,Unnamed: 0,phy,data_rate,data_rate_smooth,channel,frequency,signal_dbm,signal_smooth,noise_dbm,snr,tx_addr,timestamp,duration,ifs,start_tsf,end_tsf
12,12,6,6.0,6.000000000000015,1,2412,-86,-85.16783216783237,-93,7,e2:db:d1:d1:b0:4a,95014,444,1370.0,94570,95014
29,29,6,6.0,6.000000000000015,1,2412,-86,-84.80885780885802,-93,7,e2:db:d1:d1:b0:4a,133558,68,658.0,133490,133558
75,75,6,6.0,4.489510489510551,1,2412,-83,-84.61538461538484,-93,10,e2:db:d1:d1:b0:4a,299913,444,10433.0,299469,299913
78,78,6,6.0,4.867132867132956,1,2412,-83,-84.25407925407949,-93,10,e2:db:d1:d1:b0:4a,301722,548,-108.0,301174,301722
79,79,6,6.0,6.713286713286819,1,2412,-84,-83.98135198135219,-93,9,e2:db:d1:d1:b0:4a,302303,576,5.0,301727,302303
199,199,6,6.0,11.11888111888119,1,2412,-86,-84.2587412587415,-93,7,e2:db:d1:d1:b0:4a,811838,444,14487.0,811394,811838
220,220,6,6.0,12.755244755244854,1,2412,-85,-84.85081585081608,-93,8,e2:db:d1:d1:b0:4a,914233,444,9771.0,913789,914233
446,446,6,24.0,16.5314685314686,1,2412,-84,-86.0699300699303,-92,8,e2:db:d1:d1:b0:4a,1789625,28,961.0,1789597,1789625
480,480,6,24.0,18.62937062937069,1,2412,-86,-86.24941724941748,-92,6,e2:db:d1:d1:b0:4a,1910931,28,66.0,1910903,1910931
540,540,6,24.0,19.048951048951096,1,2412,-88,-86.20745920745944,-92,4,e2:db:d1:d1:b0:4a,2075296,28,4175.0,2075268,2075296
547,547,6,6.0,17.790209790209822,1,2412,-87,-86.08624708624731,-92,5,e2:db:d1:d1:b0:4a,2081872,68,67.0,2081804,2081872
549,549,6,24.0,14.853146853146852,1,2412,-87,-86.17948717948741,-92,5,e2:db:d1:d1:b0:4a,2089753,28,6315.0,2089725,2089753
562,562,6,6.0,10.237762237762176,1,2412,-83,-86.10722610722632,-92,9,e2:db:d1:d1:b0:4a,2143039,444,10348.0,2142595,2143039
564,564,6,6.0,7.762237762237703,1,2412,-86,-85.80186480186504,-92,6,e2:db:d1:d1:b0:4a,2144866,168,273.0,2144698,2144866
565,565,6,6.0,6.335664335664291,1,2412,-86,-85.45221445221468,-92,6,e2:db:d1:d1:b0:4a,2145067,196,5.0,2144871,2145067
566,566,6,6.0,6.377622377622369,1,2412,-86,-85.44289044289067,-92,6,e2:db:d1:d1:b0:4a,2145296,168,61.0,2145128,2145296
567,567,6,6.0,4.489510489510452,1,2412,-86,-85.71328671328693,-92,6,e2:db:d1:d1:b0:4a,2145497,196,5.0,2145301,2145497
568,568,6,6.0,6.000000000000015,1,2412,-86,-86.24242424242448,-92,6,e2:db:d1:d1:b0:4a,2145726,188,41.0,2145538,2145726
569,569,6,6.0,6.000000000000015,1,2412,-85,-86.26806526806548,-92,7,e2:db:d1:d1:b0:4a,2145946,160,60.0,2145786,2145946
570,570,6,6.0,6.000000000000015,1,2412,-86,-86.06526806526828,-92,6,e2:db:d1:d1:b0:4a,2146139,188,5.0,2145951,2146139
571,571,6,6.0,6.000000000000015,1,2412,-87,-85.58041958041979,-92,5,e2:db:d1:d1:b0:4a,2146360,160,61.0,2146200,2146360
572,572,6,6.0,6.000000000000015,1,2412,-86,-85.0722610722613,-92,6,e2:db:d1:d1:b0:4a,2146553,308,-115.0,2146245,2146553
579,579,6,6.0,6.000000000000015,1,2412,-85,-84.41958041958064,-92,7,e2:db:d1:d1:b0:4a,2163152,68,5143.0,2163084,2163152
603,603,6,6.0,4.489510489510551,1,2412,-82,-84.38228438228458,-92,10,e2:db:d1:d1:b0:4a,2247859,156,12492.0,2247703,2247859
604,604,6,6.0,4.867132867132956,1,2412,-83,-83.90909090909112,-92,9,e2:db:d1:d1:b0:4a,2248048,632,-443.0,2247416,2248048
605,605,6,6.0,8.223776223776284,1,2412,-84,-83.47086247086267,-92,8,e2:db:d1:d1:b0:4a,2248713,656,9.0,2248057,2248713
625,625,6,6.0,10.741258741258784,1,2412,-84,-83.53846153846176,-92,8,e2:db:d1:d1:b0:4a,2347859,444,859.0,2347415,2347859
649,649,6,6.0,12.419580419580456,1,2412,-86,-83.61305361305384,-92,6,e2:db:d1:d1:b0:4a,2450237,444,10344.0,2449793,2450237
692,692,6,24.0,11.748251748251828,1,2412,-82,-83.82517482517504,-92,10,e2:db:d1:d1:b0:4a,2601076,28,7997.0,2601048,2601076
693,693,6,24.0,12.125874125874233,1,2412,-83,-83.81351981352002,-92,9,e2:db:d1:d1:b0:4a,2601471,28,367.0,2601443,2601471
694,694,6,6.0,14.643356643356716,1,2412,-84,-83.53379953379974,-92,8,e2:db:d1:d1:b0:4a,2601790,52,267.0,2601738,2601790
695,695,6,6.0,13.561770629370727,1,2412,-83,-83.41025641025661,-92,9,e2:db:d1:d1:b0:4a,2602196,52,354.0,2602144,2602196
696,696,6,6.0,13.61305384615393,1,2412,-84,-83.10955710955733,-92,8,e2:db:d1:d1:b0:4a,2604541,52,2293.0,2604489,2604541
697,697,6,24.0,13.34058648018653,1,2412,-84,-83.2913752913755,-92,8,e2:db:d1:d1:b0:4a,2605578,28,1009.0,2605550,2605578
698,698,6,24.0,16.142969930070016,1,2412,-82,-83.00932400932422,-92,10,e2:db:d1:d1:b0:4a,2610227,28,4621.0,2610199,2610227
699,699,6,6.0,20.509714685314826,1,2412,-83,-82.87179487179509,-92,9,e2:db:d1:d1:b0:4a,2610949,52,670.0,2610897,2610949
700,700,7,28.8889,22.62263892773906,1,2412,-82,-82.90209790209812,-92,10,e2:db:d1:d1:b0:4a,2611080,122,9.0,2610958,2611080
702,702,6,24.0,25.083141258741325,1,2412,-83,-82.66200466200486,-92,9,e2:db:d1:d1:b0:4a,2612396,28,1099.0,2612368,2612396
703,703,6,24.0,24.073039860139858,1,2412,-83,-82.41025641025662,-92,9,e2:db:d1:d1:b0:4a,2612762,28,338.0,2612734,2612762
705,705,6,24.0,23.410516550116544,1,2412,-83,-82.32167832167853,-92,9,e2:db:d1:d1:b0:4a,2614034,28,530.0,2614006,2614034
709,709,6,24.0,22.004662237762247,1,2412,-82,-82.77389277389297,-92,10,e2:db:d1:d1:b0:4a,2626270,28,1827.0,2626242,2626270
710,710,6,24.0,16.45687552447546,1,2412,-81,-81.35664335664356,-92,11,e2:db:d1:d1:b0:4a,2626659,28,361.0,2626631,2626659
726,726,6,6.0,13.132867132867077,1,2412,-81,-80.46153846153868,-92,11,e2:db:d1:d1:b0:4a,2657195,160,2586.0,2657035,2657195
727,727,6,6.0,9.608391608391543,1,2412,-82,-80.3752913752916,-92,10,e2:db:d1:d1:b0:4a,2657460,188,77.0,2657272,2657460
728,728,6,6.0,6.713286713286644,1,2412,-82,-80.67132867132891,-92,10,e2:db:d1:d1:b0:4a,2658017,200,357.0,2657817,2658017
747,747,6,6.0,4.8671328671328045,1,2412,-73,-82.24708624708646,-92,19,e2:db:d1:d1:b0:4a,2757594,444,630.0,2757150,2757594
780,780,6,6.0,4.489510489510452,1,2412,-86,-82.44988344988367,-92,6,e2:db:d1:d1:b0:4a,2859866,444,1256.0,2859422,2859866
820,820,6,6.0,6.000000000000015,1,2412,-86,-82.778554778555,-92,6,e2:db:d1:d1:b0:4a,2990538,52,2678.0,2990486,2990538
823,823,6,6.0,6.000000000000015,1,2412,-85,-83.13986013986039,-92,7,e2:db:d1:d1:b0:4a,3003973,68,284.0,3003905,3003973
824,824,6,6.0,6.000000000000015,1,2412,-86,-83.84149184149209,-92,6,e2:db:d1:d1:b0:4a,3008991,52,4966.0,3008939,3008991
827,827,6,6.0,6.000000000000015,1,2412,-77,-84.70629370629396,-92,15,e2:db:d1:d1:b0:4a,3015148,52,308.0,3015096,3015148
830,830,6,6.0,6.000000000000015,1,2412,-85,-83.89976689976712,-92,7,e2:db:d1:d1:b0:4a,3019816,68,719.0,3019748,3019816
831,831,6,6.0,6.000000000000015,1,2412,-85,-84.00233100233122,-92,7,e2:db:d1:d1:b0:4a,3020588,52,720.0,3020536,3020588
833,833,6,6.0,6.000000000000015,1,2412,-86,-84.53613053613076,-92,6,e2:db:d1:d1:b0:4a,3023045,52,2115.0,3022993,3023045
834,834,6,6.0,6.000000000000015,1,2412,-86,-85.34965034965059,-92,6,e2:db:d1:d1:b0:4a,3023501,52,404.0,3023449,3023501
842,842,6,6.0,6.000000000000015,1,2412,-86,-86.3356643356646,-92,6,e2:db:d1:d1:b0:4a,3038700,52,255.0,3038648,3038700
843,843,6,6.0,6.000000000000015,1,2412,-84,-86.29836829836853,-92,8,e2:db:d1:d1:b0:4a,3039053,52,301.0,3039001,3039053
845,845,6,6.0,4.867132867132917,1,2412,-87,-93.45454545454545,-92,5,e2:db:d1:d1:b0:4a,3041072,52,1709.0,3041020,3041072
847,847,6,6.0,5.150349650349721,1,2412,-87,-91.50815850815837,-92,5,e2:db:d1:d1:b0:4a,3041434,52,52.0,3041382,3041434
849,849,6,6.0,6.534965034965118,1,2412,-86,-82.65268065268046,-92,6,e2:db:d1:d1:b0:4a,3042120,68,336.0,3042052,3042120
856,856,6,6.0,8.706293706293797,1,2412,-88,-68.80885780885755,-92,4,e2:db:d1:d1:b0:4a,3061370,52,7464.0,3061318,3061370
964,964,6,6.0,11.349650349650448,1,2412,-83,-51.98135198135168,-92,9,e2:db:d1:d1:b0:4a,3409668,68,271.0,3409600,3409668
967,967,7,19.5,14.150349650349753,1,2412,0,-33.7505827505824,-92,92,e2:db:d1:d1:b0:4a,3421502,676,7287.0,3420826,3421502
968,968,7,19.5,16.793706293706403,1,2412,0,-16.87878787878749,-92,92,e2:db:d1:d1:b0:4a,3421502,420,-420.0,3421082,3421502
969,969,7,19.5,20.097902097902175,1,2412,0,3.9906759906761806,-92,92,e2:db:d1:d1:b0:4a,3421502,636,-636.0,3420866,3421502
970,970,7,19.5,21.199300699300753,1,2412,0,10.993006993007022,-92,92,e2:db:d1:d1:b0:4a,3421502,636,-636.0,3420866,3421502
971,971,7,19.5,20.097902097902118,1,2412,0,3.6806526806525026,-92,92,e2:db:d1:d1:b0:4a,3421502,516,-516.0,3420986,3421502
972,972,7,19.5,16.79370629370627,1,2412,0,-17.060606060606535,-92,92,e2:db:d1:d1:b0:4a,3421502,640,-640.0,3420862,3421502
973,973,7,19.5,14.15034965034962,1,2412,0,-33.7855477855483,-92,92,e2:db:d1:d1:b0:4a,3421502,640,-640.0,3420862,3421502
974,974,6,6.0,11.349650349650313,1,2412,-85,-51.47785547785604,-92,7,e2:db:d1:d1:b0:4a,3428726,52,7172.0,3428674,3428726
977,977,6,6.0,8.706293706293662,1,2412,-85,-68.15617715617776,-92,7,e2:db:d1:d1:b0:4a,3453248,52,12496.0,3453196,3453248
983,983,6,6.0,6.534965034964987,1,2412,-86,-81.75524475524539,-92,6,e2:db:d1:d1:b0:4a,3461761,52,61.0,3461709,3461761
984,984,6,6.0,5.150349650349607,1,2412,-85,-90.48251748251809,-92,7,e2:db:d1:d1:b0:4a,3462692,52,879.0,3462640,3462692
986,986,6,6.0,4.8671328671328435,1,2412,-85,-92.33333333333383,-92,7,e2:db:d1:d1:b0:4a,3474255,444,7285.0,3473811,3474255
990,990,6,6.0,6.000000000000015,1,2412,-85,-85.4708624708627,-92,7,e2:db:d1:d1:b0:4a,3476190,168,390.0,3476022,3476190
992,992,6,6.0,6.000000000000015,1,2412,-85,-85.3752913752916,-92,7,e2:db:d1:d1:b0:4a,3476758,196,-2.0,3476562,3476758
993,993,6,6.0,6.000000000000015,1,2412,-86,-85.31468531468553,-92,6,e2:db:d1:d1:b0:4a,3477103,168,177.0,3476935,3477103
994,994,6,6.0,6.000000000000015,1,2412,-86,-85.56177156177179,-92,6,e2:db:d1:d1:b0:4a,3482089,52,4934.0,3482037,3482089
1015,1015,6,6.0,4.489510489510551,1,2412,-86,-85.4638694638697,-92,6,e2:db:d1:d1:b0:4a,3576650,444,5433.0,3576206,3576650
1037,1037,6,6.0,6.37762237762242,1,2412,-84,-85.39860139860163,-92,8,e2:db:d1:d1:b0:4a,3679060,444,4993.0,3678616,3679060
1083,1083,6,6.0,7.846153846153878,1,2412,-86,-85.50815850815876,-92,6,e2:db:d1:d1:b0:4a,3845562,52,1836.0,3845510,3845562
1084,1084,6,6.0,8.895104895104922,1,2412,-86,-85.80652680652703,-92,6,e2:db:d1:d1:b0:4a,3845958,52,344.0,3845906,3845958
1085,1085,6,6.0,8.391608391608452,1,2412,-85,-86.49883449883471,-92,7,e2:db:d1:d1:b0:4a,3850139,52,4129.0,3850087,3850139
1087,1087,6,24.0,8.884615384615465,1,2412,-87,-86.65967365967389,-92,5,e2:db:d1:d1:b0:4a,3853149,28,2464.0,3853121,3853149
1089,1089,6,6.0,11.192307692307748,1,2412,-88,-87.32167832167853,-92,4,e2:db:d1:d1:b0:4a,3853628,68,68.0,3853560,3853628
1095,1095,6,6.0,12.45104895104899,1,2412,-88,-87.09324009324031,-92,4,e2:db:d1:d1:b0:4a,3858914,52,1270.0,3858862,3858914
1096,1096,6,6.0,12.660839160839183,1,2412,-87,-86.61305361305382,-92,5,e2:db:d1:d1:b0:4a,3859391,52,425.0,3859339,3859391
1097,1097,7,19.5,11.821678321678327,1,2412,-84,-85.80652680652702,-92,8,e2:db:d1:d1:b0:4a,3859522,172,-41.0,3859350,3859522
1103,1103,7,19.5,9.93356643356641,1,2412,-87,-84.55477855477875,-92,5,e2:db:d1:d1:b0:4a,3869228,84,229.0,3869144,3869228
1145,1145,6,6.0,9.68181818181824,1,2412,-82,-90.3170163170163,-92,10,e2:db:d1:d1:b0:4a,3931431,52,5841.0,3931379,3931431
1146,1146,6,6.0,8.706293706293774,1,2412,-82,-87.77156177156162,-92,10,e2:db:d1:d1:b0:4a,3931738,52,255.0,3931686,3931738
1148,1148,6,6.0,8.202797202797262,1,2412,-82,-78.88578088578068,-92,10,e2:db:d1:d1:b0:4a,3932127,52,79.0,3932075,3932127
1149,1149,6,6.0,7.856643356643389,1,2412,-82,-58.53379953379948,-92,10,e2:db:d1:d1:b0:4a,3932613,52,434.0,3932561,3932613
1150,1150,6,6.0,9.671328671328745,1,2412,-82,-43.8624708624709,-92,10,e2:db:d1:d1:b0:4a,3933000,52,335.0,3932948,3933000
1151,1151,7,19.5,15.419580419580502,1,2412,0,-35.783216783216865,-92,92,e2:db:d1:d1:b0:4a,3933130,84,46.0,3933046,3933130
1152,1152,7,19.5,18.310023310023368,1,2412,0,-33.16083916083925,-92,92,e2:db:d1:d1:b0:4a,3933130,40,-40.0,3933090,3933130
1153,1153,7,19.5,18.888111888111954,1,2412,0,-36.11888111888124,-92,92,e2:db:d1:d1:b0:4a,3933130,56,-56.0,3933074,3933130
1154,1154,7,19.5,19.06293706293711,1,2412,-83,-44.93006993007012,-92,9,e2:db:d1:d1:b0:4a,3933130,44,-44.0,3933086,3933130
1156,1156,7,26.0,16.21678321678327,1,2412,-83,-59.214452214452564,-92,9,e2:db:d1:d1:b0:4a,3936533,72,3015.0,3936461,3936533
1157,1157,6,6.0,14.031468531468521,1,2412,-83,-79.51748251748312,-92,9,e2:db:d1:d1:b0:4a,3936797,52,212.0,3936745,3936797
1158,1158,6,6.0,11.37412587412588,1,2412,-82,-87.93706293706353,-92,10,e2:db:d1:d1:b0:4a,3937111,52,262.0,3937059,3937111
1159,1159,7,13.0,11.10839160839159,1,2412,-83,-89.71561771561817,-92,9,e2:db:d1:d1:b0:4a,3937242,108,23.0,3937134,3937242
1160,1160,6,6.0,10.685314685314657,1,2412,-82,-82.56177156177179,-92,10,e2:db:d1:d1:b0:4a,3941745,52,4451.0,3941693,3941745
1161,1161,7,19.5,10.419580419580393,1,2412,-84,-82.63170163170184,-92,8,e2:db:d1:d1:b0:4a,3941875,224,-94.0,3941651,3941875
1162,1162,6,6.0,10.494172494172567,1,2412,-82,-82.66433566433588,-92,10,e2:db:d1:d1:b0:4a,3942386,52,459.0,3942334,3942386
1163,1163,7,19.5,11.496503496503541,1,2412,-83,-82.6806526806529,-92,9,e2:db:d1:d1:b0:4a,3942517,92,39.0,3942425,3942517
1166,1166,6,6.0,11.286713286713299,1,2412,-82,-82.73892773892797,-92,10,e2:db:d1:d1:b0:4a,3942992,68,100.0,3942924,3942992
1186,1186,6,6.0,9.839160839160897,1,2412,-84,-83.31468531468555,-92,8,e2:db:d1:d1:b0:4a,3986266,444,-293.0,3985822,3986266
1230,1230,6,6.0,10.15384615384616,1,2412,-83,-83.74592074592098,-91,8,e2:db:d1:d1:b0:4a,4133122,68,10343.0,4133054,4133122
1231,1231,6,24.0,10.353146853146923,1,2412,-84,-84.80419580419604,-91,7,e2:db:d1:d1:b0:4a,4134858,28,1708.0,4134830,4134858
1249,1249,6,6.0,11.664335664335686,1,2412,-86,-85.28205128205153,-91,5,e2:db:d1:d1:b0:4a,4191074,444,10367.0,4190630,4191074
1266,1266,6,6.0,14.265734265734311,1,2412,-87,-85.86713286713311,-91,4,e2:db:d1:d1:b0:4a,4256679,68,3340.0,4256611,4256679
1268,1268,6,24.0,14.433566433566465,1,2412,-86,-93.47086247086249,-91,5,e2:db:d1:d1:b0:4a,4258172,28,1081.0,4258144,4258172
1284,1284,6,6.0,13.395104895104904,1,2412,-87,-92.05827505827494,-91,4,e2:db:d1:d1:b0:4a,4296465,68,994.0,4296397,4296465
1297,1297,6,24.0,11.138694638694616,1,2412,-85,-83.20745920745901,-91,6,e2:db:d1:d1:b0:4a,4338492,28,4600.0,4338464,4338492
1305,1305,6,6.0,11.470862470862492,1,2412,-87,-69.1491841491839,-91,4,e2:db:d1:d1:b0:4a,4362378,68,4689.0,4362310,4362378
1307,1307,6,6.0,9.470862470862468,1,2412,-87,-52.18181818181788,-91,4,e2:db:d1:d1:b0:4a,4366876,52,4177.0,4366824,4366876
1308,1308,7,6.5,6.637529137529096,1,2412,0,-34.35431235431201,-91,91,e2:db:d1:d1:b0:4a,4367006,272,-142.0,4366734,4367006
1309,1309,7,6.5,6.777389277389272,1,2412,0,-17.39860139860101,-91,91,e2:db:d1:d1:b0:4a,4367006,336,-336.0,4366670,4367006
1310,1310,7,6.5,4.969696969696935,1,2412,0,3.349650349650542,-91,91,e2:db:d1:d1:b0:4a,4367006,128,-128.0,4366878,4367006
1311,1311,7,6.5,6.573426573426591,1,2412,0,11.034965034965065,-91,91,e2:db:d1:d1:b0:4a,4367006,1912,-1912.0,4365094,4367006
1312,1312,7,6.5,6.573426573426589,1,2412,0,4.179487179487011,-91,91,e2:db:d1:d1:b0:4a,4367006,132,-132.0,4366874,4367006
1313,1313,7,6.5,6.480186480186495,1,2412,0,-17.027972027972503,-91,91,e2:db:d1:d1:b0:4a,4367006,120,-120.0,4366886,4367006
1314,1314,7,6.5,6.399766899766914,1,2412,0,-33.52680652680705,-91,91,e2:db:d1:d1:b0:4a,4367006,128,-128.0,4366878,4367006
1315,1315,7,6.5,6.301864801864816,1,2412,-83,-51.39393939393996,-91,8,e2:db:d1:d1:b0:4a,4367006,460,-460.0,4366546,4367006
1324,1324,6,6.0,6.198135198135211,1,2412,-87,-68.05594405594468,-91,4,e2:db:d1:d1:b0:4a,4393796,68,6851.0,4393728,4393796
1325,1325,6,6.0,6.100233100233114,1,2412,-86,-82.16083916083979,-91,5,e2:db:d1:d1:b0:4a,4393996,52,148.0,4393944,4393996
1326,1326,6,6.0,6.019813519813533,1,2412,-84,-91.11421911421971,-91,7,e2:db:d1:d1:b0:4a,4394577,68,513.0,4394509,4394577
1333,1333,6,6.0,5.926573426573441,1,2412,-87,-93.1258741258746,-91,4,e2:db:d1:d1:b0:4a,4407525,68,580.0,4407457,4407525
1334,1334,6,6.0,5.381118881118914,1,2412,-85,-92.74125874125875,-91,6,e2:db:d1:d1:b0:4a,4408069,68,476.0,4408001,4408069
1335,1335,6,6.0,5.610722610722654,1,2412,-87,-83.29137529137536,-91,4,e2:db:d1:d1:b0:4a,4408618,52,497.0,4408566,4408618
1338,1338,6,6.0,6.9452214452214776,1,2412,-84,-75.90909090909105,-91,7,e2:db:d1:d1:b0:4a,4414047,52,3331.0,4413995,4414047
1339,1339,6,6.0,6.431235431235504,1,2412,-84,-70.5407925407927,-91,7,e2:db:d1:d1:b0:4a,4414427,52,328.0,4414375,4414427
1340,1340,7,6.5,8.97785547785553,1,2412,-82,-66.89277389277404,-91,9,e2:db:d1:d1:b0:4a,4414558,196,-65.0,4414362,4414558
1342,1342,7,13.0,10.766899766899806,1,2412,0,-65.60139860139877,-91,91,e2:db:d1:d1:b0:4a,4415145,108,172.0,4415037,4415145
1343,1343,7,13.0,11.798368298368333,1,2412,-82,-66.4382284382286,-91,9,e2:db:d1:d1:b0:4a,4415145,240,-240.0,4414905,4415145
1352,1352,6,6.0,12.03030303030306,1,2412,-84,-77.18881118881117,-91,7,e2:db:d1:d1:b0:4a,4420945,68,358.0,4420877,4420945
1353,1353,6,24.0,11.557109557109582,1,2412,-84,-73.95337995338008,-91,7,e2:db:d1:d1:b0:4a,4423013,28,2040.0,4422985,4423013
1355,1355,6,6.0,10.40909090909092,1,2412,-84,-74.17249417249444,-91,7,e2:db:d1:d1:b0:4a,4423794,52,510.0,4423742,4423794
1357,1357,6,6.0,8.586247086247077,1,2412,-86,-77.95104895104937,-91,5,e2:db:d1:d1:b0:4a,4424251,52,79.0,4424199,4424251
1358,1358,6,6.0,7.437062937062926,1,2412,-86,-68.26573426573447,-91,5,e2:db:d1:d1:b0:4a,4425263,52,960.0,4425211,4425263
1359,1359,7,6.5,5.991841491841501,1,2412,0,-67.53379953379971,-91,91,e2:db:d1:d1:b0:4a,4425394,172,-41.0,4425222,4425394
1360,1360,7,6.5,4.837995337995311,1,2412,-82,-67.96969696969715,-91,9,e2:db:d1:d1:b0:4a,4425394,156,-156.0,4425238,4425394
1362,1362,6,6.0,6.308857808857849,1,2412,-85,-71.02797202797223,-91,6,e2:db:d1:d1:b0:4a,4426013,52,115.0,4425961,4426013
1363,1363,6,6.0,6.817016317016366,1,2412,-86,-75.69463869463893,-91,5,e2:db:d1:d1:b0:4a,4426613,52,548.0,4426561,4426613
1366,1366,6,6.0,8.297202797202832,1,2412,-85,-82.10489510489543,-91,6,e2:db:d1:d1:b0:4a,4431492,52,452.0,4431440,4431492
1367,1367,7,13.0,9.264568764568793,1,2412,-81,-91.0233100233105,-91,10,e2:db:d1:d1:b0:4a,4431622,108,22.0,4431514,4431622
1368,1368,6,6.0,9.237762237762281,1,2412,-87,-84.35431235431258,-91,4,e2:db:d1:d1:b0:4a,4431891,52,217.0,4431839,4431891
1369,1369,7,13.0,10.095571095571131,1,2412,-82,-83.72027972027993,-91,9,e2:db:d1:d1:b0:4a,4432022,108,23.0,4431914,4432022
1372,1372,7,13.0,10.216783216783245,1,2412,-82,-83.63403263403283,-91,9,e2:db:d1:d1:b0:4a,4432775,108,187.0,4432667,4432775
1373,1373,6,6.0,8.26923076923083,1,2412,-86,-83.44988344988369,-91,5,e2:db:d1:d1:b0:4a,4433017,52,190.0,4432965,4433017
1375,1375,6,6.0,9.055944055944082,1,2412,-85,-83.61538461538483,-91,6,e2:db:d1:d1:b0:4a,4433926,52,436.0,4433874,4433926
1376,1376,7,13.0,10.243589743589768,1,2412,-81,-83.26107226107247,-91,10,e2:db:d1:d1:b0:4a,4434056,996,-866.0,4433060,4434056
1377,1377,6,6.0,9.923076923076923,1,2412,-84,-83.90442890442912,-91,7,e2:db:d1:d1:b0:4a,4435266,52,1158.0,4435214,4435266
1379,1379,7,6.5,10.166666666666671,1,2412,-82,-83.6969696969699,-91,9,e2:db:d1:d1:b0:4a,4436720,1952,-1550.0,4434768,4436720
1384,1384,6,24.0,9.039627039627108,1,2412,-85,-83.08158508158527,-91,6,e2:db:d1:d1:b0:4a,4461140,28,3042.0,4461112,4461140
1402,1402,6,6.0,10.129370629370671,1,2412,-84,-82.93006993007013,-91,7,e2:db:d1:d1:b0:4a,4498282,444,-2.0,4497838,4498282
1425,1425,6,6.0,8.694638694638757,1,2412,-83,-82.64335664335685,-91,8,e2:db:d1:d1:b0:4a,4581427,68,8948.0,4581359,4581427
1434,1434,6,6.0,11.129370629370676,1,2412,-81,-81.84382284382305,-91,10,e2:db:d1:d1:b0:4a,4601577,444,281.0,4601133,4601577
1455,1455,6,6.0,11.664335664335681,1,2412,-81,-88.69463869463867,-91,10,e2:db:d1:d1:b0:4a,4633443,68,1613.0,4633375,4633443
1456,1456,6,24.0,11.08741258741257,1,2412,-81,-86.65967365967353,-91,10,e2:db:d1:d1:b0:4a,4634731,28,1260.0,4634703,4634731
1475,1475,6,6.0,13.110722610722645,1,2412,-81,-71.48951048951051,-91,10,e2:db:d1:d1:b0:4a,4705145,68,3386.0,4705077,4705145
1489,1489,6,24.0,12.71911421911425,1,2412,-83,-60.289044289044384,-91,8,e2:db:d1:d1:b0:4a,4757470,28,7813.0,4757442,4757470
1503,1503,6,6.0,11.517482517482536,1,2412,-84,-60.19114219114211,-91,7,e2:db:d1:d1:b0:4a,4783846,68,1788.0,4783778,4783846
1508,1508,7,6.5,9.494172494172492,1,2412,0,-54.97202797202778,-91,91,e2:db:d1:d1:b0:4a,4799663,1432,3058.0,4798231,4799663
1509,1509,7,6.5,6.637529137529096,1,2412,0,-46.687645687645414,-91,91,e2:db:d1:d1:b0:4a,4799663,132,-132.0,4799531,4799663
1510,1510,6,6.0,6.754079254079248,1,2412,-83,-37.226107226106926,-91,8,e2:db:d1:d1:b0:4a,4804040,68,4309.0,4803972,4804040
1517,1517,7,6.5,4.923076923076889,1,2412,-84,-28.475524475524196,-91,7,e2:db:d1:d1:b0:4a,4832301,1952,2519.0,4830349,4832301
1518,1518,7,6.5,6.461538461538479,1,2412,0,-15.53146853146856,-91,91,e2:db:d1:d1:b0:4a,4837586,1900,3385.0,4835686,4837586
1519,1519,7,6.5,6.4906759906760065,1,2412,0,-16.86247086247119,-91,91,e2:db:d1:d1:b0:4a,4837586,376,-376.0,4837210,4837586
1520,1520,7,6.5,5.8123580419580785,1,2412,0,-13.953379953380225,-91,91,e2:db:d1:d1:b0:4a,4837586,1580,-1580.0,4836006,4837586
1521,1521,7,6.5,6.699299766899796,1,2412,0,-12.086247086247187,-91,91,e2:db:d1:d1:b0:4a,4837586,1580,-1580.0,4836006,4837586
1522,1522,7,6.5,7.265859207459229,1,2412,0,-26.554778554778803,-91,91,e2:db:d1:d1:b0:4a,4837586,1580,-1580.0,4836006,4837586
1523,1523,7,6.5,6.149565501165566,1,2412,-86,-50.568764568765104,-91,5,e2:db:d1:d1:b0:4a,4837586,1576,-1576.0,4836010,4837586
1524,1524,6,6.0,8.229206526806571,1,2412,-83,-66.56876456876515,-91,8,e2:db:d1:d1:b0:4a,4842529,52,4891.0,4842477,4842529
1527,1527,7,14.4444,9.698255477855513,1,2412,-83,-79.41958041958101,-91,8,e2:db:d1:d1:b0:4a,4859060,97,5784.0,4858963,4859060
1532,1532,6,6.0,9.05787785547793,1,2412,-81,-87.42191142191199,-91,10,e2:db:d1:d1:b0:4a,4865549,68,264.0,4865481,4865549
1545,1545,6,6.0,11.228819580419632,1,2412,-81,-88.58041958042001,-91,10,e2:db:d1:d1:b0:4a,4911982,68,2059.0,4911914,4911982
1566,1566,6,24.0,10.89406433566442,1,2412,-82,-81.17249417249437,-91,9,e2:db:d1:d1:b0:4a,4999121,28,455.0,4999093,4999121
1574,1574,6,6.0,12.974358041958093,1,2412,-81,-81.42191142191163,-90,9,e2:db:d1:d1:b0:4a,5035298,68,205.0,5035230,5035298
1602,1602,6,6.0,12.046623776223843,1,2412,-82,-81.81818181818203,-90,8,e2:db:d1:d1:b0:4a,5116000,68,38.0,5115932,5116000
1617,1617,6,24.0,14.85314685314691,1,2412,-82,-82.40093240093262,-90,8,e2:db:d1:d1:b0:4a,5157484,28,2645.0,5157456,5157484
1620,1620,6,6.0,15.272727272727298,1,2412,-83,-82.66200466200488,-90,7,e2:db:d1:d1:b0:4a,5165646,68,4675.0,5165578,5165646
1621,1621,6,24.0,14.013986013986,1,2412,-83,-82.9953379953382,-90,7,e2:db:d1:d1:b0:4a,5166883,28,1209.0,5166855,5166883
1635,1635,6,6.0,14.895104895104922,1,2412,-84,-83.43822843822866,-90,6,e2:db:d1:d1:b0:4a,5202176,68,1990.0,5202108,5202176
1637,1637,6,24.0,11.874125874125914,1,2412,-83,-83.39860139860164,-90,7,e2:db:d1:d1:b0:4a,5203552,28,1114.0,5203524,5203552
1643,1643,6,6.0,9.010489510489528,1,2412,-83,-90.3030303030303,-90,7,e2:db:d1:d1:b0:4a,5218115,656,1007.0,5217459,5218115
1644,1644,6,6.0,9.807692307692369,1,2412,-84,-88.37296037296025,-90,6,e2:db:d1:d1:b0:4a,5218804,156,533.0,5218648,5218804
1645,1645,6,6.0,9.041958041958072,1,2412,-83,-79.73193473193454,-90,7,e2:db:d1:d1:b0:4a,5218993,196,-7.0,5218797,5218993
1646,1646,6,6.0,11.727272727272801,1,2412,-82,-66.23076923076898,-90,8,e2:db:d1:d1:b0:4a,5219222,156,73.0,5219066,5219222
1650,1650,7,19.5,12.63986013986019,1,2412,-83,-50.016317016316734,-90,7,e2:db:d1:d1:b0:4a,5225770,148,356.0,5225622,5225770
1651,1651,7,19.5,16.793706293706403,1,2412,0,-32.75058275058242,-90,90,e2:db:d1:d1:b0:4a,5225999,84,145.0,5225915,5225999
1652,1652,7,19.5,18.965034965035077,1,2412,0,-16.45221445221408,-90,90,e2:db:d1:d1:b0:4a,5225999,48,-48.0,5225951,5225999
1653,1653,7,19.5,20.349650349650457,1,2412,0,-3.2680652680648796,-90,90,e2:db:d1:d1:b0:4a,5225999,48,-48.0,5225951,5225999
1654,1654,7,19.5,20.632867132867222,1,2412,0,5.139860139860497,-90,90,e2:db:d1:d1:b0:4a,5225999,44,-44.0,5225955,5225999
1655,1655,7,19.5,19.50000000000005,1,2412,0,13.930069930069966,-90,90,e2:db:d1:d1:b0:4a,5225999,48,-48.0,5225951,5225999
1656,1656,7,19.5,19.50000000000005,1,2412,0,-1.7412587412588671,-90,90,e2:db:d1:d1:b0:4a,5225999,48,-48.0,5225951,5225999
1657,1657,7,19.5,19.50000000000005,1,2412,0,-8.51282051282059,-90,90,e2:db:d1:d1:b0:4a,5225999,44,-44.0,5225955,5225999
1658,1658,7,19.5,19.50000000000005,1,2412,0,-13.3496503496504,-90,90,e2:db:d1:d1:b0:4a,5225999,48,-48.0,5225951,5225999
1659,1659,7,19.5,19.50000000000005,1,2412,0,-16.251748251748293,-90,90,e2:db:d1:d1:b0:4a,5225999,48,-48.0,5225951,5225999
1660,1660,7,19.5,19.50000000000005,1,2412,-83,-17.219114219114264,-90,7,e2:db:d1:d1:b0:4a,5225999,44,-44.0,5225955,5225999
1663,1663,7,19.5,19.50000000000005,1,2412,0,-16.251748251748293,-90,90,e2:db:d1:d1:b0:4a,5227497,76,664.0,5227421,5227497
1664,1664,7,19.5,19.50000000000005,1,2412,0,-13.349650349650368,-90,90,e2:db:d1:d1:b0:4a,5227497,48,-48.0,5227449,5227497
1665,1665,7,19.5,19.50000000000005,1,2412,0,-8.512820512820483,-90,90,e2:db:d1:d1:b0:4a,5227497,48,-48.0,5227449,5227497
1666,1666,7,19.5,19.50000000000005,1,2412,0,-1.7412587412586276,-90,90,e2:db:d1:d1:b0:4a,5227497,44,-44.0,5227453,5227497
1667,1667,7,19.5,19.50000000000005,1,2412,0,6.965034965035211,-90,90,e2:db:d1:d1:b0:4a,5227497,48,-48.0,5227449,5227497
1668,1668,7,19.5,19.50000000000005,1,2412,0,0.0,-90,90,e2:db:d1:d1:b0:4a,5227497,48,-48.0,5227449,5227497
1669,1669,7,19.5,19.50000000000005,1,2412,0,0.0,-90,90,e2:db:d1:d1:b0:4a,5227497,44,-44.0,5227453,5227497
1670,1670,7,19.5,19.50000000000005,1,2412,0,0.0,-90,90,e2:db:d1:d1:b0:4a,5227497,48,-48.0,5227449,5227497
1671,1671,7,19.5,19.50000000000005,1,2412,0,0.0,-90,90,e2:db:d1:d1:b0:4a,5227497,236,-236.0,5227261,5227497
1672,1672,7,19.5,19.50000000000005,1,2412,0,6.377622377622185,-90,90,e2:db:d1:d1:b0:4a,5227497,72,-72.0,5227425,5227497
1673,1673,7,19.5,20.632867132867148,1,2412,0,4.951048951048638,-90,90,e2:db:d1:d1:b0:4a,5227497,72,-72.0,5227425,5227497
1674,1674,7,19.5,19.216783216783245,1,2412,0,-2.382284382284783,-90,90,e2:db:d1:d1:b0:4a,5227497,184,-184.0,5227313,5227497
1675,1675,7,19.5,19.24825174825175,1,2412,0,-15.020979020979476,-90,90,e2:db:d1:d1:b0:4a,5227497,76,-76.0,5227421,5227497
1676,1676,7,19.5,17.045454545454568,1,2412,0,-30.734265734266234,-90,90,e2:db:d1:d1:b0:4a,5227497,160,-160.0,5227337,5227497
1677,1677,7,19.5,16.604895104895103,1,2412,-76,-47.8601398601404,-90,14,e2:db:d1:d1:b0:4a,5229226,120,1609.0,5229106,5229226
1681,1681,6,6.0,15.377622377622359,1,2412,-78,-64.25174825174884,-90,12,e2:db:d1:d1:b0:4a,5250826,52,788.0,5250774,5250826
1682,1682,7,19.5,13.67832167832165,1,2412,-84,-78.05827505827565,-90,6,e2:db:d1:d1:b0:4a,5250957,92,39.0,5250865,5250957
1684,1684,6,6.0,10.688811188811188,1,2412,-83,-94.03729603729641,-90,7,e2:db:d1:d1:b0:4a,5253856,52,2675.0,5253804,5253856
1685,1685,7,19.5,10.405594405594393,1,2412,-84,-87.82983682983718,-90,6,e2:db:d1:d1:b0:4a,5253987,84,47.0,5253903,5253987
1688,1688,6,6.0,10.27972027972027,1,2412,-83,-75.0233100233102,-90,7,e2:db:d1:d1:b0:4a,5257076,52,1555.0,5257024,5257076
1691,1691,6,6.0,9.493006993007034,1,2412,-83,-69.99300699300717,-90,7,e2:db:d1:d1:b0:4a,5260584,68,67.0,5260516,5260584
1692,1692,6,6.0,9.178321678321677,1,2412,-82,-66.76689976689993,-90,8,e2:db:d1:d1:b0:4a,5260811,52,175.0,5260759,5260811
1693,1693,7,19.5,10.468531468531486,1,2412,0,-65.84848484848501,-90,90,e2:db:d1:d1:b0:4a,5260941,668,-538.0,5260273,5260941
1696,1696,6,6.0,8.3671300699301,1,2412,-83,-73.72261072261068,-90,7,e2:db:d1:d1:b0:4a,5263912,68,91.0,5263844,5263912
1697,1697,6,6.0,11.14335734265739,1,2412,-84,-68.21678321678328,-90,6,e2:db:d1:d1:b0:4a,5264058,52,94.0,5264006,5264058
1698,1698,7,19.5,11.792155710955743,1,2412,-84,-66.11888111888129,-90,6,e2:db:d1:d1:b0:4a,5264189,92,39.0,5264097,5264189
1701,1701,6,6.0,11.446392307692319,1,2412,-82,-67.85314685314712,-90,8,e2:db:d1:d1:b0:4a,5274481,68,196.0,5274413,5274481
1702,1702,6,6.0,10.10606713286712,1,2412,-83,-73.56410256410298,-90,7,e2:db:d1:d1:b0:4a,5276267,52,1734.0,5276215,5276267
1703,1703,7,21.6667,9.320128438228497,1,2412,0,-72.39860139860136,-90,90,e2:db:d1:d1:b0:4a,5280056,424,3365.0,5279632,5280056
1706,1706,6,6.0,8.36480629370636,1,2412,-81,-71.44988344988329,-90,9,e2:db:d1:d1:b0:4a,5286600,52,2305.0,5286548,5286600
1716,1716,6,6.0,8.007776689976746,1,2412,-83,-65.89976689976669,-90,7,e2:db:d1:d1:b0:4a,5317478,444,11716.0,5317034,5317478
1780,1780,6,6.0,10.747484848484945,1,2412,-84,-57.62237762237741,-90,6,e2:db:d1:d1:b0:4a,5524179,224,-136.0,5523955,5524179
1820,1820,6,6.0,12.536921445221534,1,2412,-82,-48.15151515151498,-90,8,e2:db:d1:d1:b0:4a,5643089,68,4203.0,5643021,5643089
1821,1821,7,21.6667,15.458450582750613,1,2412,0,-32.64568764568777,-90,90,e2:db:d1:d1:b0:4a,5644494,104,1301.0,5644390,5644494
1822,1822,7,21.6667,19.47011421911428,1,2412,0,-18.531468531468292,-90,90,e2:db:d1:d1:b0:4a,5644494,54,-54.0,5644440,5644494
1823,1823,7,21.6667,20.39358158508164,1,2412,0,-11.925407925407612,-90,90,e2:db:d1:d1:b0:4a,5644494,40,-40.0,5644454,5644494
1824,1824,7,21.6667,19.53188578088582,1,2412,0,-8.342657342657034,-90,90,e2:db:d1:d1:b0:4a,5644494,47,-47.0,5644447,5644494
1825,1825,7,21.6667,16.873371794871804,1,2412,0,-9.762237762237561,-90,90,e2:db:d1:d1:b0:4a,5644494,573,-573.0,5643921,5644494
1826,1826,6,6.0,12.406384615384571,1,2412,-85,-17.63403263403268,-90,5,e2:db:d1:d1:b0:4a,5653455,52,8909.0,5653403,5653455
1827,1827,7,6.5,9.442508624708573,1,2412,0,-16.643356643356682,-90,90,e2:db:d1:d1:b0:4a,5653585,276,-146.0,5653309,5653585
1828,1828,7,6.5,7.020591841491787,1,2412,0,-13.67132867132869,-90,90,e2:db:d1:d1:b0:4a,5655903,1952,366.0,5653951,5655903
1829,1829,7,6.5,5.494170396270348,1,2412,0,-1.668997668997851,-90,90,e2:db:d1:d1:b0:4a,5655903,1912,-1912.0,5653991,5655903
1830,1830,7,6.5,5.258738461538433,1,2412,0,3.419580419580198,-90,90,e2:db:d1:d1:b0:4a,5655903,1912,-1912.0,5653991,5655903
1831,1831,7,6.5,6.573426573426589,1,2412,0,3.8251748251746625,-90,90,e2:db:d1:d1:b0:4a,5655903,1912,-1912.0,5653991,5655903
1832,1832,7,6.5,6.438228438228454,1,2412,0,-23.785547785548044,-90,90,e2:db:d1:d1:b0:4a,5655903,1912,-1912.0,5653991,5655903
1833,1833,7,6.5,6.368298368298385,1,2412,0,-38.412587412587584,-90,90,e2:db:d1:d1:b0:4a,5655903,1912,-1912.0,5653991,5655903
1834,1834,7,6.5,6.321678321678338,1,2412,-84,-40.13986013986049,-90,6,e2:db:d1:d1:b0:4a,5655903,1912,-1912.0,5653991,5655903
1835,1835,6,6.0,5.025638228438283,1,2412,-83,-51.876456876457134,-90,7,e2:db:d1:d1:b0:4a,5661290,52,5335.0,5661238,5661290
1838,1838,6,6.0,6.658508857808896,1,2412,-84,-48.83916083916123,-90,6,e2:db:d1:d1:b0:4a,5673589,52,570.0,5673537,5673589
1839,1839,7,6.5,7.908705827505856,1,2412,0,-46.61538461538503,-90,90,e2:db:d1:d1:b0:4a,5673720,1944,-1813.0,5671776,5673720
1840,1840,7,6.5,8.787884149184173,1,2412,0,-43.62703962703995,-90,90,e2:db:d1:d1:b0:4a,5673720,1912,-1912.0,5671808,5673720
1841,1841,7,6.5,9.307698834498858,1,2412,-84,-37.45454545454557,-90,6,e2:db:d1:d1:b0:4a,5673720,1912,-1912.0,5671808,5673720
1842,1842,7,21.6667,9.479804895104918,1,2412,0,-44.19347319347338,-90,90,e2:db:d1:d1:b0:4a,5678855,612,4523.0,5678243,5678855
1847,1847,6,6.0,7.531475058275131,1,2412,-83,-56.438228438228755,-90,7,e2:db:d1:d1:b0:4a,5686184,68,68.0,5686116,5686184
1848,1848,6,6.0,8.959212820512867,1,2412,-84,-75.0303030303036,-90,6,e2:db:d1:d1:b0:4a,5686302,52,66.0,5686250,5686302
1854,1854,6,6.0,9.039241958042002,1,2412,-82,-81.498834498835,-90,8,e2:db:d1:d1:b0:4a,5698946,52,187.0,5698894,5698946
1855,1855,6,6.0,9.650350349650365,1,2412,-83,-81.50349650349685,-90,7,e2:db:d1:d1:b0:4a,5702771,52,3773.0,5702719,5702771
1856,1856,6,6.0,9.319344522144508,1,2412,-83,-90.58741258741304,-90,7,e2:db:d1:d1:b0:4a,5702990,52,167.0,5702938,5702990
1857,1857,7,26.0,11.275058275058306,1,2412,-85,-83.71794871794893,-90,5,e2:db:d1:d1:b0:4a,5703516,72,454.0,5703444,5703516
1858,1858,6,6.0,11.286713286713315,1,2412,-83,-83.3869463869466,-90,7,e2:db:d1:d1:b0:4a,5703718,52,150.0,5703666,5703718
1859,1859,7,13.0,10.668997668997694,1,2412,-85,-83.51515151515174,-90,5,e2:db:d1:d1:b0:4a,5703848,104,26.0,5703744,5703848
1861,1861,6,6.0,9.421911421911433,1,2412,-83,-83.46620046620069,-90,7,e2:db:d1:d1:b0:4a,5715631,52,6929.0,5715579,5715631
1864,1864,6,6.0,7.545454545454534,1,2412,-82,-83.3006993006995,-90,8,e2:db:d1:d1:b0:4a,5725951,52,8974.0,5725899,5725951
1865,1865,6,6.0,3.724938927738921,1,2412,-82,-90.17249417249418,-90,8,e2:db:d1:d1:b0:4a,5726807,52,804.0,5726755,5726807
1890,1890,6,6.0,5.160837062937133,1,2412,-85,-88.62237762237751,-90,5,e2:db:d1:d1:b0:4a,5831427,576,7713.0,5830851,5831427
1892,1892,6,6.0,6.033412354312428,1,2412,-84,-80.03962703962684,-90,6,e2:db:d1:d1:b0:4a,5833449,392,372.0,5833057,5833449
1910,1910,6,6.0,9.867919347319427,1,2412,-83,-66.9510489510487,-90,7,e2:db:d1:d1:b0:4a,5883548,68,108.0,5883480,5883548
1911,1911,6,6.0,12.753706060606136,1,2412,-84,-50.74592074592046,-90,6,e2:db:d1:d1:b0:4a,5883747,52,147.0,5883695,5883747
1912,1912,7,21.6667,15.115014918414994,1,2412,0,-33.314685314684986,-90,90,e2:db:d1:d1:b0:4a,5883878,78,53.0,5883800,5883878
1913,1913,7,21.6667,16.78867575757583,1,2412,0,-16.652680652680274,-90,90,e2:db:d1:d1:b0:4a,5883878,36,-36.0,5883842,5883878
1914,1914,7,21.6667,17.611518414918493,1,2412,0,-3.307692307691914,-90,90,e2:db:d1:d1:b0:4a,5883878,40,-40.0,5883838,5883878
1917,1917,7,13.0,17.42037272727279,1,2412,0,5.202797202797564,-90,90,e2:db:d1:d1:b0:4a,5886160,712,-393.0,5885448,5886160
1918,1918,7,13.0,16.05206853146857,1,2412,0,7.048951048951298,-90,90,e2:db:d1:d1:b0:4a,5886160,80,-80.0,5886080,5886160
1919,1919,7,13.0,13.343435664335656,1,2412,0,0.0,-90,90,e2:db:d1:d1:b0:4a,5886160,60,-60.0,5886100,5886160
1920,1920,7,13.0,12.454543356643352,1,2412,0,7.048951048950836,-90,90,e2:db:d1:d1:b0:4a,5886160,80,-80.0,5886080,5886160
1921,1921,7,13.0,12.860137062937053,1,2412,0,5.370629370629028,-90,90,e2:db:d1:d1:b0:4a,5886160,64,-64.0,5886096,5886160
1922,1922,7,13.0,13.440559440559447,1,2412,0,-3.3496503496507675,-90,90,e2:db:d1:d1:b0:4a,5886160,60,-60.0,5886100,5886160
1923,1923,7,13.0,12.135198135198152,1,2412,0,-17.025641025641495,-90,90,e2:db:d1:d1:b0:4a,5886160,80,-80.0,5886080,5886160
1924,1924,7,13.0,11.74358974358975,1,2412,0,-33.34265734265785,-90,90,e2:db:d1:d1:b0:4a,5886160,64,-64.0,5886096,5886160
1925,1925,7,13.0,10.944055944055943,1,2412,-84,-50.827505827506386,-90,6,e2:db:d1:d1:b0:4a,5886160,412,-412.0,5885748,5886160
1931,1931,6,6.0,9.899766899766892,1,2412,-85,-67.31002331002391,-90,5,e2:db:d1:d1:b0:4a,5901678,68,191.0,5901610,5901678
1938,1938,6,6.0,8.773892773892761,1,2412,-84,-80.83216783216845,-90,6,e2:db:d1:d1:b0:4a,5911101,68,628.0,5911033,5911101
1940,1940,7,13.0,7.142191142191146,1,2412,-83,-96.48484848484885,-90,7,e2:db:d1:d1:b0:4a,5912041,104,569.0,5911937,5912041
1943,1943,6,6.0,7.076923076923077,1,2412,-85,-89.48484848484881,-90,5,e2:db:d1:d1:b0:4a,5918238,52,5756.0,5918186,5918238
1950,1950,6,6.0,6.12354312354316,1,2412,-84,-82.4685314685314,-90,6,e2:db:d1:d1:b0:4a,5933971,52,279.0,5933919,5933971
1953,1953,6,6.0,6.994172494172567,1,2412,-84,-75.64801864801848,-90,6,e2:db:d1:d1:b0:4a,5942705,52,588.0,5942653,5942705
1957,1957,6,6.0,8.05244755244763,1,2412,-84,-64.1445221445219,-90,6,e2:db:d1:d1:b0:4a,5960834,68,108.0,5960766,5960834
1958,1958,7,13.0,9.571095571095645,1,2412,0,-49.643356643356356,-90,90,e2:db:d1:d1:b0:4a,5966487,988,4665.0,5965499,5966487
1960,1960,6,6.0,12.720279720279821,1,2412,-83,-27.26107226107213,-90,7,e2:db:d1:d1:b0:4a,5977304,52,4977.0,5977252,5977304
1961,1961,7,19.5,16.40909090909098,1,2412,0,-13.874125874125866,-90,90,e2:db:d1:d1:b0:4a,5977435,668,-537.0,5976767,5977435
1962,1962,7,19.5,18.361305361305412,1,2412,0,-10.98135198135206,-90,90,e2:db:d1:d1:b0:4a,5977435,636,-636.0,5976799,5977435
1963,1963,7,19.5,17.444055944056014,1,2412,0,-25.139860139860115,-90,90,e2:db:d1:d1:b0:4a,5977435,636,-636.0,5976799,5977435
1964,1964,7,19.5,16.206293706293774,1,2412,0,-40.27738927738933,-90,90,e2:db:d1:d1:b0:4a,5977435,52,-52.0,5977383,5977435
1965,1965,7,19.5,15.63636083916092,1,2412,-80,-33.56876456876468,-90,10,e2:db:d1:d1:b0:4a,5977435,640,-640.0,5976795,5977435
2053,2053,6,6.0,15.234266433566441,1,2412,-88,-45.340326340326804,-89,1,e2:db:d1:d1:b0:4a,6243668,576,1580.0,6243092,6243668
2065,2065,6,6.0,15.12782004662003,1,2412,-85,-50.93706293706346,-89,4,e2:db:d1:d1:b0:4a,6275360,68,11715.0,6275292,6275360
2066,2066,7,19.5,14.498839860139835,1,2412,0,-55.66200466200515,-89,89,e2:db:d1:d1:b0:4a,6275754,668,-274.0,6275086,6275754
2067,2067,7,19.5,12.347323076923097,1,2412,0,-64.3333333333335,-89,89,e2:db:d1:d1:b0:4a,6275754,108,-108.0,6275646,6275754
2075,2075,7,21.6667,13.260691375291392,1,2412,-83,-52.29603729603733,-89,6,e2:db:d1:d1:b0:4a,6313158,612,71.0,6312546,6313158
2079,2079,6,6.0,12.915702564102642,1,2412,-83,-59.42890442890436,-89,6,e2:db:d1:d1:b0:4a,6319931,52,220.0,6319879,6319931
2082,2082,6,6.0,13.036141958041986,1,2412,-84,-58.1328671328673,-89,5,e2:db:d1:d1:b0:4a,6321616,68,84.0,6321548,6321616
2083,2083,6,6.0,11.43163729603727,1,2412,-83,-63.648018648019104,-89,6,e2:db:d1:d1:b0:4a,6321761,52,93.0,6321709,6321761
2084,2084,7,21.6667,9.651136829836842,1,2412,0,-59.27972027972064,-89,89,e2:db:d1:d1:b0:4a,6321892,604,-473.0,6321288,6321892
2090,2090,6,6.0,11.149195104895112,1,2412,-84,-50.118881118881255,-89,5,e2:db:d1:d1:b0:4a,6327496,68,80.0,6327428,6327496
2091,2091,7,21.6667,13.376861072261114,1,2412,0,-52.00233100233117,-89,89,e2:db:d1:d1:b0:4a,6327872,604,-228.0,6327268,6327872
2093,2093,6,6.0,13.194265501165527,1,2412,-79,-57.91841491841513,-89,10,e2:db:d1:d1:b0:4a,6333093,52,2365.0,6333041,6333093
2097,2097,6,6.0,11.916096503496508,1,2412,-84,-68.2843822843826,-89,5,e2:db:d1:d1:b0:4a,6335954,52,386.0,6335902,6335954
2098,2098,7,21.6667,9.54235407925405,1,2412,-84,-81.79487179487231,-89,5,e2:db:d1:d1:b0:4a,6336085,612,-481.0,6335473,6336085
2102,2102,6,6.0,8.081589510489552,1,2412,-85,-81.89510489510523,-89,4,e2:db:d1:d1:b0:4a,6337170,52,88.0,6337118,6337170
2146,2146,6,6.0,7.533802797202794,1,2412,-85,-91.4242424242429,-89,4,e2:db:d1:d1:b0:4a,6447396,1360,208.0,6446036,6447396
2147,2147,6,6.0,9.213682051282076,1,2412,-85,-85.2564102564105,-89,4,e2:db:d1:d1:b0:4a,6448852,224,1232.0,6448628,6448852
2169,2169,6,6.0,7.53380279720284,1,2412,-82,-92.41025641025644,-89,7,e2:db:d1:d1:b0:4a,6546309,444,9715.0,6545865,6546309
2247,2247,6,6.0,6.766901398601441,1,2412,-87,-90.9160839160838,-89,2,e2:db:d1:d1:b0:4a,6720916,68,180.0,6720848,6720916
2250,2250,7,21.6667,11.18571421911428,1,2412,-87,-75.1794871794872,-89,2,e2:db:d1:d1:b0:4a,6726683,612,3813.0,6726071,6726683
2252,2252,6,6.0,13.194265501165548,1,2412,-86,-63.33566433566443,-89,3,e2:db:d1:d1:b0:4a,6727913,68,463.0,6727845,6727913
2253,2253,6,6.0,12.79255524475532,1,2412,-86,-55.48951048951062,-89,3,e2:db:d1:d1:b0:4a,6728078,52,113.0,6728026,6728078
2254,2254,7,21.6667,14.253319813519862,1,2412,0,-51.61771561771577,-89,89,e2:db:d1:d1:b0:4a,6728208,604,-474.0,6727604,6728208
2255,2255,7,21.6667,14.253319813519838,1,2412,0,-50.97668997669012,-89,89,e2:db:d1:d1:b0:4a,6728208,572,-572.0,6727636,6728208
2265,2265,6,6.0,12.792555244755233,1,2412,-85,-55.22610722610737,-89,4,e2:db:d1:d1:b0:4a,6751570,68,663.0,6751502,6751570
2266,2266,6,6.0,11.87957738927745,1,2412,-86,-70.42890442890445,-89,3,e2:db:d1:d1:b0:4a,6751726,52,104.0,6751674,6751726
2267,2267,7,21.6667,10.199698135198194,1,2412,-86,-80.5827505827506,-89,3,e2:db:d1:d1:b0:4a,6751856,79,51.0,6751777,6751856
2270,2270,6,6.0,8.702414452214484,1,2412,-86,-87.77622377622394,-89,3,e2:db:d1:d1:b0:4a,6759423,68,93.0,6759355,6759423
2272,2272,6,6.0,10.345774592074651,1,2412,-87,-75.77156177156178,-89,2,e2:db:d1:d1:b0:4a,6759809,52,105.0,6759757,6759809
2278,2278,6,6.0,13.815090442890547,1,2412,-84,-51.785547785547486,-89,5,e2:db:d1:d1:b0:4a,6770699,68,4751.0,6770631,6770699
2279,2279,7,21.6667,15.787122610722706,1,2412,0,-26.715617715617586,-89,89,e2:db:d1:d1:b0:4a,6776115,604,4812.0,6775511,6776115
2280,2280,7,21.6667,18.526056177156217,1,2412,0,-11.587412587412548,-89,89,e2:db:d1:d1:b0:4a,6776115,572,-572.0,6775543,6776115
2281,2281,7,21.6667,22.031891142191206,1,2412,0,-6.613053613053632,-89,89,e2:db:d1:d1:b0:4a,6776115,100,-100.0,6776015,6776115
2283,2283,7,21.6667,22.031891142191185,1,2412,0,-11.85547785547795,-89,89,e2:db:d1:d1:b0:4a,6789856,612,6462.0,6789244,6789856
2284,2284,7,21.6667,19.73818037296039,1,2412,0,-33.86480186480191,-89,89,e2:db:d1:d1:b0:4a,6789856,572,-572.0,6789284,6789856
2285,2285,7,21.6667,15.38152764568761,1,2412,-85,-49.50582750582793,-89,4,e2:db:d1:d1:b0:4a,6789856,572,-572.0,6789284,6789856
2286,2286,6,6.0,12.35924629370625,1,2412,-86,-58.778554778555296,-89,3,e2:db:d1:d1:b0:4a,6795207,52,5299.0,6795155,6795207
2298,2298,6,6.0,8.147892447552435,1,2412,-85,-67.34032634032691,-89,4,e2:db:d1:d1:b0:4a,6853513,444,4854.0,6853069,6853513
2380,2380,6,6.0,7.385393613053581,1,2412,-82,-73.33100233100288,-89,7,e2:db:d1:d1:b0:4a,7155320,52,3979.0,7155268,7155320
2381,2381,7,7.22222,7.113701538461501,1,2412,0,-74.26107226107268,-89,89,e2:db:d1:d1:b0:4a,7159643,1752,2571.0,7157891,7159643
2382,2382,7,7.22222,7.698007365967346,1,2412,-84,-68.50582750582768,-89,5,e2:db:d1:d1:b0:4a,7159643,1720,-1720.0,7157923,7159643
2385,2385,6,6.0,9.503502237762262,1,2412,-87,-71.71328671328692,-89,2,e2:db:d1:d1:b0:4a,7163696,52,152.0,7163644,7163696
2386,2386,7,21.6667,9.572137902097925,1,2412,-87,-76.81818181818208,-89,2,e2:db:d1:d1:b0:4a,7163826,79,51.0,7163747,7163826
2388,2388,6,6.0,9.218602470862491,1,2412,-85,-83.9487179487183,-89,4,e2:db:d1:d1:b0:4a,7165672,444,1236.0,7165228,7165672
2393,2393,6,6.0,8.442895944055957,1,2412,-86,-92.44522144522193,-89,3,e2:db:d1:d1:b0:4a,7167679,68,72.0,7167611,7167679
2395,2395,6,6.0,7.401713193473202,1,2412,-84,-92.56177156177156,-89,5,e2:db:d1:d1:b0:4a,7168012,52,79.0,7167960,7168012
2406,2406,6,6.0,6.251749090909089,1,2412,-84,-90.54312354312341,-89,5,e2:db:d1:d1:b0:4a,7175952,52,418.0,7175900,7175952
2408,2408,6,6.0,4.7337448484848235,1,2412,-86,-74.71794871794873,-89,3,e2:db:d1:d1:b0:4a,7180380,52,3411.0,7180328,7180380
2411,2411,6,6.0,6.347577715617734,1,2412,-86,-62.93240093240103,-89,3,e2:db:d1:d1:b0:4a,7185771,68,396.0,7185703,7185771
2412,2412,6,6.0,6.561252540792559,1,2412,-87,-55.414918414918546,-89,2,e2:db:d1:d1:b0:4a,7185983,52,160.0,7185931,7185983
2413,2413,7,7.22222,6.689457435897453,1,2412,0,-51.74125874125889,-89,89,e2:db:d1:d1:b0:4a,7191909,1752,4174.0,7190157,7191909
2414,2414,7,7.22222,6.732192400932417,1,2412,0,-51.80419580419595,-89,89,e2:db:d1:d1:b0:4a,7191909,1720,-1720.0,7190189,7191909
2415,2415,7,7.22222,6.689457435897452,1,2412,-86,-55.953379953380114,-89,3,e2:db:d1:d1:b0:4a,7191909,1720,-1720.0,7190189,7191909
2418,2418,6,6.0,6.561252540792556,1,2412,-88,-63.72494172494196,-89,1,e2:db:d1:d1:b0:4a,7196310,68,88.0,7196242,7196310
2419,2419,6,6.0,6.347577715617729,1,2412,-85,-75.648018648019,-89,4,e2:db:d1:d1:b0:4a,7196536,52,174.0,7196484,7196536
2421,2421,6,6.0,5.461020372960401,1,2412,-87,-98.93939393939434,-89,2,e2:db:d1:d1:b0:4a,7198153,52,159.0,7198101,7198153
2422,2422,6,6.0,5.482517622377662,1,2412,-87,-98.84615384615398,-89,2,e2:db:d1:d1:b0:4a,7200567,52,2362.0,7200515,7200567
2424,2424,6,6.0,6.174825361305409,1,2412,-84,-75.45221445221446,-89,5,e2:db:d1:d1:b0:4a,7202071,52,937.0,7202019,7202071
2426,2426,6,6.0,7.990675990676028,1,2412,-87,-63.237762237762325,-89,2,e2:db:d1:d1:b0:4a,7203887,52,377.0,7203835,7203887
2429,2429,6,6.0,9.214452214452244,1,2412,-86,-55.82983682983694,-89,3,e2:db:d1:d1:b0:4a,7207990,52,133.0,7207938,7207990
2430,2430,7,13.0,9.948717948717976,1,2412,0,-51.191142191142305,-89,89,e2:db:d1:d1:b0:4a,7208119,988,-859.0,7207131,7208119
2431,2431,7,13.0,8.515151515151592,1,2412,0,-50.67832167832181,-89,89,e2:db:d1:d1:b0:4a,7208119,956,-956.0,7207163,7208119
2432,2432,7,13.0,10.368298368298422,1,2412,-86,-54.37995337995355,-89,3,e2:db:d1:d1:b0:4a,7208119,956,-956.0,7207163,7208119
2433,2433,6,6.0,11.265734265734302,1,2412,-86,-62.372960372960605,-89,3,e2:db:d1:d1:b0:4a,7213461,52,5290.0,7213409,7213461
2439,2439,6,6.0,11.207459207459225,1,2412,-81,-74.50582750582788,-89,8,e2:db:d1:d1:b0:4a,7263116,444,15226.0,7262672,7263116
2509,2509,6,6.0,10.193473193473185,1,2412,-85,-90.65501165501226,-89,4,e2:db:d1:d1:b0:4a,7467918,444,82.0,7467474,7467918
2539,2539,7,26.0,9.708624708624704,1,2412,-87,-92.91142191142241,-89,2,e2:db:d1:d1:b0:4a,7558299,68,596.0,7558231,7558299
2540,2540,6,6.0,9.328671328671334,1,2412,-89,-86.33566433566456,-89,0,e2:db:d1:d1:b0:4a,7558536,52,185.0,7558484,7558536
2547,2547,6,6.0,9.216783216783236,1,2412,-85,-86.95337995338019,-89,4,e2:db:d1:d1:b0:4a,7570806,68,1245.0,7570738,7570806
2549,2549,6,6.0,8.05128205128206,1,2412,-87,-87.5477855477858,-89,2,e2:db:d1:d1:b0:4a,7572087,68,748.0,7572019,7572087
2558,2558,6,6.0,6.419580419580408,1,2412,-88,-86.9743589743592,-89,1,e2:db:d1:d1:b0:4a,7595377,68,4389.0,7595309,7595377
2559,2559,6,6.0,4.321678321678278,1,2412,-87,-86.5734265734268,-89,2,e2:db:d1:d1:b0:4a,7595622,52,193.0,7595570,7595622
2562,2562,6,6.0,6.000000000000015,1,2412,-86,-86.47086247086268,-89,3,e2:db:d1:d1:b0:4a,7600844,52,965.0,7600792,7600844
2564,2564,6,6.0,6.000000000000015,1,2412,-86,-86.65034965034988,-89,3,e2:db:d1:d1:b0:4a,7602427,52,441.0,7602375,7602427
2568,2568,6,6.0,4.079253146853221,1,2412,-86,-86.43822843822866,-89,3,e2:db:d1:d1:b0:4a,7605694,52,2075.0,7605642,7605694
2569,2569,6,6.0,6.480186713286764,1,2412,-87,-86.35897435897459,-89,2,e2:db:d1:d1:b0:4a,7606093,52,347.0,7606041,7606093
2573,2573,6,6.0,8.347579487179523,1,2412,-87,-86.39627039627064,-89,2,e2:db:d1:d1:b0:4a,7609842,52,1406.0,7609790,7609842
2577,2577,6,6.0,9.681431468531498,1,2412,-86,-86.40559440559464,-89,3,e2:db:d1:d1:b0:4a,7626444,52,10893.0,7626392,7626444
2580,2580,6,6.0,10.481742657342684,1,2412,-87,-86.53146853146876,-89,2,e2:db:d1:d1:b0:4a,7628097,52,70.0,7628045,7628097
2581,2581,7,28.8889,10.748513053613081,1,2412,-86,-86.45454545454568,-89,3,e2:db:d1:d1:b0:4a,7628228,72,59.0,7628156,7628228
2630,2630,6,6.0,10.481742657342684,1,2412,-86,-86.61305361305385,-89,3,e2:db:d1:d1:b0:4a,7775108,444,7016.0,7774664,7775108
2680,2680,6,6.0,9.681431468531489,1,2412,-87,-86.9603729603732,-89,2,e2:db:d1:d1:b0:4a,7979899,444,10359.0,7979455,7979899
2683,2683,6,6.0,8.347579487179495,1,2412,-88,-87.55710955710978,-89,1,e2:db:d1:d1:b0:4a,7982888,52,124.0,7982836,7982888
2695,2695,6,6.0,6.480186713286697,1,2412,-87,-87.79020979021001,-89,2,e2:db:d1:d1:b0:4a,8001158,52,97.0,8001106,8001158
2700,2700,6,6.0,4.079253146853095,1,2412,-89,-87.87179487179512,-89,0,e2:db:d1:d1:b0:4a,8012098,52,5493.0,8012046,8012098
2701,2701,6,6.0,6.000000000000015,1,2412,-88,-87.80186480186504,-89,1,e2:db:d1:d1:b0:4a,8015848,52,3698.0,8015796,8015848
2704,2704,6,6.0,6.000000000000015,1,2412,-88,-87.45221445221466,-89,1,e2:db:d1:d1:b0:4a,8028184,52,2073.0,8028132,8028184
2705,2705,6,6.0,6.000000000000015,1,2412,-86,-87.03496503496527,-89,3,e2:db:d1:d1:b0:4a,8029690,52,1454.0,8029638,8029690
2706,2706,6,6.0,6.000000000000015,1,2412,-86,-86.70163170163192,-89,3,e2:db:d1:d1:b0:4a,8032403,52,2661.0,8032351,8032403
2709,2709,6,6.0,6.000000000000015,1,2412,-87,-86.11888111888135,-89,2,e2:db:d1:d1:b0:4a,8036620,52,-10.0,8036568,8036620
2710,2710,6,6.0,6.000000000000015,1,2412,-86,-86.17482517482539,-89,3,e2:db:d1:d1:b0:4a,8037644,52,972.0,8037592,8037644
2713,2713,6,6.0,6.000000000000015,1,2412,-86,-86.15850815850838,-89,3,e2:db:d1:d1:b0:4a,8038869,68,68.0,8038801,8038869
2728,2728,6,6.0,6.000000000000015,1,2412,-86,-86.39160839160861,-89,3,e2:db:d1:d1:b0:4a,8082315,444,9857.0,8081871,8082315
2760,2760,6,6.0,6.000000000000015,1,2412,-86,-86.14219114219135,-89,3,e2:db:d1:d1:b0:4a,8186930,632,1986.0,8186298,8186930
2761,2761,6,6.0,6.000000000000015,1,2412,-87,-85.48018648018669,-89,2,e2:db:d1:d1:b0:4a,8187595,656,9.0,8186939,8187595
2793,2793,6,6.0,6.000000000000015,1,2412,-85,-85.31701631701654,-89,4,e2:db:d1:d1:b0:4a,8289727,224,1012.0,8289503,8289727
2794,2794,6,6.0,6.000000000000015,1,2412,-85,-84.75291375291397,-89,4,e2:db:d1:d1:b0:4a,8289984,248,9.0,8289736,8289984
2814,2814,6,6.0,6.000000000000015,1,2412,-83,-84.15384615384635,-89,6,e2:db:d1:d1:b0:4a,8331436,52,3893.0,8331384,8331436
2817,2817,6,6.0,6.000000000000015,1,2412,-83,-83.58974358974379,-89,6,e2:db:d1:d1:b0:4a,8336681,68,240.0,8336613,8336681
2819,2819,6,6.0,6.000000000000015,1,2412,-85,-83.04662004662023,-89,4,e2:db:d1:d1:b0:4a,8337361,68,256.0,8337293,8337361
2828,2828,6,6.0,6.000000000000015,1,2412,-82,-83.07925407925428,-89,7,e2:db:d1:d1:b0:4a,8359074,52,2830.0,8359022,8359074
2833,2833,6,6.0,6.000000000000015,1,2412,-83,-83.06060606060626,-89,6,e2:db:d1:d1:b0:4a,8362197,68,421.0,8362129,8362197
2836,2836,6,6.0,6.000000000000015,1,2412,-83,-82.95337995338016,-89,6,e2:db:d1:d1:b0:4a,8370053,52,524.0,8370001,8370053
2842,2842,6,6.0,6.000000000000015,1,2412,-83,-82.77855477855499,-89,6,e2:db:d1:d1:b0:4a,8377583,68,671.0,8377515,8377583
2850,2850,6,6.0,4.489510489510551,1,2412,-84,-83.17948717948742,-89,5,e2:db:d1:d1:b0:4a,8391330,632,5087.0,8390698,8391330
2851,2851,6,6.0,6.37762237762242,1,2412,-83,-84.2540792540795,-89,6,e2:db:d1:d1:b0:4a,8391995,656,9.0,8391339,8391995
2862,2862,6,6.0,7.846153846153878,1,2412,-83,-84.79720279720303,-89,6,e2:db:d1:d1:b0:4a,8403320,52,150.0,8403268,8403320
2952,2952,6,6.0,8.895104895104922,1,2412,-86,-85.14219114219138,-89,3,e2:db:d1:d1:b0:4a,8751321,68,320.0,8751253,8751321
2953,2953,6,6.0,9.52447552447555,1,2412,-88,-85.20279720279743,-89,1,e2:db:d1:d1:b0:4a,8751467,52,94.0,8751415,8751467
2967,2967,6,24.0,9.73426573426576,1,2412,-86,-85.47785547785571,-89,3,e2:db:d1:d1:b0:4a,8786103,28,123.0,8786075,8786103
2976,2976,6,6.0,9.524475524475548,1,2412,-84,-85.79254079254103,-89,5,e2:db:d1:d1:b0:4a,8800971,548,-107.0,8800423,8800971
2977,2977,6,6.0,8.895104895104915,1,2412,-84,-85.63869463869486,-89,5,e2:db:d1:d1:b0:4a,8801552,576,5.0,8800976,8801552
3029,3029,6,6.0,6.335664335664391,1,2412,-85,-85.07692307692328,-89,4,e2:db:d1:d1:b0:4a,9003910,444,-368.0,9003466,9003910
3031,3031,6,6.0,6.755244755244774,1,2412,-87,-84.63636363636384,-89,2,e2:db:d1:d1:b0:4a,9006308,576,1336.0,9005732,9006308
3047,3047,6,6.0,6.3356643356643145,1,2412,-85,-84.8927738927741,-90,5,e2:db:d1:d1:b0:4a,9082834,52,4329.0,9082782,9082834
3049,3049,6,6.0,7.384615384615458,1,2412,-84,-84.77855477855499,-90,6,e2:db:d1:d1:b0:4a,9083539,68,377.0,9083471,9083539
3050,3050,6,6.0,8.391608391608491,1,2412,-84,-84.4848484848487,-90,6,e2:db:d1:d1:b0:4a,9084024,68,417.0,9083956,9084024
3051,3051,6,24.0,11.958041958042028,1,2412,-84,-84.24009324009346,-90,6,e2:db:d1:d1:b0:4a,9085195,28,1143.0,9085167,9085195
3060,3060,6,6.0,14.265734265734316,1,2412,-85,-83.96037296037318,-90,5,e2:db:d1:d1:b0:4a,9106335,444,4881.0,9105891,9106335
3087,3087,6,6.0,13.80419580419589,1,2412,-83,-84.19813519813542,-90,7,e2:db:d1:d1:b0:4a,9196628,68,508.0,9196560,9196628
3095,3095,6,24.0,13.972027972028073,1,2412,-85,-84.49184149184173,-90,5,e2:db:d1:d1:b0:4a,9210906,28,523.0,9210878,9210906
3099,3099,6,24.0,14.34965034965045,1,2412,-85,-84.52447552447575,-90,5,e2:db:d1:d1:b0:4a,9212025,28,329.0,9211997,9212025
3102,3102,6,6.0,14.517482517482593,1,2412,-84,-84.65268065268086,-90,6,e2:db:d1:d1:b0:4a,9217876,68,252.0,9217808,9217876
3106,3106,6,6.0,17.874125874125998,1,2412,-85,-84.6643356643359,-90,5,e2:db:d1:d1:b0:4a,9219083,68,159.0,9219015,9219083
3109,3109,6,24.0,19.090909090909193,1,2412,-85,-84.60372960372983,-90,5,e2:db:d1:d1:b0:4a,9227861,28,436.0,9227833,9227861
3113,3113,6,24.0,19.258741258741324,1,2412,-84,-84.44755244755265,-90,6,e2:db:d1:d1:b0:4a,9228724,28,132.0,9228696,9228724
3116,3116,6,24.0,23.286713286713333,1,2412,-85,-84.44522144522168,-90,5,e2:db:d1:d1:b0:4a,9233881,28,3520.0,9233853,9233881
3117,3117,6,24.0,26.26573426573433,1,2412,-84,-84.61771561771585,-90,6,e2:db:d1:d1:b0:4a,9235108,28,1199.0,9235080,9235108
3122,3122,6,24.0,24.20979020979025,1,2412,-84,-91.94638694638695,-90,6,e2:db:d1:d1:b0:4a,9240013,28,177.0,9239985,9240013
3123,3123,6,24.0,19.95104895104894,1,2412,-86,-90.44289044289033,-90,4,e2:db:d1:d1:b0:4a,9240310,28,269.0,9240282,9240310
3126,3126,6,24.0,17.14452214452213,1,2412,-85,-82.00466200466181,-90,5,e2:db:d1:d1:b0:4a,9243616,28,1564.0,9243588,9243616
3128,3128,6,6.0,15.123543123543088,1,2412,-86,-61.351981351981316,-90,4,e2:db:d1:d1:b0:4a,9245205,68,223.0,9245137,9245205
3129,3129,6,6.0,11.312354312354307,1,2412,-86,-46.431235431235486,-90,4,e2:db:d1:d1:b0:4a,9245414,52,157.0,9245362,9245414
3131,3131,7,13.0,9.529137529137545,1,2412,0,-37.515151515151594,-90,90,e2:db:d1:d1:b0:4a,9247232,120,1328.0,9247112,9247232
3132,3132,7,13.0,11.284382284382277,1,2412,0,-34.09557109557119,-90,90,e2:db:d1:d1:b0:4a,9247232,92,-92.0,9247140,9247232
3133,3133,7,13.0,13.179487179487177,1,2412,0,-36.97435897435909,-90,90,e2:db:d1:d1:b0:4a,9247232,88,-88.0,9247144,9247232
3135,3135,6,6.0,15.634032634032671,1,2412,-84,-45.687645687645876,-90,6,e2:db:d1:d1:b0:4a,9248603,68,208.0,9248535,9248603
3139,3139,6,24.0,15.249417249417274,1,2412,-86,-60.61305361305398,-90,4,e2:db:d1:d1:b0:4a,9250699,28,942.0,9250671,9250699
3142,3142,6,24.0,13.536130536130537,1,2412,-84,-81.91608391608455,-90,6,e2:db:d1:d1:b0:4a,9252803,28,96.0,9252775,9252803
3160,3160,6,6.0,10.468531468531513,1,2412,-86,-91.11888111888172,-90,4,e2:db:d1:d1:b0:4a,9348355,68,422.0,9348287,9348355
3181,3181,6,6.0,9.020979020979086,1,2412,-86,-93.49417249417297,-90,4,e2:db:d1:d1:b0:4a,9413540,444,7336.0,9413096,9413540
3184,3184,6,6.0,10.447552447552475,1,2412,-87,-86.90909090909113,-90,3,e2:db:d1:d1:b0:4a,9415349,224,667.0,9415125,9415349
3186,3186,6,6.0,9.608391608391573,1,2412,-88,-86.98834498834522,-90,2,e2:db:d1:d1:b0:4a,9416696,656,379.0,9416040,9416696
3212,3212,6,6.0,9.398601398601427,1,2412,-87,-87.1678321678324,-90,3,e2:db:d1:d1:b0:4a,9519120,1360,6733.0,9517760,9519120
3226,3226,6,24.0,13.636363636363697,1,2412,-87,-86.60606060606082,-90,3,e2:db:d1:d1:b0:4a,9573122,28,459.0,9573094,9573122
3237,3237,6,24.0,13.594405594405691,1,2412,-86,-86.16783216783239,-90,4,e2:db:d1:d1:b0:4a,9605515,28,2099.0,9605487,9605515
3250,3250,6,6.0,14.181818181818295,1,2412,-85,-85.43589743589764,-90,5,e2:db:d1:d1:b0:4a,9622844,68,3020.0,9622776,9622844
3257,3257,6,6.0,16.489510489510554,1,2412,-85,-84.94172494172514,-90,5,e2:db:d1:d1:b0:4a,9630670,68,1505.0,9630602,9630670
3260,3260,6,24.0,16.699300699300718,1,2412,-84,-84.67132867132888,-90,6,e2:db:d1:d1:b0:4a,9650034,28,12659.0,9650006,9650034
3263,3263,6,6.0,13.300699300699312,1,2412,-85,-84.33799533799554,-90,5,e2:db:d1:d1:b0:4a,9654574,68,420.0,9654506,9654574
3264,3264,6,24.0,15.020979020979034,1,2412,-84,-84.45221445221466,-90,6,e2:db:d1:d1:b0:4a,9656762,28,2160.0,9656734,9656762
3266,3266,6,24.0,15.440559440559532,1,2412,-85,-84.38694638694659,-90,5,e2:db:d1:d1:b0:4a,9657364,28,151.0,9657336,9657364
3268,3268,6,6.0,16.069930069930113,1,2412,-84,-84.27272727272747,-90,6,e2:db:d1:d1:b0:4a,9658479,68,63.0,9658411,9658479
3272,3272,6,6.0,14.601398601398587,1,2412,-84,-84.13286713286736,-90,6,e2:db:d1:d1:b0:4a,9668279,68,628.0,9668211,9668279
3275,3275,6,24.0,14.853146853146857,1,2412,-85,-83.88344988345011,-90,5,e2:db:d1:d1:b0:4a,9671010,28,31.0,9670982,9671010
3291,3291,6,6.0,11.91608391608387,1,2412,-83,-83.9860139860142,-90,7,e2:db:d1:d1:b0:4a,9699230,68,292.0,9699162,9699230
3292,3292,6,24.0,11.118881118881095,1,2412,-84,-83.86946386946411,-90,6,e2:db:d1:d1:b0:4a,9699369,28,111.0,9699341,9699369
3294,3294,6,6.0,11.37062937062939,1,2412,-84,-84.3496503496506,-90,6,e2:db:d1:d1:b0:4a,9700266,68,96.0,9700198,9700266
3319,3319,6,6.0,7.7622377622378025,1,2412,-85,-85.37296037296062,-90,5,e2:db:d1:d1:b0:4a,9755700,68,191.0,9755632,9755700
3342,3342,6,6.0,6.7132867132866965,1,2412,-86,-86.0675990675993,-90,4,e2:db:d1:d1:b0:4a,9859486,68,-23.0,9859418,9859486
3344,3344,6,6.0,8.223776223776232,1,2412,-86,-86.89510489510513,-90,4,e2:db:d1:d1:b0:4a,9871499,68,7482.0,9871431,9871499
3345,3345,6,6.0,5.874125874125893,1,2412,-89,-87.05128205128229,-90,1,e2:db:d1:d1:b0:4a,9872009,68,442.0,9871941,9872009
3355,3355,6,6.0,8.391608391608491,1,2412,-89,-87.14219114219136,-90,1,e2:db:d1:d1:b0:4a,9925527,444,14555.0,9925083,9925527
3427,3427,6,24.0,11.958041958042028,1,2412,-85,-86.76456876456899,-89,4,e2:db:d1:d1:b0:4a,10108689,28,5792.0,10108661,10108689
3429,3429,6,6.0,14.265734265734316,1,2412,-86,-86.29603729603753,-89,3,e2:db:d1:d1:b0:4a,10110203,68,196.0,10110135,10110203
3433,3433,6,6.0,15.314685314685354,1,2412,-85,-85.50582750582774,-89,4,e2:db:d1:d1:b0:4a,10119372,68,3129.0,10119304,10119372
3450,3450,6,24.0,15.104895104895132,1,2412,-86,-85.14918414918436,-89,3,e2:db:d1:d1:b0:4a,10159828,28,214.0,10159800,10159828
3452,3452,6,24.0,13.636363636363646,1,2412,-85,-85.74825174825197,-89,4,e2:db:d1:d1:b0:4a,10162021,28,1863.0,10161993,10162021
3456,3456,6,6.0,10.909090909090885,1,2412,-86,-86.6736596736599,-89,3,e2:db:d1:d1:b0:4a,10163092,68,132.0,10163024,10163092
3460,3460,6,6.0,10.741258741258754,1,2412,-86,-86.8717948717951,-89,3,e2:db:d1:d1:b0:4a,10165541,68,902.0,10165473,10165541
3502,3502,6,6.0,8.223776223776207,1,2412,-90,-87.49417249417273,-89,-1,e2:db:d1:d1:b0:4a,10312815,68,425.0,10312747,10312815
3511,3511,6,6.0,4.8671328671328045,1,2412,-89,-88.13053613053637,-89,0,e2:db:d1:d1:b0:4a,10323860,68,65.0,10323792,10323860
3581,3581,6,6.0,4.489510489510452,1,2412,-87,-88.77389277389301,-89,2,e2:db:d1:d1:b0:4a,10539945,444,1001.0,10539501,10539945
3583,3583,6,6.0,6.000000000000015,1,2412,-87,-88.39160839160863,-89,2,e2:db:d1:d1:b0:4a,10542069,1332,324.0,10540737,10542069
3584,3584,6,6.0,6.000000000000015,1,2412,-90,-88.20279720279744,-89,-1,e2:db:d1:d1:b0:4a,10543757,1360,328.0,10542397,10543757
3637,3637,6,6.0,6.000000000000015,1,2412,-89,-87.50815850815873,-89,0,e2:db:d1:d1:b0:4a,10747948,392,3196.0,10747556,10747948
3638,3638,6,6.0,6.000000000000015,1,2412,-87,-87.67832167832191,-89,2,e2:db:d1:d1:b0:4a,10748373,380,45.0,10747993,10748373
3654,3654,6,6.0,6.000000000000015,1,2412,-85,-87.89510489510512,-89,4,e2:db:d1:d1:b0:4a,10790058,68,4475.0,10789990,10790058
3656,3656,6,6.0,4.489510489510551,1,2412,-89,-87.75990675990698,-89,0,e2:db:d1:d1:b0:4a,10791784,68,208.0,10791716,10791784
3680,3680,6,6.0,4.867132867132956,1,2412,-87,-87.10722610722632,-89,2,e2:db:d1:d1:b0:4a,10848091,68,188.0,10848023,10848091
3695,3695,6,6.0,8.223776223776284,1,2412,-89,-86.91375291375314,-89,0,e2:db:d1:d1:b0:4a,10888365,68,788.0,10888297,10888365
3733,3733,6,6.0,10.741258741258784,1,2412,-87,-86.97435897435922,-86,-1,e2:db:d1:d1:b0:4a,11028672,68,4495.0,11028604,11028672
3740,3740,6,6.0,12.419580419580456,1,2412,-86,-86.88811188811212,-86,0,e2:db:d1:d1:b0:4a,11051939,444,-269.0,11051495,11051939
3761,3761,6,24.0,11.748251748251828,1,2412,-85,-86.73193473193496,-86,1,e2:db:d1:d1:b0:4a,11099864,28,5835.0,11099836,11099864
3774,3774,6,24.0,13.636363636363699,1,2412,-87,-87.13519813519835,-86,-1,e2:db:d1:d1:b0:4a,11132839,28,646.0,11132811,11132839
3783,3783,6,6.0,14.265734265734311,1,2412,-88,-87.11188811188833,-86,-2,e2:db:d1:d1:b0:4a,11154334,444,10379.0,11153890,11154334
3785,3785,6,6.0,13.63636363636366,1,2412,-88,-87.38228438228461,-86,-2,e2:db:d1:d1:b0:4a,11156340,308,780.0,11156032,11156340
3810,3810,6,6.0,11.748251748251741,1,2412,-89,-87.50582750582775,-86,-3,e2:db:d1:d1:b0:4a,11261148,156,10450.0,11260992,11261148
3822,3822,6,24.0,8.601398601398548,1,2412,-87,-87.77156177156202,-86,-1,e2:db:d1:d1:b0:4a,11276301,28,857.0,11276273,11276301
3825,3825,6,6.0,8.013986013985985,1,2412,-86,-87.35198135198158,-86,0,e2:db:d1:d1:b0:4a,11285151,68,192.0,11285083,11285151
3831,3831,6,6.0,8.895104895104915,1,2412,-87,-87.35897435897459,-86,-1,e2:db:d1:d1:b0:4a,11293063,68,3460.0,11292995,11293063
3860,3860,6,6.0,7.846153846153855,1,2412,-88,-87.57808857808881,-86,-2,e2:db:d1:d1:b0:4a,11395110,68,1328.0,11395042,11395110
3891,3891,6,6.0,6.377622377622369,1,2412,-89,-87.90209790209815,-86,-3,e2:db:d1:d1:b0:4a,11501415,68,4216.0,11501347,11501415
3900,3900,6,6.0,4.489510489510452,1,2412,-87,-88.51981351981377,-86,-1,e2:db:d1:d1:b0:4a,11556189,68,3009.0,11556121,11556189
3903,3903,6,6.0,6.000000000000015,1,2412,-90,-89.17482517482541,-86,-4,e2:db:d1:d1:b0:4a,11563950,444,2259.0,11563506,11563950
3940,3940,6,6.0,6.000000000000015,1,2412,-89,-89.29370629370652,-86,-3,e2:db:d1:d1:b0:4a,11666341,444,10384.0,11665897,11666341
3975,3975,6,6.0,6.000000000000015,1,2412,-89,-88.64801864801888,-86,-3,e2:db:d1:d1:b0:4a,11768741,444,2828.0,11768297,11768741
3980,3980,6,6.0,6.000000000000015,1,2412,-89,-88.08391608391632,-86,-3,e2:db:d1:d1:b0:4a,11770899,548,-318.0,11770351,11770899
3981,3981,6,6.0,6.000000000000015,1,2412,-89,-88.39860139860161,-86,-3,e2:db:d1:d1:b0:4a,11771633,576,158.0,11771057,11771633
4024,4024,6,6.0,6.000000000000015,1,2412,-86,-87.92773892773913,-86,0,e2:db:d1:d1:b0:4a,11975529,548,-107.0,11974981,11975529
4025,4025,6,6.0,4.489510489510551,1,2412,-85,-87.46153846153867,-86,1,e2:db:d1:d1:b0:4a,11976110,576,5.0,11975534,11976110
4053,4053,6,6.0,6.37762237762242,1,2412,-89,-86.61305361305384,-87,-2,e2:db:d1:d1:b0:4a,12129572,68,13188.0,12129504,12129572
4118,4118,6,6.0,6.335664335664414,1,2412,-90,-86.04195804195827,-87,-3,e2:db:d1:d1:b0:4a,12403448,68,5461.0,12403380,12403448
4163,4163,6,6.0,9.272727272727327,1,2412,-84,-86.12820512820535,-87,3,e2:db:d1:d1:b0:4a,12591514,68,3005.0,12591446,12591514
4175,4175,6,6.0,11.370629370629413,1,2412,-84,-86.74592074592096,-87,3,e2:db:d1:d1:b0:4a,12617445,68,1159.0,12617377,12617445
4177,4177,6,24.0,12.629370629370666,1,2412,-85,-86.65501165501188,-87,2,e2:db:d1:d1:b0:4a,12620572,28,105.0,12620544,12620572
4220,4220,6,6.0,13.048951048951082,1,2412,-88,-85.71095571095591,-87,-1,e2:db:d1:d1:b0:4a,12792753,444,308.0,12792309,12792753
4276,4276,6,24.0,12.62937062937066,1,2412,-89,-86.20979020979044,-87,-2,e2:db:d1:d1:b0:4a,12978687,28,10506.0,12978659,12978687
4370,4370,6,6.0,9.860139860139924,1,2412,-87,-86.97668997669021,-88,1,e2:db:d1:d1:b0:4a,13305006,444,921.0,13304562,13305006
4381,4381,6,6.0,9.650349650349673,1,2412,-84,-86.79254079254105,-88,4,e2:db:d1:d1:b0:4a,13325402,52,5657.0,13325350,13325402
4399,4399,6,6.0,8.181818181818155,1,2412,-85,-86.5757575757578,-88,3,e2:db:d1:d1:b0:4a,13407180,444,10410.0,13406736,13407180
4475,4475,6,6.0,9.272727272727275,1,2412,-90,-86.0885780885783,-88,-2,e2:db:d1:d1:b0:4a,13612011,444,4929.0,13611567,13612011
4598,4598,6,6.0,8.013986013985987,1,2412,-85,-86.13053613053637,-88,3,e2:db:d1:d1:b0:4a,14021567,444,12220.0,14021123,14021567
4613,4613,6,24.0,9.73426573426576,1,2412,-86,-86.74358974359,-88,2,e2:db:d1:d1:b0:4a,14052437,28,1817.0,14052409,14052437
4637,4637,6,6.0,9.524475524475548,1,2412,-88,-87.83682983683008,-88,0,e2:db:d1:d1:b0:4a,14123992,444,2032.0,14123548,14123992
4757,4757,6,6.0,8.895104895104915,1,2412,-87,-88.28205128205151,-88,1,e2:db:d1:d1:b0:4a,14635985,444,4461.0,14635541,14635985
4839,4839,6,6.0,7.846153846153855,1,2412,-89,-88.28205128205153,-88,-1,e2:db:d1:d1:b0:4a,14945164,548,9648.0,14944616,14945164
4936,4936,6,6.0,6.377622377622369,1,2412,-90,-89.37296037296062,-88,-2,e2:db:d1:d1:b0:4a,15250390,444,506.0,15249946,15250390
4962,4962,6,6.0,4.489510489510452,1,2412,-91,-89.6759906759909,-88,-3,e2:db:d1:d1:b0:4a,15352793,444,331.0,15352349,15352793
4999,4999,6,6.0,6.000000000000015,1,2412,-88,-89.31468531468555,-88,0,e2:db:d1:d1:b0:4a,15457146,224,649.0,15456922,15457146
5000,5000,6,6.0,6.000000000000015,1,2412,-88,-88.75757575757598,-88,0,e2:db:d1:d1:b0:4a,15457403,248,9.0,15457155,15457403
5030,5030,6,6.0,6.000000000000015,1,2412,-90,-87.94405594405616,-88,-2,e2:db:d1:d1:b0:4a,15557584,444,5029.0,15557140,15557584
5080,5080,6,6.0,6.000000000000015,1,2412,-87,-86.77389277389298,-88,1,e2:db:d1:d1:b0:4a,15759049,52,1148.0,15758997,15759049
5081,5081,6,6.0,6.000000000000015,1,2412,-85,-86.72494172494194,-88,3,e2:db:d1:d1:b0:4a,15759530,52,429.0,15759478,15759530
5087,5087,6,6.0,4.489510489510551,1,2412,-86,-86.8741258741261,-88,2,e2:db:d1:d1:b0:4a,15765449,392,282.0,15765057,15765449
5137,5137,6,6.0,4.867132867132956,1,2412,-87,-86.89044289044311,-88,1,e2:db:d1:d1:b0:4a,15967191,444,12223.0,15966747,15967191
5148,5148,6,6.0,8.223776223776284,1,2412,-86,-86.52447552447575,-88,2,e2:db:d1:d1:b0:4a,15992412,68,3880.0,15992344,15992412
5166,5166,6,6.0,10.741258741258784,1,2412,-91,-87.08624708624733,-88,-3,e2:db:d1:d1:b0:4a,16069610,444,10421.0,16069166,16069610
5203,5203,6,6.0,12.419580419580456,1,2412,-86,-87.49883449883475,-88,2,e2:db:d1:d1:b0:4a,16171991,444,7786.0,16171547,16171991
5214,5214,6,24.0,13.258741258741292,1,2412,-87,-87.98368298368322,-88,1,e2:db:d1:d1:b0:4a,16192402,28,78.0,16192374,16192402
5216,5216,6,24.0,13.258741258741294,1,2412,-86,-88.0699300699303,-88,2,e2:db:d1:d1:b0:4a,16192970,28,159.0,16192942,16192970
5259,5259,6,6.0,12.419580419580448,1,2412,-90,-88.32400932400955,-88,-2,e2:db:d1:d1:b0:4a,16331365,68,521.0,16331297,16331365
5371,5371,6,6.0,10.741258741258754,1,2412,-89,-88.29836829836852,-88,-1,e2:db:d1:d1:b0:4a,16786423,444,5405.0,16785979,16786423
5396,5396,6,6.0,8.223776223776207,1,2412,-90,-88.73426573426597,-88,-2,e2:db:d1:d1:b0:4a,16884788,68,458.0,16884720,16884788
5399,5399,6,6.0,4.8671328671328045,1,2412,-87,-88.79020979021003,-88,1,e2:db:d1:d1:b0:4a,16888812,444,-217.0,16888368,16888812
5416,5416,6,6.0,4.489510489510452,1,2412,-89,-88.65034965034988,-88,-1,e2:db:d1:d1:b0:4a,16928524,68,365.0,16928456,16928524
5436,5436,6,6.0,6.000000000000015,1,2412,-88,-88.01864801864824,-88,0,e2:db:d1:d1:b0:4a,16991311,444,4084.0,16990867,16991311
5556,5556,6,6.0,6.000000000000015,1,2412,-87,-87.72027972027995,-88,1,e2:db:d1:d1:b0:4a,17503225,444,5684.0,17502781,17503225
5665,5665,6,6.0,6.000000000000015,1,2412,-89,-87.29836829836853,-88,-1,e2:db:d1:d1:b0:4a,17970868,52,8313.0,17970816,17970868
5760,5760,6,6.0,6.000000000000015,1,2412,-87,-87.44988344988369,-88,1,e2:db:d1:d1:b0:4a,18326020,632,8109.0,18325388,18326020
5784,5784,6,6.0,6.000000000000015,1,2412,-87,-87.53846153846176,-88,1,e2:db:d1:d1:b0:4a,18424837,444,10433.0,18424393,18424837
5788,5788,6,6.0,6.000000000000015,1,2412,-87,-88.14918414918439,-88,1,e2:db:d1:d1:b0:4a,18426681,224,261.0,18426457,18426681
5789,5789,6,6.0,6.000000000000015,1,2412,-88,-88.6923076923079,-88,0,e2:db:d1:d1:b0:4a,18426983,248,54.0,18426735,18426983
5814,5814,6,6.0,4.489510489510551,1,2412,-90,-88.51748251748273,-88,-2,e2:db:d1:d1:b0:4a,18529025,1332,-891.0,18527693,18529025
5815,5815,6,6.0,4.867132867132956,1,2412,-90,-88.4731934731937,-88,-2,e2:db:d1:d1:b0:4a,18530390,1360,5.0,18529030,18530390
5825,5825,6,6.0,8.223776223776284,1,2412,-89,-88.28671328671352,-88,-1,e2:db:d1:d1:b0:4a,18556737,68,7946.0,18556669,18556737
5855,5855,6,6.0,10.741258741258784,1,2412,-87,-87.74592074592097,-88,1,e2:db:d1:d1:b0:4a,18732021,444,5280.0,18731577,18732021
5887,5887,6,6.0,12.419580419580456,1,2412,-85,-87.22843822843846,-88,3,e2:db:d1:d1:b0:4a,18834431,444,7415.0,18833987,18834431
6123,6123,6,24.0,13.258741258741292,1,2412,-87,-86.73193473193497,-91,4,e2:db:d1:d1:b0:4a,19810783,28,5662.0,19810755,19810783
6125,6125,6,24.0,13.258741258741294,1,2412,-88,-87.11888111888135,-91,3,e2:db:d1:d1:b0:4a,19811856,28,823.0,19811828,19811856
6127,6127,6,6.0,12.419580419580448,1,2412,-87,-87.82051282051306,-91,4,e2:db:d1:d1:b0:4a,19815368,68,2001.0,19815300,19815368
6216,6216,6,6.0,10.741258741258754,1,2412,-89,-88.6480186480189,-91,2,e2:db:d1:d1:b0:4a,20153755,68,1432.0,20153687,20153755
6961,6961,6,6.0,8.223776223776207,1,2412,-89,-89.17715617715643,-93,4,e2:db:d1:d1:b0:4a,23091546,68,206.0,23091478,23091546
6977,6977,6,6.0,4.8671328671328045,1,2412,-91,-89.12587412587436,-93,2,e2:db:d1:d1:b0:4a,23135268,444,10475.0,23134824,23135268
6984,6984,6,6.0,4.489510489510452,1,2412,-89,-89.68298368298393,-93,4,e2:db:d1:d1:b0:4a,23154729,52,9456.0,23154677,23154729
7079,7079,6,6.0,6.000000000000015,1,2412,-89,-90.18881118881143,-93,4,e2:db:d1:d1:b0:4a,23468897,68,193.0,23468829,23468897
7126,7126,6,6.0,6.000000000000015,1,2412,-89,-89.80186480186504,-93,4,e2:db:d1:d1:b0:4a,23650228,52,974.0,23650176,23650228
7146,7146,6,6.0,6.000000000000015,1,2412,-90,-89.34731934731957,-93,3,e2:db:d1:d1:b0:4a,23751546,548,13480.0,23750998,23751546
7461,7461,6,6.0,6.000000000000015,1,2412,-92,-88.86946386946411,-94,2,e2:db:d1:d1:b0:4a,25184114,444,1096.0,25183670,25184114
7554,7554,6,6.0,6.000000000000015,1,2412,-88,-88.70862470862494,-94,6,e2:db:d1:d1:b0:4a,25490511,444,6911.0,25490067,25490511
7721,7721,6,6.0,6.000000000000015,1,2412,-86,-88.42424242424266,-93,7,e2:db:d1:d1:b0:4a,26214296,52,5318.0,26214244,26214296
7766,7766,6,6.0,6.000000000000015,1,2412,-88,-88.43356643356665,-93,5,e2:db:d1:d1:b0:4a,26419424,52,19938.0,26419372,26419424
7774,7774,6,6.0,6.000000000000015,1,2412,-89,-88.58508158508181,-93,4,e2:db:d1:d1:b0:4a,26440914,68,9207.0,26440846,26440914
7784,7784,6,6.0,6.000000000000015,1,2412,-89,-88.87878787878812,-93,4,e2:db:d1:d1:b0:4a,26489562,52,7654.0,26489510,26489562
7786,7786,6,6.0,6.000000000000015,1,2412,-90,-89.59440559440586,-93,3,e2:db:d1:d1:b0:4a,26501278,52,2983.0,26501226,26501278
7791,7791,6,6.0,6.000000000000015,1,2412,-91,-90.22610722610746,-93,2,e2:db:d1:d1:b0:4a,26514934,444,3224.0,26514490,26514934
7801,7801,6,6.0,6.000000000000015,1,2412,-90,-89.82051282051304,-93,3,e2:db:d1:d1:b0:4a,26553443,52,20980.0,26553391,26553443
7803,7803,6,6.0,6.000000000000015,1,2412,-89,-89.59673659673683,-93,4,e2:db:d1:d1:b0:4a,26563274,52,8405.0,26563222,26563274
7804,7804,6,6.0,6.000000000000015,1,2412,-89,-89.3636363636366,-93,4,e2:db:d1:d1:b0:4a,26567612,52,4286.0,26567560,26567612
7805,7805,6,6.0,6.000000000000015,1,2412,-90,-89.03729603729627,-93,3,e2:db:d1:d1:b0:4a,26568082,52,418.0,26568030,26568082
7806,7806,6,6.0,6.000000000000015,1,2412,-87,-88.82983682983706,-93,6,e2:db:d1:d1:b0:4a,26571198,52,3064.0,26571146,26571198
7808,7808,6,6.0,6.000000000000015,1,2412,-90,-88.64102564102588,-93,3,e2:db:d1:d1:b0:4a,26572991,68,195.0,26572923,26572991
7821,7821,6,6.0,6.000000000000015,1,2412,-89,-88.87179487179512,-93,4,e2:db:d1:d1:b0:4a,26605621,52,70.0,26605569,26605621
7829,7829,6,6.0,6.000000000000015,1,2412,-89,-89.1585081585084,-93,4,e2:db:d1:d1:b0:4a,26668375,52,11105.0,26668323,26668375
7857,7857,6,6.0,6.000000000000015,1,2412,-89,-89.62237762237787,-93,4,e2:db:d1:d1:b0:4a,26820782,68,9794.0,26820714,26820782
7897,7897,6,6.0,6.000000000000015,1,2412,-89,-90.24009324009349,-93,4,e2:db:d1:d1:b0:4a,26942092,52,8029.0,26942040,26942092
7901,7901,6,6.0,6.000000000000015,1,2412,-92,-90.62703962703986,-93,1,e2:db:d1:d1:b0:4a,26948843,68,3261.0,26948775,26948843
7909,7909,6,6.0,6.000000000000015,1,2412,-91,-90.76223776223799,-93,2,e2:db:d1:d1:b0:4a,26972958,52,7421.0,26972906,26972958
7911,7911,6,6.0,6.000000000000015,1,2412,-91,-90.37995337995362,-93,2,e2:db:d1:d1:b0:4a,26976072,68,2772.0,26976004,26976072
7934,7934,6,6.0,6.000000000000015,1,2412,-90,-89.88344988345011,-90,0,e2:db:d1:d1:b0:4a,27092928,68,4552.0,27092860,27092928
7947,7947,6,6.0,6.000000000000015,1,2412,-90,-89.10722610722632,-90,0,e2:db:d1:d1:b0:4a,27128914,444,642.0,27128470,27128914
7985,7985,6,6.0,6.000000000000015,1,2412,-86,-88.0979020979023,-90,4,e2:db:d1:d1:b0:4a,27249693,52,8431.0,27249641,27249693
8016,8016,6,6.0,6.000000000000015,1,2412,-87,-87.37062937062959,-90,3,e2:db:d1:d1:b0:4a,27309459,52,1954.0,27309407,27309459
8019,8019,6,6.0,6.000000000000015,1,2412,-88,-86.95571095571118,-90,2,e2:db:d1:d1:b0:4a,27311008,68,380.0,27310940,27311008
8029,8029,6,6.0,6.000000000000015,1,2412,-87,-86.98368298368321,-90,3,e2:db:d1:d1:b0:4a,27333740,444,2488.0,27333296,27333740
8033,8033,6,6.0,6.000000000000015,1,2412,-87,-87.20512820512845,-90,3,e2:db:d1:d1:b0:4a,27335699,548,-107.0,27335151,27335699
8034,8034,6,6.0,6.000000000000015,1,2412,-87,-87.91608391608415,-90,3,e2:db:d1:d1:b0:4a,27336280,576,5.0,27335704,27336280
8042,8042,6,6.0,6.000000000000015,1,2412,-89,-88.2680652680655,-90,1,e2:db:d1:d1:b0:4a,27346920,68,1260.0,27346852,27346920
8059,8059,6,6.0,6.000000000000015,1,2412,-89,-88.79953379953405,-90,1,e2:db:d1:d1:b0:4a,27437980,632,727.0,27437348,27437980
8067,8067,6,6.0,6.000000000000015,1,2412,-89,-89.29603729603754,-90,1,e2:db:d1:d1:b0:4a,27467055,52,19933.0,27467003,27467055
8072,8072,6,6.0,6.000000000000015,1,2412,-90,-89.62703962703986,-90,0,e2:db:d1:d1:b0:4a,27494450,52,11679.0,27494398,27494450
8126,8126,6,6.0,6.000000000000015,1,2412,-90,-89.9743589743592,-90,0,e2:db:d1:d1:b0:4a,27745968,392,879.0,27745576,27745968
8127,8127,6,6.0,6.000000000000015,1,2412,-90,-89.9743589743592,-90,0,e2:db:d1:d1:b0:4a,27746392,380,44.0,27746012,27746392
8179,8179,6,6.0,6.000000000000015,1,2412,-89,-89.67132867132891,-90,1,e2:db:d1:d1:b0:4a,28027799,52,7571.0,28027747,28027799
8181,8181,6,6.0,6.000000000000015,1,2412,-90,-89.32167832167856,-90,0,e2:db:d1:d1:b0:4a,28029733,52,1554.0,28029681,28029733
8191,8191,6,6.0,6.000000000000015,1,2412,-90,-89.00932400932425,-90,0,e2:db:d1:d1:b0:4a,28048307,52,698.0,28048255,28048307
8193,8193,6,6.0,6.000000000000015,1,2412,-88,-88.6736596736599,-90,2,e2:db:d1:d1:b0:4a,28048743,52,114.0,28048691,28048743
8199,8199,6,6.0,6.000000000000015,1,2412,-87,-88.38228438228461,-90,3,e2:db:d1:d1:b0:4a,28062253,52,3591.0,28062201,28062253
8203,8203,6,6.0,6.000000000000015,1,2412,-89,-88.59906759906781,-90,1,e2:db:d1:d1:b0:4a,28075522,52,4770.0,28075470,28075522
8207,8207,6,6.0,6.000000000000015,1,2412,-89,-88.3776223776226,-90,1,e2:db:d1:d1:b0:4a,28089313,52,11713.0,28089261,28089313
8208,8208,6,6.0,6.000000000000015,1,2412,-88,-88.60606060606085,-90,2,e2:db:d1:d1:b0:4a,28089795,52,430.0,28089743,28089795
8216,8216,6,6.0,6.000000000000015,1,2412,-89,-88.67832167832191,-90,1,e2:db:d1:d1:b0:4a,28123588,52,4019.0,28123536,28123588
8222,8222,6,6.0,6.000000000000015,1,2412,-90,-88.70163170163194,-90,0,e2:db:d1:d1:b0:4a,28153008,444,6881.0,28152564,28153008
8224,8224,6,6.0,6.000000000000015,1,2412,-87,-88.33566433566456,-90,3,e2:db:d1:d1:b0:4a,28155597,52,2069.0,28155545,28155597
8228,8228,6,6.0,6.000000000000015,1,2412,-89,-88.33799533799557,-90,1,e2:db:d1:d1:b0:4a,28170169,52,8019.0,28170117,28170169
8230,8230,6,6.0,6.000000000000015,1,2412,-87,-88.18414918414942,-90,3,e2:db:d1:d1:b0:4a,28170651,52,160.0,28170599,28170651
8236,8236,6,6.0,6.000000000000015,1,2412,-89,-88.31468531468553,-90,1,e2:db:d1:d1:b0:4a,28178467,52,698.0,28178415,28178467
8238,8238,6,6.0,6.000000000000015,1,2412,-88,-88.4965034965037,-90,2,e2:db:d1:d1:b0:4a,28178914,52,125.0,28178862,28178914
8243,8243,6,6.0,6.000000000000015,1,2412,-89,-88.46386946386971,-90,1,e2:db:d1:d1:b0:4a,28195888,52,2608.0,28195836,28195888
8245,8245,6,6.0,6.000000000000015,1,2412,-88,-88.32400932400955,-90,2,e2:db:d1:d1:b0:4a,28204342,52,8136.0,28204290,28204342
8259,8259,6,6.0,6.000000000000015,1,2412,-90,-88.24475524475548,-90,0,e2:db:d1:d1:b0:4a,28241860,52,368.0,28241808,28241860
8260,8260,6,6.0,6.000000000000015,1,2412,-87,-87.8694638694641,-90,3,e2:db:d1:d1:b0:4a,28242320,52,408.0,28242268,28242320
8265,8265,6,6.0,6.000000000000015,1,2412,-86,-87.7668997669,-90,4,e2:db:d1:d1:b0:4a,28247008,68,177.0,28246940,28247008
8270,8270,6,6.0,6.000000000000015,1,2412,-89,-87.49650349650372,-90,1,e2:db:d1:d1:b0:4a,28264197,52,6686.0,28264145,28264197
8271,8271,6,6.0,6.000000000000015,1,2412,-87,-87.4592074592077,-90,3,e2:db:d1:d1:b0:4a,28264898,52,649.0,28264846,28264898
8272,8272,6,6.0,6.000000000000015,1,2412,-88,-87.54778554778578,-90,2,e2:db:d1:d1:b0:4a,28266546,52,1596.0,28266494,28266546
8273,8273,6,6.0,6.000000000000015,1,2412,-88,-88.39160839160863,-90,2,e2:db:d1:d1:b0:4a,28267259,52,661.0,28267207,28267259
8275,8275,6,6.0,6.000000000000015,1,2412,-88,-88.72494172494197,-90,2,e2:db:d1:d1:b0:4a,28274498,52,779.0,28274446,28274498
8454,8454,6,6.0,6.000000000000015,1,2412,-89,-88.6689976689979,-90,1,e2:db:d1:d1:b0:4a,28986437,52,12829.0,28986385,28986437
8580,8580,6,6.0,6.000000000000015,1,2412,-90,-88.81118881118906,-90,0,e2:db:d1:d1:b0:4a,29383574,224,12372.0,29383350,29383574
8786,8786,6,6.0,6.000000000000015,1,2412,-90,-89.10256410256436,-90,0,e2:db:d1:d1:b0:4a,30291304,52,3076.0,30291252,30291304
8798,8798,6,6.0,6.000000000000015,1,2412,-88,-89.93006993007018,-90,2,e2:db:d1:d1:b0:4a,30351869,52,8174.0,30351817,30351869
8799,8799,6,6.0,6.000000000000015,1,2412,-89,-90.3613053613056,-90,1,e2:db:d1:d1:b0:4a,30352709,52,788.0,30352657,30352709
8831,8831,6,6.0,6.000000000000015,1,2412,-90,-90.39627039627064,-90,0,e2:db:d1:d1:b0:4a,30503008,68,5696.0,30502940,30503008
9003,9003,6,6.0,6.000000000000015,1,2412,-93,-90.24708624708647,-90,-3,e2:db:d1:d1:b0:4a,31360592,68,1785.0,31360524,31360592
9006,9006,6,6.0,6.000000000000015,1,2412,-92,-90.06526806526828,-90,-2,e2:db:d1:d1:b0:4a,31375999,68,85.0,31375931,31375999
9180,9180,6,6.0,6.000000000000015,1,2412,-88,-89.64568764568789,-90,2,e2:db:d1:d1:b0:4a,32252165,632,1119.0,32251533,32252165
9181,9181,6,6.0,6.000000000000015,1,2412,-88,-88.90442890442914,-90,2,e2:db:d1:d1:b0:4a,32252893,656,72.0,32252237,32252893
9182,9182,6,6.0,6.000000000000015,1,2412,-88,-88.53146853146876,-90,2,e2:db:d1:d1:b0:4a,32254699,156,1650.0,32254543,32254699
9183,9183,6,6.0,6.000000000000015,1,2412,-88,-88.14685314685337,-90,2,e2:db:d1:d1:b0:4a,32254952,196,57.0,32254756,32254952
9184,9184,6,6.0,6.000000000000015,1,2412,-88,-88.43123543123566,-90,2,e2:db:d1:d1:b0:4a,32255243,156,135.0,32255087,32255243
9398,9398,6,6.0,6.000000000000015,1,2412,-90,-89.2634032634035,-90,0,e2:db:d1:d1:b0:4a,33253554,68,181.0,33253486,33253554
9414,9414,6,6.0,6.000000000000015,1,2412,-91,-89.88111888111911,-90,-1,e2:db:d1:d1:b0:4a,33273558,444,-287.0,33273114,33273558
9417,9417,6,6.0,6.000000000000015,1,2412,-89,-89.77622377622403,-90,1,e2:db:d1:d1:b0:4a,33276827,548,1706.0,33276279,33276827
9418,9418,6,6.0,6.000000000000015,1,2412,-90,-90.22843822843846,-90,0,e2:db:d1:d1:b0:4a,33277408,576,5.0,33276832,33277408
9420,9420,6,6.0,6.000000000000015,1,2412,-91,-90.53379953379977,-90,-1,e2:db:d1:d1:b0:4a,33279211,68,177.0,33279143,33279211
9559,9559,6,6.0,6.000000000000015,1,2412,-90,-90.20745920745942,-90,0,e2:db:d1:d1:b0:4a,33804594,68,2848.0,33804526,33804594
9574,9574,6,6.0,6.000000000000015,1,2412,-88,-89.8857808857811,-90,2,e2:db:d1:d1:b0:4a,33894280,68,237.0,33894212,33894280
9662,9662,6,6.0,6.000000000000015,1,2412,-93,-89.65967365967389,-91,-2,e2:db:d1:d1:b0:4a,34273545,68,513.0,34273477,34273545
9739,9739,6,6.0,6.000000000000015,1,2412,-89,-89.00699300699323,-91,2,e2:db:d1:d1:b0:4a,34488604,68,4452.0,34488536,34488604
9742,9742,6,6.0,6.000000000000015,1,2412,-87,-88.60372960372983,-91,4,e2:db:d1:d1:b0:4a,34494967,68,1767.0,34494899,34494967
9744,9744,6,6.0,6.000000000000015,1,2412,-88,-88.24475524475548,-91,3,e2:db:d1:d1:b0:4a,34496096,68,329.0,34496028,34496096
9745,9745,6,6.0,6.000000000000015,1,2412,-88,-88.08158508158532,-91,3,e2:db:d1:d1:b0:4a,34505096,444,8556.0,34504652,34505096
9747,9747,6,6.0,6.000000000000015,1,2412,-88,-87.77389277389298,-91,3,e2:db:d1:d1:b0:4a,34507052,68,1393.0,34506984,34507052
9749,9749,6,6.0,6.000000000000015,1,2412,-89,-88.50349650349673,-91,2,e2:db:d1:d1:b0:4a,34508137,68,309.0,34508069,34508137
9758,9758,6,6.0,6.000000000000015,1,2412,-88,-88.98834498834522,-91,3,e2:db:d1:d1:b0:4a,34545421,52,3297.0,34545369,34545421
9760,9760,6,6.0,6.000000000000015,1,2412,-90,-89.55710955710981,-91,1,e2:db:d1:d1:b0:4a,34546609,68,585.0,34546541,34546609
9761,9761,6,6.0,6.000000000000015,1,2412,-90,-90.01398601398624,-91,1,e2:db:d1:d1:b0:4a,34546854,52,193.0,34546802,34546854
9765,9765,6,6.0,6.000000000000015,1,2412,-90,-90.08624708624733,-91,1,e2:db:d1:d1:b0:4a,34557312,68,84.0,34557244,34557312
9766,9766,6,6.0,6.000000000000015,1,2412,-90,-89.79720279720301,-91,1,e2:db:d1:d1:b0:4a,34561237,52,3873.0,34561185,34561237
9779,9779,6,6.0,6.000000000000015,1,2412,-91,-89.38228438228461,-91,0,e2:db:d1:d1:b0:4a,34598656,68,237.0,34598588,34598656
9852,9852,6,6.0,6.000000000000015,1,2412,-88,-88.59207459207481,-91,3,e2:db:d1:d1:b0:4a,35000258,68,91.0,35000190,35000258
9854,9854,6,6.0,6.000000000000015,1,2412,-87,-87.95804195804217,-92,5,e2:db:d1:d1:b0:4a,35016875,444,3422.0,35016431,35016875
