,phy,data_rate,channel,frequency,signal_dbm,noise_dbm,snr,tx_addr,timestamp,duration,ifs,start_tsf,end_tsf
0,6,24,1,2412,-80,-93,13,,52637,28,,52609,52637
1,4,1,1,2412,-70,-93,23,b0:e4:d5:32:ec:8a,54901,1960,304,52941,54901
2,6,6,1,2412,-58,-93,35,10:86:8c:5f:93:1e,58634,344,3389,58290,58634
3,4,1,1,2412,-66,-93,27,94:a6:7e:c9:98:67,61882,2464,784,59418,61882
4,6,24,1,2412,-78,-93,15,4c:01:43:d7:f3:26,70081,32,8167,70049,70081
5,6,24,1,2412,-79,-93,14,,70801,28,692,70773,70801
6,6,24,1,2412,-81,-93,12,,73179,28,2350,73151,73179
7,4,11,1,2412,-72,-93,21,48:dd:0c:7d:86:23,79778,323,6276,79455,79778
8,4,11,1,2412,-72,-93,21,48:dd:0c:7d:86:25,80114,382,-46,79732,80114
9,6,6,1,2412,-80,-93,13,40:b0:34:b7:01:d5,82356,576,1666,81780,82356
10,6,6,1,2412,-57,-93,36,12:86:8c:5f:93:1e,84233,332,1545,83901,84233
11,4,1,1,2412,-90,-93,3,00:26:62:eb:ea:74,93200,968,7999,92232,93200
12,6,6,1,2412,-86,-93,7,e2:db:d1:d1:b0:4a,95014,444,1370,94570,95014
13,6,6,1,2412,-87,-93,6,e2:db:d1:d1:b0:4b,95491,408,69,95083,95491
14,4,11,1,2412,-83,-93,10,4c:01:43:ec:a0:69,103350,361,7498,102989,103350
15,4,11,1,2412,-82,-93,11,4c:01:43:ec:a0:63,103723,322,51,103401,103723
16,4,11,1,2412,-83,-93,10,4c:01:43:ec:a0:66,104058,387,-52,103671,104058
17,4,11,1,2412,-74,-93,19,48:dd:0c:90:e3:87,104570,362,150,104208,104570
18,4,11,1,2412,-74,-93,19,48:dd:0c:90:e3:83,104944,323,51,104621,104944
19,4,11,1,2412,-75,-93,18,48:dd:0c:90:e3:85,105279,382,-47,104897,105279
20,6,6,1,2412,-58,-93,35,52:86:8c:5f:93:1e,109912,332,4301,109580,109912
21,6,6,1,2412,-85,-93,8,0a:a7:c0:a3:8d:71,113123,408,2803,112715,113123
22,6,6,1,2412,-85,-93,8,0a:a7:c0:a3:8d:73,113582,408,51,113174,113582
23,4,1,1,2412,-82,-93,11,78:67:0e:c4:a8:42,116742,2736,424,114006,116742
24,4,11,1,2412,-83,-93,10,,120110,107,3261,120003,120110
25,6,24,1,2412,-81,-93,12,78:67:0e:c4:a8:42,120238,32,96,120206,120238
26,4,1,1,2412,-83,-93,10,78:67:0e:c4:a8:42,124665,352,4075,124313,124665
27,6,24,1,2412,-81,-93,12,78:67:0e:c4:a8:42,127223,32,2526,127191,127223
28,4,1,1,2412,-85,-93,8,,132832,304,5305,132528,132832
29,6,6,1,2412,-86,-93,7,e2:db:d1:d1:b0:4a,133558,68,658,133490,133558
30,6,6,1,2412,-59,-93,34,32:86:8c:5f:93:1e,135435,332,1545,135103,135435
31,6,6,1,2412,-87,-93,6,3c:bd:c5:ee:96:6d,155275,68,19772,155207,155275
32,6,24,1,2412,-80,-93,13,,156315,28,1012,156287,156315
33,4,1,1,2412,-57,-93,36,94:a6:7e:c9:98:67,164286,2464,5507,161822,164286
34,4,11,1,2412,-80,-93,13,4c:01:43:d7:f3:23,168480,322,3872,168158,168480
35,6,6,1,2412,-88,-93,5,3c:bd:c5:ee:96:6d,173257,68,4709,173189,173257
36,4,1,1,2412,-81,-93,12,78:67:0e:38:6c:d3,179037,2736,3044,176301,179037
37,4,11,1,2412,-72,-93,21,48:dd:0c:7d:86:27,181796,362,2397,181434,181796
38,4,11,1,2412,-73,-93,20,48:dd:0c:7d:86:23,182170,323,51,181847,182170
39,4,11,1,2412,-72,-93,21,48:dd:0c:7d:86:25,182505,382,-47,182123,182505
40,6,6,1,2412,-79,-93,14,40:b0:34:b7:01:d5,184757,576,1676,184181,184757
41,6,6,1,2412,-59,-93,34,12:86:8c:5f:93:1e,186635,332,1546,186303,186635
42,6,6,1,2412,-84,-93,9,e2:db:d1:d1:b0:4b,197911,408,10868,197503,197911
43,6,6,1,2412,-84,-93,9,e2:db:d1:d1:b0:4d,198352,408,33,197944,198352
44,6,6,1,2412,-86,-93,7,e2:db:d1:d1:b0:4f,198811,408,51,198403,198811
45,6,6,1,2412,-84,-93,9,,199479,44,624,199435,199479
46,4,1,1,2412,-91,-93,2,,204540,304,4757,204236,204540
47,4,11,1,2412,-83,-93,10,4c:01:43:ec:a0:69,205749,361,848,205388,205749
48,4,11,1,2412,-81,-93,12,4c:01:43:ec:a0:63,206122,322,51,205800,206122
49,4,11,1,2412,-75,-93,18,48:dd:0c:90:e3:87,206969,362,485,206607,206969
50,4,11,1,2412,-74,-93,19,48:dd:0c:90:e3:83,207344,323,52,207021,207344
51,4,11,1,2412,-75,-93,18,48:dd:0c:90:e3:85,207679,382,-47,207297,207679
52,6,6,1,2412,-57,-93,36,52:86:8c:5f:93:1e,214025,332,6014,213693,214025
53,6,6,1,2412,-85,-93,8,0a:a7:c0:a3:8d:71,215422,408,989,215014,215422
54,6,6,1,2412,-86,-93,7,0a:a7:c0:a3:8d:73,215872,408,42,215464,215872
55,4,1,1,2412,-86,-93,7,,223072,304,6896,222768,223072
56,6,6,1,2412,-83,-93,10,,223332,44,216,223288,223332
57,4,11,1,2412,-87,-93,6,48:dd:0c:92:4b:e3,231575,254,7989,231321,231575
58,4,11,1,2412,-75,-93,18,48:dd:0c:90:e3:83,232235,254,406,231981,232235
59,4,11,1,2412,-71,-93,22,48:dd:0c:7d:86:23,232538,254,49,232284,232538
60,4,1,1,2412,-81,-93,12,78:67:0e:c4:a8:42,233685,352,795,233333,233685
61,6,6,1,2412,-59,-93,34,32:86:8c:5f:93:1e,237834,332,3817,237502,237834
62,6,24,1,2412,-79,-93,14,,243414,28,5552,243386,243414
63,4,1,1,2412,-69,-93,24,b0:e4:d5:32:ec:8a,259700,1960,14326,257740,259700
64,6,6,1,2412,-57,-93,36,10:86:8c:5f:93:1e,263435,344,3391,263091,263435
65,4,1,1,2412,-66,-93,27,94:a6:7e:c9:98:67,266689,2464,790,264225,266689
66,4,11,1,2412,-81,-93,12,,271780,107,4984,271673,271780
67,6,24,1,2412,-81,-93,12,78:67:0e:c4:a8:42,271893,32,81,271861,271893
68,4,11,1,2412,-88,-93,5,48:dd:0c:92:4b:e7,272888,362,633,272526,272888
69,4,11,1,2412,-87,-93,6,48:dd:0c:92:4b:e3,273262,323,51,272939,273262
70,4,1,1,2412,-82,-93,11,78:67:0e:c4:a8:42,273939,352,325,273587,273939
71,4,11,1,2412,-76,-93,17,48:dd:0c:90:e3:83,279271,277,5055,278994,279271
72,4,11,1,2412,-72,-93,21,48:dd:0c:7d:86:23,284571,323,4977,284248,284571
73,4,11,1,2412,-72,-93,21,48:dd:0c:7d:86:25,284906,382,-47,284524,284906
74,6,6,1,2412,-58,-93,35,12:86:8c:5f:93:1e,289036,332,3798,288704,289036
75,6,6,1,2412,-83,-93,10,e2:db:d1:d1:b0:4a,299913,444,10433,299469,299913
76,6,6,1,2412,-83,-93,10,e2:db:d1:d1:b0:4d,300849,408,528,300441,300849
77,6,6,1,2412,-82,-93,11,e2:db:d1:d1:b0:4f,301282,408,25,300874,301282
78,6,6,1,2412,-83,-93,10,e2:db:d1:d1:b0:4a,301722,548,-108,301174,301722
79,6,6,1,2412,-84,-93,9,e2:db:d1:d1:b0:4a,302303,576,5,301727,302303
80,6,6,1,2412,-83,-93,10,,303798,44,1451,303754,303798
81,6,24,1,2412,-81,-93,12,,306943,28,3117,306915,306943
82,4,1,1,2412,-85,-93,8,,307423,304,176,307119,307423
83,4,11,1,2412,-84,-93,9,4c:01:43:ec:a0:63,308521,322,776,308199,308521
84,4,11,1,2412,-74,-93,19,48:dd:0c:90:e3:87,309369,362,486,309007,309369
85,4,11,1,2412,-74,-93,19,48:dd:0c:90:e3:83,309744,323,52,309421,309744
86,4,11,1,2412,-75,-93,18,48:dd:0c:90:e3:85,310079,382,-47,309697,310079
87,6,6,1,2412,-60,-93,33,52:86:8c:5f:93:1e,315651,332,5240,315319,315651
88,4,1,1,2412,-83,-93,10,78:67:0e:c4:a8:42,321542,2736,3155,318806,321542
89,6,6,1,2412,-59,-93,34,32:86:8c:5f:93:1e,340235,332,18361,339903,340235
90,4,1,1,2412,-91,-93,2,38:01:46:30:1a:ca,341230,416,579,340814,341230
91,6,24,1,2412,-82,-93,11,,350150,28,8892,350122,350150
92,4,1,1,2412,-88,-93,5,,359263,304,8809,358959,359263
93,4,1,1,2412,-69,-93,24,b0:e4:d5:32:ec:8a,362099,1960,876,360139,362099
94,6,6,1,2412,-57,-93,36,10:86:8c:5f:93:1e,365836,344,3393,365492,365836
95,4,1,1,2412,-66,-93,27,94:a6:7e:c9:98:67,369100,2464,800,366636,369100
96,4,11,1,2412,-81,-93,12,4c:01:43:d7:f3:29,372300,362,2838,371938,372300
97,4,11,1,2412,-81,-93,12,4c:01:43:d7:f3:23,372675,322,53,372353,372675
98,4,11,1,2412,-82,-93,11,4c:01:43:d7:f3:26,373009,387,-53,372622,373009
99,6,6,1,2412,-85,-93,8,,379790,44,6737,379746,379790
100,4,1,1,2412,-85,-93,8,,383390,304,3296,383086,383390
101,4,1,1,2412,-82,-93,11,78:67:0e:38:6c:d3,383838,2736,-2288,381102,383838
102,4,11,1,2412,-73,-93,20,48:dd:0c:7d:86:27,386596,362,2396,386234,386596
103,4,11,1,2412,-72,-93,21,48:dd:0c:7d:86:23,386971,323,52,386648,386971
104,4,11,1,2412,-74,-93,19,48:dd:0c:7d:86:25,387306,382,-47,386924,387306
105,6,6,1,2412,-76,-93,17,40:b0:34:b7:01:d5,389559,576,1677,388983,389559
106,6,6,1,2412,-57,-93,36,12:86:8c:5f:93:1e,391435,332,1544,391103,391435
107,4,1,1,2412,-88,-93,5,70:3a:cb:63:35:b2,392020,2216,-1631,389804,392020
108,4,1,1,2412,-87,-93,6,48:a6:b8:49:4e:15,399572,432,7120,399140,399572
109,6,24,1,2412,-77,-93,16,,404206,28,4606,404178,404206
110,6,6,1,2412,-85,-93,8,,406105,44,1855,406061,406105
111,4,11,1,2412,-75,-93,18,48:dd:0c:90:e3:87,411769,362,5302,411407,411769
112,4,11,1,2412,-75,-93,18,48:dd:0c:90:e3:83,412143,323,51,411820,412143
113,4,11,1,2412,-83,-93,10,4c:01:43:ec:a0:66,416254,387,3724,415867,416254
114,6,6,1,2412,-59,-93,34,52:86:8c:5f:93:1e,417036,332,450,416704,417036
115,4,1,1,2412,-82,-93,11,78:67:0e:c4:a8:42,423942,2736,4170,421206,423942
116,6,6,1,2412,-81,-93,12,,426973,44,2987,426929,426973
117,4,1,1,2412,-69,-93,24,b0:e4:d5:32:ec:8a,464498,1960,35565,462538,464498
118,6,6,1,2412,-57,-93,36,10:86:8c:5f:93:1e,468236,344,3394,467892,468236
119,4,1,1,2412,-67,-93,26,94:a6:7e:c9:98:67,471493,2464,793,469029,471493
120,4,1,1,2412,-68,-93,25,3c:06:30:47:83:74,474502,416,2593,474086,474502
121,4,1,1,2412,-27,-93,66,94:a6:7e:c9:98:67,475281,432,347,474849,475281
122,4,11,1,2412,-83,-93,10,48:dd:0c:92:4b:e7,477687,362,2044,477325,477687
123,4,11,1,2412,-88,-93,5,48:dd:0c:92:4b:e3,478062,323,52,477739,478062
124,4,11,1,2412,-89,-93,4,48:dd:0c:92:4b:e5,478397,382,-47,478015,478397
125,4,1,1,2412,-78,-93,15,78:67:0e:38:6c:d3,486238,2736,5105,483502,486238
126,4,11,1,2412,-72,-93,21,48:dd:0c:7d:86:27,488997,362,2397,488635,488997
127,4,11,1,2412,-72,-93,21,48:dd:0c:7d:86:23,489372,323,52,489049,489372
128,4,11,1,2412,-75,-93,18,48:dd:0c:7d:86:25,489707,382,-47,489325,489707
129,6,24,1,2412,-81,-93,12,,504964,28,15229,504936,504964
130,4,11,1,2412,-74,-93,19,4c:01:43:ec:a0:69,512945,361,7620,512584,512945
131,4,11,1,2412,-85,-93,8,4c:01:43:ec:a0:63,513319,322,52,512997,513319
132,4,11,1,2412,-84,-93,9,4c:01:43:ec:a0:66,513653,387,-53,513266,513653
133,4,11,1,2412,-41,-93,52,48:dd:0c:90:e3:83,514543,323,567,514220,514543
134,4,11,1,2412,-73,-93,20,48:dd:0c:90:e3:85,514878,382,-47,514496,514878
135,6,6,1,2412,-59,-93,34,52:86:8c:5f:93:1e,519546,332,4336,519214,519546
136,4,1,1,2412,-83,-93,10,,523895,304,4045,523591,523895
137,6,24,1,2412,-80,-93,13,,550813,28,26890,550785,550813
138,4,1,1,2412,-70,-93,23,b0:e4:d5:32:ec:8a,573192,1960,20419,571232,573192
139,6,6,1,2412,-59,-93,34,10:86:8c:5f:93:1e,575008,344,1472,574664,575008
140,6,6,1,2412,-61,-93,32,b4:e6:2d:b4:ff:71,581571,64,6499,581507,581571
141,6,6,1,2412,-59,-93,34,,581651,44,36,581607,581651
142,4,1,1,2412,-62,-93,31,10:86:8c:5f:93:1e,581894,3088,-2845,578806,581894
143,4,1,1,2412,-62,-93,31,10:86:8c:5f:93:1e,585079,3088,97,581991,585079
144,6,24,1,2412,-70,-93,23,0a:83:14:5e:8f:39,591037,32,5926,591005,591037
145,4,1,1,2412,-67,-93,26,0a:83:14:5e:8f:39,591682,416,229,591266,591682
146,4,1,1,2412,-65,-93,28,,592110,304,124,591806,592110
147,4,1,1,2412,-65,-93,28,94:a6:7e:c9:98:67,592461,432,-81,592029,592461
148,4,1,1,2412,-67,-93,26,,592905,304,140,592601,592905
149,6,24,1,2412,-68,-93,25,0a:83:14:5e:8f:39,608701,32,15764,608669,608701
150,6,24,1,2412,-64,-93,29,,608752,28,23,608724,608752
151,4,1,1,2412,-91,-93,2,,614133,304,5077,613829,614133
152,4,11,1,2412,-83,-93,10,4c:01:43:ec:a0:69,615344,361,850,614983,615344
153,4,11,1,2412,-84,-93,9,4c:01:43:ec:a0:63,615718,322,52,615396,615718
154,4,11,1,2412,-73,-93,20,48:dd:0c:90:e3:87,616568,362,488,616206,616568
155,4,11,1,2412,-75,-93,18,48:dd:0c:90:e3:83,616943,323,52,616620,616943
156,4,11,1,2412,-74,-93,19,48:dd:0c:90:e3:85,617278,382,-47,616896,617278
157,6,6,1,2412,-57,-93,36,52:86:8c:5f:93:1e,622850,332,5240,622518,622850
158,6,24,1,2412,-81,-93,12,,631377,28,8499,631349,631377
159,4,1,1,2412,-90,-93,3,04:a2:22:bf:24:52,632779,2512,-1110,630267,632779
160,6,24,1,2412,-85,-93,8,,637274,28,4467,637246,637274
161,6,24,1,2412,-81,-93,12,,643388,28,6086,643360,643388
162,6,24,1,2412,-83,-93,10,,653824,28,10408,653796,653824
163,4,1,1,2412,-90,-93,3,,656953,352,2777,656601,656953
164,4,1,1,2412,-68,-93,25,b0:e4:d5:32:ec:8a,669297,1960,10384,667337,669297
165,6,6,1,2412,-57,-93,36,10:86:8c:5f:93:1e,673038,344,3397,672694,673038
166,4,1,1,2412,-64,-93,29,94:a6:7e:c9:98:67,675862,2464,360,673398,675862
167,4,11,1,2412,-83,-93,10,4c:01:43:d7:f3:29,679499,362,3275,679137,679499
168,4,11,1,2412,-83,-93,10,4c:01:43:d7:f3:23,679873,322,52,679551,679873
169,4,11,1,2412,-84,-93,9,4c:01:43:d7:f3:26,680208,387,-52,679821,680208
170,6,12,1,2412,-83,-93,10,,681807,32,1567,681775,681807
171,6,6,1,2412,-86,-93,7,40:b0:34:b7:01:d5,697959,576,15576,697383,697959
172,6,6,1,2412,-58,-93,35,12:86:8c:5f:93:1e,698637,332,346,698305,698637
173,4,11,1,2412,-83,-93,10,4c:01:43:ec:a0:69,717743,361,18745,717382,717743
174,4,11,1,2412,-85,-93,8,4c:01:43:ec:a0:63,718117,322,52,717795,718117
175,4,11,1,2412,-84,-93,9,4c:01:43:ec:a0:66,718451,387,-53,718064,718451
176,4,11,1,2412,-68,-93,25,48:dd:0c:90:e3:87,718968,362,155,718606,718968
177,4,11,1,2412,-75,-93,18,48:dd:0c:90:e3:83,719343,323,52,719020,719343
178,4,11,1,2412,-76,-93,17,48:dd:0c:90:e3:85,719678,382,-47,719296,719678
179,6,24,1,2412,-80,-93,13,,723419,28,3713,723391,723419
180,4,1,1,2412,-85,-93,8,78:67:0e:c4:a8:42,731142,2736,4987,728406,731142
181,6,24,1,2412,-84,-93,9,,733778,28,2608,733750,733778
182,4,1,1,2412,-89,-93,4,04:a2:22:bf:24:52,735192,2512,-1098,732680,735192
183,4,11,1,2412,-68,-93,25,4c:01:43:d7:f3:23,739975,254,4529,739721,739975
184,4,11,1,2412,-83,-93,10,4c:01:43:ec:a0:63,740979,254,750,740725,740979
185,6,6,1,2412,-59,-93,34,32:86:8c:5f:93:1e,749839,332,8528,749507,749839
186,4,1,1,2412,-71,-93,22,ce:f4:11:65:3f:f8,751620,2072,-291,749548,751620
187,6,24,1,2412,-85,-93,8,,753819,28,2171,753791,753819
188,4,1,1,2412,-87,-93,6,78:67:0e:c4:a8:42,755412,352,1241,755060,755412
189,6,6,1,2412,-61,-93,32,b4:e6:2d:b4:ff:71,756088,64,612,756024,756088
190,6,6,1,2412,-60,-93,33,,756447,44,315,756403,756447
191,6,24,1,2412,-83,-93,10,78:67:0e:c4:a8:42,757516,32,1037,757484,757516
192,4,1,1,2412,-89,-93,4,ac:67:84:84:8a:07,757962,416,30,757546,757962
193,4,1,1,2412,-60,-93,33,94:a6:7e:c9:98:67,778694,2464,18268,776230,778694
194,4,11,1,2412,-79,-93,14,4c:01:43:d7:f3:29,781898,362,2842,781536,781898
195,4,11,1,2412,-81,-93,12,4c:01:43:d7:f3:23,782273,322,53,781951,782273
196,4,11,1,2412,-81,-93,12,4c:01:43:d7:f3:26,782607,387,-53,782220,782607
197,4,11,1,2412,-78,-93,15,48:dd:0c:7d:86:23,796572,323,13642,796249,796572
198,4,11,1,2412,-74,-93,19,48:dd:0c:7d:86:25,796907,382,-47,796525,796907
199,6,6,1,2412,-86,-93,7,e2:db:d1:d1:b0:4a,811838,444,14487,811394,811838
200,6,6,1,2412,-86,-93,7,,813289,44,1407,813245,813289
201,6,6,1,2412,-60,-93,33,52:86:8c:5f:93:1e,826639,332,13018,826307,826639
202,6,6,1,2412,-89,-93,4,0a:a7:c0:a3:8d:71,830007,408,2960,829599,830007
203,4,1,1,2412,-85,-93,8,78:67:0e:c4:a8:42,833541,2736,798,830805,833541
204,6,24,1,2412,-82,-93,11,,837276,28,3707,837248,837276
205,6,24,1,2412,-80,-93,13,,855697,28,18393,855669,855697
206,4,1,1,2412,-84,-93,9,3c:bd:c5:ee:96:6d,865666,3280,6689,862386,865666
207,6,24,1,2412,-81,-93,12,,870823,28,5129,870795,870823
208,4,1,1,2412,-71,-93,22,b0:e4:d5:32:ec:8a,874095,1960,1312,872135,874095
209,6,6,1,2412,-60,-93,33,10:86:8c:5f:93:1e,877839,344,3400,877495,877839
210,4,1,1,2412,-61,-93,32,94:a6:7e:c9:98:67,881075,2464,772,878611,881075
211,6,24,1,2412,-81,-93,12,,883742,28,2639,883714,883742
212,4,11,1,2412,-83,-93,10,,885928,107,2079,885821,885928
213,6,24,1,2412,-79,-93,14,78:67:0e:c4:a8:42,886045,32,85,886013,886045
214,4,1,1,2412,-91,-93,2,40:ca:63:2d:74:be,891727,1688,3994,890039,891727
215,4,1,1,2412,-86,-93,7,78:67:0e:38:6c:d3,895839,2736,1376,893103,895839
216,4,11,1,2412,-71,-93,22,48:dd:0c:7d:86:27,898597,362,2396,898235,898597
217,4,11,1,2412,-70,-93,23,48:dd:0c:7d:86:23,898972,323,52,898649,898972
218,6,6,1,2412,-62,-93,31,12:86:8c:5f:93:1e,903440,332,4136,903108,903440
219,4,1,1,2412,-88,-93,5,70:3a:cb:63:35:b2,904018,2216,-1638,901802,904018
220,6,6,1,2412,-85,-93,8,e2:db:d1:d1:b0:4a,914233,444,9771,913789,914233
221,6,6,1,2412,-84,-93,9,e2:db:d1:d1:b0:4b,914719,408,78,914311,914719
222,6,6,1,2412,-85,-93,8,e2:db:d1:d1:b0:4d,915151,408,24,914743,915151
223,6,6,1,2412,-84,-93,9,,915657,44,462,915613,915657
224,6,24,1,2412,-80,-93,13,,921082,28,5397,921054,921082
225,4,11,1,2412,-81,-93,12,4c:01:43:ec:a0:63,922914,322,1510,922592,922914
226,4,11,1,2412,-81,-93,12,4c:01:43:ec:a0:66,923249,387,-52,922862,923249
227,4,11,1,2412,-78,-93,15,48:dd:0c:90:e3:87,923767,362,156,923405,923767
228,4,11,1,2412,-80,-93,13,48:dd:0c:90:e3:83,924142,323,52,923819,924142
229,4,11,1,2412,-79,-93,14,48:dd:0c:90:e3:85,924477,382,-47,924095,924477
230,6,6,1,2412,-61,-93,32,52:86:8c:5f:93:1e,929080,332,4271,928748,929080
231,4,1,1,2412,-86,-93,7,3c:bd:c5:ee:96:6d,929624,2512,-1968,927112,929624
232,6,6,1,2412,-85,-93,8,3c:bd:c5:ee:96:6d,950548,68,20856,950480,950548
233,6,24,1,2412,-81,-93,12,,950816,28,240,950788,950816
234,6,6,1,2412,-61,-93,32,32:86:8c:5f:93:1e,954639,332,3491,954307,954639
235,6,6,1,2412,-85,-93,8,3c:bd:c5:ee:96:6d,965612,68,10905,965544,965612
236,4,1,1,2412,-72,-93,21,b0:e4:d5:32:ec:8a,976495,1960,8923,974535,976495
237,4,11,1,2412,-82,-93,11,4c:01:43:d7:f3:29,986697,362,9840,986335,986697
238,4,11,1,2412,-78,-93,15,4c:01:43:d7:f3:23,987072,322,53,986750,987072
239,4,11,1,2412,-82,-93,11,4c:01:43:d7:f3:26,987407,387,-52,987020,987407
240,4,1,1,2412,-88,-93,5,3c:bd:c5:ee:96:6d,993644,752,5485,992892,993644
241,4,1,1,2412,-80,-93,13,78:67:0e:38:6c:d3,998239,2736,1859,995503,998239
242,4,11,1,2412,-74,-93,19,48:dd:0c:7d:86:27,1000998,362,2397,1000636,1000998
243,4,11,1,2412,-74,-93,19,48:dd:0c:7d:86:23,1001373,323,52,1001050,1001373
244,4,11,1,2412,-74,-93,19,48:dd:0c:7d:86:25,1001708,382,-47,1001326,1001708
245,6,6,1,2412,-62,-93,31,12:86:8c:5f:93:1e,1005840,332,3800,1005508,1005840
246,6,6,1,2412,-77,-93,16,,1007104,44,1220,1007060,1007104
247,4,11,1,2412,-82,-92,10,4c:01:43:ec:a0:69,1024939,361,17474,1024578,1024939
248,4,11,1,2412,-84,-92,8,4c:01:43:ec:a0:63,1025313,322,52,1024991,1025313
249,4,11,1,2412,-82,-92,10,4c:01:43:ec:a0:66,1025648,387,-52,1025261,1025648
250,4,11,1,2412,-81,-92,11,48:dd:0c:90:e3:87,1026167,362,157,1025805,1026167
251,4,11,1,2412,-80,-92,12,48:dd:0c:90:e3:83,1026542,323,52,1026219,1026542
252,4,1,1,2412,-85,-92,7,78:67:0e:c4:a8:42,1038418,2736,9140,1035682,1038418
253,4,1,1,2412,-90,-92,2,cc:f4:11:65:3f:fb,1045660,2064,5178,1043596,1045660
254,4,1,1,2412,-85,-92,7,,1051248,304,5284,1050944,1051248
255,6,6,1,2412,-63,-92,29,32:86:8c:5f:93:1e,1057041,332,5461,1056709,1057041
256,4,1,1,2412,-70,-92,22,b0:e4:d5:32:ec:8a,1078894,1960,19893,1076934,1078894
257,4,11,1,2412,-63,-92,29,10:86:8c:5f:93:1e,1083483,261,4328,1083222,1083483
258,4,1,1,2412,-60,-92,32,94:a6:7e:c9:98:67,1085917,2464,-30,1083453,1085917
259,4,1,1,2412,-93,-92,-1,78:67:0e:38:6c:d3,1100639,2736,11986,1097903,1100639
260,4,11,1,2412,-74,-92,18,48:dd:0c:7d:86:27,1103398,362,2397,1103036,1103398
261,4,11,1,2412,-74,-92,18,48:dd:0c:7d:86:23,1103773,323,52,1103450,1103773
262,4,11,1,2412,-75,-92,17,48:dd:0c:7d:86:25,1104108,382,-47,1103726,1104108
263,6,24,1,2412,-81,-92,11,,1104842,28,706,1104814,1104842
264,6,6,1,2412,-81,-92,11,40:b0:34:b7:01:d5,1106367,576,949,1105791,1106367
265,6,6,1,2412,-61,-92,31,12:86:8c:5f:93:1e,1108292,332,1593,1107960,1108292
266,4,1,1,2412,-90,-92,2,70:3a:cb:63:35:b2,1108817,2216,-1691,1106601,1108817
267,6,24,1,2412,-80,-92,12,,1123078,28,14233,1123050,1123078
268,6,24,1,2412,-84,-92,8,,1123533,28,427,1123505,1123533
269,4,11,1,2412,-89,-92,3,4c:01:43:ec:a0:63,1127712,322,3857,1127390,1127712
270,4,11,1,2412,-88,-92,4,4c:01:43:ec:a0:66,1128047,387,-52,1127660,1128047
271,6,24,1,2412,-85,-92,7,,1128342,28,267,1128314,1128342
272,4,11,1,2412,-83,-92,9,48:dd:0c:90:e3:87,1128567,362,-137,1128205,1128567
273,4,11,1,2412,-83,-92,9,4c:01:43:d7:f3:23,1129613,254,792,1129359,1129613
274,6,6,1,2412,-62,-92,30,52:86:8c:5f:93:1e,1133841,332,3896,1133509,1133841
275,4,1,1,2412,-85,-92,7,3c:bd:c5:ee:96:6d,1135720,2512,-633,1133208,1135720
276,4,1,1,2412,-83,-92,9,78:67:0e:c4:a8:42,1141065,2736,2609,1138329,1141065
277,6,6,1,2412,-60,-92,32,32:86:8c:5f:93:1e,1160567,332,19170,1160235,1160567
278,4,1,1,2412,-57,-92,35,94:a6:7e:c9:98:67,1188271,2464,25240,1185807,1188271
279,6,24,1,2412,-83,-92,9,,1191031,28,2732,1191003,1191031
280,4,11,1,2412,-84,-92,8,4c:01:43:d7:f3:29,1191497,362,104,1191135,1191497
281,4,11,1,2412,-83,-92,9,4c:01:43:d7:f3:23,1191871,322,52,1191549,1191871
282,4,11,1,2412,-83,-92,9,4c:01:43:d7:f3:26,1192206,387,-52,1191819,1192206
283,4,11,1,2412,-71,-92,21,48:dd:0c:7d:86:27,1205799,362,13231,1205437,1205799
284,4,1,1,2412,-90,-92,2,00:26:62:eb:ea:74,1216161,968,9394,1215193,1216161
285,4,11,1,2412,-84,-92,8,4c:01:43:ec:a0:69,1229737,361,13215,1229376,1229737
286,4,11,1,2412,-82,-92,10,4c:01:43:ec:a0:63,1230111,322,52,1229789,1230111
287,4,11,1,2412,-82,-92,10,48:dd:0c:90:e3:87,1230967,362,494,1230605,1230967
288,4,11,1,2412,-82,-92,10,48:dd:0c:90:e3:83,1231341,323,51,1231018,1231341
289,4,11,1,2412,-83,-92,9,48:dd:0c:90:e3:85,1231676,382,-47,1231294,1231676
290,6,6,1,2412,-63,-92,29,52:86:8c:5f:93:1e,1236344,332,4336,1236012,1236344
291,4,1,1,2412,-86,-92,6,78:67:0e:c4:a8:42,1243141,2736,4061,1240405,1243141
292,4,1,1,2412,-88,-92,4,04:a2:22:bf:24:52,1251220,1648,6431,1249572,1251220
293,6,6,1,2412,-62,-92,30,32:86:8c:5f:93:1e,1261841,332,10289,1261509,1261841
294,6,6,1,2412,-62,-92,30,b4:e6:2d:b4:ff:71,1266976,64,5071,1266912,1266976
295,6,6,1,2412,-62,-92,30,,1267057,44,37,1267013,1267057
296,6,24,1,2412,-81,-92,11,,1269905,28,2820,1269877,1269905
297,4,11,1,2412,-82,-92,10,,1270661,107,649,1270554,1270661
298,6,24,1,2412,-81,-92,11,78:67:0e:c4:a8:42,1270774,32,81,1270742,1270774
299,6,24,1,2412,-81,-92,11,,1271233,28,431,1271205,1271233
300,4,1,1,2412,-84,-92,8,78:67:0e:c4:a8:42,1271531,352,-54,1271179,1271531
301,4,1,1,2412,-85,-92,7,78:67:0e:c4:a8:42,1272317,352,434,1271965,1272317
302,4,1,1,2412,-84,-92,8,78:67:0e:c4:a8:42,1273890,352,1221,1273538,1273890
303,4,11,1,2412,-85,-92,7,,1274753,107,756,1274646,1274753
304,6,24,1,2412,-82,-92,10,78:67:0e:c4:a8:42,1274866,32,81,1274834,1274866
305,4,1,1,2412,-71,-92,21,b0:e4:d5:32:ec:8a,1283692,1960,6866,1281732,1283692
306,6,6,1,2412,-61,-92,31,10:86:8c:5f:93:1e,1290035,344,5999,1289691,1290035
307,4,1,1,2412,-62,-92,30,94:a6:7e:c9:98:67,1290669,2464,-1830,1288205,1290669
308,4,11,1,2412,-81,-92,11,4c:01:43:d7:f3:29,1293896,362,2865,1293534,1293896
309,4,11,1,2412,-80,-92,12,4c:01:43:d7:f3:23,1294271,322,53,1293949,1294271
310,4,11,1,2412,-80,-92,12,4c:01:43:d7:f3:26,1294605,387,-53,1294218,1294605
311,4,11,1,2412,-87,-92,5,2c:7e:81:03:6d:19,1304355,347,9403,1304008,1304355
312,6,6,1,2412,-87,-92,5,40:b0:34:b7:01:d5,1311169,576,6238,1310593,1311169
313,6,6,1,2412,-67,-92,25,12:86:8c:5f:93:1e,1313043,332,1542,1312711,1313043
314,4,1,1,2412,-89,-92,3,00:26:62:eb:ea:74,1318562,968,4551,1317594,1318562
315,4,11,1,2412,-87,-92,5,4c:01:43:ec:a0:63,1332510,322,13626,1332188,1332510
316,4,11,1,2412,-86,-92,6,4c:01:43:ec:a0:66,1332844,387,-53,1332457,1332844
317,4,11,1,2412,-83,-92,9,48:dd:0c:90:e3:87,1333367,362,161,1333005,1333367
318,4,11,1,2412,-83,-92,9,48:dd:0c:90:e3:83,1333741,323,51,1333418,1333741
319,4,11,1,2412,-82,-92,10,48:dd:0c:90:e3:85,1334076,382,-47,1333694,1334076
320,6,24,1,2412,-86,-92,6,,1348178,28,14074,1348150,1348178
321,6,24,1,2412,-79,-92,13,,1363398,28,15192,1363370,1363398
322,6,6,1,2412,-64,-92,28,32:86:8c:5f:93:1e,1364243,332,513,1363911,1364243
323,4,1,1,2412,-87,-92,5,ce:f4:11:65:3f:f8,1366018,2072,-297,1363946,1366018
324,6,24,1,2412,-84,-92,8,,1369313,28,3267,1369285,1369313
325,6,6,1,2412,-85,-92,7,,1369511,44,154,1369467,1369511
326,6,6,1,2412,-85,-92,7,,1369703,44,148,1369659,1369703
327,4,1,1,2412,-71,-92,21,b0:e4:d5:32:ec:8a,1386092,1960,14429,1384132,1386092
328,6,6,1,2412,-64,-92,28,10:86:8c:5f:93:1e,1389843,344,3407,1389499,1389843
329,4,1,1,2412,-61,-92,31,94:a6:7e:c9:98:67,1393068,2464,761,1390604,1393068
330,4,11,1,2412,-84,-92,8,4c:01:43:d7:f3:29,1396296,362,2866,1395934,1396296
331,4,11,1,2412,-82,-92,10,4c:01:43:d7:f3:23,1396670,322,52,1396348,1396670
332,4,11,1,2412,-82,-92,10,4c:01:43:d7:f3:26,1397005,387,-52,1396618,1397005
333,4,11,1,2412,-73,-92,19,48:dd:0c:7d:86:23,1410973,323,13645,1410650,1410973
334,4,11,1,2412,-72,-92,20,48:dd:0c:7d:86:25,1411308,382,-47,1410926,1411308
335,6,6,1,2412,-59,-92,33,12:86:8c:5f:93:1e,1415442,332,3802,1415110,1415442
336,4,1,1,2412,-91,-92,1,ac:67:84:84:8a:07,1418856,448,2966,1418408,1418856
337,6,24,1,2412,-85,-92,7,,1430826,28,11942,1430798,1430826
338,4,11,1,2412,-86,-92,6,4c:01:43:ec:a0:66,1435243,387,4030,1434856,1435243
339,4,11,1,2412,-78,-92,14,48:dd:0c:90:e3:87,1435766,362,161,1435404,1435766
340,4,11,1,2412,-78,-92,14,48:dd:0c:90:e3:83,1436141,323,52,1435818,1436141
341,4,11,1,2412,-78,-92,14,48:dd:0c:90:e3:85,1436476,382,-47,1436094,1436476
342,4,11,1,2412,-85,-92,7,,1438158,107,1575,1438051,1438158
343,6,6,1,2412,-60,-92,32,52:86:8c:5f:93:1e,1441044,332,2554,1440712,1441044
344,6,12,1,2412,-84,-92,8,,1441631,32,555,1441599,1441631
345,4,1,1,2412,-78,-92,14,3c:bd:c5:ee:96:6d,1442658,2512,-1485,1440146,1442658
346,4,1,1,2412,-82,-92,10,3c:bd:c5:ee:96:6d,1445196,976,1562,1444220,1445196
347,4,1,1,2412,-79,-92,13,78:67:0e:c4:a8:42,1447941,2736,9,1445205,1447941
348,6,24,1,2412,-79,-92,13,,1450578,28,2609,1450550,1450578
349,4,1,1,2412,-90,-92,2,04:a2:22:bf:24:52,1451969,2512,-1121,1449457,1451969
350,6,6,1,2412,-62,-92,30,32:86:8c:5f:93:1e,1466644,332,14343,1466312,1466644
351,6,24,1,2412,-78,-92,14,,1487274,28,20602,1487246,1487274
352,4,1,1,2412,-66,-92,26,b0:e4:d5:32:ec:8a,1488491,1960,-743,1486531,1488491
353,4,1,1,2412,-61,-92,31,94:a6:7e:c9:98:67,1495468,2464,4513,1493004,1495468
354,4,1,1,2412,-86,-92,6,,1505172,304,9400,1504868,1505172
355,4,11,1,2412,-84,-92,8,,1506099,107,820,1505992,1506099
356,4,1,1,2412,-80,-92,12,78:67:0e:38:6c:d3,1510240,2736,1405,1507504,1510240
357,4,11,1,2412,-77,-92,15,48:dd:0c:7d:86:27,1512999,362,2397,1512637,1512999
358,4,11,1,2412,-76,-92,16,48:dd:0c:7d:86:23,1513374,323,52,1513051,1513374
359,4,11,1,2412,-78,-92,14,48:dd:0c:7d:86:25,1513709,382,-47,1513327,1513709
360,6,6,1,2412,-60,-92,32,12:86:8c:5f:93:1e,1517844,332,3803,1517512,1517844
361,4,1,1,2412,-90,-92,2,ac:67:84:84:8a:07,1521028,416,2768,1520612,1521028
362,6,24,1,2412,-80,-92,12,,1523406,28,2350,1523378,1523406
363,4,1,1,2412,-77,-92,15,00:26:62:eb:ea:74,1525994,968,1620,1525026,1525994
364,4,11,1,2412,-83,-92,9,4c:01:43:ec:a0:69,1536934,361,10579,1536573,1536934
365,4,11,1,2412,-83,-92,9,4c:01:43:ec:a0:63,1537307,322,51,1536985,1537307
366,4,11,1,2412,-83,-92,9,4c:01:43:ec:a0:66,1537642,387,-52,1537255,1537642
367,4,11,1,2412,-79,-92,13,48:dd:0c:90:e3:83,1538541,323,576,1538218,1538541
368,4,11,1,2412,-78,-92,14,48:dd:0c:90:e3:85,1538876,382,-47,1538494,1538876
369,6,6,1,2412,-61,-92,31,52:86:8c:5f:93:1e,1544447,332,5239,1544115,1544447
370,4,1,1,2412,-73,-92,19,78:67:0e:c4:a8:42,1550341,2736,3158,1547605,1550341
371,4,1,1,2412,-77,-92,15,78:67:0e:c4:a8:42,1553159,1488,1330,1551671,1553159
372,4,1,1,2412,-80,-92,12,78:67:0e:c4:a8:42,1554658,1648,-149,1553010,1554658
373,6,6,1,2412,-60,-92,32,32:86:8c:5f:93:1e,1569043,332,14053,1568711,1569043
374,4,1,1,2412,-69,-92,23,b0:e4:d5:32:ec:8a,1590890,1960,19887,1588930,1590890
375,4,11,1,2412,-77,-92,15,,1593993,107,2996,1593886,1593993
376,6,24,1,2412,-76,-92,16,78:67:0e:c4:a8:42,1594107,32,82,1594075,1594107
377,6,6,1,2412,-64,-92,28,10:86:8c:5f:93:1e,1594645,344,194,1594301,1594645
378,4,1,1,2412,-77,-92,15,78:67:0e:c4:a8:42,1596108,352,1111,1595756,1596108
379,4,1,1,2412,-63,-92,29,94:a6:7e:c9:98:67,1597867,2464,-705,1595403,1597867
380,4,11,1,2412,-85,-92,7,4c:01:43:d7:f3:23,1601469,322,3280,1601147,1601469
381,4,11,1,2412,-85,-92,7,4c:01:43:d7:f3:26,1601804,387,-52,1601417,1601804
382,4,11,1,2412,-76,-92,16,,1607720,107,5809,1607613,1607720
383,6,24,1,2412,-75,-92,17,78:67:0e:c4:a8:42,1607833,32,81,1607801,1607833
384,4,11,1,2412,-70,-92,22,48:dd:0c:7d:86:27,1615399,362,7204,1615037,1615399
385,4,11,1,2412,-71,-92,21,48:dd:0c:7d:86:23,1615774,323,52,1615451,1615774
386,4,11,1,2412,-74,-92,18,48:dd:0c:7d:86:25,1616109,382,-47,1615727,1616109
387,4,1,1,2412,-76,-92,16,78:67:0e:c4:a8:42,1619144,352,2683,1618792,1619144
388,4,11,1,2412,-79,-92,13,48:dd:0c:90:e3:87,1640566,362,21060,1640204,1640566
389,4,11,1,2412,-78,-92,14,48:dd:0c:90:e3:83,1640940,323,51,1640617,1640940
390,4,11,1,2412,-78,-92,14,48:dd:0c:90:e3:85,1641275,382,-47,1640893,1641275
391,7,13,1,2412,-82,-92,10,4c:01:43:ec:a0:66,1642085,92,718,1641993,1642085
392,6,24,1,2412,-84,-92,8,,1642528,28,415,1642500,1642528
393,6,24,1,2412,-84,-92,8,,1643095,28,539,1643067,1643095
394,6,24,1,2412,-83,-92,9,,1643673,28,550,1643645,1643673
395,6,24,1,2412,-83,-92,9,,1644386,28,685,1644358,1644386
396,6,12,1,2412,-83,-92,9,4c:01:43:ec:a0:66,1644506,44,76,1644462,1644506
397,6,6,1,2412,-86,-92,6,0a:a7:c0:a3:8d:71,1649031,408,4117,1648623,1649031
398,6,24,1,2412,-73,-92,19,,1650727,28,1668,1650699,1650727
399,4,1,1,2412,-76,-92,16,78:67:0e:c4:a8:42,1652741,2736,-722,1650005,1652741
400,6,24,1,2412,-73,-92,19,,1655734,28,2965,1655706,1655734
401,4,1,1,2412,-92,-92,0,04:a2:22:bf:24:52,1656780,2512,-1466,1654268,1656780
402,6,24,1,2412,-81,-92,11,,1670832,28,14024,1670804,1670832
403,6,6,1,2412,-66,-92,26,32:86:8c:5f:93:1e,1671445,332,281,1671113,1671445
404,6,24,1,2412,-74,-92,18,,1679340,28,7867,1679312,1679340
405,6,24,1,2412,-83,-92,9,,1683557,28,4189,1683529,1683557
406,7,26,1,2412,-91,-92,1,94:9f:3e:53:c1:ef,1687342,76,3709,1687266,1687342
407,4,1,1,2412,-75,-92,17,b0:e4:d5:32:ec:8a,1693289,1960,3987,1691329,1693289
408,6,6,1,2412,-67,-92,25,,1699374,44,6041,1699330,1699374
409,4,1,1,2412,-62,-92,30,94:a6:7e:c9:98:67,1700266,2464,-1572,1697802,1700266
410,6,24,1,2412,-74,-92,18,,1711076,28,10782,1711048,1711076
411,4,1,1,2412,-82,-92,10,78:67:0e:38:6c:d3,1715041,2736,1229,1712305,1715041
412,4,11,1,2412,-71,-92,21,48:dd:0c:7d:86:27,1717800,362,2397,1717438,1717800
413,4,11,1,2412,-70,-92,22,48:dd:0c:7d:86:23,1718175,323,52,1717852,1718175
414,4,11,1,2412,-70,-92,22,48:dd:0c:7d:86:25,1718510,382,-47,1718128,1718510
415,6,6,1,2412,-85,-92,7,40:b0:34:b7:01:d5,1720774,576,1688,1720198,1720774
416,6,6,1,2412,-63,-92,29,12:86:8c:5f:93:1e,1722644,332,1538,1722312,1722644
417,4,1,1,2412,-86,-92,6,d8:9c:8e:01:4c:6a,1727459,3000,1815,1724459,1727459
418,4,1,1,2412,-90,-92,2,00:26:62:eb:ea:74,1735806,968,7379,1734838,1735806
419,6,24,1,2412,-83,-92,9,,1737171,28,1337,1737143,1737171
420,6,24,1,2412,-83,-92,9,,1737407,28,208,1737379,1737407
421,6,24,1,2412,-82,-92,10,,1737991,28,556,1737963,1737991
422,6,24,1,2412,-82,-92,10,,1739123,28,1104,1739095,1739123
423,6,12,1,2412,-83,-92,9,4c:01:43:ec:a0:66,1739263,44,96,1739219,1739263
424,4,11,1,2412,-84,-92,8,4c:01:43:ec:a0:69,1741731,361,2107,1741370,1741731
425,4,11,1,2412,-84,-92,8,4c:01:43:ec:a0:63,1742105,322,52,1741783,1742105
426,4,11,1,2412,-86,-92,6,4c:01:43:ec:a0:66,1742440,387,-52,1742053,1742440
427,4,11,1,2412,-81,-92,11,48:dd:0c:90:e3:87,1742966,362,164,1742604,1742966
428,4,11,1,2412,-80,-92,12,48:dd:0c:90:e3:83,1743340,323,51,1743017,1743340
429,4,11,1,2412,-80,-92,12,48:dd:0c:90:e3:85,1743675,382,-47,1743293,1743675
430,4,11,1,2412,-84,-92,8,,1745354,107,1572,1745247,1745354
431,6,6,1,2412,-63,-92,29,52:86:8c:5f:93:1e,1748246,332,2560,1747914,1748246
432,6,24,1,2412,-82,-92,10,4c:01:43:ec:a0:66,1762227,32,13949,1762195,1762227
433,6,24,1,2412,-83,-92,9,,1763953,28,1698,1763925,1763953
434,6,12,1,2412,-81,-92,11,,1764793,32,808,1764761,1764793
435,6,6,1,2412,-80,-92,12,,1770175,44,5338,1770131,1770175
436,4,1,1,2412,-84,-92,8,,1771317,304,838,1771013,1771317
437,6,24,1,2412,-81,-92,11,4c:01:43:ec:a0:66,1772784,32,1435,1772752,1772784
438,6,6,1,2412,-68,-92,24,32:86:8c:5f:93:1e,1773846,332,730,1773514,1773846
439,6,6,1,2412,-81,-92,11,,1775153,44,1263,1775109,1775153
440,4,1,1,2412,-83,-92,9,78:67:0e:c4:a8:42,1777686,352,2181,1777334,1777686
441,6,24,1,2412,-80,-92,12,,1778107,28,393,1778079,1778107
442,4,1,1,2412,-87,-92,5,78:67:0e:c4:a8:42,1778541,352,82,1778189,1778541
443,6,6,1,2412,-80,-92,12,,1780585,44,2000,1780541,1780585
444,6,12,1,2412,-80,-92,12,4c:01:43:ec:a0:66,1782201,44,1572,1782157,1782201
445,6,6,1,2412,-81,-92,11,,1788636,44,6391,1788592,1788636
446,6,24,1,2412,-84,-92,8,e2:db:d1:d1:b0:4a,1789625,28,961,1789597,1789625
447,6,12,1,2412,-81,-92,11,4c:01:43:ec:a0:66,1791052,44,1383,1791008,1791052
448,6,6,1,2412,-81,-92,11,,1791773,44,677,1791729,1791773
449,6,6,1,2412,-82,-92,10,,1793104,44,1287,1793060,1793104
450,6,24,1,2412,-81,-92,11,,1793482,28,350,1793454,1793482
451,6,6,1,2412,-67,-92,25,10:86:8c:5f:93:1e,1799445,344,5619,1799101,1799445
452,4,1,1,2412,-54,-92,38,94:a6:7e:c9:98:67,1802665,2464,756,1800201,1802665
453,6,6,1,2412,-80,-92,12,,1810972,44,8263,1810928,1810972
454,4,1,1,2412,-84,-92,8,,1813098,304,1822,1812794,1813098
455,4,11,1,2412,-75,-92,17,48:dd:0c:7d:86:27,1817979,362,4519,1817617,1817979
456,4,11,1,2412,-75,-92,17,48:dd:0c:7d:86:23,1818353,323,51,1818030,1818353
457,6,6,1,2412,-76,-92,16,,1823543,44,5146,1823499,1823543
458,4,1,1,2412,-87,-92,5,,1832567,304,8720,1832263,1832567
459,6,24,1,2412,-80,-92,12,,1833368,28,773,1833340,1833368
460,6,12,1,2412,-80,-92,12,,1835641,32,2241,1835609,1835641
461,4,11,1,2412,-80,-92,12,4c:01:43:ec:a0:69,1844130,361,8128,1843769,1844130
462,4,11,1,2412,-81,-92,11,4c:01:43:ec:a0:63,1844504,322,52,1844182,1844504
463,4,11,1,2412,-80,-92,12,4c:01:43:ec:a0:66,1844838,387,-53,1844451,1844838
464,4,11,1,2412,-82,-92,10,48:dd:0c:90:e3:83,1845740,323,579,1845417,1845740
465,4,11,1,2412,-83,-92,9,48:dd:0c:90:e3:85,1846075,382,-47,1845693,1846075
466,4,1,1,2412,-89,-92,3,40:ca:63:2d:74:be,1847516,1896,-455,1845620,1847516
467,4,1,1,2412,-85,-92,7,78:67:0e:c4:a8:42,1857540,2736,7288,1854804,1857540
468,6,24,1,2412,-81,-92,11,,1865231,28,7663,1865203,1865231
469,4,1,1,2412,-75,-92,17,b0:e4:d5:32:ec:8a,1898088,1960,30897,1896128,1898088
470,6,24,1,2412,-80,-92,12,,1900105,28,1989,1900077,1900105
471,6,6,1,2412,-66,-92,26,10:86:8c:5f:93:1e,1901846,344,1397,1901502,1901846
472,4,11,1,2412,-81,-92,11,48:dd:0c:90:e3:83,1903214,254,1114,1902960,1903214
473,4,1,1,2412,-60,-92,32,94:a6:7e:c9:98:67,1905078,2464,-600,1902614,1905078
474,4,11,1,2412,-78,-92,14,4c:01:43:d7:f3:29,1908293,362,2853,1907931,1908293
475,4,11,1,2412,-80,-92,12,4c:01:43:d7:f3:23,1908668,322,53,1908346,1908668
476,4,11,1,2412,-81,-92,11,4c:01:43:d7:f3:26,1909002,387,-53,1908615,1909002
477,4,1,1,2412,-91,-92,1,,1909708,304,402,1909404,1909708
478,6,6,1,2412,-84,-92,8,,1910744,44,992,1910700,1910744
479,6,24,1,2412,-79,-92,13,,1910837,28,65,1910809,1910837
480,6,24,1,2412,-86,-92,6,e2:db:d1:d1:b0:4a,1910931,28,66,1910903,1910931
481,4,11,1,2412,-87,-92,5,48:dd:0c:92:4b:e5,1911995,382,682,1911613,1911995
482,4,1,1,2412,-86,-92,6,,1917015,304,4716,1916711,1917015
483,4,1,1,2412,-83,-92,9,78:67:0e:38:6c:d3,1919841,2736,90,1917105,1919841
484,4,11,1,2412,-69,-92,23,48:dd:0c:7d:86:27,1922601,362,2398,1922239,1922601
485,4,11,1,2412,-69,-92,23,48:dd:0c:7d:86:23,1922975,323,51,1922652,1922975
486,4,11,1,2412,-69,-92,23,48:dd:0c:7d:86:25,1923310,382,-47,1922928,1923310
487,6,24,1,2412,-80,-92,12,,1924116,28,778,1924088,1924116
488,6,24,1,2412,-79,-92,13,,1924972,28,828,1924944,1924972
489,6,6,1,2412,-79,-92,13,40:b0:34:b7:01:d5,1926579,576,1031,1926003,1926579
490,6,6,1,2412,-68,-92,24,12:86:8c:5f:93:1e,1927447,332,536,1927115,1927447
491,4,1,1,2412,-89,-92,3,10:7b:44:eb:35:60,1927946,384,115,1927562,1927946
492,4,1,1,2412,-85,-92,7,,1931447,304,3197,1931143,1931447
493,6,24,1,2412,-79,-92,13,,1937312,28,5837,1937284,1937312
494,4,1,1,2412,-85,-92,7,,1941783,304,4167,1941479,1941783
495,6,6,1,2412,-88,-92,4,,1942012,44,185,1941968,1942012
496,6,24,1,2412,-79,-92,13,,1944919,28,2879,1944891,1944919
497,4,1,1,2412,-87,-92,5,,1946391,304,1168,1946087,1946391
498,4,11,1,2412,-83,-92,9,48:dd:0c:90:e3:87,1947765,362,1012,1947403,1947765
499,4,11,1,2412,-81,-92,11,48:dd:0c:90:e3:83,1948139,323,51,1947816,1948139
500,4,11,1,2412,-81,-92,11,48:dd:0c:90:e3:85,1948475,382,-46,1948093,1948475
501,4,11,1,2412,-79,-92,13,4c:01:43:ec:a0:69,1949598,361,762,1949237,1949598
502,4,11,1,2412,-80,-92,12,4c:01:43:ec:a0:63,1949972,322,52,1949650,1949972
503,4,11,1,2412,-78,-92,14,4c:01:43:ec:a0:66,1950306,387,-53,1949919,1950306
504,6,6,1,2412,-84,-92,8,0a:a7:c0:a3:8d:70,1955747,464,4977,1955283,1955747
505,4,1,1,2412,-82,-92,10,78:67:0e:c4:a8:42,1959940,2736,1457,1957204,1959940
506,4,1,1,2412,-77,-92,15,,1973462,304,13218,1973158,1973462
507,4,1,1,2412,-87,-92,5,04:a2:22:bf:24:52,1976416,432,2522,1975984,1976416
508,6,6,1,2412,-68,-92,24,32:86:8c:5f:93:1e,1978646,332,1898,1978314,1978646
509,6,24,1,2412,-79,-92,13,,1997874,28,19200,1997846,1997874
510,4,1,1,2412,-84,-92,8,,1999990,304,1812,1999686,1999990
511,4,1,1,2412,-74,-92,18,b0:e4:d5:32:ec:8a,2000544,1960,-1406,1998584,2000544
512,6,24,1,2412,-84,-92,8,,2003407,28,2835,2003379,2003407
513,6,6,1,2412,-66,-92,26,10:86:8c:5f:93:1e,2004247,344,496,2003903,2004247
514,4,1,1,2412,-61,-92,31,94:a6:7e:c9:98:67,2007546,2464,835,2005082,2007546
515,4,11,1,2412,-80,-92,12,4c:01:43:d7:f3:29,2010693,362,2785,2010331,2010693
516,4,11,1,2412,-78,-92,14,4c:01:43:d7:f3:23,2011067,322,52,2010745,2011067
517,4,1,1,2412,-66,-92,26,3c:06:30:47:83:74,2013628,416,2145,2013212,2013628
518,4,1,1,2412,-62,-92,30,,2014056,304,124,2013752,2014056
519,4,1,1,2412,-75,-92,17,,2016662,304,2302,2016358,2016662
520,6,24,1,2412,-78,-92,14,,2018541,28,1851,2018513,2018541
521,4,1,1,2412,-76,-92,16,78:67:0e:38:6c:d3,2022242,2736,965,2019506,2022242
522,4,1,1,2412,-72,-92,20,78:67:0e:38:6c:d3,2027422,848,4332,2026574,2027422
523,4,1,1,2412,-72,-92,20,78:67:0e:38:6c:d3,2028281,2208,-1349,2026073,2028281
524,6,6,1,2412,-86,-92,6,e2:db:d1:d1:b0:4d,2041559,408,12870,2041151,2041559
525,4,11,1,2412,-80,-92,12,4c:01:43:ec:a0:69,2048928,361,7008,2048567,2048928
526,4,11,1,2412,-81,-92,11,4c:01:43:ec:a0:63,2049302,322,52,2048980,2049302
527,4,11,1,2412,-80,-92,12,4c:01:43:ec:a0:66,2049636,387,-53,2049249,2049636
528,6,6,1,2412,-86,-92,6,,2050096,44,416,2050052,2050096
529,4,11,1,2412,-83,-92,9,48:dd:0c:90:e3:87,2050561,362,103,2050199,2050561
530,4,11,1,2412,-81,-92,11,48:dd:0c:90:e3:85,2051270,382,327,2050888,2051270
531,6,6,1,2412,-86,-92,6,,2053412,44,2098,2053368,2053412
532,6,6,1,2412,-66,-92,26,52:86:8c:5f:93:1e,2055447,332,1703,2055115,2055447
533,6,6,1,2412,-85,-92,7,0a:a7:c0:a3:8d:70,2058258,464,2347,2057794,2058258
534,6,6,1,2412,-85,-92,7,0a:a7:c0:a3:8d:71,2058746,408,80,2058338,2058746
535,6,6,1,2412,-86,-92,6,0a:a7:c0:a3:8d:73,2059196,408,42,2058788,2059196
536,6,6,1,2412,-85,-92,7,0a:a7:c0:a3:8d:75,2059628,408,24,2059220,2059628
537,4,1,1,2412,-83,-92,9,78:67:0e:c4:a8:42,2062340,2736,-24,2059604,2062340
538,4,1,1,2412,-91,-92,1,04:a2:22:bf:24:52,2066394,2512,1542,2063882,2066394
539,6,24,1,2412,-83,-92,9,,2071093,28,4671,2071065,2071093
540,6,24,1,2412,-88,-92,4,e2:db:d1:d1:b0:4a,2075296,28,4175,2075268,2075296
541,6,6,1,2412,-87,-92,5,,2075533,44,193,2075489,2075533
542,6,6,1,2412,-84,-92,8,,2078002,44,2425,2077958,2078002
543,6,6,1,2412,-88,-92,4,,2079904,44,1858,2079860,2079904
544,6,6,1,2412,-87,-92,5,,2080037,44,89,2079993,2080037
545,6,6,1,2412,-64,-92,28,32:86:8c:5f:93:1e,2081048,332,679,2080716,2081048
546,6,24,1,2412,-87,-92,5,,2081737,28,661,2081709,2081737
547,6,6,1,2412,-87,-92,5,e2:db:d1:d1:b0:4a,2081872,68,67,2081804,2081872
548,6,24,1,2412,-83,-92,9,,2083410,28,1510,2083382,2083410
549,6,24,1,2412,-87,-92,5,e2:db:d1:d1:b0:4a,2089753,28,6315,2089725,2089753
550,6,6,1,2412,-86,-92,6,,2089990,44,193,2089946,2089990
551,6,24,1,2412,-81,-92,11,,2099290,28,9272,2099262,2099290
552,4,11,1,2412,-81,-92,11,4c:01:43:d7:f3:23,2113467,322,13855,2113145,2113467
553,4,11,1,2412,-85,-92,7,4c:01:43:d7:f3:26,2113801,387,-53,2113414,2113801
554,4,11,1,2412,-65,-92,27,48:dd:0c:7d:86:23,2119960,277,5882,2119683,2119960
555,4,11,1,2412,-78,-92,14,48:dd:0c:90:e3:83,2120868,284,624,2120584,2120868
556,4,1,1,2412,-88,-92,4,9c:c9:eb:c0:93:63,2121507,2720,-2081,2118787,2121507
557,4,11,1,2412,-65,-92,27,48:dd:0c:7d:86:23,2127775,323,5945,2127452,2127775
558,4,11,1,2412,-64,-92,28,48:dd:0c:7d:86:25,2128110,382,-47,2127728,2128110
559,6,24,1,2412,-86,-92,6,,2131784,28,3646,2131756,2131784
560,6,6,1,2412,-84,-92,8,,2132064,44,236,2132020,2132064
561,6,6,1,2412,-65,-92,27,12:86:8c:5f:93:1e,2132247,332,-149,2131915,2132247
562,6,6,1,2412,-83,-92,9,e2:db:d1:d1:b0:4a,2143039,444,10348,2142595,2143039
563,6,6,1,2412,-85,-92,7,e2:db:d1:d1:b0:4f,2144425,408,978,2144017,2144425
564,6,6,1,2412,-86,-92,6,e2:db:d1:d1:b0:4a,2144866,168,273,2144698,2144866
565,6,6,1,2412,-86,-92,6,e2:db:d1:d1:b0:4a,2145067,196,5,2144871,2145067
566,6,6,1,2412,-86,-92,6,e2:db:d1:d1:b0:4a,2145296,168,61,2145128,2145296
567,6,6,1,2412,-86,-92,6,e2:db:d1:d1:b0:4a,2145497,196,5,2145301,2145497
568,6,6,1,2412,-86,-92,6,e2:db:d1:d1:b0:4a,2145726,188,41,2145538,2145726
569,6,6,1,2412,-85,-92,7,e2:db:d1:d1:b0:4a,2145946,160,60,2145786,2145946
570,6,6,1,2412,-86,-92,6,e2:db:d1:d1:b0:4a,2146139,188,5,2145951,2146139
571,6,6,1,2412,-87,-92,5,e2:db:d1:d1:b0:4a,2146360,160,61,2146200,2146360
572,6,6,1,2412,-86,-92,6,e2:db:d1:d1:b0:4a,2146553,308,-115,2146245,2146553
573,6,6,1,2412,-84,-92,8,3c:bd:c5:ee:96:6d,2150752,68,4131,2150684,2150752
574,6,24,1,2412,-80,-92,12,,2150838,28,58,2150810,2150838
575,4,11,1,2412,-76,-92,16,48:dd:0c:90:e3:87,2152564,362,1364,2152202,2152564
576,4,11,1,2412,-75,-92,17,48:dd:0c:90:e3:83,2152939,323,52,2152616,2152939
577,6,24,1,2412,-76,-92,16,,2155705,28,2738,2155677,2155705
578,6,6,1,2412,-63,-92,29,52:86:8c:5f:93:1e,2157941,332,1904,2157609,2157941
579,6,6,1,2412,-85,-92,7,e2:db:d1:d1:b0:4a,2163152,68,5143,2163084,2163152
580,4,1,1,2412,-71,-92,21,78:67:0e:c4:a8:42,2167514,848,3514,2166666,2167514
581,6,24,1,2412,-84,-92,8,3c:bd:c5:ee:96:6d,2174711,28,7169,2174683,2174711
582,6,6,1,2412,-84,-92,8,,2174989,44,234,2174945,2174989
583,6,6,1,2412,-85,-92,7,3c:bd:c5:ee:96:6d,2176960,68,1903,2176892,2176960
584,4,1,1,2412,-89,-92,3,,2178590,304,1326,2178286,2178590
585,6,6,1,2412,-64,-92,28,32:86:8c:5f:93:1e,2183448,332,4526,2183116,2183448
586,4,1,1,2412,-84,-92,8,,2189193,304,5441,2188889,2189193
587,6,24,1,2412,-76,-92,16,,2198353,28,9132,2198325,2198353
588,6,24,1,2412,-76,-92,16,,2203843,28,5462,2203815,2203843
589,4,1,1,2412,-74,-92,18,78:67:0e:c4:a8:42,2205667,352,1472,2205315,2205667
590,4,11,1,2412,-76,-92,16,,2207897,107,2123,2207790,2207897
591,6,6,1,2412,-65,-92,27,10:86:8c:5f:93:1e,2209048,344,807,2208704,2209048
592,4,1,1,2412,-57,-92,35,94:a6:7e:c9:98:67,2212268,2464,756,2209804,2212268
593,4,11,1,2412,-85,-92,7,4c:01:43:d7:f3:23,2216162,322,3572,2215840,2216162
594,4,11,1,2412,-84,-92,8,4c:01:43:d7:f3:26,2216497,387,-52,2216110,2216497
595,4,11,1,2412,-85,-92,7,48:dd:0c:92:4b:e5,2219195,382,2316,2218813,2219195
596,4,1,1,2412,-92,-92,0,9c:c9:eb:c0:93:63,2223905,2720,1990,2221185,2223905
597,4,1,1,2412,-84,-92,8,78:67:0e:38:6c:d3,2227042,2736,401,2224306,2227042
598,4,11,1,2412,-74,-92,18,48:dd:0c:7d:86:27,2229801,362,2397,2229439,2229801
599,4,11,1,2412,-74,-92,18,48:dd:0c:7d:86:23,2230176,323,52,2229853,2230176
600,4,11,1,2412,-73,-92,19,48:dd:0c:7d:86:25,2230511,382,-47,2230129,2230511
601,6,6,1,2412,-67,-92,25,12:86:8c:5f:93:1e,2234649,332,3806,2234317,2234649
602,4,1,1,2412,-89,-92,3,70:3a:cb:63:35:b2,2235211,2216,-1654,2232995,2235211
603,6,6,1,2412,-82,-92,10,e2:db:d1:d1:b0:4a,2247859,156,12492,2247703,2247859
604,6,6,1,2412,-83,-92,9,e2:db:d1:d1:b0:4a,2248048,632,-443,2247416,2248048
605,6,6,1,2412,-84,-92,8,e2:db:d1:d1:b0:4a,2248713,656,9,2248057,2248713
606,6,6,1,2412,-83,-92,9,,2249472,44,715,2249428,2249472
607,4,11,1,2412,-78,-92,14,48:dd:0c:90:e3:83,2255339,323,5544,2255016,2255339
608,4,11,1,2412,-80,-92,12,48:dd:0c:90:e3:85,2255674,382,-47,2255292,2255674
609,4,11,1,2412,-79,-92,13,,2270336,107,14555,2270229,2270336
610,6,24,1,2412,-81,-92,11,78:67:0e:c4:a8:42,2270449,32,81,2270417,2270449
611,4,1,1,2412,-80,-92,12,78:67:0e:c4:a8:42,2278994,352,8193,2278642,2278994
612,4,11,1,2412,-78,-92,14,,2280786,107,1685,2280679,2280786
613,6,24,1,2412,-80,-92,12,78:67:0e:c4:a8:42,2280899,32,81,2280867,2280899
614,6,24,1,2412,-82,-92,10,,2281223,28,296,2281195,2281223
615,6,6,1,2412,-66,-92,26,32:86:8c:5f:93:1e,2285848,332,4293,2285516,2285848
616,4,11,1,2412,-91,-92,1,48:dd:0c:90:e3:83,2288200,254,2098,2287946,2288200
617,4,1,1,2412,-72,-92,20,b0:e4:d5:32:ec:8a,2307685,1960,17525,2305725,2307685
618,6,6,1,2412,-62,-92,30,10:86:8c:5f:93:1e,2311450,344,3421,2311106,2311450
619,4,1,1,2412,-52,-92,40,94:a6:7e:c9:98:67,2314683,2464,769,2312219,2314683
620,4,11,1,2412,-92,-92,0,48:dd:0c:92:4b:e7,2320885,362,5840,2320523,2320885
621,4,1,1,2412,-91,-92,1,9c:c9:eb:c0:93:63,2326306,2720,2701,2323586,2326306
622,6,6,1,2412,-85,-92,7,40:b0:34:b7:01:d5,2335180,576,8298,2334604,2335180
623,6,6,1,2412,-65,-92,27,12:86:8c:5f:93:1e,2337049,332,1537,2336717,2337049
624,6,24,1,2412,-82,-92,10,,2346556,28,9479,2346528,2346556
625,6,6,1,2412,-84,-92,8,e2:db:d1:d1:b0:4a,2347859,444,859,2347415,2347859
626,6,6,1,2412,-83,-92,9,e2:db:d1:d1:b0:4b,2348336,408,69,2347928,2348336
627,6,6,1,2412,-85,-92,7,e2:db:d1:d1:b0:4d,2348786,408,42,2348378,2348786
628,4,1,1,2412,-86,-92,6,00:26:62:eb:ea:74,2349778,968,24,2348810,2349778
629,6,6,1,2412,-84,-92,8,,2350796,44,974,2350752,2350796
630,4,11,1,2412,-85,-92,7,4c:01:43:ec:a0:66,2356833,387,5650,2356446,2356833
631,4,11,1,2412,-73,-92,19,48:dd:0c:90:e3:87,2357364,362,169,2357002,2357364
632,4,11,1,2412,-73,-92,19,48:dd:0c:90:e3:83,2357738,323,51,2357415,2357738
633,6,6,1,2412,-84,-92,8,0a:a7:c0:a3:8d:70,2365682,464,7480,2365218,2365682
634,6,6,1,2412,-86,-92,6,0a:a7:c0:a3:8d:71,2366169,408,79,2365761,2366169
635,6,6,1,2412,-85,-92,7,0a:a7:c0:a3:8d:73,2366629,408,52,2366221,2366629
636,4,1,1,2412,-92,-92,0,48:a6:b8:49:4e:15,2396709,432,29648,2396277,2396709
637,4,1,1,2412,-92,-92,0,ac:67:84:84:8a:07,2402765,416,5640,2402349,2402765
638,6,24,1,2412,-82,-92,10,,2408344,28,5551,2408316,2408344
639,6,6,1,2412,-68,-92,24,10:86:8c:5f:93:1e,2413849,344,5161,2413505,2413849
640,4,1,1,2412,-55,-92,37,94:a6:7e:c9:98:67,2417061,2464,748,2414597,2417061
641,4,11,1,2412,-84,-92,8,4c:01:43:d7:f3:29,2420414,362,2991,2420052,2420414
642,4,11,1,2412,-83,-92,9,4c:01:43:d7:f3:23,2420789,322,53,2420467,2420789
643,4,11,1,2412,-73,-92,19,48:dd:0c:7d:86:27,2434611,362,13460,2434249,2434611
644,4,11,1,2412,-73,-92,19,48:dd:0c:7d:86:23,2434985,323,51,2434662,2434985
645,4,11,1,2412,-73,-92,19,48:dd:0c:7d:86:25,2435320,382,-47,2434938,2435320
646,6,24,1,2412,-83,-92,9,,2436942,28,1594,2436914,2436942
647,6,6,1,2412,-80,-92,12,40:b0:34:b7:01:d5,2437581,576,63,2437005,2437581
648,6,6,1,2412,-68,-92,24,12:86:8c:5f:93:1e,2439449,332,1536,2439117,2439449
649,6,6,1,2412,-86,-92,6,e2:db:d1:d1:b0:4a,2450237,444,10344,2449793,2450237
650,6,6,1,2412,-87,-92,5,e2:db:d1:d1:b0:4f,2451614,408,969,2451206,2451614
651,4,11,1,2412,-87,-92,5,4c:01:43:ec:a0:63,2458897,322,6961,2458575,2458897
652,4,11,1,2412,-79,-92,13,48:dd:0c:90:e3:87,2459764,362,505,2459402,2459764
653,4,11,1,2412,-78,-92,14,48:dd:0c:90:e3:83,2460138,323,51,2459815,2460138
654,4,11,1,2412,-79,-92,13,48:dd:0c:90:e3:85,2460473,382,-47,2460091,2460473
655,6,6,1,2412,-69,-92,23,52:86:8c:5f:93:1e,2465140,332,4335,2464808,2465140
656,6,6,1,2412,-83,-92,9,0a:a7:c0:a3:8d:75,2469162,408,3614,2468754,2469162
657,6,24,1,2412,-85,-92,7,,2470843,28,1653,2470815,2470843
658,4,1,1,2412,-83,-92,9,78:67:0e:c4:a8:42,2471940,2736,-1639,2469204,2471940
659,4,1,1,2412,-90,-92,2,04:a2:22:bf:24:52,2475977,2512,1525,2473465,2475977
660,4,1,1,2412,-79,-92,13,04:a2:22:bf:24:52,2478839,912,1950,2477927,2478839
661,6,24,1,2412,-87,-92,5,,2484467,28,5600,2484439,2484467
662,6,6,1,2412,-69,-92,23,32:86:8c:5f:93:1e,2490650,332,5851,2490318,2490650
663,6,24,1,2412,-79,-92,13,,2497876,28,7198,2497848,2497876
664,6,24,1,2412,-79,-92,13,,2508823,28,10919,2508795,2508823
665,6,6,1,2412,-71,-92,21,10:86:8c:5f:93:1e,2516250,344,7083,2515906,2516250
666,4,1,1,2412,-59,-92,33,94:a6:7e:c9:98:67,2519460,2464,746,2516996,2519460
667,4,11,1,2412,-86,-92,6,4c:01:43:d7:f3:23,2523065,322,3283,2522743,2523065
668,4,11,1,2412,-84,-92,8,4c:01:43:d7:f3:26,2523400,387,-52,2523013,2523400
669,4,1,1,2412,-88,-92,4,,2524825,304,1121,2524521,2524825
670,4,11,1,2412,-87,-92,5,48:dd:0c:92:4b:e7,2525684,362,497,2525322,2525684
671,4,11,1,2412,-87,-92,5,48:dd:0c:92:4b:e3,2526059,323,52,2525736,2526059
672,4,11,1,2412,-77,-92,15,48:dd:0c:7d:86:27,2537002,362,10581,2536640,2537002
673,4,11,1,2412,-79,-92,13,48:dd:0c:7d:86:23,2537376,323,51,2537053,2537376
674,4,11,1,2412,-80,-92,12,48:dd:0c:7d:86:25,2537711,382,-47,2537329,2537711
675,6,6,1,2412,-85,-92,7,3c:bd:c5:ee:96:6d,2538642,68,863,2538574,2538642
676,6,6,1,2412,-79,-92,13,40:b0:34:b7:01:d5,2539982,576,764,2539406,2539982
677,6,6,1,2412,-67,-92,25,12:86:8c:5f:93:1e,2541851,332,1537,2541519,2541851
678,4,1,1,2412,-89,-92,3,70:3a:cb:63:35:b2,2542410,2216,-1657,2540194,2542410
679,6,24,1,2412,-80,-92,12,,2551666,28,9228,2551638,2551666
680,6,6,1,2412,-83,-92,9,e2:db:d1:d1:b0:4d,2553596,408,1522,2553188,2553596
681,6,6,1,2412,-84,-92,8,e2:db:d1:d1:b0:4f,2554037,408,33,2553629,2554037
682,4,11,1,2412,-82,-92,10,4c:01:43:ec:a0:69,2560922,361,6524,2560561,2560922
683,4,11,1,2412,-84,-92,8,4c:01:43:ec:a0:66,2561630,387,321,2561243,2561630
684,4,11,1,2412,-80,-92,12,48:dd:0c:90:e3:87,2562163,362,171,2561801,2562163
685,4,11,1,2412,-81,-92,11,48:dd:0c:90:e3:83,2562538,323,52,2562215,2562538
686,4,11,1,2412,-81,-92,11,48:dd:0c:90:e3:85,2562873,382,-47,2562491,2562873
687,6,24,1,2412,-82,-92,10,,2563420,28,519,2563392,2563420
688,6,24,1,2412,-84,-92,8,,2581030,28,17582,2581002,2581030
689,6,6,1,2412,-84,-92,8,,2581150,44,76,2581106,2581150
690,6,24,1,2412,-82,-92,10,,2587280,28,6102,2587252,2587280
691,6,6,1,2412,-63,-92,29,32:86:8c:5f:93:1e,2593051,332,5439,2592719,2593051
692,6,24,1,2412,-82,-92,10,e2:db:d1:d1:b0:4a,2601076,28,7997,2601048,2601076
693,6,24,1,2412,-83,-92,9,e2:db:d1:d1:b0:4a,2601471,28,367,2601443,2601471
694,6,6,1,2412,-84,-92,8,e2:db:d1:d1:b0:4a,2601790,52,267,2601738,2601790
695,6,6,1,2412,-83,-92,9,e2:db:d1:d1:b0:4a,2602196,52,354,2602144,2602196
696,6,6,1,2412,-84,-92,8,e2:db:d1:d1:b0:4a,2604541,52,2293,2604489,2604541
697,6,24,1,2412,-84,-92,8,e2:db:d1:d1:b0:4a,2605578,28,1009,2605550,2605578
698,6,24,1,2412,-82,-92,10,e2:db:d1:d1:b0:4a,2610227,28,4621,2610199,2610227
699,6,6,1,2412,-83,-92,9,e2:db:d1:d1:b0:4a,2610949,52,670,2610897,2610949
700,7,28.8889,1,2412,-82,-92,10,e2:db:d1:d1:b0:4a,2611080,122,9,2610958,2611080
701,6,6,1,2412,-83,-92,9,,2611269,44,145,2611225,2611269
702,6,24,1,2412,-83,-92,9,e2:db:d1:d1:b0:4a,2612396,28,1099,2612368,2612396
703,6,24,1,2412,-83,-92,9,e2:db:d1:d1:b0:4a,2612762,28,338,2612734,2612762
704,6,6,1,2412,-83,-92,9,,2613476,44,670,2613432,2613476
705,6,24,1,2412,-83,-92,9,e2:db:d1:d1:b0:4a,2614034,28,530,2614006,2614034
706,6,6,1,2412,-63,-92,29,10:86:8c:5f:93:1e,2618651,344,4273,2618307,2618651
707,4,1,1,2412,-56,-92,36,94:a6:7e:c9:98:67,2621860,2464,745,2619396,2621860
708,4,1,1,2412,-57,-92,35,94:a6:7e:c9:98:67,2624415,1888,667,2622527,2624415
709,6,24,1,2412,-82,-92,10,e2:db:d1:d1:b0:4a,2626270,28,1827,2626242,2626270
710,6,24,1,2412,-81,-92,11,e2:db:d1:d1:b0:4a,2626659,28,361,2626631,2626659
711,4,11,1,2412,-84,-92,8,48:dd:0c:92:4b:e7,2628084,362,1063,2627722,2628084
712,4,11,1,2412,-86,-92,6,48:dd:0c:92:4b:e3,2628459,323,52,2628136,2628459
713,4,11,1,2412,-87,-92,5,48:dd:0c:92:4b:e5,2628794,382,-47,2628412,2628794
714,6,24,1,2412,-81,-92,11,,2630843,28,2021,2630815,2630843
715,4,11,1,2412,-85,-92,7,48:dd:0c:92:4b:e5,2631765,377,545,2631388,2631765
716,4,11,1,2412,-77,-92,15,48:dd:0c:7d:86:27,2639402,362,7275,2639040,2639402
717,4,11,1,2412,-76,-92,16,48:dd:0c:7d:86:23,2639777,323,52,2639454,2639777
718,4,11,1,2412,-75,-92,17,48:dd:0c:7d:86:25,2640112,382,-47,2639730,2640112
719,4,11,1,2412,-75,-92,17,48:dd:0c:7d:86:25,2641834,377,1345,2641457,2641834
720,6,6,1,2412,-84,-92,8,40:b0:34:b7:01:d5,2642388,576,-22,2641812,2642388
721,4,11,1,2412,-73,-92,19,48:dd:0c:90:e3:85,2643182,377,417,2642805,2643182
722,6,24,1,2412,-82,-92,10,,2643421,28,211,2643393,2643421
723,6,6,1,2412,-64,-92,28,12:86:8c:5f:93:1e,2644251,332,498,2643919,2644251
724,6,6,1,2412,-81,-92,11,,2644720,44,425,2644676,2644720
725,6,24,1,2412,-82,-92,10,,2654449,28,9701,2654421,2654449
726,6,6,1,2412,-81,-92,11,e2:db:d1:d1:b0:4a,2657195,160,2586,2657035,2657195
727,6,6,1,2412,-82,-92,10,e2:db:d1:d1:b0:4a,2657460,188,77,2657272,2657460
728,6,6,1,2412,-82,-92,10,e2:db:d1:d1:b0:4a,2658017,200,357,2657817,2658017
729,4,11,1,2412,-74,-92,18,48:dd:0c:90:e3:83,2664938,323,6598,2664615,2664938
730,4,11,1,2412,-72,-92,20,48:dd:0c:90:e3:85,2665273,382,-47,2664891,2665273
731,6,6,1,2412,-64,-92,28,52:86:8c:5f:93:1e,2669851,332,4246,2669519,2669851
732,4,1,1,2412,-83,-92,9,78:67:0e:c4:a8:42,2676740,2736,4153,2674004,2676740
733,4,1,1,2412,-85,-92,7,3c:bd:c5:ee:96:6d,2708541,3280,28521,2705261,2708541
734,4,1,1,2412,-88,-92,4,3c:bd:c5:ee:96:6d,2712214,3280,393,2708934,2712214
735,4,1,1,2412,-89,-92,3,3c:bd:c5:ee:96:6d,2716232,3280,738,2712952,2716232
736,4,1,1,2412,-75,-92,17,b0:e4:d5:32:ec:8a,2719848,1960,1656,2717888,2719848
737,6,6,1,2412,-66,-92,26,10:86:8c:5f:93:1e,2721664,344,1472,2721320,2721664
738,4,1,1,2412,-56,-92,36,94:a6:7e:c9:98:67,2723847,2464,-281,2721383,2723847
739,4,1,1,2412,-92,-92,0,9c:c9:eb:c0:93:63,2735909,2720,9342,2733189,2735909
740,4,11,1,2412,-69,-92,23,48:dd:0c:7d:86:27,2741802,362,5531,2741440,2741802
741,4,11,1,2412,-69,-92,23,48:dd:0c:7d:86:23,2742177,323,52,2741854,2742177
742,4,11,1,2412,-70,-92,22,48:dd:0c:7d:86:25,2742512,382,-47,2742130,2742512
743,6,6,1,2412,-85,-92,7,40:b0:34:b7:01:d5,2744784,576,1696,2744208,2744784
744,6,6,1,2412,-70,-92,22,12:86:8c:5f:93:1e,2746652,332,1536,2746320,2746652
745,6,24,1,2412,-76,-92,16,,2751921,28,5241,2751893,2751921
746,4,1,1,2412,-85,-92,7,00:26:62:eb:ea:74,2756520,968,3631,2755552,2756520
747,6,6,1,2412,-73,-92,19,e2:db:d1:d1:b0:4a,2757594,444,630,2757150,2757594
748,6,6,1,2412,-85,-92,7,e2:db:d1:d1:b0:4b,2758070,408,68,2757662,2758070
749,4,11,1,2412,-87,-92,5,4c:01:43:ec:a0:69,2765720,361,7289,2765359,2765720
750,4,11,1,2412,-86,-92,6,4c:01:43:ec:a0:63,2766094,322,52,2765772,2766094
751,4,11,1,2412,-76,-92,16,48:dd:0c:90:e3:87,2766963,362,507,2766601,2766963
752,4,11,1,2412,-76,-92,16,48:dd:0c:90:e3:83,2767337,323,51,2767014,2767337
753,4,11,1,2412,-75,-92,17,48:dd:0c:90:e3:85,2767673,382,-46,2767291,2767673
754,4,1,1,2412,-77,-92,15,78:67:0e:c4:a8:42,2779139,2736,8730,2776403,2779139
755,6,24,1,2412,-78,-92,14,,2787280,28,8113,2787252,2787280
756,6,24,1,2412,-84,-92,8,,2790850,28,3542,2790822,2790850
757,4,11,1,2412,-84,-92,8,4c:01:43:d7:f3:23,2795956,254,4852,2795702,2795956
758,4,11,1,2412,-83,-92,9,4c:01:43:ec:a0:63,2796961,254,751,2796707,2796961
759,6,6,1,2412,-72,-92,20,32:86:8c:5f:93:1e,2797853,332,560,2797521,2797853
760,4,1,1,2412,-91,-92,1,ce:f4:11:65:3f:f8,2799616,2072,-309,2797544,2799616
761,6,24,1,2412,-83,-92,9,,2804156,28,4512,2804128,2804156
762,6,24,1,2412,-80,-92,12,,2807580,28,3396,2807552,2807580
763,4,1,1,2412,-80,-92,12,78:67:0e:c4:a8:42,2809195,352,1263,2808843,2809195
764,4,11,1,2412,-81,-92,11,,2811108,107,1806,2811001,2811108
765,6,24,1,2412,-82,-92,10,78:67:0e:c4:a8:42,2811221,32,81,2811189,2811221
766,4,1,1,2412,-94,-92,-2,40:ca:63:2d:74:be,2815150,1688,2241,2813462,2815150
767,4,1,1,2412,-70,-92,22,b0:e4:d5:32:ec:8a,2819681,1960,2571,2817721,2819681
768,4,1,1,2412,-54,-92,38,94:a6:7e:c9:98:67,2826671,2464,4526,2824207,2826671
769,4,11,1,2412,-86,-92,6,4c:01:43:d7:f3:26,2830598,387,3540,2830211,2830598
770,4,11,1,2412,-86,-92,6,48:dd:0c:92:4b:e7,2832884,362,1924,2832522,2832884
771,4,1,1,2412,-89,-92,3,10:7b:44:eb:35:60,2834378,1960,-466,2832418,2834378
772,4,1,1,2412,-79,-92,13,78:67:0e:38:6c:d3,2841443,2736,4329,2838707,2841443
773,4,11,1,2412,-71,-92,21,48:dd:0c:7d:86:27,2844202,362,2397,2843840,2844202
774,4,11,1,2412,-72,-92,20,48:dd:0c:7d:86:23,2844576,323,51,2844253,2844576
775,4,11,1,2412,-71,-92,21,48:dd:0c:7d:86:25,2844912,382,-46,2844530,2844912
776,6,6,1,2412,-70,-92,22,12:86:8c:5f:93:1e,2849053,332,3809,2848721,2849053
777,4,1,1,2412,-90,-92,2,ac:67:84:84:8a:07,2854310,448,4809,2853862,2854310
778,4,1,1,2412,-87,-92,5,00:26:62:eb:ea:74,2857169,968,1891,2856201,2857169
779,4,1,1,2412,-86,-92,6,00:26:62:eb:ea:74,2858166,912,85,2857254,2858166
780,6,6,1,2412,-86,-92,6,e2:db:d1:d1:b0:4a,2859866,444,1256,2859422,2859866
781,6,6,1,2412,-88,-92,4,e2:db:d1:d1:b0:4d,2860766,408,492,2860358,2860766
782,6,6,1,2412,-87,-92,5,e2:db:d1:d1:b0:4f,2861198,408,24,2860790,2861198
783,6,6,1,2412,-87,-92,5,,2863545,44,2303,2863501,2863545
784,4,11,1,2412,-83,-92,9,4c:01:43:ec:a0:69,2868119,361,4213,2867758,2868119
785,4,11,1,2412,-82,-92,10,4c:01:43:ec:a0:63,2868493,322,52,2868171,2868493
786,4,11,1,2412,-85,-92,7,4c:01:43:ec:a0:66,2868827,387,-53,2868440,2868827
787,4,11,1,2412,-84,-92,8,48:dd:0c:90:e3:87,2869363,362,174,2869001,2869363
788,4,11,1,2412,-78,-92,14,48:dd:0c:90:e3:83,2869737,323,51,2869414,2869737
789,4,11,1,2412,-80,-92,12,48:dd:0c:90:e3:85,2870072,382,-47,2869690,2870072
790,6,24,1,2412,-85,-92,7,,2870849,28,749,2870821,2870849
791,6,24,1,2412,-84,-92,8,,2871108,28,231,2871080,2871108
792,6,6,1,2412,-84,-92,8,0a:a7:c0:a3:8d:70,2877701,464,6129,2877237,2877701
793,4,1,1,2412,-83,-92,9,78:67:0e:c4:a8:42,2881539,2736,1102,2878803,2881539
794,4,1,1,2412,-91,-92,1,,2899953,304,18110,2899649,2899953
795,6,6,1,2412,-72,-92,20,32:86:8c:5f:93:1e,2900252,332,-33,2899920,2900252
796,4,1,1,2412,-72,-92,20,,2902212,304,1656,2901908,2902212
797,6,6,1,2412,-86,-92,6,3c:bd:c5:ee:96:6d,2903480,68,1200,2903412,2903480
798,6,24,1,2412,-84,-92,8,,2903833,28,325,2903805,2903833
799,6,6,1,2412,-86,-92,6,3c:bd:c5:ee:96:6d,2904781,68,880,2904713,2904781
800,6,6,1,2412,-85,-92,7,3c:bd:c5:ee:96:6d,2918960,68,14111,2918892,2918960
801,4,1,1,2412,-56,-92,36,94:a6:7e:c9:98:67,2929081,2464,7657,2926617,2929081
802,4,11,1,2412,-83,-92,9,4c:01:43:d7:f3:23,2932663,322,3260,2932341,2932663
803,4,1,1,2412,-82,-92,10,,2942328,304,9361,2942024,2942328
804,4,1,1,2412,-81,-92,11,78:67:0e:38:6c:d3,2943844,2736,-1220,2941108,2943844
805,4,11,1,2412,-72,-92,20,48:dd:0c:7d:86:27,2946603,362,2397,2946241,2946603
806,6,6,1,2412,-84,-92,8,40:b0:34:b7:01:d5,2949587,576,2408,2949011,2949587
807,6,24,1,2412,-84,-92,8,,2950847,28,1232,2950819,2950847
808,6,6,1,2412,-71,-92,21,12:86:8c:5f:93:1e,2951454,332,275,2951122,2951454
809,6,6,1,2412,-85,-92,7,e2:db:d1:d1:b0:4f,2963654,408,11792,2963246,2963654
810,6,6,1,2412,-84,-92,8,,2964876,44,1178,2964832,2964876
811,4,11,1,2412,-82,-92,10,4c:01:43:ec:a0:66,2971226,387,5963,2970839,2971226
812,4,11,1,2412,-77,-92,15,48:dd:0c:90:e3:87,2971762,362,174,2971400,2971762
813,4,11,1,2412,-77,-92,15,48:dd:0c:90:e3:83,2972137,323,52,2971814,2972137
814,4,11,1,2412,-60,-92,32,48:dd:0c:90:e3:85,2972472,382,-47,2972090,2972472
815,6,6,1,2412,-68,-92,24,52:86:8c:5f:93:1e,2977129,332,4325,2976797,2977129
816,6,24,1,2412,-82,-92,10,,2981532,28,4375,2981504,2981532
817,6,6,1,2412,-84,-92,8,0a:a7:c0:a3:8d:70,2981616,464,-380,2981152,2981616
818,4,1,1,2412,-89,-92,3,78:67:0e:c4:a8:42,2983939,2736,-413,2981203,2983939
819,6,6,1,2412,-86,-92,6,,2987808,44,3825,2987764,2987808
820,6,6,1,2412,-86,-92,6,e2:db:d1:d1:b0:4a,2990538,52,2678,2990486,2990538
821,6,6,1,2412,-85,-92,7,,2990917,44,335,2990873,2990917
822,6,24,1,2412,-86,-92,6,,3003621,28,12676,3003593,3003621
823,6,6,1,2412,-85,-92,7,e2:db:d1:d1:b0:4a,3003973,68,284,3003905,3003973
824,6,6,1,2412,-86,-92,6,e2:db:d1:d1:b0:4a,3008991,52,4966,3008939,3008991
825,6,6,1,2412,-85,-92,7,,3009265,44,230,3009221,3009265
826,6,24,1,2412,-78,-92,14,,3014788,28,5495,3014760,3014788
827,6,6,1,2412,-77,-92,15,e2:db:d1:d1:b0:4a,3015148,52,308,3015096,3015148
828,6,6,1,2412,-81,-92,11,,3015462,44,270,3015418,3015462
829,6,6,1,2412,-86,-92,6,,3019029,44,3523,3018985,3019029
830,6,6,1,2412,-85,-92,7,e2:db:d1:d1:b0:4a,3019816,68,719,3019748,3019816
831,6,6,1,2412,-85,-92,7,e2:db:d1:d1:b0:4a,3020588,52,720,3020536,3020588
832,6,6,1,2412,-85,-92,7,,3020878,44,246,3020834,3020878
833,6,6,1,2412,-86,-92,6,e2:db:d1:d1:b0:4a,3023045,52,2115,3022993,3023045
834,6,6,1,2412,-86,-92,6,e2:db:d1:d1:b0:4a,3023501,52,404,3023449,3023501
835,6,6,1,2412,-86,-92,6,,3023791,44,246,3023747,3023791
836,6,6,1,2412,-69,-92,23,10:86:8c:5f:93:1e,3028255,344,4120,3027911,3028255
837,4,1,1,2412,-59,-92,33,94:a6:7e:c9:98:67,3032124,2464,1405,3029660,3032124
838,4,11,1,2412,-85,-92,7,4c:01:43:d7:f3:29,3034688,362,2202,3034326,3034688
839,6,24,1,2412,-86,-92,6,,3036868,28,2152,3036840,3036868
840,6,6,1,2412,-84,-92,8,,3036983,44,71,3036939,3036983
841,4,11,1,2412,-84,-92,8,48:dd:0c:92:4b:e5,3038393,382,1028,3038011,3038393
842,6,6,1,2412,-86,-92,6,e2:db:d1:d1:b0:4a,3038700,52,255,3038648,3038700
843,6,6,1,2412,-84,-92,8,e2:db:d1:d1:b0:4a,3039053,52,301,3039001,3039053
844,6,6,1,2412,-84,-92,8,,3039311,44,214,3039267,3039311
845,6,6,1,2412,-87,-92,5,e2:db:d1:d1:b0:4a,3041072,52,1709,3041020,3041072
846,6,6,1,2412,-86,-92,6,,3041330,44,214,3041286,3041330
847,6,6,1,2412,-87,-92,5,e2:db:d1:d1:b0:4a,3041434,52,52,3041382,3041434
848,6,6,1,2412,-85,-92,7,,3041716,44,238,3041672,3041716
849,6,6,1,2412,-86,-92,6,e2:db:d1:d1:b0:4a,3042120,68,336,3042052,3042120
850,6,24,1,2412,-79,-92,13,,3046014,28,3866,3045986,3046014
851,4,1,1,2412,-85,-92,7,78:67:0e:38:6c:d3,3046534,2736,-2216,3043798,3046534
852,4,11,1,2412,-77,-92,15,48:dd:0c:7d:86:27,3049293,362,2397,3048931,3049293
853,4,11,1,2412,-79,-92,13,48:dd:0c:7d:86:23,3049667,323,51,3049344,3049667
854,4,11,1,2412,-78,-92,14,48:dd:0c:7d:86:25,3050002,382,-47,3049620,3050002
855,6,6,1,2412,-67,-92,25,12:86:8c:5f:93:1e,3053854,332,3520,3053522,3053854
856,6,6,1,2412,-88,-92,4,e2:db:d1:d1:b0:4a,3061370,52,7464,3061318,3061370
857,4,1,1,2412,-86,-92,6,ac:67:84:84:8a:07,3061898,448,80,3061450,3061898
858,4,1,1,2412,-78,-92,14,3c:bd:c5:ee:96:6d,3068555,3280,3377,3065275,3068555
859,4,11,1,2412,-82,-92,10,4c:01:43:ec:a0:69,3072916,361,4000,3072555,3072916
860,4,1,1,2412,-83,-92,9,3c:bd:c5:ee:96:6d,3083240,2512,7812,3080728,3083240
861,6,6,1,2412,-81,-92,11,0a:a7:c0:a3:8d:73,3085617,408,1969,3085209,3085617
862,4,1,1,2412,-88,-92,4,,3094193,304,8272,3093889,3094193
863,4,1,1,2412,-90,-92,2,60:32:b1:64:4c:f2,3094635,3224,-2782,3091411,3094635
864,6,6,1,2412,-66,-92,26,32:86:8c:5f:93:1e,3105055,332,10088,3104723,3105055
865,6,24,1,2412,-86,-92,6,,3110848,28,5765,3110820,3110848
866,6,24,1,2412,-85,-92,7,,3124155,28,13279,3124127,3124155
867,4,1,1,2412,-58,-92,34,94:a6:7e:c9:98:67,3133523,2464,6904,3131059,3133523
868,4,11,1,2412,-85,-92,7,4c:01:43:d7:f3:29,3137088,362,3203,3136726,3137088
869,4,11,1,2412,-85,-92,7,4c:01:43:d7:f3:23,3137462,322,52,3137140,3137462
870,4,11,1,2412,-85,-92,7,4c:01:43:d7:f3:26,3137797,387,-52,3137410,3137797
871,6,24,1,2412,-84,-92,8,,3139785,28,1960,3139757,3139785
872,4,11,1,2412,-80,-92,12,48:dd:0c:7d:86:25,3151308,382,11141,3150926,3151308
873,6,6,1,2412,-84,-92,8,40:b0:34:b7:01:d5,3154745,576,2861,3154169,3154745
874,4,1,1,2412,-85,-92,7,00:26:62:eb:ea:74,3161773,968,6060,3160805,3161773
875,4,1,1,2412,-86,-92,6,,3162949,304,872,3162645,3162949
876,6,6,1,2412,-83,-92,9,e2:db:d1:d1:b0:4b,3167533,408,4176,3167125,3167533
877,6,6,1,2412,-85,-92,7,e2:db:d1:d1:b0:4d,3167974,408,33,3167566,3167974
878,6,6,1,2412,-82,-92,10,e2:db:d1:d1:b0:4f,3168415,408,33,3168007,3168415
879,4,11,1,2412,-83,-92,9,4c:01:43:ec:a0:69,3175315,361,6539,3174954,3175315
880,4,11,1,2412,-85,-92,7,4c:01:43:ec:a0:63,3175689,322,52,3175367,3175689
881,4,11,1,2412,-84,-92,8,4c:01:43:ec:a0:66,3176024,387,-52,3175637,3176024
882,4,11,1,2412,-72,-92,20,48:dd:0c:90:e3:87,3176562,362,176,3176200,3176562
883,4,11,1,2412,-72,-92,20,48:dd:0c:90:e3:83,3176936,323,51,3176613,3176936
884,4,11,1,2412,-72,-92,20,48:dd:0c:90:e3:85,3177272,382,-46,3176890,3177272
885,6,6,1,2412,-85,-92,7,0a:a7:c0:a3:8d:71,3185077,408,7397,3184669,3185077
886,6,24,1,2412,-82,-92,10,,3191374,28,6269,3191346,3191374
887,4,1,1,2412,-87,-92,5,04:a2:22:bf:24:52,3192786,2512,-1100,3190274,3192786
888,6,24,1,2412,-80,-92,12,,3203421,28,10607,3203393,3203421
889,6,6,1,2412,-67,-92,25,32:86:8c:5f:93:1e,3207455,332,3702,3207123,3207455
890,4,11,1,2412,-82,-92,10,,3224878,107,17316,3224771,3224878
891,4,1,1,2412,-54,-92,38,94:a6:7e:c9:98:67,3241820,1320,15622,3240500,3241820
892,4,1,1,2412,-55,-92,37,94:a6:7e:c9:98:67,3243312,1480,12,3241832,3243312
893,4,11,1,2412,-71,-92,21,48:dd:0c:7d:86:27,3253830,362,10156,3253468,3253830
894,4,11,1,2412,-72,-92,20,48:dd:0c:7d:86:23,3254205,323,52,3253882,3254205
895,4,11,1,2412,-74,-92,18,48:dd:0c:7d:86:25,3254540,382,-47,3254158,3254540
896,6,6,1,2412,-67,-92,25,12:86:8c:5f:93:1e,3258656,332,3784,3258324,3258656
897,4,1,1,2412,-87,-92,5,70:3a:cb:63:35:b2,3259207,2216,-1665,3256991,3259207
898,4,1,1,2412,-85,-92,7,00:26:62:eb:ea:74,3264174,968,3999,3263206,3264174
899,4,1,1,2412,-72,-92,20,ac:67:84:84:8a:07,3265445,448,823,3264997,3265445
900,4,1,1,2412,-74,-92,18,78:67:0e:c4:a8:42,3265946,352,149,3265594,3265946
901,4,11,1,2412,-80,-92,12,4c:01:43:d7:f3:26,3274994,383,8665,3274611,3274994
902,4,1,1,2412,-83,-92,9,78:67:0e:c4:a8:42,3275780,352,434,3275428,3275780
903,4,1,1,2412,-85,-92,7,78:67:0e:c4:a8:42,3276642,352,510,3276290,3276642
904,4,11,1,2412,-84,-92,8,4c:01:43:ec:a0:63,3278088,322,1124,3277766,3278088
905,4,11,1,2412,-85,-92,7,4c:01:43:ec:a0:66,3278422,387,-53,3278035,3278422
906,4,11,1,2412,-71,-92,21,48:dd:0c:90:e3:87,3278962,362,178,3278600,3278962
907,4,11,1,2412,-72,-92,20,48:dd:0c:90:e3:83,3279336,323,51,3279013,3279336
908,4,11,1,2412,-72,-92,20,48:dd:0c:90:e3:85,3279671,382,-47,3279289,3279671
909,4,1,1,2412,-83,-92,9,78:67:0e:c4:a8:42,3291139,2736,8732,3288403,3291139
910,6,6,1,2412,-86,-92,6,,3304104,44,12921,3304060,3304104
911,4,1,1,2412,-85,-92,7,78:67:0e:c4:a8:42,3305436,352,980,3305084,3305436
912,6,6,1,2412,-85,-92,7,3c:bd:c5:ee:96:6d,3306570,68,1066,3306502,3306570
913,4,11,1,2412,-79,-92,13,,3308546,107,1869,3308439,3308546
914,6,24,1,2412,-79,-92,13,78:67:0e:c4:a8:42,3308659,32,81,3308627,3308659
915,6,24,1,2412,-77,-92,15,78:67:0e:c4:a8:42,3308785,32,94,3308753,3308785
916,4,11,1,2412,-82,-92,10,,3309574,107,682,3309467,3309574
917,6,24,1,2412,-79,-92,13,78:67:0e:c4:a8:42,3309715,32,109,3309683,3309715
918,6,6,1,2412,-68,-92,24,32:86:8c:5f:93:1e,3309861,332,-186,3309529,3309861
919,6,6,1,2412,-84,-92,8,3c:bd:c5:ee:96:6d,3315202,68,5273,3315134,3315202
920,4,1,1,2412,-81,-92,11,,3320927,304,5421,3320623,3320927
921,4,1,1,2412,-83,-92,9,78:67:0e:c4:a8:42,3324711,352,3432,3324359,3324711
922,4,11,1,2412,-80,-92,12,,3326420,107,1602,3326313,3326420
923,4,11,1,2412,-81,-92,11,,3328537,107,2010,3328430,3328537
924,6,24,1,2412,-80,-92,12,78:67:0e:c4:a8:42,3328650,32,81,3328618,3328650
925,4,11,1,2412,-79,-92,13,,3333933,107,5176,3333826,3333933
926,6,24,1,2412,-80,-92,12,78:67:0e:c4:a8:42,3334068,32,103,3334036,3334068
927,4,1,1,2412,-81,-92,11,78:67:0e:c4:a8:42,3334597,352,177,3334245,3334597
928,4,1,1,2412,-82,-92,10,bc:98:df:ff:0f:8b,3335619,2568,-1546,3333051,3335619
929,6,6,1,2412,-69,-92,23,10:86:8c:5f:93:1e,3338059,344,2096,3337715,3338059
930,4,1,1,2412,-65,-92,27,94:a6:7e:c9:98:67,3338667,2464,-1856,3336203,3338667
931,4,11,1,2412,-82,-92,10,4c:01:43:d7:f3:29,3341887,362,2858,3341525,3341887
932,4,1,1,2412,-80,-92,12,78:67:0e:c4:a8:42,3343120,352,881,3342768,3343120
933,4,1,1,2412,-80,-92,12,78:67:0e:c4:a8:42,3344179,352,707,3343827,3344179
934,4,11,1,2412,-87,-92,5,48:dd:0c:92:4b:e7,3344883,362,342,3344521,3344883
935,4,11,1,2412,-88,-92,4,48:dd:0c:92:4b:e3,3345258,323,52,3344935,3345258
936,4,11,1,2412,-78,-92,14,,3346156,107,791,3346049,3346156
937,6,24,1,2412,-81,-92,11,78:67:0e:c4:a8:42,3346287,32,99,3346255,3346287
938,6,24,1,2412,-81,-92,11,,3346395,28,80,3346367,3346395
939,6,24,1,2412,-81,-92,11,,3350856,28,4433,3350828,3350856
940,4,11,1,2412,-77,-92,15,48:dd:0c:7d:86:25,3356369,382,5131,3355987,3356369
941,4,1,1,2412,-91,-92,1,ac:67:84:84:8a:07,3356701,416,-84,3356285,3356701
942,6,6,1,2412,-82,-92,10,40:b0:34:b7:01:d5,3359191,576,1914,3358615,3359191
943,6,6,1,2412,-71,-92,21,12:86:8c:5f:93:1e,3361056,332,1533,3360724,3361056
944,6,24,1,2412,-81,-92,11,,3366812,28,5728,3366784,3366812
945,4,11,1,2412,-78,-92,14,,3371194,107,4275,3371087,3371194
946,6,6,1,2412,-83,-92,9,e2:db:d1:d1:b0:4f,3373213,408,1611,3372805,3373213
947,6,6,1,2412,-83,-92,9,,3373764,44,507,3373720,3373764
948,4,11,1,2412,-85,-92,7,4c:01:43:ec:a0:69,3380113,361,5988,3379752,3380113
949,4,11,1,2412,-84,-92,8,4c:01:43:ec:a0:63,3380487,322,52,3380165,3380487
950,4,11,1,2412,-79,-92,13,48:dd:0c:90:e3:85,3382071,382,1202,3381689,3382071
951,6,6,1,2412,-70,-92,22,52:86:8c:5f:93:1e,3386657,332,4254,3386325,3386657
952,4,1,1,2412,-78,-92,14,78:67:0e:c4:a8:42,3388887,352,1878,3388535,3388887
953,4,1,1,2412,-79,-92,13,78:67:0e:c4:a8:42,3389438,352,199,3389086,3389438
954,4,1,1,2412,-80,-92,12,78:67:0e:c4:a8:42,3390241,352,451,3389889,3390241
955,4,1,1,2412,-78,-92,14,78:67:0e:c4:a8:42,3391190,352,597,3390838,3391190
956,4,1,1,2412,-79,-92,13,78:67:0e:c4:a8:42,3391763,352,221,3391411,3391763
957,4,1,1,2412,-92,-92,0,78:67:0e:c4:a8:42,3397342,352,5227,3396990,3397342
958,4,1,1,2412,-79,-92,13,78:67:0e:c4:a8:42,3398262,352,568,3397910,3398262
959,4,1,1,2412,-80,-92,12,78:67:0e:c4:a8:42,3400957,352,2343,3400605,3400957
960,4,1,1,2412,-79,-92,13,78:67:0e:c4:a8:42,3401517,352,208,3401165,3401517
961,4,1,1,2412,-79,-92,13,78:67:0e:c4:a8:42,3402050,352,181,3401698,3402050
962,4,1,1,2412,-79,-92,13,78:67:0e:c4:a8:42,3403492,352,1090,3403140,3403492
963,4,1,1,2412,-73,-92,19,78:67:0e:c4:a8:42,3409329,352,5485,3408977,3409329
964,6,6,1,2412,-83,-92,9,e2:db:d1:d1:b0:4a,3409668,68,271,3409600,3409668
965,6,6,1,2412,-66,-92,26,32:86:8c:5f:93:1e,3412660,332,2660,3412328,3412660
966,4,11,1,2412,-78,-92,14,,3413539,107,772,3413432,3413539
967,7,19.5,1,2412,0,-92,92,e2:db:d1:d1:b0:4a,3421502,676,7287,3420826,3421502
968,7,19.5,1,2412,0,-92,92,e2:db:d1:d1:b0:4a,3421502,420,-420,3421082,3421502
969,7,19.5,1,2412,0,-92,92,e2:db:d1:d1:b0:4a,3421502,636,-636,3420866,3421502
970,7,19.5,1,2412,0,-92,92,e2:db:d1:d1:b0:4a,3421502,636,-636,3420866,3421502
971,7,19.5,1,2412,0,-92,92,e2:db:d1:d1:b0:4a,3421502,516,-516,3420986,3421502
972,7,19.5,1,2412,0,-92,92,e2:db:d1:d1:b0:4a,3421502,640,-640,3420862,3421502
973,7,19.5,1,2412,0,-92,92,e2:db:d1:d1:b0:4a,3421502,640,-640,3420862,3421502
974,6,6,1,2412,-85,-92,7,e2:db:d1:d1:b0:4a,3428726,52,7172,3428674,3428726
975,6,6,1,2412,-64,-92,28,10:86:8c:5f:93:1e,3437856,344,8786,3437512,3437856
976,4,1,1,2412,-57,-92,35,94:a6:7e:c9:98:67,3440700,2464,380,3438236,3440700
977,6,6,1,2412,-85,-92,7,e2:db:d1:d1:b0:4a,3453248,52,12496,3453196,3453248
978,4,11,1,2412,-73,-92,19,48:dd:0c:7d:86:27,3457613,362,4003,3457251,3457613
979,4,11,1,2412,-76,-92,16,48:dd:0c:7d:86:23,3457987,323,51,3457664,3457987
980,4,11,1,2412,-75,-92,17,48:dd:0c:7d:86:25,3458323,382,-46,3457941,3458323
981,4,1,1,2412,-79,-92,13,78:67:0e:c4:a8:42,3461368,352,2693,3461016,3461368
982,6,6,1,2412,-84,-92,8,,3461648,44,236,3461604,3461648
983,6,6,1,2412,-86,-92,6,e2:db:d1:d1:b0:4a,3461761,52,61,3461709,3461761
984,6,6,1,2412,-85,-92,7,e2:db:d1:d1:b0:4a,3462692,52,879,3462640,3462692
985,4,11,1,2412,-78,-92,14,,3466526,107,3727,3466419,3466526
986,6,6,1,2412,-85,-92,7,e2:db:d1:d1:b0:4a,3474255,444,7285,3473811,3474255
987,6,6,1,2412,-85,-92,7,e2:db:d1:d1:b0:4b,3474750,408,87,3474342,3474750
988,6,6,1,2412,-85,-92,7,e2:db:d1:d1:b0:4d,3475182,408,24,3474774,3475182
989,6,6,1,2412,-86,-92,6,e2:db:d1:d1:b0:4f,3475632,408,42,3475224,3475632
990,6,6,1,2412,-85,-92,7,e2:db:d1:d1:b0:4a,3476190,168,390,3476022,3476190
991,6,6,1,2412,-86,-92,6,,3476564,44,330,3476520,3476564
992,6,6,1,2412,-85,-92,7,e2:db:d1:d1:b0:4a,3476758,196,-2,3476562,3476758
993,6,6,1,2412,-86,-92,6,e2:db:d1:d1:b0:4a,3477103,168,177,3476935,3477103
994,6,6,1,2412,-86,-92,6,e2:db:d1:d1:b0:4a,3482089,52,4934,3482037,3482089
995,4,11,1,2412,-75,-92,17,48:dd:0c:90:e3:87,3483761,362,1310,3483399,3483761
996,4,11,1,2412,-77,-92,15,48:dd:0c:90:e3:83,3484136,323,52,3483813,3484136
997,4,11,1,2412,-76,-92,16,48:dd:0c:90:e3:85,3484471,382,-47,3484089,3484471
998,4,1,1,2412,-84,-92,8,78:67:0e:c4:a8:42,3495939,2736,8732,3493203,3495939
999,6,6,1,2412,-66,-92,26,32:86:8c:5f:93:1e,3514657,332,18386,3514325,3514657
1000,6,24,1,2412,-82,-92,10,,3523434,28,8749,3523406,3523434
1001,4,1,1,2412,-84,-92,8,78:67:0e:c4:a8:42,3524877,352,1091,3524525,3524877
1002,4,1,1,2412,-72,-92,20,b0:e4:d5:32:ec:8a,3536476,1960,9639,3534516,3536476
1003,4,1,1,2412,-57,-92,35,94:a6:7e:c9:98:67,3543474,2464,4534,3541010,3543474
1004,4,11,1,2412,-87,-92,5,4c:01:43:d7:f3:23,3547061,322,3265,3546739,3547061
1005,6,24,1,2412,-82,-92,10,,3547906,28,817,3547878,3547906
1006,6,24,1,2412,-82,-92,10,4c:01:43:d7:f3:26,3553016,32,5078,3552984,3553016
1007,4,1,1,2412,-91,-92,1,,3553732,304,412,3553428,3553732
1008,6,6,1,2412,-85,-92,7,,3554504,44,728,3554460,3554504
1009,4,11,1,2412,-74,-92,18,48:dd:0c:7d:86:23,3561378,323,6551,3561055,3561378
1010,4,11,1,2412,-74,-92,18,48:dd:0c:7d:86:25,3561714,382,-46,3561332,3561714
1011,6,6,1,2412,-90,-92,2,40:b0:34:b7:01:d5,3563993,576,1703,3563417,3563993
1012,6,6,1,2412,-64,-92,28,12:86:8c:5f:93:1e,3565858,332,1533,3565526,3565858
1013,4,1,1,2412,-89,-92,3,70:3a:cb:63:35:b2,3566405,2216,-1669,3564189,3566405
1014,4,1,1,2412,-90,-92,2,d8:9c:8e:01:4c:6a,3570773,3000,1368,3567773,3570773
1015,6,6,1,2412,-86,-92,6,e2:db:d1:d1:b0:4a,3576650,444,5433,3576206,3576650
1016,6,6,1,2412,-85,-92,7,e2:db:d1:d1:b0:4b,3577117,408,59,3576709,3577117
1017,6,6,1,2412,-87,-92,5,e2:db:d1:d1:b0:4d,3577576,408,51,3577168,3577576
1018,6,6,1,2412,-88,-92,4,e2:db:d1:d1:b0:4f,3578035,408,51,3577627,3578035
1019,6,6,1,2412,-87,-92,5,,3578739,44,660,3578695,3578739
1020,4,11,1,2412,-75,-92,17,48:dd:0c:90:e3:83,3586535,323,7473,3586212,3586535
1021,4,11,1,2412,-76,-92,16,48:dd:0c:90:e3:85,3586871,382,-46,3586489,3586871
1022,4,1,1,2412,-80,-92,12,40:ca:63:2d:74:be,3588244,1896,-523,3586348,3588244
1023,6,6,1,2412,-63,-92,29,52:86:8c:5f:93:1e,3591537,332,2961,3591205,3591537
1024,4,1,1,2412,-81,-92,11,78:67:0e:c4:a8:42,3598339,2736,4066,3595603,3598339
1025,6,24,1,2412,-80,-92,12,,3601107,28,2740,3601079,3601107
1026,4,1,1,2412,-89,-92,3,04:a2:22:bf:24:52,3602385,2512,-1234,3599873,3602385
1027,6,24,1,2412,-79,-92,13,,3608449,28,6036,3608421,3608449
1028,4,1,1,2412,-90,-92,2,,3609634,304,881,3609330,3609634
1029,6,6,1,2412,-65,-92,27,32:86:8c:5f:93:1e,3617058,332,7092,3616726,3617058
1030,6,6,1,2412,-68,-92,24,b4:e6:2d:b4:ff:71,3644174,64,27052,3644110,3644174
1031,6,6,1,2412,-64,-92,28,,3644254,44,36,3644210,3644254
1032,4,1,1,2412,-58,-92,34,94:a6:7e:c9:98:67,3649778,2464,3060,3647314,3649778
1033,4,1,1,2412,-80,-92,12,,3656342,304,6260,3656038,3656342
1034,6,24,1,2412,-86,-92,6,3c:bd:c5:ee:96:6d,3656618,28,248,3656590,3656618
1035,6,6,1,2412,-84,-92,8,40:b0:34:b7:01:d5,3666394,576,9200,3665818,3666394
1036,6,6,1,2412,-86,-92,6,3c:bd:c5:ee:96:6d,3673623,68,7161,3673555,3673623
1037,6,6,1,2412,-84,-92,8,e2:db:d1:d1:b0:4a,3679060,444,4993,3678616,3679060
1038,6,6,1,2412,-85,-92,7,e2:db:d1:d1:b0:4b,3679555,408,87,3679147,3679555
1039,6,6,1,2412,-87,-92,5,e2:db:d1:d1:b0:4d,3679996,408,33,3679588,3679996
1040,6,6,1,2412,-86,-92,6,e2:db:d1:d1:b0:4f,3680437,408,33,3680029,3680437
1041,6,6,1,2412,-85,-92,7,,3681383,44,902,3681339,3681383
1042,6,24,1,2412,-81,-92,11,,3685717,28,4306,3685689,3685717
1043,4,11,1,2412,-87,-92,5,4c:01:43:ec:a0:63,3687683,322,1644,3687361,3687683
1044,6,24,1,2412,-84,-92,8,,3688358,28,647,3688330,3688358
1045,4,11,1,2412,-78,-92,14,48:dd:0c:90:e3:87,3688561,362,-159,3688199,3688561
1046,4,11,1,2412,-79,-92,13,48:dd:0c:90:e3:83,3688935,323,51,3688612,3688935
1047,4,11,1,2412,-79,-92,13,48:dd:0c:90:e3:85,3689270,382,-47,3688888,3689270
1048,4,1,1,2412,-76,-92,16,,3698122,304,8548,3697818,3698122
1049,4,1,1,2412,-91,-92,1,92:bd:c5:2c:8c:cb,3698780,912,-254,3697868,3698780
1050,4,11,1,2412,-85,-92,7,4c:01:43:d7:f3:23,3699967,277,910,3699690,3699967
1051,4,11,1,2412,-87,-92,5,4c:01:43:ec:a0:63,3700522,284,271,3700238,3700522
1052,4,1,1,2412,-85,-92,7,78:67:0e:c4:a8:42,3700826,2736,-2432,3698090,3700826
1053,6,24,1,2412,-85,-92,7,,3716848,28,15994,3716820,3716848
1054,6,6,1,2412,-66,-92,26,32:86:8c:5f:93:1e,3719459,332,2279,3719127,3719459
1055,6,6,1,2412,-79,-92,13,,3736376,44,16873,3736332,3736376
1056,4,1,1,2412,-88,-92,4,78:67:0e:c4:a8:42,3736817,3472,-3031,3733345,3736817
1057,4,1,1,2412,-71,-92,21,b0:e4:d5:32:ec:8a,3741275,1960,2498,3739315,3741275
1058,4,1,1,2412,-54,-92,38,94:a6:7e:c9:98:67,3748252,2464,4513,3745788,3748252
1059,4,11,1,2412,-84,-92,8,4c:01:43:d7:f3:23,3751860,322,3286,3751538,3751860
1060,4,11,1,2412,-74,-92,18,48:dd:0c:92:4b:e5,3755192,382,2950,3754810,3755192
1061,6,24,1,2412,-87,-92,5,,3758919,28,3699,3758891,3758919
1062,4,11,1,2412,-74,-92,18,48:dd:0c:7d:86:23,3766179,323,6937,3765856,3766179
1063,4,11,1,2412,-74,-92,18,48:dd:0c:7d:86:25,3766514,382,-47,3766132,3766514
1064,6,6,1,2412,-89,-92,3,40:b0:34:b7:01:d5,3768795,576,1705,3768219,3768795
1065,6,6,1,2412,-67,-92,25,12:86:8c:5f:93:1e,3770659,332,1532,3770327,3770659
1066,4,1,1,2412,-90,-92,2,10:7b:44:eb:35:60,3778092,384,7049,3777708,3778092
1067,6,6,1,2412,-68,-92,24,52:86:8c:5f:93:1e,3796336,332,17912,3796004,3796336
1068,6,6,1,2412,-82,-92,10,0a:a7:c0:a3:8d:71,3799447,408,2703,3799039,3799447
1069,6,6,1,2412,-84,-92,8,0a:a7:c0:a3:8d:73,3799898,408,43,3799490,3799898
1070,6,6,1,2412,-84,-92,8,0a:a7:c0:a3:8d:75,3800338,408,32,3799930,3800338
1071,4,1,1,2412,-79,-92,13,78:67:0e:c4:a8:42,3803138,2736,64,3800402,3803138
1072,4,1,1,2412,-79,-92,13,78:67:0e:c4:a8:42,3812475,352,8985,3812123,3812475
1073,4,11,1,2412,-77,-92,15,,3814395,107,1813,3814288,3814395
1074,6,6,1,2412,-69,-92,23,32:86:8c:5f:93:1e,3821859,332,7132,3821527,3821859
1075,4,1,1,2412,-90,-92,2,ce:f4:11:65:3f:f8,3823614,2072,-317,3821542,3823614
1076,6,6,1,2412,-86,-92,6,,3828271,44,4613,3828227,3828271
1077,6,24,1,2412,-84,-92,8,,3828404,28,105,3828376,3828404
1078,4,1,1,2412,-81,-92,11,78:67:0e:c4:a8:42,3828771,3472,-3105,3825299,3828771
1079,4,1,1,2412,-79,-92,13,78:67:0e:c4:a8:42,3832397,3472,154,3828925,3832397
1080,6,6,1,2412,-63,-92,29,b4:e6:2d:b4:ff:71,3843338,64,10877,3843274,3843338
1081,6,6,1,2412,-69,-92,23,,3843418,44,36,3843374,3843418
1082,4,1,1,2412,-75,-92,17,b0:e4:d5:32:ec:8a,3843674,1960,-1704,3841714,3843674
1083,6,6,1,2412,-86,-92,6,e2:db:d1:d1:b0:4a,3845562,52,1836,3845510,3845562
1084,6,6,1,2412,-86,-92,6,e2:db:d1:d1:b0:4a,3845958,52,344,3845906,3845958
1085,6,6,1,2412,-85,-92,7,e2:db:d1:d1:b0:4a,3850139,52,4129,3850087,3850139
1086,4,1,1,2412,-59,-92,33,94:a6:7e:c9:98:67,3850657,2464,-1946,3848193,3850657
1087,6,24,1,2412,-87,-92,5,e2:db:d1:d1:b0:4a,3853149,28,2464,3853121,3853149
1088,6,12,1,2412,-87,-92,5,,3853492,32,311,3853460,3853492
1089,6,6,1,2412,-88,-92,4,e2:db:d1:d1:b0:4a,3853628,68,68,3853560,3853628
1090,4,11,1,2412,-81,-92,11,4c:01:43:d7:f3:23,3854259,322,309,3853937,3854259
1091,4,11,1,2412,-82,-92,10,4c:01:43:d7:f3:26,3854594,387,-52,3854207,3854594
1092,4,11,1,2412,-86,-92,6,48:dd:0c:92:4b:e7,3856882,362,1926,3856520,3856882
1093,4,11,1,2412,-89,-92,3,48:dd:0c:92:4b:e3,3857257,323,52,3856934,3857257
1094,4,11,1,2412,-88,-92,4,48:dd:0c:92:4b:e5,3857592,382,-47,3857210,3857592
1095,6,6,1,2412,-88,-92,4,e2:db:d1:d1:b0:4a,3858914,52,1270,3858862,3858914
1096,6,6,1,2412,-87,-92,5,e2:db:d1:d1:b0:4a,3859391,52,425,3859339,3859391
1097,7,19.5,1,2412,-84,-92,8,e2:db:d1:d1:b0:4a,3859522,172,-41,3859350,3859522
1098,6,6,1,2412,-88,-92,4,,3859773,44,207,3859729,3859773
1099,4,1,1,2412,-79,-92,13,78:67:0e:38:6c:d3,3865446,2736,2937,3862710,3865446
1100,4,11,1,2412,-73,-92,19,48:dd:0c:7d:86:27,3868205,362,2397,3867843,3868205
1101,4,11,1,2412,-73,-92,19,48:dd:0c:7d:86:23,3868580,323,52,3868257,3868580
1102,4,11,1,2412,-73,-92,19,48:dd:0c:7d:86:25,3868915,382,-47,3868533,3868915
1103,7,19.5,1,2412,-87,-92,5,e2:db:d1:d1:b0:4a,3869228,84,229,3869144,3869228
1104,6,6,1,2412,-88,-92,4,f8:51:28:bf:c3:33,3872437,64,3145,3872373,3872437
1105,6,6,1,2412,-86,-92,6,f8:51:28:bf:c3:33,3872834,64,333,3872770,3872834
1106,6,6,1,2412,-67,-92,25,12:86:8c:5f:93:1e,3873060,332,-106,3872728,3873060
1107,4,1,1,2412,-87,-92,5,f8:51:28:bf:c3:33,3876643,416,3167,3876227,3876643
1108,4,1,1,2412,-88,-92,4,f8:51:28:bf:c3:33,3881273,416,4214,3880857,3881273
1109,4,1,1,2412,-86,-92,6,f8:51:28:bf:c3:33,3881841,416,152,3881425,3881841
1110,4,1,1,2412,-88,-92,4,f8:51:28:bf:c3:33,3883022,416,765,3882606,3883022
1111,4,1,1,2412,-79,-92,13,f8:51:28:bf:c3:33,3886819,416,3381,3886403,3886819
1112,4,1,1,2412,-79,-92,13,f8:51:28:bf:c3:33,3887411,416,176,3886995,3887411
1113,4,1,1,2412,-87,-92,5,f8:51:28:bf:c3:33,3887934,416,107,3887518,3887934
1114,4,1,1,2412,-90,-92,2,f8:51:28:bf:c3:33,3891020,416,2670,3890604,3891020
1115,4,1,1,2412,-88,-92,4,f8:51:28:bf:c3:33,3891624,416,188,3891208,3891624
1116,4,1,1,2412,-87,-92,5,f8:51:28:bf:c3:33,3892210,416,170,3891794,3892210
1117,4,1,1,2412,-89,-92,3,f8:51:28:bf:c3:33,3892769,416,143,3892353,3892769
1118,4,11,1,2412,-88,-92,4,48:dd:0c:90:e3:83,3893734,323,642,3893411,3893734
1119,4,11,1,2412,-80,-92,12,48:dd:0c:90:e3:85,3894070,382,-46,3893688,3894070
1120,4,1,1,2412,-88,-92,4,f8:51:28:bf:c3:33,3894866,416,380,3894450,3894866
1121,4,1,1,2412,-88,-92,4,f8:51:28:bf:c3:33,3895407,416,125,3894991,3895407
1122,4,1,1,2412,-86,-92,6,f8:51:28:bf:c3:33,3900855,416,5032,3900439,3900855
1123,4,1,1,2412,-80,-92,12,3c:bd:c5:ee:96:6d,3904795,1056,2884,3903739,3904795
1124,4,1,1,2412,-90,-92,2,f8:51:28:bf:c3:33,3908332,416,3121,3907916,3908332
1125,4,1,1,2412,-88,-92,4,f8:51:28:bf:c3:33,3908855,416,107,3908439,3908855
1126,4,1,1,2412,-89,-92,3,f8:51:28:bf:c3:33,3909387,416,116,3908971,3909387
1127,4,1,1,2412,-88,-92,4,f8:51:28:bf:c3:33,3911678,416,1875,3911262,3911678
1128,4,1,1,2412,-85,-92,7,f8:51:28:bf:c3:33,3912219,416,125,3911803,3912219
1129,4,1,1,2412,-87,-92,5,f8:51:28:bf:c3:33,3914356,416,1721,3913940,3914356
1130,4,1,1,2412,-86,-92,6,f8:51:28:bf:c3:33,3914897,416,125,3914481,3914897
1131,4,1,1,2412,-88,-92,4,f8:51:28:bf:c3:33,3915447,416,134,3915031,3915447
1132,4,1,1,2412,-87,-92,5,f8:51:28:bf:c3:33,3915988,416,125,3915572,3915988
1133,4,1,1,2412,-89,-92,3,f8:51:28:bf:c3:33,3916547,416,143,3916131,3916547
1134,4,1,1,2412,-88,-92,4,f8:51:28:bf:c3:33,3917088,416,125,3916672,3917088
1135,4,1,1,2412,-90,-92,2,f8:51:28:bf:c3:33,3917638,416,134,3917222,3917638
1136,4,1,1,2412,-88,-92,4,f8:51:28:bf:c3:33,3918179,416,125,3917763,3918179
1137,4,1,1,2412,-90,-92,2,f8:51:28:bf:c3:33,3920275,416,1680,3919859,3920275
1138,4,1,1,2412,-87,-92,5,f8:51:28:bf:c3:33,3920807,416,116,3920391,3920807
1139,4,1,1,2412,-87,-92,5,f8:51:28:bf:c3:33,3921907,416,684,3921491,3921907
1140,4,1,1,2412,-89,-92,3,f8:51:28:bf:c3:33,3923344,416,1021,3922928,3923344
1141,4,1,1,2412,-91,-92,1,f8:51:28:bf:c3:33,3923876,416,116,3923460,3923876
1142,4,1,1,2412,-88,-92,4,f8:51:28:bf:c3:33,3924426,416,134,3924010,3924426
1143,4,1,1,2412,-88,-92,4,f8:51:28:bf:c3:33,3924949,416,107,3924533,3924949
1144,6,6,1,2412,-65,-92,27,32:86:8c:5f:93:1e,3925538,332,257,3925206,3925538
1145,6,6,1,2412,-82,-92,10,e2:db:d1:d1:b0:4a,3931431,52,5841,3931379,3931431
1146,6,6,1,2412,-82,-92,10,e2:db:d1:d1:b0:4a,3931738,52,255,3931686,3931738
1147,6,6,1,2412,-83,-92,9,,3931996,44,214,3931952,3931996
1148,6,6,1,2412,-82,-92,10,e2:db:d1:d1:b0:4a,3932127,52,79,3932075,3932127
1149,6,6,1,2412,-82,-92,10,e2:db:d1:d1:b0:4a,3932613,52,434,3932561,3932613
1150,6,6,1,2412,-82,-92,10,e2:db:d1:d1:b0:4a,3933000,52,335,3932948,3933000
1151,7,19.5,1,2412,0,-92,92,e2:db:d1:d1:b0:4a,3933130,84,46,3933046,3933130
1152,7,19.5,1,2412,0,-92,92,e2:db:d1:d1:b0:4a,3933130,40,-40,3933090,3933130
1153,7,19.5,1,2412,0,-92,92,e2:db:d1:d1:b0:4a,3933130,56,-56,3933074,3933130
1154,7,19.5,1,2412,-83,-92,9,e2:db:d1:d1:b0:4a,3933130,44,-44,3933086,3933130
1155,6,6,1,2412,-81,-92,11,,3933446,44,272,3933402,3933446
1156,7,26,1,2412,-83,-92,9,e2:db:d1:d1:b0:4a,3936533,72,3015,3936461,3936533
1157,6,6,1,2412,-83,-92,9,e2:db:d1:d1:b0:4a,3936797,52,212,3936745,3936797
1158,6,6,1,2412,-82,-92,10,e2:db:d1:d1:b0:4a,3937111,52,262,3937059,3937111
1159,7,13,1,2412,-83,-92,9,e2:db:d1:d1:b0:4a,3937242,108,23,3937134,3937242
1160,6,6,1,2412,-82,-92,10,e2:db:d1:d1:b0:4a,3941745,52,4451,3941693,3941745
1161,7,19.5,1,2412,-84,-92,8,e2:db:d1:d1:b0:4a,3941875,224,-94,3941651,3941875
1162,6,6,1,2412,-82,-92,10,e2:db:d1:d1:b0:4a,3942386,52,459,3942334,3942386
1163,7,19.5,1,2412,-83,-92,9,e2:db:d1:d1:b0:4a,3942517,92,39,3942425,3942517
1164,6,6,1,2412,-82,-92,10,,3942696,44,135,3942652,3942696
1165,6,24,1,2412,-82,-92,10,,3942824,28,100,3942796,3942824
1166,6,6,1,2412,-82,-92,10,e2:db:d1:d1:b0:4a,3942992,68,100,3942924,3942992
1167,6,6,1,2412,-64,-92,28,10:86:8c:5f:93:1e,3949861,344,6525,3949517,3949861
1168,4,11,1,2412,-90,-92,2,4c:01:43:d7:f3:23,3956659,322,6476,3956337,3956659
1169,4,11,1,2412,-75,-92,17,4c:01:43:d7:f3:26,3956993,387,-53,3956606,3956993
1170,4,11,1,2412,-80,-92,12,48:dd:0c:90:e3:83,3959181,254,1934,3958927,3959181
1171,6,6,1,2412,-86,-92,6,,3962783,44,3558,3962739,3962783
1172,6,6,1,2412,-85,-92,7,3c:bd:c5:ee:96:6d,3963358,68,507,3963290,3963358
1173,6,6,1,2412,-87,-92,5,3c:bd:c5:ee:96:6d,3963829,68,403,3963761,3963829
1174,4,1,1,2412,-79,-92,13,78:67:0e:38:6c:d3,3967846,2736,1281,3965110,3967846
1175,4,11,1,2412,-76,-92,16,48:dd:0c:7d:86:27,3970605,362,2397,3970243,3970605
1176,4,11,1,2412,-76,-92,16,48:dd:0c:7d:86:23,3970980,323,52,3970657,3970980
1177,4,11,1,2412,-75,-92,17,48:dd:0c:7d:86:25,3971315,382,-47,3970933,3971315
1178,6,6,1,2412,-67,-92,25,12:86:8c:5f:93:1e,3975460,332,3813,3975128,3975460
1179,4,1,1,2412,-89,-92,3,70:3a:cb:63:35:b2,3976003,2216,-1673,3973787,3976003
1180,6,6,1,2412,-85,-92,7,,3979915,44,3868,3979871,3979915
1181,6,24,1,2412,-83,-92,9,,3981311,28,1368,3981283,3981311
1182,6,6,1,2412,-83,-92,9,,3981459,44,104,3981415,3981459
1183,4,1,1,2412,-87,-92,5,00:26:62:eb:ea:74,3983653,968,1226,3982685,3983653
1184,6,6,1,2412,-83,-92,9,3c:bd:c5:ee:96:6d,3985766,68,2045,3985698,3985766
1185,6,6,1,2412,-80,-92,12,,3986115,44,305,3986071,3986115
1186,6,6,1,2412,-84,-92,8,e2:db:d1:d1:b0:4a,3986266,444,-293,3985822,3986266
1187,6,6,1,2412,-83,-92,9,e2:db:d1:d1:b0:4b,3986742,408,68,3986334,3986742
1188,6,6,1,2412,-83,-92,9,e2:db:d1:d1:b0:4d,3987193,408,43,3986785,3987193
1189,6,6,1,2412,-84,-92,8,e2:db:d1:d1:b0:4f,3987633,408,32,3987225,3987633
1190,4,1,1,2412,-87,-92,5,78:67:0e:c4:a8:42,3988481,352,496,3988129,3988481
1191,6,6,1,2412,-85,-92,7,,3989119,44,594,3989075,3989119
1192,4,1,1,2412,-86,-92,6,78:67:0e:c4:a8:42,3989401,352,-70,3989049,3989401
1193,4,1,1,2412,-87,-92,5,78:67:0e:c4:a8:42,3990285,352,532,3989933,3990285
1194,6,24,1,2412,-86,-92,6,,3990888,28,575,3990860,3990888
1195,4,11,1,2412,-76,-92,16,48:dd:0c:90:e3:83,3996134,323,4923,3995811,3996134
1196,4,11,1,2412,-85,-92,7,4c:01:43:ec:a0:69,3997218,361,723,3996857,3997218
1197,4,1,1,2412,-86,-92,6,78:67:0e:c4:a8:42,3998458,352,888,3998106,3998458
1198,4,1,1,2412,-80,-92,12,78:67:0e:38:6c:d3,3999410,2096,-1144,3997314,3999410
1199,4,1,1,2412,-77,-92,15,78:67:0e:38:6c:d3,4001517,2352,-245,3999165,4001517
1200,6,6,1,2412,-66,-92,26,52:86:8c:5f:93:1e,4003725,332,1876,4003393,4003725
1201,4,1,1,2412,-81,-92,11,,4004319,304,290,4004015,4004319
1202,6,6,1,2412,-88,-92,4,0a:a7:c0:a3:8d:73,4004823,408,96,4004415,4004823
1203,4,1,1,2412,-91,-92,1,92:bd:c5:2c:8c:cc,4006019,912,284,4005107,4006019
1204,4,1,1,2412,-93,-92,-1,3c:bd:c5:2c:8c:ca,4006975,912,44,4006063,4006975
1205,6,6,1,2412,-82,-91,9,,4024069,44,17050,4024025,4024069
1206,6,6,1,2412,-67,-91,24,32:86:8c:5f:93:1e,4026661,332,2260,4026329,4026661
1207,4,1,1,2412,-72,-91,19,b0:e4:d5:32:ec:8a,4048473,1960,19852,4046513,4048473
1208,4,1,1,2412,-56,-91,35,94:a6:7e:c9:98:67,4055463,2464,4526,4052999,4055463
1209,4,1,1,2412,-84,-91,7,78:67:0e:c4:a8:42,4057851,352,2036,4057499,4057851
1210,4,11,1,2412,-86,-91,5,48:dd:0c:92:4b:e7,4061682,362,3469,4061320,4061682
1211,4,11,1,2412,-86,-91,5,48:dd:0c:92:4b:e3,4062057,323,52,4061734,4062057
1212,4,1,1,2412,-84,-91,7,78:67:0e:c4:a8:42,4063270,352,861,4062918,4063270
1213,4,1,1,2412,-64,-91,27,78:67:0e:38:6c:d3,4070246,2736,4240,4067510,4070246
1214,4,11,1,2412,-76,-91,15,48:dd:0c:7d:86:25,4073715,382,3087,4073333,4073715
1215,6,6,1,2412,-88,-91,3,40:b0:34:b7:01:d5,4075998,576,1707,4075422,4075998
1216,6,6,1,2412,-66,-91,25,12:86:8c:5f:93:1e,4077861,332,1531,4077529,4077861
1217,4,1,1,2412,-88,-91,3,70:3a:cb:63:35:b2,4078403,2216,-1674,4076187,4078403
1218,6,24,1,2412,-85,-91,6,,4083535,28,5104,4083507,4083535
1219,6,6,1,2412,-82,-91,9,e2:db:d1:d1:b0:4b,4089150,408,5207,4088742,4089150
1220,6,6,1,2412,-82,-91,9,e2:db:d1:d1:b0:4d,4089591,408,33,4089183,4089591
1221,6,6,1,2412,-81,-91,10,e2:db:d1:d1:b0:4f,4090041,408,42,4089633,4090041
1222,6,6,1,2412,-82,-91,9,,4090637,44,552,4090593,4090637
1223,4,11,1,2412,-81,-91,10,48:dd:0c:90:e3:87,4098159,362,7160,4097797,4098159
1224,4,11,1,2412,-81,-91,10,48:dd:0c:90:e3:83,4098534,323,52,4098211,4098534
1225,4,11,1,2412,-81,-91,10,48:dd:0c:90:e3:85,4098869,382,-47,4098487,4098869
1226,6,6,1,2412,-69,-91,22,52:86:8c:5f:93:1e,4103542,332,4341,4103210,4103542
1227,6,6,1,2412,-81,-91,10,,4107231,44,3645,4107187,4107231
1228,6,6,1,2412,-87,-91,4,0a:a7:c0:a3:8d:75,4107625,408,-14,4107217,4107625
1229,4,1,1,2412,-91,-91,0,40:ca:63:2d:74:be,4122711,1688,13398,4121023,4122711
1230,6,6,1,2412,-83,-91,8,e2:db:d1:d1:b0:4a,4133122,68,10343,4133054,4133122
1231,6,24,1,2412,-84,-91,7,e2:db:d1:d1:b0:4a,4134858,28,1708,4134830,4134858
1232,6,6,1,2412,-82,-91,9,,4135076,44,174,4135032,4135076
1233,4,1,1,2412,-71,-91,20,b0:e4:d5:32:ec:8a,4150872,1960,13836,4148912,4150872
1234,6,6,1,2412,-69,-91,22,10:86:8c:5f:93:1e,4154661,344,3445,4154317,4154661
1235,4,1,1,2412,-54,-91,37,94:a6:7e:c9:98:67,4157849,2464,724,4155385,4157849
1236,4,11,1,2412,-88,-91,3,4c:01:43:d7:f3:29,4161083,362,2872,4160721,4161083
1237,4,11,1,2412,-81,-91,10,4c:01:43:d7:f3:23,4161458,322,53,4161136,4161458
1238,4,11,1,2412,-82,-91,9,4c:01:43:d7:f3:26,4161792,387,-53,4161405,4161792
1239,6,6,1,2412,-83,-91,8,,4162497,44,661,4162453,4162497
1240,4,11,1,2412,-90,-91,1,48:dd:0c:92:4b:e7,4164082,362,1223,4163720,4164082
1241,4,11,1,2412,-88,-91,3,48:dd:0c:92:4b:e3,4164456,323,51,4164133,4164456
1242,4,11,1,2412,-91,-91,0,48:dd:0c:92:4b:e5,4164792,382,-46,4164410,4164792
1243,4,11,1,2412,-76,-91,15,48:dd:0c:7d:86:23,4175780,323,10665,4175457,4175780
1244,4,11,1,2412,-75,-91,16,48:dd:0c:7d:86:25,4176115,382,-47,4175733,4176115
1245,4,1,1,2412,-85,-91,6,,4178201,304,1782,4177897,4178201
1246,6,6,1,2412,-82,-91,9,40:b0:34:b7:01:d5,4178400,576,-377,4177824,4178400
1247,6,6,1,2412,-83,-91,8,,4179683,44,1239,4179639,4179683
1248,6,6,1,2412,-69,-91,22,12:86:8c:5f:93:1e,4180263,332,248,4179931,4180263
1249,6,6,1,2412,-86,-91,5,e2:db:d1:d1:b0:4a,4191074,444,10367,4190630,4191074
1250,6,6,1,2412,-86,-91,5,e2:db:d1:d1:b0:4b,4191551,408,69,4191143,4191551
1251,6,6,1,2412,-87,-91,4,,4193452,44,1857,4193408,4193452
1252,4,11,1,2412,-70,-91,21,4c:01:43:ec:a0:63,4199677,322,5903,4199355,4199677
1253,4,11,1,2412,-68,-91,23,4c:01:43:ec:a0:66,4200012,387,-52,4199625,4200012
1254,4,11,1,2412,-84,-91,7,48:dd:0c:90:e3:83,4200934,323,599,4200611,4200934
1255,4,11,1,2412,-83,-91,8,48:dd:0c:90:e3:85,4201269,382,-47,4200887,4201269
1256,4,1,1,2412,-63,-91,28,78:67:0e:c4:a8:42,4212738,2736,8733,4210002,4212738
1257,6,6,1,2412,-84,-91,7,,4216376,44,3594,4216332,4216376
1258,6,6,1,2412,-87,-91,4,,4216623,44,203,4216579,4216623
1259,4,1,1,2412,-87,-91,4,,4222967,304,6040,4222663,4222967
1260,6,24,1,2412,-82,-91,9,,4230871,28,7876,4230843,4230871
1261,6,6,1,2412,-68,-91,23,32:86:8c:5f:93:1e,4231462,332,259,4231130,4231462
1262,6,24,1,2412,-81,-91,10,,4237269,28,5779,4237241,4237269
1263,6,24,1,2412,-84,-91,7,,4243924,28,6627,4243896,4243924
1264,6,6,1,2412,-86,-91,5,,4249037,44,5069,4248993,4249037
1265,4,1,1,2412,-81,-91,10,b0:e4:d5:32:ec:8a,4253271,1960,2274,4251311,4253271
1266,6,6,1,2412,-87,-91,4,e2:db:d1:d1:b0:4a,4256679,68,3340,4256611,4256679
1267,6,6,1,2412,-68,-91,23,10:86:8c:5f:93:1e,4257063,344,40,4256719,4257063
1268,6,24,1,2412,-86,-91,5,e2:db:d1:d1:b0:4a,4258172,28,1081,4258144,4258172
1269,6,6,1,2412,-87,-91,4,,4258390,44,174,4258346,4258390
1270,6,6,1,2412,-84,-91,7,3c:bd:c5:ee:96:6d,4259520,68,1062,4259452,4259520
1271,4,1,1,2412,-62,-91,29,94:a6:7e:c9:98:67,4260263,2464,-1721,4257799,4260263
1272,4,11,1,2412,-89,-91,2,48:dd:0c:92:4b:e5,4267192,382,6547,4266810,4267192
1273,4,1,1,2412,-88,-91,3,10:7b:44:eb:35:60,4267984,1960,-1168,4266024,4267984
1274,4,11,1,2412,-75,-91,16,48:dd:0c:7d:86:23,4275803,323,7496,4275480,4275803
1275,6,6,1,2412,-82,-91,9,,4279308,44,3461,4279264,4279308
1276,6,6,1,2412,-83,-91,8,3c:bd:c5:ee:96:6d,4279604,68,228,4279536,4279604
1277,6,24,1,2412,-81,-91,10,78:67:0e:c4:a8:42,4280317,32,681,4280285,4280317
1278,6,6,1,2412,-66,-91,25,12:86:8c:5f:93:1e,4282663,332,2014,4282331,4282663
1279,6,24,1,2412,-80,-91,11,78:67:0e:c4:a8:42,4286293,32,3598,4286261,4286293
1280,4,1,1,2412,-90,-91,1,d8:9c:8e:01:4c:6a,4287554,3000,-1739,4284554,4287554
1281,6,6,1,2412,-87,-91,4,e2:db:d1:d1:b0:4b,4293944,408,5982,4293536,4293944
1282,6,6,1,2412,-88,-91,3,e2:db:d1:d1:b0:4d,4294403,408,51,4293995,4294403
1283,6,6,1,2412,-87,-91,4,,4295403,44,956,4295359,4295403
1284,6,6,1,2412,-87,-91,4,e2:db:d1:d1:b0:4a,4296465,68,994,4296397,4296465
1285,6,6,1,2412,-86,-91,5,,4297988,44,1479,4297944,4297988
1286,4,11,1,2412,-82,-91,9,4c:01:43:ec:a0:63,4302076,322,3766,4301754,4302076
1287,4,11,1,2412,-83,-91,8,4c:01:43:ec:a0:66,4302411,387,-52,4302024,4302411
1288,4,11,1,2412,-87,-91,4,48:dd:0c:90:e3:87,4302959,362,186,4302597,4302959
1289,4,11,1,2412,-86,-91,5,48:dd:0c:90:e3:83,4303333,323,51,4303010,4303333
1290,4,11,1,2412,-87,-91,4,48:dd:0c:90:e3:85,4303669,382,-46,4303287,4303669
1291,6,6,1,2412,-65,-91,26,52:86:8c:5f:93:1e,4308262,332,4261,4307930,4308262
1292,4,1,1,2412,-83,-91,8,10:7b:44:eb:35:60,4313597,384,4951,4313213,4313597
1293,4,1,1,2412,-68,-91,23,ac:67:84:84:8a:07,4313995,448,-50,4313547,4313995
1294,4,1,1,2412,-84,-91,7,10:7b:44:eb:35:60,4314474,384,95,4314090,4314474
1295,6,24,1,2412,-84,-91,7,,4323473,28,8971,4323445,4323473
1296,6,6,1,2412,-66,-91,25,32:86:8c:5f:93:1e,4333864,332,10059,4333532,4333864
1297,6,24,1,2412,-85,-91,6,e2:db:d1:d1:b0:4a,4338492,28,4600,4338464,4338492
1298,6,6,1,2412,-87,-91,4,,4338711,44,175,4338667,4338711
1299,4,11,1,2412,-83,-91,8,48:dd:0c:90:e3:83,4344205,254,5240,4343951,4344205
1300,4,11,1,2412,-75,-91,16,48:dd:0c:7d:86:23,4344507,254,48,4344253,4344507
1301,4,1,1,2412,-88,-91,3,ac:67:84:84:8a:07,4352693,416,7770,4352277,4352693
1302,4,1,1,2412,-69,-91,22,,4353121,304,124,4352817,4353121
1303,6,24,1,2412,-82,-91,9,,4353822,28,673,4353794,4353822
1304,6,24,1,2412,-82,-91,9,78:67:0e:c4:a8:42,4357621,32,3767,4357589,4357621
1305,6,6,1,2412,-87,-91,4,e2:db:d1:d1:b0:4a,4362378,68,4689,4362310,4362378
1306,4,1,1,2412,-59,-91,32,94:a6:7e:c9:98:67,4362647,2464,-2195,4360183,4362647
1307,6,6,1,2412,-87,-91,4,e2:db:d1:d1:b0:4a,4366876,52,4177,4366824,4366876
1308,7,6.5,1,2412,0,-91,91,e2:db:d1:d1:b0:4a,4367006,272,-142,4366734,4367006
1309,7,6.5,1,2412,0,-91,91,e2:db:d1:d1:b0:4a,4367006,336,-336,4366670,4367006
1310,7,6.5,1,2412,0,-91,91,e2:db:d1:d1:b0:4a,4367006,128,-128,4366878,4367006
1311,7,6.5,1,2412,0,-91,91,e2:db:d1:d1:b0:4a,4367006,1912,-1912,4365094,4367006
1312,7,6.5,1,2412,0,-91,91,e2:db:d1:d1:b0:4a,4367006,132,-132,4366874,4367006
1313,7,6.5,1,2412,0,-91,91,e2:db:d1:d1:b0:4a,4367006,120,-120,4366886,4367006
1314,7,6.5,1,2412,0,-91,91,e2:db:d1:d1:b0:4a,4367006,128,-128,4366878,4367006
1315,7,6.5,1,2412,-83,-91,8,e2:db:d1:d1:b0:4a,4367006,460,-460,4366546,4367006
1316,6,6,1,2412,-85,-91,6,,4376182,44,9132,4376138,4376182
1317,6,24,1,2412,-87,-91,4,,4377055,28,845,4377027,4377055
1318,4,1,1,2412,-84,-91,7,78:67:0e:38:6c:d3,4377447,2736,-2344,4374711,4377447
1319,4,11,1,2412,-75,-91,16,48:dd:0c:7d:86:27,4380206,362,2397,4379844,4380206
1320,4,11,1,2412,-75,-91,16,48:dd:0c:7d:86:23,4380581,323,52,4380258,4380581
1321,4,11,1,2412,-75,-91,16,48:dd:0c:7d:86:25,4380916,382,-47,4380534,4380916
1322,4,1,1,2412,-85,-91,6,78:67:0e:38:6c:d3,4383058,3808,-1666,4379250,4383058
1323,4,1,1,2412,-79,-91,12,78:67:0e:38:6c:d3,4386877,3760,59,4383117,4386877
1324,6,6,1,2412,-87,-91,4,e2:db:d1:d1:b0:4a,4393796,68,6851,4393728,4393796
1325,6,6,1,2412,-86,-91,5,e2:db:d1:d1:b0:4a,4393996,52,148,4393944,4393996
1326,6,6,1,2412,-84,-91,7,e2:db:d1:d1:b0:4a,4394577,68,513,4394509,4394577
1327,4,11,1,2412,-82,-91,9,4c:01:43:ec:a0:69,4404101,361,9163,4403740,4404101
1328,4,11,1,2412,-83,-91,8,4c:01:43:ec:a0:63,4404475,322,52,4404153,4404475
1329,4,11,1,2412,-81,-91,10,48:dd:0c:90:e3:87,4405359,362,522,4404997,4405359
1330,4,11,1,2412,-81,-91,10,48:dd:0c:90:e3:83,4405733,323,51,4405410,4405733
1331,4,11,1,2412,-83,-91,8,48:dd:0c:90:e3:85,4406068,382,-47,4405686,4406068
1332,6,24,1,2412,-84,-91,7,,4406877,28,781,4406849,4406877
1333,6,6,1,2412,-87,-91,4,e2:db:d1:d1:b0:4a,4407525,68,580,4407457,4407525
1334,6,6,1,2412,-85,-91,6,e2:db:d1:d1:b0:4a,4408069,68,476,4408001,4408069
1335,6,6,1,2412,-87,-91,4,e2:db:d1:d1:b0:4a,4408618,52,497,4408566,4408618
1336,6,6,1,2412,-87,-91,4,,4409103,44,441,4409059,4409103
1337,6,6,1,2412,-65,-91,26,52:86:8c:5f:93:1e,4410664,332,1229,4410332,4410664
1338,6,6,1,2412,-84,-91,7,e2:db:d1:d1:b0:4a,4414047,52,3331,4413995,4414047
1339,6,6,1,2412,-84,-91,7,e2:db:d1:d1:b0:4a,4414427,52,328,4414375,4414427
1340,7,6.5,1,2412,-82,-91,9,e2:db:d1:d1:b0:4a,4414558,196,-65,4414362,4414558
1341,6,6,1,2412,-87,-91,4,,4414865,44,263,4414821,4414865
1342,7,13,1,2412,0,-91,91,e2:db:d1:d1:b0:4a,4415145,108,172,4415037,4415145
1343,7,13,1,2412,-82,-91,9,e2:db:d1:d1:b0:4a,4415145,240,-240,4414905,4415145
1344,6,6,1,2412,-87,-91,4,,4415589,44,400,4415545,4415589
1345,6,24,1,2412,-88,-91,3,,4415717,28,100,4415689,4415717
1346,6,6,1,2412,-87,-91,4,,4415836,44,75,4415792,4415836
1347,6,6,1,2412,-84,-91,7,,4416451,44,571,4416407,4416451
1348,6,24,1,2412,-87,-91,4,,4416510,28,31,4416482,4416510
1349,6,6,1,2412,-86,-91,5,,4416661,44,107,4416617,4416661
1350,6,24,1,2412,-81,-91,10,,4420250,28,3561,4420222,4420250
1351,6,24,1,2412,-87,-91,4,,4420519,28,241,4420491,4420519
1352,6,6,1,2412,-84,-91,7,e2:db:d1:d1:b0:4a,4420945,68,358,4420877,4420945
1353,6,24,1,2412,-84,-91,7,e2:db:d1:d1:b0:4a,4423013,28,2040,4422985,4423013
1354,6,6,1,2412,-87,-91,4,,4423232,44,175,4423188,4423232
1355,6,6,1,2412,-84,-91,7,e2:db:d1:d1:b0:4a,4423794,52,510,4423742,4423794
1356,6,6,1,2412,-86,-91,5,,4424120,44,282,4424076,4424120
1357,6,6,1,2412,-86,-91,5,e2:db:d1:d1:b0:4a,4424251,52,79,4424199,4424251
1358,6,6,1,2412,-86,-91,5,e2:db:d1:d1:b0:4a,4425263,52,960,4425211,4425263
1359,7,6.5,1,2412,0,-91,91,e2:db:d1:d1:b0:4a,4425394,172,-41,4425222,4425394
1360,7,6.5,1,2412,-82,-91,9,e2:db:d1:d1:b0:4a,4425394,156,-156,4425238,4425394
1361,6,6,1,2412,-86,-91,5,,4425846,44,408,4425802,4425846
1362,6,6,1,2412,-85,-91,6,e2:db:d1:d1:b0:4a,4426013,52,115,4425961,4426013
1363,6,6,1,2412,-86,-91,5,e2:db:d1:d1:b0:4a,4426613,52,548,4426561,4426613
1364,6,24,1,2412,-84,-91,7,,4427325,28,684,4427297,4427325
1365,4,11,1,2412,-80,-91,11,48:dd:0c:90:e3:85,4430988,377,3286,4430611,4430988
1366,6,6,1,2412,-85,-91,6,e2:db:d1:d1:b0:4a,4431492,52,452,4431440,4431492
1367,7,13,1,2412,-81,-91,10,e2:db:d1:d1:b0:4a,4431622,108,22,4431514,4431622
1368,6,6,1,2412,-87,-91,4,e2:db:d1:d1:b0:4a,4431891,52,217,4431839,4431891
1369,7,13,1,2412,-82,-91,9,e2:db:d1:d1:b0:4a,4432022,108,23,4431914,4432022
1370,6,6,1,2412,-86,-91,5,,4432218,44,152,4432174,4432218
1371,4,11,1,2412,-76,-91,15,48:dd:0c:7d:86:25,4432480,377,-115,4432103,4432480
1372,7,13,1,2412,-82,-91,9,e2:db:d1:d1:b0:4a,4432775,108,187,4432667,4432775
1373,6,6,1,2412,-86,-91,5,e2:db:d1:d1:b0:4a,4433017,52,190,4432965,4433017
1374,6,6,1,2412,-85,-91,6,,4433438,44,377,4433394,4433438
1375,6,6,1,2412,-85,-91,6,e2:db:d1:d1:b0:4a,4433926,52,436,4433874,4433926
1376,7,13,1,2412,-81,-91,10,e2:db:d1:d1:b0:4a,4434056,996,-866,4433060,4434056
1377,6,6,1,2412,-84,-91,7,e2:db:d1:d1:b0:4a,4435266,52,1158,4435214,4435266
1378,6,6,1,2412,-63,-91,28,32:86:8c:5f:93:1e,4436318,332,720,4435986,4436318
1379,7,6.5,1,2412,-82,-91,9,e2:db:d1:d1:b0:4a,4436720,1952,-1550,4434768,4436720
1380,6,6,1,2412,-85,-91,6,,4438787,44,2023,4438743,4438787
1381,6,6,1,2412,-81,-91,10,,4440422,44,1591,4440378,4440422
1382,6,24,1,2412,-83,-91,8,,4455104,28,14654,4455076,4455104
1383,4,1,1,2412,-71,-91,20,b0:e4:d5:32:ec:8a,4458070,1960,1006,4456110,4458070
1384,6,24,1,2412,-85,-91,6,e2:db:d1:d1:b0:4a,4461140,28,3042,4461112,4461140
1385,6,6,1,2412,-85,-91,6,,4461358,44,174,4461314,4461358
1386,4,1,1,2412,-87,-91,4,bc:98:df:ff:0f:8b,4462037,2568,-1889,4459469,4462037
1387,4,1,1,2412,-62,-91,29,94:a6:7e:c9:98:67,4465068,2464,567,4462604,4465068
1388,6,6,1,2412,-62,-91,29,10:86:8c:5f:93:1e,4467387,344,1975,4467043,4467387
1389,4,11,1,2412,-83,-91,8,4c:01:43:d7:f3:29,4468282,362,533,4467920,4468282
1390,4,11,1,2412,-84,-91,7,4c:01:43:d7:f3:23,4468656,322,52,4468334,4468656
1391,4,11,1,2412,-83,-91,8,4c:01:43:d7:f3:26,4468991,387,-52,4468604,4468991
1392,6,24,1,2412,-81,-91,10,,4470870,28,1851,4470842,4470870
1393,4,11,1,2412,-75,-91,16,48:dd:0c:7d:86:27,4482606,362,11374,4482244,4482606
1394,4,11,1,2412,-74,-91,17,48:dd:0c:7d:86:23,4482981,323,52,4482658,4482981
1395,4,11,1,2412,-74,-91,17,48:dd:0c:7d:86:25,4483316,382,-47,4482934,4483316
1396,4,1,1,2412,-89,-91,2,ac:67:84:84:8a:07,4484952,416,1220,4484536,4484952
1397,6,6,1,2412,-88,-91,3,40:b0:34:b7:01:d5,4485602,576,74,4485026,4485602
1398,4,1,1,2412,-90,-91,1,,4486841,304,935,4486537,4486841
1399,6,6,1,2412,-64,-91,27,12:86:8c:5f:93:1e,4487465,332,292,4487133,4487465
1400,4,1,1,2412,-90,-91,1,00:26:62:eb:ea:74,4492982,968,4549,4492014,4492982
1401,6,24,1,2412,-83,-91,8,,4497840,28,4830,4497812,4497840
1402,6,6,1,2412,-84,-91,7,e2:db:d1:d1:b0:4a,4498282,444,-2,4497838,4498282
1403,6,6,1,2412,-84,-91,7,e2:db:d1:d1:b0:4b,4498759,408,69,4498351,4498759
1404,4,11,1,2412,-80,-91,11,4c:01:43:ec:a0:69,4506500,361,7380,4506139,4506500
1405,4,11,1,2412,-70,-91,21,4c:01:43:ec:a0:63,4506874,322,52,4506552,4506874
1406,4,11,1,2412,-82,-91,9,4c:01:43:ec:a0:66,4507209,387,-52,4506822,4507209
1407,4,11,1,2412,-85,-91,6,48:dd:0c:90:e3:87,4507758,362,187,4507396,4507758
1408,4,1,1,2412,-61,-91,30,aa:c1:43:3f:c0:7a,4508133,1128,-753,4507005,4508133
1409,4,1,1,2412,-60,-91,31,,4512395,304,3958,4512091,4512395
1410,6,6,1,2412,-64,-91,27,52:86:8c:5f:93:1e,4513134,332,407,4512802,4513134
1411,6,6,1,2412,-83,-91,8,0a:a7:c0:a3:8d:75,4517169,408,3627,4516761,4517169
1412,6,24,1,2412,-82,-91,9,,4518331,28,1134,4518303,4518331
1413,4,1,1,2412,-83,-91,8,78:67:0e:c4:a8:42,4519938,2736,-1129,4517202,4519938
1414,4,1,1,2412,-93,-91,-2,04:a2:22:bf:24:52,4524018,2512,1568,4521506,4524018
1415,6,6,1,2412,-84,-91,7,,4542440,44,18378,4542396,4542440
1416,6,24,1,2412,-84,-91,7,,4550876,28,8408,4550848,4550876
1417,4,1,1,2412,-93,-91,-2,04:a2:22:bf:24:52,4555436,432,4128,4555004,4555436
1418,6,24,1,2412,-83,-91,8,,4555720,28,256,4555692,4555720
1419,4,1,1,2412,-90,-91,1,04:a2:22:bf:24:52,4556210,432,58,4555778,4556210
1420,4,1,1,2412,-92,-91,-1,04:a2:22:bf:24:52,4557001,432,359,4556569,4557001
1421,4,1,1,2412,-93,-91,-2,04:a2:22:bf:24:52,4557803,432,370,4557371,4557803
1422,4,1,1,2412,-85,-91,6,bc:98:df:ff:0f:8b,4564424,2568,4053,4561856,4564424
1423,4,1,1,2412,-63,-91,28,94:a6:7e:c9:98:67,4567014,2464,126,4564550,4567014
1424,4,1,1,2412,-91,-91,0,ac:67:84:84:8a:07,4572411,416,4981,4571995,4572411
1425,6,6,1,2412,-83,-91,8,e2:db:d1:d1:b0:4a,4581427,68,8948,4581359,4581427
1426,4,11,1,2412,-69,-91,22,48:dd:0c:7d:86:27,4582628,362,839,4582266,4582628
1427,4,11,1,2412,-79,-91,12,48:dd:0c:7d:86:23,4583002,323,51,4582679,4583002
1428,4,11,1,2412,-70,-91,21,48:dd:0c:7d:86:25,4583338,382,-46,4582956,4583338
1429,4,1,1,2412,-85,-91,6,78:67:0e:38:6c:d3,4583741,2736,-2333,4581005,4583741
1430,6,24,1,2412,-82,-91,9,,4586397,28,2628,4586369,4586397
1431,6,6,1,2412,-64,-91,27,12:86:8c:5f:93:1e,4589865,332,3136,4589533,4589865
1432,4,1,1,2412,-89,-91,2,10:7b:44:eb:35:60,4600376,384,10127,4599992,4600376
1433,4,1,1,2412,-88,-91,3,10:7b:44:eb:35:60,4600852,384,92,4600468,4600852
1434,6,6,1,2412,-81,-91,10,e2:db:d1:d1:b0:4a,4601577,444,281,4601133,4601577
1435,6,6,1,2412,-81,-91,10,e2:db:d1:d1:b0:4b,4602045,408,60,4601637,4602045
1436,6,6,1,2412,-82,-91,9,e2:db:d1:d1:b0:4f,4602954,408,501,4602546,4602954
1437,6,6,1,2412,-86,-91,5,0a:a7:c0:a3:8d:70,4603794,156,684,4603638,4603794
1438,6,12,1,2412,-87,-91,4,,4604258,32,432,4604226,4604258
1439,4,1,1,2412,-86,-91,5,ac:67:84:84:8a:07,4606967,416,2293,4606551,4606967
1440,4,1,1,2412,-86,-91,5,,4608536,304,1265,4608232,4608536
1441,4,11,1,2412,-82,-91,9,4c:01:43:ec:a0:69,4608899,361,2,4608538,4608899
1442,4,11,1,2412,-82,-91,9,4c:01:43:ec:a0:63,4609273,322,52,4608951,4609273
1443,4,11,1,2412,-82,-91,9,4c:01:43:ec:a0:66,4609607,387,-53,4609220,4609607
1444,4,11,1,2412,-84,-91,7,48:dd:0c:90:e3:87,4610158,362,189,4609796,4610158
1445,4,11,1,2412,-83,-91,8,48:dd:0c:90:e3:83,4610533,323,52,4610210,4610533
1446,4,1,1,2412,-91,-91,0,40:ca:63:2d:74:be,4612255,1896,-174,4610359,4612255
1447,4,1,1,2412,-59,-91,32,1e:e6:95:95:b4:fe,4617661,1128,4278,4616533,4617661
1448,6,6,1,2412,-85,-91,6,0a:a7:c0:a3:8d:70,4619925,464,1800,4619461,4619925
1449,6,6,1,2412,-86,-91,5,0a:a7:c0:a3:8d:71,4620545,408,212,4620137,4620545
1450,6,6,1,2412,-87,-91,4,0a:a7:c0:a3:8d:73,4621004,408,51,4620596,4621004
1451,6,6,1,2412,-86,-91,5,0a:a7:c0:a3:8d:75,4621666,408,254,4621258,4621666
1452,4,1,1,2412,-81,-91,10,78:67:0e:c4:a8:42,4625507,2736,1105,4622771,4625507
1453,6,24,1,2412,-82,-91,9,,4630872,28,5337,4630844,4630872
1454,4,1,1,2412,-80,-91,11,78:67:0e:c4:a8:42,4631762,352,538,4631410,4631762
1455,6,6,1,2412,-81,-91,10,e2:db:d1:d1:b0:4a,4633443,68,1613,4633375,4633443
1456,6,24,1,2412,-81,-91,10,e2:db:d1:d1:b0:4a,4634731,28,1260,4634703,4634731
1457,6,6,1,2412,-81,-91,10,,4634950,44,175,4634906,4634950
1458,6,6,1,2412,-68,-91,23,32:86:8c:5f:93:1e,4641066,332,5784,4640734,4641066
1459,4,1,1,2412,-88,-91,3,ce:f4:11:65:3f:f8,4642812,2072,-326,4640740,4642812
1460,4,1,1,2412,-81,-91,10,ac:67:84:84:8a:07,4652397,416,9169,4651981,4652397
1461,6,6,1,2412,-67,-91,24,10:86:8c:5f:93:1e,4666666,344,13925,4666322,4666666
1462,4,1,1,2412,-67,-91,24,94:a6:7e:c9:98:67,4669861,2464,731,4667397,4669861
1463,4,11,1,2412,-89,-91,2,48:dd:0c:92:4b:e3,4676456,323,6272,4676133,4676456
1464,4,11,1,2412,-87,-91,4,48:dd:0c:92:4b:e5,4676791,382,-47,4676409,4676791
1465,4,11,1,2412,-76,-91,15,48:dd:0c:7d:86:23,4680092,254,3047,4679838,4680092
1466,4,11,1,2412,-88,-91,3,48:dd:0c:92:4b:e3,4680739,254,393,4680485,4680739
1467,4,1,1,2412,-85,-91,6,78:67:0e:38:6c:d3,4684648,2736,1173,4681912,4684648
1468,4,11,1,2412,-75,-91,16,48:dd:0c:7d:86:27,4687407,362,2397,4687045,4687407
1469,4,11,1,2412,-63,-91,28,48:dd:0c:7d:86:23,4687781,323,51,4687458,4687781
1470,4,11,1,2412,-75,-91,16,48:dd:0c:7d:86:25,4688116,382,-47,4687734,4688116
1471,6,6,1,2412,-82,-91,9,,4690131,44,1971,4690087,4690131
1472,6,6,1,2412,-86,-91,5,40:b0:34:b7:01:d5,4690523,576,-184,4689947,4690523
1473,4,1,1,2412,-88,-91,3,00:26:62:eb:ea:74,4700357,968,8866,4699389,4700357
1474,4,1,1,2412,-84,-91,7,cc:f4:11:65:3f:fb,4701691,1184,150,4700507,4701691
1475,6,6,1,2412,-81,-91,10,e2:db:d1:d1:b0:4a,4705145,68,3386,4705077,4705145
1476,6,6,1,2412,-80,-91,11,,4705374,44,185,4705330,4705374
1477,4,1,1,2412,-68,-91,23,94:a6:7e:c9:98:67,4708976,3072,530,4705904,4708976
1478,4,1,1,2412,-69,-91,22,94:a6:7e:c9:98:67,4713656,3072,1608,4710584,4713656
1479,4,1,1,2412,-67,-91,24,94:a6:7e:c9:98:67,4717108,3072,380,4714036,4717108
1480,4,1,1,2412,-51,-91,40,,4720193,304,2781,4719889,4720193
1481,4,1,1,2412,-64,-91,27,94:a6:7e:c9:98:67,4724250,3072,985,4721178,4724250
1482,4,1,1,2412,-85,-91,6,78:67:0e:c4:a8:42,4727658,2736,672,4724922,4727658
1483,4,1,1,2412,-85,-91,6,78:67:0e:c4:a8:42,4730521,832,2031,4729689,4730521
1484,4,1,1,2412,-85,-91,6,cc:f4:11:65:3f:fb,4731492,1536,-565,4729956,4731492
1485,4,1,1,2412,-90,-91,1,ac:67:84:84:8a:07,4736061,416,4153,4735645,4736061
1486,4,1,1,2412,-88,-91,3,,4736489,304,124,4736185,4736489
1487,4,1,1,2412,-72,-91,19,ce:f4:11:65:3f:f8,4745212,2072,6651,4743140,4745212
1488,6,24,1,2412,-83,-91,8,,4749629,28,4389,4749601,4749629
1489,6,24,1,2412,-83,-91,8,e2:db:d1:d1:b0:4a,4757470,28,7813,4757442,4757470
1490,6,6,1,2412,-83,-91,8,,4757689,44,175,4757645,4757689
1491,6,24,1,2412,-84,-91,7,,4758085,28,368,4758057,4758085
1492,4,1,1,2412,-89,-91,2,,4760279,304,1890,4759975,4760279
1493,6,6,1,2412,-71,-91,20,10:86:8c:5f:93:1e,4769065,344,8442,4768721,4769065
1494,4,11,1,2412,-69,-91,22,10:86:8c:5f:93:1e,4769609,347,197,4769262,4769609
1495,4,1,1,2412,-55,-91,36,94:a6:7e:c9:98:67,4772259,2464,186,4769795,4772259
1496,4,11,1,2412,-81,-91,10,4c:01:43:d7:f3:29,4775480,362,2859,4775118,4775480
1497,4,11,1,2412,-80,-91,11,4c:01:43:d7:f3:23,4775855,322,53,4775533,4775855
1498,4,11,1,2412,-81,-91,10,4c:01:43:d7:f3:26,4776189,387,-53,4775802,4776189
1499,6,24,1,2412,-82,-91,9,4c:01:43:d7:f3:26,4777026,32,805,4776994,4777026
1500,4,11,1,2412,-87,-91,4,48:dd:0c:92:4b:e3,4778856,323,1507,4778533,4778856
1501,4,1,1,2412,-87,-91,4,10:7b:44:eb:35:60,4779993,1960,-823,4778033,4779993
1502,4,1,1,2412,-92,-91,-1,10:7b:44:eb:35:60,4781990,1152,845,4780838,4781990
1503,6,6,1,2412,-84,-91,7,e2:db:d1:d1:b0:4a,4783846,68,1788,4783778,4783846
1504,4,11,1,2412,-71,-91,20,48:dd:0c:7d:86:27,4789807,362,5599,4789445,4789807
1505,4,11,1,2412,-72,-91,19,48:dd:0c:7d:86:25,4790516,382,327,4790134,4790516
1506,4,1,1,2412,-83,-91,8,78:67:0e:38:6c:d3,4794261,1056,2689,4793205,4794261
1507,6,6,1,2412,-69,-91,22,12:86:8c:5f:93:1e,4795173,332,580,4794841,4795173
1508,7,6.5,1,2412,0,-91,91,e2:db:d1:d1:b0:4a,4799663,1432,3058,4798231,4799663
1509,7,6.5,1,2412,0,-91,91,e2:db:d1:d1:b0:4a,4799663,132,-132,4799531,4799663
1510,6,6,1,2412,-83,-91,8,e2:db:d1:d1:b0:4a,4804040,68,4309,4803972,4804040
1511,6,24,1,2412,-83,-91,8,,4805627,28,1559,4805599,4805627
1512,4,1,1,2412,-85,-91,6,78:67:0e:c4:a8:42,4806056,1184,-755,4804872,4806056
1513,4,1,1,2412,-81,-91,10,78:67:0e:c4:a8:42,4812337,352,5929,4811985,4812337
1514,6,6,1,2412,-82,-91,9,,4815946,44,3565,4815902,4815946
1515,6,6,1,2412,-69,-91,22,52:86:8c:5f:93:1e,4820397,332,4119,4820065,4820397
1516,4,1,1,2412,-78,-91,13,3c:bd:c5:ee:96:6d,4827830,2512,4921,4825318,4827830
1517,7,6.5,1,2412,-84,-91,7,e2:db:d1:d1:b0:4a,4832301,1952,2519,4830349,4832301
1518,7,6.5,1,2412,0,-91,91,e2:db:d1:d1:b0:4a,4837586,1900,3385,4835686,4837586
1519,7,6.5,1,2412,0,-91,91,e2:db:d1:d1:b0:4a,4837586,376,-376,4837210,4837586
1520,7,6.5,1,2412,0,-91,91,e2:db:d1:d1:b0:4a,4837586,1580,-1580,4836006,4837586
1521,7,6.5,1,2412,0,-91,91,e2:db:d1:d1:b0:4a,4837586,1580,-1580,4836006,4837586
1522,7,6.5,1,2412,0,-91,91,e2:db:d1:d1:b0:4a,4837586,1580,-1580,4836006,4837586
1523,7,6.5,1,2412,-86,-91,5,e2:db:d1:d1:b0:4a,4837586,1576,-1576,4836010,4837586
1524,6,6,1,2412,-83,-91,8,e2:db:d1:d1:b0:4a,4842529,52,4891,4842477,4842529
1525,6,6,1,2412,-68,-91,23,32:86:8c:5f:93:1e,4845876,332,3015,4845544,4845876
1526,4,11,1,2412,-83,-91,8,4c:01:43:ec:a0:63,4853179,254,7049,4852925,4853179
1527,7,14.4444,1,2412,-83,-91,8,e2:db:d1:d1:b0:4a,4859060,97,5784,4858963,4859060
1528,6,6,1,2412,-82,-91,9,,4859239,44,135,4859195,4859239
1529,6,24,1,2412,-82,-91,9,,4862848,28,3581,4862820,4862848
1530,6,24,1,2412,-82,-91,9,,4863476,28,600,4863448,4863476
1531,6,24,1,2412,-82,-91,9,,4865217,28,1713,4865189,4865217
1532,6,6,1,2412,-81,-91,10,e2:db:d1:d1:b0:4a,4865549,68,264,4865481,4865549
1533,6,24,1,2412,-83,-91,8,,4865701,28,124,4865673,4865701
1534,4,1,1,2412,-83,-91,8,78:67:0e:38:6c:d3,4889521,2736,21084,4886785,4889521
1535,4,11,1,2412,-71,-91,20,48:dd:0c:7d:86:27,4892280,362,2397,4891918,4892280
1536,4,11,1,2412,-72,-91,19,48:dd:0c:7d:86:23,4892655,323,52,4892332,4892655
1537,4,11,1,2412,-72,-91,19,48:dd:0c:7d:86:25,4892990,382,-47,4892608,4892990
1538,6,6,1,2412,-64,-91,27,12:86:8c:5f:93:1e,4897110,332,3788,4896778,4897110
1539,4,1,1,2412,-68,-91,23,cc:f4:11:65:3f:fb,4898812,2112,-410,4896700,4898812
1540,4,1,1,2412,-90,-91,1,00:26:62:eb:ea:74,4902584,968,2804,4901616,4902584
1541,6,6,1,2412,-80,-91,11,e2:db:d1:d1:b0:4b,4908341,408,5349,4907933,4908341
1542,6,6,1,2412,-80,-91,11,e2:db:d1:d1:b0:4d,4908791,408,42,4908383,4908791
1543,6,6,1,2412,-80,-91,11,e2:db:d1:d1:b0:4f,4909223,408,24,4908815,4909223
1544,6,6,1,2412,-81,-91,10,,4909855,44,588,4909811,4909855
1545,6,6,1,2412,-81,-91,10,e2:db:d1:d1:b0:4a,4911982,68,2059,4911914,4911982
1546,4,11,1,2412,-81,-91,10,48:dd:0c:90:e3:87,4917357,362,5013,4916995,4917357
1547,4,11,1,2412,-80,-91,11,48:dd:0c:90:e3:83,4917732,323,52,4917409,4917732
1548,6,6,1,2412,-84,-91,7,0a:a7:c0:a3:8d:73,4926283,408,8143,4925875,4926283
1549,4,1,1,2412,-90,-91,1,10:7b:44:eb:35:60,4945977,384,19310,4945593,4945977
1550,4,1,1,2412,-88,-91,3,ac:67:84:84:8a:07,4946375,448,-50,4945927,4946375
1551,4,1,1,2412,-90,-91,1,10:7b:44:eb:35:60,4946854,384,95,4946470,4946854
1552,6,6,1,2412,-80,-91,11,,4953511,44,6613,4953467,4953511
1553,6,6,1,2412,-65,-91,26,,4956627,44,3072,4956583,4956627
1554,6,24,1,2412,-82,-91,9,,4963806,28,7151,4963778,4963806
1555,4,1,1,2412,-78,-91,13,b0:e4:d5:32:ec:8a,4970066,1960,4300,4968106,4970066
1556,6,6,1,2412,-67,-91,24,10:86:8c:5f:93:1e,4973868,344,3458,4973524,4973868
1557,4,1,1,2412,-55,-91,36,94:a6:7e:c9:98:67,4977065,2464,733,4974601,4977065
1558,4,11,1,2412,-83,-91,8,4c:01:43:d7:f3:29,4980364,362,2937,4980002,4980364
1559,4,11,1,2412,-74,-91,17,4c:01:43:d7:f3:23,4980738,322,52,4980416,4980738
1560,6,24,1,2412,-82,-91,9,,4987286,28,6520,4987258,4987286
1561,4,11,1,2412,-75,-91,16,48:dd:0c:7d:86:25,4994602,382,6934,4994220,4994602
1562,4,11,1,2412,-69,-91,22,4c:01:43:d7:f3:23,4996334,254,1478,4996080,4996334
1563,6,24,1,2412,-81,-91,10,,4996948,28,586,4996920,4996948
1564,6,6,1,2412,-86,-91,5,40:b0:34:b7:01:d5,4997608,576,84,4997032,4997608
1565,6,24,1,2412,-82,-91,9,4c:01:43:d7:f3:26,4998638,32,998,4998606,4998638
1566,6,24,1,2412,-82,-91,9,e2:db:d1:d1:b0:4a,4999121,28,455,4999093,4999121
1567,6,6,1,2412,-81,-91,10,,4999340,44,175,4999296,4999340
1568,6,6,1,2412,-67,-91,24,12:86:8c:5f:93:1e,4999467,332,-205,4999135,4999467
1569,4,1,1,2412,-89,-91,2,70:3a:cb:63:35:b2,4999998,2216,-1685,4997782,4999998
1570,4,1,1,2412,-79,-90,11,78:67:0e:38:6c:d3,5017687,3472,14217,5014215,5017687
1571,4,1,1,2412,-79,-90,11,78:67:0e:38:6c:d3,5021286,3472,127,5017814,5021286
1572,4,11,1,2412,-87,-90,3,,5030646,203,9157,5030443,5030646
1573,6,6,1,2412,-82,-90,8,4c:01:43:d7:f3:26,5035025,52,4327,5034973,5035025
1574,6,6,1,2412,-81,-90,9,e2:db:d1:d1:b0:4a,5035298,68,205,5035230,5035298
1575,6,6,1,2412,-82,-90,8,,5036812,44,1470,5036768,5036812
1576,6,24,1,2412,-81,-90,9,,5044162,28,7322,5044134,5044162
1577,4,1,1,2412,-90,-90,0,cc:f4:11:65:3f:fb,5046191,1536,493,5044655,5046191
1578,6,24,1,2412,-80,-90,10,4c:01:43:d7:f3:26,5047749,32,1526,5047717,5047749
1579,6,24,1,2412,-81,-90,9,,5049048,28,1271,5049020,5049048
1580,6,24,1,2412,-81,-90,9,4c:01:43:d7:f3:26,5057982,32,8902,5057950,5057982
1581,4,1,1,2412,-90,-90,0,ac:67:84:84:8a:07,5064317,416,5919,5063901,5064317
1582,4,1,1,2412,-88,-90,2,,5064745,304,124,5064441,5064745
1583,4,1,1,2412,-78,-90,12,b0:e4:d5:32:ec:8a,5072465,1960,5760,5070505,5072465
1584,6,6,1,2412,-67,-90,23,10:86:8c:5f:93:1e,5076268,344,3459,5075924,5076268
1585,4,1,1,2412,-57,-90,33,94:a6:7e:c9:98:67,5079451,2464,719,5076987,5079451
1586,4,11,1,2412,-83,-90,7,4c:01:43:d7:f3:29,5084252,362,4439,5083890,5084252
1587,4,11,1,2412,-84,-90,6,4c:01:43:d7:f3:23,5084627,322,53,5084305,5084627
1588,4,11,1,2412,-85,-90,5,4c:01:43:d7:f3:26,5084961,387,-53,5084574,5084961
1589,4,11,1,2412,-81,-90,9,48:dd:0c:7d:86:23,5097383,323,12099,5097060,5097383
1590,4,11,1,2412,-81,-90,9,48:dd:0c:7d:86:25,5097718,382,-47,5097336,5097718
1591,6,6,1,2412,-69,-90,21,12:86:8c:5f:93:1e,5101868,332,3818,5101536,5101868
1592,4,1,1,2412,-88,-90,2,,5104954,304,2782,5104650,5104954
1593,6,24,1,2412,-81,-90,9,,5105387,28,405,5105359,5105387
1594,4,1,1,2412,-91,-90,-1,d8:9c:8e:01:4c:6a,5107144,3000,-1243,5104144,5107144
1595,4,1,1,2412,-84,-90,6,00:26:62:eb:ea:74,5112734,968,4622,5111766,5112734
1596,6,6,1,2412,-81,-90,9,e2:db:d1:d1:b0:4d,5113599,408,457,5113191,5113599
1597,6,6,1,2412,-83,-90,7,e2:db:d1:d1:b0:4f,5114048,408,41,5113640,5114048
1598,6,6,1,2412,-83,-90,7,e2:db:d1:d1:b0:4d,5114489,308,133,5114181,5114489
1599,6,6,1,2412,-82,-90,8,e2:db:d1:d1:b0:4f,5114884,308,87,5114576,5114884
1600,6,24,1,2412,-84,-90,6,3c:bd:c5:ee:96:6d,5115615,28,703,5115587,5115615
1601,6,6,1,2412,-83,-90,7,,5115894,44,235,5115850,5115894
1602,6,6,1,2412,-82,-90,8,e2:db:d1:d1:b0:4a,5116000,68,38,5115932,5116000
1603,4,11,1,2412,-85,-90,5,4c:01:43:ec:a0:66,5121602,387,5215,5121215,5121602
1604,4,11,1,2412,-74,-90,16,48:dd:0c:90:e3:87,5122157,362,193,5121795,5122157
1605,4,11,1,2412,-76,-90,14,48:dd:0c:90:e3:83,5122531,323,51,5122208,5122531
1606,4,11,1,2412,-78,-90,12,48:dd:0c:90:e3:85,5122867,382,-46,5122485,5122867
1607,6,6,1,2412,-66,-90,24,52:86:8c:5f:93:1e,5127613,332,4414,5127281,5127613
1608,4,1,1,2412,-83,-90,7,78:67:0e:c4:a8:42,5132510,352,4545,5132158,5132510
1609,4,11,1,2412,-86,-90,4,,5137275,107,4658,5137168,5137275
1610,6,6,1,2412,-83,-90,7,,5144607,44,7288,5144563,5144607
1611,6,24,1,2412,-83,-90,7,3c:bd:c5:ee:96:6d,5144687,28,52,5144659,5144687
1612,6,6,1,2412,-83,-90,7,,5144946,44,215,5144902,5144946
1613,6,6,1,2412,-82,-90,8,3c:bd:c5:ee:96:6d,5146334,68,1320,5146266,5146334
1614,6,24,1,2412,-79,-90,11,,5147860,28,1498,5147832,5147860
1615,6,6,1,2412,-68,-90,22,32:86:8c:5f:93:1e,5153068,332,4876,5152736,5153068
1616,4,1,1,2412,-90,-90,0,ce:f4:11:65:3f:f8,5154811,2072,-329,5152739,5154811
1617,6,24,1,2412,-82,-90,8,e2:db:d1:d1:b0:4a,5157484,28,2645,5157456,5157484
1618,6,6,1,2412,-84,-90,6,,5157703,44,175,5157659,5157703
1619,6,6,1,2412,-83,-90,7,3c:bd:c5:ee:96:6d,5160903,68,3132,5160835,5160903
1620,6,6,1,2412,-83,-90,7,e2:db:d1:d1:b0:4a,5165646,68,4675,5165578,5165646
1621,6,24,1,2412,-83,-90,7,e2:db:d1:d1:b0:4a,5166883,28,1209,5166855,5166883
1622,6,6,1,2412,-84,-90,6,,5167102,44,175,5167058,5167102
1623,6,24,1,2412,-79,-90,11,,5170580,28,3450,5170552,5170580
1624,6,6,1,2412,-78,-90,12,,5170827,44,203,5170783,5170827
1625,6,24,1,2412,-81,-90,9,3c:bd:c5:ee:96:6d,5171660,28,805,5171632,5171660
1626,6,6,1,2412,-83,-90,7,,5171875,44,171,5171831,5171875
1627,6,6,1,2412,-81,-90,9,3c:bd:c5:ee:96:6d,5177631,68,5688,5177563,5177631
1628,4,1,1,2412,-68,-90,22,bc:98:df:ff:0f:8b,5178826,2568,-1373,5176258,5178826
1629,6,6,1,2412,-69,-90,21,10:86:8c:5f:93:1e,5181250,344,2080,5180906,5181250
1630,4,1,1,2412,-53,-90,37,94:a6:7e:c9:98:67,5181858,2464,-1856,5179394,5181858
1631,4,1,1,2412,-79,-90,11,78:67:0e:38:6c:d3,5196649,2736,12055,5193913,5196649
1632,4,11,1,2412,-72,-90,18,48:dd:0c:7d:86:27,5199408,362,2397,5199046,5199408
1633,4,11,1,2412,-71,-90,19,48:dd:0c:7d:86:23,5199782,323,51,5199459,5199782
1634,4,11,1,2412,-74,-90,16,48:dd:0c:7d:86:25,5200118,382,-46,5199736,5200118
1635,6,6,1,2412,-84,-90,6,e2:db:d1:d1:b0:4a,5202176,68,1990,5202108,5202176
1636,6,6,1,2412,-81,-90,9,40:b0:34:b7:01:d5,5202410,576,-342,5201834,5202410
1637,6,24,1,2412,-83,-90,7,e2:db:d1:d1:b0:4a,5203552,28,1114,5203524,5203552
1638,6,6,1,2412,-66,-90,24,12:86:8c:5f:93:1e,5204270,332,386,5203938,5204270
1639,4,1,1,2412,-89,-90,1,cc:f4:11:65:3f:fb,5206011,2112,-371,5203899,5206011
1640,6,6,1,2412,-80,-90,10,3c:bd:c5:ee:96:6d,5214056,68,7977,5213988,5214056
1641,6,6,1,2412,-83,-90,7,e2:db:d1:d1:b0:4d,5216011,408,1547,5215603,5216011
1642,6,6,1,2412,-83,-90,7,e2:db:d1:d1:b0:4f,5216452,408,33,5216044,5216452
1643,6,6,1,2412,-83,-90,7,e2:db:d1:d1:b0:4a,5218115,656,1007,5217459,5218115
1644,6,6,1,2412,-84,-90,6,e2:db:d1:d1:b0:4a,5218804,156,533,5218648,5218804
1645,6,6,1,2412,-83,-90,7,e2:db:d1:d1:b0:4a,5218993,196,-7,5218797,5218993
1646,6,6,1,2412,-82,-90,8,e2:db:d1:d1:b0:4a,5219222,156,73,5219066,5219222
1647,4,11,1,2412,-78,-90,12,48:dd:0c:90:e3:87,5224557,362,4973,5224195,5224557
1648,4,11,1,2412,-79,-90,11,48:dd:0c:90:e3:83,5224931,323,51,5224608,5224931
1649,4,11,1,2412,-78,-90,12,48:dd:0c:90:e3:85,5225266,382,-47,5224884,5225266
1650,7,19.5,1,2412,-83,-90,7,e2:db:d1:d1:b0:4a,5225770,148,356,5225622,5225770
1651,7,19.5,1,2412,0,-90,90,e2:db:d1:d1:b0:4a,5225999,84,145,5225915,5225999
1652,7,19.5,1,2412,0,-90,90,e2:db:d1:d1:b0:4a,5225999,48,-48,5225951,5225999
1653,7,19.5,1,2412,0,-90,90,e2:db:d1:d1:b0:4a,5225999,48,-48,5225951,5225999
1654,7,19.5,1,2412,0,-90,90,e2:db:d1:d1:b0:4a,5225999,44,-44,5225955,5225999
1655,7,19.5,1,2412,0,-90,90,e2:db:d1:d1:b0:4a,5225999,48,-48,5225951,5225999
1656,7,19.5,1,2412,0,-90,90,e2:db:d1:d1:b0:4a,5225999,48,-48,5225951,5225999
1657,7,19.5,1,2412,0,-90,90,e2:db:d1:d1:b0:4a,5225999,44,-44,5225955,5225999
1658,7,19.5,1,2412,0,-90,90,e2:db:d1:d1:b0:4a,5225999,48,-48,5225951,5225999
1659,7,19.5,1,2412,0,-90,90,e2:db:d1:d1:b0:4a,5225999,48,-48,5225951,5225999
1660,7,19.5,1,2412,-83,-90,7,e2:db:d1:d1:b0:4a,5225999,44,-44,5225955,5225999
1661,6,6,1,2412,-84,-90,6,,5226611,44,568,5226567,5226611
1662,6,24,1,2412,-83,-90,7,,5226757,28,118,5226729,5226757
1663,7,19.5,1,2412,0,-90,90,e2:db:d1:d1:b0:4a,5227497,76,664,5227421,5227497
1664,7,19.5,1,2412,0,-90,90,e2:db:d1:d1:b0:4a,5227497,48,-48,5227449,5227497
1665,7,19.5,1,2412,0,-90,90,e2:db:d1:d1:b0:4a,5227497,48,-48,5227449,5227497
1666,7,19.5,1,2412,0,-90,90,e2:db:d1:d1:b0:4a,5227497,44,-44,5227453,5227497
1667,7,19.5,1,2412,0,-90,90,e2:db:d1:d1:b0:4a,5227497,48,-48,5227449,5227497
1668,7,19.5,1,2412,0,-90,90,e2:db:d1:d1:b0:4a,5227497,48,-48,5227449,5227497
1669,7,19.5,1,2412,0,-90,90,e2:db:d1:d1:b0:4a,5227497,44,-44,5227453,5227497
1670,7,19.5,1,2412,0,-90,90,e2:db:d1:d1:b0:4a,5227497,48,-48,5227449,5227497
1671,7,19.5,1,2412,0,-90,90,e2:db:d1:d1:b0:4a,5227497,236,-236,5227261,5227497
1672,7,19.5,1,2412,0,-90,90,e2:db:d1:d1:b0:4a,5227497,72,-72,5227425,5227497
1673,7,19.5,1,2412,0,-90,90,e2:db:d1:d1:b0:4a,5227497,72,-72,5227425,5227497
1674,7,19.5,1,2412,0,-90,90,e2:db:d1:d1:b0:4a,5227497,184,-184,5227313,5227497
1675,7,19.5,1,2412,0,-90,90,e2:db:d1:d1:b0:4a,5227497,76,-76,5227421,5227497
1676,7,19.5,1,2412,0,-90,90,e2:db:d1:d1:b0:4a,5227497,160,-160,5227337,5227497
1677,7,19.5,1,2412,-76,-90,14,e2:db:d1:d1:b0:4a,5229226,120,1609,5229106,5229226
1678,6,6,1,2412,-69,-90,21,52:86:8c:5f:93:1e,5230836,332,1278,5230504,5230836
1679,6,24,1,2412,-82,-90,8,,5246102,28,15238,5246074,5246102
1680,6,24,1,2412,-83,-90,7,,5249986,28,3856,5249958,5249986
1681,6,6,1,2412,-78,-90,12,e2:db:d1:d1:b0:4a,5250826,52,788,5250774,5250826
1682,7,19.5,1,2412,-84,-90,6,e2:db:d1:d1:b0:4a,5250957,92,39,5250865,5250957
1683,6,6,1,2412,-83,-90,7,,5251129,44,128,5251085,5251129
1684,6,6,1,2412,-83,-90,7,e2:db:d1:d1:b0:4a,5253856,52,2675,5253804,5253856
1685,7,19.5,1,2412,-84,-90,6,e2:db:d1:d1:b0:4a,5253987,84,47,5253903,5253987
1686,6,6,1,2412,-83,-90,7,,5254151,44,120,5254107,5254151
1687,6,6,1,2412,-66,-90,24,32:86:8c:5f:93:1e,5255469,332,986,5255137,5255469
1688,6,6,1,2412,-83,-90,7,e2:db:d1:d1:b0:4a,5257076,52,1555,5257024,5257076
1689,6,6,1,2412,-83,-90,7,,5260321,44,3201,5260277,5260321
1690,6,24,1,2412,-84,-90,6,,5260449,28,100,5260421,5260449
1691,6,6,1,2412,-83,-90,7,e2:db:d1:d1:b0:4a,5260584,68,67,5260516,5260584
1692,6,6,1,2412,-82,-90,8,e2:db:d1:d1:b0:4a,5260811,52,175,5260759,5260811
1693,7,19.5,1,2412,0,-90,90,e2:db:d1:d1:b0:4a,5260941,668,-538,5260273,5260941
1694,6,6,1,2412,-83,-90,7,,5263625,44,2640,5263581,5263625
1695,6,24,1,2412,-84,-90,6,,5263753,28,100,5263725,5263753
1696,6,6,1,2412,-83,-90,7,e2:db:d1:d1:b0:4a,5263912,68,91,5263844,5263912
1697,6,6,1,2412,-84,-90,6,e2:db:d1:d1:b0:4a,5264058,52,94,5264006,5264058
1698,7,19.5,1,2412,-84,-90,6,e2:db:d1:d1:b0:4a,5264189,92,39,5264097,5264189
1699,4,1,1,2412,-86,-90,4,78:67:0e:c4:a8:42,5273882,352,9341,5273530,5273882
1700,6,24,1,2412,-82,-90,8,,5274217,28,307,5274189,5274217
1701,6,6,1,2412,-82,-90,8,e2:db:d1:d1:b0:4a,5274481,68,196,5274413,5274481
1702,6,6,1,2412,-83,-90,7,e2:db:d1:d1:b0:4a,5276267,52,1734,5276215,5276267
1703,7,21.6667,1,2412,0,-90,90,e2:db:d1:d1:b0:4a,5280056,424,3365,5279632,5280056
1704,6,6,1,2412,-66,-90,24,10:86:8c:5f:93:1e,5281070,344,670,5280726,5281070
1705,4,1,1,2412,-53,-90,37,94:a6:7e:c9:98:67,5284243,2464,709,5281779,5284243
1706,6,6,1,2412,-81,-90,9,e2:db:d1:d1:b0:4a,5286600,52,2305,5286548,5286600
1707,6,6,1,2412,-83,-90,7,,5290308,44,3664,5290264,5290308
1708,6,6,1,2412,-81,-90,9,,5296999,44,6647,5296955,5296999
1709,6,6,1,2412,-81,-90,9,,5297178,44,135,5297134,5297178
1710,4,1,1,2412,-80,-90,10,78:67:0e:38:6c:d3,5299049,2736,-865,5296313,5299049
1711,4,11,1,2412,-72,-90,18,48:dd:0c:7d:86:27,5301808,362,2397,5301446,5301808
1712,4,11,1,2412,-73,-90,17,48:dd:0c:7d:86:23,5302182,323,51,5301859,5302182
1713,4,11,1,2412,-73,-90,17,48:dd:0c:7d:86:25,5302517,382,-47,5302135,5302517
1714,6,24,1,2412,-80,-90,10,,5304219,28,1674,5304191,5304219
1715,6,6,1,2412,-83,-90,7,40:b0:34:b7:01:d5,5305318,576,523,5304742,5305318
1716,6,6,1,2412,-83,-90,7,e2:db:d1:d1:b0:4a,5317478,444,11716,5317034,5317478
1717,6,6,1,2412,-83,-90,7,e2:db:d1:d1:b0:4b,5317946,408,60,5317538,5317946
1718,6,6,1,2412,-83,-90,7,e2:db:d1:d1:b0:4d,5318396,408,42,5317988,5318396
1719,6,6,1,2412,-83,-90,7,e2:db:d1:d1:b0:4f,5318967,408,163,5318559,5318967
1720,6,6,1,2412,-82,-90,8,,5319986,44,975,5319942,5319986
1721,4,1,1,2412,-88,-90,2,ac:67:84:84:8a:07,5322126,448,1692,5321678,5322126
1722,4,1,1,2412,-87,-90,3,ac:67:84:84:8a:07,5323163,448,589,5322715,5323163
1723,4,11,1,2412,-82,-90,8,4c:01:43:ec:a0:69,5325691,361,2167,5325330,5325691
1724,4,11,1,2412,-81,-90,9,4c:01:43:ec:a0:63,5326065,322,52,5325743,5326065
1725,4,11,1,2412,-81,-90,9,4c:01:43:ec:a0:66,5326399,387,-53,5326012,5326399
1726,4,11,1,2412,-76,-90,14,48:dd:0c:90:e3:87,5326956,362,195,5326594,5326956
1727,4,11,1,2412,-76,-90,14,48:dd:0c:90:e3:83,5327331,323,52,5327008,5327331
1728,4,11,1,2412,-77,-90,13,48:dd:0c:90:e3:85,5327666,382,-47,5327284,5327666
1729,6,6,1,2412,-81,-90,9,,5331866,44,4156,5331822,5331866
1730,6,6,1,2412,-68,-90,22,52:86:8c:5f:93:1e,5332269,332,71,5331937,5332269
1731,4,1,1,2412,-67,-90,23,,5334116,304,1543,5333812,5334116
1732,6,6,1,2412,-83,-90,7,3c:bd:c5:ee:96:6d,5343409,68,9225,5343341,5343409
1733,4,1,1,2412,-85,-90,5,78:67:0e:c4:a8:42,5346821,352,3060,5346469,5346821
1734,4,1,1,2412,-84,-90,6,,5348697,304,1572,5348393,5348697
1735,6,24,1,2412,-86,-90,4,,5350885,28,2160,5350857,5350885
1736,6,6,1,2412,-68,-90,22,32:86:8c:5f:93:1e,5357871,332,6654,5357539,5357871
1737,4,1,1,2412,-89,-90,1,ce:f4:11:65:3f:f8,5359611,2072,-332,5357539,5359611
1738,6,24,1,2412,-84,-90,6,,5364696,28,5057,5364668,5364696
1739,4,1,1,2412,-87,-90,3,,5367924,304,2924,5367620,5367924
1740,4,1,1,2412,-70,-90,20,b0:e4:d5:32:ec:8a,5379663,1960,9779,5377703,5379663
1741,4,1,1,2412,-87,-90,3,bc:98:df:ff:0f:8b,5385515,2568,3284,5382947,5385515
1742,4,1,1,2412,-59,-90,31,94:a6:7e:c9:98:67,5388132,2464,153,5385668,5388132
1743,4,11,1,2412,-87,-90,3,4c:01:43:d7:f3:29,5391935,362,3441,5391573,5391935
1744,4,11,1,2412,-89,-90,1,4c:01:43:d7:f3:23,5392309,322,52,5391987,5392309
1745,4,11,1,2412,-87,-90,3,48:dd:0c:92:4b:e3,5393255,323,623,5392932,5393255
1746,4,11,1,2412,-88,-90,2,48:dd:0c:92:4b:e5,5393590,382,-47,5393208,5393590
1747,6,24,1,2412,-82,-90,8,3c:bd:c5:ee:96:6d,5397890,28,4272,5397862,5397890
1748,6,6,1,2412,-81,-90,9,,5398169,44,235,5398125,5398169
1749,4,1,1,2412,-69,-90,21,78:67:0e:38:6c:d3,5401449,2736,544,5398713,5401449
1750,4,11,1,2412,-77,-90,13,48:dd:0c:7d:86:27,5404208,362,2397,5403846,5404208
1751,4,11,1,2412,-77,-90,13,48:dd:0c:7d:86:23,5404583,323,52,5404260,5404583
1752,6,6,1,2412,-65,-90,25,12:86:8c:5f:93:1e,5409069,332,4154,5408737,5409069
1753,6,24,1,2412,-80,-90,10,,5409611,28,514,5409583,5409611
1754,6,24,1,2412,-81,-90,9,4c:01:43:d7:f3:26,5424617,32,14974,5424585,5424617
1755,4,11,1,2412,-85,-90,5,4c:01:43:ec:a0:63,5428464,322,3525,5428142,5428464
1756,4,11,1,2412,-66,-90,24,4c:01:43:ec:a0:66,5428798,387,-53,5428411,5428798
1757,4,11,1,2412,-77,-90,13,48:dd:0c:90:e3:87,5429356,362,196,5428994,5429356
1758,4,11,1,2412,-78,-90,12,48:dd:0c:90:e3:83,5429731,323,52,5429408,5429731
1759,4,11,1,2412,-78,-90,12,48:dd:0c:90:e3:85,5430066,382,-47,5429684,5430066
1760,6,6,1,2412,-66,-90,24,52:86:8c:5f:93:1e,5434671,332,4273,5434339,5434671
1761,4,1,1,2412,-81,-90,9,3c:bd:c5:ee:96:6d,5437490,976,1843,5436514,5437490
1762,4,1,1,2412,-92,-90,-2,10:7b:44:eb:35:60,5438618,384,744,5438234,5438618
1763,6,24,1,2412,-80,-90,10,,5453046,28,14400,5453018,5453046
1764,6,6,1,2412,-82,-90,8,3c:bd:c5:ee:96:6d,5459290,68,6176,5459222,5459290
1765,6,6,1,2412,-65,-90,25,32:86:8c:5f:93:1e,5460270,332,648,5459938,5460270
1766,6,24,1,2412,-84,-90,6,4c:01:43:d7:f3:26,5464307,32,4005,5464275,5464307
1767,6,6,1,2412,-87,-90,3,40:b0:34:b7:01:d5,5480740,644,15789,5480096,5480740
1768,4,1,1,2412,-68,-90,22,10:86:8c:5f:93:1e,5481646,3088,-2182,5478558,5481646
1769,4,1,1,2412,-64,-90,26,10:86:8c:5f:93:1e,5484930,3088,196,5481842,5484930
1770,4,1,1,2412,-70,-90,20,b0:e4:d5:32:ec:8a,5488353,1960,1463,5486393,5488353
1771,4,1,1,2412,-67,-90,23,94:a6:7e:c9:98:67,5490335,2464,-482,5487871,5490335
1772,4,1,1,2412,-63,-90,27,10:86:8c:5f:93:1e,5493910,3088,487,5490822,5493910
1773,4,1,1,2412,-84,-90,6,,5501284,304,7070,5500980,5501284
1774,4,1,1,2412,-83,-90,7,78:67:0e:c4:a8:42,5501671,3472,-3085,5498199,5501671
1775,6,6,1,2412,-86,-90,4,40:b0:34:b7:01:d5,5510182,576,7935,5509606,5510182
1776,4,1,1,2412,-88,-90,2,cc:f4:11:65:3f:fb,5513211,2112,917,5511099,5513211
1777,4,1,1,2412,-83,-90,7,,5520425,304,6910,5520121,5520425
1778,6,6,1,2412,-86,-90,4,e2:db:d1:d1:b0:4f,5523675,408,2842,5523267,5523675
1779,6,24,1,2412,-81,-90,9,,5524091,28,388,5524063,5524091
1780,6,6,1,2412,-84,-90,6,e2:db:d1:d1:b0:4a,5524179,224,-136,5523955,5524179
1781,6,6,1,2412,-85,-90,5,,5524564,44,341,5524520,5524564
1782,4,1,1,2412,-92,-90,-2,10:7b:44:eb:35:60,5526314,384,1366,5525930,5526314
1783,4,11,1,2412,-83,-90,7,4c:01:43:ec:a0:66,5531197,387,4496,5530810,5531197
1784,4,11,1,2412,-75,-90,15,48:dd:0c:90:e3:87,5531756,362,197,5531394,5531756
1785,4,11,1,2412,-75,-90,15,48:dd:0c:90:e3:85,5532466,382,328,5532084,5532466
1786,4,1,1,2412,-85,-90,5,78:67:0e:c4:a8:42,5543936,2736,8734,5541200,5543936
1787,6,24,1,2412,-81,-90,9,4c:01:43:d7:f3:26,5546634,32,2666,5546602,5546634
1788,4,1,1,2412,-87,-90,3,,5555625,304,8687,5555321,5555625
1789,6,6,1,2412,-66,-90,24,32:86:8c:5f:93:1e,5562671,332,6714,5562339,5562671
1790,4,1,1,2412,-89,-90,1,ce:f4:11:65:3f:f8,5564411,2072,-332,5562339,5564411
1791,4,1,1,2412,-77,-90,13,,5574703,304,9988,5574399,5574703
1792,4,1,1,2412,-90,-90,0,,5575609,304,602,5575305,5575609
1793,4,1,1,2412,-92,-90,-2,,5576571,304,658,5576267,5576571
1794,6,6,1,2412,-63,-90,27,10:86:8c:5f:93:1e,5588596,344,11681,5588252,5588596
1795,4,1,1,2412,-59,-90,31,94:a6:7e:c9:98:67,5591438,2464,378,5588974,5591438
1796,4,11,1,2412,-84,-90,6,4c:01:43:d7:f3:29,5594677,362,2877,5594315,5594677
1797,6,6,1,2412,-84,-90,6,3c:bd:c5:ee:96:6d,5601114,68,6369,5601046,5601114
1798,4,11,1,2412,-86,-90,4,4c:01:43:d7:f3:26,5602013,383,516,5601630,5602013
1799,4,11,1,2412,-83,-90,7,4c:01:43:d7:f3:26,5602519,383,123,5602136,5602519
1800,4,11,1,2412,-81,-90,9,4c:01:43:ec:a0:66,5603266,382,365,5602884,5603266
1801,4,11,1,2412,-83,-90,7,4c:01:43:ec:a0:66,5603769,382,121,5603387,5603769
1802,4,11,1,2412,-82,-90,8,4c:01:43:ec:a0:66,5604275,382,124,5603893,5604275
1803,4,1,1,2412,-87,-90,3,,5604781,304,202,5604477,5604781
1804,6,6,1,2412,-64,-90,26,12:86:8c:5f:93:1e,5613876,332,8763,5613544,5613876
1805,6,6,1,2412,-83,-90,7,,5617315,44,3395,5617271,5617315
1806,4,1,1,2412,-84,-90,6,,5620353,304,2734,5620049,5620353
1807,6,6,1,2412,-86,-90,4,e2:db:d1:d1:b0:4d,5625633,408,4872,5625225,5625633
1808,6,6,1,2412,-83,-90,7,,5626751,44,1074,5626707,5626751
1809,4,1,1,2412,-92,-90,-2,10:7b:44:eb:35:60,5628199,384,1064,5627815,5628199
1810,4,1,1,2412,-89,-90,1,ac:67:84:84:8a:07,5628597,448,-50,5628149,5628597
1811,4,1,1,2412,-87,-90,3,ac:67:84:84:8a:07,5629501,448,456,5629053,5629501
1812,6,24,1,2412,-84,-90,6,3c:bd:c5:ee:96:6d,5631117,28,1588,5631089,5631117
1813,6,6,1,2412,-85,-90,5,,5631397,44,236,5631353,5631397
1814,4,11,1,2412,-82,-90,8,4c:01:43:ec:a0:69,5632888,361,1130,5632527,5632888
1815,4,11,1,2412,-82,-90,8,4c:01:43:ec:a0:66,5633596,387,321,5633209,5633596
1816,4,11,1,2412,-77,-90,13,48:dd:0c:90:e3:87,5634156,362,198,5633794,5634156
1817,4,11,1,2412,-79,-90,11,48:dd:0c:90:e3:83,5634530,323,51,5634207,5634530
1818,4,11,1,2412,-77,-90,13,48:dd:0c:90:e3:85,5634865,382,-47,5634483,5634865
1819,6,6,1,2412,-84,-90,6,3c:bd:c5:ee:96:6d,5638818,68,3885,5638750,5638818
1820,6,6,1,2412,-82,-90,8,e2:db:d1:d1:b0:4a,5643089,68,4203,5643021,5643089
1821,7,21.6667,1,2412,0,-90,90,e2:db:d1:d1:b0:4a,5644494,104,1301,5644390,5644494
1822,7,21.6667,1,2412,0,-90,90,e2:db:d1:d1:b0:4a,5644494,54,-54,5644440,5644494
1823,7,21.6667,1,2412,0,-90,90,e2:db:d1:d1:b0:4a,5644494,40,-40,5644454,5644494
1824,7,21.6667,1,2412,0,-90,90,e2:db:d1:d1:b0:4a,5644494,47,-47,5644447,5644494
1825,7,21.6667,1,2412,0,-90,90,e2:db:d1:d1:b0:4a,5644494,573,-573,5643921,5644494
1826,6,6,1,2412,-85,-90,5,e2:db:d1:d1:b0:4a,5653455,52,8909,5653403,5653455
1827,7,6.5,1,2412,0,-90,90,e2:db:d1:d1:b0:4a,5653585,276,-146,5653309,5653585
1828,7,6.5,1,2412,0,-90,90,e2:db:d1:d1:b0:4a,5655903,1952,366,5653951,5655903
1829,7,6.5,1,2412,0,-90,90,e2:db:d1:d1:b0:4a,5655903,1912,-1912,5653991,5655903
1830,7,6.5,1,2412,0,-90,90,e2:db:d1:d1:b0:4a,5655903,1912,-1912,5653991,5655903
1831,7,6.5,1,2412,0,-90,90,e2:db:d1:d1:b0:4a,5655903,1912,-1912,5653991,5655903
1832,7,6.5,1,2412,0,-90,90,e2:db:d1:d1:b0:4a,5655903,1912,-1912,5653991,5655903
1833,7,6.5,1,2412,0,-90,90,e2:db:d1:d1:b0:4a,5655903,1912,-1912,5653991,5655903
1834,7,6.5,1,2412,-84,-90,6,e2:db:d1:d1:b0:4a,5655903,1912,-1912,5653991,5655903
1835,6,6,1,2412,-83,-90,7,e2:db:d1:d1:b0:4a,5661290,52,5335,5661238,5661290
1836,6,6,1,2412,-66,-90,24,32:86:8c:5f:93:1e,5665073,332,3451,5664741,5665073
1837,4,1,1,2412,-90,-90,0,ac:67:84:84:8a:07,5672967,416,7478,5672551,5672967
1838,6,6,1,2412,-84,-90,6,e2:db:d1:d1:b0:4a,5673589,52,570,5673537,5673589
1839,7,6.5,1,2412,0,-90,90,e2:db:d1:d1:b0:4a,5673720,1944,-1813,5671776,5673720
1840,7,6.5,1,2412,0,-90,90,e2:db:d1:d1:b0:4a,5673720,1912,-1912,5671808,5673720
1841,7,6.5,1,2412,-84,-90,6,e2:db:d1:d1:b0:4a,5673720,1912,-1912,5671808,5673720
1842,7,21.6667,1,2412,0,-90,90,e2:db:d1:d1:b0:4a,5678855,612,4523,5678243,5678855
1843,6,24,1,2412,-84,-90,6,,5683898,28,5015,5683870,5683898
1844,6,24,1,2412,-83,-90,7,,5684299,28,373,5684271,5684299
1845,6,24,1,2412,-83,-90,7,,5685560,28,1233,5685532,5685560
1846,6,24,1,2412,-83,-90,7,,5686048,28,460,5686020,5686048
1847,6,6,1,2412,-83,-90,7,e2:db:d1:d1:b0:4a,5686184,68,68,5686116,5686184
1848,6,6,1,2412,-84,-90,6,e2:db:d1:d1:b0:4a,5686302,52,66,5686250,5686302
1849,6,6,1,2412,-65,-90,25,10:86:8c:5f:93:1e,5690672,344,4026,5690328,5690672
1850,4,1,1,2412,-59,-90,31,94:a6:7e:c9:98:67,5694076,2464,940,5691612,5694076
1851,4,1,1,2412,-83,-90,7,,5696664,304,2284,5696360,5696664
1852,6,24,1,2412,-84,-90,6,,5698591,28,1899,5698563,5698591
1853,6,6,1,2412,-82,-90,8,,5698707,44,72,5698663,5698707
1854,6,6,1,2412,-82,-90,8,e2:db:d1:d1:b0:4a,5698946,52,187,5698894,5698946
1855,6,6,1,2412,-83,-90,7,e2:db:d1:d1:b0:4a,5702771,52,3773,5702719,5702771
1856,6,6,1,2412,-83,-90,7,e2:db:d1:d1:b0:4a,5702990,52,167,5702938,5702990
1857,7,26,1,2412,-85,-90,5,e2:db:d1:d1:b0:4a,5703516,72,454,5703444,5703516
1858,6,6,1,2412,-83,-90,7,e2:db:d1:d1:b0:4a,5703718,52,150,5703666,5703718
1859,7,13,1,2412,-85,-90,5,e2:db:d1:d1:b0:4a,5703848,104,26,5703744,5703848
1860,4,1,1,2412,-83,-90,7,78:67:0e:38:6c:d3,5708650,2736,2066,5705914,5708650
1861,6,6,1,2412,-83,-90,7,e2:db:d1:d1:b0:4a,5715631,52,6929,5715579,5715631
1862,6,6,1,2412,-66,-90,24,12:86:8c:5f:93:1e,5716272,332,309,5715940,5716272
1863,4,1,1,2412,-82,-90,8,,5716925,304,349,5716621,5716925
1864,6,6,1,2412,-82,-90,8,e2:db:d1:d1:b0:4a,5725951,52,8974,5725899,5725951
1865,6,6,1,2412,-82,-90,8,e2:db:d1:d1:b0:4a,5726807,52,804,5726755,5726807
1866,6,24,1,2412,-79,-90,11,4c:01:43:d7:f3:26,5732079,32,5240,5732047,5732079
1867,6,6,1,2412,-83,-90,7,e2:db:d1:d1:b0:4d,5733027,408,540,5732619,5733027
1868,6,6,1,2412,-82,-90,8,,5734857,44,1786,5734813,5734857
1869,4,11,1,2412,-83,-90,7,4c:01:43:ec:a0:69,5735287,361,69,5734926,5735287
1870,4,11,1,2412,-85,-90,5,4c:01:43:ec:a0:66,5735995,387,321,5735608,5735995
1871,4,11,1,2412,-78,-90,12,48:dd:0c:90:e3:87,5736555,362,198,5736193,5736555
1872,4,11,1,2412,-78,-90,12,48:dd:0c:90:e3:83,5736930,323,52,5736607,5736930
1873,4,11,1,2412,-78,-90,12,48:dd:0c:90:e3:85,5737265,382,-47,5736883,5737265
1874,6,6,1,2412,-68,-90,22,52:86:8c:5f:93:1e,5741930,332,4333,5741598,5741930
1875,6,24,1,2412,-80,-90,10,,5751372,28,9414,5751344,5751372
1876,6,24,1,2412,-79,-90,11,,5763535,28,12135,5763507,5763535
1877,6,6,1,2412,-85,-90,5,3c:bd:c5:ee:96:6d,5766782,68,3179,5766714,5766782
1878,6,6,1,2412,-67,-90,23,32:86:8c:5f:93:1e,5767472,332,358,5767140,5767472
1879,6,24,1,2412,-80,-90,10,4c:01:43:d7:f3:26,5773550,32,6046,5773518,5773550
1880,6,6,1,2412,-84,-90,6,,5778473,44,4879,5778429,5778473
1881,6,24,1,2412,-80,-90,10,3c:bd:c5:ee:96:6d,5788264,28,9763,5788236,5788264
1882,6,6,1,2412,-79,-90,11,,5788479,44,171,5788435,5788479
1883,6,6,1,2412,-68,-90,22,10:86:8c:5f:93:1e,5793072,344,4249,5792728,5793072
1884,4,1,1,2412,-61,-90,29,94:a6:7e:c9:98:67,5796261,2464,725,5793797,5796261
1885,4,11,1,2412,-83,-90,7,4c:01:43:d7:f3:26,5800231,387,3583,5799844,5800231
1886,4,1,1,2412,-88,-90,2,,5806259,304,5724,5805955,5806259
1887,6,6,1,2412,-84,-90,6,3c:bd:c5:ee:96:6d,5807648,52,1337,5807596,5807648
1888,6,6,1,2412,-83,-90,7,3c:bd:c5:ee:96:6d,5810501,52,2801,5810449,5810501
1889,4,1,1,2412,-89,-90,1,04:a2:22:bf:24:52,5823138,3280,9357,5819858,5823138
1890,6,6,1,2412,-85,-90,5,e2:db:d1:d1:b0:4a,5831427,576,7713,5830851,5831427
1891,6,6,1,2412,-86,-90,4,,5832685,44,1214,5832641,5832685
1892,6,6,1,2412,-84,-90,6,e2:db:d1:d1:b0:4a,5833449,392,372,5833057,5833449
1893,4,11,1,2412,-82,-90,8,4c:01:43:ec:a0:66,5838394,387,4558,5838007,5838394
1894,4,11,1,2412,-74,-90,16,48:dd:0c:90:e3:87,5838955,362,199,5838593,5838955
1895,4,11,1,2412,-73,-90,17,48:dd:0c:90:e3:83,5839330,323,52,5839007,5839330
1896,4,11,1,2412,-75,-90,15,48:dd:0c:90:e3:85,5839665,382,-47,5839283,5839665
1897,6,6,1,2412,-68,-90,22,52:86:8c:5f:93:1e,5844314,332,4317,5843982,5844314
1898,6,6,1,2412,-84,-90,6,0a:a7:c0:a3:8d:70,5847088,464,2310,5846624,5847088
1899,4,1,1,2412,-86,-90,4,,5849381,304,1989,5849077,5849381
1900,4,1,1,2412,-88,-90,2,78:67:0e:c4:a8:42,5854444,832,4231,5853612,5854444
1901,4,1,1,2412,-88,-90,2,,5870022,304,15274,5869718,5870022
1902,4,1,1,2412,-86,-90,4,78:67:0e:c4:a8:42,5871459,352,1085,5871107,5871459
1903,4,1,1,2412,-80,-90,10,,5873293,304,1530,5872989,5873293
1904,4,11,1,2412,-88,-90,2,,5873972,107,572,5873865,5873972
1905,6,24,1,2412,-76,-90,14,78:67:0e:c4:a8:42,5874086,32,82,5874054,5874086
1906,4,11,1,2412,-79,-90,11,4c:01:43:ec:a0:63,5881272,239,6947,5881033,5881272
1907,4,11,1,2412,-81,-90,9,4c:01:43:ec:a0:66,5881789,217,300,5881572,5881789
1908,6,6,1,2412,-86,-90,4,,5883238,44,1405,5883194,5883238
1909,6,24,1,2412,-85,-90,5,,5883372,28,106,5883344,5883372
1910,6,6,1,2412,-83,-90,7,e2:db:d1:d1:b0:4a,5883548,68,108,5883480,5883548
1911,6,6,1,2412,-84,-90,6,e2:db:d1:d1:b0:4a,5883747,52,147,5883695,5883747
1912,7,21.6667,1,2412,0,-90,90,e2:db:d1:d1:b0:4a,5883878,78,53,5883800,5883878
1913,7,21.6667,1,2412,0,-90,90,e2:db:d1:d1:b0:4a,5883878,36,-36,5883842,5883878
1914,7,21.6667,1,2412,0,-90,90,e2:db:d1:d1:b0:4a,5883878,40,-40,5883838,5883878
1915,4,11,1,2412,-82,-90,8,,5885724,107,1739,5885617,5885724
1916,6,24,1,2412,-75,-90,15,78:67:0e:c4:a8:42,5885841,32,85,5885809,5885841
1917,7,13,1,2412,0,-90,90,e2:db:d1:d1:b0:4a,5886160,712,-393,5885448,5886160
1918,7,13,1,2412,0,-90,90,e2:db:d1:d1:b0:4a,5886160,80,-80,5886080,5886160
1919,7,13,1,2412,0,-90,90,e2:db:d1:d1:b0:4a,5886160,60,-60,5886100,5886160
1920,7,13,1,2412,0,-90,90,e2:db:d1:d1:b0:4a,5886160,80,-80,5886080,5886160
1921,7,13,1,2412,0,-90,90,e2:db:d1:d1:b0:4a,5886160,64,-64,5886096,5886160
1922,7,13,1,2412,0,-90,90,e2:db:d1:d1:b0:4a,5886160,60,-60,5886100,5886160
1923,7,13,1,2412,0,-90,90,e2:db:d1:d1:b0:4a,5886160,80,-80,5886080,5886160
1924,7,13,1,2412,0,-90,90,e2:db:d1:d1:b0:4a,5886160,64,-64,5886096,5886160
1925,7,13,1,2412,-84,-90,6,e2:db:d1:d1:b0:4a,5886160,412,-412,5885748,5886160
1926,4,1,1,2412,-79,-90,11,b0:e4:d5:32:ec:8a,5893068,1960,4948,5891108,5893068
1927,6,6,1,2412,-67,-90,23,10:86:8c:5f:93:1e,5895474,344,2062,5895130,5895474
1928,4,1,1,2412,-78,-90,12,,5898084,304,2306,5897780,5898084
1929,4,1,1,2412,-61,-90,29,94:a6:7e:c9:98:67,5898419,2464,-2129,5895955,5898419
1930,6,24,1,2412,-84,-90,6,,5901419,28,2972,5901391,5901419
1931,6,6,1,2412,-85,-90,5,e2:db:d1:d1:b0:4a,5901678,68,191,5901610,5901678
1932,4,1,1,2412,-79,-90,11,,5904403,304,2421,5904099,5904403
1933,6,24,1,2412,-75,-90,15,,5905942,28,1511,5905914,5905942
1934,4,11,1,2412,-79,-90,11,4c:01:43:ec:a0:66,5908455,215,2298,5908240,5908455
1935,4,11,1,2412,-78,-90,12,4c:01:43:ec:a0:66,5908797,215,127,5908582,5908797
1936,4,11,1,2412,-79,-90,11,4c:01:43:ec:a0:66,5909530,215,518,5909315,5909530
1937,4,1,1,2412,-77,-90,13,,5910405,304,571,5910101,5910405
1938,6,6,1,2412,-84,-90,6,e2:db:d1:d1:b0:4a,5911101,68,628,5911033,5911101
1939,4,1,1,2412,-78,-90,12,,5911368,304,-37,5911064,5911368
1940,7,13,1,2412,-83,-90,7,e2:db:d1:d1:b0:4a,5912041,104,569,5911937,5912041
1941,6,24,1,2412,-84,-90,6,,5912310,28,241,5912282,5912310
1942,6,6,1,2412,-84,-90,6,,5912430,44,76,5912386,5912430
1943,6,6,1,2412,-85,-90,5,e2:db:d1:d1:b0:4a,5918238,52,5756,5918186,5918238
1944,6,6,1,2412,-67,-90,23,12:86:8c:5f:93:1e,5921074,332,2504,5920742,5921074
1945,6,24,1,2412,-84,-90,6,,5923627,28,2525,5923599,5923627
1946,4,11,1,2412,-75,-90,15,48:dd:0c:7d:86:27,5923833,362,-156,5923471,5923833
1947,4,11,1,2412,-75,-90,15,48:dd:0c:7d:86:23,5924207,323,51,5923884,5924207
1948,4,11,1,2412,-74,-90,16,48:dd:0c:7d:86:25,5924542,382,-47,5924160,5924542
1949,6,24,1,2412,-85,-90,5,,5933640,28,9070,5933612,5933640
1950,6,6,1,2412,-84,-90,6,e2:db:d1:d1:b0:4a,5933971,52,279,5933919,5933971
1951,4,11,1,2412,-74,-90,16,48:dd:0c:90:e3:83,5941729,323,7435,5941406,5941729
1952,4,11,1,2412,-75,-90,15,48:dd:0c:90:e3:85,5942065,382,-46,5941683,5942065
1953,6,6,1,2412,-84,-90,6,e2:db:d1:d1:b0:4a,5942705,52,588,5942653,5942705
1954,6,6,1,2412,-67,-90,23,52:86:8c:5f:93:1e,5946674,332,3637,5946342,5946674
1955,6,6,1,2412,-84,-90,6,,5949539,44,2821,5949495,5949539
1956,6,24,1,2412,-85,-90,5,,5960658,28,11091,5960630,5960658
1957,6,6,1,2412,-84,-90,6,e2:db:d1:d1:b0:4a,5960834,68,108,5960766,5960834
1958,7,13,1,2412,0,-90,90,e2:db:d1:d1:b0:4a,5966487,988,4665,5965499,5966487
1959,6,6,1,2412,-67,-90,23,32:86:8c:5f:93:1e,5972275,332,5456,5971943,5972275
1960,6,6,1,2412,-83,-90,7,e2:db:d1:d1:b0:4a,5977304,52,4977,5977252,5977304
1961,7,19.5,1,2412,0,-90,90,e2:db:d1:d1:b0:4a,5977435,668,-537,5976767,5977435
1962,7,19.5,1,2412,0,-90,90,e2:db:d1:d1:b0:4a,5977435,636,-636,5976799,5977435
1963,7,19.5,1,2412,0,-90,90,e2:db:d1:d1:b0:4a,5977435,636,-636,5976799,5977435
1964,7,19.5,1,2412,0,-90,90,e2:db:d1:d1:b0:4a,5977435,52,-52,5977383,5977435
1965,7,19.5,1,2412,-80,-90,10,e2:db:d1:d1:b0:4a,5977435,640,-640,5976795,5977435
1966,4,11,1,2412,-75,-90,15,4c:01:43:ec:a0:66,5985622,219,7968,5985403,5985622
1967,4,1,1,2412,-77,-90,13,b0:e4:d5:32:ec:8a,5994059,1960,6477,5992099,5994059
1968,6,6,1,2412,-67,-90,23,10:86:8c:5f:93:1e,5997875,344,3472,5997531,5997875
1969,4,1,1,2412,-68,-90,22,94:a6:7e:c9:98:67,6001430,2464,1091,5998966,6001430
1970,4,11,1,2412,-89,-90,1,4c:01:43:d7:f3:23,6004650,322,2898,6004328,6004650
1971,4,11,1,2412,-81,-90,9,4c:01:43:d7:f3:26,6004984,387,-53,6004597,6004984
1972,4,11,1,2412,-81,-90,9,4c:01:43:d7:f3:26,6006099,268,847,6005831,6006099
1973,6,24,1,2412,-78,-90,12,,6006289,28,162,6006261,6006289
1974,6,24,1,2412,-78,-90,12,,6006398,28,81,6006370,6006398
1975,4,1,1,2412,-88,-90,2,ac:67:84:84:8a:07,6010858,416,4044,6010442,6010858
1976,4,11,1,2412,-79,-89,10,48:dd:0c:90:e3:83,6015170,254,4058,6014916,6015170
1977,6,24,1,2412,-80,-89,9,4c:01:43:d7:f3:26,6021074,32,5872,6021042,6021074
1978,6,6,1,2412,-86,-89,3,40:b0:34:b7:01:d5,6021619,576,-31,6021043,6021619
1979,4,1,1,2412,-88,-89,1,70:3a:cb:63:35:b2,6023999,2216,164,6021783,6023999
1980,4,1,1,2412,-88,-89,1,00:26:62:eb:ea:74,6036277,968,11310,6035309,6036277
1981,4,11,1,2412,-77,-89,12,4c:01:43:ec:a0:69,6042483,361,5845,6042122,6042483
1982,4,11,1,2412,-78,-89,11,4c:01:43:ec:a0:66,6043191,387,321,6042804,6043191
1983,4,11,1,2412,-80,-89,9,48:dd:0c:90:e3:87,6043754,362,201,6043392,6043754
1984,4,11,1,2412,-81,-89,8,48:dd:0c:90:e3:83,6044129,323,52,6043806,6044129
1985,4,11,1,2412,-79,-89,10,48:dd:0c:90:e3:85,6044464,382,-47,6044082,6044464
1986,6,6,1,2412,-64,-89,25,52:86:8c:5f:93:1e,6049090,332,4294,6048758,6049090
1987,4,1,1,2412,-78,-89,11,78:67:0e:c4:a8:42,6055936,2736,4110,6053200,6055936
1988,6,24,1,2412,-80,-89,9,4c:01:43:d7:f3:26,6059837,32,3869,6059805,6059837
1989,6,24,1,2412,-78,-89,11,,6070897,28,11032,6070869,6070897
1990,6,6,1,2412,-63,-89,26,32:86:8c:5f:93:1e,6074676,332,3447,6074344,6074676
1991,4,1,1,2412,-89,-89,0,ce:f4:11:65:3f:f8,6076410,2072,-338,6074338,6076410
1992,6,24,1,2412,-79,-89,10,,6084024,28,7586,6083996,6084024
1993,4,1,1,2412,-75,-89,14,b0:e4:d5:32:ec:8a,6096458,1960,10474,6094498,6096458
1994,6,6,1,2412,-66,-89,23,10:86:8c:5f:93:1e,6100275,344,3473,6099931,6100275
1995,4,1,1,2412,-82,-89,7,bc:98:df:ff:0f:8b,6102013,2568,-830,6099445,6102013
1996,4,1,1,2412,-65,-89,24,94:a6:7e:c9:98:67,6104612,2464,135,6102148,6104612
1997,4,11,1,2412,-80,-89,9,4c:01:43:d7:f3:23,6107301,322,2367,6106979,6107301
1998,4,11,1,2412,-80,-89,9,4c:01:43:d7:f3:26,6107635,387,-53,6107248,6107635
1999,4,11,1,2412,-79,-89,10,4c:01:43:d7:f3:23,6108403,284,484,6108119,6108403
2000,4,11,1,2412,-79,-89,10,4c:01:43:d7:f3:23,6109166,284,479,6108882,6109166
2001,4,1,1,2412,-79,-89,10,,6110700,304,1230,6110396,6110700
2002,4,11,1,2412,-81,-89,8,4c:01:43:ec:a0:66,6111053,219,134,6110834,6111053
2003,6,24,1,2412,-80,-89,9,,6112055,28,974,6112027,6112055
2004,6,24,1,2412,-80,-89,9,,6112967,28,884,6112939,6112967
2005,4,11,1,2412,-72,-89,17,48:dd:0c:7d:86:27,6121010,362,7681,6120648,6121010
2006,4,11,1,2412,-72,-89,17,48:dd:0c:7d:86:23,6121385,323,52,6121062,6121385
2007,4,11,1,2412,-72,-89,17,48:dd:0c:7d:86:25,6121720,382,-47,6121338,6121720
2008,6,6,1,2412,-68,-89,21,12:86:8c:5f:93:1e,6125876,332,3824,6125544,6125876
2009,4,1,1,2412,-86,-89,3,70:3a:cb:63:35:b2,6126400,2216,-1692,6124184,6126400
2010,4,11,1,2412,-82,-89,7,4c:01:43:ec:a0:66,6130470,219,3851,6130251,6130470
2011,6,6,1,2412,-82,-89,7,e2:db:d1:d1:b0:4b,6137179,408,6301,6136771,6137179
2012,6,6,1,2412,-83,-89,6,e2:db:d1:d1:b0:4f,6138070,408,483,6137662,6138070
2013,6,6,1,2412,-81,-89,8,,6138499,44,385,6138455,6138499
2014,6,6,1,2412,-83,-89,6,,6138603,44,60,6138559,6138603
2015,6,24,1,2412,-79,-89,10,4c:01:43:d7:f3:26,6139424,32,789,6139392,6139424
2016,4,1,1,2412,-81,-89,8,,6141154,304,1426,6140850,6141154
2017,4,1,1,2412,-82,-89,7,,6141973,304,515,6141669,6141973
2018,4,1,1,2412,-86,-89,3,ac:67:84:84:8a:07,6142526,448,105,6142078,6142526
2019,4,1,1,2412,-87,-89,2,ac:67:84:84:8a:07,6143421,448,447,6142973,6143421
2020,4,11,1,2412,-83,-89,6,4c:01:43:ec:a0:69,6144882,361,1100,6144521,6144882
2021,4,11,1,2412,-82,-89,7,4c:01:43:ec:a0:63,6145256,322,52,6144934,6145256
2022,4,11,1,2412,-82,-89,7,4c:01:43:ec:a0:66,6145590,387,-53,6145203,6145590
2023,4,1,1,2412,-90,-89,-1,40:ca:63:2d:74:be,6148197,1896,711,6146301,6148197
2024,6,24,1,2412,-80,-89,9,,6150899,28,2674,6150871,6150899
2025,4,1,1,2412,-84,-89,5,ac:67:84:84:8a:07,6154294,416,2979,6153878,6154294
2026,4,1,1,2412,-84,-89,5,78:67:0e:c4:a8:42,6161110,848,5968,6160262,6161110
2027,6,12,1,2412,-82,-89,7,,6161883,32,741,6161851,6161883
2028,6,24,1,2412,-81,-89,8,,6162003,28,92,6161975,6162003
2029,6,24,1,2412,-81,-89,8,,6162168,28,137,6162140,6162168
2030,4,11,1,2412,-82,-89,7,4c:01:43:d7:f3:23,6166641,296,4177,6166345,6166641
2031,6,24,1,2412,-81,-89,8,,6168264,28,1595,6168236,6168264
2032,6,24,1,2412,-81,-89,8,4c:01:43:ec:a0:66,6168465,32,169,6168433,6168465
2033,4,1,1,2412,-85,-89,4,ac:67:84:84:8a:07,6173025,416,4144,6172609,6173025
2034,6,6,1,2412,-66,-89,23,32:86:8c:5f:93:1e,6177075,332,3718,6176743,6177075
2035,6,6,1,2412,-66,-89,23,10:86:8c:5f:93:1e,6202676,344,25257,6202332,6202676
2036,4,1,1,2412,-82,-89,7,,6204071,304,1091,6203767,6204071
2037,4,1,1,2412,-61,-89,28,94:a6:7e:c9:98:67,6205849,2464,-686,6203385,6205849
2038,4,11,1,2412,-87,-89,2,4c:01:43:d7:f3:29,6209087,362,2876,6208725,6209087
2039,4,11,1,2412,-87,-89,2,4c:01:43:d7:f3:23,6209461,322,52,6209139,6209461
2040,4,11,1,2412,-85,-89,4,4c:01:43:d7:f3:26,6209796,387,-52,6209409,6209796
2041,4,11,1,2412,-85,-89,4,4c:01:43:d7:f3:26,6210229,274,159,6209955,6210229
2042,4,11,1,2412,-87,-89,2,4c:01:43:d7:f3:26,6210576,274,73,6210302,6210576
2043,4,1,1,2412,-82,-89,7,78:67:0e:38:6c:d3,6220651,2736,7339,6217915,6220651
2044,4,11,1,2412,-76,-89,13,48:dd:0c:7d:86:27,6223410,362,2397,6223048,6223410
2045,4,11,1,2412,-75,-89,14,48:dd:0c:7d:86:23,6223784,323,51,6223461,6223784
2046,4,11,1,2412,-77,-89,12,48:dd:0c:7d:86:25,6224120,382,-46,6223738,6224120
2047,6,24,1,2412,-85,-89,4,4c:01:43:d7:f3:26,6225838,32,1686,6225806,6225838
2048,6,6,1,2412,-82,-89,7,e2:db:d1:d1:b0:4b,6239556,408,13310,6239148,6239556
2049,6,6,1,2412,-86,-89,3,e2:db:d1:d1:b0:4d,6239997,408,33,6239589,6239997
2050,6,6,1,2412,-86,-89,3,e2:db:d1:d1:b0:4f,6240456,408,51,6240048,6240456
2051,6,6,1,2412,-87,-89,2,,6241159,44,659,6241115,6241159
2052,4,1,1,2412,-87,-89,2,00:26:62:eb:ea:74,6241512,968,-615,6240544,6241512
2053,6,6,1,2412,-88,-89,1,e2:db:d1:d1:b0:4a,6243668,576,1580,6243092,6243668
2054,4,11,1,2412,-64,-89,25,4c:01:43:ec:a0:63,6247655,322,3665,6247333,6247655
2055,4,11,1,2412,-79,-89,10,48:dd:0c:90:e3:87,6248554,362,537,6248192,6248554
2056,4,11,1,2412,-76,-89,13,48:dd:0c:90:e3:85,6249264,382,328,6248882,6249264
2057,6,24,1,2412,-81,-89,8,,6250581,28,1289,6250553,6250581
2058,6,24,1,2412,-79,-89,10,,6251682,28,1073,6251654,6251682
2059,6,12,1,2412,-78,-89,11,4c:01:43:ec:a0:66,6251808,44,82,6251764,6251808
2060,6,6,1,2412,-87,-89,2,3c:bd:c5:ee:96:6d,6261498,68,9622,6261430,6261498
2061,4,1,1,2412,-90,-89,-1,10:7b:44:eb:35:60,6262293,384,411,6261909,6262293
2062,4,1,1,2412,-89,-89,0,ac:67:84:84:8a:07,6262691,448,-50,6262243,6262691
2063,4,1,1,2412,-90,-89,-1,10:7b:44:eb:35:60,6263179,384,104,6262795,6263179
2064,4,1,1,2412,-89,-89,0,ac:67:84:84:8a:07,6263577,448,-50,6263129,6263577
2065,6,6,1,2412,-85,-89,4,e2:db:d1:d1:b0:4a,6275360,68,11715,6275292,6275360
2066,7,19.5,1,2412,0,-89,89,e2:db:d1:d1:b0:4a,6275754,668,-274,6275086,6275754
2067,7,19.5,1,2412,0,-89,89,e2:db:d1:d1:b0:4a,6275754,108,-108,6275646,6275754
2068,6,6,1,2412,-66,-89,23,32:86:8c:5f:93:1e,6279477,332,3391,6279145,6279477
2069,6,12,1,2412,-76,-89,13,4c:01:43:ec:a0:66,6280106,44,585,6280062,6280106
2070,4,1,1,2412,-80,-89,9,bc:98:df:ff:0f:8b,6280382,3176,-2900,6277206,6280382
2071,6,24,1,2412,-86,-89,3,,6297922,28,17512,6297894,6297922
2072,6,6,1,2412,-66,-89,23,10:86:8c:5f:93:1e,6306388,344,8122,6306044,6306388
2073,4,1,1,2412,-60,-89,29,94:a6:7e:c9:98:67,6309614,2464,762,6307150,6309614
2074,4,11,1,2412,-83,-89,6,4c:01:43:d7:f3:23,6312475,322,2539,6312153,6312475
2075,7,21.6667,1,2412,-83,-89,6,e2:db:d1:d1:b0:4a,6313158,612,71,6312546,6313158
2076,6,6,1,2412,-83,-89,6,,6316936,44,3734,6316892,6316936
2077,6,6,1,2412,-84,-89,5,,6319412,44,2432,6319368,6319412
2078,6,6,1,2412,-80,-89,9,,6319659,44,203,6319615,6319659
2079,6,6,1,2412,-83,-89,6,e2:db:d1:d1:b0:4a,6319931,52,220,6319879,6319931
2080,6,6,1,2412,-83,-89,6,,6321336,44,1361,6321292,6321336
2081,6,24,1,2412,-83,-89,6,,6321464,28,100,6321436,6321464
2082,6,6,1,2412,-84,-89,5,e2:db:d1:d1:b0:4a,6321616,68,84,6321548,6321616
2083,6,6,1,2412,-83,-89,6,e2:db:d1:d1:b0:4a,6321761,52,93,6321709,6321761
2084,7,21.6667,1,2412,0,-89,89,e2:db:d1:d1:b0:4a,6321892,604,-473,6321288,6321892
2085,4,11,1,2412,-73,-89,16,48:dd:0c:7d:86:27,6323691,362,1437,6323329,6323691
2086,4,11,1,2412,-72,-89,17,48:dd:0c:7d:86:23,6324065,323,51,6323742,6324065
2087,4,11,1,2412,-72,-89,17,48:dd:0c:7d:86:25,6324401,382,-46,6324019,6324401
2088,4,1,1,2412,-76,-89,13,78:67:0e:38:6c:d3,6325870,848,621,6325022,6325870
2089,6,24,1,2412,-84,-89,5,,6327348,28,1450,6327320,6327348
2090,6,6,1,2412,-84,-89,5,e2:db:d1:d1:b0:4a,6327496,68,80,6327428,6327496
2091,7,21.6667,1,2412,0,-89,89,e2:db:d1:d1:b0:4a,6327872,604,-228,6327268,6327872
2092,6,6,1,2412,-69,-89,20,12:86:8c:5f:93:1e,6330676,332,2472,6330344,6330676
2093,6,6,1,2412,-79,-89,10,e2:db:d1:d1:b0:4a,6333093,52,2365,6333041,6333093
2094,6,6,1,2412,-84,-89,5,,6335147,44,2010,6335103,6335147
2095,6,6,1,2412,-83,-89,6,,6335440,44,249,6335396,6335440
2096,6,12,1,2412,-77,-89,12,4c:01:43:ec:a0:66,6335516,44,32,6335472,6335516
2097,6,6,1,2412,-84,-89,5,e2:db:d1:d1:b0:4a,6335954,52,386,6335902,6335954
2098,7,21.6667,1,2412,-84,-89,5,e2:db:d1:d1:b0:4a,6336085,612,-481,6335473,6336085
2099,6,6,1,2412,-84,-89,5,,6336783,44,654,6336739,6336783
2100,6,24,1,2412,-84,-89,5,,6336911,28,100,6336883,6336911
2101,6,6,1,2412,-84,-89,5,,6337030,44,75,6336986,6337030
2102,6,6,1,2412,-85,-89,4,e2:db:d1:d1:b0:4a,6337170,52,88,6337118,6337170
2103,6,6,1,2412,-83,-89,6,,6338160,44,946,6338116,6338160
2104,4,1,1,2412,-86,-89,3,3c:bd:c5:e4:38:93,6339155,2520,-1525,6336635,6339155
2105,6,6,1,2412,-83,-89,6,,6344455,44,5256,6344411,6344455
2106,6,12,1,2412,-77,-89,12,,6347128,32,2641,6347096,6347128
2107,6,24,1,2412,-82,-89,7,,6347559,28,403,6347531,6347559
2108,6,6,1,2412,-81,-89,8,,6347757,44,154,6347713,6347757
2109,6,6,1,2412,-82,-89,7,,6361048,44,13247,6361004,6361048
2110,4,1,1,2412,-84,-89,5,78:67:0e:c4:a8:42,6363136,2736,-648,6360400,6363136
2111,6,6,1,2412,-84,-89,5,3c:bd:c5:ee:96:6d,6366829,68,3625,6366761,6366829
2112,4,11,1,2412,-85,-89,4,,6372768,107,5832,6372661,6372768
2113,6,24,1,2412,-82,-89,7,78:67:0e:c4:a8:42,6372881,32,81,6372849,6372881
2114,6,24,1,2412,-76,-89,13,,6373270,28,361,6373242,6373270
2115,6,12,1,2412,-76,-89,13,4c:01:43:ec:a0:66,6373384,44,70,6373340,6373384
2116,6,24,1,2412,-76,-89,13,,6379859,28,6447,6379831,6379859
2117,6,12,1,2412,-76,-89,13,4c:01:43:ec:a0:66,6379981,44,78,6379937,6379981
2118,6,24,1,2412,-76,-89,13,,6381314,28,1305,6381286,6381314
2119,6,12,1,2412,-76,-89,13,4c:01:43:ec:a0:66,6381456,44,98,6381412,6381456
2120,6,6,1,2412,-71,-89,18,32:86:8c:5f:93:1e,6381878,332,90,6381546,6381878
2121,6,24,1,2412,-75,-89,14,,6382235,28,329,6382207,6382235
2122,6,6,1,2412,-79,-89,10,4c:01:43:d7:f3:26,6385670,52,3383,6385618,6385670
2123,6,6,1,2412,-84,-89,5,,6386396,44,682,6386352,6386396
2124,6,24,1,2412,-79,-89,10,4c:01:43:d7:f3:26,6386581,32,153,6386549,6386581
2125,6,6,1,2412,-74,-89,15,,6395222,44,8597,6395178,6395222
2126,6,24,1,2412,-76,-89,13,,6396393,28,1143,6396365,6396393
2127,6,24,1,2412,-75,-89,14,,6396662,28,241,6396634,6396662
2128,6,24,1,2412,-76,-89,13,,6397000,28,310,6396972,6397000
2129,6,12,1,2412,-76,-89,13,4c:01:43:ec:a0:66,6397134,44,90,6397090,6397134
2130,4,1,1,2412,-89,-89,0,48:a6:b8:49:4e:15,6397407,432,-159,6396975,6397407
2131,4,11,1,2412,-84,-89,5,48:dd:0c:92:4b:e3,6399539,254,1878,6399285,6399539
2132,4,11,1,2412,-77,-89,12,48:dd:0c:90:e3:83,6400152,254,359,6399898,6400152
2133,4,11,1,2412,-77,-89,12,48:dd:0c:7d:86:23,6400454,254,48,6400200,6400454
2134,4,1,1,2412,-79,-89,10,b0:e4:d5:32:ec:8a,6403656,1960,1242,6401696,6403656
2135,4,1,1,2412,-90,-89,-1,,6406190,304,2230,6405886,6406190
2136,6,6,1,2412,-68,-89,21,10:86:8c:5f:93:1e,6407477,344,943,6407133,6407477
2137,4,1,1,2412,-56,-89,33,94:a6:7e:c9:98:67,6410650,2464,709,6408186,6410650
2138,4,11,1,2412,-83,-89,6,4c:01:43:d7:f3:26,6415015,321,4044,6414694,6415015
2139,4,11,1,2412,-84,-89,5,4c:01:43:d7:f3:26,6415553,336,202,6415217,6415553
2140,4,11,1,2412,-85,-89,4,48:dd:0c:92:4b:e7,6416879,362,964,6416517,6416879
2141,4,11,1,2412,-84,-89,5,48:dd:0c:92:4b:e3,6417253,323,51,6416930,6417253
2142,4,11,1,2412,-85,-89,4,48:dd:0c:92:4b:e5,6417588,382,-47,6417206,6417588
2143,6,6,1,2412,-66,-89,23,12:86:8c:5f:93:1e,6433078,332,15158,6432746,6433078
2144,4,1,1,2412,-90,-89,-1,d8:9c:8e:01:4c:6a,6437821,3000,1743,6434821,6437821
2145,6,6,1,2412,-85,-89,4,,6445828,44,7963,6445784,6445828
2146,6,6,1,2412,-85,-89,4,e2:db:d1:d1:b0:4a,6447396,1360,208,6446036,6447396
2147,6,6,1,2412,-85,-89,4,e2:db:d1:d1:b0:4a,6448852,224,1232,6448628,6448852
2148,4,11,1,2412,-82,-89,7,4c:01:43:ec:a0:66,6452787,387,3548,6452400,6452787
2149,4,11,1,2412,-75,-89,14,48:dd:0c:90:e3:87,6453353,362,204,6452991,6453353
2150,4,11,1,2412,-75,-89,14,48:dd:0c:90:e3:83,6453728,323,52,6453405,6453728
2151,4,11,1,2412,-75,-89,14,48:dd:0c:90:e3:85,6454063,382,-47,6453681,6454063
2152,4,1,1,2412,-91,-89,-2,40:ca:63:2d:74:be,6455424,1896,-535,6453528,6455424
2153,6,24,1,2412,-81,-89,8,,6467500,28,12048,6467472,6467500
2154,4,1,1,2412,-85,-89,4,04:a2:22:bf:24:52,6472153,912,3741,6471241,6472153
2155,6,24,1,2412,-80,-89,9,,6483478,28,11297,6483450,6483478
2156,6,6,1,2412,-66,-89,23,32:86:8c:5f:93:1e,6484277,332,467,6483945,6484277
2157,6,24,1,2412,-82,-89,7,,6496784,28,12479,6496756,6496784
2158,6,24,1,2412,-80,-89,9,4c:01:43:d7:f3:26,6504687,32,7871,6504655,6504687
2159,6,6,1,2412,-66,-89,23,10:86:8c:5f:93:1e,6512565,344,7534,6512221,6512565
2160,4,1,1,2412,-56,-89,33,94:a6:7e:c9:98:67,6513128,2464,-1901,6510664,6513128
2161,4,11,1,2412,-83,-89,6,4c:01:43:d7:f3:29,6516273,362,2783,6515911,6516273
2162,4,11,1,2412,-86,-89,3,4c:01:43:d7:f3:23,6516647,322,52,6516325,6516647
2163,4,11,1,2412,-86,-89,3,4c:01:43:d7:f3:26,6516982,387,-52,6516595,6516982
2164,6,6,1,2412,-82,-89,7,,6526480,44,9454,6526436,6526480
2165,4,11,1,2412,-71,-89,18,48:dd:0c:7d:86:23,6530985,323,4182,6530662,6530985
2166,4,11,1,2412,-74,-89,15,48:dd:0c:7d:86:25,6531320,382,-47,6530938,6531320
2167,6,6,1,2412,-84,-89,5,40:b0:34:b7:01:d5,6533625,576,1729,6533049,6533625
2168,4,1,1,2412,-86,-89,3,70:3a:cb:63:35:b2,6536150,2216,309,6533934,6536150
2169,6,6,1,2412,-82,-89,7,e2:db:d1:d1:b0:4a,6546309,444,9715,6545865,6546309
2170,6,6,1,2412,-84,-89,5,e2:db:d1:d1:b0:4f,6547685,408,968,6547277,6547685
2171,4,11,1,2412,-83,-89,6,4c:01:43:ec:a0:69,6554477,361,6431,6554116,6554477
2172,4,11,1,2412,-79,-89,10,48:dd:0c:90:e3:87,6555753,362,914,6555391,6555753
2173,4,11,1,2412,-78,-89,11,48:dd:0c:90:e3:83,6556128,323,52,6555805,6556128
2174,4,11,1,2412,-75,-89,14,48:dd:0c:90:e3:85,6556463,382,-47,6556081,6556463
2175,6,6,1,2412,-82,-89,7,,6559269,44,2762,6559225,6559269
2176,6,6,1,2412,-67,-89,22,52:86:8c:5f:93:1e,6561078,332,1477,6560746,6561078
2177,6,6,1,2412,-80,-89,9,,6561634,44,512,6561590,6561634
2178,6,24,1,2412,-81,-89,8,,6562139,28,477,6562111,6562139
2179,6,12,1,2412,-81,-89,8,4c:01:43:ec:a0:66,6562253,44,70,6562209,6562253
2180,4,1,1,2412,-79,-89,10,3c:bd:c5:ee:96:6d,6562606,2512,-2159,6560094,6562606
2181,4,1,1,2412,-79,-89,10,,6566281,304,3371,6565977,6566281
2182,6,24,1,2412,-80,-89,9,,6588681,28,22372,6588653,6588681
2183,6,12,1,2412,-80,-89,9,4c:01:43:ec:a0:66,6588795,44,70,6588751,6588795
2184,6,6,1,2412,-80,-89,9,4c:01:43:ec:a0:66,6589245,52,398,6589193,6589245
2185,6,6,1,2412,-80,-89,9,,6589862,44,573,6589818,6589862
2186,6,24,1,2412,-85,-89,4,,6591027,28,1137,6590999,6591027
2187,6,12,1,2412,-80,-89,9,4c:01:43:ec:a0:66,6591140,44,69,6591096,6591140
2188,6,6,1,2412,-79,-89,10,4c:01:43:ec:a0:66,6591885,52,693,6591833,6591885
2189,6,6,1,2412,-80,-89,9,,6592671,44,742,6592627,6592671
2190,6,24,1,2412,-80,-89,9,,6593580,28,881,6593552,6593580
2191,6,12,1,2412,-80,-89,9,4c:01:43:ec:a0:66,6593693,44,69,6593649,6593693
2192,6,6,1,2412,-79,-89,10,,6594310,44,573,6594266,6594310
2193,6,24,1,2412,-80,-89,9,,6594699,28,361,6594671,6594699
2194,6,12,1,2412,-79,-89,10,4c:01:43:ec:a0:66,6594812,44,69,6594768,6594812
2195,6,6,1,2412,-80,-89,9,,6595399,44,543,6595355,6595399
2196,6,24,1,2412,-80,-89,9,,6595692,28,265,6595664,6595692
2197,6,12,1,2412,-79,-89,10,4c:01:43:ec:a0:66,6595805,44,69,6595761,6595805
2198,6,24,1,2412,-80,-89,9,,6596922,28,1089,6596894,6596922
2199,6,12,1,2412,-80,-89,9,4c:01:43:ec:a0:66,6597035,44,69,6596991,6597035
2200,6,6,1,2412,-79,-89,10,4c:01:43:ec:a0:66,6597528,52,441,6597476,6597528
2201,6,6,1,2412,-79,-89,10,,6598109,44,537,6598065,6598109
2202,6,6,1,2412,-79,-89,10,,6598901,44,748,6598857,6598901
2203,6,6,1,2412,-79,-89,10,,6599998,44,1053,6599954,6599998
2204,6,24,1,2412,-79,-89,10,,6600410,28,384,6600382,6600410
2205,6,12,1,2412,-80,-89,9,4c:01:43:ec:a0:66,6600522,44,68,6600478,6600522
2206,6,24,1,2412,-79,-89,10,,6601201,28,651,6601173,6601201
2207,6,12,1,2412,-79,-89,10,4c:01:43:ec:a0:66,6601313,44,68,6601269,6601313
2208,6,6,1,2412,-79,-89,10,,6602306,44,949,6602262,6602306
2209,6,6,1,2412,-79,-89,10,,6604442,44,2092,6604398,6604442
2210,6,24,1,2412,-79,-89,10,,6604620,28,150,6604592,6604620
2211,6,12,1,2412,-79,-89,10,4c:01:43:ec:a0:66,6604732,44,68,6604688,6604732
2212,6,6,1,2412,-79,-89,10,,6606404,44,1628,6606360,6606404
2213,6,24,1,2412,-79,-89,10,,6606596,28,164,6606568,6606596
2214,6,12,1,2412,-79,-89,10,4c:01:43:ec:a0:66,6606709,44,69,6606665,6606709
2215,6,24,1,2412,-79,-89,10,,6607481,28,744,6607453,6607481
2216,6,12,1,2412,-78,-89,11,4c:01:43:ec:a0:66,6607593,44,68,6607549,6607593
2217,4,1,1,2412,-76,-89,13,b0:e4:d5:32:ec:8a,6608454,1960,-1099,6606494,6608454
2218,4,1,1,2412,-55,-89,34,94:a6:7e:c9:98:67,6615434,2464,4516,6612970,6615434
2219,4,11,1,2412,-86,-89,3,4c:01:43:d7:f3:23,6619047,322,3291,6618725,6619047
2220,6,6,1,2412,-77,-89,12,,6619939,44,848,6619895,6619939
2221,6,24,1,2412,-78,-89,11,,6620224,28,257,6620196,6620224
2222,6,6,1,2412,-78,-89,11,,6622605,44,2337,6622561,6622605
2223,6,24,1,2412,-81,-89,8,,6623933,28,1300,6623905,6623933
2224,6,6,1,2412,-77,-89,12,,6625156,44,1179,6625112,6625156
2225,6,24,1,2412,-78,-89,11,,6626261,28,1077,6626233,6626261
2226,6,12,1,2412,-78,-89,11,4c:01:43:ec:a0:66,6626374,44,69,6626330,6626374
2227,6,24,1,2412,-77,-89,12,,6627330,28,928,6627302,6627330
2228,6,12,1,2412,-77,-89,12,4c:01:43:ec:a0:66,6627471,44,97,6627427,6627471
2229,6,24,1,2412,-88,-89,1,4c:01:43:d7:f3:26,6627810,32,307,6627778,6627810
2230,4,11,1,2412,-73,-89,16,48:dd:0c:7d:86:23,6633386,323,5253,6633063,6633386
2231,6,6,1,2412,-78,-89,11,40:b0:34:b7:01:d5,6636026,576,2064,6635450,6636026
2232,6,24,1,2412,-79,-89,10,,6637284,28,1230,6637256,6637284
2233,6,6,1,2412,-72,-89,17,12:86:8c:5f:93:1e,6637879,332,263,6637547,6637879
2234,4,1,1,2412,-84,-89,5,00:26:62:eb:ea:74,6648208,968,9361,6647240,6648208
2235,6,6,1,2412,-84,-89,5,,6650670,44,2418,6650626,6650670
2236,6,6,1,2412,-76,-89,13,4c:01:43:ec:a0:66,6656124,52,5402,6656072,6656124
2237,4,11,1,2412,-78,-89,11,4c:01:43:ec:a0:69,6656876,361,391,6656515,6656876
2238,4,11,1,2412,-77,-89,12,4c:01:43:ec:a0:63,6657250,322,52,6656928,6657250
2239,4,11,1,2412,-77,-89,12,4c:01:43:ec:a0:66,6657585,387,-52,6657198,6657585
2240,6,6,1,2412,-76,-89,13,4c:01:43:ec:a0:66,6657860,52,223,6657808,6657860
2241,4,11,1,2412,-77,-89,12,48:dd:0c:90:e3:87,6658153,362,-69,6657791,6658153
2242,4,11,1,2412,-77,-89,12,48:dd:0c:90:e3:83,6658528,323,52,6658205,6658528
2243,6,6,1,2412,-76,-89,13,4c:01:43:ec:a0:66,6659821,52,1241,6659769,6659821
2244,4,1,1,2412,-92,-89,-3,cc:f4:11:65:3f:fb,6702829,1184,41824,6701645,6702829
2245,4,1,1,2412,-60,-89,29,94:a6:7e:c9:98:67,6717830,2464,12537,6715366,6717830
2246,6,12,1,2412,-84,-89,5,,6720668,32,2806,6720636,6720668
2247,6,6,1,2412,-87,-89,2,e2:db:d1:d1:b0:4a,6720916,68,180,6720848,6720916
2248,6,6,1,2412,-66,-89,23,b4:e6:2d:b4:ff:71,6722178,64,1198,6722114,6722178
2249,6,6,1,2412,-66,-89,23,,6722258,44,36,6722214,6722258
2250,7,21.6667,1,2412,-87,-89,2,e2:db:d1:d1:b0:4a,6726683,612,3813,6726071,6726683
2251,6,6,1,2412,-84,-89,5,,6727382,44,655,6727338,6727382
2252,6,6,1,2412,-86,-89,3,e2:db:d1:d1:b0:4a,6727913,68,463,6727845,6727913
2253,6,6,1,2412,-86,-89,3,e2:db:d1:d1:b0:4a,6728078,52,113,6728026,6728078
2254,7,21.6667,1,2412,0,-89,89,e2:db:d1:d1:b0:4a,6728208,604,-474,6727604,6728208
2255,7,21.6667,1,2412,0,-89,89,e2:db:d1:d1:b0:4a,6728208,572,-572,6727636,6728208
2256,6,6,1,2412,-84,-89,5,40:b0:34:b7:01:d5,6738427,576,9643,6737851,6738427
2257,6,24,1,2412,-87,-89,2,,6739807,28,1352,6739779,6739807
2258,6,6,1,2412,-66,-89,23,12:86:8c:5f:93:1e,6740279,332,140,6739947,6740279
2259,6,24,1,2412,-79,-89,10,,6740632,28,325,6740604,6740632
2260,6,24,1,2412,-77,-89,12,,6740999,28,339,6740971,6740999
2261,6,24,1,2412,-78,-89,11,,6742403,28,1376,6742375,6742403
2262,6,24,1,2412,-79,-89,10,,6743204,28,773,6743176,6743204
2263,6,24,1,2412,-77,-89,12,4c:01:43:ec:a0:66,6743315,32,79,6743283,6743315
2264,6,6,1,2412,-81,-89,8,,6750839,44,7480,6750795,6750839
2265,6,6,1,2412,-85,-89,4,e2:db:d1:d1:b0:4a,6751570,68,663,6751502,6751570
2266,6,6,1,2412,-86,-89,3,e2:db:d1:d1:b0:4a,6751726,52,104,6751674,6751726
2267,7,21.6667,1,2412,-86,-89,3,e2:db:d1:d1:b0:4a,6751856,79,51,6751777,6751856
2268,6,6,1,2412,-84,-89,5,e2:db:d1:d1:b0:4f,6758745,408,6481,6758337,6758745
2269,6,24,1,2412,-86,-89,3,,6759262,28,489,6759234,6759262
2270,6,6,1,2412,-86,-89,3,e2:db:d1:d1:b0:4a,6759423,68,93,6759355,6759423
2271,6,6,1,2412,-85,-89,4,,6759652,44,185,6759608,6759652
2272,6,6,1,2412,-87,-89,2,e2:db:d1:d1:b0:4a,6759809,52,105,6759757,6759809
2273,4,11,1,2412,-75,-89,14,48:dd:0c:90:e3:87,6760553,362,382,6760191,6760553
2274,4,11,1,2412,-74,-89,15,48:dd:0c:90:e3:83,6760927,323,51,6760604,6760927
2275,4,11,1,2412,-76,-89,13,48:dd:0c:90:e3:85,6761262,382,-47,6760880,6761262
2276,4,11,1,2412,-80,-89,9,4c:01:43:ec:a0:63,6762222,322,638,6761900,6762222
2277,6,6,1,2412,-66,-89,23,52:86:8c:5f:93:1e,6765880,332,3326,6765548,6765880
2278,6,6,1,2412,-84,-89,5,e2:db:d1:d1:b0:4a,6770699,68,4751,6770631,6770699
2279,7,21.6667,1,2412,0,-89,89,e2:db:d1:d1:b0:4a,6776115,604,4812,6775511,6776115
2280,7,21.6667,1,2412,0,-89,89,e2:db:d1:d1:b0:4a,6776115,572,-572,6775543,6776115
2281,7,21.6667,1,2412,0,-89,89,e2:db:d1:d1:b0:4a,6776115,100,-100,6776015,6776115
2282,4,1,1,2412,-90,-89,-1,ac:67:84:84:8a:07,6782782,448,6219,6782334,6782782
2283,7,21.6667,1,2412,0,-89,89,e2:db:d1:d1:b0:4a,6789856,612,6462,6789244,6789856
2284,7,21.6667,1,2412,0,-89,89,e2:db:d1:d1:b0:4a,6789856,572,-572,6789284,6789856
2285,7,21.6667,1,2412,-85,-89,4,e2:db:d1:d1:b0:4a,6789856,572,-572,6789284,6789856
2286,6,6,1,2412,-86,-89,3,e2:db:d1:d1:b0:4a,6795207,52,5299,6795155,6795207
2287,6,6,1,2412,-84,-89,5,,6801511,44,6260,6801467,6801511
2288,4,1,1,2412,-71,-89,18,,6803878,304,2063,6803574,6803878
2289,4,1,1,2412,-74,-89,15,b0:e4:d5:32:ec:8a,6813253,1960,7415,6811293,6813253
2290,6,6,1,2412,-86,-89,3,,6816058,44,2761,6816014,6816058
2291,4,1,1,2412,-66,-89,23,94:a6:7e:c9:98:67,6820234,2464,1712,6817770,6820234
2292,4,11,1,2412,-80,-89,9,4c:01:43:d7:f3:29,6825057,362,4461,6824695,6825057
2293,4,11,1,2412,-80,-89,9,4c:01:43:d7:f3:26,6825766,387,322,6825379,6825766
2294,4,11,1,2412,-74,-89,15,48:dd:0c:7d:86:27,6837812,362,11684,6837450,6837812
2295,4,11,1,2412,-75,-89,14,48:dd:0c:7d:86:23,6838186,323,51,6837863,6838186
2296,4,11,1,2412,-75,-89,14,48:dd:0c:7d:86:25,6838522,382,-46,6838140,6838522
2297,4,1,1,2412,-89,-89,0,00:26:62:eb:ea:74,6848215,968,8725,6847247,6848215
2298,6,6,1,2412,-85,-89,4,e2:db:d1:d1:b0:4a,6853513,444,4854,6853069,6853513
2299,6,6,1,2412,-85,-89,4,e2:db:d1:d1:b0:4b,6853990,408,69,6853582,6853990
2300,6,6,1,2412,-85,-89,4,e2:db:d1:d1:b0:4d,6854431,408,33,6854023,6854431
2301,6,6,1,2412,-87,-89,2,e2:db:d1:d1:b0:4f,6854890,408,51,6854482,6854890
2302,6,6,1,2412,-86,-89,3,,6855450,44,516,6855406,6855450
2303,4,11,1,2412,-81,-89,8,4c:01:43:ec:a0:69,6861674,361,5863,6861313,6861674
2304,4,11,1,2412,-77,-89,12,4c:01:43:ec:a0:63,6862048,322,52,6861726,6862048
2305,4,11,1,2412,-83,-89,6,4c:01:43:ec:a0:66,6862382,387,-53,6861995,6862382
2306,4,11,1,2412,-77,-89,12,48:dd:0c:90:e3:87,6862952,362,208,6862590,6862952
2307,4,11,1,2412,-76,-89,13,48:dd:0c:90:e3:83,6863327,323,52,6863004,6863327
2308,4,11,1,2412,-77,-89,12,48:dd:0c:90:e3:85,6863662,382,-47,6863280,6863662
2309,6,24,1,2412,-78,-89,11,,6870907,28,7217,6870879,6870907
2310,4,1,1,2412,-83,-89,6,78:67:0e:c4:a8:42,6875196,2736,1553,6872460,6875196
2311,4,1,1,2412,-84,-89,5,78:67:0e:c4:a8:42,6881103,352,5555,6880751,6881103
2312,4,1,1,2412,-86,-89,3,,6882493,304,1086,6882189,6882493
2313,6,6,1,2412,-65,-89,24,32:86:8c:5f:93:1e,6893880,332,11055,6893548,6893880
2314,4,1,1,2412,-85,-89,4,,6906880,304,12696,6906576,6906880
2315,4,11,1,2412,-84,-89,5,4c:01:43:d7:f3:23,6907939,254,805,6907685,6907939
2316,4,11,1,2412,-85,-89,4,4c:01:43:ec:a0:63,6908652,254,459,6908398,6908652
2317,4,11,1,2412,-85,-89,4,,6910207,107,1448,6910100,6910207
2318,6,24,1,2412,-79,-89,10,78:67:0e:c4:a8:42,6910320,32,81,6910288,6910320
2319,4,1,1,2412,-74,-89,15,b0:e4:d5:32:ec:8a,6915652,1960,3372,6913692,6915652
2320,4,11,1,2412,-84,-89,5,4c:01:43:d7:f3:23,6926473,322,10499,6926151,6926473
2321,4,11,1,2412,-83,-89,6,4c:01:43:d7:f3:26,6926808,387,-52,6926421,6926808
2322,4,1,1,2412,-80,-89,9,78:67:0e:38:6c:d3,6937453,2736,7909,6934717,6937453
2323,4,11,1,2412,-74,-89,15,48:dd:0c:7d:86:27,6940212,362,2397,6939850,6940212
2324,4,11,1,2412,-73,-89,16,48:dd:0c:7d:86:23,6940586,323,51,6940263,6940586
2325,4,11,1,2412,-73,-89,16,48:dd:0c:7d:86:25,6940921,382,-47,6940539,6940921
2326,6,24,1,2412,-82,-89,7,,6949768,28,8819,6949740,6949768
2327,6,24,1,2412,-82,-89,7,,6950907,28,1111,6950879,6950907
2328,4,1,1,2412,-86,-89,3,00:26:62:eb:ea:74,6955821,968,3946,6954853,6955821
2329,4,1,1,2412,-91,-89,-2,,6959668,304,3543,6959364,6959668
2330,6,24,1,2412,-83,-89,6,,6963484,28,3788,6963456,6963484
2331,4,11,1,2412,-87,-89,2,4c:01:43:ec:a0:69,6964073,361,228,6963712,6964073
2332,4,11,1,2412,-87,-89,2,4c:01:43:ec:a0:63,6964446,322,51,6964124,6964446
2333,4,11,1,2412,-86,-89,3,4c:01:43:ec:a0:66,6964781,387,-52,6964394,6964781
2334,4,11,1,2412,-77,-89,12,48:dd:0c:90:e3:83,6965902,323,798,6965579,6965902
2335,4,11,1,2412,-77,-89,12,48:dd:0c:90:e3:85,6966237,382,-47,6965855,6966237
2336,4,1,1,2412,-90,-89,-1,40:ca:63:2d:74:be,6967405,1896,-728,6965509,6967405
2337,6,6,1,2412,-61,-89,28,52:86:8c:5f:93:1e,6970681,332,2944,6970349,6970681
2338,6,6,1,2412,-84,-89,5,0a:a7:c0:a3:8d:71,6973930,408,2841,6973522,6973930
2339,4,1,1,2412,-78,-89,11,78:67:0e:c4:a8:42,6977535,2736,869,6974799,6977535
2340,4,1,1,2412,-85,-89,4,04:a2:22:bf:24:52,6981708,2512,1661,6979196,6981708
2341,6,6,1,2412,-60,-89,29,32:86:8c:5f:93:1e,6996282,332,14242,6995950,6996282
2342,4,1,1,2412,-91,-89,-2,ce:f4:11:65:3f:f8,6998008,2072,-346,6995936,6998008
2343,6,6,1,2412,-59,-89,30,b4:e6:2d:b4:ff:71,7003343,64,5271,7003279,7003343
2344,6,6,1,2412,-62,-89,27,,7003423,44,36,7003379,7003423
2345,4,1,1,2412,-92,-89,-3,d4:6c:6d:86:e7:7e,7015737,1776,10538,7013961,7015737
2346,4,1,1,2412,-69,-89,20,b0:e4:d5:32:ec:8a,7018051,1960,354,7016091,7018051
2347,6,24,1,2412,-84,-89,5,,7020102,28,2023,7020074,7020102
2348,6,24,1,2412,-83,-89,6,,7020723,28,593,7020695,7020723
2349,4,1,1,2412,-59,-89,30,94:a6:7e:c9:98:67,7025028,2464,1841,7022564,7025028
2350,6,24,1,2412,-85,-89,4,,7030913,28,5857,7030885,7030913
2351,4,1,1,2412,-86,-89,3,78:67:0e:38:6c:d3,7039853,2736,6204,7037117,7039853
2352,4,11,1,2412,-73,-89,16,48:dd:0c:7d:86:27,7042613,362,2398,7042251,7042613
2353,4,11,1,2412,-71,-89,18,48:dd:0c:7d:86:23,7042987,323,51,7042664,7042987
2354,4,11,1,2412,-73,-89,16,48:dd:0c:7d:86:25,7043322,382,-47,7042940,7043322
2355,6,6,1,2412,-61,-89,28,12:86:8c:5f:93:1e,7047481,332,3827,7047149,7047481
2356,6,6,1,2412,-87,-89,2,e2:db:d1:d1:b0:4b,7058770,408,10881,7058362,7058770
2357,6,6,1,2412,-87,-89,2,e2:db:d1:d1:b0:4d,7059220,408,42,7058812,7059220
2358,4,11,1,2412,-81,-89,8,4c:01:43:ec:a0:69,7066472,361,6891,7066111,7066472
2359,4,11,1,2412,-84,-89,5,4c:01:43:ec:a0:63,7066845,322,51,7066523,7066845
2360,4,11,1,2412,-83,-89,6,4c:01:43:ec:a0:66,7067180,387,-52,7066793,7067180
2361,4,11,1,2412,-72,-89,17,48:dd:0c:90:e3:87,7067752,362,210,7067390,7067752
2362,4,11,1,2412,-72,-89,17,48:dd:0c:90:e3:85,7068462,382,328,7068080,7068462
2363,6,6,1,2412,-85,-89,4,,7072820,44,4314,7072776,7072820
2364,6,6,1,2412,-61,-89,28,52:86:8c:5f:93:1e,7073083,332,-69,7072751,7073083
2365,6,6,1,2412,-86,-89,3,0a:a7:c0:a3:8d:70,7075808,464,2261,7075344,7075808
2366,6,6,1,2412,-84,-89,5,0a:a7:c0:a3:8d:71,7076324,408,108,7075916,7076324
2367,6,6,1,2412,-86,-89,3,0a:a7:c0:a3:8d:73,7076782,408,50,7076374,7076782
2368,6,6,1,2412,-85,-89,4,0a:a7:c0:a3:8d:75,7077214,408,24,7076806,7077214
2369,4,1,1,2412,-87,-89,2,04:a2:22:bf:24:52,7084013,2512,4287,7081501,7084013
2370,6,24,1,2412,-84,-89,5,,7088634,28,4593,7088606,7088634
2371,6,6,1,2412,-61,-89,28,32:86:8c:5f:93:1e,7098682,332,9716,7098350,7098682
2372,6,24,1,2412,-80,-89,9,,7110913,28,12203,7110885,7110913
2373,4,1,1,2412,-74,-89,15,b0:e4:d5:32:ec:8a,7120451,1960,7578,7118491,7120451
2374,6,6,1,2412,-61,-89,28,10:86:8c:5f:93:1e,7124282,344,3487,7123938,7124282
2375,6,6,1,2412,-86,-89,3,,7134970,44,10644,7134926,7134970
2376,4,11,1,2412,-68,-89,21,48:dd:0c:7d:86:23,7145182,323,9889,7144859,7145182
2377,4,11,1,2412,-67,-89,22,48:dd:0c:7d:86:25,7145517,382,-47,7145135,7145517
2378,6,6,1,2412,-65,-89,24,12:86:8c:5f:93:1e,7150019,332,4170,7149687,7150019
2379,4,1,1,2412,-72,-89,17,70:3a:cb:63:35:b2,7151289,2216,-946,7149073,7151289
2380,6,6,1,2412,-82,-89,7,e2:db:d1:d1:b0:4a,7155320,52,3979,7155268,7155320
2381,7,7.22222,1,2412,0,-89,89,e2:db:d1:d1:b0:4a,7159643,1752,2571,7157891,7159643
2382,7,7.22222,1,2412,-84,-89,5,e2:db:d1:d1:b0:4a,7159643,1720,-1720,7157923,7159643
2383,6,6,1,2412,-82,-89,7,,7163245,44,3558,7163201,7163245
2384,6,6,1,2412,-86,-89,3,,7163492,44,203,7163448,7163492
2385,6,6,1,2412,-87,-89,2,e2:db:d1:d1:b0:4a,7163696,52,152,7163644,7163696
2386,7,21.6667,1,2412,-87,-89,2,e2:db:d1:d1:b0:4a,7163826,79,51,7163747,7163826
2387,6,6,1,2412,-87,-89,2,,7163992,44,122,7163948,7163992
2388,6,6,1,2412,-85,-89,4,e2:db:d1:d1:b0:4a,7165672,444,1236,7165228,7165672
2389,6,6,1,2412,-85,-89,4,e2:db:d1:d1:b0:4b,7166158,408,78,7165750,7166158
2390,6,6,1,2412,-84,-89,5,e2:db:d1:d1:b0:4d,7166590,408,24,7166182,7166590
2391,6,6,1,2412,-87,-89,2,e2:db:d1:d1:b0:4f,7167022,408,24,7166614,7167022
2392,6,12,1,2412,-85,-89,4,,7167539,32,485,7167507,7167539
2393,6,6,1,2412,-86,-89,3,e2:db:d1:d1:b0:4a,7167679,68,72,7167611,7167679
2394,6,6,1,2412,-84,-89,5,,7167881,44,158,7167837,7167881
2395,6,6,1,2412,-84,-89,5,e2:db:d1:d1:b0:4a,7168012,52,79,7167960,7168012
2396,4,11,1,2412,-78,-89,11,4c:01:43:ec:a0:69,7168870,361,497,7168509,7168870
2397,4,11,1,2412,-77,-89,12,4c:01:43:ec:a0:63,7169244,322,52,7168922,7169244
2398,4,11,1,2412,-78,-89,11,4c:01:43:ec:a0:66,7169579,387,-52,7169192,7169579
2399,4,11,1,2412,-75,-89,14,48:dd:0c:90:e3:87,7170152,362,211,7169790,7170152
2400,4,11,1,2412,-76,-89,13,48:dd:0c:90:e3:85,7170861,382,327,7170479,7170861
2401,6,24,1,2412,-84,-89,5,,7171197,28,308,7171169,7171197
2402,6,6,1,2412,-86,-89,3,,7171317,44,76,7171273,7171317
2403,6,24,1,2412,-86,-89,3,,7171967,28,622,7171939,7171967
2404,6,6,1,2412,-89,-89,0,,7172087,44,76,7172043,7172087
2405,6,6,1,2412,-62,-89,27,52:86:8c:5f:93:1e,7175482,332,3063,7175150,7175482
2406,6,6,1,2412,-84,-89,5,e2:db:d1:d1:b0:4a,7175952,52,418,7175900,7175952
2407,4,1,1,2412,-84,-89,5,3c:bd:c5:ee:96:6d,7176917,2512,-1547,7174405,7176917
2408,6,6,1,2412,-86,-89,3,e2:db:d1:d1:b0:4a,7180380,52,3411,7180328,7180380
2409,4,1,1,2412,-84,-89,5,78:67:0e:c4:a8:42,7182500,2736,-616,7179764,7182500
2410,6,24,1,2412,-87,-89,2,,7185307,28,2779,7185279,7185307
2411,6,6,1,2412,-86,-89,3,e2:db:d1:d1:b0:4a,7185771,68,396,7185703,7185771
2412,6,6,1,2412,-87,-89,2,e2:db:d1:d1:b0:4a,7185983,52,160,7185931,7185983
2413,7,7.22222,1,2412,0,-89,89,e2:db:d1:d1:b0:4a,7191909,1752,4174,7190157,7191909
2414,7,7.22222,1,2412,0,-89,89,e2:db:d1:d1:b0:4a,7191909,1720,-1720,7190189,7191909
2415,7,7.22222,1,2412,-86,-89,3,e2:db:d1:d1:b0:4a,7191909,1720,-1720,7190189,7191909
2416,6,6,1,2412,-86,-89,3,,7196026,44,4073,7195982,7196026
2417,6,24,1,2412,-88,-89,1,,7196154,28,100,7196126,7196154
2418,6,6,1,2412,-88,-89,1,e2:db:d1:d1:b0:4a,7196310,68,88,7196242,7196310
2419,6,6,1,2412,-85,-89,4,e2:db:d1:d1:b0:4a,7196536,52,174,7196484,7196536
2420,6,6,1,2412,-85,-89,4,,7197942,44,1362,7197898,7197942
2421,6,6,1,2412,-87,-89,2,e2:db:d1:d1:b0:4a,7198153,52,159,7198101,7198153
2422,6,6,1,2412,-87,-89,2,e2:db:d1:d1:b0:4a,7200567,52,2362,7200515,7200567
2423,6,6,1,2412,-63,-89,26,32:86:8c:5f:93:1e,7201082,332,183,7200750,7201082
2424,6,6,1,2412,-84,-89,5,e2:db:d1:d1:b0:4a,7202071,52,937,7202019,7202071
2425,6,6,1,2412,-86,-89,3,,7203458,44,1343,7203414,7203458
2426,6,6,1,2412,-87,-89,2,e2:db:d1:d1:b0:4a,7203887,52,377,7203835,7203887
2427,6,24,1,2412,-86,-89,3,,7207685,28,3770,7207657,7207685
2428,6,6,1,2412,-86,-89,3,,7207805,44,76,7207761,7207805
2429,6,6,1,2412,-86,-89,3,e2:db:d1:d1:b0:4a,7207990,52,133,7207938,7207990
2430,7,13,1,2412,0,-89,89,e2:db:d1:d1:b0:4a,7208119,988,-859,7207131,7208119
2431,7,13,1,2412,0,-89,89,e2:db:d1:d1:b0:4a,7208119,956,-956,7207163,7208119
2432,7,13,1,2412,-86,-89,3,e2:db:d1:d1:b0:4a,7208119,956,-956,7207163,7208119
2433,6,6,1,2412,-86,-89,3,e2:db:d1:d1:b0:4a,7213461,52,5290,7213409,7213461
2434,6,6,1,2412,-65,-89,24,10:86:8c:5f:93:1e,7226684,344,12879,7226340,7226684
2435,4,1,1,2412,-60,-89,29,94:a6:7e:c9:98:67,7229838,2464,690,7227374,7229838
2436,4,1,1,2412,-92,-89,-3,82:67:0e:4d:a3:6e,7242076,2472,9766,7239604,7242076
2437,4,11,1,2412,-70,-89,19,48:dd:0c:7d:86:25,7245733,382,3275,7245351,7245733
2438,4,1,1,2412,-68,-89,21,78:67:0e:38:6c:d3,7247446,2208,-495,7245238,7247446
2439,6,6,1,2412,-81,-89,8,e2:db:d1:d1:b0:4a,7263116,444,15226,7262672,7263116
2440,4,11,1,2412,-85,-89,4,4c:01:43:ec:a0:63,7271643,322,8205,7271321,7271643
2441,4,11,1,2412,-74,-89,15,48:dd:0c:90:e3:87,7272551,362,546,7272189,7272551
2442,4,11,1,2412,-75,-89,14,48:dd:0c:90:e3:83,7272926,323,52,7272603,7272926
2443,4,11,1,2412,-74,-89,15,48:dd:0c:90:e3:85,7273261,382,-47,7272879,7273261
2444,4,1,1,2412,-92,-89,-3,10:7b:44:eb:35:60,7273645,384,,7273261,7273645
2445,4,1,1,2412,-93,-89,-4,ac:67:84:84:8a:07,7274044,448,-49,7273596,7274044
2446,6,24,1,2412,-81,-89,8,,7283492,28,9420,7283464,7283492
2447,4,1,1,2412,-93,-89,-4,,7287483,304,3687,7287179,7287483
2448,6,24,1,2412,-86,-89,3,,7295145,28,7634,7295117,7295145
2449,6,24,1,2412,-85,-89,4,,7295792,28,619,7295764,7295792
2450,4,11,1,2412,-87,-89,2,4c:01:43:ec:a0:63,7296928,254,882,7296674,7296928
2451,4,11,1,2412,-83,-89,6,4c:01:43:d7:f3:23,7297652,254,470,7297398,7297652
2452,6,24,1,2412,-86,-89,3,,7301878,28,4198,7301850,7301878
2453,6,12,1,2412,-86,-89,3,,7301994,32,84,7301962,7301994
2454,4,11,1,2412,-87,-89,2,4c:01:43:ec:a0:63,7302675,296,385,7302379,7302675
2455,4,11,1,2412,-84,-89,5,4c:01:43:d7:f3:23,7303532,296,561,7303236,7303532
2456,6,6,1,2412,-65,-89,24,32:86:8c:5f:93:1e,7303683,332,-181,7303351,7303683
2457,6,24,1,2412,-82,-89,7,,7306331,28,2620,7306303,7306331
2458,4,1,1,2412,-91,-89,-2,,7308399,304,1764,7308095,7308399
2459,6,6,1,2412,-65,-89,24,10:86:8c:5f:93:1e,7329083,344,20340,7328739,7329083
2460,4,1,1,2412,-56,-89,33,94:a6:7e:c9:98:67,7332236,2464,689,7329772,7332236
2461,4,11,1,2412,-83,-89,6,4c:01:43:d7:f3:23,7335912,322,3354,7335590,7335912
2462,4,11,1,2412,-83,-89,6,4c:01:43:d7:f3:26,7336247,387,-52,7335860,7336247
2463,6,6,1,2412,-86,-89,3,3c:bd:c5:ee:96:6d,7341068,68,4753,7341000,7341068
2464,4,1,1,2412,-75,-89,14,78:67:0e:38:6c:d3,7347054,2736,3250,7344318,7347054
2465,4,11,1,2412,-72,-89,17,48:dd:0c:7d:86:27,7349813,362,2397,7349451,7349813
2466,4,11,1,2412,-72,-89,17,48:dd:0c:7d:86:23,7350187,323,51,7349864,7350187
2467,4,11,1,2412,-73,-89,16,48:dd:0c:7d:86:25,7350523,382,-46,7350141,7350523
2468,6,24,1,2412,-87,-89,2,,7352220,28,1669,7352192,7352220
2469,6,12,1,2412,-86,-89,3,,7352340,32,88,7352308,7352340
2470,6,12,1,2412,-86,-89,3,,7352472,32,100,7352440,7352472
2471,6,6,1,2412,-84,-89,5,40:b0:34:b7:01:d5,7352833,576,-215,7352257,7352833
2472,4,11,1,2412,-83,-89,6,4c:01:43:d7:f3:23,7354698,331,1534,7354367,7354698
2473,6,6,1,2412,-65,-89,24,12:86:8c:5f:93:1e,7354884,332,-146,7354552,7354884
2474,4,1,1,2412,-88,-89,1,d8:9c:8e:01:4c:6a,7359436,3000,1552,7356436,7359436
2475,6,6,1,2412,-87,-89,2,e2:db:d1:d1:b0:4d,7366405,408,6561,7365997,7366405
2476,4,1,1,2412,-86,-89,3,00:26:62:eb:ea:74,7367273,968,-100,7366305,7367273
2477,4,11,1,2412,-87,-89,2,4c:01:43:ec:a0:69,7373668,361,6034,7373307,7373668
2478,4,11,1,2412,-86,-89,3,4c:01:43:ec:a0:66,7374376,387,321,7373989,7374376
2479,4,11,1,2412,-82,-89,7,48:dd:0c:90:e3:85,7375661,382,903,7375279,7375661
2480,4,1,1,2412,-91,-89,-2,40:ca:63:2d:74:be,7377002,1896,-555,7375106,7377002
2481,6,6,1,2412,-88,-89,1,0a:a7:c0:a3:8d:71,7383528,408,6118,7383120,7383528
2482,6,6,1,2412,-88,-89,1,0a:a7:c0:a3:8d:73,7383969,408,33,7383561,7383969
2483,6,6,1,2412,-88,-89,1,0a:a7:c0:a3:8d:75,7384410,408,33,7384002,7384410
2484,4,1,1,2412,-86,-89,3,04:a2:22:bf:24:52,7391236,2512,4314,7388724,7391236
2485,6,24,1,2412,-80,-89,9,78:67:0e:c4:a8:42,7394052,32,2784,7394020,7394052
2486,6,6,1,2412,-64,-89,25,32:86:8c:5f:93:1e,7405885,332,11501,7405553,7405885
2487,4,1,1,2412,-89,-89,0,ce:f4:11:65:3f:f8,7407643,2072,-314,7405571,7407643
2488,6,6,1,2412,-82,-89,7,,7410191,44,2504,7410147,7410191
2489,6,24,1,2412,-80,-89,9,,7418250,28,8031,7418222,7418250
2490,4,1,1,2412,-71,-89,18,b0:e4:d5:32:ec:8a,7427648,1960,7438,7425688,7427648
2491,6,6,1,2412,-64,-89,25,10:86:8c:5f:93:1e,7431484,344,3492,7431140,7431484
2492,4,1,1,2412,-58,-89,31,94:a6:7e:c9:98:67,7434631,2464,683,7432167,7434631
2493,4,11,1,2412,-82,-89,7,4c:01:43:d7:f3:29,7437868,362,2875,7437506,7437868
2494,4,11,1,2412,-83,-89,6,4c:01:43:d7:f3:23,7438243,322,53,7437921,7438243
2495,4,11,1,2412,-83,-89,6,4c:01:43:d7:f3:26,7438577,387,-53,7438190,7438577
2496,4,11,1,2412,-83,-89,6,4c:01:43:d7:f3:26,7439010,286,147,7438724,7439010
2497,4,11,1,2412,-82,-89,7,4c:01:43:d7:f3:26,7439372,321,41,7439051,7439372
2498,4,11,1,2412,-82,-89,7,4c:01:43:d7:f3:26,7439765,336,57,7439429,7439765
2499,6,24,1,2412,-82,-89,7,,7443495,28,3702,7443467,7443495
2500,4,1,1,2412,-78,-89,11,78:67:0e:38:6c:d3,7449454,2736,3223,7446718,7449454
2501,4,11,1,2412,-75,-89,14,48:dd:0c:7d:86:27,7452213,362,2397,7451851,7452213
2502,4,11,1,2412,-76,-89,13,48:dd:0c:7d:86:23,7452587,323,51,7452264,7452587
2503,4,11,1,2412,-76,-89,13,48:dd:0c:7d:86:25,7452923,382,-46,7452541,7452923
2504,6,6,1,2412,-63,-89,26,12:86:8c:5f:93:1e,7457085,332,3830,7456753,7457085
2505,6,12,1,2412,-80,-89,9,,7464032,32,6915,7464000,7464032
2506,6,12,1,2412,-80,-89,9,,7466098,32,2034,7466066,7466098
2507,6,12,1,2412,-81,-89,8,,7466375,32,245,7466343,7466375
2508,6,12,1,2412,-81,-89,8,,7467392,32,985,7467360,7467392
2509,6,6,1,2412,-85,-89,4,e2:db:d1:d1:b0:4a,7467918,444,82,7467474,7467918
2510,6,6,1,2412,-85,-89,4,e2:db:d1:d1:b0:4b,7468413,408,87,7468005,7468413
2511,6,6,1,2412,-87,-89,2,e2:db:d1:d1:b0:4f,7469295,408,474,7468887,7469295
2512,6,12,1,2412,-81,-89,8,,7475276,32,5949,7475244,7475276
2513,6,12,1,2412,-81,-89,8,,7475483,32,175,7475451,7475483
2514,4,11,1,2412,-84,-89,5,4c:01:43:ec:a0:69,7476067,361,223,7475706,7476067
2515,4,11,1,2412,-82,-89,7,4c:01:43:ec:a0:63,7476441,322,52,7476119,7476441
2516,4,11,1,2412,-80,-89,9,48:dd:0c:90:e3:87,7477351,362,548,7476989,7477351
2517,4,11,1,2412,-79,-89,10,48:dd:0c:90:e3:85,7478061,382,328,7477679,7478061
2518,6,6,1,2412,-64,-89,25,52:86:8c:5f:93:1e,7482931,332,4538,7482599,7482931
2519,4,1,1,2412,-83,-89,6,3c:bd:c5:ee:96:6d,7485096,2512,-347,7482584,7485096
2520,6,6,1,2412,-89,-89,0,0a:a7:c0:a3:8d:73,7488448,408,2944,7488040,7488448
2521,6,6,1,2412,-89,-89,0,0a:a7:c0:a3:8d:75,7488889,408,33,7488481,7488889
2522,6,24,1,2412,-82,-89,7,,7507027,28,18110,7506999,7507027
2523,6,6,1,2412,-61,-89,28,32:86:8c:5f:93:1e,7508284,332,925,7507952,7508284
2524,6,6,1,2412,-87,-89,2,,7520193,44,11865,7520149,7520193
2525,6,6,1,2412,-84,-89,5,,7521428,44,1191,7521384,7521428
2526,6,24,1,2412,-82,-89,7,,7528424,28,6968,7528396,7528424
2527,4,1,1,2412,-66,-89,23,b0:e4:d5:32:ec:8a,7530048,1960,-336,7528088,7530048
2528,6,6,1,2412,-61,-89,28,10:86:8c:5f:93:1e,7533886,344,3494,7533542,7533886
2529,4,1,1,2412,-58,-89,31,94:a6:7e:c9:98:67,7537047,2464,697,7534583,7537047
2530,4,11,1,2412,-83,-89,6,4c:01:43:d7:f3:29,7540268,362,2859,7539906,7540268
2531,4,11,1,2412,-82,-89,7,4c:01:43:d7:f3:23,7540642,322,52,7540320,7540642
2532,4,11,1,2412,-83,-89,6,4c:01:43:d7:f3:26,7540977,387,-52,7540590,7540977
2533,6,24,1,2412,-82,-89,7,,7551381,28,10376,7551353,7551381
2534,4,1,1,2412,-83,-89,6,78:67:0e:38:6c:d3,7551900,2736,-2217,7549164,7551900
2535,4,11,1,2412,-73,-89,16,48:dd:0c:7d:86:27,7554660,362,2398,7554298,7554660
2536,4,11,1,2412,-73,-89,16,48:dd:0c:7d:86:25,7555369,382,327,7554987,7555369
2537,6,24,1,2412,-81,-89,8,,7556976,28,1579,7556948,7556976
2538,6,6,1,2412,-82,-89,7,40:b0:34:b7:01:d5,7557635,576,83,7557059,7557635
2539,7,26,1,2412,-87,-89,2,e2:db:d1:d1:b0:4a,7558299,68,596,7558231,7558299
2540,6,6,1,2412,-89,-89,0,e2:db:d1:d1:b0:4a,7558536,52,185,7558484,7558536
2541,6,6,1,2412,-60,-89,29,12:86:8c:5f:93:1e,7559486,332,618,7559154,7559486
2542,4,1,1,2412,-86,-89,3,00:26:62:eb:ea:74,7565001,968,4547,7564033,7565001
2543,6,6,1,2412,-88,-89,1,,7568572,44,3527,7568528,7568572
2544,6,6,1,2412,-87,-89,2,,7568965,44,349,7568921,7568965
2545,6,6,1,2412,-86,-89,3,,7569094,44,85,7569050,7569094
2546,4,1,1,2412,-83,-89,6,,7569493,304,95,7569189,7569493
2547,6,6,1,2412,-85,-89,4,e2:db:d1:d1:b0:4a,7570806,68,1245,7570738,7570806
2548,6,6,1,2412,-87,-89,2,,7571271,44,421,7571227,7571271
2549,6,6,1,2412,-87,-89,2,e2:db:d1:d1:b0:4a,7572087,68,748,7572019,7572087
2550,6,24,1,2412,-86,-89,3,,7573334,28,1219,7573306,7573334
2551,6,6,1,2412,-87,-89,2,,7575992,44,2614,7575948,7575992
2552,6,6,1,2412,-86,-89,3,,7576141,44,105,7576097,7576141
2553,4,11,1,2412,-72,-89,17,48:dd:0c:90:e3:83,7580125,323,3661,7579802,7580125
2554,4,11,1,2412,-78,-89,11,48:dd:0c:90:e3:85,7580460,382,-47,7580078,7580460
2555,6,6,1,2412,-60,-89,29,52:86:8c:5f:93:1e,7585085,332,4293,7584753,7585085
2556,6,6,1,2412,-87,-89,2,0a:a7:c0:a3:8d:70,7588726,464,3177,7588262,7588726
2557,6,24,1,2412,-82,-89,7,,7590920,28,2166,7590892,7590920
2558,6,6,1,2412,-88,-89,1,e2:db:d1:d1:b0:4a,7595377,68,4389,7595309,7595377
2559,6,6,1,2412,-87,-89,2,e2:db:d1:d1:b0:4a,7595622,52,193,7595570,7595622
2560,6,6,1,2412,-85,-89,4,,7599579,44,3913,7599535,7599579
2561,6,6,1,2412,-85,-89,4,,7599827,44,204,7599783,7599827
2562,6,6,1,2412,-86,-89,3,e2:db:d1:d1:b0:4a,7600844,52,965,7600792,7600844
2563,6,6,1,2412,-87,-89,2,,7601934,44,1046,7601890,7601934
2564,6,6,1,2412,-86,-89,3,e2:db:d1:d1:b0:4a,7602427,52,441,7602375,7602427
2565,6,6,1,2412,-87,-89,2,,7603003,44,532,7602959,7603003
2566,6,24,1,2412,-82,-89,7,,7603215,28,184,7603187,7603215
2567,6,24,1,2412,-86,-89,3,,7603567,28,324,7603539,7603567
2568,6,6,1,2412,-86,-89,3,e2:db:d1:d1:b0:4a,7605694,52,2075,7605642,7605694
2569,6,6,1,2412,-87,-89,2,e2:db:d1:d1:b0:4a,7606093,52,347,7606041,7606093
2570,6,6,1,2412,-86,-89,3,,7606399,44,262,7606355,7606399
2571,6,6,1,2412,-87,-89,2,,7608255,44,1812,7608211,7608255
2572,6,6,1,2412,-87,-89,2,,7608384,44,85,7608340,7608384
2573,6,6,1,2412,-87,-89,2,e2:db:d1:d1:b0:4a,7609842,52,1406,7609790,7609842
2574,6,6,1,2412,-87,-89,2,,7610199,44,313,7610155,7610199
2575,6,6,1,2412,-58,-89,31,32:86:8c:5f:93:1e,7610686,332,155,7610354,7610686
2576,6,6,1,2412,-86,-89,3,3c:bd:c5:ee:96:6d,7615499,68,4745,7615431,7615499
2577,6,6,1,2412,-86,-89,3,e2:db:d1:d1:b0:4a,7626444,52,10893,7626392,7626444
2578,6,6,1,2412,-76,-89,13,,7626750,44,262,7626706,7626750
2579,6,6,1,2412,-87,-89,2,,7627975,44,1181,7627931,7627975
2580,6,6,1,2412,-87,-89,2,e2:db:d1:d1:b0:4a,7628097,52,70,7628045,7628097
2581,7,28.8889,1,2412,-86,-89,3,e2:db:d1:d1:b0:4a,7628228,72,59,7628156,7628228
2582,6,6,1,2412,-86,-89,3,,7628374,44,102,7628330,7628374
2583,6,6,1,2412,-87,-89,2,,7629223,44,805,7629179,7629223
2584,6,24,1,2412,-87,-89,2,,7629583,28,332,7629555,7629583
2585,6,6,1,2412,-87,-89,2,,7629734,44,107,7629690,7629734
2586,4,1,1,2412,-65,-89,24,b0:e4:d5:32:ec:8a,7632447,1960,753,7630487,7632447
2587,6,6,1,2412,-60,-89,29,10:86:8c:5f:93:1e,7636286,344,3495,7635942,7636286
2588,4,1,1,2412,-58,-89,31,94:a6:7e:c9:98:67,7639428,2464,678,7636964,7639428
2589,4,11,1,2412,-83,-89,6,4c:01:43:d7:f3:26,7643377,387,3562,7642990,7643377
2590,4,11,1,2412,-86,-89,3,48:dd:0c:92:4b:e7,7645677,362,1938,7645315,7645677
2591,4,11,1,2412,-62,-89,27,48:dd:0c:92:4b:e5,7646387,382,328,7646005,7646387
2592,4,1,1,2412,-83,-89,6,78:67:0e:38:6c:d3,7654255,2736,5132,7651519,7654255
2593,4,11,1,2412,-75,-89,14,48:dd:0c:7d:86:27,7657013,362,2396,7656651,7657013
2594,4,11,1,2412,-73,-89,16,48:dd:0c:7d:86:23,7657388,323,52,7657065,7657388
2595,4,11,1,2412,-74,-89,15,48:dd:0c:7d:86:25,7657723,382,-47,7657341,7657723
2596,6,6,1,2412,-59,-89,30,12:86:8c:5f:93:1e,7661886,332,3831,7661554,7661886
2597,6,6,1,2412,-87,-89,2,e2:db:d1:d1:b0:4b,7673682,408,11388,7673274,7673682
2598,6,6,1,2412,-88,-89,1,e2:db:d1:d1:b0:4d,7674141,408,51,7673733,7674141
2599,6,6,1,2412,-88,-89,1,e2:db:d1:d1:b0:4f,7674581,408,32,7674173,7674581
2600,6,6,1,2412,-86,-89,3,,7675204,44,579,7675160,7675204
2601,4,11,1,2412,-81,-89,8,4c:01:43:ec:a0:69,7680865,361,5300,7680504,7680865
2602,4,11,1,2412,-83,-89,6,4c:01:43:ec:a0:63,7681238,322,51,7680916,7681238
2603,4,11,1,2412,-83,-89,6,4c:01:43:ec:a0:66,7681573,387,-52,7681186,7681573
2604,4,11,1,2412,-73,-89,16,48:dd:0c:90:e3:87,7682150,362,215,7681788,7682150
2605,4,11,1,2412,-73,-89,16,48:dd:0c:90:e3:83,7682525,323,52,7682202,7682525
2606,4,11,1,2412,-74,-89,15,48:dd:0c:90:e3:85,7682860,382,-47,7682478,7682860
2607,6,24,1,2412,-84,-89,5,,7683499,28,611,7683471,7683499
2608,4,1,1,2412,-90,-89,-1,40:ca:63:2d:74:be,7684205,1896,-1190,7682309,7684205
2609,6,6,1,2412,-86,-89,3,0a:a7:c0:a3:8d:70,7690202,464,5533,7689738,7690202
2610,6,6,1,2412,-88,-89,1,0a:a7:c0:a3:8d:71,7690700,408,90,7690292,7690700
2611,6,6,1,2412,-87,-89,2,0a:a7:c0:a3:8d:73,7691149,408,41,7690741,7691149
2612,4,1,1,2412,-90,-89,-1,,7691741,304,288,7691437,7691741
2613,4,1,1,2412,-81,-89,8,78:67:0e:c4:a8:42,7694334,2736,-143,7691598,7694334
2614,6,6,1,2412,-90,-89,-1,3c:bd:c5:ee:96:6d,7700981,52,6595,7700929,7700981
2615,6,6,1,2412,-90,-89,-1,3c:bd:c5:ee:96:6d,7702725,52,1692,7702673,7702725
2616,6,6,1,2412,-90,-89,-1,,7703233,44,464,7703189,7703233
2617,6,6,1,2412,-60,-89,29,32:86:8c:5f:93:1e,7713087,332,9522,7712755,7713087
2618,4,1,1,2412,-89,-89,0,ce:f4:11:65:3f:f8,7714807,2072,-352,7712735,7714807
2619,6,6,1,2412,-88,-89,1,3c:bd:c5:ee:96:6d,7721005,68,6130,7720937,7721005
2620,6,6,1,2412,-88,-89,1,,7727404,44,6355,7727360,7727404
2621,4,1,1,2412,-60,-89,29,94:a6:7e:c9:98:67,7741826,2464,11958,7739362,7741826
2622,4,11,1,2412,-85,-89,4,4c:01:43:d7:f3:29,7745216,362,3028,7744854,7745216
2623,4,11,1,2412,-86,-89,3,4c:01:43:d7:f3:23,7745591,322,53,7745269,7745591
2624,6,24,1,2412,-83,-89,6,,7750919,28,5300,7750891,7750919
2625,4,11,1,2412,-72,-89,17,48:dd:0c:7d:86:23,7759789,323,8547,7759466,7759789
2626,4,11,1,2412,-73,-89,16,48:dd:0c:7d:86:25,7760124,382,-47,7759742,7760124
2627,6,6,1,2412,-86,-89,3,40:b0:34:b7:01:d5,7762437,576,1737,7761861,7762437
2628,6,6,1,2412,-62,-89,27,12:86:8c:5f:93:1e,7764287,332,1518,7763955,7764287
2629,6,6,1,2412,-78,-89,11,,7767648,44,3317,7767604,7767648
2630,6,6,1,2412,-86,-89,3,e2:db:d1:d1:b0:4a,7775108,444,7016,7774664,7775108
2631,6,6,1,2412,-87,-89,2,e2:db:d1:d1:b0:4b,7775586,408,70,7775178,7775586
2632,6,6,1,2412,-86,-89,3,e2:db:d1:d1:b0:4d,7776035,408,41,7775627,7776035
2633,6,6,1,2412,-81,-89,8,e2:db:d1:d1:b0:4f,7776476,408,33,7776068,7776476
2634,4,11,1,2412,-77,-89,12,4c:01:43:ec:a0:69,7783264,361,6427,7782903,7783264
2635,4,11,1,2412,-79,-89,10,4c:01:43:ec:a0:63,7783637,322,51,7783315,7783637
2636,4,11,1,2412,-78,-89,11,4c:01:43:ec:a0:66,7783972,387,-52,7783585,7783972
2637,6,6,1,2412,-62,-89,27,52:86:8c:5f:93:1e,7789887,332,5583,7789555,7789887
2638,6,6,1,2412,-85,-89,4,,7796462,44,6531,7796418,7796462
2639,4,1,1,2412,-80,-89,9,78:67:0e:c4:a8:42,7796886,2736,-2312,7794150,7796886
2640,6,24,1,2412,-78,-89,11,,7799523,28,2609,7799495,7799523
2641,6,6,1,2412,-88,-89,1,,7806969,44,7402,7806925,7806969
2642,6,6,1,2412,-62,-89,27,32:86:8c:5f:93:1e,7815604,332,8303,7815272,7815604
2643,4,1,1,2412,-89,-89,0,ce:f4:11:65:3f:f8,7817207,2072,-469,7815135,7817207
2644,6,24,1,2412,-83,-89,6,,7831548,28,14313,7831520,7831548
2645,4,1,1,2412,-74,-89,15,b0:e4:d5:32:ec:8a,7837246,1960,3738,7835286,7837246
2646,6,6,1,2412,-61,-89,28,10:86:8c:5f:93:1e,7841088,344,3498,7840744,7841088
2647,4,11,1,2412,-60,-89,29,10:86:8c:5f:93:1e,7841631,347,196,7841284,7841631
2648,6,24,1,2412,-82,-89,7,,7844011,28,2352,7843983,7844011
2649,4,1,1,2412,-59,-89,30,94:a6:7e:c9:98:67,7844222,2464,-2253,7841758,7844222
2650,4,11,1,2412,-73,-89,16,48:dd:0c:7d:86:27,7861814,362,17230,7861452,7861814
2651,4,11,1,2412,-74,-89,15,48:dd:0c:7d:86:23,7862189,323,52,7861866,7862189
2652,4,11,1,2412,-74,-89,15,48:dd:0c:7d:86:25,7862524,382,-47,7862142,7862524
2653,6,6,1,2412,-61,-89,28,12:86:8c:5f:93:1e,7866688,332,3832,7866356,7866688
2654,4,1,1,2412,-89,-89,0,00:26:62:eb:ea:74,7872203,968,4547,7871235,7872203
2655,6,6,1,2412,-89,-89,0,e2:db:d1:d1:b0:4f,7878895,408,6284,7878487,7878895
2656,6,6,1,2412,-88,-89,1,,7879715,44,776,7879671,7879715
2657,6,6,1,2412,-86,-89,3,,7883616,44,3857,7883572,7883616
2658,6,6,1,2412,-87,-89,2,3c:bd:c5:ee:96:6d,7885094,68,1410,7885026,7885094
2659,4,11,1,2412,-80,-89,9,4c:01:43:ec:a0:69,7885662,361,207,7885301,7885662
2660,4,11,1,2412,-80,-89,9,4c:01:43:ec:a0:63,7886036,322,52,7885714,7886036
2661,4,11,1,2412,-80,-89,9,4c:01:43:ec:a0:66,7886371,387,-52,7885984,7886371
2662,4,11,1,2412,-81,-89,8,48:dd:0c:90:e3:87,7886950,362,217,7886588,7886950
2663,4,11,1,2412,-79,-89,10,48:dd:0c:90:e3:85,7887660,382,328,7887278,7887660
2664,4,1,1,2412,-69,-89,20,3c:bd:c5:ee:96:6d,7895085,1056,6369,7894029,7895085
2665,4,11,1,2412,-83,-89,6,,7907854,107,12662,7907747,7907854
2666,6,24,1,2412,-78,-89,11,78:67:0e:c4:a8:42,7907967,32,81,7907935,7907967
2667,6,24,1,2412,-80,-89,9,,7910928,28,2933,7910900,7910928
2668,6,6,1,2412,-61,-89,28,32:86:8c:5f:93:1e,7917888,332,6628,7917556,7917888
2669,6,6,1,2412,-85,-89,4,,7920580,44,2648,7920536,7920580
2670,6,24,1,2412,-79,-89,10,,7924622,28,4014,7924594,7924622
2671,4,1,1,2412,-91,-89,-2,ac:67:84:84:8a:07,7929881,416,4843,7929465,7929881
2672,4,1,1,2412,-74,-89,15,b0:e4:d5:32:ec:8a,7939645,1960,7804,7937685,7939645
2673,6,6,1,2412,-64,-89,25,10:86:8c:5f:93:1e,7943488,344,3499,7943144,7943488
2674,4,1,1,2412,-65,-89,24,94:a6:7e:c9:98:67,7948831,2464,2879,7946367,7948831
2675,4,1,1,2412,-79,-89,10,78:67:0e:38:6c:d3,7961455,2736,9888,7958719,7961455
2676,4,11,1,2412,-78,-89,11,48:dd:0c:7d:86:27,7964214,362,2397,7963852,7964214
2677,4,11,1,2412,-78,-89,11,48:dd:0c:7d:86:23,7964588,323,51,7964265,7964588
2678,4,11,1,2412,-79,-89,10,48:dd:0c:7d:86:25,7964924,382,-46,7964542,7964924
2679,6,6,1,2412,-65,-89,24,12:86:8c:5f:93:1e,7969096,332,3840,7968764,7969096
2680,6,6,1,2412,-87,-89,2,e2:db:d1:d1:b0:4a,7979899,444,10359,7979455,7979899
2681,6,6,1,2412,-88,-89,1,e2:db:d1:d1:b0:4d,7980816,408,509,7980408,7980816
2682,6,6,1,2412,-86,-89,3,,7982712,44,1852,7982668,7982712
2683,6,6,1,2412,-88,-89,1,e2:db:d1:d1:b0:4a,7982888,52,124,7982836,7982888
2684,6,6,1,2412,-89,-89,0,,7985913,44,2981,7985869,7985913
2685,4,11,1,2412,-85,-89,4,4c:01:43:ec:a0:69,7988061,361,1787,7987700,7988061
2686,4,11,1,2412,-87,-89,2,4c:01:43:ec:a0:66,7988770,387,322,7988383,7988770
2687,4,11,1,2412,-77,-89,12,48:dd:0c:90:e3:87,7989350,362,218,7988988,7989350
2688,4,11,1,2412,-77,-89,12,48:dd:0c:90:e3:83,7989724,323,51,7989401,7989724
2689,4,11,1,2412,-77,-89,12,48:dd:0c:90:e3:85,7990059,382,-47,7989677,7990059
2690,6,6,1,2412,-89,-89,0,,7990513,44,410,7990469,7990513
2691,6,24,1,2412,-81,-89,8,,7990925,28,384,7990897,7990925
2692,6,6,1,2412,-90,-89,-1,,7993549,44,2580,7993505,7993549
2693,6,6,1,2412,-86,-89,3,0a:a7:c0:a3:8d:75,7998790,408,4833,7998382,7998790
2694,6,6,1,2412,-88,-89,1,,8001009,44,2175,8000965,8001009
2695,6,6,1,2412,-87,-89,2,e2:db:d1:d1:b0:4a,8001158,52,97,8001106,8001158
2696,4,1,1,2412,-84,-89,5,78:67:0e:c4:a8:42,8004308,1184,1966,8003124,8004308
2697,4,1,1,2412,-83,-89,6,78:67:0e:c4:a8:42,8005503,848,347,8004655,8005503
2698,4,11,1,2412,-85,-89,4,,8006436,107,826,8006329,8006436
2699,6,24,1,2412,-84,-89,5,78:67:0e:c4:a8:42,8006553,32,85,8006521,8006553
2700,6,6,1,2412,-89,-89,0,e2:db:d1:d1:b0:4a,8012098,52,5493,8012046,8012098
2701,6,6,1,2412,-88,-89,1,e2:db:d1:d1:b0:4a,8015848,52,3698,8015796,8015848
2702,6,6,1,2412,-62,-89,27,32:86:8c:5f:93:1e,8020289,332,4109,8019957,8020289
2703,6,6,1,2412,-64,-89,25,b4:e6:2d:b4:ff:71,8026059,64,5706,8025995,8026059
2704,6,6,1,2412,-88,-89,1,e2:db:d1:d1:b0:4a,8028184,52,2073,8028132,8028184
2705,6,6,1,2412,-86,-89,3,e2:db:d1:d1:b0:4a,8029690,52,1454,8029638,8029690
2706,6,6,1,2412,-86,-89,3,e2:db:d1:d1:b0:4a,8032403,52,2661,8032351,8032403
2707,4,5.5,1,2412,-86,-89,3,,8035919,213,3303,8035706,8035919
2708,6,24,1,2412,-83,-89,6,,8036578,28,631,8036550,8036578
2709,6,6,1,2412,-87,-89,2,e2:db:d1:d1:b0:4a,8036620,52,-10,8036568,8036620
2710,6,6,1,2412,-86,-89,3,e2:db:d1:d1:b0:4a,8037644,52,972,8037592,8037644
2711,6,6,1,2412,-85,-89,4,,8037967,44,279,8037923,8037967
2712,6,24,1,2412,-86,-89,3,,8038733,28,738,8038705,8038733
2713,6,6,1,2412,-86,-89,3,e2:db:d1:d1:b0:4a,8038869,68,68,8038801,8038869
2714,6,24,1,2412,-86,-89,3,,8039629,28,732,8039601,8039629
2715,6,6,1,2412,-86,-89,3,,8039757,44,84,8039713,8039757
2716,4,1,1,2412,-74,-89,15,b0:e4:d5:32:ec:8a,8042044,1960,327,8040084,8042044
2717,6,12,1,2412,-87,-89,2,,8049779,32,7703,8049747,8049779
2718,6,6,1,2412,-85,-89,4,,8057584,44,7761,8057540,8057584
2719,4,1,1,2412,-79,-89,10,78:67:0e:38:6c:d3,8063856,2736,3536,8061120,8063856
2720,4,11,1,2412,-72,-89,17,48:dd:0c:7d:86:27,8066615,362,2397,8066253,8066615
2721,4,11,1,2412,-72,-89,17,48:dd:0c:7d:86:23,8066989,323,51,8066666,8066989
2722,4,11,1,2412,-71,-89,18,48:dd:0c:7d:86:25,8067324,382,-47,8066942,8067324
2723,6,6,1,2412,-87,-89,2,40:b0:34:b7:01:d5,8069640,576,1740,8069064,8069640
2724,6,24,1,2412,-84,-89,5,,8070928,28,1260,8070900,8070928
2725,4,11,1,2412,-79,-89,10,48:dd:0c:90:e3:83,8071154,254,-28,8070900,8071154
2726,6,6,1,2412,-64,-89,25,12:86:8c:5f:93:1e,8071489,332,3,8071157,8071489
2727,4,1,1,2412,-88,-89,1,70:3a:cb:63:35:b2,8072014,2216,-1691,8069798,8072014
2728,6,6,1,2412,-86,-89,3,e2:db:d1:d1:b0:4a,8082315,444,9857,8081871,8082315
2729,6,6,1,2412,-85,-89,4,e2:db:d1:d1:b0:4b,8082800,408,77,8082392,8082800
2730,6,6,1,2412,-86,-89,3,e2:db:d1:d1:b0:4d,8083260,408,52,8082852,8083260
2731,6,6,1,2412,-85,-89,4,e2:db:d1:d1:b0:4f,8083691,408,23,8083283,8083691
2732,4,1,1,2412,-88,-89,1,00:26:62:eb:ea:74,8084238,968,-421,8083270,8084238
2733,4,11,1,2412,-79,-89,10,4c:01:43:ec:a0:66,8091168,387,6543,8090781,8091168
2734,4,1,1,2412,-89,-89,0,10:7b:44:eb:35:60,8095963,384,4411,8095579,8095963
2735,6,6,1,2412,-63,-89,26,52:86:8c:5f:93:1e,8097090,332,795,8096758,8097090
2736,4,1,1,2412,-83,-89,6,78:67:0e:c4:a8:42,8103934,2736,4108,8101198,8103934
2737,6,6,1,2412,-84,-89,5,,8107239,44,3261,8107195,8107239
2738,6,24,1,2412,-80,-89,9,,8117828,28,10561,8117800,8117828
2739,6,24,1,2412,-81,-89,8,,8119109,28,1253,8119081,8119109
2740,6,6,1,2412,-83,-89,6,3c:bd:c5:ee:96:6d,8122407,68,3230,8122339,8122407
2741,6,6,1,2412,-68,-89,21,32:86:8c:5f:93:1e,8122689,332,-50,8122357,8122689
2742,6,24,1,2412,-84,-89,5,3c:bd:c5:ee:96:6d,8135588,28,12871,8135560,8135588
2743,6,6,1,2412,-85,-89,4,,8135867,44,235,8135823,8135867
2744,4,1,1,2412,-91,-89,-2,ac:67:84:84:8a:07,8136103,416,-180,8135687,8136103
2745,6,6,1,2412,-84,-89,5,3c:bd:c5:ee:96:6d,8137318,68,1147,8137250,8137318
2746,4,1,1,2412,-57,-89,32,94:a6:7e:c9:98:67,8151434,2464,11652,8148970,8151434
2747,6,6,1,2412,-79,-89,10,,8153851,44,2373,8153807,8153851
2748,4,11,1,2412,-84,-89,5,4c:01:43:d7:f3:29,8154665,362,452,8154303,8154665
2749,4,11,1,2412,-84,-89,5,4c:01:43:d7:f3:23,8155040,322,53,8154718,8155040
2750,4,11,1,2412,-84,-89,5,4c:01:43:d7:f3:26,8155374,387,-53,8154987,8155374
2751,4,11,1,2412,-82,-89,7,48:dd:0c:92:4b:e7,8157676,362,1940,8157314,8157676
2752,4,11,1,2412,-83,-89,6,48:dd:0c:92:4b:e5,8158386,382,328,8158004,8158386
2753,4,1,1,2412,-86,-89,3,78:67:0e:38:6c:d3,8166256,2736,5134,8163520,8166256
2754,4,11,1,2412,-74,-89,15,48:dd:0c:7d:86:27,8169014,362,2396,8168652,8169014
2755,4,11,1,2412,-75,-89,14,48:dd:0c:7d:86:23,8169389,323,52,8169066,8169389
2756,4,11,1,2412,-73,-89,16,48:dd:0c:7d:86:25,8169724,382,-47,8169342,8169724
2757,6,6,1,2412,-83,-89,6,40:b0:34:b7:01:d5,8172041,576,1741,8171465,8172041
2758,6,6,1,2412,-69,-89,20,12:86:8c:5f:93:1e,8173890,332,1517,8173558,8173890
2759,4,1,1,2412,-86,-89,3,00:26:62:eb:ea:74,8184312,968,9454,8183344,8184312
2760,6,6,1,2412,-86,-89,3,e2:db:d1:d1:b0:4a,8186930,632,1986,8186298,8186930
2761,6,6,1,2412,-87,-89,2,e2:db:d1:d1:b0:4a,8187595,656,9,8186939,8187595
2762,6,6,1,2412,-87,-89,2,,8188610,44,971,8188566,8188610
2763,4,11,1,2412,-85,-89,4,4c:01:43:ec:a0:69,8192859,361,3888,8192498,8192859
2764,4,11,1,2412,-84,-89,5,4c:01:43:ec:a0:63,8193233,322,52,8192911,8193233
2765,4,11,1,2412,-83,-89,6,4c:01:43:ec:a0:66,8193567,387,-53,8193180,8193567
2766,4,11,1,2412,-78,-89,11,48:dd:0c:90:e3:87,8194149,362,220,8193787,8194149
2767,4,11,1,2412,-78,-89,11,48:dd:0c:90:e3:83,8194524,323,52,8194201,8194524
2768,4,11,1,2412,-77,-89,12,48:dd:0c:90:e3:85,8194859,382,-47,8194477,8194859
2769,4,1,1,2412,-90,-89,-1,40:ca:63:2d:74:be,8196261,1896,-494,8194365,8196261
2770,4,1,1,2412,-81,-89,8,3c:bd:c5:ee:96:6d,8202300,976,5063,8201324,8202300
2771,6,6,1,2412,-85,-89,4,0a:a7:c0:a3:8d:70,8203475,464,711,8203011,8203475
2772,6,6,1,2412,-87,-89,2,0a:a7:c0:a3:8d:71,8203990,408,107,8203582,8203990
2773,6,6,1,2412,-87,-89,2,0a:a7:c0:a3:8d:73,8204421,408,23,8204013,8204421
2774,6,6,1,2412,-86,-89,3,0a:a7:c0:a3:8d:75,8204863,408,34,8204455,8204863
2775,4,1,1,2412,-85,-89,4,78:67:0e:c4:a8:42,8206334,2736,-1265,8203598,8206334
2776,4,1,1,2412,-78,-89,11,,8223777,304,17139,8223473,8223777
2777,6,6,1,2412,-67,-89,22,32:86:8c:5f:93:1e,8225089,332,980,8224757,8225089
2778,6,24,1,2412,-82,-89,7,,8230926,28,5809,8230898,8230926
2779,6,6,1,2412,-86,-89,3,,8243972,44,13002,8243928,8243972
2780,4,1,1,2412,-69,-89,20,b0:e4:d5:32:ec:8a,8246843,1960,911,8244883,8246843
2781,6,6,1,2412,-65,-89,24,10:86:8c:5f:93:1e,8250691,344,3504,8250347,8250691
2782,4,1,1,2412,-82,-89,7,bc:98:df:ff:0f:8b,8256394,976,4727,8255418,8256394
2783,4,1,1,2412,-83,-89,6,bc:98:df:ff:0f:8b,8257380,976,10,8256404,8257380
2784,4,1,1,2412,-83,-89,6,bc:98:df:ff:0f:8b,8258366,976,10,8257390,8258366
2785,4,11,1,2412,-79,-89,10,48:dd:0c:7d:86:27,8269021,362,10293,8268659,8269021
2786,4,11,1,2412,-78,-89,11,48:dd:0c:7d:86:23,8269396,323,52,8269073,8269396
2787,4,11,1,2412,-80,-89,9,48:dd:0c:7d:86:25,8269731,382,-47,8269349,8269731
2788,4,11,1,2412,-74,-89,15,48:dd:0c:90:e3:85,8275469,377,5361,8275092,8275469
2789,4,1,1,2412,-80,-89,9,,8276754,304,981,8276450,8276754
2790,4,11,1,2412,-81,-89,8,,8277125,107,264,8277018,8277125
2791,4,1,1,2412,-83,-89,6,78:67:0e:c4:a8:42,8280828,352,3351,8280476,8280828
2792,6,6,1,2412,-84,-89,5,e2:db:d1:d1:b0:4f,8288491,408,7255,8288083,8288491
2793,6,6,1,2412,-85,-89,4,e2:db:d1:d1:b0:4a,8289727,224,1012,8289503,8289727
2794,6,6,1,2412,-85,-89,4,e2:db:d1:d1:b0:4a,8289984,248,9,8289736,8289984
2795,6,6,1,2412,-85,-89,4,,8290411,44,383,8290367,8290411
2796,6,6,1,2412,-86,-89,3,3c:bd:c5:ee:96:6d,8290856,68,377,8290788,8290856
2797,4,11,1,2412,-82,-89,7,4c:01:43:ec:a0:63,8295632,322,4454,8295310,8295632
2798,4,11,1,2412,-85,-89,4,4c:01:43:ec:a0:66,8295966,387,-53,8295579,8295966
2799,4,11,1,2412,-76,-89,13,48:dd:0c:90:e3:87,8296549,362,221,8296187,8296549
2800,4,11,1,2412,-75,-89,14,48:dd:0c:90:e3:83,8296923,323,51,8296600,8296923
2801,4,11,1,2412,-75,-89,14,48:dd:0c:90:e3:85,8297259,382,-46,8296877,8297259
2802,6,6,1,2412,-88,-89,1,3c:bd:c5:ee:96:6d,8298753,68,1426,8298685,8298753
2803,4,1,1,2412,-87,-89,2,,8299889,304,832,8299585,8299889
2804,6,6,1,2412,-86,-89,3,0a:a7:c0:a3:8d:70,8304727,464,4374,8304263,8304727
2805,6,6,1,2412,-86,-89,3,0a:a7:c0:a3:8d:71,8305233,408,98,8304825,8305233
2806,6,6,1,2412,-86,-89,3,0a:a7:c0:a3:8d:75,8306330,408,689,8305922,8306330
2807,4,1,1,2412,-83,-89,6,78:67:0e:c4:a8:42,8308734,2736,-332,8305998,8308734
2808,6,24,1,2412,-81,-89,8,,8311369,28,2607,8311341,8311369
2809,6,6,1,2412,-88,-89,1,0a:a7:c0:a3:8d:70,8312095,608,118,8311487,8312095
2810,6,6,1,2412,-88,-89,1,0a:a7:c0:a3:8d:70,8319322,608,6619,8318714,8319322
2811,6,24,1,2412,-82,-89,7,,8323920,28,4570,8323892,8323920
2812,6,24,1,2412,-83,-89,6,,8325565,28,1617,8325537,8325565
2813,6,6,1,2412,-68,-89,21,32:86:8c:5f:93:1e,8327491,332,1594,8327159,8327491
2814,6,6,1,2412,-83,-89,6,e2:db:d1:d1:b0:4a,8331436,52,3893,8331384,8331436
2815,6,6,1,2412,-84,-89,5,,8336200,44,4720,8336156,8336200
2816,6,24,1,2412,-83,-89,6,,8336373,28,145,8336345,8336373
2817,6,6,1,2412,-83,-89,6,e2:db:d1:d1:b0:4a,8336681,68,240,8336613,8336681
2818,6,24,1,2412,-84,-89,5,,8337037,28,328,8337009,8337037
2819,6,6,1,2412,-85,-89,4,e2:db:d1:d1:b0:4a,8337361,68,256,8337293,8337361
2820,6,6,1,2412,-84,-89,5,,8340536,44,3131,8340492,8340536
2821,6,6,1,2412,-82,-89,7,,8342250,44,1670,8342206,8342250
2822,6,24,1,2412,-83,-89,6,,8342378,28,100,8342350,8342378
2823,6,6,1,2412,-84,-89,5,,8342518,44,96,8342474,8342518
2824,6,24,1,2412,-82,-89,7,,8343180,28,634,8343152,8343180
2825,6,6,1,2412,-85,-89,4,,8343300,44,76,8343256,8343300
2826,6,6,1,2412,-85,-89,4,,8348309,44,4965,8348265,8348309
2827,4,1,1,2412,-60,-89,29,94:a6:7e:c9:98:67,8356192,2464,5419,8353728,8356192
2828,6,6,1,2412,-82,-89,7,e2:db:d1:d1:b0:4a,8359074,52,2830,8359022,8359074
2829,4,11,1,2412,-73,-89,16,4c:01:43:d7:f3:29,8359464,362,28,8359102,8359464
2830,4,11,1,2412,-83,-89,6,4c:01:43:d7:f3:23,8359839,322,53,8359517,8359839
2831,4,11,1,2412,-81,-89,8,4c:01:43:d7:f3:26,8360173,387,-53,8359786,8360173
2832,6,24,1,2412,-84,-89,5,,8361708,28,1507,8361680,8361708
2833,6,6,1,2412,-83,-89,6,e2:db:d1:d1:b0:4a,8362197,68,421,8362129,8362197
2834,6,6,1,2412,-83,-89,6,,8366204,44,3963,8366160,8366204
2835,6,6,1,2412,-82,-89,7,,8369477,44,3229,8369433,8369477
2836,6,6,1,2412,-83,-89,6,e2:db:d1:d1:b0:4a,8370053,52,524,8370001,8370053
2837,4,1,1,2412,-81,-89,8,78:67:0e:38:6c:d3,8371056,2736,-1733,8368320,8371056
2838,6,6,1,2412,-83,-89,6,,8374116,44,3016,8374072,8374116
2839,6,6,1,2412,-83,-89,6,,8375041,44,881,8374997,8375041
2840,6,6,1,2412,-84,-89,5,,8376127,44,1042,8376083,8376127
2841,6,6,1,2412,-82,-89,7,40:b0:34:b7:01:d5,8376844,576,141,8376268,8376844
2842,6,6,1,2412,-83,-89,6,e2:db:d1:d1:b0:4a,8377583,68,671,8377515,8377583
2843,6,6,1,2412,-66,-89,23,12:86:8c:5f:93:1e,8378690,332,775,8378358,8378690
2844,6,6,1,2412,-83,-89,6,,8382963,44,4229,8382919,8382963
2845,6,24,1,2412,-83,-89,6,,8383091,28,100,8383063,8383091
2846,6,24,1,2412,-83,-89,6,,8383915,28,796,8383887,8383915
2847,6,6,1,2412,-84,-89,5,,8384031,44,72,8383987,8384031
2848,4,1,1,2412,-87,-89,2,00:26:62:eb:ea:74,8384206,968,-793,8383238,8384206
2849,6,6,1,2412,-83,-89,6,,8385611,44,1361,8385567,8385611
2850,6,6,1,2412,-84,-89,5,e2:db:d1:d1:b0:4a,8391330,632,5087,8390698,8391330
2851,6,6,1,2412,-83,-89,6,e2:db:d1:d1:b0:4a,8391995,656,9,8391339,8391995
2852,6,6,1,2412,-88,-89,1,,8393345,44,1306,8393301,8393345
2853,6,6,1,2412,-87,-89,2,3c:bd:c5:ee:96:6d,8394015,68,602,8393947,8394015
2854,6,24,1,2412,-83,-89,6,,8394767,28,724,8394739,8394767
2855,6,24,1,2412,-80,-89,9,,8397913,28,3118,8397885,8397913
2856,6,6,1,2412,-90,-89,-1,3c:bd:c5:ee:96:6d,8398498,68,517,8398430,8398498
2857,4,11,1,2412,-76,-89,13,48:dd:0c:90:e3:87,8398948,362,88,8398586,8398948
2858,4,11,1,2412,-75,-89,14,48:dd:0c:90:e3:83,8399323,323,52,8399000,8399323
2859,4,11,1,2412,-74,-89,15,48:dd:0c:90:e3:85,8399658,382,-47,8399276,8399658
2860,6,6,1,2412,-82,-89,7,,8401545,44,1843,8401501,8401545
2861,6,6,1,2412,-84,-89,5,,8403118,44,1529,8403074,8403118
2862,6,6,1,2412,-83,-89,6,e2:db:d1:d1:b0:4a,8403320,52,150,8403268,8403320
2863,6,6,1,2412,-66,-89,23,52:86:8c:5f:93:1e,8404291,332,639,8403959,8404291
2864,6,6,1,2412,-84,-89,5,,8408490,44,4155,8408446,8408490
2865,6,6,1,2412,-82,-89,7,,8408679,44,145,8408635,8408679
2866,6,6,1,2412,-84,-89,5,,8409065,44,342,8409021,8409065
2867,4,1,1,2412,-83,-89,6,78:67:0e:c4:a8:42,8411133,2736,-668,8408397,8411133
2868,6,24,1,2412,-80,-89,9,,8440125,28,28964,8440097,8440125
2869,4,1,1,2412,-83,-89,6,78:67:0e:c4:a8:42,8441771,352,1294,8441419,8441771
2870,4,11,1,2412,-84,-89,5,,8443540,107,1662,8443433,8443540
2871,6,24,1,2412,-79,-89,10,78:67:0e:c4:a8:42,8443653,32,81,8443621,8443653
2872,4,1,1,2412,-61,-89,28,94:a6:7e:c9:98:67,8458626,2464,12509,8456162,8458626
2873,4,11,1,2412,-82,-89,7,4c:01:43:d7:f3:23,8462264,322,3316,8461942,8462264
2874,4,11,1,2412,-84,-89,5,4c:01:43:d7:f3:26,8462599,387,-52,8462212,8462599
2875,6,6,1,2412,-88,-89,1,,8466191,44,3548,8466147,8466191
2876,4,1,1,2412,-81,-89,8,78:67:0e:38:6c:d3,8473456,2736,4529,8470720,8473456
2877,4,11,1,2412,-76,-89,13,48:dd:0c:7d:86:27,8476215,362,2397,8475853,8476215
2878,4,11,1,2412,-75,-89,14,48:dd:0c:7d:86:23,8476589,323,51,8476266,8476589
2879,4,11,1,2412,-74,-89,15,48:dd:0c:7d:86:25,8476925,382,-46,8476543,8476925
2880,6,6,1,2412,-62,-89,27,12:86:8c:5f:93:1e,8481092,332,3835,8480760,8481092
2881,4,1,1,2412,-85,-89,4,00:26:62:eb:ea:74,8486606,968,4546,8485638,8486606
2882,6,6,1,2412,-86,-89,3,e2:db:d1:d1:b0:4f,8493267,408,6253,8492859,8493267
2883,6,6,1,2412,-86,-89,3,,8493880,44,569,8493836,8493880
2884,4,11,1,2412,-74,-89,15,48:dd:0c:90:e3:87,8501348,362,7106,8500986,8501348
2885,4,11,1,2412,-74,-89,15,48:dd:0c:90:e3:83,8501723,323,52,8501400,8501723
2886,6,6,1,2412,-62,-89,27,52:86:8c:5f:93:1e,8506691,332,4636,8506359,8506691
2887,6,6,1,2412,-86,-89,3,0a:a7:c0:a3:8d:70,8509564,464,2409,8509100,8509564
2888,6,6,1,2412,-86,-89,3,0a:a7:c0:a3:8d:71,8510061,408,89,8509653,8510061
2889,6,6,1,2412,-86,-89,3,0a:a7:c0:a3:8d:73,8510502,408,33,8510094,8510502
2890,6,6,1,2412,-85,-89,4,0a:a7:c0:a3:8d:75,8510943,408,33,8510535,8510943
2891,4,1,1,2412,-83,-89,6,78:67:0e:c4:a8:42,8513533,2736,-146,8510797,8513533
2892,6,12,1,2412,-86,-89,3,,8526406,32,12841,8526374,8526406
2893,6,12,1,2412,-84,-89,5,,8527926,32,1488,8527894,8527926
2894,6,6,1,2412,-61,-89,28,32:86:8c:5f:93:1e,8532291,332,4033,8531959,8532291
2895,6,24,1,2412,-79,-89,10,,8533048,28,729,8533020,8533048
2896,6,24,1,2412,-87,-89,2,,8550937,28,17861,8550909,8550937
2897,4,1,1,2412,-76,-89,13,b0:e4:d5:32:ec:8a,8554040,1960,1143,8552080,8554040
2898,4,1,1,2412,-62,-89,27,94:a6:7e:c9:98:67,8561032,2464,4528,8558568,8561032
2899,4,1,1,2412,-83,-89,6,78:67:0e:c4:a8:42,8563647,352,2263,8563295,8563647
2900,4,11,1,2412,-87,-89,2,4c:01:43:d7:f3:29,8564263,362,254,8563901,8564263
2901,4,1,1,2412,-88,-89,1,78:67:0e:38:6c:d3,8575857,2736,8858,8573121,8575857
2902,4,11,1,2412,-76,-89,13,48:dd:0c:7d:86:23,8578990,323,2810,8578667,8578990
2903,4,11,1,2412,-76,-89,13,48:dd:0c:7d:86:25,8579326,382,-46,8578944,8579326
2904,6,6,1,2412,-90,-89,-1,40:b0:34:b7:01:d5,8581646,576,1744,8581070,8581646
2905,6,6,1,2412,-63,-89,26,12:86:8c:5f:93:1e,8583516,332,1538,8583184,8583516
2906,4,1,1,2412,-89,-89,0,70:3a:cb:63:35:b2,8584040,2216,-1692,8581824,8584040
2907,4,11,1,2412,-83,-89,6,4c:01:43:ec:a0:66,8603163,387,18736,8602776,8603163
2908,4,11,1,2412,-77,-89,12,48:dd:0c:90:e3:87,8603748,362,223,8603386,8603748
2909,4,11,1,2412,-77,-89,12,48:dd:0c:90:e3:83,8604123,323,52,8603800,8604123
2910,4,11,1,2412,-75,-89,14,48:dd:0c:90:e3:85,8604458,382,-47,8604076,8604458
2911,6,6,1,2412,-65,-89,24,52:86:8c:5f:93:1e,8609092,332,4302,8608760,8609092
2912,6,6,1,2412,-86,-89,3,,8614134,44,4998,8614090,8614134
2913,4,1,1,2412,-82,-89,7,78:67:0e:c4:a8:42,8615933,2736,-937,8613197,8615933
2914,4,1,1,2412,-89,-89,0,04:a2:22:bf:24:52,8620048,2512,1603,8617536,8620048
2915,4,1,1,2412,-89,-89,0,ac:67:84:84:8a:07,8623570,448,3074,8623122,8623570
2916,4,1,1,2412,-93,-89,-4,10:7b:44:eb:35:60,8624076,384,122,8623692,8624076
2917,4,1,1,2412,-91,-89,-2,ac:67:84:84:8a:07,8624474,448,-50,8624026,8624474
2918,6,24,1,2412,-84,-89,5,,8630935,28,6433,8630907,8630935
2919,4,1,1,2412,-90,-89,-1,ce:f4:11:65:3f:f8,8636405,2072,3398,8634333,8636405
2920,6,24,1,2412,-83,-89,6,,8644304,28,7871,8644276,8644304
2921,6,24,1,2412,-80,-89,9,,8648255,28,3923,8648227,8648255
2922,6,6,1,2412,-66,-89,23,10:86:8c:5f:93:1e,8660292,344,11693,8659948,8660292
2923,4,1,1,2412,-64,-89,25,94:a6:7e:c9:98:67,8662765,2464,9,8660301,8662765
2924,6,24,1,2412,-82,-89,7,,8668611,28,5818,8668583,8668611
2925,6,24,1,2412,-82,-89,7,,8669233,28,594,8669205,8669233
2926,4,11,1,2412,-78,-89,11,48:dd:0c:7d:86:27,8681016,362,11421,8680654,8681016
2927,4,11,1,2412,-78,-89,11,48:dd:0c:7d:86:23,8681390,323,51,8681067,8681390
2928,4,11,1,2412,-79,-89,10,48:dd:0c:7d:86:25,8681725,382,-47,8681343,8681725
2929,6,6,1,2412,-87,-89,2,40:b0:34:b7:01:d5,8684047,576,1746,8683471,8684047
2930,6,6,1,2412,-67,-89,22,12:86:8c:5f:93:1e,8685893,332,1514,8685561,8685893
2931,6,6,1,2412,-87,-89,2,e2:db:d1:d1:b0:4b,8697398,408,11097,8696990,8697398
2932,6,6,1,2412,-86,-89,3,e2:db:d1:d1:b0:4d,8697839,408,33,8697431,8697839
2933,6,6,1,2412,-85,-89,4,e2:db:d1:d1:b0:4f,8698297,408,50,8697889,8698297
2934,4,11,1,2412,-83,-89,6,4c:01:43:ec:a0:69,8704853,361,6195,8704492,8704853
2935,4,11,1,2412,-82,-89,7,4c:01:43:ec:a0:63,8705227,322,52,8704905,8705227
2936,4,11,1,2412,-83,-89,6,4c:01:43:ec:a0:66,8705561,387,-53,8705174,8705561
2937,4,11,1,2412,-83,-89,6,48:dd:0c:90:e3:87,8706148,362,225,8705786,8706148
2938,4,11,1,2412,-84,-89,5,48:dd:0c:90:e3:83,8706522,323,51,8706199,8706522
2939,4,11,1,2412,-85,-89,4,48:dd:0c:90:e3:85,8706858,382,-46,8706476,8706858
2940,6,24,1,2412,-80,-89,9,,8710933,28,4047,8710905,8710933
2941,6,6,1,2412,-66,-89,23,52:86:8c:5f:93:1e,8711494,332,229,8711162,8711494
2942,6,6,1,2412,-89,-89,0,,8717566,44,6028,8717522,8717566
2943,6,24,1,2412,-82,-89,7,,8723529,28,5935,8723501,8723529
2944,6,6,1,2412,-86,-89,3,0a:a7:c0:a3:8d:70,8725917,308,2080,8725609,8725917
2945,6,6,1,2412,-67,-89,22,32:86:8c:5f:93:1e,8737093,332,10844,8736761,8737093
2946,6,6,1,2412,-88,-89,1,,8739389,44,2252,8739345,8739389
2947,6,6,1,2412,-87,-89,2,,8740386,44,953,8740342,8740386
2948,6,6,1,2412,-88,-89,1,,8748465,44,8035,8748421,8748465
2949,6,6,1,2412,-87,-89,2,3c:bd:c5:ee:96:6d,8749766,68,1233,8749698,8749766
2950,6,6,1,2412,-87,-89,2,,8750800,44,990,8750756,8750800
2951,6,24,1,2412,-86,-89,3,,8750933,28,105,8750905,8750933
2952,6,6,1,2412,-86,-89,3,e2:db:d1:d1:b0:4a,8751321,68,320,8751253,8751321
2953,6,6,1,2412,-88,-89,1,e2:db:d1:d1:b0:4a,8751467,52,94,8751415,8751467
2954,4,1,1,2412,-73,-89,16,b0:e4:d5:32:ec:8a,8761290,1960,7863,8759330,8761290
2955,4,1,1,2412,-60,-89,29,94:a6:7e:c9:98:67,8765538,2464,1784,8763074,8765538
2956,4,11,1,2412,-84,-89,5,4c:01:43:d7:f3:29,8769062,362,3162,8768700,8769062
2957,4,11,1,2412,-84,-89,5,4c:01:43:d7:f3:26,8769772,387,323,8769385,8769772
2958,6,6,1,2412,-84,-89,5,,8772984,44,3168,8772940,8772984
2959,6,6,1,2412,-84,-89,5,,8773579,44,551,8773535,8773579
2960,6,6,1,2412,-85,-89,4,,8774626,44,1003,8774582,8774626
2961,4,1,1,2412,-90,-89,-1,ac:67:84:84:8a:07,8775841,416,799,8775425,8775841
2962,4,1,1,2412,-84,-89,5,78:67:0e:38:6c:d3,8780657,2736,2080,8777921,8780657
2963,4,11,1,2412,-76,-89,13,48:dd:0c:7d:86:27,8783416,362,2397,8783054,8783416
2964,4,11,1,2412,-75,-89,14,48:dd:0c:7d:86:23,8783791,323,52,8783468,8783791
2965,4,11,1,2412,-74,-89,15,48:dd:0c:7d:86:25,8784126,382,-47,8783744,8784126
2966,6,6,1,2412,-85,-89,4,,8785952,44,1782,8785908,8785952
2967,6,24,1,2412,-86,-89,3,e2:db:d1:d1:b0:4a,8786103,28,123,8786075,8786103
2968,6,6,1,2412,-85,-89,4,,8786328,44,181,8786284,8786328
2969,6,6,1,2412,-89,-89,0,40:b0:34:b7:01:d5,8786448,576,-456,8785872,8786448
2970,6,6,1,2412,-66,-89,23,12:86:8c:5f:93:1e,8788294,332,1514,8787962,8788294
2971,6,24,1,2412,-82,-89,7,,8790938,28,2616,8790910,8790938
2972,4,11,1,2412,-74,-89,15,48:dd:0c:7d:86:23,8791853,254,661,8791599,8791853
2973,6,6,1,2412,-82,-89,7,,8798401,44,6504,8798357,8798401
2974,6,6,1,2412,-86,-89,3,e2:db:d1:d1:b0:4d,8800080,408,1271,8799672,8800080
2975,6,6,1,2412,-84,-89,5,e2:db:d1:d1:b0:4f,8800530,408,42,8800122,8800530
2976,6,6,1,2412,-84,-89,5,e2:db:d1:d1:b0:4a,8800971,548,-107,8800423,8800971
2977,6,6,1,2412,-84,-89,5,e2:db:d1:d1:b0:4a,8801552,576,5,8800976,8801552
2978,6,24,1,2412,-84,-89,5,,8802211,28,631,8802183,8802211
2979,6,6,1,2412,-85,-89,4,,8802351,44,96,8802307,8802351
2980,6,6,1,2412,-84,-89,5,,8802583,44,188,8802539,8802583
2981,4,1,1,2412,-90,-89,-1,78:67:0e:4b:85:1f,8803167,2552,-1968,8800615,8803167
2982,4,11,1,2412,-80,-89,9,48:dd:0c:90:e3:87,8808548,362,5019,8808186,8808548
2983,4,11,1,2412,-80,-89,9,48:dd:0c:90:e3:83,8808922,323,51,8808599,8808922
2984,4,11,1,2412,-81,-89,8,48:dd:0c:90:e3:85,8809257,382,-47,8808875,8809257
2985,6,6,1,2412,-82,-89,7,,8813180,44,3879,8813136,8813180
2986,6,6,1,2412,-67,-89,22,52:86:8c:5f:93:1e,8813893,332,381,8813561,8813893
2987,6,6,1,2412,-84,-89,5,,8818700,44,4763,8818656,8818700
2988,4,1,1,2412,-83,-89,6,78:67:0e:c4:a8:42,8820733,2736,-703,8817997,8820733
2989,6,6,1,2412,-68,-89,21,32:86:8c:5f:93:1e,8839494,332,18429,8839162,8839494
2990,6,24,1,2412,-80,-89,9,,8844207,28,4685,8844179,8844207
2991,4,1,1,2412,-80,-89,9,b0:e4:d5:32:ec:8a,8861238,1960,15071,8859278,8861238
2992,6,6,1,2412,-67,-89,22,10:86:8c:5f:93:1e,8865094,344,3512,8864750,8865094
2993,4,1,1,2412,-63,-89,26,94:a6:7e:c9:98:67,8868220,2464,662,8865756,8868220
2994,6,24,1,2412,-82,-89,7,,8873987,28,5739,8873959,8873987
2995,6,24,1,2412,-82,-89,7,,8879456,28,5441,8879428,8879456
2996,6,24,1,2412,-82,-89,7,4c:01:43:d7:f3:26,8879577,32,89,8879545,8879577
2997,4,11,1,2412,-74,-89,15,48:dd:0c:7d:86:27,8885816,362,5877,8885454,8885816
2998,4,11,1,2412,-75,-89,14,48:dd:0c:7d:86:23,8886191,323,52,8885868,8886191
2999,4,11,1,2412,-74,-89,15,48:dd:0c:7d:86:25,8886526,382,-47,8886144,8886526
3000,6,24,1,2412,-79,-89,10,,8888935,28,2381,8888907,8888935
3001,6,6,1,2412,-66,-89,23,12:86:8c:5f:93:1e,8890694,332,1427,8890362,8890694
3002,4,1,1,2412,-85,-89,4,00:26:62:eb:ea:74,8898776,968,7114,8897808,8898776
3003,4,11,1,2412,-78,-89,11,48:dd:0c:90:e3:87,8910947,362,11809,8910585,8910947
3004,4,11,1,2412,-80,-89,9,48:dd:0c:90:e3:83,8911322,323,52,8910999,8911322
3005,6,6,1,2412,-67,-89,22,52:86:8c:5f:93:1e,8916294,332,4640,8915962,8916294
3006,6,6,1,2412,-88,-89,1,0a:a7:c0:a3:8d:70,8920554,464,3796,8920090,8920554
3007,6,6,1,2412,-86,-89,3,0a:a7:c0:a3:8d:71,8921042,408,80,8920634,8921042
3008,6,6,1,2412,-89,-89,0,0a:a7:c0:a3:8d:73,8921501,408,51,8921093,8921501
3009,6,6,1,2412,-87,-89,2,0a:a7:c0:a3:8d:75,8921942,408,33,8921534,8921942
3010,6,24,1,2412,-79,-89,10,,8928583,28,6613,8928555,8928583
3011,4,1,1,2412,-79,-89,10,78:67:0e:c4:a8:42,8930218,352,1283,8929866,8930218
3012,6,24,1,2412,-80,-89,9,78:67:0e:c4:a8:42,8932318,32,2068,8932286,8932318
3013,4,11,1,2412,-84,-89,5,4c:01:43:d7:f3:23,8937785,284,5183,8937501,8937785
3014,6,6,1,2412,-84,-89,5,32:86:8c:5f:93:1e,8941895,332,3778,8941563,8941895
3015,6,24,1,2412,-84,-89,5,,8942387,28,464,8942359,8942387
3016,6,24,1,2412,-84,-89,5,,8943016,28,601,8942988,8943016
3017,6,6,1,2412,-88,-89,1,3c:bd:c5:ee:96:6d,8948348,68,5264,8948280,8948348
3018,6,24,1,2412,-79,-89,10,,8950942,28,2566,8950914,8950942
3019,4,1,1,2412,-76,-89,13,b0:e4:d5:32:ec:8a,8963637,1960,10735,8961677,8963637
3020,6,6,1,2412,-66,-89,23,10:86:8c:5f:93:1e,8967495,344,3514,8967151,8967495
3021,4,1,1,2412,-61,-89,28,94:a6:7e:c9:98:67,8970618,2464,659,8968154,8970618
3022,6,24,1,2412,-80,-89,9,,8982007,28,11361,8981979,8982007
3023,4,1,1,2412,-84,-89,5,78:67:0e:38:6c:d3,8985458,2736,715,8982722,8985458
3024,4,11,1,2412,-74,-89,15,48:dd:0c:7d:86:27,8988217,362,2397,8987855,8988217
3025,4,11,1,2412,-74,-89,15,48:dd:0c:7d:86:25,8988927,382,328,8988545,8988927
3026,6,6,1,2412,-62,-89,27,12:86:8c:5f:93:1e,8993095,332,3836,8992763,8993095
3027,4,1,1,2412,-84,-89,5,d8:9c:8e:01:4c:6a,8998170,3000,2075,8995170,8998170
3028,6,24,1,2412,-79,-89,10,,9003834,28,5636,9003806,9003834
3029,6,6,1,2412,-85,-89,4,e2:db:d1:d1:b0:4a,9003910,444,-368,9003466,9003910
3030,6,6,1,2412,-86,-89,3,e2:db:d1:d1:b0:4b,9004396,408,78,9003988,9004396
3031,6,6,1,2412,-87,-89,2,e2:db:d1:d1:b0:4a,9006308,576,1336,9005732,9006308
3032,6,6,1,2412,-86,-89,3,,9007090,44,738,9007046,9007090
3033,4,11,1,2412,-76,-90,14,48:dd:0c:90:e3:87,9013347,362,5895,9012985,9013347
3034,4,11,1,2412,-76,-90,14,48:dd:0c:90:e3:83,9013721,323,51,9013398,9013721
3035,4,11,1,2412,-75,-90,15,48:dd:0c:90:e3:85,9014057,382,-46,9013675,9014057
3036,4,1,1,2412,-83,-90,7,78:67:0e:38:6c:d3,9024668,3472,7139,9021196,9024668
3037,6,24,1,2412,-78,-90,12,,9032139,28,7443,9032111,9032139
3038,4,1,1,2412,-61,-90,29,10:86:8c:5f:93:1e,9036087,3088,860,9032999,9036087
3039,4,1,1,2412,-65,-90,25,10:86:8c:5f:93:1e,9039275,3088,100,9036187,9039275
3040,4,1,1,2412,-62,-90,28,10:86:8c:5f:93:1e,9042504,3088,141,9039416,9042504
3041,6,6,1,2412,-64,-90,26,32:86:8c:5f:93:1e,9045503,332,2667,9045171,9045503
3042,4,1,1,2412,-60,-90,30,10:86:8c:5f:93:1e,9046034,3088,-2557,9042946,9046034
3043,6,24,1,2412,-81,-90,9,,9055082,28,9020,9055054,9055082
3044,4,1,1,2412,-71,-90,19,b0:e4:d5:32:ec:8a,9066037,1960,8995,9064077,9066037
3045,4,11,1,2412,-77,-90,13,4c:01:43:d7:f3:29,9078078,362,11679,9077716,9078078
3046,4,11,1,2412,-78,-90,12,4c:01:43:d7:f3:23,9078453,322,53,9078131,9078453
3047,6,6,1,2412,-85,-90,5,e2:db:d1:d1:b0:4a,9082834,52,4329,9082782,9082834
3048,6,6,1,2412,-84,-90,6,,9083094,44,216,9083050,9083094
3049,6,6,1,2412,-84,-90,6,e2:db:d1:d1:b0:4a,9083539,68,377,9083471,9083539
3050,6,6,1,2412,-84,-90,6,e2:db:d1:d1:b0:4a,9084024,68,417,9083956,9084024
3051,6,24,1,2412,-84,-90,6,e2:db:d1:d1:b0:4a,9085195,28,1143,9085167,9085195
3052,6,6,1,2412,-85,-90,5,,9085414,44,175,9085370,9085414
3053,6,24,1,2412,-77,-90,13,,9086569,28,1127,9086541,9086569
3054,6,6,1,2412,-83,-90,7,40:b0:34:b7:01:d5,9093652,576,6507,9093076,9093652
3055,6,24,1,2412,-78,-90,12,,9095248,28,1568,9095220,9095248
3056,6,6,1,2412,-60,-90,30,12:86:8c:5f:93:1e,9095605,332,25,9095273,9095605
3057,4,1,1,2412,-88,-90,2,70:3a:cb:63:35:b2,9096129,2216,-1692,9093913,9096129
3058,6,24,1,2412,-83,-90,7,,9098539,28,2382,9098511,9098539
3059,4,1,1,2412,-86,-90,4,00:26:62:eb:ea:74,9101010,968,1503,9100042,9101010
3060,6,6,1,2412,-85,-90,5,e2:db:d1:d1:b0:4a,9106335,444,4881,9105891,9106335
3061,6,6,1,2412,-83,-90,7,e2:db:d1:d1:b0:4b,9106830,408,87,9106422,9106830
3062,4,11,1,2412,-78,-90,12,4c:01:43:d7:f3:23,9108043,254,959,9107789,9108043
3063,6,24,1,2412,-78,-90,12,,9110942,28,2871,9110914,9110942
3064,4,11,1,2412,-81,-90,9,4c:01:43:ec:a0:69,9114449,361,3146,9114088,9114449
3065,4,11,1,2412,-75,-90,15,48:dd:0c:90:e3:87,9115747,362,936,9115385,9115747
3066,4,11,1,2412,-74,-90,16,48:dd:0c:90:e3:83,9116121,323,51,9115798,9116121
3067,4,11,1,2412,-73,-90,17,48:dd:0c:90:e3:85,9116456,382,-47,9116074,9116456
3068,6,6,1,2412,-62,-90,28,52:86:8c:5f:93:1e,9121096,332,4308,9120764,9121096
3069,6,6,1,2412,-85,-90,5,0a:a7:c0:a3:8d:70,9123817,464,2257,9123353,9123817
3070,6,6,1,2412,-87,-90,3,0a:a7:c0:a3:8d:73,9124755,408,530,9124347,9124755
3071,6,6,1,2412,-88,-90,2,0a:a7:c0:a3:8d:75,9125312,408,149,9124904,9125312
3072,6,6,1,2412,-59,-90,31,32:86:8c:5f:93:1e,9146696,332,21052,9146364,9146696
3073,4,1,1,2412,-90,-90,0,ce:f4:11:65:3f:f8,9148404,2072,-364,9146332,9148404
3074,4,1,1,2412,-86,-90,4,d8:9c:8e:01:4c:6a,9159648,2952,8292,9156696,9159648
3075,4,1,1,2412,-80,-90,10,b0:e4:d5:32:ec:8a,9168436,1960,6828,9166476,9168436
3076,4,1,1,2412,-60,-90,30,94:a6:7e:c9:98:67,9175413,2464,4513,9172949,9175413
3077,4,11,1,2412,-80,-90,10,4c:01:43:d7:f3:29,9178661,362,2886,9178299,9178661
3078,4,11,1,2412,-79,-90,11,4c:01:43:d7:f3:23,9179035,322,52,9178713,9179035
3079,4,11,1,2412,-79,-90,11,4c:01:43:d7:f3:26,9179370,387,-52,9178983,9179370
3080,6,24,1,2412,-82,-90,8,,9182759,28,3361,9182731,9182759
3081,4,1,1,2412,-90,-90,0,78:67:0e:38:6c:d3,9190258,2736,4763,9187522,9190258
3082,4,11,1,2412,-75,-90,15,48:dd:0c:7d:86:27,9193017,362,2397,9192655,9193017
3083,4,11,1,2412,-75,-90,15,48:dd:0c:7d:86:23,9193391,323,51,9193068,9193391
3084,4,11,1,2412,-75,-90,15,48:dd:0c:7d:86:25,9193726,382,-47,9193344,9193726
3085,6,6,1,2412,-89,-90,1,,9195911,44,2141,9195867,9195911
3086,6,6,1,2412,-83,-90,7,40:b0:34:b7:01:d5,9196052,576,-435,9195476,9196052
3087,6,6,1,2412,-83,-90,7,e2:db:d1:d1:b0:4a,9196628,68,508,9196560,9196628
3088,6,6,1,2412,-88,-90,2,3c:bd:c5:ee:96:6d,9197226,68,530,9197158,9197226
3089,6,6,1,2412,-59,-90,31,12:86:8c:5f:93:1e,9197897,332,339,9197565,9197897
3090,4,1,1,2412,-88,-90,2,70:3a:cb:63:35:b2,9198422,2216,-1691,9196206,9198422
3091,6,24,1,2412,-81,-90,9,,9205939,28,7489,9205911,9205939
3092,6,6,1,2412,-83,-90,7,e2:db:d1:d1:b0:4b,9209464,408,3117,9209056,9209464
3093,6,6,1,2412,-80,-90,10,e2:db:d1:d1:b0:4d,9209905,408,33,9209497,9209905
3094,6,6,1,2412,-81,-90,9,e2:db:d1:d1:b0:4f,9210355,408,42,9209947,9210355
3095,6,24,1,2412,-85,-90,5,e2:db:d1:d1:b0:4a,9210906,28,523,9210878,9210906
3096,6,6,1,2412,-83,-90,7,,9211128,44,178,9211084,9211128
3097,6,24,1,2412,-86,-90,4,,9211528,28,372,9211500,9211528
3098,6,6,1,2412,-84,-90,6,,9211668,44,96,9211624,9211668
3099,6,24,1,2412,-85,-90,5,e2:db:d1:d1:b0:4a,9212025,28,329,9211997,9212025
3100,4,11,1,2412,-82,-90,8,4c:01:43:ec:a0:63,9217221,322,4874,9216899,9217221
3101,4,11,1,2412,-82,-90,8,4c:01:43:ec:a0:66,9217556,387,-52,9217169,9217556
3102,6,6,1,2412,-84,-90,6,e2:db:d1:d1:b0:4a,9217876,68,252,9217808,9217876
3103,4,11,1,2412,-75,-90,15,48:dd:0c:90:e3:87,9218146,362,-92,9217784,9218146
3104,4,11,1,2412,-78,-90,12,48:dd:0c:90:e3:83,9218521,323,52,9218198,9218521
3105,4,11,1,2412,-78,-90,12,48:dd:0c:90:e3:85,9218856,382,-47,9218474,9218856
3106,6,6,1,2412,-85,-90,5,e2:db:d1:d1:b0:4a,9219083,68,159,9219015,9219083
3107,6,6,1,2412,-84,-90,6,,9223226,44,4099,9223182,9223226
3108,6,6,1,2412,-85,-90,5,,9227397,44,4127,9227353,9227397
3109,6,24,1,2412,-85,-90,5,e2:db:d1:d1:b0:4a,9227861,28,436,9227833,9227861
3110,6,6,1,2412,-86,-90,4,0a:a7:c0:a3:8d:75,9227925,408,-344,9227517,9227925
3111,6,24,1,2412,-83,-90,7,,9228444,28,491,9228416,9228444
3112,6,6,1,2412,-84,-90,6,,9228564,44,76,9228520,9228564
3113,6,24,1,2412,-84,-90,6,e2:db:d1:d1:b0:4a,9228724,28,132,9228696,9228724
3114,6,6,1,2412,-85,-90,5,,9229277,44,509,9229233,9229277
3115,4,1,1,2412,-84,-90,6,78:67:0e:c4:a8:42,9230333,2736,-1680,9227597,9230333
3116,6,24,1,2412,-85,-90,5,e2:db:d1:d1:b0:4a,9233881,28,3520,9233853,9233881
3117,6,24,1,2412,-84,-90,6,e2:db:d1:d1:b0:4a,9235108,28,1199,9235080,9235108
3118,6,24,1,2412,-84,-90,6,,9235777,28,641,9235749,9235777
3119,6,6,1,2412,-84,-90,6,,9236851,44,1030,9236807,9236851
3120,6,24,1,2412,-85,-90,5,,9239688,28,2809,9239660,9239688
3121,6,6,1,2412,-85,-90,5,,9239808,44,76,9239764,9239808
3122,6,24,1,2412,-84,-90,6,e2:db:d1:d1:b0:4a,9240013,28,177,9239985,9240013
3123,6,24,1,2412,-86,-90,4,e2:db:d1:d1:b0:4a,9240310,28,269,9240282,9240310
3124,6,6,1,2412,-84,-90,6,,9240904,44,550,9240860,9240904
3125,6,6,1,2412,-79,-90,11,,9242024,44,1076,9241980,9242024
3126,6,24,1,2412,-85,-90,5,e2:db:d1:d1:b0:4a,9243616,28,1564,9243588,9243616
3127,6,24,1,2412,-86,-90,4,,9244914,28,1270,9244886,9244914
3128,6,6,1,2412,-86,-90,4,e2:db:d1:d1:b0:4a,9245205,68,223,9245137,9245205
3129,6,6,1,2412,-86,-90,4,e2:db:d1:d1:b0:4a,9245414,52,157,9245362,9245414
3130,6,6,1,2412,-83,-90,7,,9245784,44,326,9245740,9245784
3131,7,13,1,2412,0,-90,90,e2:db:d1:d1:b0:4a,9247232,120,1328,9247112,9247232
3132,7,13,1,2412,0,-90,90,e2:db:d1:d1:b0:4a,9247232,92,-92,9247140,9247232
3133,7,13,1,2412,0,-90,90,e2:db:d1:d1:b0:4a,9247232,88,-88,9247144,9247232
3134,6,6,1,2412,-84,-90,6,,9248327,44,1051,9248283,9248327
3135,6,6,1,2412,-84,-90,6,e2:db:d1:d1:b0:4a,9248603,68,208,9248535,9248603
3136,6,6,1,2412,-59,-90,31,32:86:8c:5f:93:1e,9249098,332,163,9248766,9249098
3137,6,24,1,2412,-86,-90,4,,9249609,28,483,9249581,9249609
3138,6,6,1,2412,-85,-90,5,,9249729,44,76,9249685,9249729
3139,6,24,1,2412,-86,-90,4,e2:db:d1:d1:b0:4a,9250699,28,942,9250671,9250699
3140,6,6,1,2412,-86,-90,4,,9250923,44,180,9250879,9250923
3141,6,6,1,2412,-85,-90,5,,9252679,44,1712,9252635,9252679
3142,6,24,1,2412,-84,-90,6,e2:db:d1:d1:b0:4a,9252803,28,96,9252775,9252803
3143,6,6,1,2412,-85,-90,5,,9258125,44,5278,9258081,9258125
3144,6,24,1,2412,-80,-90,10,,9258370,28,217,9258342,9258370
3145,4,1,1,2412,-89,-90,1,ac:67:84:84:8a:07,9259292,416,506,9258876,9259292
3146,4,1,1,2412,-73,-90,17,b0:e4:d5:32:ec:8a,9270835,1960,9583,9268875,9270835
3147,4,1,1,2412,-72,-90,18,,9276840,304,5701,9276536,9276840
3148,4,1,1,2412,-63,-90,27,94:a6:7e:c9:98:67,9277812,2464,-1492,9275348,9277812
3149,4,1,1,2412,-81,-90,9,bc:98:df:ff:0f:8b,9280475,2568,95,9277907,9280475
3150,4,1,1,2412,-74,-90,16,,9288503,304,7724,9288199,9288503
3151,4,11,1,2412,-79,-90,11,48:dd:0c:7d:86:27,9293020,362,4155,9292658,9293020
3152,4,11,1,2412,-80,-90,10,48:dd:0c:7d:86:23,9293394,323,51,9293071,9293394
3153,4,1,1,2412,-60,-90,30,10:86:8c:5f:93:1e,9304125,3088,7643,9301037,9304125
3154,4,1,1,2412,-60,-90,30,10:86:8c:5f:93:1e,9307305,3088,92,9304217,9307305
3155,4,1,1,2412,-64,-90,26,10:86:8c:5f:93:1e,9310469,3088,76,9307381,9310469
3156,4,1,1,2412,-60,-90,30,10:86:8c:5f:93:1e,9313633,3088,76,9310545,9313633
3157,4,1,1,2412,-87,-90,3,00:26:62:eb:ea:74,9318176,872,3671,9317304,9318176
3158,6,6,1,2412,-87,-90,3,,9345586,44,27366,9345542,9345586
3159,6,6,1,2412,-87,-90,3,,9347865,44,2235,9347821,9347865
3160,6,6,1,2412,-86,-90,4,e2:db:d1:d1:b0:4a,9348355,68,422,9348287,9348355
3161,6,6,1,2412,-62,-90,28,32:86:8c:5f:93:1e,9351498,332,2811,9351166,9351498
3162,4,11,1,2412,-87,-90,3,4c:01:43:ec:a0:63,9352947,254,1195,9352693,9352947
3163,4,11,1,2412,-85,-90,5,4c:01:43:d7:f3:23,9353648,254,447,9353394,9353648
3164,6,24,1,2412,-79,-90,11,,9358756,28,5080,9358728,9358756
3165,6,24,1,2412,-83,-90,7,,9363523,28,4739,9363495,9363523
3166,4,1,1,2412,-90,-90,0,,9368379,304,4552,9368075,9368379
3167,4,1,1,2412,-90,-90,0,,9368731,304,48,9368427,9368731
3168,4,1,1,2412,-91,-90,-1,,9369046,304,11,9368742,9369046
3169,4,1,1,2412,-92,-90,-2,,9369360,304,10,9369056,9369360
3170,4,1,1,2412,-91,-90,-1,,9369675,304,11,9369371,9369675
3171,4,1,1,2412,-92,-90,-2,,9370322,304,343,9370018,9370322
3172,4,1,1,2412,-74,-90,16,b0:e4:d5:32:ec:8a,9373234,1960,952,9371274,9373234
3173,6,6,1,2412,-63,-90,27,10:86:8c:5f:93:1e,9377097,344,3519,9376753,9377097
3174,4,1,1,2412,-60,-90,30,94:a6:7e:c9:98:67,9383013,2464,3452,9380549,9383013
3175,4,11,1,2412,-72,-90,18,48:dd:0c:7d:86:27,9397817,362,14442,9397455,9397817
3176,4,11,1,2412,-73,-90,17,48:dd:0c:7d:86:23,9398192,323,52,9397869,9398192
3177,4,11,1,2412,-72,-90,18,48:dd:0c:7d:86:25,9398527,382,-47,9398145,9398527
3178,6,6,1,2412,-85,-90,5,40:b0:34:b7:01:d5,9400855,576,1752,9400279,9400855
3179,6,6,1,2412,-63,-90,27,12:86:8c:5f:93:1e,9402942,332,1755,9402610,9402942
3180,4,5.5,1,2412,-86,-90,4,,9405760,213,2605,9405547,9405760
3181,6,6,1,2412,-86,-90,4,e2:db:d1:d1:b0:4a,9413540,444,7336,9413096,9413540
3182,6,6,1,2412,-87,-90,3,e2:db:d1:d1:b0:4b,9414026,408,78,9413618,9414026
3183,6,6,1,2412,-86,-90,4,e2:db:d1:d1:b0:4d,9414458,408,24,9414050,9414458
3184,6,6,1,2412,-87,-90,3,e2:db:d1:d1:b0:4a,9415349,224,667,9415125,9415349
3185,4,1,1,2412,-84,-90,6,00:26:62:eb:ea:74,9415661,968,-656,9414693,9415661
3186,6,6,1,2412,-88,-90,2,e2:db:d1:d1:b0:4a,9416696,656,379,9416040,9416696
3187,4,11,1,2412,-81,-90,9,48:dd:0c:90:e3:87,9422946,362,5888,9422584,9422946
3188,4,11,1,2412,-80,-90,10,48:dd:0c:90:e3:83,9423320,323,51,9422997,9423320
3189,4,11,1,2412,-82,-90,8,48:dd:0c:90:e3:85,9423656,382,-46,9423274,9423656
3190,6,6,1,2412,-62,-90,28,52:86:8c:5f:93:1e,9428299,332,4311,9427967,9428299
3191,4,1,1,2412,-84,-90,6,78:67:0e:c4:a8:42,9435132,2736,4097,9432396,9435132
3192,4,1,1,2412,-85,-90,5,78:67:0e:c4:a8:42,9439018,352,3534,9438666,9439018
3193,6,6,1,2412,-88,-90,2,3c:bd:c5:ee:96:6d,9447441,68,8355,9447373,9447441
3194,6,6,1,2412,-61,-90,29,32:86:8c:5f:93:1e,9453898,332,6125,9453566,9453898
3195,4,1,1,2412,-92,-90,-2,ce:f4:11:65:3f:f8,9455604,2072,-366,9453532,9455604
3196,6,24,1,2412,-88,-90,2,3c:bd:c5:ee:96:6d,9458893,28,3261,9458865,9458893
3197,6,6,1,2412,-88,-90,2,,9459172,44,235,9459128,9459172
3198,6,6,1,2412,-86,-90,4,3c:bd:c5:ee:96:6d,9461415,68,2175,9461347,9461415
3199,6,6,1,2412,-62,-90,28,10:86:8c:5f:93:1e,9479499,344,17740,9479155,9479499
3200,4,1,1,2412,-58,-90,32,94:a6:7e:c9:98:67,9482623,2464,660,9480159,9482623
3201,4,11,1,2412,-81,-90,9,4c:01:43:d7:f3:23,9486234,322,3289,9485912,9486234
3202,4,11,1,2412,-79,-90,11,4c:01:43:d7:f3:26,9486568,387,-53,9486181,9486568
3203,6,24,1,2412,-81,-90,9,,9493787,28,7191,9493759,9493787
3204,6,24,1,2412,-81,-90,9,,9494421,28,606,9494393,9494421
3205,6,24,1,2412,-80,-90,10,,9494868,28,419,9494840,9494868
3206,6,24,1,2412,-80,-90,10,4c:01:43:d7:f3:26,9494987,32,87,9494955,9494987
3207,4,1,1,2412,-81,-90,9,78:67:0e:38:6c:d3,9497459,2736,-264,9494723,9497459
3208,4,11,1,2412,-80,-90,10,48:dd:0c:7d:86:27,9500218,362,2397,9499856,9500218
3209,4,11,1,2412,-81,-90,9,48:dd:0c:7d:86:23,9500593,323,52,9500270,9500593
3210,6,6,1,2412,-62,-90,28,12:86:8c:5f:93:1e,9505099,332,4174,9504767,9505099
3211,6,24,1,2412,-80,-90,10,,9511027,28,5900,9510999,9511027
3212,6,6,1,2412,-87,-90,3,e2:db:d1:d1:b0:4a,9519120,1360,6733,9517760,9519120
3213,6,6,1,2412,-85,-90,5,,9520740,44,1576,9520696,9520740
3214,6,24,1,2412,-79,-90,11,,9523627,28,2859,9523599,9523627
3215,4,11,1,2412,-84,-90,6,4c:01:43:ec:a0:69,9524044,361,56,9523683,9524044
3216,4,11,1,2412,-86,-90,4,4c:01:43:ec:a0:63,9524418,322,52,9524096,9524418
3217,4,11,1,2412,-86,-90,4,4c:01:43:ec:a0:66,9524752,387,-53,9524365,9524752
3218,4,11,1,2412,-83,-90,7,48:dd:0c:90:e3:83,9525720,323,645,9525397,9525720
3219,4,11,1,2412,-84,-90,6,48:dd:0c:90:e3:85,9526055,382,-47,9525673,9526055
3220,6,6,1,2412,-64,-90,26,52:86:8c:5f:93:1e,9530698,332,4311,9530366,9530698
3221,6,6,1,2412,-86,-90,4,0a:a7:c0:a3:8d:73,9544205,408,13099,9543797,9544205
3222,6,6,1,2412,-86,-90,4,0a:a7:c0:a3:8d:75,9546769,408,2156,9546361,9546769
3223,6,6,1,2412,-65,-90,25,32:86:8c:5f:93:1e,9556300,332,9199,9555968,9556300
3224,4,1,1,2412,-84,-90,6,,9567584,304,10980,9567280,9567584
3225,6,6,1,2412,-87,-90,3,,9572635,44,5007,9572591,9572635
3226,6,24,1,2412,-87,-90,3,e2:db:d1:d1:b0:4a,9573122,28,459,9573094,9573122
3227,4,1,1,2412,-60,-90,30,94:a6:7e:c9:98:67,9584634,2464,9048,9582170,9584634
3228,6,6,1,2412,-59,-90,31,b4:e6:2d:b4:ff:71,9586969,64,2271,9586905,9586969
3229,6,6,1,2412,-85,-90,5,,9587122,44,109,9587078,9587122
3230,4,11,1,2412,-81,-90,9,4c:01:43:d7:f3:29,9588259,362,775,9587897,9588259
3231,6,6,1,2412,-59,-90,31,b4:e6:2d:b4:ff:71,9588472,64,149,9588408,9588472
3232,4,11,1,2412,-80,-90,10,4c:01:43:d7:f3:26,9588968,387,109,9588581,9588968
3233,6,6,1,2412,-59,-90,31,b4:e6:2d:b4:ff:71,9589280,64,248,9589216,9589280
3234,6,6,1,2412,-65,-90,25,,9589360,44,36,9589316,9589360
3235,4,11,1,2412,-76,-90,14,48:dd:0c:7d:86:23,9603052,323,13369,9602729,9603052
3236,4,11,1,2412,-77,-90,13,48:dd:0c:7d:86:25,9603388,382,-46,9603006,9603388
3237,6,24,1,2412,-86,-90,4,e2:db:d1:d1:b0:4a,9605515,28,2099,9605487,9605515
3238,6,6,1,2412,-86,-90,4,,9606729,44,1170,9606685,9606729
3239,6,24,1,2412,-86,-90,4,,9607430,28,673,9607402,9607430
3240,6,6,1,2412,-65,-90,25,12:86:8c:5f:93:1e,9607499,332,-263,9607167,9607499
3241,6,6,1,2412,-86,-90,4,,9609682,44,2139,9609638,9609682
3242,6,6,1,2412,-86,-90,4,,9615115,44,5389,9615071,9615115
3243,4,1,1,2412,-85,-90,5,00:26:62:eb:ea:74,9615552,968,-531,9614584,9615552
3244,6,6,1,2412,-84,-90,6,,9616458,44,862,9616414,9616458
3245,6,6,1,2412,-84,-90,6,,9616842,44,340,9616798,9616842
3246,6,6,1,2412,-85,-90,5,,9617277,44,391,9617233,9617277
3247,6,6,1,2412,-86,-90,4,,9617807,44,486,9617763,9617807
3248,6,6,1,2412,-85,-90,5,,9618330,44,479,9618286,9618330
3249,6,6,1,2412,-85,-90,5,e2:db:d1:d1:b0:4f,9619756,408,1018,9619348,9619756
3250,6,6,1,2412,-85,-90,5,e2:db:d1:d1:b0:4a,9622844,68,3020,9622776,9622844
3251,6,6,1,2412,-86,-90,4,,9625970,44,3082,9625926,9625970
3252,6,24,1,2412,-85,-90,5,,9626098,28,100,9626070,9626098
3253,4,11,1,2412,-78,-90,12,48:dd:0c:90:e3:87,9627745,362,1285,9627383,9627745
3254,4,11,1,2412,-77,-90,13,48:dd:0c:90:e3:83,9628120,323,52,9627797,9628120
3255,6,6,1,2412,-85,-90,5,,9628970,44,806,9628926,9628970
3256,6,24,1,2412,-86,-90,4,,9629097,28,99,9629069,9629097
3257,6,6,1,2412,-85,-90,5,e2:db:d1:d1:b0:4a,9630670,68,1505,9630602,9630670
3258,6,24,1,2412,-83,-90,7,,9637293,28,6595,9637265,9637293
3259,6,6,1,2412,-87,-90,3,0a:a7:c0:a3:8d:75,9637347,408,-354,9636939,9637347
3260,6,24,1,2412,-84,-90,6,e2:db:d1:d1:b0:4a,9650034,28,12659,9650006,9650034
3261,6,6,1,2412,-85,-90,5,,9650257,44,179,9650213,9650257
3262,6,24,1,2412,-84,-90,6,,9654086,28,3801,9654058,9654086
3263,6,6,1,2412,-85,-90,5,e2:db:d1:d1:b0:4a,9654574,68,420,9654506,9654574
3264,6,24,1,2412,-84,-90,6,e2:db:d1:d1:b0:4a,9656762,28,2160,9656734,9656762
3265,6,6,1,2412,-86,-90,4,,9657185,44,379,9657141,9657185
3266,6,24,1,2412,-85,-90,5,e2:db:d1:d1:b0:4a,9657364,28,151,9657336,9657364
3267,6,24,1,2412,-86,-90,4,,9658348,28,956,9658320,9658348
3268,6,6,1,2412,-84,-90,6,e2:db:d1:d1:b0:4a,9658479,68,63,9658411,9658479
3269,6,6,1,2412,-85,-90,5,,9659066,44,543,9659022,9659066
3270,6,6,1,2412,-85,-90,5,,9667392,44,8282,9667348,9667392
3271,6,24,1,2412,-85,-90,5,,9667583,28,163,9667555,9667583
3272,6,6,1,2412,-84,-90,6,e2:db:d1:d1:b0:4a,9668279,68,628,9668211,9668279
3273,6,6,1,2412,-86,-90,4,,9670811,44,2488,9670767,9670811
3274,6,24,1,2412,-84,-90,6,,9670951,28,112,9670923,9670951
3275,6,24,1,2412,-85,-90,5,e2:db:d1:d1:b0:4a,9671010,28,31,9670982,9671010
3276,6,6,1,2412,-87,-90,3,,9671262,44,208,9671218,9671262
3277,6,24,1,2412,-86,-90,4,,9673478,28,2188,9673450,9673478
3278,6,6,1,2412,-84,-90,6,,9673598,44,76,9673554,9673598
3279,6,6,1,2412,-84,-90,6,,9673918,44,276,9673874,9673918
3280,6,6,1,2412,-84,-90,6,,9674353,44,391,9674309,9674353
3281,6,24,1,2412,-84,-90,6,,9679046,28,4665,9679018,9679046
3282,4,1,1,2412,-91,-90,-1,,9679256,304,-94,9678952,9679256
3283,4,1,1,2412,-74,-90,16,b0:e4:d5:32:ec:8a,9680432,1960,-784,9678472,9680432
3284,6,24,1,2412,-82,-90,8,,9683529,28,3069,9683501,9683529
3285,6,6,1,2412,-65,-90,25,10:86:8c:5f:93:1e,9684299,344,426,9683955,9684299
3286,4,1,1,2412,-60,-90,30,94:a6:7e:c9:98:67,9689581,2464,2818,9687117,9689581
3287,4,1,1,2412,-67,-90,23,,9692183,304,2298,9691879,9692183
3288,7,72.2222,1,2412,-65,-90,25,10:86:8c:5f:93:1e,9692334,50,101,9692284,9692334
3289,6,24,1,2412,-71,-90,19,,9692399,28,37,9692371,9692399
3290,6,6,1,2412,-84,-90,6,,9698870,44,6427,9698826,9698870
3291,6,6,1,2412,-83,-90,7,e2:db:d1:d1:b0:4a,9699230,68,292,9699162,9699230
3292,6,24,1,2412,-84,-90,6,e2:db:d1:d1:b0:4a,9699369,28,111,9699341,9699369
3293,6,24,1,2412,-84,-90,6,,9700102,28,705,9700074,9700102
3294,6,6,1,2412,-84,-90,6,e2:db:d1:d1:b0:4a,9700266,68,96,9700198,9700266
3295,6,24,1,2412,-84,-90,6,,9701085,28,791,9701057,9701085
3296,6,6,1,2412,-84,-90,6,,9701205,44,76,9701161,9701205
3297,6,24,1,2412,-85,-90,5,,9701947,28,714,9701919,9701947
3298,4,11,1,2412,-77,-90,13,48:dd:0c:7d:86:25,9705728,382,3399,9705346,9705728
3299,6,6,1,2412,-87,-90,3,40:b0:34:b7:01:d5,9708058,576,1754,9707482,9708058
3300,6,6,1,2412,-66,-90,24,12:86:8c:5f:93:1e,9709900,332,1510,9709568,9709900
3301,6,24,1,2412,-71,-90,19,,9712816,28,2888,9712788,9712816
3302,6,24,1,2412,-68,-90,22,10:86:8c:5f:93:1e,9712928,32,80,9712896,9712928
3303,6,6,1,2412,-85,-90,5,e2:db:d1:d1:b0:4b,9722275,408,8939,9721867,9722275
3304,6,6,1,2412,-85,-90,5,e2:db:d1:d1:b0:4d,9722725,408,42,9722317,9722725
3305,4,11,1,2412,-77,-90,13,48:dd:0c:90:e3:87,9730145,362,7058,9729783,9730145
3306,4,11,1,2412,-78,-90,12,48:dd:0c:90:e3:83,9730520,323,52,9730197,9730520
3307,4,11,1,2412,-77,-90,13,48:dd:0c:90:e3:85,9730855,382,-47,9730473,9730855
3308,6,6,1,2412,-84,-90,6,,9732526,44,1627,9732482,9732526
3309,6,6,1,2412,-86,-90,4,,9732907,44,337,9732863,9732907
3310,6,6,1,2412,-66,-90,24,52:86:8c:5f:93:1e,9735501,332,2262,9735169,9735501
3311,4,1,1,2412,-81,-90,9,3c:bd:c5:ee:96:6d,9739625,976,3148,9738649,9739625
3312,6,6,1,2412,-84,-90,6,,9741211,44,1542,9741167,9741211
3313,6,24,1,2412,-85,-90,5,,9741339,28,100,9741311,9741339
3314,6,6,1,2412,-85,-90,5,,9741462,44,79,9741418,9741462
3315,4,1,1,2412,-88,-90,2,04:a2:22:bf:24:52,9746433,2512,2459,9743921,9746433
3316,6,6,1,2412,-86,-90,4,,9752413,44,5936,9752369,9752413
3317,6,6,1,2412,-85,-90,5,,9754272,44,1815,9754228,9754272
3318,6,6,1,2412,-87,-90,3,,9755441,44,1125,9755397,9755441
3319,6,6,1,2412,-85,-90,5,e2:db:d1:d1:b0:4a,9755700,68,191,9755632,9755700
3320,6,6,1,2412,-66,-90,24,b4:e6:2d:b4:ff:71,9768065,64,12301,9768001,9768065
3321,6,6,1,2412,-65,-90,25,,9768145,44,36,9768101,9768145
3322,4,1,1,2412,-73,-90,17,b0:e4:d5:32:ec:8a,9782873,1960,12768,9780913,9782873
3323,6,6,1,2412,-86,-90,4,,9785506,44,2589,9785462,9785506
3324,6,6,1,2412,-85,-90,5,,9785853,44,303,9785809,9785853
3325,6,6,1,2412,-69,-90,21,10:86:8c:5f:93:1e,9786700,344,503,9786356,9786700
3326,4,1,1,2412,-62,-90,28,94:a6:7e:c9:98:67,9789862,2464,698,9787398,9789862
3327,4,11,1,2412,-86,-90,4,4c:01:43:d7:f3:29,9793058,362,2834,9792696,9793058
3328,4,11,1,2412,-89,-90,1,4c:01:43:d7:f3:23,9793432,322,52,9793110,9793432
3329,4,11,1,2412,-86,-90,4,4c:01:43:d7:f3:26,9793767,387,-52,9793380,9793767
3330,4,1,1,2412,-80,-90,10,78:67:0e:38:6c:d3,9804660,2736,8157,9801924,9804660
3331,4,11,1,2412,-74,-90,16,48:dd:0c:7d:86:27,9807419,362,2397,9807057,9807419
3332,4,11,1,2412,-75,-90,15,48:dd:0c:7d:86:23,9807793,323,51,9807470,9807793
3333,4,11,1,2412,-74,-90,16,48:dd:0c:7d:86:25,9808128,382,-47,9807746,9808128
3334,6,6,1,2412,-68,-90,22,12:86:8c:5f:93:1e,9812301,332,3841,9811969,9812301
3335,6,6,1,2412,-66,-90,24,52:86:8c:5f:93:1e,9837901,332,25268,9837569,9837901
3336,6,6,1,2412,-86,-90,4,,9838456,44,511,9838412,9838456
3337,4,1,1,2412,-80,-90,10,78:67:0e:c4:a8:42,9845006,2736,3814,9842270,9845006
3338,6,6,1,2412,-89,-90,1,,9852033,44,6983,9851989,9852033
3339,6,24,1,2412,-83,-90,7,4c:01:43:d7:f3:26,9854225,32,2160,9854193,9854225
3340,6,24,1,2412,-82,-90,8,4c:01:43:d7:f3:26,9859276,32,5019,9859244,9859276
3341,6,24,1,2412,-82,-90,8,4c:01:43:d7:f3:26,9859441,32,133,9859409,9859441
3342,6,6,1,2412,-86,-90,4,e2:db:d1:d1:b0:4a,9859486,68,-23,9859418,9859486
3343,6,6,1,2412,-67,-90,23,32:86:8c:5f:93:1e,9863949,332,4131,9863617,9863949
3344,6,6,1,2412,-86,-90,4,e2:db:d1:d1:b0:4a,9871499,68,7482,9871431,9871499
3345,6,6,1,2412,-89,-90,1,e2:db:d1:d1:b0:4a,9872009,68,442,9871941,9872009
3346,6,6,1,2412,-87,-90,3,,9876985,44,4932,9876941,9876985
3347,6,6,1,2412,-89,-90,1,,9878837,44,1808,9878793,9878837
3348,6,6,1,2412,-88,-90,2,,9880725,44,1844,9880681,9880725
3349,4,1,1,2412,-70,-90,20,b0:e4:d5:32:ec:8a,9885231,1960,2546,9883271,9885231
3350,4,1,1,2412,-58,-90,32,94:a6:7e:c9:98:67,9892209,2464,4514,9889745,9892209
3351,4,1,1,2412,-82,-90,8,78:67:0e:38:6c:d3,9907060,2736,12115,9904324,9907060
3352,4,11,1,2412,-75,-90,15,48:dd:0c:7d:86:27,9909818,362,2396,9909456,9909818
3353,4,11,1,2412,-75,-90,15,48:dd:0c:7d:86:23,9910193,323,52,9909870,9910193
3354,4,11,1,2412,-76,-90,14,48:dd:0c:7d:86:25,9910528,382,-47,9910146,9910528
3355,6,6,1,2412,-89,-90,1,e2:db:d1:d1:b0:4a,9925527,444,14555,9925083,9925527
3356,6,6,1,2412,-88,-90,2,e2:db:d1:d1:b0:4b,9926004,408,69,9925596,9926004
3357,6,6,1,2412,-89,-90,1,e2:db:d1:d1:b0:4d,9926445,408,33,9926037,9926445
3358,6,6,1,2412,-89,-90,1,,9928304,44,1815,9928260,9928304
3359,4,11,1,2412,-81,-90,9,48:dd:0c:90:e3:85,9935654,382,6968,9935272,9935654
3360,6,6,1,2412,-63,-90,27,52:86:8c:5f:93:1e,9940301,332,4315,9939969,9940301
3361,6,6,1,2412,-90,-90,0,,9943094,44,2749,9943050,9943094
3362,6,6,1,2412,-86,-90,4,0a:a7:c0:a3:8d:70,9943392,464,-166,9942928,9943392
3363,6,6,1,2412,-87,-90,3,0a:a7:c0:a3:8d:71,9943907,408,107,9943499,9943907
3364,6,6,1,2412,-86,-90,4,0a:a7:c0:a3:8d:73,9944339,408,24,9943931,9944339
3365,6,6,1,2412,-85,-90,5,0a:a7:c0:a3:8d:75,9944789,408,42,9944381,9944789
3366,6,24,1,2412,-84,-90,6,,9946026,28,1209,9945998,9946026
3367,6,24,1,2412,-83,-90,7,,9946426,28,372,9946398,9946426
3368,6,24,1,2412,-83,-90,7,,9946820,28,366,9946792,9946820
3369,4,1,1,2412,-84,-90,6,78:67:0e:c4:a8:42,9947132,2736,-2424,9944396,9947132
3370,4,1,1,2412,-74,-90,16,78:67:0e:c4:a8:42,9949905,352,2421,9949553,9949905
3371,4,1,1,2412,-84,-90,6,78:67:0e:c4:a8:42,9950386,352,129,9950034,9950386
3372,4,1,1,2412,-85,-90,5,78:67:0e:c4:a8:42,9950838,352,100,9950486,9950838
3373,4,1,1,2412,-81,-90,9,78:67:0e:c4:a8:42,9951760,352,570,9951408,9951760
3374,4,1,1,2412,-81,-90,9,78:67:0e:c4:a8:42,9952221,352,109,9951869,9952221
3375,4,1,1,2412,-84,-90,6,78:67:0e:c4:a8:42,9952682,352,109,9952330,9952682
3376,4,1,1,2412,-82,-90,8,78:67:0e:c4:a8:42,9953152,352,118,9952800,9953152
3377,4,1,1,2412,-82,-90,8,78:67:0e:c4:a8:42,9953604,352,100,9953252,9953604
3378,4,1,1,2412,-84,-90,6,78:67:0e:c4:a8:42,9954065,352,109,9953713,9954065
3379,4,1,1,2412,-82,-90,8,,9955941,304,1572,9955637,9955941
3380,6,24,1,2412,-83,-90,7,,9956250,28,281,9956222,9956250
3381,6,24,1,2412,-84,-90,6,,9956552,28,274,9956524,9956552
3382,4,1,1,2412,-81,-90,9,,9956992,304,136,9956688,9956992
3383,4,1,1,2412,-83,-90,7,78:67:0e:c4:a8:42,9958405,352,1061,9958053,9958405
3384,6,6,1,2412,-63,-90,27,32:86:8c:5f:93:1e,9965902,332,7165,9965570,9965902
3385,6,6,1,2412,-88,-90,2,,9979613,44,13667,9979569,9979613
3386,4,1,1,2412,-75,-90,15,b0:e4:d5:32:ec:8a,9987630,1960,6057,9985670,9987630
3387,6,24,1,2412,-78,-90,12,,9990957,28,3299,9990929,9990957
3388,6,6,1,2412,-63,-90,27,10:86:8c:5f:93:1e,9991502,344,201,9991158,9991502
3389,4,1,1,2412,-56,-90,34,94:a6:7e:c9:98:67,9994628,2464,662,9992164,9994628
3390,6,24,1,2412,-83,-90,7,,9996942,28,2286,9996914,9996942
3391,4,11,1,2412,-79,-90,11,4c:01:43:d7:f3:29,9997857,362,553,9997495,9997857
3392,4,11,1,2412,-80,-90,10,4c:01:43:d7:f3:26,9998566,387,322,9998179,9998566
3393,4,1,1,2412,-93,-90,-3,ac:67:84:84:8a:07,10002044,416,3062,10001628,10002044
3394,6,24,1,2412,-79,-90,11,,10003536,28,1464,10003508,10003536
3395,6,6,1,2412,-86,-89,3,,10017781,44,14201,10017737,10017781
3396,6,6,1,2412,-87,-89,2,e2:db:d1:d1:b0:4b,10028421,408,10232,10028013,10028421
3397,6,6,1,2412,-87,-89,2,e2:db:d1:d1:b0:4d,10028863,408,34,10028455,10028863
3398,6,6,1,2412,-87,-89,2,e2:db:d1:d1:b0:4f,10029312,408,41,10028904,10029312
3399,6,6,1,2412,-86,-89,3,,10032796,44,3440,10032752,10032796
3400,4,11,1,2412,-84,-89,5,48:dd:0c:90:e3:83,10037719,323,4600,10037396,10037719
3401,4,11,1,2412,-87,-89,2,48:dd:0c:90:e3:85,10038054,382,-47,10037672,10038054
3402,6,24,1,2412,-85,-89,4,,10038535,28,453,10038507,10038535
3403,6,6,1,2412,-88,-89,1,,10039669,44,1090,10039625,10039669
3404,6,6,1,2412,-65,-89,24,52:86:8c:5f:93:1e,10042703,332,2702,10042371,10042703
3405,6,6,1,2412,-86,-89,3,,10043068,44,321,10043024,10043068
3406,4,1,1,2412,-88,-89,1,3c:bd:c5:ee:96:6d,10043595,2512,-1985,10041083,10043595
3407,6,6,1,2412,-81,-89,8,0a:a7:c0:a3:8d:75,10048269,408,4266,10047861,10048269
3408,6,24,1,2412,-83,-89,6,,10048890,28,593,10048862,10048890
3409,4,1,1,2412,-92,-89,-3,,10053707,304,4513,10053403,10053707
3410,6,24,1,2412,-84,-89,5,,10055083,28,1348,10055055,10055083
3411,6,6,1,2412,-84,-89,5,,10055810,44,683,10055766,10055810
3412,6,6,1,2412,-88,-89,1,,10056604,44,750,10056560,10056604
3413,4,1,1,2412,-68,-89,21,c0:8d:51:da:5c:ef,10057031,416,11,10056615,10057031
3414,4,1,1,2412,-65,-89,24,,10057458,304,123,10057154,10057458
3415,6,6,1,2412,-86,-89,3,,10058422,44,920,10058378,10058422
3416,6,6,1,2412,-66,-89,23,32:86:8c:5f:93:1e,10068302,332,9548,10067970,10068302
3417,6,24,1,2412,-82,-89,7,,10070963,28,2633,10070935,10070963
3418,6,24,1,2412,-86,-89,3,,10080932,28,9941,10080904,10080932
3419,6,6,1,2412,-86,-89,3,,10081051,44,75,10081007,10081051
3420,6,6,1,2412,-86,-89,3,,10082724,44,1629,10082680,10082724
3421,6,24,1,2412,-83,-89,6,,10083531,28,779,10083503,10083531
3422,6,24,1,2412,-84,-89,5,,10088459,28,4900,10088431,10088459
3423,4,1,1,2412,-72,-89,17,b0:e4:d5:32:ec:8a,10090029,1960,-390,10088069,10090029
3424,6,6,1,2412,-86,-89,3,,10093654,44,3581,10093610,10093654
3425,4,11,1,2412,-84,-89,5,4c:01:43:d7:f3:23,10102535,322,8559,10102213,10102535
3426,4,11,1,2412,-85,-89,4,4c:01:43:d7:f3:26,10102869,387,-53,10102482,10102869
3427,6,24,1,2412,-85,-89,4,e2:db:d1:d1:b0:4a,10108689,28,5792,10108661,10108689
3428,6,6,1,2412,-87,-89,2,,10109939,44,1206,10109895,10109939
3429,6,6,1,2412,-86,-89,3,e2:db:d1:d1:b0:4a,10110203,68,196,10110135,10110203
3430,4,11,1,2412,-75,-89,14,48:dd:0c:7d:86:23,10114994,323,4468,10114671,10114994
3431,4,11,1,2412,-74,-89,15,48:dd:0c:7d:86:25,10115329,382,-47,10114947,10115329
3432,6,24,1,2412,-84,-89,5,,10116175,28,818,10116147,10116175
3433,6,6,1,2412,-85,-89,4,e2:db:d1:d1:b0:4a,10119372,68,3129,10119304,10119372
3434,6,6,1,2412,-66,-89,23,12:86:8c:5f:93:1e,10119504,332,-200,10119172,10119504
3435,4,1,1,2412,-89,-89,0,70:3a:cb:63:35:b2,10120027,2216,-1693,10117811,10120027
3436,4,11,1,2412,-78,-89,11,48:dd:0c:90:e3:83,10127142,254,6861,10126888,10127142
3437,6,6,1,2412,-85,-89,4,e2:db:d1:d1:b0:4b,10130820,408,3270,10130412,10130820
3438,6,6,1,2412,-85,-89,4,,10132359,44,1495,10132315,10132359
3439,4,1,1,2412,-91,-89,-2,00:26:62:eb:ea:74,10133725,968,398,10132757,10133725
3440,6,6,1,2412,-63,-89,26,52:86:8c:5f:93:1e,10145103,332,11046,10144771,10145103
3441,6,6,1,2412,-82,-89,7,,10147987,44,2840,10147943,10147987
3442,6,6,1,2412,-85,-89,4,0a:a7:c0:a3:8d:75,10149265,408,870,10148857,10149265
3443,6,24,1,2412,-80,-89,9,,10150958,28,1665,10150930,10150958
3444,4,1,1,2412,-82,-89,7,78:67:0e:c4:a8:42,10152069,2736,-1625,10149333,10152069
3445,4,1,1,2412,-83,-89,6,78:67:0e:c4:a8:42,10154887,848,1970,10154039,10154887
3446,4,1,1,2412,-82,-89,7,78:67:0e:c4:a8:42,10155745,1192,-334,10154553,10155745
3447,4,1,1,2412,-80,-89,9,78:67:0e:c4:a8:42,10156948,1192,11,10155756,10156948
3448,4,1,1,2412,-82,-89,7,,10158591,304,1339,10158287,10158591
3449,6,6,1,2412,-86,-89,3,,10159586,44,951,10159542,10159586
3450,6,24,1,2412,-86,-89,3,e2:db:d1:d1:b0:4a,10159828,28,214,10159800,10159828
3451,4,1,1,2412,-81,-89,8,78:67:0e:c4:a8:42,10160130,352,-50,10159778,10160130
3452,6,24,1,2412,-85,-89,4,e2:db:d1:d1:b0:4a,10162021,28,1863,10161993,10162021
3453,6,6,1,2412,-86,-89,3,,10162322,44,257,10162278,10162322
3454,4,11,1,2412,-82,-89,7,,10162778,107,349,10162671,10162778
3455,6,24,1,2412,-82,-89,7,78:67:0e:c4:a8:42,10162892,32,82,10162860,10162892
3456,6,6,1,2412,-86,-89,3,e2:db:d1:d1:b0:4a,10163092,68,132,10163024,10163092
3457,6,24,1,2412,-79,-89,10,,10164176,28,1056,10164148,10164176
3458,6,24,1,2412,-86,-89,3,,10164292,28,88,10164264,10164292
3459,6,6,1,2412,-87,-89,2,,10164571,44,235,10164527,10164571
3460,6,6,1,2412,-86,-89,3,e2:db:d1:d1:b0:4a,10165541,68,902,10165473,10165541
3461,6,6,1,2412,-63,-89,26,32:86:8c:5f:93:1e,10170703,332,4830,10170371,10170703
3462,6,6,1,2412,-86,-89,3,,10175597,44,4850,10175553,10175597
3463,6,6,1,2412,-87,-89,2,,10176632,44,991,10176588,10176632
3464,6,6,1,2412,-87,-89,2,0a:a7:c0:a3:8d:70,10184382,372,7378,10184010,10184382
3465,6,6,1,2412,-86,-89,3,0a:a7:c0:a3:8d:70,10184788,376,30,10184412,10184788
3466,6,6,1,2412,-87,-89,2,,10186103,44,1271,10186059,10186103
3467,6,6,1,2412,-86,-89,3,0a:a7:c0:a3:8d:70,10186183,372,-292,10185811,10186183
3468,6,6,1,2412,-87,-89,2,,10186790,44,563,10186746,10186790
3469,4,1,1,2412,-72,-89,17,b0:e4:d5:32:ec:8a,10192429,1960,3679,10190469,10192429
3470,6,6,1,2412,-87,-89,2,,10195046,44,2573,10195002,10195046
3471,6,24,1,2412,-82,-89,7,,10196010,28,936,10195982,10196010
3472,6,6,1,2412,-64,-89,25,10:86:8c:5f:93:1e,10196367,344,13,10196023,10196367
3473,4,1,1,2412,-78,-89,11,bc:98:df:ff:0f:8b,10196937,2568,-1998,10194369,10196937
3474,4,11,1,2412,-70,-89,19,48:dd:0c:7d:86:27,10217509,362,20210,10217147,10217509
3475,4,11,1,2412,-69,-89,20,48:dd:0c:7d:86:23,10217883,323,51,10217560,10217883
3476,4,11,1,2412,-68,-89,21,48:dd:0c:7d:86:25,10218219,382,-46,10217837,10218219
3477,6,6,1,2412,-64,-89,25,12:86:8c:5f:93:1e,10221903,332,3352,10221571,10221903
3478,6,24,1,2412,-79,-89,10,,10231994,28,10063,10231966,10231994
3479,6,6,1,2412,-89,-89,0,e2:db:d1:d1:b0:4b,10236511,408,4109,10236103,10236511
3480,6,6,1,2412,-88,-89,1,e2:db:d1:d1:b0:4d,10236961,408,42,10236553,10236961
3481,4,11,1,2412,-78,-89,11,48:dd:0c:90:e3:83,10242518,323,5234,10242195,10242518
3482,4,11,1,2412,-79,-89,10,48:dd:0c:90:e3:85,10242854,382,-46,10242472,10242854
3483,6,6,1,2412,-63,-89,26,52:86:8c:5f:93:1e,10247503,332,4317,10247171,10247503
3484,4,1,1,2412,-81,-89,8,78:67:0e:c4:a8:42,10254331,2736,4092,10251595,10254331
3485,4,1,1,2412,-78,-89,11,bc:98:df:ff:0f:8b,10257219,3176,-288,10254043,10257219
3486,4,1,1,2412,-65,-89,24,10:86:8c:5f:93:1e,10265996,3088,5689,10262908,10265996
3487,4,1,1,2412,-67,-89,22,10:86:8c:5f:93:1e,10269339,3088,255,10266251,10269339
3488,4,11,1,2412,-82,-89,7,,10272363,107,2917,10272256,10272363
3489,6,24,1,2412,-82,-89,7,78:67:0e:c4:a8:42,10272477,32,82,10272445,10272477
3490,4,11,1,2412,-70,-89,19,48:dd:0c:7d:86:25,10272819,377,-35,10272442,10272819
3491,6,6,1,2412,-62,-89,27,32:86:8c:5f:93:1e,10273369,332,218,10273037,10273369
3492,4,1,1,2412,-67,-89,22,10:86:8c:5f:93:1e,10273891,3088,-2566,10270803,10273891
3493,6,6,1,2412,-89,-89,0,,10286645,44,12710,10286601,10286645
3494,6,6,1,2412,-90,-89,-1,,10294336,44,7647,10294292,10294336
3495,4,1,1,2412,-67,-89,22,b0:e4:d5:32:ec:8a,10294828,1960,-1468,10292868,10294828
3496,6,6,1,2412,-86,-89,3,,10296987,44,2115,10296943,10296987
3497,4,1,1,2412,-65,-89,24,94:a6:7e:c9:98:67,10301805,2464,2354,10299341,10301805
3498,4,11,1,2412,-69,-89,20,4c:01:43:d7:f3:29,10305056,362,2889,10304694,10305056
3499,4,11,1,2412,-88,-89,1,48:dd:0c:92:4b:e5,10308783,382,3345,10308401,10308783
3500,6,24,1,2412,-81,-89,8,,10310965,28,2154,10310937,10310965
3501,6,6,1,2412,-88,-89,1,3c:bd:c5:ee:96:6d,10312322,68,1289,10312254,10312322
3502,6,6,1,2412,-90,-89,-1,e2:db:d1:d1:b0:4a,10312815,68,425,10312747,10312815
3503,4,11,1,2412,-74,-89,15,48:dd:0c:7d:86:23,10319794,323,6656,10319471,10319794
3504,4,11,1,2412,-75,-89,14,48:dd:0c:7d:86:25,10320129,382,-47,10319747,10320129
3505,6,6,1,2412,-90,-89,-1,,10321145,44,972,10321101,10321145
3506,6,24,1,2412,-80,-89,9,,10321444,28,271,10321416,10321444
3507,6,24,1,2412,-82,-89,7,,10322079,28,607,10322051,10322079
3508,6,6,1,2412,-88,-89,1,,10322235,44,112,10322191,10322235
3509,6,24,1,2412,-83,-89,6,,10323075,28,812,10323047,10323075
3510,6,24,1,2412,-82,-89,7,,10323727,28,624,10323699,10323727
3511,6,6,1,2412,-89,-89,0,e2:db:d1:d1:b0:4a,10323860,68,65,10323792,10323860
3512,6,6,1,2412,-63,-89,26,12:86:8c:5f:93:1e,10324304,332,112,10323972,10324304
3513,6,6,1,2412,-89,-89,0,,10330975,44,6627,10330931,10330975
3514,6,6,1,2412,-87,-89,2,,10331393,44,374,10331349,10331393
3515,6,6,1,2412,-89,-89,0,,10332507,44,1070,10332463,10332507
3516,4,1,1,2412,-87,-89,2,00:26:62:eb:ea:74,10338084,968,4609,10337116,10338084
3517,6,6,1,2412,-86,-89,3,3c:bd:c5:ee:96:6d,10341503,68,3351,10341435,10341503
3518,4,11,1,2412,-84,-89,5,48:dd:0c:90:e3:85,10345253,382,3368,10344871,10345253
3519,6,24,1,2412,-83,-89,6,,10346305,28,1024,10346277,10346305
3520,6,6,1,2412,-89,-89,0,,10347137,44,788,10347093,10347137
3521,4,1,1,2412,-89,-89,0,3c:bd:c5:ee:96:6d,10352753,976,4640,10351777,10352753
3522,6,24,1,2412,-83,-89,6,,10356506,28,3725,10356478,10356506
3523,6,24,1,2412,-83,-89,6,,10356623,28,89,10356595,10356623
3524,4,1,1,2412,-92,-89,-3,04:a2:22:bf:24:52,10360862,2512,1727,10358350,10360862
3525,6,24,1,2412,-85,-89,4,,10366808,28,5918,10366780,10366808
3526,6,6,1,2412,-88,-89,1,,10369117,44,2265,10369073,10369117
3527,6,6,1,2412,-90,-89,-1,,10369755,44,594,10369711,10369755
3528,4,1,1,2412,-86,-89,3,38:01:46:30:1a:ca,10373239,416,3068,10372823,10373239
3529,6,24,1,2412,-84,-89,5,,10374013,28,746,10373985,10374013
3530,6,24,1,2412,-84,-89,5,,10375248,28,1207,10375220,10375248
3531,6,6,1,2412,-63,-89,26,32:86:8c:5f:93:1e,10375605,332,25,10375273,10375605
3532,4,1,1,2412,-85,-89,4,38:01:46:30:1a:ca,10377019,352,1062,10376667,10377019
3533,4,1,1,2412,-90,-89,-1,38:01:46:30:1a:ca,10377707,848,-160,10376859,10377707
3534,6,24,1,2412,-82,-89,7,,10390965,28,13230,10390937,10390965
3535,4,1,1,2412,-70,-89,19,b0:e4:d5:32:ec:8a,10397227,1960,4302,10395267,10397227
3536,6,6,1,2412,-60,-89,29,10:86:8c:5f:93:1e,10401105,344,3534,10400761,10401105
3537,4,1,1,2412,-61,-89,28,94:a6:7e:c9:98:67,10404222,2464,653,10401758,10404222
3538,4,11,1,2412,-82,-89,7,4c:01:43:d7:f3:29,10407455,362,2871,10407093,10407455
3539,4,11,1,2412,-64,-89,25,4c:01:43:d7:f3:23,10407830,322,53,10407508,10407830
3540,4,11,1,2412,-81,-89,8,4c:01:43:d7:f3:26,10408164,387,-53,10407777,10408164
3541,4,1,1,2412,-83,-89,6,78:67:0e:38:6c:d3,10419061,2736,8161,10416325,10419061
3542,4,11,1,2412,-73,-89,16,48:dd:0c:7d:86:27,10421819,362,2396,10421457,10421819
3543,4,11,1,2412,-72,-89,17,48:dd:0c:7d:86:23,10422194,323,52,10421871,10422194
3544,4,11,1,2412,-74,-89,15,48:dd:0c:7d:86:25,10422529,382,-47,10422147,10422529
3545,6,6,1,2412,-89,-89,0,,10424026,44,1453,10423982,10424026
3546,6,6,1,2412,-62,-89,27,12:86:8c:5f:93:1e,10426706,332,2348,10426374,10426706
3547,4,1,1,2412,-84,-89,5,,10431929,304,4919,10431625,10431929
3548,6,6,1,2412,-89,-89,0,,10432349,44,376,10432305,10432349
3549,4,1,1,2412,-84,-89,5,00:26:62:eb:ea:74,10432714,968,-603,10431746,10432714
3550,6,6,1,2412,-83,-89,6,,10444666,44,11908,10444622,10444666
3551,6,24,1,2412,-85,-89,4,,10444779,28,85,10444751,10444779
3552,4,11,1,2412,-83,-89,6,4c:01:43:ec:a0:69,10446176,361,1036,10445815,10446176
3553,4,11,1,2412,-84,-89,5,4c:01:43:ec:a0:63,10446549,322,51,10446227,10446549
3554,6,6,1,2412,-88,-89,1,,10458299,44,11706,10458255,10458299
3555,4,1,1,2412,-88,-89,1,78:67:0e:c4:a8:42,10463180,1888,2993,10461292,10463180
3556,6,6,1,2412,-89,-89,0,,10467066,44,3842,10467022,10467066
3557,6,6,1,2412,-88,-89,1,,10469082,44,1972,10469038,10469082
3558,6,24,1,2412,-82,-89,7,,10470964,28,1854,10470936,10470964
3559,6,6,1,2412,-57,-89,32,32:86:8c:5f:93:1e,10477905,332,6609,10477573,10477905
3560,6,24,1,2412,-82,-89,7,,10483535,28,5602,10483507,10483535
3561,6,6,1,2412,-89,-89,0,,10489211,44,5632,10489167,10489211
3562,6,12,1,2412,-82,-89,7,,10490613,32,1370,10490581,10490613
3563,6,12,1,2412,-86,-89,3,,10491266,32,621,10491234,10491266
3564,6,12,1,2412,-82,-89,7,,10492107,32,809,10492075,10492107
3565,7,26,1,2412,-84,-89,5,94:9f:3e:53:c1:ef,10492574,88,379,10492486,10492574
3566,6,24,1,2412,-83,-89,6,,10498713,28,6111,10498685,10498713
3567,4,1,1,2412,-75,-89,14,b0:e4:d5:32:ec:8a,10499626,1960,-1047,10497666,10499626
3568,6,6,1,2412,-56,-89,33,10:86:8c:5f:93:1e,10503506,344,3536,10503162,10503506
3569,4,1,1,2412,-63,-89,26,94:a6:7e:c9:98:67,10506609,2464,639,10504145,10506609
3570,4,11,1,2412,-84,-89,5,4c:01:43:d7:f3:29,10509855,362,2884,10509493,10509855
3571,4,11,1,2412,-84,-89,5,4c:01:43:d7:f3:23,10510229,322,52,10509907,10510229
3572,4,11,1,2412,-79,-89,10,4c:01:43:d7:f3:26,10510564,387,-52,10510177,10510564
3573,4,11,1,2412,-76,-89,13,48:dd:0c:7d:86:23,10512320,254,1502,10512066,10512320
3574,4,11,1,2412,-78,-89,11,48:dd:0c:90:e3:83,10512623,254,49,10512369,10512623
3575,4,11,1,2412,-87,-89,2,48:dd:0c:92:4b:e5,10513610,382,605,10513228,10513610
3576,6,6,1,2412,-87,-89,2,3c:bd:c5:ee:96:6d,10513858,68,180,10513790,10513858
3577,6,6,1,2412,-87,-89,2,,10527224,44,13322,10527180,10527224
3578,6,6,1,2412,-87,-89,2,3c:bd:c5:ee:96:6d,10528737,68,1445,10528669,10528737
3579,6,6,1,2412,-58,-89,31,12:86:8c:5f:93:1e,10529106,332,37,10528774,10529106
3580,6,6,1,2412,-90,-89,-1,,10538500,44,9350,10538456,10538500
3581,6,6,1,2412,-87,-89,2,e2:db:d1:d1:b0:4a,10539945,444,1001,10539501,10539945
3582,6,6,1,2412,-90,-89,-1,e2:db:d1:d1:b0:4b,10540413,408,60,10540005,10540413
3583,6,6,1,2412,-87,-89,2,e2:db:d1:d1:b0:4a,10542069,1332,324,10540737,10542069
3584,6,6,1,2412,-90,-89,-1,e2:db:d1:d1:b0:4a,10543757,1360,328,10542397,10543757
3585,4,11,1,2412,-82,-89,7,4c:01:43:ec:a0:69,10548123,361,4005,10547762,10548123
3586,4,11,1,2412,-82,-89,7,4c:01:43:ec:a0:66,10548832,387,322,10548445,10548832
3587,4,11,1,2412,-79,-89,10,48:dd:0c:90:e3:87,10549343,362,149,10548981,10549343
3588,4,11,1,2412,-78,-89,11,48:dd:0c:90:e3:83,10549718,323,52,10549395,10549718
3589,4,11,1,2412,-79,-89,10,48:dd:0c:90:e3:85,10550053,382,-47,10549671,10550053
3590,6,6,1,2412,-89,-89,0,,10550497,44,400,10550453,10550497
3591,6,6,1,2412,-89,-89,0,,10552438,44,1897,10552394,10552438
3592,4,1,1,2412,-87,-89,2,,10553882,304,1140,10553578,10553882
3593,6,6,1,2412,-55,-89,34,52:86:8c:5f:93:1e,10554706,332,492,10554374,10554706
3594,4,1,1,2412,-86,-89,3,,10569582,304,14572,10569278,10569582
3595,6,6,1,2412,-56,-89,33,32:86:8c:5f:93:1e,10580307,332,10393,10579975,10580307
3596,4,1,1,2412,-88,-89,1,ce:f4:11:65:3f:f8,10582002,2072,-377,10579930,10582002
3597,6,24,1,2412,-80,-89,9,,10594009,28,11979,10593981,10594009
3598,6,24,1,2412,-81,-89,8,,10595001,28,964,10594973,10595001
3599,6,24,1,2412,-80,-89,9,,10595642,28,613,10595614,10595642
3600,6,24,1,2412,-80,-89,9,,10596289,28,619,10596261,10596289
3601,4,1,1,2412,-72,-89,17,b0:e4:d5:32:ec:8a,10602026,1960,3777,10600066,10602026
3602,4,1,1,2412,-86,-89,3,,10604025,304,1695,10603721,10604025
3603,4,1,1,2412,-86,-89,3,,10605075,304,746,10604771,10605075
3604,6,6,1,2412,-56,-89,33,10:86:8c:5f:93:1e,10605907,344,488,10605563,10605907
3605,6,24,1,2412,-88,-89,1,,10620865,28,14930,10620837,10620865
3606,6,6,1,2412,-87,-89,2,,10620986,44,77,10620942,10620986
3607,4,1,1,2412,-84,-89,5,ac:67:84:84:8a:07,10621891,416,489,10621475,10621891
3608,4,1,1,2412,-90,-89,-1,78:67:0e:38:6c:d3,10623861,2736,-766,10621125,10623861
3609,6,24,1,2412,-85,-89,4,,10630966,28,7077,10630938,10630966
3610,6,6,1,2412,-60,-89,29,12:86:8c:5f:93:1e,10631506,332,208,10631174,10631506
3611,4,1,1,2412,-90,-89,-1,70:3a:cb:63:35:b2,10632030,2216,-1692,10629814,10632030
3612,4,11,1,2412,-80,-89,9,4c:01:43:ec:a0:63,10650805,322,18453,10650483,10650805
3613,4,11,1,2412,-77,-89,12,48:dd:0c:90:e3:87,10651743,362,576,10651381,10651743
3614,4,11,1,2412,-70,-89,19,48:dd:0c:90:e3:83,10652117,323,51,10651794,10652117
3615,4,11,1,2412,-76,-89,13,48:dd:0c:90:e3:85,10652453,382,-46,10652071,10652453
3616,6,6,1,2412,-87,-89,2,34:15:13:b7:0a:84,10652707,64,190,10652643,10652707
3617,6,6,1,2412,-80,-89,9,,10652789,44,38,10652745,10652789
3618,6,6,1,2412,-86,-89,3,0a:a7:c0:a3:8d:73,10660839,408,7642,10660431,10660839
3619,4,1,1,2412,-89,-89,0,d8:9c:8e:01:4c:6a,10666709,2952,2918,10663757,10666709
3620,6,6,1,2412,-87,-89,2,,10700526,44,33773,10700482,10700526
3621,6,6,1,2412,-90,-89,-1,,10701128,44,558,10701084,10701128
3622,4,1,1,2412,-91,-89,-2,ac:67:84:84:8a:07,10706511,416,4967,10706095,10706511
3623,6,6,1,2412,-60,-89,29,10:86:8c:5f:93:1e,10708307,344,1452,10707963,10708307
3624,6,24,1,2412,-86,-89,3,,10710971,28,2636,10710943,10710971
3625,4,1,1,2412,-91,-89,-2,bc:98:df:ff:0f:8b,10711248,2568,-2291,10708680,10711248
3626,4,1,1,2412,-68,-89,21,94:a6:7e:c9:98:67,10713856,2464,144,10711392,10713856
3627,4,1,1,2412,-82,-89,7,,10717010,304,2850,10716706,10717010
3628,4,11,1,2412,-85,-89,4,48:dd:0c:92:4b:e7,10717673,362,301,10717311,10717673
3629,6,24,1,2412,-84,-89,5,,10723584,28,5883,10723556,10723584
3630,4,1,1,2412,-86,-89,3,78:67:0e:38:6c:d3,10726262,2736,-58,10723526,10726262
3631,4,11,1,2412,-82,-89,7,48:dd:0c:7d:86:27,10729021,362,2397,10728659,10729021
3632,4,11,1,2412,-81,-89,8,48:dd:0c:7d:86:23,10729395,323,51,10729072,10729395
3633,4,11,1,2412,-82,-89,7,48:dd:0c:7d:86:25,10729731,382,-46,10729349,10729731
3634,6,6,1,2412,-83,-89,6,40:b0:34:b7:01:d5,10732069,576,1762,10731493,10732069
3635,6,6,1,2412,-59,-89,30,12:86:8c:5f:93:1e,10733908,332,1507,10733576,10733908
3636,4,1,1,2412,-81,-89,8,3c:bd:c5:ee:96:6d,10744360,752,9700,10743608,10744360
3637,6,6,1,2412,-89,-89,0,e2:db:d1:d1:b0:4a,10747948,392,3196,10747556,10747948
3638,6,6,1,2412,-87,-89,2,e2:db:d1:d1:b0:4a,10748373,380,45,10747993,10748373
3639,6,6,1,2412,-88,-89,1,,10748950,44,533,10748906,10748950
3640,4,1,1,2412,-84,-89,5,,10750041,304,787,10749737,10750041
3641,4,11,1,2412,-83,-89,6,48:dd:0c:90:e3:87,10754143,362,3740,10753781,10754143
3642,4,11,1,2412,-81,-89,8,48:dd:0c:90:e3:83,10754517,323,51,10754194,10754517
3643,4,11,1,2412,-83,-89,6,48:dd:0c:90:e3:85,10754852,382,-47,10754470,10754852
3644,4,1,1,2412,-87,-89,2,ac:67:84:84:8a:07,10756812,416,1544,10756396,10756812
3645,6,6,1,2412,-84,-89,5,0a:a7:c0:a3:8d:70,10762550,464,5274,10762086,10762550
3646,6,6,1,2412,-85,-89,4,0a:a7:c0:a3:8d:71,10763056,408,98,10762648,10763056
3647,6,6,1,2412,-85,-89,4,0a:a7:c0:a3:8d:73,10763488,408,24,10763080,10763488
3648,6,6,1,2412,-85,-89,4,0a:a7:c0:a3:8d:75,10763947,408,51,10763539,10763947
3649,4,1,1,2412,-82,-89,7,78:67:0e:c4:a8:42,10766331,2736,-352,10763595,10766331
3650,6,6,1,2412,-88,-89,1,,10773072,44,6697,10773028,10773072
3651,4,1,1,2412,-83,-89,6,,10774616,304,1240,10774312,10774616
3652,4,1,1,2412,-82,-89,7,,10775898,304,978,10775594,10775898
3653,6,6,1,2412,-87,-89,2,,10785515,44,9573,10785471,10785515
3654,6,6,1,2412,-85,-89,4,e2:db:d1:d1:b0:4a,10790058,68,4475,10789990,10790058
3655,6,6,1,2412,-86,-89,3,,10791508,44,1406,10791464,10791508
3656,6,6,1,2412,-89,-89,0,e2:db:d1:d1:b0:4a,10791784,68,208,10791716,10791784
3657,6,6,1,2412,-86,-89,3,,10791937,44,109,10791893,10791937
3658,6,6,1,2412,-87,-89,2,,10793484,44,1503,10793440,10793484
3659,4,1,1,2412,-84,-89,5,,10794000,304,212,10793696,10794000
3660,6,6,1,2412,-87,-89,2,3c:bd:c5:ee:96:6d,10795845,68,1777,10795777,10795845
3661,6,24,1,2412,-85,-89,4,,10804566,28,8693,10804538,10804566
3662,4,1,1,2412,-73,-89,16,b0:e4:d5:32:ec:8a,10806824,1960,298,10804864,10806824
3663,6,6,1,2412,-84,-89,5,,10809272,44,2404,10809228,10809272
3664,4,1,1,2412,-78,-89,11,bc:98:df:ff:0f:8b,10810866,2568,-974,10808298,10810866
3665,6,6,1,2412,-59,-89,30,10:86:8c:5f:93:1e,10813289,344,2079,10812945,10813289
3666,4,1,1,2412,-65,-89,24,94:a6:7e:c9:98:67,10813824,2464,-1929,10811360,10813824
3667,4,11,1,2412,-55,-89,34,10:86:8c:5f:93:1e,10816317,347,2146,10815970,10816317
3668,6,6,1,2412,-64,-89,25,b4:e6:2d:b4:ff:71,10816556,64,175,10816492,10816556
3669,6,6,1,2412,-59,-89,30,,10816637,44,37,10816593,10816637
3670,6,6,1,2412,-86,-89,3,,10819717,44,3036,10819673,10819717
3671,4,11,1,2412,-74,-89,15,48:dd:0c:7d:86:27,10831421,362,11342,10831059,10831421
3672,4,11,1,2412,-74,-89,15,48:dd:0c:7d:86:23,10831795,323,51,10831472,10831795
3673,4,11,1,2412,-74,-89,15,48:dd:0c:7d:86:25,10832130,382,-47,10831748,10832130
3674,6,6,1,2412,-84,-89,5,40:b0:34:b7:01:d5,10834470,576,1764,10833894,10834470
3675,6,6,1,2412,-87,-89,2,,10835516,44,1002,10835472,10835516
3676,6,6,1,2412,-86,-89,3,,10835859,44,299,10835815,10835859
3677,6,6,1,2412,-59,-89,30,12:86:8c:5f:93:1e,10836308,332,117,10835976,10836308
3678,6,6,1,2412,-85,-89,4,,10837095,44,743,10837051,10837095
3679,4,11,1,2412,-75,-89,14,48:dd:0c:7d:86:23,10847835,254,10486,10847581,10847835
3680,6,6,1,2412,-87,-89,2,e2:db:d1:d1:b0:4a,10848091,68,188,10848023,10848091
3681,4,1,1,2412,-90,-89,-1,3c:bd:c5:b9:4d:74,10854189,912,5186,10853277,10854189
3682,4,11,1,2412,-83,-89,6,4c:01:43:ec:a0:69,10855229,361,679,10854868,10855229
3683,4,11,1,2412,-82,-89,7,4c:01:43:ec:a0:63,10855603,322,52,10855281,10855603
3684,4,11,1,2412,-82,-89,7,4c:01:43:ec:a0:66,10855937,387,-53,10855550,10855937
3685,4,11,1,2412,-80,-89,9,48:dd:0c:90:e3:87,10856542,362,243,10856180,10856542
3686,4,11,1,2412,-80,-89,9,48:dd:0c:90:e3:83,10856917,323,52,10856594,10856917
3687,4,11,1,2412,-79,-89,10,48:dd:0c:90:e3:85,10857252,382,-47,10856870,10857252
3688,6,6,1,2412,-58,-89,31,52:86:8c:5f:93:1e,10861908,332,4324,10861576,10861908
3689,6,6,1,2412,-87,-89,2,0a:a7:c0:a3:8d:71,10866780,408,4464,10866372,10866780
3690,6,6,1,2412,-87,-89,2,0a:a7:c0:a3:8d:73,10867212,408,24,10866804,10867212
3691,6,6,1,2412,-86,-89,3,0a:a7:c0:a3:8d:75,10867644,408,24,10867236,10867644
3692,4,1,1,2412,-84,-89,5,78:67:0e:c4:a8:42,10868731,2736,-1649,10865995,10868731
3693,4,1,1,2412,-85,-89,4,,10882216,304,13181,10881912,10882216
3694,6,6,1,2412,-57,-89,32,32:86:8c:5f:93:1e,10887509,332,4961,10887177,10887509
3695,6,6,1,2412,-89,-89,0,e2:db:d1:d1:b0:4a,10888365,68,788,10888297,10888365
3696,4,11,1,2412,-83,-89,6,,10891116,107,2644,10891009,10891116
3697,6,24,1,2412,-82,-89,7,78:67:0e:c4:a8:42,10891234,32,86,10891202,10891234
3698,6,6,1,2412,-89,-89,0,,10904554,44,13276,10904510,10904554
3699,4,1,1,2412,-74,-89,15,b0:e4:d5:32:ec:8a,10909223,1960,2709,10907263,10909223
3700,6,6,1,2412,-86,-89,3,,10911357,44,2090,10911313,10911357
3701,4,1,1,2412,-79,-89,10,bc:98:df:ff:0f:8b,10913258,2568,-667,10910690,10913258
3702,4,1,1,2412,-68,-89,21,94:a6:7e:c9:98:67,10916225,2464,503,10913761,10916225
3703,4,1,1,2412,-77,-89,12,78:67:0e:38:6c:d3,10931062,2736,12101,10928326,10931062
3704,4,11,1,2412,-61,-89,28,48:dd:0c:7d:86:27,10933822,362,2398,10933460,10933822
3705,4,11,1,2412,-78,-89,11,48:dd:0c:7d:86:23,10934196,323,51,10933873,10934196
3706,4,11,1,2412,-79,-89,10,48:dd:0c:7d:86:25,10934531,382,-47,10934149,10934531
3707,6,6,1,2412,-85,-89,4,40:b0:34:b7:01:d5,10936871,576,1764,10936295,10936871
3708,6,6,1,2412,-87,-89,2,,10938168,44,1253,10938124,10938168
3709,6,6,1,2412,-61,-89,28,12:86:8c:5f:93:1e,10938708,332,208,10938376,10938708
3710,6,6,1,2412,-87,-89,2,e2:db:d1:d1:b0:4d,10950455,408,11339,10950047,10950455
3711,6,24,1,2412,-81,-89,8,,10956335,28,5852,10956307,10956335
3712,4,11,1,2412,-86,-89,3,4c:01:43:ec:a0:69,10957628,361,932,10957267,10957628
3713,4,11,1,2412,-80,-89,9,48:dd:0c:90:e3:87,10958942,362,952,10958580,10958942
3714,4,11,1,2412,-78,-89,11,48:dd:0c:90:e3:83,10959316,323,51,10958993,10959316
3715,4,11,1,2412,-77,-89,12,48:dd:0c:90:e3:85,10959652,382,-46,10959270,10959652
3716,6,24,1,2412,-86,-89,3,,10963551,28,3871,10963523,10963551
3717,6,6,1,2412,-62,-89,27,52:86:8c:5f:93:1e,10964309,332,426,10963977,10964309
3718,6,6,1,2412,-88,-89,1,0a:a7:c0:a3:8d:70,10967874,464,3101,10967410,10967874
3719,6,6,1,2412,-60,-89,29,32:86:8c:5f:93:1e,10989910,332,21704,10989578,10989910
3720,4,1,1,2412,-91,-89,-2,,10993602,304,3388,10993298,10993602
3721,6,6,1,2412,-62,-89,27,b4:e6:2d:b4:ff:71,11000422,64,6756,11000358,11000422
3722,6,6,1,2412,-61,-89,28,,11000502,44,36,11000458,11000502
3723,6,24,1,2412,-84,-89,5,,11002190,28,1660,11002162,11002190
3724,6,24,1,2412,-89,-89,0,,11007264,28,5046,11007236,11007264
3725,6,6,1,2412,-89,-89,0,,11007380,44,72,11007336,11007380
3726,6,6,1,2412,-88,-89,1,,11008216,44,792,11008172,11008216
3727,4,1,1,2412,-92,-89,-3,ac:67:84:84:8a:07,11009279,416,647,11008863,11009279
3728,4,1,1,2412,-90,-89,-1,,11009708,304,125,11009404,11009708
3729,4,1,1,2412,-81,-86,5,bc:98:df:ff:0f:8b,11015652,2568,3376,11013084,11015652
3730,6,6,1,2412,-61,-86,25,10:86:8c:5f:93:1e,11018076,344,2080,11017732,11018076
3731,4,1,1,2412,-65,-86,21,94:a6:7e:c9:98:67,11018611,2464,-1929,11016147,11018611
3732,6,6,1,2412,-87,-86,-1,,11024109,44,5454,11024065,11024109
3733,6,6,1,2412,-87,-86,-1,e2:db:d1:d1:b0:4a,11028672,68,4495,11028604,11028672
3734,4,11,1,2412,-76,-86,10,48:dd:0c:7d:86:27,11036221,362,7187,11035859,11036221
3735,4,11,1,2412,-77,-86,9,48:dd:0c:7d:86:23,11036596,323,52,11036273,11036596
3736,4,11,1,2412,-78,-86,8,48:dd:0c:7d:86:25,11036931,382,-47,11036549,11036931
3737,6,6,1,2412,-60,-86,26,12:86:8c:5f:93:1e,11041109,332,3846,11040777,11041109
3738,4,1,1,2412,-89,-86,-3,00:26:62:eb:ea:74,11049878,968,7801,11048910,11049878
3739,6,6,1,2412,-85,-86,1,,11051764,44,1842,11051720,11051764
3740,6,6,1,2412,-86,-86,0,e2:db:d1:d1:b0:4a,11051939,444,-269,11051495,11051939
3741,6,6,1,2412,-87,-86,-1,e2:db:d1:d1:b0:4d,11052884,408,537,11052476,11052884
3742,4,11,1,2412,-85,-86,1,4c:01:43:ec:a0:69,11060027,361,6782,11059666,11060027
3743,4,11,1,2412,-85,-86,1,4c:01:43:ec:a0:63,11060401,322,52,11060079,11060401
3744,4,11,1,2412,-85,-86,1,4c:01:43:ec:a0:66,11060735,387,-53,11060348,11060735
3745,4,11,1,2412,-77,-86,9,48:dd:0c:90:e3:87,11061342,362,245,11060980,11061342
3746,4,11,1,2412,-79,-86,7,48:dd:0c:90:e3:83,11061716,323,51,11061393,11061716
3747,4,11,1,2412,-79,-86,7,48:dd:0c:90:e3:85,11062052,382,-46,11061670,11062052
3748,6,6,1,2412,-86,-86,0,3c:bd:c5:ee:96:6d,11062617,68,497,11062549,11062617
3749,6,6,1,2412,-87,-86,-1,3c:bd:c5:ee:96:6d,11062890,68,205,11062822,11062890
3750,6,6,1,2412,-63,-86,23,52:86:8c:5f:93:1e,11066710,332,3488,11066378,11066710
3751,6,6,1,2412,-91,-86,-5,0a:a7:c0:a3:8d:70,11069477,464,2303,11069013,11069477
3752,6,6,1,2412,-89,-86,-3,0a:a7:c0:a3:8d:71,11069966,408,81,11069558,11069966
3753,4,1,1,2412,-87,-86,-1,78:67:0e:c4:a8:42,11074657,2736,1955,11071921,11074657
3754,6,6,1,2412,-85,-86,1,,11077417,44,2716,11077373,11077417
3755,4,1,1,2412,-89,-86,-3,04:a2:22:bf:24:52,11077659,2512,-2270,11075147,11077659
3756,4,1,1,2412,-89,-86,-3,,11082647,304,4684,11082343,11082647
3757,4,1,1,2412,-87,-86,-1,,11083830,304,879,11083526,11083830
3758,4,1,1,2412,-90,-86,-4,10:7b:44:eb:35:60,11091740,384,7526,11091356,11091740
3759,4,1,1,2412,-91,-86,-5,ac:67:84:84:8a:07,11093016,448,828,11092568,11093016
3760,4,1,1,2412,-92,-86,-6,ce:f4:11:65:3f:f8,11094001,2072,-1087,11091929,11094001
3761,6,24,1,2412,-85,-86,1,e2:db:d1:d1:b0:4a,11099864,28,5835,11099836,11099864
3762,6,24,1,2412,-84,-86,2,,11108475,28,8583,11108447,11108475
3763,6,24,1,2412,-81,-86,5,,11111275,28,2772,11111247,11111275
3764,4,1,1,2412,-69,-86,17,b0:e4:d5:32:ec:8a,11114022,1960,787,11112062,11114022
3765,4,1,1,2412,-86,-86,0,bc:98:df:ff:0f:8b,11118051,2568,1461,11115483,11118051
3766,6,6,1,2412,-60,-86,26,10:86:8c:5f:93:1e,11120475,344,2080,11120131,11120475
3767,4,1,1,2412,-61,-86,25,94:a6:7e:c9:98:67,11121010,2464,-1929,11118546,11121010
3768,4,11,1,2412,-82,-86,4,4c:01:43:d7:f3:29,11124252,362,2880,11123890,11124252
3769,4,11,1,2412,-82,-86,4,4c:01:43:d7:f3:23,11124626,322,52,11124304,11124626
3770,4,11,1,2412,-75,-86,11,4c:01:43:d7:f3:26,11124961,387,-52,11124574,11124961
3771,6,6,1,2412,-86,-86,0,,11128608,44,3603,11128564,11128608
3772,6,6,1,2412,-86,-86,0,,11129030,44,378,11128986,11129030
3773,6,12,1,2412,-86,-86,0,,11132165,32,3103,11132133,11132165
3774,6,24,1,2412,-87,-86,-1,e2:db:d1:d1:b0:4a,11132839,28,646,11132811,11132839
3775,6,24,1,2412,-87,-86,-1,,11134303,28,1436,11134275,11134303
3776,6,6,1,2412,-86,-86,0,,11134419,44,72,11134375,11134419
3777,6,24,1,2412,-86,-86,0,,11135551,28,1104,11135523,11135551
3778,4,1,1,2412,-81,-86,5,78:67:0e:38:6c:d3,11135863,2736,-2424,11133127,11135863
3779,4,11,1,2412,-73,-86,13,48:dd:0c:7d:86:27,11138621,362,2396,11138259,11138621
3780,4,11,1,2412,-74,-86,12,48:dd:0c:7d:86:23,11138996,323,52,11138673,11138996
3781,4,11,1,2412,-73,-86,13,48:dd:0c:7d:86:25,11139331,382,-47,11138949,11139331
3782,6,6,1,2412,-59,-86,27,12:86:8c:5f:93:1e,11143511,332,3848,11143179,11143511
3783,6,6,1,2412,-88,-86,-2,e2:db:d1:d1:b0:4a,11154334,444,10379,11153890,11154334
3784,6,6,1,2412,-88,-86,-2,e2:db:d1:d1:b0:4d,11155252,408,510,11154844,11155252
3785,6,6,1,2412,-88,-86,-2,e2:db:d1:d1:b0:4a,11156340,308,780,11156032,11156340
3786,4,11,1,2412,-77,-86,9,48:dd:0c:90:e3:87,11163742,362,7040,11163380,11163742
3787,4,11,1,2412,-77,-86,9,48:dd:0c:90:e3:83,11164116,323,51,11163793,11164116
3788,4,11,1,2412,-78,-86,8,48:dd:0c:90:e3:85,11164451,382,-47,11164069,11164451
3789,6,24,1,2412,-83,-86,3,,11165112,28,633,11165084,11165112
3790,6,24,1,2412,-86,-86,0,,11168383,28,3243,11168355,11168383
3791,6,24,1,2412,-82,-86,4,,11168492,28,81,11168464,11168492
3792,6,6,1,2412,-58,-86,28,52:86:8c:5f:93:1e,11169110,332,286,11168778,11169110
3793,6,6,1,2412,-90,-86,-4,0a:a7:c0:a3:8d:70,11171854,464,2280,11171390,11171854
3794,4,1,1,2412,-84,-86,2,78:67:0e:c4:a8:42,11175930,2736,1340,11173194,11175930
3795,6,6,1,2412,-59,-86,27,32:86:8c:5f:93:1e,11194880,332,18618,11194548,11194880
3796,6,6,1,2412,-91,-86,-5,,11199467,44,4543,11199423,11199467
3797,4,1,1,2412,-77,-86,9,78:67:0e:38:6c:d3,11201343,3472,-1596,11197871,11201343
3798,6,24,1,2412,-83,-86,3,,11209003,28,7632,11208975,11209003
3799,4,1,1,2412,-85,-86,1,78:67:0e:c4:a8:42,11209511,3472,-2964,11206039,11209511
3800,4,11,1,2412,-75,-86,11,4c:01:43:d7:f3:23,11228865,322,19032,11228543,11228865
3801,4,11,1,2412,-86,-86,0,4c:01:43:d7:f3:26,11229199,387,-53,11228812,11229199
3802,4,1,1,2412,-77,-86,9,78:67:0e:38:6c:d3,11229634,3472,-3037,11226162,11229634
3803,4,1,1,2412,-79,-86,7,78:67:0e:38:6c:d3,11238263,2736,5893,11235527,11238263
3804,4,11,1,2412,-72,-86,14,48:dd:0c:7d:86:27,11241022,362,2397,11240660,11241022
3805,4,11,1,2412,-73,-86,13,48:dd:0c:7d:86:23,11241396,323,51,11241073,11241396
3806,4,11,1,2412,-71,-86,15,48:dd:0c:7d:86:25,11241732,382,-46,11241350,11241732
3807,6,6,1,2412,-64,-86,22,12:86:8c:5f:93:1e,11245910,332,3846,11245578,11245910
3808,4,1,1,2412,-81,-86,5,70:3a:cb:63:35:b2,11246435,2216,-1691,11244219,11246435
3809,6,24,1,2412,-83,-86,3,,11250542,28,4079,11250514,11250542
3810,6,6,1,2412,-89,-86,-3,e2:db:d1:d1:b0:4a,11261148,156,10450,11260992,11261148
3811,6,6,1,2412,-87,-86,-1,,11262883,44,1691,11262839,11262883
3812,4,11,1,2412,-86,-86,0,4c:01:43:ec:a0:69,11264824,361,1580,11264463,11264824
3813,4,11,1,2412,-87,-86,-1,4c:01:43:ec:a0:63,11265198,322,52,11264876,11265198
3814,4,11,1,2412,-73,-86,13,4c:01:43:ec:a0:66,11265533,387,-52,11265146,11265533
3815,4,11,1,2412,-76,-86,10,48:dd:0c:90:e3:87,11266141,362,246,11265779,11266141
3816,4,11,1,2412,-75,-86,11,48:dd:0c:90:e3:83,11266516,323,52,11266193,11266516
3817,4,11,1,2412,-77,-86,9,48:dd:0c:90:e3:85,11266851,382,-47,11266469,11266851
3818,6,24,1,2412,-81,-86,5,,11270026,28,3147,11269998,11270026
3819,4,11,1,2412,-85,-86,1,,11271132,107,999,11271025,11271132
3820,6,6,1,2412,-63,-86,23,52:86:8c:5f:93:1e,11271510,332,46,11271178,11271510
3821,4,1,1,2412,-87,-86,-1,78:67:0e:c4:a8:42,11275416,352,3554,11275064,11275416
3822,6,24,1,2412,-87,-86,-1,e2:db:d1:d1:b0:4a,11276301,28,857,11276273,11276301
3823,6,6,1,2412,-86,-86,0,,11281409,44,5064,11281365,11281409
3824,6,6,1,2412,-86,-86,0,,11284891,44,3438,11284847,11284891
3825,6,6,1,2412,-86,-86,0,e2:db:d1:d1:b0:4a,11285151,68,192,11285083,11285151
3826,6,6,1,2412,-88,-86,-2,,11285300,44,105,11285256,11285300
3827,6,6,1,2412,-87,-86,-1,,11285794,44,450,11285750,11285794
3828,6,6,1,2412,-87,-86,-1,,11286771,44,933,11286727,11286771
3829,6,24,1,2412,-82,-86,4,,11287294,28,495,11287266,11287294
3830,6,6,1,2412,-87,-86,-1,,11289535,44,2197,11289491,11289535
3831,6,6,1,2412,-87,-86,-1,e2:db:d1:d1:b0:4a,11293063,68,3460,11292995,11293063
3832,6,6,1,2412,-64,-86,22,32:86:8c:5f:93:1e,11297112,332,3717,11296780,11297112
3833,6,24,1,2412,-79,-86,7,,11305712,28,8572,11305684,11305712
3834,4,1,1,2412,-69,-86,17,b0:e4:d5:32:ec:8a,11318821,1960,11149,11316861,11318821
3835,6,6,1,2412,-60,-86,26,10:86:8c:5f:93:1e,11322711,344,3546,11322367,11322711
3836,4,1,1,2412,-62,-86,24,94:a6:7e:c9:98:67,11325797,2464,622,11323333,11325797
3837,4,11,1,2412,-85,-86,1,4c:01:43:d7:f3:29,11329051,362,2892,11328689,11329051
3838,4,11,1,2412,-91,-86,-5,48:dd:0c:92:4b:e3,11332446,323,3072,11332123,11332446
3839,4,11,1,2412,-74,-86,12,48:dd:0c:7d:86:27,11343422,362,10614,11343060,11343422
3840,4,11,1,2412,-73,-86,13,48:dd:0c:7d:86:23,11343796,323,51,11343473,11343796
3841,4,11,1,2412,-71,-86,15,48:dd:0c:7d:86:25,11344132,382,-46,11343750,11344132
3842,6,6,1,2412,-87,-86,-1,,11344526,44,350,11344482,11344526
3843,6,6,1,2412,-82,-86,4,40:b0:34:b7:01:d5,11346475,576,1373,11345899,11346475
3844,6,6,1,2412,-60,-86,26,12:86:8c:5f:93:1e,11348311,332,1504,11347979,11348311
3845,6,24,1,2412,-78,-86,8,,11348640,28,301,11348612,11348640
3846,6,24,1,2412,-84,-86,2,,11350976,28,2308,11350948,11350976
3847,6,6,1,2412,-86,-86,0,,11360140,44,9120,11360096,11360140
3848,6,6,1,2412,-87,-86,-1,e2:db:d1:d1:b0:4f,11360684,408,136,11360276,11360684
3849,6,24,1,2412,-84,-86,2,,11363556,28,2844,11363528,11363556
3850,4,11,1,2412,-86,-86,0,4c:01:43:ec:a0:69,11367223,361,3306,11366862,11367223
3851,4,11,1,2412,-84,-86,2,4c:01:43:ec:a0:63,11367597,322,52,11367275,11367597
3852,4,11,1,2412,-85,-86,1,4c:01:43:ec:a0:66,11367932,387,-52,11367545,11367932
3853,4,11,1,2412,-84,-86,2,48:dd:0c:90:e3:87,11368541,362,247,11368179,11368541
3854,4,11,1,2412,-83,-86,3,48:dd:0c:90:e3:83,11368916,323,52,11368593,11368916
3855,4,1,1,2412,-82,-86,4,78:67:0e:c4:a8:42,11380876,2736,9224,11378140,11380876
3856,6,6,1,2412,-88,-86,-2,,11390406,44,9486,11390362,11390406
3857,6,6,1,2412,-86,-86,0,,11390799,44,349,11390755,11390799
3858,6,6,1,2412,-87,-86,-1,,11392018,44,1175,11391974,11392018
3859,6,6,1,2412,-87,-86,-1,,11393714,44,1652,11393670,11393714
3860,6,6,1,2412,-88,-86,-2,e2:db:d1:d1:b0:4a,11395110,68,1328,11395042,11395110
3861,6,24,1,2412,-83,-86,3,,11396050,28,912,11396022,11396050
3862,6,24,1,2412,-82,-86,4,,11406687,28,10609,11406659,11406687
3863,4,11,1,2412,-85,-86,1,4c:01:43:ec:a0:63,11408917,254,1976,11408663,11408917
3864,4,11,1,2412,-84,-86,2,4c:01:43:d7:f3:23,11410014,254,843,11409760,11410014
3865,4,1,1,2412,-66,-86,20,b0:e4:d5:32:ec:8a,11421220,1960,9246,11419260,11421220
3866,6,6,1,2412,-87,-86,-1,,11423961,44,2697,11423917,11423961
3867,4,1,1,2412,-58,-86,28,94:a6:7e:c9:98:67,11428205,2464,1780,11425741,11428205
3868,4,11,1,2412,-79,-86,7,4c:01:43:d7:f3:29,11431709,362,3142,11431347,11431709
3869,4,11,1,2412,-81,-86,5,4c:01:43:d7:f3:23,11432084,322,53,11431762,11432084
3870,4,11,1,2412,-81,-86,5,4c:01:43:d7:f3:26,11432418,387,-53,11432031,11432418
3871,4,11,1,2412,-89,-86,-3,48:dd:0c:92:4b:e3,11434846,323,2105,11434523,11434846
3872,4,11,1,2412,-77,-86,9,48:dd:0c:7d:86:23,11446197,323,11028,11445874,11446197
3873,4,11,1,2412,-71,-86,15,48:dd:0c:7d:86:25,11446532,382,-47,11446150,11446532
3874,6,6,1,2412,-65,-86,21,12:86:8c:5f:93:1e,11450713,332,3849,11450381,11450713
3875,4,1,1,2412,-90,-86,-4,70:3a:cb:63:35:b2,11451237,2216,-1692,11449021,11451237
3876,6,6,1,2412,-86,-86,0,e2:db:d1:d1:b0:4b,11462037,408,10392,11461629,11462037
3877,6,6,1,2412,-89,-86,-3,e2:db:d1:d1:b0:4f,11462936,408,491,11462528,11462936
3878,4,11,1,2412,-78,-86,8,48:dd:0c:90:e3:87,11470941,362,7643,11470579,11470941
3879,4,11,1,2412,-77,-86,9,48:dd:0c:90:e3:83,11471315,323,51,11470992,11471315
3880,4,1,1,2412,-85,-86,1,,11471943,304,324,11471639,11471943
3881,6,6,1,2412,-65,-86,21,52:86:8c:5f:93:1e,11476312,332,4037,11475980,11476312
3882,6,6,1,2412,-88,-86,-2,0a:a7:c0:a3:8d:71,11479790,408,3070,11479382,11479790
3883,6,6,1,2412,-88,-86,-2,0a:a7:c0:a3:8d:73,11480249,408,51,11479841,11480249
3884,6,6,1,2412,-89,-86,-3,,11483568,44,3275,11483524,11483568
3885,4,1,1,2412,-84,-86,2,78:67:0e:c4:a8:42,11484802,2736,-1502,11482066,11484802
3886,4,1,1,2412,-74,-86,12,78:67:0e:c4:a8:42,11487575,352,2421,11487223,11487575
3887,6,6,1,2412,-90,-86,-4,,11495512,44,7893,11495468,11495512
3888,6,6,1,2412,-89,-86,-3,,11496658,44,1102,11496614,11496658
3889,4,11,1,2412,-85,-86,1,,11497017,107,252,11496910,11497017
3890,6,24,1,2412,-84,-86,2,78:67:0e:c4:a8:42,11497131,32,82,11497099,11497131
3891,6,6,1,2412,-89,-86,-3,e2:db:d1:d1:b0:4a,11501415,68,4216,11501347,11501415
3892,6,6,1,2412,-61,-86,25,32:86:8c:5f:93:1e,11501912,332,165,11501580,11501912
3893,6,24,1,2412,-85,-86,1,,11510978,28,9038,11510950,11510978
3894,4,1,1,2412,-66,-86,20,b0:e4:d5:32:ec:8a,11523619,1960,10681,11521659,11523619
3895,4,1,1,2412,-81,-86,5,bc:98:df:ff:0f:8b,11527654,2568,1467,11525086,11527654
3896,4,1,1,2412,-68,-86,18,94:a6:7e:c9:98:67,11530622,2464,504,11528158,11530622
3897,6,6,1,2412,-60,-86,26,10:86:8c:5f:93:1e,11533002,344,2036,11532658,11533002
3898,4,11,1,2412,-86,-86,0,4c:01:43:d7:f3:23,11534224,322,900,11533902,11534224
3899,6,6,1,2412,-59,-86,27,12:86:8c:5f:93:1e,11553112,332,18556,11552780,11553112
3900,6,6,1,2412,-87,-86,-1,e2:db:d1:d1:b0:4a,11556189,68,3009,11556121,11556189
3901,6,6,1,2412,-88,-86,-2,,11561001,44,4768,11560957,11561001
3902,4,1,1,2412,-91,-86,-5,00:26:62:eb:ea:74,11561247,968,-722,11560279,11561247
3903,6,6,1,2412,-90,-86,-4,e2:db:d1:d1:b0:4a,11563950,444,2259,11563506,11563950
3904,6,6,1,2412,-88,-86,-2,e2:db:d1:d1:b0:4b,11564444,408,86,11564036,11564444
3905,6,6,1,2412,-87,-86,-1,,11565914,44,1426,11565870,11565914
3906,6,6,1,2412,-91,-86,-5,3c:bd:c5:ee:96:6d,11568840,68,2858,11568772,11568840
3907,4,11,1,2412,-83,-86,3,4c:01:43:ec:a0:63,11572395,322,3233,11572073,11572395
3908,4,11,1,2412,-85,-86,1,4c:01:43:ec:a0:66,11572729,387,-53,11572342,11572729
3909,4,11,1,2412,-82,-86,4,48:dd:0c:90:e3:83,11573715,323,663,11573392,11573715
3910,4,11,1,2412,-84,-86,2,48:dd:0c:90:e3:85,11574050,382,-47,11573668,11574050
3911,6,6,1,2412,-60,-86,26,52:86:8c:5f:93:1e,11578713,332,4331,11578381,11578713
3912,4,1,1,2412,-90,-86,-4,3c:bd:c5:ee:96:6d,11581499,976,1810,11580523,11581499
3913,6,6,1,2412,-89,-86,-3,,11582666,44,1123,11582622,11582666
3914,6,6,1,2412,-87,-86,-1,0a:a7:c0:a3:8d:70,11582822,464,-308,11582358,11582822
3915,6,6,1,2412,-87,-86,-1,0a:a7:c0:a3:8d:73,11583795,408,565,11583387,11583795
3916,6,6,1,2412,-86,-86,0,0a:a7:c0:a3:8d:75,11584345,408,142,11583937,11584345
3917,4,1,1,2412,-88,-86,-2,ac:67:84:84:8a:07,11590189,448,5396,11589741,11590189
3918,6,6,1,2412,-89,-86,-3,3c:bd:c5:ee:96:6d,11590597,68,340,11590529,11590597
3919,4,1,1,2412,-90,-86,-4,ac:67:84:84:8a:07,11591067,448,22,11590619,11591067
3920,6,6,1,2412,-90,-86,-4,,11593759,44,2648,11593715,11593759
3921,6,6,1,2412,-90,-86,-4,,11594802,44,999,11594758,11594802
3922,6,24,1,2412,-82,-86,4,,11596851,28,2021,11596823,11596851
3923,6,6,1,2412,-60,-86,26,32:86:8c:5f:93:1e,11604314,332,7131,11603982,11604314
3924,6,6,1,2412,-89,-86,-3,3c:bd:c5:ee:96:6d,11609624,68,5242,11609556,11609624
3925,6,6,1,2412,-89,-86,-3,3c:bd:c5:ee:96:6d,11613573,68,3881,11613505,11613573
3926,6,6,1,2412,-89,-86,-3,3c:bd:c5:ee:96:6d,11621607,68,7966,11621539,11621607
3927,6,6,1,2412,-87,-86,-1,3c:bd:c5:ee:96:6d,11622561,68,886,11622493,11622561
3928,6,6,1,2412,-61,-86,25,10:86:8c:5f:93:1e,11629913,344,7008,11629569,11629913
3929,4,1,1,2412,-69,-86,17,94:a6:7e:c9:98:67,11633001,2464,624,11630537,11633001
3930,4,11,1,2412,-85,-86,1,4c:01:43:d7:f3:29,11636250,362,2887,11635888,11636250
3931,4,11,1,2412,-85,-86,1,4c:01:43:d7:f3:23,11636624,322,52,11636302,11636624
3932,6,6,1,2412,-87,-86,-1,,11638310,44,1642,11638266,11638310
3933,4,11,1,2412,-89,-86,-3,48:dd:0c:92:4b:e7,11639271,362,599,11638909,11639271
3934,6,6,1,2412,-88,-86,-2,,11640693,44,1378,11640649,11640693
3935,4,1,1,2412,-90,-86,-4,9c:c9:eb:c0:93:63,11644802,2720,1389,11642082,11644802
3936,4,11,1,2412,-75,-86,11,48:dd:0c:7d:86:27,11650623,362,5459,11650261,11650623
3937,4,11,1,2412,-76,-86,10,48:dd:0c:7d:86:23,11650998,323,52,11650675,11650998
3938,4,11,1,2412,-75,-86,11,48:dd:0c:7d:86:25,11651333,382,-47,11650951,11651333
3939,6,6,1,2412,-61,-86,25,12:86:8c:5f:93:1e,11655513,332,3848,11655181,11655513
3940,6,6,1,2412,-89,-86,-3,e2:db:d1:d1:b0:4a,11666341,444,10384,11665897,11666341
3941,6,6,1,2412,-88,-86,-2,e2:db:d1:d1:b0:4b,11666818,408,69,11666410,11666818
3942,6,24,1,2412,-81,-86,5,,11668330,28,1484,11668302,11668330
3943,6,6,1,2412,-88,-86,-2,,11668674,44,300,11668630,11668674
3944,4,11,1,2412,-84,-86,2,4c:01:43:ec:a0:69,11674555,361,5520,11674194,11674555
3945,4,11,1,2412,-83,-86,3,4c:01:43:ec:a0:63,11674929,322,52,11674607,11674929
3946,4,11,1,2412,-84,-86,2,4c:01:43:ec:a0:66,11675263,387,-53,11674876,11675263
3947,4,11,1,2412,-78,-86,8,48:dd:0c:90:e3:87,11675740,362,115,11675378,11675740
3948,4,11,1,2412,-77,-86,9,48:dd:0c:90:e3:83,11676115,323,52,11675792,11676115
3949,4,11,1,2412,-78,-86,8,48:dd:0c:90:e3:85,11676450,382,-47,11676068,11676450
3950,4,1,1,2412,-89,-86,-3,3c:bd:c5:2c:8c:ca,11678632,2600,-418,11676032,11678632
3951,6,6,1,2412,-60,-86,26,52:86:8c:5f:93:1e,11681114,332,2150,11680782,11681114
3952,4,1,1,2412,-87,-86,-1,78:67:0e:c4:a8:42,11687930,2736,4080,11685194,11687930
3953,4,1,1,2412,-88,-86,-2,04:a2:22:bf:24:52,11692059,2512,1617,11689547,11692059
3954,6,6,1,2412,-62,-86,24,32:86:8c:5f:93:1e,11706713,332,14322,11706381,11706713
3955,6,6,1,2412,-87,-86,-1,0a:a7:c0:a3:8d:73,11723894,308,16873,11723586,11723894
3956,6,6,1,2412,-86,-86,0,0a:a7:c0:a3:8d:75,11724234,308,32,11723926,11724234
3957,6,6,1,2412,-86,-86,0,0a:a7:c0:a3:8d:70,11724620,308,78,11724312,11724620
3958,6,6,1,2412,-86,-86,0,0a:a7:c0:a3:8d:71,11724997,308,69,11724689,11724997
3959,4,1,1,2412,-68,-86,18,b0:e4:d5:32:ec:8a,11728418,1960,1461,11726458,11728418
3960,6,24,1,2412,-79,-86,7,,11731573,28,3127,11731545,11731573
3961,4,1,1,2412,-79,-86,7,bc:98:df:ff:0f:8b,11732454,2568,-1687,11729886,11732454
3962,6,6,1,2412,-62,-86,24,10:86:8c:5f:93:1e,11734894,344,2096,11734550,11734894
3963,4,1,1,2412,-66,-86,20,94:a6:7e:c9:98:67,11735438,2464,-1920,11732974,11735438
3964,4,11,1,2412,-85,-86,1,4c:01:43:d7:f3:23,11739024,322,3264,11738702,11739024
3965,4,11,1,2412,-86,-86,0,4c:01:43:d7:f3:26,11739358,387,-53,11738971,11739358
3966,4,1,1,2412,-79,-86,7,78:67:0e:38:6c:d3,11750264,2736,8170,11747528,11750264
3967,4,11,1,2412,-71,-86,15,48:dd:0c:7d:86:27,11753023,362,2397,11752661,11753023
3968,4,11,1,2412,-71,-86,15,48:dd:0c:7d:86:23,11753398,323,52,11753075,11753398
3969,4,11,1,2412,-72,-86,14,48:dd:0c:7d:86:25,11753733,382,-47,11753351,11753733
3970,6,6,1,2412,-89,-86,-3,,11755936,44,2159,11755892,11755936
3971,6,6,1,2412,-87,-86,-1,,11756392,44,412,11756348,11756392
3972,6,6,1,2412,-65,-86,21,12:86:8c:5f:93:1e,11758351,332,1627,11758019,11758351
3973,4,1,1,2412,-90,-86,-4,cc:f4:11:65:3f:fb,11759599,2112,-864,11757487,11759599
3974,4,1,1,2412,-92,-86,-6,54:65:de:91:d4:c0,11765469,2632,3238,11762837,11765469
3975,6,6,1,2412,-89,-86,-3,e2:db:d1:d1:b0:4a,11768741,444,2828,11768297,11768741
3976,6,6,1,2412,-88,-86,-2,e2:db:d1:d1:b0:4b,11769227,408,78,11768819,11769227
3977,6,6,1,2412,-89,-86,-3,e2:db:d1:d1:b0:4d,11769686,408,51,11769278,11769686
3978,6,6,1,2412,-87,-86,-1,e2:db:d1:d1:b0:4f,11770135,408,41,11769727,11770135
3979,6,6,1,2412,-89,-86,-3,,11770669,44,490,11770625,11770669
3980,6,6,1,2412,-89,-86,-3,e2:db:d1:d1:b0:4a,11770899,548,-318,11770351,11770899
3981,6,6,1,2412,-89,-86,-3,e2:db:d1:d1:b0:4a,11771633,576,158,11771057,11771633
3982,6,24,1,2412,-86,-86,0,,11772515,28,854,11772487,11772515
3983,6,24,1,2412,-86,-86,0,,11774059,28,1516,11774031,11774059
3984,6,12,1,2412,-86,-86,0,4c:01:43:ec:a0:66,11774844,44,741,11774800,11774844
3985,6,6,1,2412,-65,-86,21,52:86:8c:5f:93:1e,11783514,332,8338,11783182,11783514
3986,6,24,1,2412,-84,-86,2,,11797366,28,13824,11797338,11797366
3987,6,6,1,2412,-63,-86,23,32:86:8c:5f:93:1e,11809114,332,11416,11808782,11809114
3988,6,6,1,2412,-88,-86,-2,,11820561,44,11403,11820517,11820561
3989,4,1,1,2412,-46,-86,40,b0:e4:d5:32:ec:8a,11830817,1960,8296,11828857,11830817
3990,6,6,1,2412,-60,-86,26,10:86:8c:5f:93:1e,11834715,344,3554,11834371,11834715
3991,4,1,1,2412,-83,-86,3,bc:98:df:ff:0f:8b,11835186,2568,-2097,11832618,11835186
3992,4,1,1,2412,-62,-86,24,94:a6:7e:c9:98:67,11837812,2464,162,11835348,11837812
3993,4,11,1,2412,-80,-86,6,4c:01:43:d7:f3:29,11841049,362,2875,11840687,11841049
3994,4,11,1,2412,-82,-86,4,4c:01:43:d7:f3:23,11841423,322,52,11841101,11841423
3995,4,11,1,2412,-82,-86,4,4c:01:43:d7:f3:26,11841758,387,-52,11841371,11841758
3996,4,11,1,2412,-76,-86,10,48:dd:0c:7d:86:25,11856133,382,13993,11855751,11856133
3997,6,6,1,2412,-84,-86,2,40:b0:34:b7:01:d5,11858480,576,1771,11857904,11858480
3998,6,6,1,2412,-60,-86,26,12:86:8c:5f:93:1e,11860315,332,1503,11859983,11860315
3999,4,1,1,2412,-91,-86,-5,70:3a:cb:63:35:b2,11860766,2216,-1765,11858550,11860766
4000,6,6,1,2412,-86,-86,0,e2:db:d1:d1:b0:4b,11871651,408,10477,11871243,11871651
4001,6,6,1,2412,-87,-86,-1,e2:db:d1:d1:b0:4d,11872082,408,23,11871674,11872082
4002,6,6,1,2412,-86,-86,0,e2:db:d1:d1:b0:4f,11872532,408,42,11872124,11872532
4003,6,6,1,2412,-87,-86,-1,,11873084,44,508,11873040,11873084
4004,4,11,1,2412,-84,-86,2,48:dd:0c:90:e3:83,11880914,323,7507,11880591,11880914
4005,4,11,1,2412,-71,-86,15,48:dd:0c:90:e3:85,11881249,382,-47,11880867,11881249
4006,6,6,1,2412,-61,-86,25,52:86:8c:5f:93:1e,11885959,332,4378,11885627,11885959
4007,4,1,1,2412,-89,-86,-3,3c:bd:c5:ee:96:6d,11888699,1056,1684,11887643,11888699
4008,6,6,1,2412,-87,-86,-1,,11901206,44,12463,11901162,11901206
4009,6,6,1,2412,-86,-86,0,,11904788,44,3538,11904744,11904788
4010,6,6,1,2412,-83,-86,3,,11906466,44,1634,11906422,11906466
4011,6,24,1,2412,-86,-86,0,,11910991,28,4497,11910963,11910991
4012,6,6,1,2412,-62,-86,24,32:86:8c:5f:93:1e,11911516,332,193,11911184,11911516
4013,6,24,1,2412,-82,-86,4,,11918685,28,7141,11918657,11918685
4014,4,1,1,2412,-73,-86,13,b0:e4:d5:32:ec:8a,11933216,1960,12571,11931256,11933216
4015,6,6,1,2412,-60,-86,26,10:86:8c:5f:93:1e,11939691,344,6131,11939347,11939691
4016,4,11,1,2412,-86,-86,0,4c:01:43:d7:f3:23,11943823,322,3810,11943501,11943823
4017,6,24,1,2412,-82,-86,4,,11950917,28,7066,11950889,11950917
4018,4,11,1,2412,-76,-86,10,48:dd:0c:7d:86:23,11955789,323,4549,11955466,11955789
4019,6,6,1,2412,-57,-86,29,12:86:8c:5f:93:1e,11962715,332,6594,11962383,11962715
4020,6,6,1,2412,-85,-86,1,,11963412,44,653,11963368,11963412
4021,6,6,1,2412,-86,-86,0,e2:db:d1:d1:b0:4d,11974495,408,10675,11974087,11974495
4022,6,6,1,2412,-86,-86,0,,11975002,44,463,11974958,11975002
4023,6,6,1,2412,-86,-86,0,e2:db:d1:d1:b0:4f,11975088,408,-322,11974680,11975088
4024,6,6,1,2412,-86,-86,0,e2:db:d1:d1:b0:4a,11975529,548,-107,11974981,11975529
4025,6,6,1,2412,-85,-86,1,e2:db:d1:d1:b0:4a,11976110,576,5,11975534,11976110
4026,6,24,1,2412,-84,-86,2,,11976837,28,699,11976809,11976837
4027,4,11,1,2412,-80,-86,6,48:dd:0c:90:e3:83,11983314,323,6154,11982991,11983314
4028,4,11,1,2412,-81,-86,5,48:dd:0c:90:e3:85,11983649,382,-47,11983267,11983649
4029,6,6,1,2412,-86,-86,0,,11984442,44,749,11984398,11984442
4030,6,6,1,2412,-86,-86,0,,11985907,44,1421,11985863,11985907
4031,6,6,1,2412,-57,-86,29,52:86:8c:5f:93:1e,11988316,332,2077,11987984,11988316
4032,6,24,1,2412,-86,-86,0,,11990986,28,2642,11990958,11990986
4033,4,1,1,2412,-85,-86,1,78:67:0e:c4:a8:42,11995130,2736,1408,11992394,11995130
4034,4,1,1,2412,-84,-86,2,78:67:0e:c4:a8:42,11997904,848,1926,11997056,11997904
4035,6,24,1,2412,-86,-86,0,,12003735,28,5803,12003707,12003735
4036,6,6,1,2412,-56,-87,31,32:86:8c:5f:93:1e,12013916,332,9849,12013584,12013916
4037,4,1,1,2412,-68,-87,19,b0:e4:d5:32:ec:8a,12035615,1960,19739,12033655,12035615
4038,4,1,1,2412,-89,-87,-2,bc:98:df:ff:0f:8b,12039666,2568,1483,12037098,12039666
4039,6,6,1,2412,-56,-87,31,10:86:8c:5f:93:1e,12042089,344,2079,12041745,12042089
4040,4,1,1,2412,-65,-87,22,94:a6:7e:c9:98:67,12042624,2464,-1929,12040160,12042624
4041,4,11,1,2412,-81,-87,6,4c:01:43:d7:f3:29,12045848,362,2862,12045486,12045848
4042,4,11,1,2412,-81,-87,6,4c:01:43:d7:f3:23,12046222,322,52,12045900,12046222
4043,4,11,1,2412,-81,-87,6,4c:01:43:d7:f3:26,12046557,387,-52,12046170,12046557
4044,6,6,1,2412,-87,-87,0,,12049140,44,2539,12049096,12049140
4045,6,6,1,2412,-86,-87,1,,12049676,44,492,12049632,12049676
4046,6,24,1,2412,-83,-87,4,,12053846,28,4142,12053818,12053846
4047,4,1,1,2412,-89,-87,-2,78:67:0e:38:6c:d3,12057465,2736,883,12054729,12057465
4048,6,6,1,2412,-55,-87,32,12:86:8c:5f:93:1e,12065422,332,7625,12065090,12065422
4049,6,24,1,2412,-82,-87,5,,12070991,28,5541,12070963,12070991
4050,6,6,1,2412,-90,-87,-3,0a:a7:c0:a3:8d:73,12094410,408,23011,12094002,12094410
4051,6,24,1,2412,-82,-87,5,,12096289,28,1851,12096261,12096289
4052,6,6,1,2412,-56,-87,31,32:86:8c:5f:93:1e,12116316,332,19695,12115984,12116316
4053,6,6,1,2412,-89,-87,-2,e2:db:d1:d1:b0:4a,12129572,68,13188,12129504,12129572
4054,4,1,1,2412,-66,-87,21,b0:e4:d5:32:ec:8a,12138015,1960,6483,12136055,12138015
4055,6,6,1,2412,-54,-87,33,10:86:8c:5f:93:1e,12144477,344,6118,12144133,12144477
4056,4,11,1,2412,-85,-87,2,4c:01:43:d7:f3:29,12148247,362,3408,12147885,12148247
4057,4,11,1,2412,-84,-87,3,4c:01:43:d7:f3:23,12148622,322,53,12148300,12148622
4058,4,11,1,2412,-85,-87,2,4c:01:43:d7:f3:26,12148956,387,-53,12148569,12148956
4059,4,1,1,2412,-87,-87,0,,12153146,304,3886,12152842,12153146
4060,4,1,1,2412,-86,-87,1,,12154405,304,955,12154101,12154405
4061,4,1,1,2412,-77,-87,10,78:67:0e:38:6c:d3,12165036,2208,8423,12162828,12165036
4062,6,6,1,2412,-53,-87,34,12:86:8c:5f:93:1e,12167943,332,2575,12167611,12167943
4063,4,1,1,2412,-90,-87,-3,d8:9c:8e:01:4c:6a,12172426,3000,1483,12169426,12172426
4064,6,6,1,2412,-89,-87,-2,e2:db:d1:d1:b0:4b,12178814,408,5980,12178406,12178814
4065,4,1,1,2412,-90,-87,-3,3c:bd:c5:ee:96:6d,12195894,976,16104,12194918,12195894
4066,4,1,1,2412,-83,-87,4,78:67:0e:c4:a8:42,12199929,2736,1299,12197193,12199929
4067,4,1,1,2412,-90,-87,-3,04:a2:22:bf:24:52,12204068,2512,1627,12201556,12204068
4068,4,1,1,2412,-81,-87,6,,12206896,304,2524,12206592,12206896
4069,4,1,1,2412,-84,-87,3,78:67:0e:c4:a8:42,12208371,352,1123,12208019,12208371
4070,6,6,1,2412,-54,-87,33,32:86:8c:5f:93:1e,12218718,332,10015,12218386,12218718
4071,6,6,1,2412,-89,-87,-2,,12226067,44,7305,12226023,12226067
4072,6,6,1,2412,-89,-87,-2,,12227130,44,1019,12227086,12227130
4073,4,1,1,2412,-71,-87,16,b0:e4:d5:32:ec:8a,12240414,1960,11324,12238454,12240414
4074,6,24,1,2412,-86,-87,1,,12243910,28,3468,12243882,12243910
4075,4,1,1,2412,-88,-87,-1,bc:98:df:ff:0f:8b,12244453,2568,-2025,12241885,12244453
4076,6,6,1,2412,-54,-87,33,10:86:8c:5f:93:1e,12246877,344,2080,12246533,12246877
4077,4,1,1,2412,-67,-87,20,94:a6:7e:c9:98:67,12247431,2464,-1910,12244967,12247431
4078,4,1,1,2412,-68,-87,19,94:a6:7e:c9:98:67,12250049,1320,1298,12248729,12250049
4079,4,1,1,2412,-67,-87,20,94:a6:7e:c9:98:67,12251433,1480,-96,12249953,12251433
4080,6,6,1,2412,-87,-87,0,,12260614,44,9137,12260570,12260614
4081,4,1,1,2412,-86,-87,1,78:67:0e:38:6c:d3,12262265,2736,-1085,12259529,12262265
4082,4,11,1,2412,-74,-87,13,48:dd:0c:7d:86:27,12265024,362,2397,12264662,12265024
4083,4,11,1,2412,-73,-87,14,48:dd:0c:7d:86:23,12265399,323,52,12265076,12265399
4084,4,11,1,2412,-74,-87,13,48:dd:0c:7d:86:25,12265734,382,-47,12265352,12265734
4085,4,1,1,2412,-90,-87,-3,00:26:62:eb:ea:74,12280316,968,13614,12279348,12280316
4086,6,6,1,2412,-90,-87,-3,e2:db:d1:d1:b0:4f,12282114,408,1390,12281706,12282114
4087,6,6,1,2412,-89,-87,-2,3c:bd:c5:ee:96:6d,12287587,68,5405,12287519,12287587
4088,4,11,1,2412,-87,-87,0,4c:01:43:ec:a0:69,12288813,361,865,12288452,12288813
4089,4,11,1,2412,-84,-87,3,48:dd:0c:90:e3:87,12290139,362,964,12289777,12290139
4090,4,11,1,2412,-85,-87,2,48:dd:0c:90:e3:83,12290513,323,51,12290190,12290513
4091,4,11,1,2412,-83,-87,4,48:dd:0c:90:e3:85,12290848,382,-47,12290466,12290848
4092,6,12,1,2412,-86,-87,1,,12292509,32,1629,12292477,12292509
4093,6,12,1,2412,-86,-87,1,,12293307,32,766,12293275,12293307
4094,6,6,1,2412,-55,-87,32,52:86:8c:5f:93:1e,12295518,332,1879,12295186,12295518
4095,6,24,1,2412,-79,-87,8,,12299176,28,3630,12299148,12299176
4096,4,1,1,2412,-81,-87,6,78:67:0e:c4:a8:42,12305102,352,5574,12304750,12305102
4097,6,12,1,2412,-86,-87,1,,12306228,32,1094,12306196,12306228
4098,4,1,1,2412,-90,-87,-3,04:a2:22:bf:24:52,12306464,2512,-2276,12303952,12306464
4099,4,1,1,2412,-89,-87,-2,04:a2:22:bf:24:52,12309002,912,1626,12308090,12309002
4100,6,12,1,2412,-87,-87,0,,12310595,32,1561,12310563,12310595
4101,6,12,1,2412,-86,-87,1,,12312117,32,1490,12312085,12312117
4102,6,6,1,2412,-54,-87,33,32:86:8c:5f:93:1e,12321119,332,8670,12320787,12321119
4103,4,1,1,2412,-76,-87,11,b0:e4:d5:32:ec:8a,12342813,1960,19734,12340853,12342813
4104,6,6,1,2412,-90,-87,-3,,12345778,44,2921,12345734,12345778
4105,6,6,1,2412,-56,-87,31,10:86:8c:5f:93:1e,12346718,344,596,12346374,12346718
4106,4,1,1,2412,-69,-87,18,94:a6:7e:c9:98:67,12349798,2464,616,12347334,12349798
4107,4,11,1,2412,-89,-87,-2,48:dd:0c:92:4b:e3,12356445,323,6324,12356122,12356445
4108,4,1,1,2412,-85,-87,2,78:67:0e:38:6c:d3,12364665,2736,5484,12361929,12364665
4109,4,11,1,2412,-78,-87,9,48:dd:0c:7d:86:27,12367424,362,2397,12367062,12367424
4110,4,11,1,2412,-77,-87,10,48:dd:0c:7d:86:23,12367798,323,51,12367475,12367798
4111,4,11,1,2412,-78,-87,9,48:dd:0c:7d:86:25,12368134,382,-46,12367752,12368134
4112,6,6,1,2412,-55,-87,32,12:86:8c:5f:93:1e,12372605,332,4139,12372273,12372605
4113,6,6,1,2412,-87,-87,0,3c:bd:c5:ee:96:6d,12387101,68,14428,12387033,12387101
4114,4,11,1,2412,-88,-87,-1,48:dd:0c:90:e3:83,12392913,323,5489,12392590,12392913
4115,4,11,1,2412,-87,-87,0,48:dd:0c:90:e3:85,12393248,382,-47,12392866,12393248
4116,6,24,1,2412,-81,-87,6,,12395086,28,1810,12395058,12395086
4117,6,6,1,2412,-56,-87,31,52:86:8c:5f:93:1e,12397919,332,2501,12397587,12397919
4118,6,6,1,2412,-90,-87,-3,e2:db:d1:d1:b0:4a,12403448,68,5461,12403380,12403448
4119,6,24,1,2412,-89,-87,-2,,12403996,28,520,12403968,12403996
4120,4,1,1,2412,-85,-87,2,78:67:0e:c4:a8:42,12404729,2736,-2003,12401993,12404729
4121,6,6,1,2412,-55,-87,32,32:86:8c:5f:93:1e,12423518,332,18457,12423186,12423518
4122,4,1,1,2412,-90,-87,-3,04:a2:22:bf:24:52,12429796,3280,2998,12426516,12429796
4123,6,24,1,2412,-82,-87,5,,12439645,28,9821,12439617,12439645
4124,4,1,1,2412,-69,-87,18,b0:e4:d5:32:ec:8a,12445212,1960,3607,12443252,12445212
4125,6,6,1,2412,-56,-87,31,10:86:8c:5f:93:1e,12449120,344,3564,12448776,12449120
4126,4,1,1,2412,-61,-87,26,94:a6:7e:c9:98:67,12452336,2464,752,12449872,12452336
4127,4,11,1,2412,-89,-87,-2,4c:01:43:d7:f3:23,12455820,322,3162,12455498,12455820
4128,4,11,1,2412,-88,-87,-1,4c:01:43:d7:f3:26,12456155,387,-52,12455768,12456155
4129,6,24,1,2412,-87,-87,0,,12472116,28,15933,12472088,12472116
4130,4,1,1,2412,-93,-87,-6,48:5d:36:d8:ef:52,12472712,1712,-1116,12471000,12472712
4131,6,6,1,2412,-88,-87,-1,40:b0:34:b7:01:d5,12474279,576,991,12473703,12474279
4132,6,6,1,2412,-57,-87,30,12:86:8c:5f:93:1e,12474880,332,269,12474548,12474880
4133,6,6,1,2412,-87,-87,0,,12483598,44,8674,12483554,12483598
4134,6,6,1,2412,-87,-87,0,e2:db:d1:d1:b0:4f,12486944,408,2938,12486536,12486944
4135,6,6,1,2412,-85,-87,2,,12490369,44,3381,12490325,12490369
4136,4,11,1,2412,-86,-87,1,4c:01:43:ec:a0:69,12493611,361,2881,12493250,12493611
4137,4,11,1,2412,-85,-87,2,4c:01:43:ec:a0:63,12493984,322,51,12493662,12493984
4138,6,6,1,2412,-86,-87,1,,12502121,44,8093,12502077,12502121
4139,6,6,1,2412,-85,-87,2,,12502635,44,470,12502591,12502635
4140,6,6,1,2412,-87,-87,0,,12503091,44,412,12503047,12503091
4141,6,6,1,2412,-85,-87,2,,12503247,44,112,12503203,12503247
4142,4,1,1,2412,-86,-87,1,3c:bd:c5:ee:96:6d,12503500,2512,-2259,12500988,12503500
4143,4,1,1,2412,-82,-87,5,78:67:0e:c4:a8:42,12510861,352,7009,12510509,12510861
4144,4,11,1,2412,-83,-87,4,,12513509,107,2541,12513402,12513509
4145,6,24,1,2412,-80,-87,7,78:67:0e:c4:a8:42,12513623,32,82,12513591,12513623
4146,4,11,1,2412,-81,-87,6,,12514157,107,427,12514050,12514157
4147,6,24,1,2412,-80,-87,7,78:67:0e:c4:a8:42,12514270,32,81,12514238,12514270
4148,4,1,1,2412,-74,-87,13,c0:8d:51:da:5c:ef,12523947,416,9261,12523531,12523947
4149,4,1,1,2412,-57,-87,30,,12524374,304,123,12524070,12524374
4150,6,6,1,2412,-56,-87,31,32:86:8c:5f:93:1e,12525920,332,1214,12525588,12525920
4151,6,24,1,2412,-81,-87,6,,12532065,28,6117,12532037,12532065
4152,6,6,1,2412,-87,-87,0,,12539606,44,7497,12539562,12539606
4153,6,6,1,2412,-55,-87,32,10:86:8c:5f:93:1e,12551520,344,11570,12551176,12551520
4154,4,1,1,2412,-67,-87,20,94:a6:7e:c9:98:67,12554606,2464,622,12552142,12554606
4155,4,11,1,2412,-72,-87,15,4c:01:43:d7:f3:23,12558220,322,3292,12557898,12558220
4156,4,11,1,2412,-87,-87,0,4c:01:43:d7:f3:26,12558554,387,-53,12558167,12558554
4157,6,24,1,2412,-87,-87,0,,12563571,28,4989,12563543,12563571
4158,4,1,1,2412,-89,-87,-2,78:67:0e:38:6c:d3,12569466,2736,3159,12566730,12569466
4159,4,11,1,2412,-76,-87,11,48:dd:0c:7d:86:27,12572225,362,2397,12571863,12572225
4160,4,11,1,2412,-76,-87,11,48:dd:0c:7d:86:23,12572599,323,51,12572276,12572599
4161,6,6,1,2412,-54,-87,33,12:86:8c:5f:93:1e,12577120,332,4189,12576788,12577120
4162,6,6,1,2412,-84,-87,3,e2:db:d1:d1:b0:4b,12588441,408,10913,12588033,12588441
4163,6,6,1,2412,-84,-87,3,e2:db:d1:d1:b0:4a,12591514,68,3005,12591446,12591514
4164,6,6,1,2412,-84,-87,3,,12591797,44,239,12591753,12591797
4165,4,1,1,2412,-91,-87,-4,3c:bd:c5:b9:4d:74,12592516,2528,-1809,12589988,12592516
4166,4,11,1,2412,-85,-87,2,4c:01:43:ec:a0:69,12596009,361,3132,12595648,12596009
4167,4,11,1,2412,-82,-87,5,4c:01:43:ec:a0:63,12596383,322,52,12596061,12596383
4168,4,11,1,2412,-83,-87,4,4c:01:43:ec:a0:66,12596718,387,-52,12596331,12596718
4169,4,11,1,2412,-82,-87,5,48:dd:0c:90:e3:87,12597338,362,258,12596976,12597338
4170,4,11,1,2412,-81,-87,6,48:dd:0c:90:e3:83,12597712,323,51,12597389,12597712
4171,4,11,1,2412,-83,-87,4,48:dd:0c:90:e3:85,12598048,382,-46,12597666,12598048
4172,6,6,1,2412,-54,-87,33,52:86:8c:5f:93:1e,12602721,332,4341,12602389,12602721
4173,4,1,1,2412,-83,-87,4,78:67:0e:c4:a8:42,12609529,2736,4072,12606793,12609529
4174,4,1,1,2412,-79,-87,8,04:a2:22:bf:24:52,12616218,1088,5601,12615130,12616218
4175,6,6,1,2412,-84,-87,3,e2:db:d1:d1:b0:4a,12617445,68,1159,12617377,12617445
4176,6,6,1,2412,-85,-87,2,,12620439,44,2950,12620395,12620439
4177,6,24,1,2412,-85,-87,2,e2:db:d1:d1:b0:4a,12620572,28,105,12620544,12620572
4178,6,6,1,2412,-86,-87,1,,12620802,44,186,12620758,12620802
4179,6,6,1,2412,-85,-87,2,,12623664,44,2818,12623620,12623664
4180,6,6,1,2412,-55,-87,32,32:86:8c:5f:93:1e,12628321,332,4325,12627989,12628321
4181,4,1,1,2412,-91,-87,-4,ce:f4:11:65:3f:f8,12629998,2072,-395,12627926,12629998
4182,6,6,1,2412,-84,-87,3,,12632147,44,2105,12632103,12632147
4183,6,24,1,2412,-85,-87,2,,12643716,28,11541,12643688,12643716
4184,6,24,1,2412,-86,-87,1,,12648501,28,4757,12648473,12648501
4185,4,1,1,2412,-70,-87,17,b0:e4:d5:32:ec:8a,12650011,1960,-450,12648051,12650011
4186,6,24,1,2412,-82,-87,5,,12653841,28,3802,12653813,12653841
4187,4,1,1,2412,-66,-87,21,94:a6:7e:c9:98:67,12657056,2464,751,12654592,12657056
4188,4,1,1,2412,-67,-87,20,94:a6:7e:c9:98:67,12659638,2296,286,12657342,12659638
4189,6,6,1,2412,-54,-87,33,12:86:8c:5f:93:1e,12679521,332,19551,12679189,12679521
4190,6,6,1,2412,-88,-87,-1,,12682961,44,3396,12682917,12682961
4191,6,6,1,2412,-85,-87,2,e2:db:d1:d1:b0:4d,12691318,408,7949,12690910,12691318
4192,6,6,1,2412,-86,-87,1,,12692282,44,920,12692238,12692282
4193,4,1,1,2412,-87,-87,0,,12692485,304,-101,12692181,12692485
4194,4,11,1,2412,-78,-87,9,4c:01:43:ec:a0:69,12698408,361,5562,12698047,12698408
4195,4,11,1,2412,-83,-87,4,4c:01:43:ec:a0:63,12698782,322,52,12698460,12698782
4196,4,11,1,2412,-84,-87,3,4c:01:43:ec:a0:66,12699117,387,-52,12698730,12699117
4197,4,11,1,2412,-78,-87,9,48:dd:0c:90:e3:87,12699738,362,259,12699376,12699738
4198,4,11,1,2412,-79,-87,8,48:dd:0c:90:e3:83,12700112,323,51,12699789,12700112
4199,4,11,1,2412,-79,-87,8,48:dd:0c:90:e3:85,12700447,382,-47,12700065,12700447
4200,6,6,1,2412,-53,-87,34,52:86:8c:5f:93:1e,12705121,332,4342,12704789,12705121
4201,6,6,1,2412,-86,-87,1,,12709209,44,4044,12709165,12709209
4202,6,24,1,2412,-85,-87,2,,12711004,28,1767,12710976,12711004
4203,4,1,1,2412,-86,-87,1,78:67:0e:c4:a8:42,12711929,2736,-1811,12709193,12711929
4204,6,6,1,2412,-87,-87,0,3c:bd:c5:ee:96:6d,12715110,52,3129,12715058,12715110
4205,6,6,1,2412,-88,-87,-1,3c:bd:c5:ee:96:6d,12715658,52,496,12715606,12715658
4206,6,6,1,2412,-88,-87,-1,3c:bd:c5:ee:96:6d,12720925,52,5215,12720873,12720925
4207,4,1,1,2412,-90,-87,-3,04:a2:22:bf:24:52,12725338,3280,1133,12722058,12725338
4208,6,24,1,2412,-85,-87,2,,12755221,28,29855,12755193,12755221
4209,6,6,1,2412,-55,-87,32,10:86:8c:5f:93:1e,12756321,344,756,12755977,12756321
4210,4,1,1,2412,-65,-87,22,94:a6:7e:c9:98:67,12759405,2464,620,12756941,12759405
4211,4,11,1,2412,-88,-87,-1,4c:01:43:d7:f3:29,12762644,362,2877,12762282,12762644
4212,4,11,1,2412,-89,-87,-2,4c:01:43:d7:f3:23,12763019,322,53,12762697,12763019
4213,4,11,1,2412,-90,-87,-3,4c:01:43:d7:f3:26,12763354,387,-52,12762967,12763354
4214,4,1,1,2412,-83,-87,4,78:67:0e:38:6c:d3,12774266,2736,8176,12771530,12774266
4215,4,11,1,2412,-80,-87,7,48:dd:0c:7d:86:27,12777025,362,2397,12776663,12777025
4216,4,11,1,2412,-78,-87,9,48:dd:0c:7d:86:23,12777400,323,52,12777077,12777400
4217,4,11,1,2412,-77,-87,10,48:dd:0c:7d:86:25,12777735,382,-47,12777353,12777735
4218,6,6,1,2412,-54,-87,33,12:86:8c:5f:93:1e,12782320,332,4253,12781988,12782320
4219,6,24,1,2412,-86,-87,1,,12792001,28,9653,12791973,12792001
4220,6,6,1,2412,-88,-87,-1,e2:db:d1:d1:b0:4a,12792753,444,308,12792309,12792753
4221,6,6,1,2412,-89,-87,-2,e2:db:d1:d1:b0:4b,12793221,408,60,12792813,12793221
4222,6,6,1,2412,-87,-87,0,e2:db:d1:d1:b0:4d,12793652,408,23,12793244,12793652
4223,6,6,1,2412,-88,-87,-1,e2:db:d1:d1:b0:4f,12794111,408,51,12793703,12794111
4224,6,6,1,2412,-89,-87,-2,,12794797,44,642,12794753,12794797
4225,6,24,1,2412,-84,-87,3,,12798559,28,3734,12798531,12798559
4226,4,11,1,2412,-87,-87,0,4c:01:43:ec:a0:69,12800807,361,1887,12800446,12800807
4227,4,11,1,2412,-89,-87,-2,4c:01:43:ec:a0:63,12801181,322,52,12800859,12801181
4228,4,11,1,2412,-89,-87,-2,4c:01:43:ec:a0:66,12801515,387,-53,12801128,12801515
4229,4,11,1,2412,-86,-87,1,48:dd:0c:90:e3:87,12802137,362,260,12801775,12802137
4230,4,11,1,2412,-85,-87,2,48:dd:0c:90:e3:83,12802512,323,52,12802189,12802512
4231,4,11,1,2412,-85,-87,2,48:dd:0c:90:e3:85,12802847,382,-47,12802465,12802847
4232,6,24,1,2412,-86,-87,1,,12804228,28,1353,12804200,12804228
4233,6,6,1,2412,-54,-87,33,52:86:8c:5f:93:1e,12807521,332,2961,12807189,12807521
4234,4,1,1,2412,-92,-87,-5,ac:67:84:84:8a:07,12824429,448,16460,12823981,12824429
4235,6,6,1,2412,-52,-87,35,32:86:8c:5f:93:1e,12833121,332,8360,12832789,12833121
4236,6,24,1,2412,-84,-87,3,,12838289,28,5140,12838261,12838289
4237,6,6,1,2412,-90,-87,-3,,12845072,44,6739,12845028,12845072
4238,4,1,1,2412,-63,-87,24,b0:e4:d5:32:ec:8a,12854809,1960,7777,12852849,12854809
4239,4,1,1,2412,-87,-87,0,bc:98:df:ff:0f:8b,12858874,2568,1497,12856306,12858874
4240,6,6,1,2412,-53,-87,34,10:86:8c:5f:93:1e,12861298,344,2080,12860954,12861298
4241,4,1,1,2412,-66,-87,21,94:a6:7e:c9:98:67,12861843,2464,-1919,12859379,12861843
4242,6,6,1,2412,-54,-87,33,b4:e6:2d:b4:ff:71,12864187,64,2280,12864123,12864187
4243,6,6,1,2412,-51,-87,36,,12864267,44,36,12864223,12864267
4244,4,11,1,2412,-87,-87,0,4c:01:43:d7:f3:23,12865419,322,830,12865097,12865419
4245,4,11,1,2412,-86,-87,1,4c:01:43:d7:f3:26,12865753,387,-53,12865366,12865753
4246,6,24,1,2412,-87,-87,0,,12870999,28,5218,12870971,12870999
4247,4,1,1,2412,-86,-87,1,78:67:0e:38:6c:d3,12876667,2736,2932,12873931,12876667
4248,4,11,1,2412,-79,-87,8,48:dd:0c:7d:86:27,12879426,362,2397,12879064,12879426
4249,4,11,1,2412,-78,-87,9,48:dd:0c:7d:86:23,12879801,323,52,12879478,12879801
4250,4,11,1,2412,-79,-87,8,48:dd:0c:7d:86:25,12880136,382,-47,12879754,12880136
4251,6,24,1,2412,-82,-87,5,,12882408,28,2244,12882380,12882408
4252,6,6,1,2412,-86,-87,1,40:b0:34:b7:01:d5,12882782,576,-202,12882206,12882782
4253,6,6,1,2412,-53,-87,34,12:86:8c:5f:93:1e,12884322,332,1208,12883990,12884322
4254,4,1,1,2412,-91,-87,-4,d8:9c:8e:01:4c:6a,12888998,3000,1676,12885998,12888998
4255,6,6,1,2412,-90,-87,-3,e2:db:d1:d1:b0:4d,12896089,408,6683,12895681,12896089
4256,6,6,1,2412,-90,-87,-3,e2:db:d1:d1:b0:4f,12896521,408,24,12896113,12896521
4257,6,6,1,2412,-90,-87,-3,,12897525,44,960,12897481,12897525
4258,6,6,1,2412,-90,-87,-3,,12897655,44,86,12897611,12897655
4259,6,6,1,2412,-91,-87,-4,,12898999,44,1300,12898955,12898999
4260,6,6,1,2412,-87,-87,0,3c:bd:c5:ee:96:6d,12902730,68,3663,12902662,12902730
4261,4,11,1,2412,-85,-87,2,4c:01:43:ec:a0:69,12903206,361,115,12902845,12903206
4262,4,11,1,2412,-86,-87,1,4c:01:43:ec:a0:63,12903580,322,52,12903258,12903580
4263,4,11,1,2412,-85,-87,2,4c:01:43:ec:a0:66,12903914,387,-53,12903527,12903914
4264,4,11,1,2412,-79,-87,8,48:dd:0c:7d:86:23,12904349,254,181,12904095,12904349
4265,4,11,1,2412,-82,-87,5,48:dd:0c:90:e3:83,12905000,323,328,12904677,12905000
4266,4,11,1,2412,-82,-87,5,48:dd:0c:90:e3:85,12905335,382,-47,12904953,12905335
4267,6,6,1,2412,-52,-87,35,52:86:8c:5f:93:1e,12910811,332,5144,12910479,12910811
4268,4,1,1,2412,-83,-87,4,3c:bd:c5:ee:96:6d,12911556,2512,-1767,12909044,12911556
4269,6,6,1,2412,-87,-87,0,,12915586,44,3986,12915542,12915586
4270,6,24,1,2412,-85,-87,2,,12947293,28,31679,12947265,12947293
4271,4,1,1,2412,-64,-87,23,b0:e4:d5:32:ec:8a,12957209,1960,7956,12955249,12957209
4272,4,1,1,2412,-61,-87,26,94:a6:7e:c9:98:67,12964760,2464,5087,12962296,12964760
4273,4,11,1,2412,-90,-87,-3,4c:01:43:d7:f3:29,12967443,362,2321,12967081,12967443
4274,4,11,1,2412,-91,-87,-4,4c:01:43:d7:f3:23,12967818,322,53,12967496,12967818
4275,4,11,1,2412,-89,-87,-2,4c:01:43:d7:f3:26,12968153,387,-52,12967766,12968153
4276,6,24,1,2412,-89,-87,-2,e2:db:d1:d1:b0:4a,12978687,28,10506,12978659,12978687
4277,4,11,1,2412,-80,-87,7,48:dd:0c:7d:86:27,12979413,362,364,12979051,12979413
4278,4,11,1,2412,-80,-87,7,48:dd:0c:7d:86:23,12979787,323,51,12979464,12979787
4279,4,11,1,2412,-82,-87,5,48:dd:0c:7d:86:25,12980123,382,-46,12979741,12980123
4280,6,6,1,2412,-89,-87,-2,,12984484,44,4317,12984440,12984484
4281,6,6,1,2412,-85,-87,2,40:b0:34:b7:01:d5,12984892,576,-168,12984316,12984892
4282,6,6,1,2412,-55,-87,32,12:86:8c:5f:93:1e,12986722,332,1498,12986390,12986722
4283,6,6,1,2412,-88,-87,-1,,12999628,44,12862,12999584,12999628
4284,4,11,1,2412,-78,-87,9,48:dd:0c:90:e3:87,13006937,362,6947,13006575,13006937
4285,4,11,1,2412,-79,-87,8,48:dd:0c:90:e3:83,13007311,323,51,13006988,13007311
4286,4,11,1,2412,-81,-87,6,48:dd:0c:90:e3:85,13007647,382,-46,13007265,13007647
4287,4,11,1,2412,-92,-88,-4,,13017472,107,9718,13017365,13017472
4288,6,24,1,2412,-83,-88,5,78:67:0e:c4:a8:42,13017586,32,82,13017554,13017586
4289,6,6,1,2412,-57,-88,31,32:86:8c:5f:93:1e,13037923,332,20005,13037591,13037923
4290,6,24,1,2412,-82,-88,6,,13039998,28,2047,13039970,13039998
4291,6,24,1,2412,-87,-88,1,,13044675,28,4649,13044647,13044675
4292,6,24,1,2412,-83,-88,5,,13055088,28,10385,13055060,13055088
4293,4,1,1,2412,-71,-88,17,b0:e4:d5:32:ec:8a,13059608,1960,2560,13057648,13059608
4294,4,1,1,2412,-88,-88,0,bc:98:df:ff:0f:8b,13063657,2568,1481,13061089,13063657
4295,6,6,1,2412,-60,-88,28,10:86:8c:5f:93:1e,13066080,344,2079,13065736,13066080
4296,4,1,1,2412,-63,-88,25,94:a6:7e:c9:98:67,13067427,2464,-1117,13064963,13067427
4297,4,11,1,2412,-89,-88,-1,4c:01:43:d7:f3:23,13070218,322,2469,13069896,13070218
4298,4,11,1,2412,-88,-88,0,4c:01:43:d7:f3:26,13070552,387,-53,13070165,13070552
4299,4,11,1,2412,-80,-88,8,4c:01:43:d7:f3:23,13075860,254,5054,13075606,13075860
4300,4,11,1,2412,-81,-88,7,4c:01:43:ec:a0:63,13076512,254,398,13076258,13076512
4301,4,11,1,2412,-76,-88,12,48:dd:0c:7d:86:27,13084226,362,7352,13083864,13084226
4302,4,11,1,2412,-76,-88,12,48:dd:0c:7d:86:23,13084600,323,51,13084277,13084600
4303,4,11,1,2412,-80,-88,8,48:dd:0c:7d:86:25,13084935,382,-47,13084553,13084935
4304,6,6,1,2412,-81,-88,7,40:b0:34:b7:01:d5,13087294,576,1783,13086718,13087294
4305,6,6,1,2412,-58,-88,30,12:86:8c:5f:93:1e,13089124,332,1498,13088792,13089124
4306,4,1,1,2412,-91,-88,-3,70:3a:cb:63:35:b2,13089648,2216,-1692,13087432,13089648
4307,6,24,1,2412,-81,-88,7,,13098534,28,8858,13098506,13098534
4308,6,6,1,2412,-81,-88,7,,13098732,44,154,13098688,13098732
4309,6,6,1,2412,-89,-88,-1,e2:db:d1:d1:b0:4b,13100442,408,1302,13100034,13100442
4310,6,6,1,2412,-90,-88,-2,e2:db:d1:d1:b0:4d,13100892,408,42,13100484,13100892
4311,6,6,1,2412,-89,-88,-1,,13101893,44,957,13101849,13101893
4312,4,11,1,2412,-77,-88,11,4c:01:43:ec:a0:69,13108004,361,5750,13107643,13108004
4313,4,11,1,2412,-78,-88,10,4c:01:43:ec:a0:63,13108377,322,51,13108055,13108377
4314,4,11,1,2412,-80,-88,8,48:dd:0c:90:e3:85,13110046,382,1287,13109664,13110046
4315,6,24,1,2412,-89,-88,-1,,13111005,28,931,13110977,13111005
4316,6,6,1,2412,-61,-88,27,52:86:8c:5f:93:1e,13114723,332,3386,13114391,13114723
4317,6,24,1,2412,-81,-88,7,,13124165,28,9414,13124137,13124165
4318,4,1,1,2412,-68,-88,20,ac:67:84:84:8a:07,13131884,448,7271,13131436,13131884
4319,4,1,1,2412,-89,-88,-1,,13142138,304,9950,13141834,13142138
4320,4,1,1,2412,-61,-88,27,b0:e4:d5:32:ec:8a,13162007,1960,17909,13160047,13162007
4321,4,11,1,2412,-85,-88,3,4c:01:43:d7:f3:23,13172617,322,10288,13172295,13172617
4322,4,1,1,2412,-64,-88,24,94:a6:7e:c9:98:67,13173730,2464,-1351,13171266,13173730
4323,6,24,1,2412,-87,-88,1,,13181528,28,7770,13181500,13181528
4324,6,24,1,2412,-86,-88,2,4c:01:43:d7:f3:26,13181646,32,86,13181614,13181646
4325,6,24,1,2412,-80,-88,8,,13183408,28,1734,13183380,13183408
4326,4,11,1,2412,-78,-88,10,48:dd:0c:7d:86:23,13187061,323,3330,13186738,13187061
4327,4,11,1,2412,-82,-88,6,48:dd:0c:7d:86:25,13187396,382,-47,13187014,13187396
4328,6,6,1,2412,-85,-88,3,40:b0:34:b7:01:d5,13189695,576,1723,13189119,13189695
4329,6,24,1,2412,-87,-88,1,,13191009,28,1286,13190981,13191009
4330,6,6,1,2412,-59,-88,29,12:86:8c:5f:93:1e,13191524,332,183,13191192,13191524
4331,6,6,1,2412,-87,-88,1,e2:db:d1:d1:b0:4f,13203730,408,11798,13203322,13203730
4332,6,6,1,2412,-88,-88,0,,13204398,44,624,13204354,13204398
4333,6,24,1,2412,-87,-88,1,,13204813,28,387,13204785,13204813
4334,4,11,1,2412,-81,-88,7,4c:01:43:ec:a0:69,13210403,361,5229,13210042,13210403
4335,4,11,1,2412,-82,-88,6,4c:01:43:ec:a0:63,13210776,322,51,13210454,13210776
4336,4,11,1,2412,-83,-88,5,4c:01:43:ec:a0:66,13211111,387,-52,13210724,13211111
4337,4,11,1,2412,-85,-88,3,48:dd:0c:90:e3:87,13211736,362,263,13211374,13211736
4338,4,11,1,2412,-84,-88,4,48:dd:0c:90:e3:83,13212111,323,52,13211788,13212111
4339,4,11,1,2412,-84,-88,4,48:dd:0c:90:e3:85,13212446,382,-47,13212064,13212446
4340,6,6,1,2412,-58,-88,30,52:86:8c:5f:93:1e,13218010,332,5232,13217678,13218010
4341,4,11,1,2412,-81,-88,7,4c:01:43:ec:a0:63,13219772,254,1508,13219518,13219772
4342,4,11,1,2412,-88,-88,0,4c:01:43:d7:f3:23,13220080,254,54,13219826,13220080
4343,4,1,1,2412,-88,-88,0,,13221477,304,1093,13221173,13221477
4344,6,24,1,2412,-82,-88,6,,13226967,28,5462,13226939,13226967
4345,6,6,1,2412,-88,-88,0,,13243714,44,16703,13243670,13243714
4346,6,24,1,2412,-87,-88,1,,13245303,28,1561,13245275,13245303
4347,6,6,1,2412,-86,-88,2,,13245459,44,112,13245415,13245459
4348,6,6,1,2412,-86,-88,2,e0:db:d1:d0:b0:49,13245557,212,-114,13245345,13245557
4349,4,1,1,2412,-61,-88,27,b0:e4:d5:32:ec:8a,13246216,1912,-1253,13244304,13246216
4350,4,1,1,2412,-61,-88,27,b0:e4:d5:32:ec:8a,13248630,1912,502,13246718,13248630
4351,4,1,1,2412,-61,-88,27,b0:e4:d5:32:ec:8a,13250678,1912,136,13248766,13250678
4352,4,1,1,2412,-87,-88,1,3c:bd:c5:ee:96:6d,13255781,3280,1823,13252501,13255781
4353,4,1,1,2412,-90,-88,-2,,13259073,304,2988,13258769,13259073
4354,6,6,1,2412,-87,-88,1,e0:db:d1:d0:b0:49,13259261,212,-24,13259049,13259261
4355,4,11,1,2412,-87,-88,1,4c:01:43:d7:f3:26,13263860,383,4216,13263477,13263860
4356,4,1,1,2412,-61,-88,27,b0:e4:d5:32:ec:8a,13264407,1960,-1413,13262447,13264407
4357,4,1,1,2412,-62,-88,26,94:a6:7e:c9:98:67,13271511,2464,4640,13269047,13271511
4358,4,11,1,2412,-82,-88,6,4c:01:43:ec:a0:66,13274614,382,2721,13274232,13274614
4359,4,11,1,2412,-85,-88,3,4c:01:43:d7:f3:29,13275024,362,48,13274662,13275024
4360,4,11,1,2412,-85,-88,3,4c:01:43:d7:f3:26,13275733,387,322,13275346,13275733
4361,6,6,1,2412,-81,-88,7,,13276004,44,227,13275960,13276004
4362,6,24,1,2412,-87,-88,1,,13283920,28,7888,13283892,13283920
4363,4,1,1,2412,-82,-88,6,78:67:0e:38:6c:d3,13286268,2736,-388,13283532,13286268
4364,4,11,1,2412,-80,-88,8,48:dd:0c:7d:86:27,13289026,362,2396,13288664,13289026
4365,4,11,1,2412,-81,-88,7,48:dd:0c:7d:86:23,13289401,323,52,13289078,13289401
4366,4,11,1,2412,-73,-88,15,48:dd:0c:7d:86:25,13289736,382,-47,13289354,13289736
4367,4,1,1,2412,-90,-88,-2,00:26:62:eb:ea:74,13301614,968,10910,13300646,13301614
4368,6,24,1,2412,-82,-88,6,,13303214,28,1572,13303186,13303214
4369,6,24,1,2412,-82,-88,6,78:67:0e:c4:a8:42,13303641,32,395,13303609,13303641
4370,6,6,1,2412,-87,-88,1,e2:db:d1:d1:b0:4a,13305006,444,921,13304562,13305006
4371,6,6,1,2412,-86,-88,2,e2:db:d1:d1:b0:4b,13305502,408,88,13305094,13305502
4372,6,6,1,2412,-85,-88,3,e2:db:d1:d1:b0:4f,13306392,408,482,13305984,13306392
4373,6,6,1,2412,-87,-88,1,,13306979,44,543,13306935,13306979
4374,4,11,1,2412,-82,-88,6,4c:01:43:ec:a0:69,13312801,361,5461,13312440,13312801
4375,4,11,1,2412,-83,-88,5,4c:01:43:ec:a0:63,13313175,322,52,13312853,13313175
4376,4,11,1,2412,-84,-88,4,4c:01:43:ec:a0:66,13313510,387,-52,13313123,13313510
4377,4,11,1,2412,-85,-88,3,48:dd:0c:90:e3:87,13314136,362,264,13313774,13314136
4378,4,11,1,2412,-85,-88,3,48:dd:0c:90:e3:83,13314511,323,52,13314188,13314511
4379,6,6,1,2412,-87,-88,1,0a:a7:c0:a3:8d:70,13317272,608,2153,13316664,13317272
4380,6,6,1,2412,-58,-88,30,52:86:8c:5f:93:1e,13319693,332,2089,13319361,13319693
4381,6,6,1,2412,-84,-88,4,e2:db:d1:d1:b0:4a,13325402,52,5657,13325350,13325402
4382,6,6,1,2412,-83,-88,5,,13325702,44,256,13325658,13325702
4383,4,1,1,2412,-86,-88,2,78:67:0e:c4:a8:42,13326328,2736,-2110,13323592,13326328
4384,4,1,1,2412,-88,-88,0,bc:98:df:ff:0f:8b,13334565,3176,5061,13331389,13334565
4385,4,1,1,2412,-89,-88,-1,bc:98:df:ff:0f:8b,13338102,3176,361,13334926,13338102
4386,4,1,1,2412,-90,-88,-2,bc:98:df:ff:0f:8b,13341657,3176,379,13338481,13341657
4387,4,1,1,2412,-88,-88,0,bc:98:df:ff:0f:8b,13350786,3176,5953,13347610,13350786
4388,6,24,1,2412,-81,-88,7,,13363717,28,12903,13363689,13363717
4389,4,1,1,2412,-68,-88,20,b0:e4:d5:32:ec:8a,13366806,1960,1129,13364846,13366806
4390,6,6,1,2412,-56,-88,32,10:86:8c:5f:93:1e,13370725,344,3575,13370381,13370725
4391,4,1,1,2412,-60,-88,28,94:a6:7e:c9:98:67,13373790,2464,601,13371326,13373790
4392,4,11,1,2412,-82,-88,6,4c:01:43:d7:f3:29,13377042,362,2890,13376680,13377042
4393,4,11,1,2412,-81,-88,7,4c:01:43:d7:f3:23,13377416,322,52,13377094,13377416
4394,4,11,1,2412,-81,-88,7,4c:01:43:d7:f3:26,13377751,387,-52,13377364,13377751
4395,6,6,1,2412,-85,-88,3,,13385838,44,8043,13385794,13385838
4396,4,1,1,2412,-87,-88,1,78:67:0e:38:6c:d3,13388668,2736,94,13385932,13388668
4397,6,6,1,2412,-84,-88,4,40:b0:34:b7:01:d5,13394497,576,5253,13393921,13394497
4398,6,6,1,2412,-57,-88,31,12:86:8c:5f:93:1e,13396326,332,1497,13395994,13396326
4399,6,6,1,2412,-85,-88,3,e2:db:d1:d1:b0:4a,13407180,444,10410,13406736,13407180
4400,6,6,1,2412,-84,-88,4,e2:db:d1:d1:b0:4d,13408333,408,745,13407925,13408333
4401,6,6,1,2412,-85,-88,3,e2:db:d1:d1:b0:4f,13408774,408,33,13408366,13408774
4402,4,11,1,2412,-84,-88,4,4c:01:43:ec:a0:69,13415200,361,6065,13414839,13415200
4403,4,11,1,2412,-84,-88,4,4c:01:43:ec:a0:63,13415574,322,52,13415252,13415574
4404,4,11,1,2412,-85,-88,3,4c:01:43:ec:a0:66,13415909,387,-52,13415522,13415909
4405,4,11,1,2412,-85,-88,3,48:dd:0c:90:e3:87,13416536,362,265,13416174,13416536
4406,4,11,1,2412,-85,-88,3,48:dd:0c:90:e3:83,13416910,323,51,13416587,13416910
4407,4,11,1,2412,-85,-88,3,48:dd:0c:90:e3:85,13417246,382,-46,13416864,13417246
4408,6,6,1,2412,-57,-88,31,52:86:8c:5f:93:1e,13421925,332,4347,13421593,13421925
4409,4,1,1,2412,-84,-88,4,3c:bd:c5:ee:96:6d,13424714,976,1813,13423738,13424714
4410,4,1,1,2412,-84,-88,4,,13426210,304,1192,13425906,13426210
4411,6,6,1,2412,-88,-88,0,0a:a7:c0:a3:8d:71,13426498,408,-120,13426090,13426498
4412,6,6,1,2412,-89,-88,-1,0a:a7:c0:a3:8d:73,13426938,408,32,13426530,13426938
4413,4,1,1,2412,-87,-88,1,78:67:0e:c4:a8:42,13428728,2736,-946,13425992,13428728
4414,6,24,1,2412,-85,-88,3,,13431373,28,2617,13431345,13431373
4415,6,24,1,2412,-81,-88,7,,13432095,28,694,13432067,13432095
4416,6,24,1,2412,-86,-88,2,,13443584,28,11461,13443556,13443584
4417,6,6,1,2412,-60,-88,28,32:86:8c:5f:93:1e,13447526,332,3610,13447194,13447526
4418,6,24,1,2412,-83,-88,5,,13455164,28,7610,13455136,13455164
4419,4,1,1,2412,-87,-88,1,bc:98:df:ff:0f:8b,13455420,3176,-2920,13452244,13455420
4420,4,1,1,2412,-86,-88,2,bc:98:df:ff:0f:8b,13458948,3176,352,13455772,13458948
4421,4,1,1,2412,-64,-88,24,b0:e4:d5:32:ec:8a,13469205,1960,8297,13467245,13469205
4422,4,1,1,2412,-60,-88,28,94:a6:7e:c9:98:67,13476249,2464,4580,13473785,13476249
4423,4,11,1,2412,-87,-88,1,4c:01:43:d7:f3:26,13480150,387,3514,13479763,13480150
4424,4,1,1,2412,-88,-88,0,bc:98:df:ff:0f:8b,13481743,3176,-1583,13478567,13481743
4425,4,1,1,2412,-87,-88,1,78:67:0e:38:6c:d3,13491068,2736,6589,13488332,13491068
4426,4,11,1,2412,-76,-88,12,48:dd:0c:7d:86:27,13493827,362,2397,13493465,13493827
4427,4,11,1,2412,-76,-88,12,48:dd:0c:7d:86:23,13494201,323,51,13493878,13494201
4428,4,11,1,2412,-75,-88,13,48:dd:0c:7d:86:25,13494537,382,-46,13494155,13494537
4429,6,24,1,2412,-86,-88,2,,13498166,28,3601,13498138,13498166
4430,6,6,1,2412,-56,-88,32,12:86:8c:5f:93:1e,13498726,332,228,13498394,13498726
4431,4,1,1,2412,-79,-88,9,78:67:0e:38:6c:d3,13509899,432,10741,13509467,13509899
4432,4,1,1,2412,-86,-88,2,78:67:0e:38:6c:d3,13510949,432,618,13510517,13510949
4433,4,11,1,2412,-84,-88,4,4c:01:43:ec:a0:69,13517599,361,6289,13517238,13517599
4434,4,11,1,2412,-82,-88,6,48:dd:0c:90:e3:87,13518935,362,974,13518573,13518935
4435,4,11,1,2412,-83,-88,5,48:dd:0c:90:e3:83,13519310,323,52,13518987,13519310
4436,4,11,1,2412,-82,-88,6,48:dd:0c:90:e3:85,13519645,382,-47,13519263,13519645
4437,6,24,1,2412,-84,-88,4,,13521797,28,2124,13521769,13521797
4438,4,1,1,2412,-86,-88,2,78:67:0e:c4:a8:42,13527225,352,5076,13526873,13527225
4439,4,1,1,2412,-90,-88,-2,,13529259,304,1730,13528955,13529259
4440,4,1,1,2412,-86,-88,2,78:67:0e:c4:a8:42,13532630,2736,635,13529894,13532630
4441,4,1,1,2412,-66,-88,22,78:67:0e:c4:a8:42,13535403,832,1941,13534571,13535403
4442,4,11,1,2412,-87,-88,1,,13536311,107,801,13536204,13536311
4443,4,1,1,2412,-76,-88,12,78:67:0e:c4:a8:42,13536752,352,89,13536400,13536752
4444,4,1,1,2412,-87,-88,1,78:67:0e:c4:a8:42,13539280,352,2176,13538928,13539280
4445,4,1,1,2412,-88,-88,0,78:67:0e:c4:a8:42,13540623,352,991,13540271,13540623
4446,4,1,1,2412,-93,-88,-5,78:67:0e:c4:a8:42,13541525,352,550,13541173,13541525
4447,4,1,1,2412,-87,-88,1,78:67:0e:c4:a8:42,13542121,352,244,13541769,13542121
4448,4,1,1,2412,-89,-88,-1,78:67:0e:c4:a8:42,13542780,352,307,13542428,13542780
4449,4,1,1,2412,-86,-88,2,78:67:0e:c4:a8:42,13543367,352,235,13543015,13543367
4450,4,1,1,2412,-84,-88,4,78:67:0e:c4:a8:42,13546506,352,2787,13546154,13546506
4451,4,1,1,2412,-88,-88,0,78:67:0e:c4:a8:42,13547824,352,966,13547472,13547824
4452,4,1,1,2412,-77,-88,11,78:67:0e:c4:a8:42,13548618,352,442,13548266,13548618
4453,4,1,1,2412,-88,-88,0,78:67:0e:c4:a8:42,13549538,352,568,13549186,13549538
4454,4,1,1,2412,-88,-88,0,78:67:0e:c4:a8:42,13550757,352,867,13550405,13550757
4455,4,1,1,2412,-87,-88,1,78:67:0e:c4:a8:42,13551272,352,163,13550920,13551272
4456,4,1,1,2412,-87,-88,1,78:67:0e:c4:a8:42,13551778,352,154,13551426,13551778
4457,6,6,1,2412,-56,-88,32,32:86:8c:5f:93:1e,13553063,332,953,13552731,13553063
4458,4,1,1,2412,-87,-88,1,78:67:0e:c4:a8:42,13553975,352,560,13553623,13553975
4459,4,1,1,2412,-89,-88,-1,78:67:0e:c4:a8:42,13554544,352,217,13554192,13554544
4460,4,1,1,2412,-89,-88,-1,78:67:0e:c4:a8:42,13555167,352,271,13554815,13555167
4461,4,1,1,2412,-89,-88,-1,,13556108,304,637,13555804,13556108
4462,4,1,1,2412,-87,-88,1,,13557206,304,794,13556902,13557206
4463,4,1,1,2412,-88,-88,0,78:67:0e:c4:a8:42,13557646,352,88,13557294,13557646
4464,4,11,1,2412,-86,-88,2,,13559366,107,1613,13559259,13559366
4465,4,1,1,2412,-66,-88,22,b0:e4:d5:32:ec:8a,13571604,1960,10278,13569644,13571604
4466,6,6,1,2412,-56,-88,32,10:86:8c:5f:93:1e,13575526,344,3578,13575182,13575526
4467,4,1,1,2412,-65,-88,23,94:a6:7e:c9:98:67,13579006,2464,1016,13576542,13579006
4468,4,1,1,2412,-83,-88,5,78:67:0e:38:6c:d3,13593468,2736,11726,13590732,13593468
4469,4,11,1,2412,-77,-88,11,48:dd:0c:7d:86:27,13596227,362,2397,13595865,13596227
4470,4,11,1,2412,-79,-88,9,48:dd:0c:7d:86:23,13596601,323,51,13596278,13596601
4471,4,11,1,2412,-76,-88,12,48:dd:0c:7d:86:25,13596937,382,-46,13596555,13596937
4472,6,6,1,2412,-88,-88,0,,13599245,44,2264,13599201,13599245
4473,6,6,1,2412,-58,-88,30,12:86:8c:5f:93:1e,13604197,332,4620,13603865,13604197
4474,4,1,1,2412,-87,-88,1,00:26:62:eb:ea:74,13606638,968,1473,13605670,13606638
4475,6,6,1,2412,-90,-88,-2,e2:db:d1:d1:b0:4a,13612011,444,4929,13611567,13612011
4476,6,6,1,2412,-89,-88,-1,e2:db:d1:d1:b0:4b,13612506,408,87,13612098,13612506
4477,6,6,1,2412,-91,-88,-3,e2:db:d1:d1:b0:4d,13612938,408,24,13612530,13612938
4478,6,6,1,2412,-90,-88,-2,,13614011,44,1029,13613967,13614011
4479,6,24,1,2412,-82,-88,6,,13616548,28,2509,13616520,13616548
4480,4,1,1,2412,-87,-88,1,78:67:0e:c4:a8:42,13618748,352,1848,13618396,13618748
4481,4,11,1,2412,-83,-88,5,4c:01:43:ec:a0:69,13619998,361,889,13619637,13619998
4482,4,11,1,2412,-83,-88,5,4c:01:43:ec:a0:63,13620372,322,52,13620050,13620372
4483,4,11,1,2412,-68,-88,20,4c:01:43:ec:a0:66,13620706,387,-53,13620319,13620706
4484,4,11,1,2412,-81,-88,7,48:dd:0c:90:e3:83,13621710,323,681,13621387,13621710
4485,4,11,1,2412,-82,-88,6,48:dd:0c:90:e3:85,13622045,382,-47,13621663,13622045
4486,6,6,1,2412,-55,-88,33,52:86:8c:5f:93:1e,13627609,332,5232,13627277,13627609
4487,6,6,1,2412,-86,-88,2,0a:a7:c0:a3:8d:70,13629488,464,1415,13629024,13629488
4488,6,6,1,2412,-88,-88,0,0a:a7:c0:a3:8d:75,13630972,408,1076,13630564,13630972
4489,6,24,1,2412,-83,-88,5,,13637308,28,6308,13637280,13637308
4490,6,24,1,2412,-83,-88,5,,13643549,28,6213,13643521,13643549
4491,4,11,1,2412,-84,-88,4,,13646618,107,2962,13646511,13646618
4492,6,24,1,2412,-82,-88,6,78:67:0e:c4:a8:42,13656554,32,9904,13656522,13656554
4493,4,11,1,2412,-85,-88,3,,13669678,107,13017,13669571,13669678
4494,6,24,1,2412,-82,-88,6,78:67:0e:c4:a8:42,13669849,32,139,13669817,13669849
4495,6,24,1,2412,-85,-88,3,,13671012,28,1135,13670984,13671012
4496,4,1,1,2412,-83,-88,5,78:67:0e:c4:a8:42,13680544,352,9180,13680192,13680544
4497,4,11,1,2412,-77,-88,11,4c:01:43:d7:f3:23,13684615,322,3749,13684293,13684615
4498,4,11,1,2412,-81,-88,7,,13685819,107,1097,13685712,13685819
4499,6,24,1,2412,-82,-88,6,78:67:0e:c4:a8:42,13685932,32,81,13685900,13685932
4500,6,24,1,2412,-81,-88,7,,13686040,28,80,13686012,13686040
4501,4,1,1,2412,-58,-88,30,,13700684,304,14340,13700380,13700684
4502,7,72.2222,1,2412,-53,-88,35,10:86:8c:5f:93:1e,13700835,54,97,13700781,13700835
4503,6,24,1,2412,-74,-88,14,,13701674,28,811,13701646,13701674
4504,6,24,1,2412,-74,-88,14,,13701918,28,216,13701890,13701918
4505,6,24,1,2412,-74,-88,14,,13702172,28,226,13702144,13702172
4506,6,24,1,2412,-53,-88,35,10:86:8c:5f:93:1e,13702294,32,90,13702262,13702294
4507,6,6,1,2412,-53,-88,35,12:86:8c:5f:93:1e,13703528,332,902,13703196,13703528
4508,6,24,1,2412,-82,-88,6,,13706993,28,3437,13706965,13706993
4509,4,1,1,2412,-84,-88,4,3c:bd:c5:ee:96:6d,13708503,432,1078,13708071,13708503
4510,4,11,1,2412,-82,-88,6,4c:01:43:ec:a0:69,13722397,361,13533,13722036,13722397
4511,4,11,1,2412,-87,-88,1,4c:01:43:ec:a0:63,13722771,322,52,13722449,13722771
4512,4,11,1,2412,-85,-88,3,4c:01:43:ec:a0:66,13723105,387,-53,13722718,13723105
4513,4,11,1,2412,-80,-88,8,48:dd:0c:90:e3:87,13723735,362,268,13723373,13723735
4514,4,11,1,2412,-82,-88,6,48:dd:0c:90:e3:83,13724109,323,51,13723786,13724109
4515,4,11,1,2412,-80,-88,8,48:dd:0c:90:e3:85,13724445,382,-46,13724063,13724445
4516,4,1,1,2412,-58,-88,30,,13725272,304,523,13724968,13725272
4517,6,24,1,2412,-66,-88,22,,13725489,28,189,13725461,13725489
4518,6,6,1,2412,-53,-88,35,52:86:8c:5f:93:1e,13729128,332,3307,13728796,13729128
4519,6,6,1,2412,-86,-88,2,0a:a7:c0:a3:8d:70,13731965,464,2373,13731501,13731965
4520,4,1,1,2412,-81,-88,7,3c:bd:c5:ee:96:6d,13732933,2512,-1544,13730421,13732933
4521,6,6,1,2412,-87,-88,1,0a:a7:c0:a3:8d:75,13735356,408,2015,13734948,13735356
4522,4,1,1,2412,-90,-88,-2,78:67:0e:c4:a8:42,13746644,3472,7816,13743172,13746644
4523,4,1,1,2412,-89,-88,-1,78:67:0e:c4:a8:42,13750718,3472,602,13747246,13750718
4524,6,6,1,2412,-55,-88,33,32:86:8c:5f:93:1e,13754727,332,3677,13754395,13754727
4525,6,6,1,2412,-87,-88,1,3c:bd:c5:ee:96:6d,13761344,68,6549,13761276,13761344
4526,6,6,1,2412,-87,-88,1,,13773350,44,11962,13773306,13773350
4527,6,24,1,2412,-86,-88,2,3c:bd:c5:ee:96:6d,13775134,28,1756,13775106,13775134
4528,6,6,1,2412,-86,-88,2,,13775385,44,207,13775341,13775385
4529,4,1,1,2412,-67,-88,21,b0:e4:d5:32:ec:8a,13776403,1960,-942,13774443,13776403
4530,6,6,1,2412,-85,-88,3,,13778421,44,1974,13778377,13778421
4531,6,6,1,2412,-52,-88,36,10:86:8c:5f:93:1e,13780329,344,1564,13779985,13780329
4532,4,1,1,2412,-58,-88,30,94:a6:7e:c9:98:67,13783390,2464,597,13780926,13783390
4533,4,11,1,2412,-88,-88,0,4c:01:43:d7:f3:29,13786640,362,2888,13786278,13786640
4534,4,11,1,2412,-87,-88,1,4c:01:43:d7:f3:23,13787014,322,52,13786692,13787014
4535,6,6,1,2412,-88,-88,0,,13794156,44,7098,13794112,13794156
4536,4,11,1,2412,-80,-88,8,48:dd:0c:7d:86:27,13801027,362,6509,13800665,13801027
4537,4,11,1,2412,-78,-88,10,48:dd:0c:7d:86:23,13801402,323,52,13801079,13801402
4538,4,11,1,2412,-78,-88,10,48:dd:0c:7d:86:25,13801737,382,-47,13801355,13801737
4539,6,6,1,2412,-52,-88,36,12:86:8c:5f:93:1e,13805929,332,3860,13805597,13805929
4540,4,11,1,2412,-87,-88,1,,13808473,107,2437,13808366,13808473
4541,6,24,1,2412,-84,-88,4,78:67:0e:c4:a8:42,13808616,32,111,13808584,13808616
4542,4,11,1,2412,-89,-88,-1,,13808948,107,225,13808841,13808948
4543,4,1,1,2412,-88,-88,0,78:67:0e:c4:a8:42,13816168,352,6868,13815816,13816168
4544,6,6,1,2412,-89,-88,-1,e2:db:d1:d1:b0:4b,13817273,408,697,13816865,13817273
4545,6,24,1,2412,-84,-88,4,78:67:0e:c4:a8:42,13818333,32,1028,13818301,13818333
4546,4,11,1,2412,-86,-88,2,4c:01:43:ec:a0:66,13825504,387,6784,13825117,13825504
4547,4,11,1,2412,-76,-88,12,48:dd:0c:90:e3:87,13826135,362,269,13825773,13826135
4548,4,11,1,2412,-76,-88,12,48:dd:0c:90:e3:83,13826509,323,51,13826186,13826509
4549,4,11,1,2412,-75,-88,13,48:dd:0c:90:e3:85,13826844,382,-47,13826462,13826844
4550,6,6,1,2412,-54,-88,34,52:86:8c:5f:93:1e,13831528,332,4352,13831196,13831528
4551,4,1,1,2412,-88,-88,0,78:67:0e:c4:a8:42,13842887,352,11007,13842535,13842887
4552,6,24,1,2412,-83,-88,5,78:67:0e:c4:a8:42,13844767,32,1848,13844735,13844767
4553,4,1,1,2412,-90,-88,-2,04:a2:22:bf:24:52,13846820,1648,405,13845172,13846820
4554,6,6,1,2412,-53,-88,35,32:86:8c:5f:93:1e,13857129,332,9977,13856797,13857129
4555,4,11,1,2412,-86,-88,2,,13869729,107,12493,13869622,13869729
4556,6,24,1,2412,-83,-88,5,78:67:0e:c4:a8:42,13869842,32,81,13869810,13869842
4557,4,1,1,2412,-86,-88,2,78:67:0e:c4:a8:42,13871484,352,1290,13871132,13871484
4558,4,1,1,2412,-88,-88,0,78:67:0e:c4:a8:42,13877422,352,5586,13877070,13877422
4559,4,1,1,2412,-85,-88,3,78:67:0e:c4:a8:42,13878436,352,662,13878084,13878436
4560,4,1,1,2412,-70,-88,18,b0:e4:d5:32:ec:8a,13878802,1960,-1594,13876842,13878802
4561,4,11,1,2412,-84,-88,4,,13880854,107,1945,13880747,13880854
4562,6,6,1,2412,-88,-88,0,,13882402,44,1504,13882358,13882402
4563,6,6,1,2412,-53,-88,35,10:86:8c:5f:93:1e,13885290,344,2544,13884946,13885290
4564,4,11,1,2412,-57,-88,31,10:86:8c:5f:93:1e,13885833,347,196,13885486,13885833
4565,4,1,1,2412,-66,-88,22,94:a6:7e:c9:98:67,13886210,2464,-2087,13883746,13886210
4566,6,6,1,2412,-61,-88,27,b4:e6:2d:b4:ff:71,13888554,64,2280,13888490,13888554
4567,6,6,1,2412,-53,-88,35,,13888634,44,36,13888590,13888634
4568,4,11,1,2412,-88,-88,0,4c:01:43:d7:f3:26,13889748,387,727,13889361,13889748
4569,4,1,1,2412,-85,-88,3,78:67:0e:38:6c:d3,13900669,2736,8185,13897933,13900669
4570,4,11,1,2412,-78,-88,10,48:dd:0c:7d:86:27,13903428,362,2397,13903066,13903428
4571,4,11,1,2412,-79,-88,9,48:dd:0c:7d:86:23,13903803,323,52,13903480,13903803
4572,4,11,1,2412,-78,-88,10,48:dd:0c:7d:86:25,13904138,382,-47,13903756,13904138
4573,6,6,1,2412,-83,-88,5,40:b0:34:b7:01:d5,13906502,576,1788,13905926,13906502
4574,6,6,1,2412,-54,-88,34,12:86:8c:5f:93:1e,13908329,332,1495,13907997,13908329
4575,4,1,1,2412,-92,-88,-4,70:3a:cb:63:35:b2,13908853,2216,-1692,13906637,13908853
4576,6,6,1,2412,-87,-88,1,e2:db:d1:d1:b0:4f,13920551,408,11290,13920143,13920551
4577,4,11,1,2412,-78,-88,10,48:dd:0c:90:e3:87,13928534,362,7621,13928172,13928534
4578,4,11,1,2412,-78,-88,10,48:dd:0c:90:e3:83,13928909,323,52,13928586,13928909
4579,4,11,1,2412,-78,-88,10,48:dd:0c:90:e3:85,13929244,382,-47,13928862,13929244
4580,6,6,1,2412,-54,-88,34,52:86:8c:5f:93:1e,13933930,332,4354,13933598,13933930
4581,6,6,1,2412,-88,-88,0,0a:a7:c0:a3:8d:70,13936732,464,2338,13936268,13936732
4582,6,6,1,2412,-87,-88,1,0a:a7:c0:a3:8d:73,13937652,408,512,13937244,13937652
4583,6,6,1,2412,-87,-88,1,0a:a7:c0:a3:8d:75,13938111,408,51,13937703,13938111
4584,6,24,1,2412,-81,-88,7,,13954596,28,16457,13954568,13954596
4585,6,24,1,2412,-86,-88,2,,13956091,28,1467,13956063,13956091
4586,6,6,1,2412,-54,-88,34,32:86:8c:5f:93:1e,13959530,332,3107,13959198,13959530
4587,6,6,1,2412,-86,-88,2,,13971056,44,11482,13971012,13971056
4588,6,6,1,2412,-84,-88,4,,13972848,44,1748,13972804,13972848
4589,4,1,1,2412,-67,-88,21,b0:e4:d5:32:ec:8a,13981201,1960,6393,13979241,13981201
4590,6,6,1,2412,-55,-88,33,10:86:8c:5f:93:1e,13985129,344,3584,13984785,13985129
4591,4,1,1,2412,-69,-88,19,94:a6:7e:c9:98:67,13988178,2464,585,13985714,13988178
4592,4,11,1,2412,-87,-88,1,4c:01:43:d7:f3:23,13991814,322,3314,13991492,13991814
4593,4,11,1,2412,-86,-88,2,4c:01:43:d7:f3:26,13992148,387,-53,13991761,13992148
4594,6,24,1,2412,-82,-88,6,,13996909,28,4733,13996881,13996909
4595,4,1,1,2412,-91,-88,-3,ac:67:84:84:8a:07,14001215,416,3890,14000799,14001215
4596,4,1,1,2412,-83,-88,5,78:67:0e:38:6c:d3,14006110,848,4047,14005262,14006110
4597,6,6,1,2412,-83,-88,5,40:b0:34:b7:01:d5,14008903,576,2217,14008327,14008903
4598,6,6,1,2412,-85,-88,3,e2:db:d1:d1:b0:4a,14021567,444,12220,14021123,14021567
4599,6,6,1,2412,-85,-88,3,e2:db:d1:d1:b0:4b,14022043,408,68,14021635,14022043
4600,6,6,1,2412,-84,-88,4,,14023656,44,1569,14023612,14023656
4601,4,11,1,2412,-86,-88,2,4c:01:43:ec:a0:69,14029593,361,5576,14029232,14029593
4602,4,11,1,2412,-88,-88,0,4c:01:43:ec:a0:63,14029967,322,52,14029645,14029967
4603,4,11,1,2412,-78,-88,10,48:dd:0c:90:e3:87,14030934,362,605,14030572,14030934
4604,4,11,1,2412,-74,-88,14,48:dd:0c:90:e3:83,14031309,323,52,14030986,14031309
4605,4,11,1,2412,-79,-88,9,48:dd:0c:90:e3:85,14031644,382,-47,14031262,14031644
4606,4,1,1,2412,-88,-88,0,78:67:0e:c4:a8:42,14033925,352,1929,14033573,14033925
4607,4,1,1,2412,-73,-88,15,00:26:62:eb:ea:74,14035662,968,769,14034694,14035662
4608,6,6,1,2412,-56,-88,32,52:86:8c:5f:93:1e,14038538,332,2544,14038206,14038538
4609,6,6,1,2412,-87,-88,1,0a:a7:c0:a3:8d:70,14039126,464,124,14038662,14039126
4610,6,6,1,2412,-87,-88,1,0a:a7:c0:a3:8d:71,14039632,408,98,14039224,14039632
4611,4,1,1,2412,-83,-88,5,78:67:0e:c4:a8:42,14043739,2736,1371,14041003,14043739
4612,6,24,1,2412,-80,-88,8,,14050592,28,6825,14050564,14050592
4613,6,24,1,2412,-86,-88,2,e2:db:d1:d1:b0:4a,14052437,28,1817,14052409,14052437
4614,6,6,1,2412,-86,-88,2,,14052674,44,193,14052630,14052674
4615,6,6,1,2412,-59,-88,29,32:86:8c:5f:93:1e,14061930,332,8924,14061598,14061930
4616,4,1,1,2412,-92,-88,-4,ce:f4:11:65:3f:f8,14063595,2072,-407,14061523,14063595
4617,6,24,1,2412,-82,-88,6,,14071025,28,7402,14070997,14071025
4618,6,24,1,2412,-80,-88,8,,14071187,28,134,14071159,14071187
4619,4,1,1,2412,-71,-88,17,b0:e4:d5:32:ec:8a,14083601,1960,10454,14081641,14083601
4620,6,24,1,2412,-81,-88,7,,14087305,28,3676,14087277,14087305
4621,4,1,1,2412,-91,-88,-3,bc:98:df:ff:0f:8b,14087685,2568,-2188,14085117,14087685
4622,6,6,1,2412,-60,-88,28,10:86:8c:5f:93:1e,14090109,344,2080,14089765,14090109
4623,4,1,1,2412,-60,-88,28,94:a6:7e:c9:98:67,14090663,2464,-1910,14088199,14090663
4624,4,11,1,2412,-81,-88,7,4c:01:43:d7:f3:29,14093838,362,2813,14093476,14093838
4625,4,11,1,2412,-82,-88,6,4c:01:43:d7:f3:23,14094213,322,53,14093891,14094213
4626,4,11,1,2412,-81,-88,7,4c:01:43:d7:f3:26,14094548,387,-52,14094161,14094548
4627,4,1,1,2412,-83,-88,5,78:67:0e:38:6c:d3,14105470,2736,8186,14102734,14105470
4628,4,11,1,2412,-66,-88,22,48:dd:0c:7d:86:27,14108229,362,2397,14107867,14108229
4629,4,11,1,2412,-73,-88,15,48:dd:0c:7d:86:23,14108603,323,51,14108280,14108603
4630,4,11,1,2412,-72,-88,16,48:dd:0c:7d:86:25,14108939,382,-46,14108557,14108939
4631,6,24,1,2412,-80,-88,8,,14109773,28,806,14109745,14109773
4632,4,1,1,2412,-84,-88,4,78:67:0e:c4:a8:42,14111418,352,1293,14111066,14111418
4633,6,6,1,2412,-83,-88,5,40:b0:34:b7:01:d5,14111853,576,-141,14111277,14111853
4634,6,6,1,2412,-89,-88,-1,e2:db:d1:d1:b0:4d,14119973,308,7812,14119665,14119973
4635,6,6,1,2412,-88,-88,0,e2:db:d1:d1:b0:4b,14120780,308,499,14120472,14120780
4636,4,1,1,2412,-85,-88,3,00:26:62:eb:ea:74,14121516,968,-232,14120548,14121516
4637,6,6,1,2412,-88,-88,0,e2:db:d1:d1:b0:4a,14123992,444,2032,14123548,14123992
4638,6,6,1,2412,-87,-88,1,e2:db:d1:d1:b0:4b,14124478,408,78,14124070,14124478
4639,6,6,1,2412,-88,-88,0,e2:db:d1:d1:b0:4f,14125368,408,482,14124960,14125368
4640,4,11,1,2412,-82,-88,6,48:dd:0c:90:e3:85,14134044,382,8294,14133662,14134044
4641,4,1,1,2412,-88,-88,0,,14134913,304,565,14134609,14134913
4642,6,6,1,2412,-60,-88,28,52:86:8c:5f:93:1e,14138730,332,3485,14138398,14138730
4643,6,6,1,2412,-91,-88,-3,0a:a7:c0:a3:8d:70,14143691,464,4497,14143227,14143691
4644,4,1,1,2412,-85,-88,3,78:67:0e:c4:a8:42,14148301,848,3762,14147453,14148301
4645,6,24,1,2412,-81,-88,7,,14149122,28,793,14149094,14149122
4646,6,24,1,2412,-83,-88,5,,14151026,28,1876,14150998,14151026
4647,4,1,1,2412,-91,-88,-3,ac:67:84:84:8a:07,14154520,416,3078,14154104,14154520
4648,6,24,1,2412,-83,-88,5,,14163613,28,9065,14163585,14163613
4649,6,24,1,2412,-81,-88,7,,14171504,28,7863,14171476,14171504
4650,6,6,1,2412,-60,-88,28,b4:e6:2d:b4:ff:71,14171980,64,412,14171916,14171980
4651,6,6,1,2412,-59,-88,29,,14172060,44,36,14172016,14172060
4652,4,1,1,2412,-74,-88,14,ac:67:84:84:8a:07,14175641,448,3133,14175193,14175641
4653,4,1,1,2412,-66,-88,22,b0:e4:d5:32:ec:8a,14186000,1960,8399,14184040,14186000
4654,6,6,1,2412,-58,-88,30,10:86:8c:5f:93:1e,14192503,344,6159,14192159,14192503
4655,4,1,1,2412,-58,-88,30,94:a6:7e:c9:98:67,14193002,2464,-1965,14190538,14193002
4656,4,11,1,2412,-84,-88,4,4c:01:43:d7:f3:29,14196238,362,2874,14195876,14196238
4657,4,11,1,2412,-86,-88,2,4c:01:43:d7:f3:23,14196613,322,53,14196291,14196613
4658,4,11,1,2412,-77,-88,11,48:dd:0c:7d:86:27,14210629,362,13654,14210267,14210629
4659,4,11,1,2412,-78,-88,10,48:dd:0c:7d:86:23,14211003,323,51,14210680,14211003
4660,4,11,1,2412,-76,-88,12,48:dd:0c:7d:86:25,14211338,382,-47,14210956,14211338
4661,6,6,1,2412,-56,-88,32,12:86:8c:5f:93:1e,14215531,332,3861,14215199,14215531
4662,4,1,1,2412,-92,-88,-4,70:3a:cb:63:35:b2,14216055,2216,-1692,14213839,14216055
4663,6,24,1,2412,-85,-88,3,,14231027,28,14944,14230999,14231027
4664,6,24,1,2412,-81,-88,7,,14233281,28,2226,14233253,14233281
4665,4,11,1,2412,-86,-88,2,4c:01:43:ec:a0:69,14234394,361,752,14234033,14234394
4666,4,11,1,2412,-86,-88,2,48:dd:0c:90:e3:87,14235734,362,978,14235372,14235734
4667,4,11,1,2412,-86,-88,2,48:dd:0c:90:e3:83,14236108,323,51,14235785,14236108
4668,4,11,1,2412,-82,-88,6,48:dd:0c:90:e3:85,14236443,382,-47,14236061,14236443
4669,6,24,1,2412,-81,-88,7,,14253849,28,17378,14253821,14253849
4670,4,1,1,2412,-88,-88,0,,14256224,304,2071,14255920,14256224
4671,4,11,1,2412,-85,-88,3,,14272556,107,16225,14272449,14272556
4672,6,24,1,2412,-82,-88,6,78:67:0e:c4:a8:42,14272670,32,82,14272638,14272670
4673,4,1,1,2412,-86,-88,2,78:67:0e:c4:a8:42,14275751,352,2729,14275399,14275751
4674,4,1,1,2412,-69,-88,19,b0:e4:d5:32:ec:8a,14288399,1960,10688,14286439,14288399
4675,6,6,1,2412,-59,-88,29,10:86:8c:5f:93:1e,14294890,344,6147,14294546,14294890
4676,4,1,1,2412,-65,-88,23,94:a6:7e:c9:98:67,14295388,2464,-1966,14292924,14295388
4677,4,11,1,2412,-83,-88,5,4c:01:43:d7:f3:29,14298761,362,3011,14298399,14298761
4678,4,11,1,2412,-85,-88,3,4c:01:43:d7:f3:23,14299135,322,52,14298813,14299135
4679,4,11,1,2412,-85,-88,3,4c:01:43:d7:f3:26,14299470,387,-52,14299083,14299470
4680,4,11,1,2412,-75,-88,13,48:dd:0c:7d:86:25,14313738,382,13886,14313356,14313738
4681,6,6,1,2412,-85,-88,3,40:b0:34:b7:01:d5,14316169,576,1855,14315593,14316169
4682,6,6,1,2412,-57,-88,31,12:86:8c:5f:93:1e,14317932,332,1431,14317600,14317932
4683,4,1,1,2412,-88,-88,0,00:26:62:eb:ea:74,14328350,968,9450,14327382,14328350
4684,6,6,1,2412,-89,-88,-1,e2:db:d1:d1:b0:4b,14329270,408,512,14328862,14329270
4685,4,11,1,2412,-86,-88,2,4c:01:43:ec:a0:69,14336790,361,7159,14336429,14336790
4686,4,11,1,2412,-86,-88,2,4c:01:43:ec:a0:63,14337164,322,52,14336842,14337164
4687,4,11,1,2412,-86,-88,2,4c:01:43:ec:a0:66,14337498,387,-53,14337111,14337498
4688,4,11,1,2412,-79,-88,9,48:dd:0c:90:e3:87,14338133,362,273,14337771,14338133
4689,6,6,1,2412,-86,-88,2,,14341257,44,3080,14341213,14341257
4690,6,6,1,2412,-58,-88,30,52:86:8c:5f:93:1e,14343533,332,1944,14343201,14343533
4691,6,6,1,2412,-57,-88,31,32:86:8c:5f:93:1e,14369132,332,25267,14368800,14369132
4692,4,1,1,2412,-68,-88,20,b0:e4:d5:32:ec:8a,14390798,1960,19706,14388838,14390798
4693,6,6,1,2412,-57,-88,31,10:86:8c:5f:93:1e,14394732,344,3590,14394388,14394732
4694,4,1,1,2412,-67,-88,21,94:a6:7e:c9:98:67,14397775,2464,579,14395311,14397775
4695,6,24,1,2412,-84,-88,4,,14400079,28,2276,14400051,14400079
4696,4,11,1,2412,-77,-88,11,4c:01:43:d7:f3:29,14401037,362,596,14400675,14401037
4697,6,24,1,2412,-82,-88,6,,14404647,28,3582,14404619,14404647
4698,4,11,1,2412,-73,-88,15,48:dd:0c:7d:86:23,14415804,323,10834,14415481,14415804
4699,4,11,1,2412,-73,-88,15,48:dd:0c:7d:86:25,14416139,382,-47,14415757,14416139
4700,6,24,1,2412,-85,-88,3,,14418267,28,2100,14418239,14418267
4701,6,6,1,2412,-59,-88,29,12:86:8c:5f:93:1e,14420333,332,1734,14420001,14420333
4702,6,6,1,2412,-87,-88,1,3c:bd:c5:ee:96:6d,14420886,68,485,14420818,14420886
4703,4,1,1,2412,-92,-88,-4,78:67:0e:4b:85:1f,14435204,2552,11766,14432652,14435204
4704,4,11,1,2412,-78,-88,10,4c:01:43:ec:a0:69,14439189,361,3624,14438828,14439189
4705,4,11,1,2412,-80,-88,8,4c:01:43:ec:a0:63,14439563,322,52,14439241,14439563
4706,4,11,1,2412,-81,-88,7,48:dd:0c:90:e3:87,14440533,362,608,14440171,14440533
4707,4,11,1,2412,-81,-88,7,48:dd:0c:90:e3:83,14440908,323,52,14440585,14440908
4708,4,11,1,2412,-80,-88,8,48:dd:0c:90:e3:85,14441243,382,-47,14440861,14441243
4709,6,6,1,2412,-57,-88,31,52:86:8c:5f:93:1e,14445932,332,4357,14445600,14445932
4710,4,1,1,2412,-87,-88,1,,14450355,304,4119,14450051,14450355
4711,4,11,1,2412,-84,-88,4,,14460693,107,10231,14460586,14460693
4712,6,24,1,2412,-84,-88,4,78:67:0e:c4:a8:42,14460868,32,143,14460836,14460868
4713,6,24,1,2412,-81,-88,7,,14471029,28,10133,14471001,14471029
4714,6,6,1,2412,-57,-88,31,32:86:8c:5f:93:1e,14471533,332,172,14471201,14471533
4715,6,24,1,2412,-83,-88,5,,14477498,28,5937,14477470,14477498
4716,4,5.5,1,2412,-93,-88,-5,,14479911,213,2200,14479698,14479911
4717,6,24,1,2412,-81,-88,7,,14484345,28,4406,14484317,14484345
4718,4,1,1,2412,-88,-88,0,,14488834,304,4185,14488530,14488834
4719,4,1,1,2412,-66,-88,22,b0:e4:d5:32:ec:8a,14493198,1960,2404,14491238,14493198
4720,4,1,1,2412,-68,-88,20,94:a6:7e:c9:98:67,14500183,2464,4521,14497719,14500183
4721,4,11,1,2412,-67,-88,21,4c:01:43:d7:f3:23,14503811,322,3306,14503489,14503811
4722,4,11,1,2412,-84,-88,4,4c:01:43:d7:f3:26,14504146,387,-52,14503759,14504146
4723,4,1,1,2412,-83,-88,5,78:67:0e:38:6c:d3,14515070,2736,8188,14512334,14515070
4724,4,11,1,2412,-75,-88,13,48:dd:0c:7d:86:27,14517829,362,2397,14517467,14517829
4725,4,11,1,2412,-74,-88,14,48:dd:0c:7d:86:23,14518204,323,52,14517881,14518204
4726,4,11,1,2412,-75,-88,13,48:dd:0c:7d:86:25,14518539,382,-47,14518157,14518539
4727,6,6,1,2412,-85,-88,3,40:b0:34:b7:01:d5,14520908,576,1793,14520332,14520908
4728,6,6,1,2412,-55,-88,33,12:86:8c:5f:93:1e,14522733,332,1493,14522401,14522733
4729,4,1,1,2412,-83,-88,5,78:67:0e:c4:a8:42,14535220,352,12135,14534868,14535220
4730,4,1,1,2412,-83,-88,5,78:67:0e:c4:a8:42,14536089,352,517,14535737,14536089
4731,4,11,1,2412,-81,-88,7,,14540423,107,4227,14540316,14540423
4732,6,24,1,2412,-84,-88,4,78:67:0e:c4:a8:42,14540555,32,100,14540523,14540555
4733,4,11,1,2412,-83,-88,5,4c:01:43:ec:a0:69,14541588,361,672,14541227,14541588
4734,4,11,1,2412,-84,-88,4,48:dd:0c:90:e3:83,14543307,323,1396,14542984,14543307
4735,6,6,1,2412,-56,-88,32,52:86:8c:5f:93:1e,14548333,332,4694,14548001,14548333
4736,6,24,1,2412,-80,-88,8,,14551030,28,2669,14551002,14551030
4737,4,1,1,2412,-90,-88,-2,,14553666,304,2332,14553362,14553666
4738,4,1,1,2412,-84,-88,4,78:67:0e:c4:a8:42,14555127,2736,-1275,14552391,14555127
4739,4,1,1,2412,-90,-88,-2,78:67:0e:c4:a8:42,14557927,352,2448,14557575,14557927
4740,6,24,1,2412,-85,-88,3,,14558898,28,943,14558870,14558898
4741,6,24,1,2412,-80,-88,8,,14563608,28,4682,14563580,14563608
4742,4,1,1,2412,-92,-88,-4,ac:67:84:84:8a:07,14570890,448,6834,14570442,14570890
4743,6,6,1,2412,-56,-88,32,32:86:8c:5f:93:1e,14573934,332,2712,14573602,14573934
4744,6,24,1,2412,-73,-88,15,,14587316,28,13354,14587288,14587316
4745,4,1,1,2412,-66,-88,22,b0:e4:d5:32:ec:8a,14595597,1960,6321,14593637,14595597
4746,6,6,1,2412,-56,-88,32,10:86:8c:5f:93:1e,14599533,344,3592,14599189,14599533
4747,4,1,1,2412,-66,-88,22,94:a6:7e:c9:98:67,14602578,2464,581,14600114,14602578
4748,6,24,1,2412,-83,-88,5,,14605195,28,2589,14605167,14605195
4749,4,11,1,2412,-81,-88,7,4c:01:43:d7:f3:29,14605836,362,279,14605474,14605836
4750,4,11,1,2412,-80,-88,8,4c:01:43:d7:f3:23,14606211,322,53,14605889,14606211
4751,4,11,1,2412,-81,-88,7,4c:01:43:d7:f3:26,14606545,387,-53,14606158,14606545
4752,4,11,1,2412,-78,-88,10,48:dd:0c:7d:86:23,14620604,323,13736,14620281,14620604
4753,4,11,1,2412,-71,-88,17,48:dd:0c:7d:86:25,14620940,382,-46,14620558,14620940
4754,6,6,1,2412,-90,-88,-2,40:b0:34:b7:01:d5,14623309,576,1793,14622733,14623309
4755,6,6,1,2412,-55,-88,33,12:86:8c:5f:93:1e,14625134,332,1493,14624802,14625134
4756,6,24,1,2412,-80,-88,8,,14631080,28,5918,14631052,14631080
4757,6,6,1,2412,-87,-88,1,e2:db:d1:d1:b0:4a,14635985,444,4461,14635541,14635985
4758,6,6,1,2412,-87,-88,1,e2:db:d1:d1:b0:4b,14636461,408,68,14636053,14636461
4759,6,6,1,2412,-87,-88,1,,14636977,44,472,14636933,14636977
4760,4,11,1,2412,-83,-88,5,4c:01:43:ec:a0:63,14644360,322,7061,14644038,14644360
4761,4,11,1,2412,-84,-88,4,4c:01:43:ec:a0:66,14644695,387,-52,14644308,14644695
4762,4,11,1,2412,-78,-88,10,48:dd:0c:90:e3:87,14645333,362,276,14644971,14645333
4763,4,11,1,2412,-78,-88,10,48:dd:0c:90:e3:83,14645707,323,51,14645384,14645707
4764,4,11,1,2412,-78,-88,10,48:dd:0c:90:e3:85,14646042,382,-47,14645660,14646042
4765,6,6,1,2412,-55,-88,33,52:86:8c:5f:93:1e,14650735,332,4361,14650403,14650735
4766,6,6,1,2412,-89,-88,-1,0a:a7:c0:a3:8d:70,14655681,464,4482,14655217,14655681
4767,6,6,1,2412,-87,-88,1,0a:a7:c0:a3:8d:71,14656177,408,88,14655769,14656177
4768,6,6,1,2412,-89,-88,-1,0a:a7:c0:a3:8d:73,14656618,408,33,14656210,14656618
4769,6,6,1,2412,-88,-88,0,,14668791,44,12129,14668747,14668791
4770,4,1,1,2412,-87,-88,1,,14670878,304,1783,14670574,14670878
4771,4,1,1,2412,-87,-88,1,,14671737,304,555,14671433,14671737
4772,6,6,1,2412,-88,-88,0,,14671998,44,217,14671954,14671998
4773,4,1,1,2412,-91,-88,-3,ac:67:84:84:8a:07,14674567,448,2121,14674119,14674567
4774,4,1,1,2412,-87,-88,1,,14676054,304,1183,14675750,14676054
4775,6,6,1,2412,-55,-88,33,32:86:8c:5f:93:1e,14676334,332,-52,14676002,14676334
4776,4,1,1,2412,-65,-88,23,b0:e4:d5:32:ec:8a,14697996,1960,19702,14696036,14697996
4777,4,1,1,2412,-57,-88,31,,14700120,304,1820,14699816,14700120
4778,6,24,1,2412,-71,-88,17,,14700337,28,189,14700309,14700337
4779,4,1,1,2412,-54,-88,34,,14701889,304,1248,14701585,14701889
4780,6,6,1,2412,-55,-88,33,10:86:8c:5f:93:1e,14702049,344,-184,14701705,14702049
4781,4,1,1,2412,-65,-88,23,94:a6:7e:c9:98:67,14704972,2464,459,14702508,14704972
4782,4,11,1,2412,-72,-88,16,4c:01:43:d7:f3:29,14708236,362,2902,14707874,14708236
4783,4,11,1,2412,-76,-88,12,4c:01:43:d7:f3:23,14708610,322,52,14708288,14708610
4784,4,11,1,2412,-81,-88,7,4c:01:43:d7:f3:26,14708945,387,-52,14708558,14708945
4785,4,1,1,2412,-87,-88,1,38:01:46:30:1a:ca,14715612,416,6251,14715196,14715612
4786,4,1,1,2412,-80,-88,8,78:67:0e:38:6c:d3,14719871,2736,1523,14717135,14719871
4787,4,11,1,2412,-79,-88,9,48:dd:0c:7d:86:27,14722630,362,2397,14722268,14722630
4788,4,11,1,2412,-76,-88,12,48:dd:0c:7d:86:23,14723004,323,51,14722681,14723004
4789,4,11,1,2412,-77,-88,11,48:dd:0c:7d:86:25,14723340,382,-46,14722958,14723340
4790,4,1,1,2412,-90,-88,-2,00:26:62:eb:ea:74,14736434,968,12126,14735466,14736434
4791,4,11,1,2412,-86,-88,2,4c:01:43:ec:a0:69,14746385,361,9590,14746024,14746385
4792,4,11,1,2412,-85,-88,3,4c:01:43:ec:a0:63,14746759,322,52,14746437,14746759
4793,4,11,1,2412,-78,-88,10,48:dd:0c:90:e3:87,14747732,362,611,14747370,14747732
4794,4,11,1,2412,-78,-88,10,48:dd:0c:90:e3:83,14748107,323,52,14747784,14748107
4795,4,11,1,2412,-78,-88,10,48:dd:0c:90:e3:85,14748442,382,-47,14748060,14748442
4796,6,6,1,2412,-88,-88,0,,14750592,44,2106,14750548,14750592
4797,6,24,1,2412,-83,-88,5,,14778743,28,28123,14778715,14778743
4798,6,6,1,2412,-57,-88,31,32:86:8c:5f:93:1e,14778804,332,-271,14778472,14778804
4799,4,1,1,2412,-91,-88,-3,ce:f4:11:65:3f:f8,14780394,2072,-482,14778322,14780394
4800,4,1,1,2412,-92,-88,-4,ac:67:84:84:8a:07,14784804,416,3994,14784388,14784804
4801,6,24,1,2412,-79,-88,9,,14791031,28,6199,14791003,14791031
4802,6,24,1,2412,-85,-88,3,,14799080,28,8021,14799052,14799080
4803,4,1,1,2412,-60,-88,28,b0:e4:d5:32:ec:8a,14800396,1960,-644,14798436,14800396
4804,6,24,1,2412,-79,-88,9,,14803609,28,3185,14803581,14803609
4805,6,6,1,2412,-58,-88,30,10:86:8c:5f:93:1e,14806910,344,2957,14806566,14806910
4806,4,1,1,2412,-60,-88,28,94:a6:7e:c9:98:67,14807408,2464,-1966,14804944,14807408
4807,4,11,1,2412,-80,-88,8,4c:01:43:d7:f3:29,14810635,362,2865,14810273,14810635
4808,4,11,1,2412,-79,-88,9,4c:01:43:d7:f3:23,14811010,322,53,14810688,14811010
4809,4,11,1,2412,-80,-88,8,4c:01:43:d7:f3:26,14811344,387,-53,14810957,14811344
4810,4,1,1,2412,-90,-88,-2,,14821655,304,10007,14821351,14821655
4811,4,1,1,2412,-80,-88,8,78:67:0e:38:6c:d3,14822271,2736,-2120,14819535,14822271
4812,4,11,1,2412,-79,-88,9,48:dd:0c:7d:86:27,14825031,362,2398,14824669,14825031
4813,4,11,1,2412,-79,-88,9,48:dd:0c:7d:86:23,14825405,323,51,14825082,14825405
4814,4,11,1,2412,-79,-88,9,48:dd:0c:7d:86:25,14825740,382,-47,14825358,14825740
4815,6,6,1,2412,-90,-88,-2,40:b0:34:b7:01:d5,14828111,576,1795,14827535,14828111
4816,6,6,1,2412,-59,-88,29,12:86:8c:5f:93:1e,14829935,332,1492,14829603,14829935
4817,4,11,1,2412,-81,-88,7,4c:01:43:ec:a0:69,14848784,361,18488,14848423,14848784
4818,4,11,1,2412,-82,-88,6,4c:01:43:ec:a0:63,14849158,322,52,14848836,14849158
4819,4,11,1,2412,-72,-88,16,48:dd:0c:90:e3:87,14850132,362,612,14849770,14850132
4820,4,11,1,2412,-79,-88,9,48:dd:0c:90:e3:85,14850842,382,328,14850460,14850842
4821,6,6,1,2412,-59,-88,29,52:86:8c:5f:93:1e,14855535,332,4361,14855203,14855535
4822,4,1,1,2412,-86,-88,2,78:67:0e:c4:a8:42,14862326,2736,4055,14859590,14862326
4823,6,24,1,2412,-80,-88,8,,14871039,28,8685,14871011,14871039
4824,6,6,1,2412,-59,-88,29,32:86:8c:5f:93:1e,14881136,332,9765,14880804,14881136
4825,4,1,1,2412,-90,-88,-2,,14900413,304,18973,14900109,14900413
4826,4,1,1,2412,-61,-88,27,b0:e4:d5:32:ec:8a,14902795,1960,422,14900835,14902795
4827,6,6,1,2412,-59,-88,29,10:86:8c:5f:93:1e,14906736,344,3597,14906392,14906736
4828,4,1,1,2412,-58,-88,30,94:a6:7e:c9:98:67,14909772,2464,572,14907308,14909772
4829,4,11,1,2412,-86,-88,2,4c:01:43:d7:f3:26,14913744,387,3585,14913357,14913744
4830,4,11,1,2412,-86,-88,2,48:dd:0c:92:4b:e7,14916066,362,1960,14915704,14916066
4831,4,11,1,2412,-87,-88,1,48:dd:0c:92:4b:e3,14916441,323,52,14916118,14916441
4832,4,11,1,2412,-86,-88,2,48:dd:0c:92:4b:e5,14916776,382,-47,14916394,14916776
4833,4,1,1,2412,-90,-88,-2,,14920317,304,3237,14920013,14920317
4834,4,1,1,2412,-83,-88,5,78:67:0e:38:6c:d3,14924671,2736,1618,14921935,14924671
4835,4,11,1,2412,-74,-88,14,48:dd:0c:7d:86:27,14927430,362,2397,14927068,14927430
4836,4,11,1,2412,-74,-88,14,48:dd:0c:7d:86:23,14927805,323,52,14927482,14927805
4837,4,11,1,2412,-73,-88,15,48:dd:0c:7d:86:25,14928140,382,-47,14927758,14928140
4838,6,6,1,2412,-58,-88,30,12:86:8c:5f:93:1e,14934968,332,6496,14934636,14934968
4839,6,6,1,2412,-89,-88,-1,e2:db:d1:d1:b0:4a,14945164,548,9648,14944616,14945164
4840,4,1,1,2412,-88,-88,0,,14947132,304,1664,14946828,14947132
4841,6,24,1,2412,-83,-88,5,,14951033,28,3873,14951005,14951033
4842,4,11,1,2412,-84,-88,4,4c:01:43:ec:a0:69,14951349,361,-45,14950988,14951349
4843,4,11,1,2412,-87,-88,1,4c:01:43:ec:a0:63,14951723,322,52,14951401,14951723
4844,4,11,1,2412,-86,-88,2,4c:01:43:ec:a0:66,14952057,387,-53,14951670,14952057
4845,4,11,1,2412,-84,-88,4,48:dd:0c:90:e3:87,14952532,362,113,14952170,14952532
4846,4,11,1,2412,-84,-88,4,48:dd:0c:90:e3:85,14953242,382,328,14952860,14953242
4847,6,6,1,2412,-89,-88,-1,0a:a7:c0:a3:8d:73,14961637,408,7987,14961229,14961637
4848,6,24,1,2412,-82,-88,6,,14964314,28,2649,14964286,14964314
4849,4,1,1,2412,-86,-88,2,78:67:0e:c4:a8:42,14964726,2736,-2324,14961990,14964726
4850,4,1,1,2412,-92,-88,-4,04:a2:22:bf:24:52,14968892,2512,1654,14966380,14968892
4851,4,1,1,2412,-91,-88,-3,ac:67:84:84:8a:07,14982032,448,12692,14981584,14982032
4852,4,1,1,2412,-92,-88,-4,ac:67:84:84:8a:07,14982909,448,429,14982461,14982909
4853,6,6,1,2412,-57,-88,31,32:86:8c:5f:93:1e,14983536,332,295,14983204,14983536
4854,6,24,1,2412,-82,-88,6,,14987320,28,3756,14987292,14987320
4855,4,1,1,2412,-76,-88,12,b0:e4:d5:32:ec:8a,15005194,1960,15914,15003234,15005194
4856,6,6,1,2412,-59,-88,29,10:86:8c:5f:93:1e,15009136,344,3598,15008792,15009136
4857,4,1,1,2412,-61,-88,27,94:a6:7e:c9:98:67,15011950,2464,350,15009486,15011950
4858,4,11,1,2412,-80,-88,8,4c:01:43:d7:f3:23,15015809,322,3537,15015487,15015809
4859,4,11,1,2412,-80,-88,8,4c:01:43:d7:f3:26,15016143,387,-53,15015756,15016143
4860,4,11,1,2412,-76,-88,12,48:dd:0c:7d:86:27,15029830,362,13325,15029468,15029830
4861,4,11,1,2412,-76,-88,12,48:dd:0c:7d:86:23,15030205,323,52,15029882,15030205
4862,4,11,1,2412,-76,-88,12,48:dd:0c:7d:86:25,15030540,382,-47,15030158,15030540
4863,6,24,1,2412,-80,-88,8,,15032120,28,1552,15032092,15032120
4864,6,6,1,2412,-85,-88,3,40:b0:34:b7:01:d5,15033563,576,867,15032987,15033563
4865,6,6,1,2412,-59,-88,29,12:86:8c:5f:93:1e,15034738,332,843,15034406,15034738
4866,4,1,1,2412,-90,-88,-2,,15035229,304,187,15034925,15035229
4867,4,1,1,2412,-88,-88,0,00:26:62:eb:ea:74,15042720,968,6523,15041752,15042720
4868,4,1,1,2412,-89,-88,-1,78:67:0e:c4:a8:42,15051531,352,8459,15051179,15051531
4869,4,11,1,2412,-87,-88,1,4c:01:43:ec:a0:69,15053582,361,1690,15053221,15053582
4870,4,11,1,2412,-86,-88,2,4c:01:43:ec:a0:63,15053956,322,52,15053634,15053956
4871,4,11,1,2412,-86,-88,2,4c:01:43:ec:a0:66,15054290,387,-53,15053903,15054290
4872,4,11,1,2412,-89,-88,-1,48:dd:0c:90:e3:87,15054932,362,280,15054570,15054932
4873,4,11,1,2412,-89,-88,-1,48:dd:0c:90:e3:83,15055306,323,51,15054983,15055306
4874,4,11,1,2412,-89,-88,-1,48:dd:0c:90:e3:85,15055641,382,-47,15055259,15055641
4875,6,6,1,2412,-85,-88,3,,15080946,44,25261,15080902,15080946
4876,6,24,1,2412,-80,-88,8,,15081283,28,309,15081255,15081283
4877,4,1,1,2412,-92,-88,-4,ac:67:84:84:8a:07,15084837,448,3106,15084389,15084837
4878,6,6,1,2412,-57,-88,31,32:86:8c:5f:93:1e,15085936,332,767,15085604,15085936
4879,6,24,1,2412,-81,-88,7,,15103863,28,17899,15103835,15103863
4880,4,1,1,2412,-70,-88,18,b0:e4:d5:32:ec:8a,15107593,1960,1770,15105633,15107593
4881,6,24,1,2412,-84,-88,4,,15111038,28,3417,15111010,15111038
4882,6,6,1,2412,-57,-88,31,10:86:8c:5f:93:1e,15111538,344,156,15111194,15111538
4883,4,1,1,2412,-59,-88,29,94:a6:7e:c9:98:67,15114579,2464,577,15112115,15114579
4884,4,11,1,2412,-86,-88,2,4c:01:43:d7:f3:23,15118208,322,3307,15117886,15118208
4885,4,11,1,2412,-83,-88,5,4c:01:43:d7:f3:26,15118543,387,-52,15118156,15118543
4886,4,1,1,2412,-88,-88,0,,15121565,304,2718,15121261,15121565
4887,6,6,1,2412,-87,-88,1,,15121834,44,225,15121790,15121834
4888,6,24,1,2412,-84,-88,4,,15123616,28,1754,15123588,15123616
4889,4,11,1,2412,-74,-88,14,48:dd:0c:7d:86:27,15129809,362,5831,15129447,15129809
4890,4,11,1,2412,-74,-88,14,48:dd:0c:7d:86:23,15130184,323,52,15129861,15130184
4891,4,11,1,2412,-75,-88,13,48:dd:0c:7d:86:25,15130519,382,-47,15130137,15130519
4892,4,11,1,2412,-85,-88,3,4c:01:43:d7:f3:23,15132257,254,1484,15132003,15132257
4893,4,11,1,2412,-82,-88,6,4c:01:43:ec:a0:63,15132559,254,48,15132305,15132559
4894,4,1,1,2412,-90,-88,-2,,15134172,304,1309,15133868,15134172
4895,6,6,1,2412,-86,-88,2,,15134558,44,342,15134514,15134558
4896,6,6,1,2412,-59,-88,29,12:86:8c:5f:93:1e,15137137,332,2247,15136805,15137137
4897,6,6,1,2412,-84,-88,4,,15146766,44,9585,15146722,15146766
4898,6,12,1,2412,-85,-88,3,,15151520,32,4722,15151488,15151520
4899,4,11,1,2412,-83,-88,5,4c:01:43:ec:a0:69,15155981,361,4100,15155620,15155981
4900,4,11,1,2412,-81,-88,7,4c:01:43:ec:a0:63,15156354,322,51,15156032,15156354
4901,4,11,1,2412,-83,-88,5,4c:01:43:ec:a0:66,15156689,387,-52,15156302,15156689
4902,6,24,1,2412,-84,-88,4,,15160735,28,4018,15160707,15160735
4903,6,6,1,2412,-59,-88,29,52:86:8c:5f:93:1e,15162737,332,1670,15162405,15162737
4904,4,1,1,2412,-87,-88,1,78:67:0e:c4:a8:42,15168142,352,5053,15167790,15168142
4905,4,1,1,2412,-89,-88,-1,78:67:0e:c4:a8:42,15169526,2736,-1352,15166790,15169526
4906,6,24,1,2412,-82,-88,6,78:67:0e:c4:a8:42,15172932,32,3374,15172900,15172932
4907,6,6,1,2412,-88,-88,0,,15174421,44,1445,15174377,15174421
4908,6,24,1,2412,-82,-88,6,,15191044,28,16595,15191016,15191044
4909,6,6,1,2412,-90,-88,-2,,15192351,44,1263,15192307,15192351
4910,6,6,1,2412,-88,-88,0,,15192932,44,537,15192888,15192932
4911,6,6,1,2412,-89,-88,-1,,15193497,44,521,15193453,15193497
4912,6,6,1,2412,-88,-88,0,,15195485,44,1944,15195441,15195485
4913,6,6,1,2412,-88,-88,0,,15200861,44,5332,15200817,15200861
4914,6,24,1,2412,-80,-88,8,,15203504,28,2615,15203476,15203504
4915,6,24,1,2412,-81,-88,7,,15204454,28,922,15204426,15204454
4916,6,24,1,2412,-81,-88,7,,15208537,28,4055,15208509,15208537
4917,4,1,1,2412,-66,-88,22,b0:e4:d5:32:ec:8a,15209993,1960,-504,15208033,15209993
4918,6,6,1,2412,-60,-88,28,10:86:8c:5f:93:1e,15213939,344,3602,15213595,15213939
4919,4,1,1,2412,-90,-88,-2,,15214780,304,537,15214476,15214780
4920,4,1,1,2412,-84,-88,4,bc:98:df:ff:0f:8b,15215188,2568,-2160,15212620,15215188
4921,4,1,1,2412,-61,-88,27,94:a6:7e:c9:98:67,15217805,2464,153,15215341,15217805
4922,4,11,1,2412,-80,-88,8,4c:01:43:d7:f3:29,15220233,362,2066,15219871,15220233
4923,4,11,1,2412,-81,-88,7,4c:01:43:d7:f3:23,15220608,322,53,15220286,15220608
4924,4,11,1,2412,-80,-88,8,4c:01:43:d7:f3:26,15220942,387,-53,15220555,15220942
4925,4,1,1,2412,-85,-88,3,bc:98:df:ff:0f:8b,15224384,3176,266,15221208,15224384
4926,4,1,1,2412,-89,-88,-1,78:67:0e:38:6c:d3,15231872,2736,4752,15229136,15231872
4927,4,11,1,2412,-79,-88,9,48:dd:0c:7d:86:27,15234631,362,2397,15234269,15234631
4928,4,11,1,2412,-79,-88,9,48:dd:0c:7d:86:25,15235341,382,328,15234959,15235341
4929,6,6,1,2412,-77,-88,11,4c:01:43:d7:f3:26,15236171,52,778,15236119,15236171
4930,6,24,1,2412,-79,-88,9,,15237268,28,1069,15237240,15237268
4931,6,6,1,2412,-78,-88,10,4c:01:43:d7:f3:26,15237507,52,187,15237455,15237507
4932,6,6,1,2412,-85,-88,3,40:b0:34:b7:01:d5,15238050,576,-33,15237474,15238050
4933,6,6,1,2412,-61,-88,27,12:86:8c:5f:93:1e,15239538,332,1156,15239206,15239538
4934,4,1,1,2412,-88,-88,0,00:26:62:eb:ea:74,15247519,968,7013,15246551,15247519
4935,6,24,1,2412,-79,-88,9,,15249440,28,1893,15249412,15249440
4936,6,6,1,2412,-90,-88,-2,e2:db:d1:d1:b0:4a,15250390,444,506,15249946,15250390
4937,6,6,1,2412,-91,-88,-3,e2:db:d1:d1:b0:4d,15251317,408,519,15250909,15251317
4938,4,11,1,2412,-79,-88,9,48:dd:0c:7d:86:23,15255631,284,4030,15255347,15255631
4939,4,11,1,2412,-82,-88,6,4c:01:43:ec:a0:69,15258380,361,2388,15258019,15258380
4940,4,11,1,2412,-82,-88,6,4c:01:43:ec:a0:63,15258753,322,51,15258431,15258753
4941,4,11,1,2412,-82,-88,6,4c:01:43:ec:a0:66,15259088,387,-52,15258701,15259088
4942,4,11,1,2412,-81,-88,7,48:dd:0c:90:e3:85,15260441,382,971,15260059,15260441
4943,6,6,1,2412,-59,-88,29,52:86:8c:5f:93:1e,15265139,332,4366,15264807,15265139
4944,6,24,1,2412,-81,-88,7,78:67:0e:c4:a8:42,15271658,32,6487,15271626,15271658
4945,4,11,1,2412,-82,-88,6,4c:01:43:ec:a0:63,15275844,254,3932,15275590,15275844
4946,6,24,1,2412,-78,-88,10,,15284193,28,8321,15284165,15284193
4947,4,1,1,2412,-77,-88,11,ac:67:84:84:8a:07,15290405,448,5764,15289957,15290405
4948,6,6,1,2412,-57,-88,31,32:86:8c:5f:93:1e,15290739,332,2,15290407,15290739
4949,4,1,1,2412,-92,-88,-4,,15295676,304,4633,15295372,15295676
4950,4,1,1,2412,-64,-88,24,b0:e4:d5:32:ec:8a,15312392,1960,14756,15310432,15312392
4951,4,1,1,2412,-71,-88,17,94:a6:7e:c9:98:67,15319379,2464,4523,15316915,15319379
4952,6,6,1,2412,-56,-88,32,10:86:8c:5f:93:1e,15321810,344,2087,15321466,15321810
4953,4,11,1,2412,-79,-88,9,4c:01:43:d7:f3:29,15322633,362,461,15322271,15322633
4954,4,11,1,2412,-79,-88,9,4c:01:43:d7:f3:23,15323007,322,52,15322685,15323007
4955,4,11,1,2412,-78,-88,10,4c:01:43:d7:f3:26,15323342,387,-52,15322955,15323342
4956,6,24,1,2412,-84,-88,4,,15333312,28,9942,15333284,15333312
4957,6,6,1,2412,-83,-88,5,,15333850,44,494,15333806,15333850
4958,4,11,1,2412,-79,-88,9,48:dd:0c:7d:86:27,15337139,362,2927,15336777,15337139
4959,4,11,1,2412,-78,-88,10,48:dd:0c:7d:86:25,15337848,382,327,15337466,15337848
4960,6,6,1,2412,-56,-88,32,12:86:8c:5f:93:1e,15341940,332,3760,15341608,15341940
4961,6,24,1,2412,-78,-88,10,,15352018,28,10050,15351990,15352018
4962,6,6,1,2412,-91,-88,-3,e2:db:d1:d1:b0:4a,15352793,444,331,15352349,15352793
4963,6,24,1,2412,-84,-88,4,,15354478,28,1657,15354450,15354478
4964,4,1,1,2412,-87,-88,1,,15355181,304,399,15354877,15355181
4965,6,6,1,2412,-90,-88,-2,,15356467,44,1242,15356423,15356467
4966,4,11,1,2412,-79,-88,9,48:dd:0c:90:e3:87,15362131,362,5302,15361769,15362131
4967,4,11,1,2412,-84,-88,4,4c:01:43:ec:a0:63,15364492,322,2039,15364170,15364492
4968,4,11,1,2412,-84,-88,4,4c:01:43:ec:a0:66,15364827,387,-52,15364440,15364827
4969,6,6,1,2412,-56,-88,32,52:86:8c:5f:93:1e,15368978,332,3819,15368646,15368978
4970,6,6,1,2412,-88,-88,0,,15373922,44,4900,15373878,15373922
4971,4,1,1,2412,-86,-88,2,78:67:0e:c4:a8:42,15374326,2736,-2332,15371590,15374326
4972,4,1,1,2412,-88,-88,0,,15382939,304,8309,15382635,15382939
4973,6,6,1,2412,-90,-88,-2,,15383165,44,182,15383121,15383165
4974,6,6,1,2412,-56,-88,32,32:86:8c:5f:93:1e,15393139,332,9642,15392807,15393139
4975,4,1,1,2412,-88,-88,0,,15393627,304,184,15393323,15393627
4976,6,6,1,2412,-89,-88,-1,,15393853,44,182,15393809,15393853
4977,6,24,1,2412,-83,-88,5,,15397212,28,3331,15397184,15397212
4978,6,6,1,2412,-89,-88,-1,,15411342,44,14086,15411298,15411342
4979,4,1,1,2412,-89,-88,-1,,15412603,304,957,15412299,15412603
4980,6,6,1,2412,-87,-88,1,,15412824,44,177,15412780,15412824
4981,4,1,1,2412,-60,-88,28,b0:e4:d5:32:ec:8a,15414791,1960,7,15412831,15414791
4982,6,24,1,2412,-82,-88,6,,15417792,28,2973,15417764,15417792
4983,4,1,1,2412,-87,-88,1,bc:98:df:ff:0f:8b,15418887,2568,-1473,15416319,15418887
4984,6,6,1,2412,-57,-88,31,10:86:8c:5f:93:1e,15421310,344,2079,15420966,15421310
4985,4,1,1,2412,-64,-88,24,94:a6:7e:c9:98:67,15421864,2464,-1910,15419400,15421864
4986,4,11,1,2412,-76,-88,12,4c:01:43:d7:f3:29,15425032,362,2806,15424670,15425032
4987,4,11,1,2412,-78,-88,10,4c:01:43:d7:f3:23,15425407,322,53,15425085,15425407
4988,4,11,1,2412,-77,-88,11,4c:01:43:d7:f3:26,15425742,387,-52,15425355,15425742
4989,6,24,1,2412,-75,-88,13,,15431042,28,5272,15431014,15431042
4990,4,1,1,2412,-84,-88,4,78:67:0e:38:6c:d3,15436673,2736,2895,15433937,15436673
4991,4,11,1,2412,-80,-88,8,48:dd:0c:7d:86:27,15439432,362,2397,15439070,15439432
4992,4,11,1,2412,-80,-88,8,48:dd:0c:7d:86:23,15439806,323,51,15439483,15439806
4993,4,11,1,2412,-80,-88,8,48:dd:0c:7d:86:25,15440141,382,-47,15439759,15440141
4994,6,24,1,2412,-83,-88,5,,15442312,28,2143,15442284,15442312
4995,6,24,1,2412,-76,-88,12,,15443619,28,1279,15443591,15443619
4996,6,6,1,2412,-58,-88,30,12:86:8c:5f:93:1e,15444340,332,389,15444008,15444340
4997,6,6,1,2412,-88,-88,0,,15456178,44,11794,15456134,15456178
4998,6,6,1,2412,-89,-88,-1,e2:db:d1:d1:b0:4d,15456273,408,-313,15455865,15456273
4999,6,6,1,2412,-88,-88,0,e2:db:d1:d1:b0:4a,15457146,224,649,15456922,15457146
5000,6,6,1,2412,-88,-88,0,e2:db:d1:d1:b0:4a,15457403,248,9,15457155,15457403
5001,6,6,1,2412,-88,-88,0,,15460558,44,3111,15460514,15460558
5002,4,11,1,2412,-82,-88,6,,15461823,107,1158,15461716,15461823
5003,6,24,1,2412,-83,-88,5,78:67:0e:c4:a8:42,15462006,32,151,15461974,15462006
5004,4,11,1,2412,-83,-88,5,48:dd:0c:90:e3:85,15465240,382,2852,15464858,15465240
5005,4,11,1,2412,-89,-88,-1,,15467278,203,1835,15467075,15467278
5006,6,6,1,2412,-90,-88,-2,,15467738,44,416,15467694,15467738
5007,6,6,1,2412,-89,-88,-1,,15468068,44,286,15468024,15468068
5008,4,1,1,2412,-88,-88,0,,15469211,304,839,15468907,15469211
5009,6,6,1,2412,-58,-88,30,52:86:8c:5f:93:1e,15469939,332,396,15469607,15469939
5010,4,1,1,2412,-83,-88,5,3c:bd:c5:ee:96:6d,15472040,2512,-411,15469528,15472040
5011,6,6,1,2412,-58,-88,30,32:86:8c:5f:93:1e,15495541,332,23169,15495209,15495541
5012,6,24,1,2412,-83,-88,5,,15497912,28,2343,15497884,15497912
5013,6,6,1,2412,-89,-88,-1,,15503002,44,5046,15502958,15503002
5014,6,24,1,2412,-77,-88,11,,15511048,28,8018,15511020,15511048
5015,6,6,1,2412,-89,-88,-1,,15512822,44,1730,15512778,15512822
5016,6,12,1,2412,-82,-88,6,,15513610,32,756,15513578,15513610
5017,6,12,1,2412,-81,-88,7,,15513926,32,284,15513894,15513926
5018,6,24,1,2412,-77,-88,11,,15514397,28,443,15514369,15514397
5019,4,2,1,2412,-87,-88,1,34:15:13:b7:0a:84,15515346,208,741,15515138,15515346
5020,4,2,1,2412,-86,-88,2,34:15:13:b7:0a:84,15515834,208,280,15515626,15515834
5021,4,2,1,2412,-87,-88,1,34:15:13:b7:0a:84,15516350,208,308,15516142,15516350
5022,4,1,1,2412,-61,-88,27,b0:e4:d5:32:ec:8a,15517190,1960,-1120,15515230,15517190
5023,6,6,1,2412,-59,-88,29,10:86:8c:5f:93:1e,15521477,344,3943,15521133,15521477
5024,4,1,1,2412,-62,-88,26,94:a6:7e:c9:98:67,15525560,2464,1619,15523096,15525560
5025,4,1,1,2412,-89,-88,-1,bc:98:df:ff:0f:8b,15528709,2568,581,15526141,15528709
5026,4,1,1,2412,-90,-88,-2,bc:98:df:ff:0f:8b,15531305,3176,-580,15528129,15531305
5027,6,6,1,2412,-59,-88,29,12:86:8c:5f:93:1e,15546740,332,15103,15546408,15546740
5028,4,1,1,2412,-87,-88,1,bc:98:df:ff:0f:8b,15548547,3176,-1369,15545371,15548547
5029,4,1,1,2412,-92,-88,-4,bc:98:df:ff:0f:8b,15552111,3176,388,15548935,15552111
5030,6,6,1,2412,-90,-88,-2,e2:db:d1:d1:b0:4a,15557584,444,5029,15557140,15557584
5031,6,6,1,2412,-89,-88,-1,e2:db:d1:d1:b0:4b,15558052,408,60,15557644,15558052
5032,4,1,1,2412,-86,-88,2,78:67:0e:c4:a8:42,15561313,352,2909,15560961,15561313
5033,6,24,1,2412,-79,-88,9,78:67:0e:c4:a8:42,15565116,32,3771,15565084,15565116
5034,4,11,1,2412,-82,-88,6,4c:01:43:ec:a0:69,15565576,361,99,15565215,15565576
5035,4,1,1,2412,-89,-88,-1,,15570086,304,4206,15569782,15570086
5036,6,6,1,2412,-61,-88,27,52:86:8c:5f:93:1e,15572341,332,1923,15572009,15572341
5037,4,1,1,2412,-86,-88,2,78:67:0e:c4:a8:42,15579126,2736,4049,15576390,15579126
5038,4,1,1,2412,-80,-88,8,00:26:62:eb:ea:74,15586630,920,6584,15585710,15586630
5039,6,24,1,2412,-81,-88,7,,15591617,28,4959,15591589,15591617
5040,6,6,1,2412,-59,-88,29,32:86:8c:5f:93:1e,15597941,332,5992,15597609,15597941
5041,6,24,1,2412,-81,-88,7,,15604398,28,6429,15604370,15604398
5042,4,11,1,2412,-87,-88,1,4c:01:43:db:2d:83,15615648,284,10966,15615364,15615648
5043,4,11,1,2412,-81,-88,7,4c:01:43:d7:f3:23,15615986,284,54,15615702,15615986
5044,6,6,1,2412,-90,-88,-2,,15616544,44,514,15616500,15616544
5045,6,6,1,2412,-89,-88,-1,,15616957,44,369,15616913,15616957
5046,4,1,1,2412,-64,-88,24,b0:e4:d5:32:ec:8a,15619590,1960,673,15617630,15619590
5047,6,6,1,2412,-58,-88,30,10:86:8c:5f:93:1e,15623541,344,3607,15623197,15623541
5048,4,1,1,2412,-62,-88,26,94:a6:7e:c9:98:67,15626566,2464,561,15624102,15626566
5049,4,1,1,2412,-89,-88,-1,,15629178,304,2308,15628874,15629178
5050,4,11,1,2412,-71,-88,17,4c:01:43:d7:f3:26,15630541,387,976,15630154,15630541
5051,4,1,1,2412,-87,-88,1,,15636602,304,5757,15636298,15636602
5052,6,6,1,2412,-89,-88,-1,,15636828,44,182,15636784,15636828
5053,6,24,1,2412,-80,-88,8,,15637362,28,506,15637334,15637362
5054,6,6,1,2412,-87,-88,1,40:b0:34:b7:01:d5,15647320,576,9382,15646744,15647320
5055,6,6,1,2412,-58,-88,30,12:86:8c:5f:93:1e,15649142,332,1490,15648810,15649142
5056,4,2,1,2412,-87,-88,1,34:15:13:b7:0a:84,15650860,208,1510,15650652,15650860
5057,4,2,1,2412,-84,-88,4,,15651081,152,69,15650929,15651081
5058,6,24,1,2412,-82,-88,6,,15654509,28,3400,15654481,15654509
5059,6,6,1,2412,-88,-88,0,e2:db:d1:d1:b0:4b,15660472,408,5555,15660064,15660472
5060,4,11,1,2412,-81,-88,7,4c:01:43:ec:a0:69,15667975,361,7142,15667614,15667975
5061,4,11,1,2412,-81,-88,7,4c:01:43:ec:a0:63,15668349,322,52,15668027,15668349
5062,4,11,1,2412,-80,-88,8,4c:01:43:ec:a0:66,15668683,387,-53,15668296,15668683
5063,4,11,1,2412,-84,-88,4,48:dd:0c:90:e3:87,15669330,362,285,15668968,15669330
5064,4,11,1,2412,-82,-88,6,48:dd:0c:90:e3:83,15669704,323,51,15669381,15669704
5065,4,11,1,2412,-82,-88,6,48:dd:0c:90:e3:85,15670040,382,-46,15669658,15670040
5066,6,24,1,2412,-80,-88,8,,15671048,28,980,15671020,15671048
5067,6,6,1,2412,-55,-88,33,52:86:8c:5f:93:1e,15674742,332,3362,15674410,15674742
5068,4,1,1,2412,-87,-88,1,78:67:0e:c4:a8:42,15681526,2736,4048,15678790,15681526
5069,6,6,1,2412,-55,-88,33,32:86:8c:5f:93:1e,15700341,332,18483,15700009,15700341
5070,4,1,1,2412,-89,-88,-1,,15703251,304,2606,15702947,15703251
5071,4,1,1,2412,-92,-88,-4,,15725738,304,22183,15725434,15725738
5072,6,6,1,2412,-54,-88,34,10:86:8c:5f:93:1e,15725942,344,-140,15725598,15725942
5073,6,6,1,2412,-60,-88,28,b4:e6:2d:b4:ff:71,15727457,64,1451,15727393,15727457
5074,6,6,1,2412,-54,-88,34,,15727538,44,37,15727494,15727538
5075,4,1,1,2412,-92,-88,-4,bc:98:df:ff:0f:8b,15727678,2568,-2428,15725110,15727678
5076,6,6,1,2412,-86,-88,2,,15748650,44,20928,15748606,15748650
5077,4,1,1,2412,-82,-88,6,,15753157,304,4203,15752853,15753157
5078,4,1,1,2412,-82,-88,6,,15754407,304,946,15754103,15754407
5079,4,1,1,2412,-83,-88,5,,15757849,304,3138,15757545,15757849
5080,6,6,1,2412,-87,-88,1,e2:db:d1:d1:b0:4a,15759049,52,1148,15758997,15759049
5081,6,6,1,2412,-85,-88,3,e2:db:d1:d1:b0:4a,15759530,52,429,15759478,15759530
5082,4,1,1,2412,-90,-88,-2,,15762106,304,2272,15761802,15762106
5083,6,6,1,2412,-87,-88,1,,15762491,44,341,15762447,15762491
5084,6,6,1,2412,-84,-88,4,e2:db:d1:d1:b0:4b,15763045,408,146,15762637,15763045
5085,6,6,1,2412,-87,-88,1,e2:db:d1:d1:b0:4d,15763523,408,70,15763115,15763523
5086,6,6,1,2412,-87,-88,1,,15764775,44,1208,15764731,15764775
5087,6,6,1,2412,-86,-88,2,e2:db:d1:d1:b0:4a,15765449,392,282,15765057,15765449
5088,4,11,1,2412,-81,-88,7,4c:01:43:ec:a0:69,15770374,361,4564,15770013,15770374
5089,4,11,1,2412,-80,-88,8,4c:01:43:ec:a0:63,15770748,322,52,15770426,15770748
5090,4,11,1,2412,-81,-88,7,4c:01:43:ec:a0:66,15771082,387,-53,15770695,15771082
5091,4,11,1,2412,-81,-88,7,48:dd:0c:90:e3:87,15771730,362,286,15771368,15771730
5092,4,11,1,2412,-76,-88,12,48:dd:0c:90:e3:83,15772104,323,51,15771781,15772104
5093,4,11,1,2412,-81,-88,7,48:dd:0c:90:e3:85,15772440,382,-46,15772058,15772440
5094,6,6,1,2412,-55,-88,33,52:86:8c:5f:93:1e,15777142,332,4370,15776810,15777142
5095,4,1,1,2412,-80,-88,8,,15781255,304,3809,15780951,15781255
5096,4,1,1,2412,-81,-88,7,78:67:0e:c4:a8:42,15783925,2736,-66,15781189,15783925
5097,6,6,1,2412,-56,-88,32,32:86:8c:5f:93:1e,15802743,332,18486,15802411,15802743
5098,4,1,1,2412,-82,-88,6,,15806908,304,3861,15806604,15806908
5099,6,6,1,2412,-88,-88,0,,15807223,44,271,15807179,15807223
5100,4,1,1,2412,-69,-88,19,b0:e4:d5:32:ec:8a,15824388,1960,15205,15822428,15824388
5101,6,6,1,2412,-58,-88,30,10:86:8c:5f:93:1e,15830894,344,6162,15830550,15830894
5102,4,1,1,2412,-67,-88,21,94:a6:7e:c9:98:67,15831402,2464,-1956,15828938,15831402
5103,4,11,1,2412,-86,-88,2,4c:01:43:d7:f3:29,15834631,362,2867,15834269,15834631
5104,4,11,1,2412,-84,-88,4,4c:01:43:d7:f3:26,15835340,387,322,15834953,15835340
5105,4,11,1,2412,-86,-88,2,4c:01:43:d7:f3:26,15835792,274,178,15835518,15835792
5106,6,6,1,2412,-88,-88,0,3c:bd:c5:ee:96:6d,15839884,68,4024,15839816,15839884
5107,6,24,1,2412,-84,-88,4,,15843627,28,3715,15843599,15843627
5108,6,6,1,2412,-55,-88,33,12:86:8c:5f:93:1e,15853942,332,9983,15853610,15853942
5109,4,1,1,2412,-87,-88,1,00:26:62:eb:ea:74,15864243,968,9333,15863275,15864243
5110,6,6,1,2412,-87,-88,1,e2:db:d1:d1:b0:4d,15865736,408,1085,15865328,15865736
5111,6,6,1,2412,-87,-88,1,,15867006,44,1226,15866962,15867006
5112,4,11,1,2412,-84,-88,4,48:dd:0c:90:e3:83,15874504,323,7175,15874181,15874504
5113,4,11,1,2412,-83,-88,5,48:dd:0c:90:e3:85,15874839,382,-47,15874457,15874839
5114,4,1,1,2412,-85,-88,3,3c:bd:c5:ee:96:6d,15882430,1056,6535,15881374,15882430
5115,4,11,1,2412,-84,-88,4,,15889615,107,7078,15889508,15889615
5116,6,24,1,2412,-85,-88,3,78:67:0e:c4:a8:42,15889734,32,87,15889702,15889734
5117,4,1,1,2412,-83,-88,5,78:67:0e:c4:a8:42,15894191,352,4105,15893839,15894191
5118,4,1,1,2412,-89,-88,-1,,15895257,304,762,15894953,15895257
5119,6,6,1,2412,-89,-88,-1,,15898042,44,2741,15897998,15898042
5120,6,6,1,2412,-91,-88,-3,,15898747,44,661,15898703,15898747
5121,4,1,1,2412,-92,-88,-4,,15900121,304,1070,15899817,15900121
5122,4,1,1,2412,-90,-88,-2,,15904761,304,4336,15904457,15904761
5123,6,6,1,2412,-56,-88,32,32:86:8c:5f:93:1e,15905143,332,50,15904811,15905143
5124,6,24,1,2412,-83,-88,5,,15911053,28,5882,15911025,15911053
5125,6,6,1,2412,-55,-88,33,b4:e6:2d:b4:ff:71,15912629,64,1512,15912565,15912629
5126,6,6,1,2412,-55,-88,33,b4:e6:2d:b4:ff:71,15912905,64,212,15912841,15912905
5127,6,6,1,2412,-55,-88,33,,15912985,44,36,15912941,15912985
5128,6,24,1,2412,-83,-88,5,,15923622,28,10609,15923594,15923622
5129,4,1,1,2412,-62,-88,26,b0:e4:d5:32:ec:8a,15927038,1960,1456,15925078,15927038
5130,6,6,1,2412,-56,-88,32,10:86:8c:5f:93:1e,15932915,344,5533,15932571,15932915
5131,4,1,1,2412,-63,-88,25,94:a6:7e:c9:98:67,15935981,2464,602,15933517,15935981
5132,4,1,1,2412,-86,-88,2,78:67:0e:38:6c:d3,15948674,2736,9957,15945938,15948674
5133,4,11,1,2412,-73,-88,15,48:dd:0c:7d:86:27,15951433,362,2397,15951071,15951433
5134,4,11,1,2412,-72,-88,16,48:dd:0c:7d:86:23,15951807,323,51,15951484,15951807
5135,4,11,1,2412,-74,-88,14,48:dd:0c:7d:86:25,15952142,382,-47,15951760,15952142
5136,6,6,1,2412,-82,-88,6,40:b0:34:b7:01:d5,15954524,576,1806,15953948,15954524
5137,6,6,1,2412,-87,-88,1,e2:db:d1:d1:b0:4a,15967191,444,12223,15966747,15967191
5138,6,6,1,2412,-87,-88,1,e2:db:d1:d1:b0:4f,15968541,408,942,15968133,15968541
5139,4,1,1,2412,-93,-88,-5,00:26:62:eb:ea:74,15969277,968,-232,15968309,15969277
5140,4,11,1,2412,-84,-88,4,4c:01:43:ec:a0:69,15975171,361,5533,15974810,15975171
5141,4,11,1,2412,-83,-88,5,4c:01:43:ec:a0:63,15975545,322,52,15975223,15975545
5142,4,11,1,2412,-84,-88,4,4c:01:43:ec:a0:66,15975880,387,-52,15975493,15975880
5143,4,11,1,2412,-85,-88,3,48:dd:0c:90:e3:85,15977239,382,977,15976857,15977239
5144,4,2,1,2412,-84,-88,4,34:15:13:b7:0a:84,15977881,208,434,15977673,15977881
5145,4,2,1,2412,-83,-88,5,,15978102,152,69,15977950,15978102
5146,6,6,1,2412,-56,-88,32,52:86:8c:5f:93:1e,15981944,332,3510,15981612,15981944
5147,6,6,1,2412,-85,-88,3,,15988464,44,6476,15988420,15988464
5148,6,6,1,2412,-86,-88,2,e2:db:d1:d1:b0:4a,15992412,68,3880,15992344,15992412
5149,4,2,1,2412,-88,-88,0,34:15:13:b7:0a:84,15995953,208,3333,15995745,15995953
5150,4,2,1,2412,-88,-88,0,34:15:13:b7:0a:84,15996450,208,289,15996242,15996450
5151,4,2,1,2412,-86,-88,2,34:15:13:b7:0a:84,15996939,208,281,15996731,15996939
5152,4,2,1,2412,-83,-88,5,,15997160,152,69,15997008,15997160
5153,6,24,1,2412,-83,-88,5,,15998578,28,1390,15998550,15998578
5154,6,6,1,2412,-59,-88,29,32:86:8c:5f:93:1e,16007628,332,8718,16007296,16007628
5155,4,1,1,2412,-70,-88,18,b0:e4:d5:32:ec:8a,16029187,1960,19599,16027227,16029187
5156,4,1,1,2412,-92,-88,-4,bc:98:df:ff:0f:8b,16033285,2568,1530,16030717,16033285
5157,6,6,1,2412,-59,-88,29,10:86:8c:5f:93:1e,16035709,344,2080,16035365,16035709
5158,4,11,1,2412,-86,-88,2,4c:01:43:d7:f3:23,16039804,322,3773,16039482,16039804
5159,6,24,1,2412,-87,-88,1,,16043526,28,3694,16043498,16043526
5160,4,1,1,2412,-79,-88,9,78:67:0e:38:6c:d3,16051074,2736,4812,16048338,16051074
5161,4,11,1,2412,-74,-88,14,48:dd:0c:7d:86:27,16053833,362,2397,16053471,16053833
5162,4,11,1,2412,-74,-88,14,48:dd:0c:7d:86:23,16054208,323,52,16053885,16054208
5163,4,11,1,2412,-74,-88,14,48:dd:0c:7d:86:25,16054543,382,-47,16054161,16054543
5164,6,6,1,2412,-85,-88,3,40:b0:34:b7:01:d5,16056925,576,1806,16056349,16056925
5165,6,6,1,2412,-59,-88,29,12:86:8c:5f:93:1e,16058745,332,1488,16058413,16058745
5166,6,6,1,2412,-91,-88,-3,e2:db:d1:d1:b0:4a,16069610,444,10421,16069166,16069610
5167,6,6,1,2412,-90,-88,-2,e2:db:d1:d1:b0:4b,16070096,408,78,16069688,16070096
5168,4,1,1,2412,-90,-88,-2,78:67:0e:c4:a8:42,16071718,352,1270,16071366,16071718
5169,4,1,1,2412,-85,-88,3,78:67:0e:c4:a8:42,16072565,352,495,16072213,16072565
5170,6,6,1,2412,-89,-88,-1,,16072917,44,308,16072873,16072917
5171,4,1,1,2412,-84,-88,4,78:67:0e:c4:a8:42,16073420,352,151,16073068,16073420
5172,6,6,1,2412,-90,-88,-2,,16073781,44,317,16073737,16073781
5173,6,6,1,2412,-88,-88,0,,16075238,44,1413,16075194,16075238
5174,4,11,1,2412,-81,-88,7,,16075691,107,346,16075584,16075691
5175,4,11,1,2412,-80,-88,8,4c:01:43:ec:a0:63,16077944,322,1931,16077622,16077944
5176,4,11,1,2412,-81,-88,7,4c:01:43:ec:a0:66,16078279,387,-52,16077892,16078279
5177,4,11,1,2412,-85,-88,3,48:dd:0c:90:e3:87,16078929,362,288,16078567,16078929
5178,4,11,1,2412,-86,-88,2,48:dd:0c:90:e3:83,16079303,323,51,16078980,16079303
5179,4,11,1,2412,-85,-88,3,48:dd:0c:90:e3:85,16079639,382,-46,16079257,16079639
5180,6,6,1,2412,-88,-88,0,0a:a7:c0:a3:8d:71,16087718,408,7671,16087310,16087718
5181,4,1,1,2412,-82,-88,6,78:67:0e:c4:a8:42,16091125,2736,671,16088389,16091125
5182,6,6,1,2412,-87,-88,1,,16102645,44,11476,16102601,16102645
5183,6,24,1,2412,-80,-88,8,,16103253,28,580,16103225,16103253
5184,6,24,1,2412,-87,-88,1,,16104480,28,1199,16104452,16104480
5185,6,6,1,2412,-58,-88,30,32:86:8c:5f:93:1e,16109944,332,5132,16109612,16109944
5186,4,2,1,2412,-89,-88,-1,34:15:13:b7:0a:84,16127774,208,17622,16127566,16127774
5187,4,2,1,2412,-80,-88,8,,16127995,152,69,16127843,16127995
5188,6,6,1,2412,-87,-88,1,3c:bd:c5:ee:96:6d,16130836,68,2773,16130768,16130836
5189,4,1,1,2412,-66,-88,22,b0:e4:d5:32:ec:8a,16131586,1960,-1210,16129626,16131586
5190,6,6,1,2412,-60,-88,28,10:86:8c:5f:93:1e,16135545,344,3615,16135201,16135545
5191,4,1,1,2412,-61,-88,27,94:a6:7e:c9:98:67,16138563,2464,554,16136099,16138563
5192,4,11,1,2412,-84,-88,4,4c:01:43:d7:f3:23,16142204,322,3319,16141882,16142204
5193,4,11,1,2412,-84,-88,4,4c:01:43:d7:f3:26,16142538,387,-53,16142151,16142538
5194,4,11,1,2412,-89,-88,-1,48:dd:0c:92:4b:e5,16145574,382,2654,16145192,16145574
5195,6,24,1,2412,-84,-88,4,,16147939,28,2337,16147911,16147939
5196,4,1,1,2412,-87,-88,1,78:67:0e:38:6c:d3,16153474,2736,2799,16150738,16153474
5197,4,11,1,2412,-77,-88,11,48:dd:0c:7d:86:27,16156233,362,2397,16155871,16156233
5198,4,11,1,2412,-70,-88,18,48:dd:0c:7d:86:23,16156608,323,52,16156285,16156608
5199,4,11,1,2412,-75,-88,13,48:dd:0c:7d:86:25,16156943,382,-47,16156561,16156943
5200,6,6,1,2412,-82,-88,6,40:b0:34:b7:01:d5,16159326,576,1807,16158750,16159326
5201,6,6,1,2412,-61,-88,27,12:86:8c:5f:93:1e,16161144,332,1486,16160812,16161144
5202,6,6,1,2412,-85,-88,3,,16163761,44,2573,16163717,16163761
5203,6,6,1,2412,-86,-88,2,e2:db:d1:d1:b0:4a,16171991,444,7786,16171547,16171991
5204,6,6,1,2412,-86,-88,2,e2:db:d1:d1:b0:4d,16172944,408,545,16172536,16172944
5205,6,6,1,2412,-86,-88,2,e2:db:d1:d1:b0:4f,16173403,408,51,16172995,16173403
5206,4,11,1,2412,-81,-88,7,4c:01:43:ec:a0:69,16179969,361,6205,16179608,16179969
5207,4,11,1,2412,-81,-88,7,4c:01:43:ec:a0:63,16180343,322,52,16180021,16180343
5208,4,11,1,2412,-80,-88,8,4c:01:43:ec:a0:66,16180677,387,-53,16180290,16180677
5209,4,11,1,2412,-82,-88,6,48:dd:0c:90:e3:83,16181703,323,703,16181380,16181703
5210,4,11,1,2412,-83,-88,5,48:dd:0c:90:e3:85,16182038,382,-47,16181656,16182038
5211,6,6,1,2412,-58,-88,30,52:86:8c:5f:93:1e,16186744,332,4374,16186412,16186744
5212,6,6,1,2412,-88,-88,0,0a:a7:c0:a3:8d:71,16190046,408,2894,16189638,16190046
5213,6,6,1,2412,-85,-88,3,,16192296,44,2206,16192252,16192296
5214,6,24,1,2412,-87,-88,1,e2:db:d1:d1:b0:4a,16192402,28,78,16192374,16192402
5215,6,6,1,2412,-86,-88,2,,16192783,44,337,16192739,16192783
5216,6,24,1,2412,-86,-88,2,e2:db:d1:d1:b0:4a,16192970,28,159,16192942,16192970
5217,6,6,1,2412,-87,-88,1,,16193207,44,193,16193163,16193207
5218,4,1,1,2412,-91,-88,-3,,16196962,304,3451,16196658,16196962
5219,6,6,1,2412,-85,-88,3,,16197337,44,331,16197293,16197337
5220,7,26,1,2412,-63,-88,25,94:a6:7e:c9:98:67,16203887,64,6486,16203823,16203887
5221,6,24,1,2412,-60,-88,28,,16203959,28,44,16203931,16203959
5222,6,6,1,2412,-61,-88,27,32:86:8c:5f:93:1e,16212346,332,8055,16212014,16212346
5223,4,1,1,2412,-60,-88,28,3c:06:30:47:83:74,16220587,416,7825,16220171,16220587
5224,4,1,1,2412,-58,-88,30,,16221016,304,125,16220712,16221016
5225,6,24,1,2412,-85,-88,3,,16231056,28,10012,16231028,16231056
5226,4,1,1,2412,-64,-88,24,b0:e4:d5:32:ec:8a,16233985,1960,969,16232025,16233985
5227,4,1,1,2412,-90,-88,-2,bc:98:df:ff:0f:8b,16238080,2568,1527,16235512,16238080
5228,6,6,1,2412,-60,-88,28,10:86:8c:5f:93:1e,16240504,344,2080,16240160,16240504
5229,4,1,1,2412,-57,-88,31,94:a6:7e:c9:98:67,16240967,2464,-2001,16238503,16240967
5230,6,24,1,2412,-87,-88,1,,16243631,28,2636,16243603,16243631
5231,4,11,1,2412,-87,-88,1,4c:01:43:d7:f3:29,16244229,362,236,16243867,16244229
5232,4,11,1,2412,-70,-88,18,4c:01:43:d7:f3:23,16244603,322,52,16244281,16244603
5233,6,24,1,2412,-83,-88,5,,16249193,28,4562,16249165,16249193
5234,6,6,1,2412,-88,-88,0,,16258749,44,9512,16258705,16258749
5235,6,6,1,2412,-90,-88,-2,,16260505,44,1712,16260461,16260505
5236,6,6,1,2412,-57,-88,31,12:86:8c:5f:93:1e,16268338,332,7501,16268006,16268338
5237,6,24,1,2412,-84,-88,4,78:67:0e:c4:a8:42,16273805,32,5435,16273773,16273805
5238,4,11,1,2412,-83,-88,5,4c:01:43:ec:a0:69,16282368,361,8202,16282007,16282368
5239,4,11,1,2412,-83,-88,5,4c:01:43:ec:a0:63,16282742,322,52,16282420,16282742
5240,4,11,1,2412,-79,-88,9,48:dd:0c:90:e3:87,16283729,362,625,16283367,16283729
5241,4,11,1,2412,-80,-88,8,48:dd:0c:90:e3:83,16284103,323,51,16283780,16284103
5242,4,11,1,2412,-80,-88,8,48:dd:0c:90:e3:85,16284438,382,-47,16284056,16284438
5243,4,1,1,2412,-91,-88,-3,40:ca:63:2d:74:be,16285633,1896,-701,16283737,16285633
5244,6,6,1,2412,-58,-88,30,52:86:8c:5f:93:1e,16289146,332,3181,16288814,16289146
5245,6,6,1,2412,-87,-88,1,0a:a7:c0:a3:8d:70,16291930,464,2320,16291466,16291930
5246,6,6,1,2412,-87,-88,1,0a:a7:c0:a3:8d:71,16292418,408,80,16292010,16292418
5247,6,6,1,2412,-86,-88,2,0a:a7:c0:a3:8d:73,16292850,408,24,16292442,16292850
5248,4,11,1,2412,-79,-88,9,48:dd:0c:90:e3:83,16295098,254,1994,16294844,16295098
5249,4,1,1,2412,-86,-88,2,78:67:0e:c4:a8:42,16295925,2736,-1909,16293189,16295925
5250,6,24,1,2412,-85,-88,3,,16301678,28,5725,16301650,16301678
5251,6,24,1,2412,-84,-88,4,,16311054,28,9348,16311026,16311054
5252,6,6,1,2412,-78,-88,10,32:86:8c:5f:93:1e,16314745,332,3359,16314413,16314745
5253,4,1,1,2412,-92,-88,-4,ac:67:84:84:8a:07,16319296,448,4103,16318848,16319296
5254,6,6,1,2412,-91,-88,-3,,16320626,44,1286,16320582,16320626
5255,4,1,1,2412,-91,-88,-3,,16322360,304,1430,16322056,16322360
5256,6,24,1,2412,-83,-88,5,,16323632,28,1244,16323604,16323632
5257,6,6,1,2412,-89,-88,-1,,16329306,44,5630,16329262,16329306
5258,4,1,1,2412,-91,-88,-3,,16330776,304,1166,16330472,16330776
5259,6,6,1,2412,-90,-88,-2,e2:db:d1:d1:b0:4a,16331365,68,521,16331297,16331365
5260,4,1,1,2412,-64,-88,24,b0:e4:d5:32:ec:8a,16336437,1960,3112,16334477,16336437
5261,6,6,1,2412,-59,-88,29,10:86:8c:5f:93:1e,16340345,344,3564,16340001,16340345
5262,4,1,1,2412,-65,-88,23,94:a6:7e:c9:98:67,16344428,2464,1619,16341964,16344428
5263,4,11,1,2412,-74,-88,14,4c:01:43:d7:f3:26,16347337,387,2522,16346950,16347337
5264,6,6,1,2412,-90,-88,-2,,16355891,44,8510,16355847,16355891
5265,6,24,1,2412,-84,-88,4,,16357561,28,1642,16357533,16357561
5266,4,1,1,2412,-87,-88,1,78:67:0e:38:6c:d3,16358275,2736,-2022,16355539,16358275
5267,4,11,1,2412,-78,-88,10,48:dd:0c:7d:86:27,16361034,362,2397,16360672,16361034
5268,4,11,1,2412,-79,-88,9,48:dd:0c:7d:86:23,16361408,323,51,16361085,16361408
5269,4,11,1,2412,-74,-88,14,48:dd:0c:7d:86:25,16361744,382,-46,16361362,16361744
5270,6,6,1,2412,-82,-88,6,40:b0:34:b7:01:d5,16364128,576,1808,16363552,16364128
5271,6,6,1,2412,-60,-88,28,12:86:8c:5f:93:1e,16365947,332,1487,16365615,16365947
5272,4,11,1,2412,-86,-88,2,4c:01:43:db:2d:89,16369251,362,2942,16368889,16369251
5273,4,11,1,2412,-88,-88,0,4c:01:43:db:2d:83,16369625,322,52,16369303,16369625
5274,4,11,1,2412,-74,-88,14,4c:01:43:db:2d:86,16369960,387,-52,16369573,16369960
5275,6,6,1,2412,-90,-88,-2,e2:db:d1:d1:b0:4d,16377726,408,7358,16377318,16377726
5276,6,6,1,2412,-90,-88,-2,e2:db:d1:d1:b0:4f,16378185,408,51,16377777,16378185
5277,4,11,1,2412,-80,-88,8,48:dd:0c:90:e3:87,16386128,362,7581,16385766,16386128
5278,4,11,1,2412,-80,-88,8,48:dd:0c:90:e3:83,16386503,323,52,16386180,16386503
5279,4,11,1,2412,-81,-88,7,48:dd:0c:90:e3:85,16386838,382,-47,16386456,16386838
5280,6,24,1,2412,-83,-88,5,,16391061,28,4195,16391033,16391061
5281,6,6,1,2412,-59,-88,29,52:86:8c:5f:93:1e,16391546,332,153,16391214,16391546
5282,4,1,1,2412,-85,-88,3,78:67:0e:c4:a8:42,16398325,2736,4043,16395589,16398325
5283,6,24,1,2412,-83,-88,5,,16404340,28,5987,16404312,16404340
5284,4,1,1,2412,-90,-88,-2,,16408557,304,3913,16408253,16408557
5285,6,6,1,2412,-62,-88,26,32:86:8c:5f:93:1e,16417146,332,8257,16416814,16417146
5286,4,1,1,2412,-93,-88,-5,ac:67:84:84:8a:07,16421120,448,3526,16420672,16421120
5287,4,1,1,2412,-62,-88,26,b0:e4:d5:32:ec:8a,16438784,1960,15704,16436824,16438784
5288,4,1,1,2412,-60,-88,28,94:a6:7e:c9:98:67,16445761,2464,4513,16443297,16445761
5289,4,11,1,2412,-89,-88,-1,4c:01:43:d7:f3:23,16449402,322,3319,16449080,16449402
5290,6,24,1,2412,-83,-88,5,,16453230,28,3800,16453202,16453230
5291,4,11,1,2412,-78,-88,10,48:dd:0c:7d:86:25,16464143,382,10531,16463761,16464143
5292,6,6,1,2412,-86,-88,2,40:b0:34:b7:01:d5,16466529,576,1810,16465953,16466529
5293,6,6,1,2412,-59,-88,29,12:86:8c:5f:93:1e,16468346,332,1485,16468014,16468346
5294,4,1,1,2412,-91,-88,-3,,16470071,304,1421,16469767,16470071
5295,6,24,1,2412,-86,-88,2,,16471061,28,962,16471033,16471061
5296,4,11,1,2412,-91,-88,-3,4c:01:43:db:2d:83,16472025,322,642,16471703,16472025
5297,4,11,1,2412,-89,-88,-1,4c:01:43:db:2d:86,16472359,387,-53,16471972,16472359
5298,4,11,1,2412,-88,-88,0,4c:01:43:ec:a0:69,16487166,361,14446,16486805,16487166
5299,4,11,1,2412,-79,-88,9,48:dd:0c:90:e3:87,16488528,362,1000,16488166,16488528
5300,4,11,1,2412,-79,-88,9,48:dd:0c:90:e3:83,16488902,323,51,16488579,16488902
5301,4,11,1,2412,-79,-88,9,48:dd:0c:90:e3:85,16489238,382,-46,16488856,16489238
5302,6,6,1,2412,-56,-88,32,52:86:8c:5f:93:1e,16493947,332,4377,16493615,16493947
5303,6,6,1,2412,-89,-88,-1,0a:a7:c0:a3:8d:71,16497209,408,2854,16496801,16497209
5304,4,1,1,2412,-87,-88,1,,16498310,304,797,16498006,16498310
5305,6,24,1,2412,-83,-88,5,,16505104,28,6766,16505076,16505104
5306,6,6,1,2412,-58,-88,30,32:86:8c:5f:93:1e,16519548,332,14112,16519216,16519548
5307,4,1,1,2412,-88,-88,0,,16536893,304,17041,16536589,16536893
5308,4,1,1,2412,-65,-88,23,b0:e4:d5:32:ec:8a,16541183,1960,2330,16539223,16541183
5309,6,6,1,2412,-89,-88,-1,,16543054,44,1827,16543010,16543054
5310,4,1,1,2412,-57,-88,31,94:a6:7e:c9:98:67,16548177,2464,2659,16545713,16548177
5311,6,6,1,2412,-86,-88,2,,16550765,44,2544,16550721,16550765
5312,4,11,1,2412,-86,-88,2,4c:01:43:d7:f3:26,16552136,387,984,16551749,16552136
5313,6,24,1,2412,-86,-88,2,,16568769,28,16605,16568741,16568769
5314,6,6,1,2412,-87,-88,1,40:b0:34:b7:01:d5,16568930,576,-415,16568354,16568930
5315,6,6,1,2412,-61,-88,27,12:86:8c:5f:93:1e,16570747,332,1485,16570415,16570747
5316,6,6,1,2412,-88,-88,0,,16571307,44,516,16571263,16571307
5317,6,6,1,2412,-90,-88,-2,,16576338,44,4987,16576294,16576338
5318,6,6,1,2412,-89,-88,-1,,16576647,44,265,16576603,16576647
5319,4,1,1,2412,-91,-88,-3,,16581367,304,4416,16581063,16581367
5320,6,6,1,2412,-91,-88,-3,e2:db:d1:d1:b0:4d,16582585,408,810,16582177,16582585
5321,6,24,1,2412,-86,-88,2,78:67:0e:c4:a8:42,16583446,32,829,16583414,16583446
5322,6,6,1,2412,-88,-88,0,,16588589,44,5099,16588545,16588589
5323,6,6,1,2412,-60,-88,28,52:86:8c:5f:93:1e,16596348,332,7427,16596016,16596348
5324,6,24,1,2412,-86,-88,2,,16605761,28,9385,16605733,16605761
5325,6,6,1,2412,-59,-88,29,32:86:8c:5f:93:1e,16621947,332,15854,16621615,16621947
5326,4,1,1,2412,-92,-88,-4,ac:67:84:84:8a:07,16626600,448,4205,16626152,16626600
5327,4,1,1,2412,-90,-88,-2,ac:67:84:84:8a:07,16627504,448,456,16627056,16627504
5328,6,24,1,2412,-81,-88,7,,16631061,28,3529,16631033,16631061
5329,6,6,1,2412,-88,-88,0,3c:bd:c5:ee:96:6d,16636658,68,5529,16636590,16636658
5330,4,1,1,2412,-61,-88,27,b0:e4:d5:32:ec:8a,16643582,1960,4964,16641622,16643582
5331,6,24,1,2412,-82,-88,6,,16646034,28,2424,16646006,16646034
5332,4,1,1,2412,-57,-88,31,94:a6:7e:c9:98:67,16650569,2464,2071,16648105,16650569
5333,4,11,1,2412,-81,-88,7,4c:01:43:d7:f3:29,16653834,362,2903,16653472,16653834
5334,4,11,1,2412,-81,-88,7,4c:01:43:d7:f3:23,16654208,322,52,16653886,16654208
5335,4,11,1,2412,-81,-88,7,4c:01:43:d7:f3:26,16654543,387,-52,16654156,16654543
5336,4,1,1,2412,-82,-88,6,78:67:0e:38:6c:d3,16665475,2736,8196,16662739,16665475
5337,4,11,1,2412,-74,-88,14,48:dd:0c:7d:86:27,16668234,362,2397,16667872,16668234
5338,4,11,1,2412,-75,-88,13,48:dd:0c:7d:86:23,16668609,323,52,16668286,16668609
5339,4,11,1,2412,-74,-88,14,48:dd:0c:7d:86:25,16668944,382,-47,16668562,16668944
5340,6,6,1,2412,-86,-88,2,40:b0:34:b7:01:d5,16671331,576,1811,16670755,16671331
5341,4,1,1,2412,-82,-88,6,78:67:0e:38:6c:d3,16673675,3472,-1128,16670203,16673675
5342,6,6,1,2412,-55,-88,33,12:86:8c:5f:93:1e,16677356,332,3349,16677024,16677356
5343,4,11,1,2412,-82,-88,6,4c:01:43:d7:f3:26,16683821,383,6082,16683438,16683821
5344,6,6,1,2412,-88,-88,0,e2:db:d1:d1:b0:4b,16684497,408,268,16684089,16684497
5345,6,6,1,2412,-87,-88,1,e2:db:d1:d1:b0:4f,16685388,408,483,16684980,16685388
5346,6,24,1,2412,-82,-88,6,4c:01:43:d7:f3:26,16685847,32,427,16685815,16685847
5347,6,24,1,2412,-83,-88,5,,16686025,28,150,16685997,16686025
5348,4,11,1,2412,-86,-88,2,4c:01:43:ec:a0:63,16692337,322,5990,16692015,16692337
5349,4,11,1,2412,-85,-88,3,4c:01:43:ec:a0:66,16692672,387,-52,16692285,16692672
5350,4,1,1,2412,-88,-88,0,,16694486,304,1510,16694182,16694486
5351,6,24,1,2412,-87,-88,1,,16694815,28,301,16694787,16694815
5352,6,6,1,2412,-55,-88,33,52:86:8c:5f:93:1e,16699600,332,4453,16699268,16699600
5353,6,24,1,2412,-88,-88,0,,16705105,28,5477,16705077,16705105
5354,4,1,1,2412,-88,-88,0,78:67:0e:c4:a8:42,16705525,2736,-2316,16702789,16705525
5355,6,24,1,2412,-84,-88,4,,16711058,28,5505,16711030,16711058
5356,6,24,1,2412,-85,-88,3,,16723636,28,12550,16723608,16723636
5357,6,6,1,2412,-87,-88,1,,16742452,44,18772,16742408,16742452
5358,4,1,1,2412,-71,-88,17,b0:e4:d5:32:ec:8a,16745982,1960,1570,16744022,16745982
5359,6,6,1,2412,-84,-88,4,,16748241,44,2215,16748197,16748241
5360,6,6,1,2412,-55,-88,33,10:86:8c:5f:93:1e,16750527,344,1942,16750183,16750527
5361,4,1,1,2412,-57,-88,31,94:a6:7e:c9:98:67,16753002,2464,11,16750538,16753002
5362,4,11,1,2412,-83,-88,5,4c:01:43:d7:f3:29,16756226,362,2862,16755864,16756226
5363,4,11,1,2412,-86,-88,2,4c:01:43:d7:f3:23,16756601,322,53,16756279,16756601
5364,4,11,1,2412,-87,-88,1,4c:01:43:d7:f3:26,16756935,387,-53,16756548,16756935
5365,4,1,1,2412,-91,-88,-3,ac:67:84:84:8a:07,16759017,416,1666,16758601,16759017
5366,6,6,1,2412,-86,-88,2,40:b0:34:b7:01:d5,16773732,576,14139,16773156,16773732
5367,6,6,1,2412,-54,-88,34,12:86:8c:5f:93:1e,16775550,332,1486,16775218,16775550
5368,6,6,1,2412,-87,-88,1,,16778287,44,2693,16778243,16778287
5369,4,11,1,2412,-93,-88,-5,4c:01:43:db:2d:86,16779557,387,883,16779170,16779557
5370,4,1,1,2412,-91,-88,-3,d8:9c:8e:01:4c:6a,16780574,3000,-1983,16777574,16780574
5371,6,6,1,2412,-89,-88,-1,e2:db:d1:d1:b0:4a,16786423,444,5405,16785979,16786423
5372,6,6,1,2412,-91,-88,-3,e2:db:d1:d1:b0:4b,16786891,408,60,16786483,16786891
5373,6,24,1,2412,-83,-88,5,,16787307,28,388,16787279,16787307
5374,6,6,1,2412,-90,-88,-2,,16789312,44,1961,16789268,16789312
5375,6,24,1,2412,-83,-88,5,,16791061,28,1721,16791033,16791061
5376,6,24,1,2412,-87,-88,1,,16792225,28,1136,16792197,16792225
5377,6,24,1,2412,-88,-88,0,,16792650,28,397,16792622,16792650
5378,6,12,1,2412,-88,-88,0,4c:01:43:ec:a0:66,16793554,44,860,16793510,16793554
5379,4,11,1,2412,-88,-88,0,4c:01:43:ec:a0:69,16794703,361,788,16794342,16794703
5380,4,11,1,2412,-87,-88,1,4c:01:43:ec:a0:63,16795077,322,52,16794755,16795077
5381,6,24,1,2412,-82,-88,6,,16807112,28,12007,16807084,16807112
5382,6,6,1,2412,-54,-88,34,32:86:8c:5f:93:1e,16826750,332,19306,16826418,16826750
5383,4,1,1,2412,-87,-88,1,,16835136,304,8082,16834832,16835136
5384,6,6,1,2412,-90,-88,-2,,16835357,44,177,16835313,16835357
5385,6,6,1,2412,-88,-88,0,,16848311,44,12910,16848267,16848311
5386,4,1,1,2412,-60,-88,28,b0:e4:d5:32:ec:8a,16848549,1960,-1722,16846589,16848549
5387,4,1,1,2412,-85,-88,3,bc:98:df:ff:0f:8b,16852490,2568,1373,16849922,16852490
5388,4,1,1,2412,-55,-88,33,94:a6:7e:c9:98:67,16855525,2464,571,16853061,16855525
5389,4,11,1,2412,-55,-88,33,10:86:8c:5f:93:1e,16858290,347,2418,16857943,16858290
5390,4,11,1,2412,-85,-88,3,4c:01:43:d7:f3:23,16859000,322,388,16858678,16859000
5391,4,11,1,2412,-86,-88,2,4c:01:43:d7:f3:26,16859335,387,-52,16858948,16859335
5392,6,6,1,2412,-63,-88,25,b4:e6:2d:b4:ff:71,16864140,64,4741,16864076,16864140
5393,6,6,1,2412,-54,-88,34,,16864220,44,36,16864176,16864220
5394,4,11,1,2412,-80,-88,8,48:dd:0c:7d:86:25,16873745,382,9143,16873363,16873745
5395,6,24,1,2412,-84,-88,4,,16884262,28,10489,16884234,16884262
5396,6,6,1,2412,-90,-88,-2,e2:db:d1:d1:b0:4a,16884788,68,458,16884720,16884788
5397,6,6,1,2412,-56,-88,32,12:86:8c:5f:93:1e,16884893,332,-227,16884561,16884893
5398,6,24,1,2412,-83,-88,5,,16888585,28,3664,16888557,16888585
5399,6,6,1,2412,-87,-88,1,e2:db:d1:d1:b0:4a,16888812,444,-217,16888368,16888812
5400,6,6,1,2412,-91,-88,-3,e2:db:d1:d1:b0:4b,16889280,408,60,16888872,16889280
5401,6,6,1,2412,-90,-88,-2,e2:db:d1:d1:b0:4d,16889739,408,51,16889331,16889739
5402,6,6,1,2412,-90,-88,-2,,16890882,44,1099,16890838,16890882
5403,4,1,1,2412,-92,-88,-4,78:67:0e:4b:85:1f,16892876,2552,-558,16890324,16892876
5404,4,11,1,2412,-82,-88,6,4c:01:43:ec:a0:69,16896761,361,3524,16896400,16896761
5405,4,11,1,2412,-83,-88,5,4c:01:43:ec:a0:63,16897135,322,52,16896813,16897135
5406,4,11,1,2412,-85,-88,3,4c:01:43:ec:a0:66,16897469,387,-53,16897082,16897469
5407,4,11,1,2412,-81,-88,7,48:dd:0c:90:e3:87,16898127,362,296,16897765,16898127
5408,4,11,1,2412,-81,-88,7,48:dd:0c:90:e3:83,16898501,323,51,16898178,16898501
5409,4,11,1,2412,-82,-88,6,48:dd:0c:90:e3:85,16898837,382,-46,16898455,16898837
5410,6,6,1,2412,-57,-88,31,52:86:8c:5f:93:1e,16904043,332,4874,16903711,16904043
5411,4,1,1,2412,-85,-88,3,78:67:0e:c4:a8:42,16910324,2736,3545,16907588,16910324
5412,4,1,1,2412,-92,-88,-4,04:a2:22:bf:24:52,16914489,2512,1653,16911977,16914489
5413,6,6,1,2412,-88,-88,0,,16922572,44,8039,16922528,16922572
5414,4,1,1,2412,-90,-88,-2,,16923193,304,317,16922889,16923193
5415,4,1,1,2412,-90,-88,-2,,16928091,304,4594,16927787,16928091
5416,6,6,1,2412,-89,-88,-1,e2:db:d1:d1:b0:4a,16928524,68,365,16928456,16928524
5417,6,6,1,2412,-58,-88,30,32:86:8c:5f:93:1e,16929151,332,295,16928819,16929151
5418,6,24,1,2412,-84,-88,4,,16946994,28,17815,16946966,16946994
5419,6,6,1,2412,-58,-88,30,10:86:8c:5f:93:1e,16954750,344,7412,16954406,16954750
5420,4,1,1,2412,-52,-88,36,94:a6:7e:c9:98:67,16957769,2464,555,16955305,16957769
5421,4,11,1,2412,-84,-88,4,4c:01:43:d7:f3:23,16961400,322,3309,16961078,16961400
5422,6,24,1,2412,-84,-88,4,,16967577,28,6149,16967549,16967577
5423,6,6,1,2412,-57,-88,31,12:86:8c:5f:93:1e,16980351,332,12442,16980019,16980351
5424,4,1,1,2412,-58,-88,30,,16983138,304,2483,16982834,16983138
5425,4,1,1,2412,-57,-88,31,,16983618,304,176,16983314,16983618
5426,4,1,1,2412,-57,-88,31,,16983932,304,10,16983628,16983932
5427,4,1,1,2412,-57,-88,31,,16984247,304,11,16983943,16984247
5428,4,1,1,2412,-56,-88,32,,16984562,304,11,16984258,16984562
5429,4,1,1,2412,-57,-88,31,,16984877,304,11,16984573,16984877
5430,4,1,1,2412,-57,-88,31,,16985200,304,19,16984896,16985200
5431,4,1,1,2412,-57,-88,31,,16985515,304,11,16985211,16985515
5432,4,1,1,2412,-56,-88,32,,16985830,304,11,16985526,16985830
5433,4,1,1,2412,-57,-88,31,,16986145,304,11,16985841,16986145
5434,4,1,1,2412,-56,-88,32,,16986459,304,10,16986155,16986459
5435,4,1,1,2412,-57,-88,31,,16986783,304,20,16986479,16986783
5436,6,6,1,2412,-88,-88,0,e2:db:d1:d1:b0:4a,16991311,444,4084,16990867,16991311
5437,4,11,1,2412,-87,-88,1,4c:01:43:ec:a0:63,16999534,322,7901,16999212,16999534
5438,6,24,1,2412,-84,-88,4,,17002728,28,3166,17002700,17002728
5439,4,1,1,2412,-89,-88,-1,00:26:62:eb:ea:74,17016725,968,13029,17015757,17016725
5440,4,1,1,2412,-86,-88,2,,17023399,304,6370,17023095,17023399
5441,4,1,1,2412,-87,-88,1,,17024450,304,747,17024146,17024450
5442,6,24,1,2412,-85,-88,3,,17031065,28,6587,17031037,17031065
5443,6,6,1,2412,-56,-88,32,,17036695,44,5586,17036651,17036695
5444,6,6,1,2412,-87,-88,1,,17038739,44,2000,17038695,17038739
5445,6,6,1,2412,-87,-88,1,,17039581,44,798,17039537,17039581
5446,6,6,1,2412,-86,-88,2,,17048576,44,8951,17048532,17048576
5447,6,6,1,2412,-87,-88,1,,17049059,44,439,17049015,17049059
5448,4,1,1,2412,-60,-88,28,b0:e4:d5:32:ec:8a,17053179,1960,2160,17051219,17053179
5449,4,1,1,2412,-84,-88,4,bc:98:df:ff:0f:8b,17057272,2568,1525,17054704,17057272
5450,4,1,1,2412,-48,-88,40,94:a6:7e:c9:98:67,17060168,2464,432,17057704,17060168
5451,4,11,1,2412,-88,-88,0,4c:01:43:d7:f3:29,17063425,362,2895,17063063,17063425
5452,4,11,1,2412,-87,-88,1,4c:01:43:d7:f3:23,17063800,322,53,17063478,17063800
5453,4,11,1,2412,-89,-88,-1,4c:01:43:d7:f3:26,17064134,387,-53,17063747,17064134
5454,4,11,1,2412,-75,-88,13,48:dd:0c:7d:86:27,17077836,362,13340,17077474,17077836
5455,4,11,1,2412,-74,-88,14,48:dd:0c:7d:86:23,17078210,323,51,17077887,17078210
5456,4,11,1,2412,-75,-88,13,48:dd:0c:7d:86:25,17078545,382,-47,17078163,17078545
5457,4,1,1,2412,-86,-88,2,78:67:0e:38:6c:d3,17079936,2208,-817,17077728,17079936
5458,6,6,1,2412,-82,-88,6,40:b0:34:b7:01:d5,17081999,576,1487,17081423,17081999
5459,6,6,1,2412,-53,-88,35,b4:e6:2d:b4:ff:71,17085426,64,3363,17085362,17085426
5460,6,6,1,2412,-53,-88,35,b4:e6:2d:b4:ff:71,17085678,64,188,17085614,17085678
5461,6,6,1,2412,-53,-88,35,b4:e6:2d:b4:ff:71,17090253,64,4511,17090189,17090253
5462,6,6,1,2412,-53,-88,35,b4:e6:2d:b4:ff:71,17090460,64,143,17090396,17090460
5463,6,6,1,2412,-53,-88,35,b4:e6:2d:b4:ff:71,17090676,64,152,17090612,17090676
5464,6,6,1,2412,-53,-88,35,b4:e6:2d:b4:ff:71,17090901,64,161,17090837,17090901
5465,4,1,1,2412,-55,-88,33,b4:e6:2d:b4:ff:71,17091237,416,-80,17090821,17091237
5466,4,1,1,2412,-55,-88,33,b4:e6:2d:b4:ff:71,17091805,416,152,17091389,17091805
5467,4,1,1,2412,-55,-88,33,b4:e6:2d:b4:ff:71,17092346,416,125,17091930,17092346
5468,4,1,1,2412,-84,-88,4,78:67:0e:c4:a8:42,17092907,352,209,17092555,17092907
5469,4,1,1,2412,-54,-88,34,b4:e6:2d:b4:ff:71,17093740,416,417,17093324,17093740
5470,4,1,1,2412,-57,-88,31,,17094166,304,122,17093862,17094166
5471,4,11,1,2412,-77,-88,11,48:dd:0c:7d:86:23,17095866,277,1423,17095589,17095866
5472,4,11,1,2412,-86,-88,2,48:dd:0c:90:e3:83,17096372,284,222,17096088,17096372
5473,6,6,1,2412,-87,-88,1,,17100623,44,4207,17100579,17100623
5474,4,1,1,2412,-92,-88,-4,cc:f4:11:65:3f:fb,17104864,2064,2177,17102800,17104864
5475,6,24,1,2412,-86,-88,2,,17111063,28,6171,17111035,17111063
5476,4,1,1,2412,-82,-88,6,,17114495,304,3128,17114191,17114495
5477,6,24,1,2412,-85,-88,3,,17118940,28,4417,17118912,17118940
5478,6,24,1,2412,-86,-88,2,,17123641,28,4673,17123613,17123641
5479,4,1,1,2412,-92,-88,-4,ce:f4:11:65:3f:f8,17141721,2024,16056,17139697,17141721
5480,4,1,1,2412,-62,-88,26,b0:e4:d5:32:ec:8a,17155579,1960,11898,17153619,17155579
5481,4,1,1,2412,-50,-88,38,94:a6:7e:c9:98:67,17165057,3544,5934,17161513,17165057
5482,4,1,1,2412,-50,-88,38,94:a6:7e:c9:98:67,17168638,3104,477,17165534,17168638
5483,4,1,1,2412,-49,-88,39,94:a6:7e:c9:98:67,17171779,3032,109,17168747,17171779
5484,4,1,1,2412,-49,-88,39,94:a6:7e:c9:98:67,17174867,3624,-536,17171243,17174867
5485,6,6,1,2412,-91,-88,-3,,17181792,44,6881,17181748,17181792
5486,6,6,1,2412,-85,-88,3,,17182333,44,497,17182289,17182333
5487,6,6,1,2412,-83,-88,5,40:b0:34:b7:01:d5,17183336,576,427,17182760,17183336
5488,6,6,1,2412,-90,-88,-2,,17200239,44,16859,17200195,17200239
5489,4,11,1,2412,-80,-88,8,4c:01:43:ec:a0:69,17203958,361,3358,17203597,17203958
5490,4,11,1,2412,-84,-88,4,48:dd:0c:90:e3:83,17205701,323,1420,17205378,17205701
5491,4,1,1,2412,-85,-88,3,78:67:0e:c4:a8:42,17207111,352,1058,17206759,17207111
5492,4,11,1,2412,-89,-88,-1,,17209075,107,1857,17208968,17209075
5493,6,6,1,2412,-87,-88,1,0a:a7:c0:a3:8d:71,17215544,408,6061,17215136,17215544
5494,6,6,1,2412,-88,-88,0,0a:a7:c0:a3:8d:73,17215993,408,41,17215585,17215993
5495,4,1,1,2412,-88,-88,0,78:67:0e:c4:a8:42,17217524,2736,-1205,17214788,17217524
5496,4,1,1,2412,-87,-88,1,,17220962,304,3134,17220658,17220962
5497,4,1,1,2412,-90,-88,-2,,17225684,304,4418,17225380,17225684
5498,6,6,1,2412,-91,-88,-3,,17228773,44,3045,17228729,17228773
5499,4,1,1,2412,-60,-88,28,b0:e4:d5:32:ec:8a,17257978,1960,27245,17256018,17257978
5500,4,1,1,2412,-86,-88,2,bc:98:df:ff:0f:8b,17262073,2568,1527,17259505,17262073
5501,4,1,1,2412,-51,-88,37,94:a6:7e:c9:98:67,17264954,2464,417,17262490,17264954
5502,6,6,1,2412,-90,-88,-2,3c:bd:c5:ee:96:6d,17267395,68,2373,17267327,17267395
5503,4,11,1,2412,-86,-88,2,4c:01:43:d7:f3:29,17268224,362,467,17267862,17268224
5504,4,11,1,2412,-86,-88,2,4c:01:43:d7:f3:23,17268599,322,53,17268277,17268599
5505,4,11,1,2412,-84,-88,4,4c:01:43:d7:f3:26,17268933,387,-53,17268546,17268933
5506,4,11,1,2412,-89,-88,-1,,17272744,107,3704,17272637,17272744
5507,6,24,1,2412,-87,-88,1,78:67:0e:c4:a8:42,17272859,32,83,17272827,17272859
5508,4,1,1,2412,-90,-88,-2,78:67:0e:38:6c:d3,17279877,2736,4282,17277141,17279877
5509,4,11,1,2412,-84,-88,4,48:dd:0c:7d:86:27,17282636,362,2397,17282274,17282636
5510,4,11,1,2412,-83,-88,5,48:dd:0c:7d:86:23,17283011,323,52,17282688,17283011
5511,4,11,1,2412,-84,-88,4,48:dd:0c:7d:86:25,17283346,382,-47,17282964,17283346
5512,6,6,1,2412,-87,-88,1,40:b0:34:b7:01:d5,17285737,576,1815,17285161,17285737
5513,6,24,1,2412,-87,-88,1,,17287307,28,1542,17287279,17287307
5514,4,11,1,2412,-86,-88,2,4c:01:43:ec:a0:66,17307065,387,19371,17306678,17307065
5515,4,11,1,2412,-84,-88,4,48:dd:0c:90:e3:87,17307726,362,299,17307364,17307726
5516,4,11,1,2412,-85,-88,3,48:dd:0c:90:e3:83,17308100,323,51,17307777,17308100
5517,4,11,1,2412,-84,-88,4,48:dd:0c:90:e3:85,17308436,382,-46,17308054,17308436
5518,4,11,1,2412,-86,-88,2,4c:01:43:ec:a0:63,17331453,254,22763,17331199,17331453
5519,4,11,1,2412,-88,-88,0,4c:01:43:d7:f3:23,17331756,254,49,17331502,17331756
5520,6,6,1,2412,-89,-88,-1,,17350144,44,18344,17350100,17350144
5521,6,6,1,2412,-89,-88,-1,,17350564,44,376,17350520,17350564
5522,6,24,1,2412,-83,-88,5,,17351069,28,477,17351041,17351069
5523,4,1,1,2412,-91,-88,-3,,17352244,304,871,17351940,17352244
5524,4,1,1,2412,-92,-88,-4,,17353396,304,848,17353092,17353396
5525,4,1,1,2412,-63,-88,25,b0:e4:d5:32:ec:8a,17360377,1960,5021,17358417,17360377
5526,4,1,1,2412,-56,-88,32,94:a6:7e:c9:98:67,17368406,2464,5565,17365942,17368406
5527,4,11,1,2412,-83,-88,5,4c:01:43:d7:f3:23,17370998,322,2270,17370676,17370998
5528,4,11,1,2412,-82,-88,6,4c:01:43:d7:f3:26,17371333,387,-52,17370946,17371333
5529,4,1,1,2412,-89,-88,-1,78:67:0e:38:6c:d3,17382277,2736,8208,17379541,17382277
5530,4,11,1,2412,-79,-88,9,48:dd:0c:7d:86:27,17385036,362,2397,17384674,17385036
5531,4,11,1,2412,-79,-88,9,48:dd:0c:7d:86:23,17385410,323,51,17385087,17385410
5532,4,11,1,2412,-79,-88,9,48:dd:0c:7d:86:25,17385746,382,-46,17385364,17385746
5533,4,11,1,2412,-87,-88,1,4c:01:43:ec:a0:69,17408755,361,22648,17408394,17408755
5534,4,11,1,2412,-86,-88,2,4c:01:43:ec:a0:63,17409129,322,52,17408807,17409129
5535,4,11,1,2412,-84,-88,4,48:dd:0c:90:e3:87,17410126,362,635,17409764,17410126
5536,4,11,1,2412,-83,-88,5,48:dd:0c:90:e3:83,17410500,323,51,17410177,17410500
5537,4,11,1,2412,-84,-88,4,48:dd:0c:90:e3:85,17410835,382,-47,17410453,17410835
5538,4,1,1,2412,-87,-88,1,,17420741,304,9602,17420437,17420741
5539,4,1,1,2412,-86,-88,2,78:67:0e:c4:a8:42,17422324,2736,-1153,17419588,17422324
5540,6,24,1,2412,-84,-88,4,,17431070,28,8718,17431042,17431070
5541,6,24,1,2412,-85,-88,3,,17431479,28,381,17431451,17431479
5542,6,24,1,2412,-85,-88,3,,17443904,28,12397,17443876,17443904
5543,4,1,1,2412,-63,-88,25,b0:e4:d5:32:ec:8a,17462776,1960,16912,17460816,17462776
5544,4,1,1,2412,-91,-88,-3,bc:98:df:ff:0f:8b,17466874,2568,1530,17464306,17466874
5545,4,1,1,2412,-56,-88,32,94:a6:7e:c9:98:67,17469463,2464,125,17466999,17469463
5546,4,11,1,2412,-88,-88,0,4c:01:43:d7:f3:29,17473023,362,3198,17472661,17473023
5547,4,11,1,2412,-89,-88,-1,4c:01:43:d7:f3:23,17473398,322,53,17473076,17473398
5548,4,11,1,2412,-81,-88,7,4c:01:43:d7:f3:26,17473732,387,-53,17473345,17473732
5549,4,11,1,2412,-76,-88,12,48:dd:0c:7d:86:27,17487436,362,13342,17487074,17487436
5550,4,11,1,2412,-78,-88,10,48:dd:0c:7d:86:23,17487810,323,51,17487487,17487810
5551,4,11,1,2412,-78,-88,10,48:dd:0c:7d:86:25,17488146,382,-46,17487764,17488146
5552,4,1,1,2412,-88,-88,0,,17490803,304,2353,17490499,17490803
5553,4,1,1,2412,-91,-88,-3,,17495988,304,4881,17495684,17495988
5554,4,11,1,2412,-89,-88,-1,4c:01:43:db:2d:83,17496763,322,453,17496441,17496763
5555,4,11,1,2412,-91,-88,-3,4c:01:43:db:2d:86,17497097,387,-53,17496710,17497097
5556,6,6,1,2412,-87,-88,1,e2:db:d1:d1:b0:4a,17503225,444,5684,17502781,17503225
5557,6,6,1,2412,-86,-88,2,e2:db:d1:d1:b0:4d,17504161,408,528,17503753,17504161
5558,6,6,1,2412,-88,-88,0,e2:db:d1:d1:b0:4f,17504620,408,51,17504212,17504620
5559,4,1,1,2412,-90,-88,-2,00:26:62:eb:ea:74,17505136,968,-452,17504168,17505136
5560,4,1,1,2412,-89,-88,-1,00:26:62:eb:ea:74,17506132,832,164,17505300,17506132
5561,4,11,1,2412,-86,-88,2,4c:01:43:ec:a0:69,17511154,361,4661,17510793,17511154
5562,4,11,1,2412,-85,-88,3,4c:01:43:ec:a0:63,17511528,322,52,17511206,17511528
5563,6,24,1,2412,-87,-88,1,,17512158,28,602,17512130,17512158
5564,4,11,1,2412,-86,-88,2,48:dd:0c:90:e3:85,17513235,382,695,17512853,17513235
5565,4,1,1,2412,-91,-88,-3,3c:bd:c5:ee:96:6d,17518154,2512,2407,17515642,17518154
5566,6,24,1,2412,-86,-88,2,,17524565,28,6383,17524537,17524565
5567,6,24,1,2412,-87,-88,1,,17537306,28,12713,17537278,17537306
5568,6,24,1,2412,-87,-88,1,,17555130,28,17796,17555102,17555130
5569,6,6,1,2412,-89,-88,-1,,17560020,44,4846,17559976,17560020
5570,4,1,1,2412,-92,-88,-4,,17564083,304,3759,17563779,17564083
5571,4,1,1,2412,-67,-88,21,b0:e4:d5:32:ec:8a,17565176,1960,-867,17563216,17565176
5572,4,1,1,2412,-92,-88,-4,bc:98:df:ff:0f:8b,17569291,2568,1547,17566723,17569291
5573,4,1,1,2412,-61,-88,27,94:a6:7e:c9:98:67,17572153,2464,398,17569689,17572153
5574,4,11,1,2412,-89,-88,-1,4c:01:43:d7:f3:29,17575423,362,2908,17575061,17575423
5575,4,11,1,2412,-87,-88,1,4c:01:43:d7:f3:23,17575797,322,52,17575475,17575797
5576,4,11,1,2412,-89,-88,-1,4c:01:43:d7:f3:26,17576132,387,-52,17575745,17576132
5577,4,11,1,2412,-88,-88,0,4c:01:43:ec:a0:63,17576911,254,525,17576657,17576911
5578,4,11,1,2412,-89,-88,-1,4c:01:43:d7:f3:23,17577969,254,804,17577715,17577969
5579,4,1,1,2412,-94,-88,-6,,17582591,304,4318,17582287,17582591
5580,4,11,1,2412,-88,-88,0,48:dd:0c:7d:86:23,17590211,323,7297,17589888,17590211
5581,4,11,1,2412,-77,-88,11,48:dd:0c:7d:86:25,17590546,382,-47,17590164,17590546
5582,6,6,1,2412,-92,-88,-4,,17592560,44,1970,17592516,17592560
5583,6,6,1,2412,-79,-88,9,40:b0:34:b7:01:d5,17592941,576,-195,17592365,17592941
5584,4,1,1,2412,-87,-88,1,00:26:62:eb:ea:74,17602726,968,8817,17601758,17602726
5585,4,11,1,2412,-90,-88,-2,4c:01:43:ec:a0:69,17613553,361,10466,17613192,17613553
5586,4,11,1,2412,-90,-88,-2,4c:01:43:ec:a0:63,17613927,322,52,17613605,17613927
5587,4,11,1,2412,-91,-88,-3,4c:01:43:ec:a0:66,17614261,387,-53,17613874,17614261
5588,4,11,1,2412,-83,-88,5,48:dd:0c:90:e3:87,17614925,362,302,17614563,17614925
5589,4,11,1,2412,-83,-88,5,48:dd:0c:90:e3:85,17615635,382,328,17615253,17615635
5590,6,24,1,2412,-85,-88,3,,17618648,28,2985,17618620,17618648
5591,4,1,1,2412,-87,-88,1,78:67:0e:c4:a8:42,17620268,352,1268,17619916,17620268
5592,4,1,1,2412,-85,-88,3,3c:bd:c5:ee:96:6d,17620535,2512,-2245,17618023,17620535
5593,4,1,1,2412,-90,-88,-2,,17626994,304,6155,17626690,17626994
5594,4,1,1,2412,-94,-88,-6,,17630593,304,3295,17630289,17630593
5595,6,24,1,2412,-86,-88,2,,17637303,28,6682,17637275,17637303
5596,6,24,1,2412,-85,-88,3,,17655096,28,17765,17655068,17655096
5597,4,1,1,2412,-63,-88,25,b0:e4:d5:32:ec:8a,17667575,1960,10519,17665615,17667575
5598,6,24,1,2412,-86,-88,2,,17671077,28,3474,17671049,17671077
5599,4,1,1,2412,-59,-88,29,94:a6:7e:c9:98:67,17674552,2464,1011,17672088,17674552
5600,4,11,1,2412,-90,-88,-2,4c:01:43:d7:f3:29,17677822,362,2908,17677460,17677822
5601,4,11,1,2412,-90,-88,-2,4c:01:43:d7:f3:26,17678531,387,322,17678144,17678531
5602,6,24,1,2412,-89,-88,-1,,17683646,28,5087,17683618,17683646
5603,4,11,1,2412,-80,-88,8,48:dd:0c:7d:86:27,17692236,362,8228,17691874,17692236
5604,4,11,1,2412,-80,-88,8,48:dd:0c:7d:86:23,17692611,323,52,17692288,17692611
5605,4,11,1,2412,-79,-88,9,48:dd:0c:7d:86:25,17692946,382,-47,17692564,17692946
5606,6,24,1,2412,-86,-88,2,,17698101,28,5127,17698073,17698101
5607,6,24,1,2412,-85,-88,3,,17701485,28,3356,17701457,17701485
5608,6,6,1,2412,-91,-88,-3,,17709953,44,8424,17709909,17709953
5609,4,11,1,2412,-85,-88,3,4c:01:43:ec:a0:69,17715952,361,5638,17715591,17715952
5610,4,11,1,2412,-82,-88,6,4c:01:43:ec:a0:63,17716326,322,52,17716004,17716326
5611,4,11,1,2412,-82,-88,6,48:dd:0c:90:e3:87,17717325,362,637,17716963,17717325
5612,4,11,1,2412,-85,-88,3,48:dd:0c:90:e3:83,17717699,323,51,17717376,17717699
5613,4,11,1,2412,-85,-88,3,48:dd:0c:90:e3:85,17718035,382,-46,17717653,17718035
5614,6,24,1,2412,-85,-88,3,,17718661,28,598,17718633,17718661
5615,4,1,1,2412,-92,-88,-4,04:a2:22:bf:24:52,17733705,2512,12532,17731193,17733705
5616,6,24,1,2412,-86,-88,2,,17737297,28,3564,17737269,17737297
5617,6,24,1,2412,-83,-88,5,,17755534,28,18209,17755506,17755534
5618,4,1,1,2412,-73,-88,15,ac:67:84:84:8a:07,17765574,448,9592,17765126,17765574
5619,4,1,1,2412,-63,-88,25,94:a6:7e:c9:98:67,17776955,2464,8917,17774491,17776955
5620,4,11,1,2412,-85,-88,3,4c:01:43:d7:f3:29,17780222,362,2905,17779860,17780222
5621,4,11,1,2412,-86,-88,2,4c:01:43:d7:f3:23,17780596,322,52,17780274,17780596
5622,4,11,1,2412,-86,-88,2,4c:01:43:d7:f3:26,17780931,387,-52,17780544,17780931
5623,4,1,1,2412,-90,-88,-2,,17787666,304,6431,17787362,17787666
5624,4,11,1,2412,-80,-88,8,48:dd:0c:7d:86:27,17794637,362,6609,17794275,17794637
5625,4,11,1,2412,-81,-88,7,48:dd:0c:7d:86:23,17795012,323,52,17794689,17795012
5626,4,11,1,2412,-80,-88,8,48:dd:0c:7d:86:25,17795347,382,-47,17794965,17795347
5627,6,24,1,2412,-83,-88,5,,17796995,28,1620,17796967,17796995
5628,4,1,1,2412,-90,-88,-2,00:26:62:eb:ea:74,17807512,968,9549,17806544,17807512
5629,6,6,1,2412,-90,-88,-2,e2:db:d1:d1:b0:4d,17811354,408,3434,17810946,17811354
5630,4,11,1,2412,-87,-88,1,4c:01:43:ec:a0:69,17818351,361,6636,17817990,17818351
5631,4,11,1,2412,-84,-88,4,4c:01:43:ec:a0:63,17818725,322,52,17818403,17818725
5632,4,11,1,2412,-85,-88,3,4c:01:43:ec:a0:66,17819059,387,-53,17818672,17819059
5633,4,1,1,2412,-84,-88,4,78:67:0e:c4:a8:42,17831923,2736,10128,17829187,17831923
5634,6,24,1,2412,-89,-88,-1,,17843655,28,11704,17843627,17843655
5635,6,6,1,2412,-90,-88,-2,,17846699,44,3000,17846655,17846699
5636,6,6,1,2412,-88,-88,0,,17847188,44,445,17847144,17847188
5637,4,1,1,2412,-88,-88,0,,17848817,304,1325,17848513,17848817
5638,4,1,1,2412,-88,-88,0,,17852274,304,3153,17851970,17852274
5639,6,24,1,2412,-85,-88,3,,17854470,28,2168,17854442,17854470
5640,4,1,1,2412,-72,-88,16,b0:e4:d5:32:ec:8a,17872373,1960,15943,17870413,17872373
5641,4,1,1,2412,-89,-88,-1,bc:98:df:ff:0f:8b,17876475,2568,1534,17873907,17876475
5642,4,1,1,2412,-60,-88,28,94:a6:7e:c9:98:67,17879350,2464,411,17876886,17879350
5643,4,11,1,2412,-90,-88,-2,4c:01:43:d7:f3:29,17882621,362,2909,17882259,17882621
5644,4,11,1,2412,-90,-88,-2,4c:01:43:d7:f3:23,17882996,322,53,17882674,17882996
5645,4,11,1,2412,-90,-88,-2,4c:01:43:d7:f3:26,17883330,387,-53,17882943,17883330
5646,6,6,1,2412,-89,-88,-1,,17889103,44,5729,17889059,17889103
5647,4,1,1,2412,-89,-88,-1,,17891473,304,2066,17891169,17891473
5648,6,6,1,2412,-90,-88,-2,,17891694,44,177,17891650,17891694
5649,4,1,1,2412,-90,-88,-2,,17893618,304,1620,17893314,17893618
5650,4,1,1,2412,-89,-88,-1,78:67:0e:38:6c:d3,17894278,2736,-2076,17891542,17894278
5651,4,11,1,2412,-72,-88,16,48:dd:0c:7d:86:27,17897037,362,2397,17896675,17897037
5652,4,11,1,2412,-71,-88,17,48:dd:0c:7d:86:25,17897747,382,328,17897365,17897747
5653,6,24,1,2412,-86,-88,2,,17898775,28,1000,17898747,17898775
5654,6,6,1,2412,-85,-88,3,40:b0:34:b7:01:d5,17900144,576,793,17899568,17900144
5655,6,6,1,2412,-89,-88,-1,,17904404,44,4216,17904360,17904404
5656,6,24,1,2412,-86,-88,2,,17918018,28,13586,17917990,17918018
5657,4,11,1,2412,-88,-88,0,4c:01:43:ec:a0:63,17921123,322,2783,17920801,17921123
5658,4,11,1,2412,-89,-88,-1,4c:01:43:ec:a0:66,17921458,387,-52,17921071,17921458
5659,4,11,1,2412,-85,-88,3,48:dd:0c:90:e3:87,17922124,362,304,17921762,17922124
5660,4,11,1,2412,-86,-88,2,48:dd:0c:90:e3:83,17922499,323,52,17922176,17922499
5661,4,11,1,2412,-85,-88,3,48:dd:0c:90:e3:85,17922834,382,-47,17922452,17922834
5662,4,1,1,2412,-90,-88,-2,3c:bd:c5:ee:96:6d,17927753,2512,2407,17925241,17927753
5663,6,6,1,2412,-60,-88,28,32:86:8c:5f:93:1e,17953187,332,25102,17952855,17953187
5664,6,6,1,2412,-90,-88,-2,,17962503,44,9272,17962459,17962503
5665,6,6,1,2412,-89,-88,-1,e2:db:d1:d1:b0:4a,17970868,52,8313,17970816,17970868
5666,6,6,1,2412,-89,-88,-1,,17971123,44,211,17971079,17971123
5667,4,1,1,2412,-92,-88,-4,,17973265,304,1838,17972961,17973265
5668,4,1,1,2412,-67,-88,21,b0:e4:d5:32:ec:8a,17974773,1960,-452,17972813,17974773
5669,4,1,1,2412,-89,-88,-1,bc:98:df:ff:0f:8b,17978881,2568,1540,17976313,17978881
5670,6,6,1,2412,-61,-88,27,10:86:8c:5f:93:1e,17981305,344,2080,17980961,17981305
5671,4,1,1,2412,-57,-88,31,94:a6:7e:c9:98:67,17981849,2464,-1920,17979385,17981849
5672,4,11,1,2412,-88,-88,0,4c:01:43:d7:f3:29,17985021,362,2810,17984659,17985021
5673,4,11,1,2412,-88,-88,0,4c:01:43:d7:f3:23,17985395,322,52,17985073,17985395
5674,6,24,1,2412,-87,-88,1,,17991084,28,5661,17991056,17991084
5675,4,1,1,2412,-76,-88,12,78:67:0e:38:6c:d3,17996678,2736,2858,17993942,17996678
5676,4,1,1,2412,-83,-88,5,78:67:0e:38:6c:d3,18001232,832,3722,18000400,18001232
5677,4,1,1,2412,-85,-88,3,,18002036,304,500,18001732,18002036
5678,4,1,1,2412,-86,-88,2,,18003236,304,896,18002932,18003236
5679,4,1,1,2412,-86,-88,2,,18004422,304,882,18004118,18004422
5680,6,24,1,2412,-88,-88,0,,18004805,28,355,18004777,18004805
5681,6,6,1,2412,-62,-88,26,12:86:8c:5f:93:1e,18014366,332,9229,18014034,18014366
5682,4,1,1,2412,-85,-88,3,,18016643,304,1973,18016339,18016643
5683,4,11,1,2412,-87,-88,1,4c:01:43:ec:a0:69,18023148,361,6144,18022787,18023148
5684,4,11,1,2412,-87,-88,1,4c:01:43:ec:a0:63,18023522,322,52,18023200,18023522
5685,4,11,1,2412,-86,-88,2,4c:01:43:ec:a0:66,18023857,387,-52,18023470,18023857
5686,4,11,1,2412,-88,-88,0,48:dd:0c:90:e3:87,18024524,362,305,18024162,18024524
5687,4,11,1,2412,-88,-88,0,48:dd:0c:90:e3:83,18024899,323,52,18024576,18024899
5688,4,11,1,2412,-91,-88,-3,48:dd:0c:90:e3:85,18025234,382,-47,18024852,18025234
5689,4,1,1,2412,-88,-88,0,,18040529,304,14991,18040225,18040529
5690,4,1,1,2412,-87,-88,1,,18053777,304,12944,18053473,18053777
5691,4,1,1,2412,-88,-88,0,,18055714,304,1633,18055410,18055714
5692,6,6,1,2412,-57,-88,31,32:86:8c:5f:93:1e,18056011,332,-35,18055679,18056011
5693,4,1,1,2412,-86,-88,2,,18056906,304,591,18056602,18056906
5694,6,6,1,2412,-60,-88,28,b4:e6:2d:b4:ff:71,18063298,64,6328,18063234,18063298
5695,6,6,1,2412,-60,-88,28,b4:e6:2d:b4:ff:71,18063550,64,188,18063486,18063550
5696,6,6,1,2412,-60,-88,28,b4:e6:2d:b4:ff:71,18063721,64,107,18063657,18063721
5697,6,6,1,2412,-60,-88,28,b4:e6:2d:b4:ff:71,18063937,64,152,18063873,18063937
5698,6,6,1,2412,-60,-88,28,b4:e6:2d:b4:ff:71,18064162,64,161,18064098,18064162
5699,6,6,1,2412,-60,-88,28,b4:e6:2d:b4:ff:71,18064580,64,354,18064516,18064580
5700,4,1,1,2412,-61,-88,27,b4:e6:2d:b4:ff:71,18064943,416,-53,18064527,18064943
5701,4,1,1,2412,-62,-88,26,b4:e6:2d:b4:ff:71,18065502,416,143,18065086,18065502
5702,4,1,1,2412,-56,-88,32,,18065928,304,122,18065624,18065928
5703,4,1,1,2412,-68,-88,20,b0:e4:d5:32:ec:8a,18077172,1960,9284,18075212,18077172
5704,6,6,1,2412,-55,-88,33,10:86:8c:5f:93:1e,18082067,344,4551,18081723,18082067
5705,4,11,1,2412,-87,-88,1,4c:01:43:d7:f3:29,18087420,362,4991,18087058,18087420
5706,4,11,1,2412,-88,-88,0,4c:01:43:d7:f3:23,18087795,322,53,18087473,18087795
5707,4,11,1,2412,-87,-88,1,4c:01:43:d7:f3:26,18088129,387,-53,18087742,18088129
5708,4,1,1,2412,-85,-88,3,78:67:0e:38:6c:d3,18099079,2736,8214,18096343,18099079
5709,4,11,1,2412,-78,-88,10,48:dd:0c:7d:86:27,18101838,362,2397,18101476,18101838
5710,4,11,1,2412,-78,-88,10,48:dd:0c:7d:86:23,18102212,323,51,18101889,18102212
5711,4,11,1,2412,-74,-88,14,48:dd:0c:7d:86:25,18102547,382,-47,18102165,18102547
5712,6,6,1,2412,-57,-88,31,12:86:8c:5f:93:1e,18110202,332,7323,18109870,18110202
5713,6,6,1,2412,-89,-88,-1,e2:db:d1:d1:b0:4b,18118089,408,7479,18117681,18118089
5714,4,1,1,2412,-90,-88,-2,,18124141,304,5748,18123837,18124141
5715,4,11,1,2412,-86,-88,2,48:dd:0c:90:e3:87,18126924,362,2421,18126562,18126924
5716,4,11,1,2412,-85,-88,3,48:dd:0c:90:e3:85,18127634,382,328,18127252,18127634
5717,6,6,1,2412,-57,-88,31,52:86:8c:5f:93:1e,18135552,332,7586,18135220,18135552
5718,4,1,1,2412,-79,-88,9,78:67:0e:c4:a8:42,18141906,848,5506,18141058,18141906
5719,6,24,1,2412,-87,-88,1,,18147294,28,5360,18147266,18147294
5720,6,24,1,2412,-85,-88,3,,18151079,28,3757,18151051,18151079
5721,6,6,1,2412,-88,-88,0,,18156794,44,5671,18156750,18156794
5722,6,6,1,2412,-87,-88,1,,18157892,44,1054,18157848,18157892
5723,6,6,1,2412,-57,-88,31,32:86:8c:5f:93:1e,18158257,332,33,18157925,18158257
5724,6,24,1,2412,-85,-88,3,,18163657,28,5372,18163629,18163657
5725,4,1,1,2412,-44,-88,44,b0:e4:d5:32:ec:8a,18179571,1960,13954,18177611,18179571
5726,4,1,1,2412,-93,-88,-5,bc:98:df:ff:0f:8b,18183699,2568,1560,18181131,18183699
5727,4,1,1,2412,-92,-88,-4,bc:98:df:ff:0f:8b,18186296,1088,1509,18185208,18186296
5728,4,1,1,2412,-54,-88,34,94:a6:7e:c9:98:67,18188392,2464,-368,18185928,18188392
5729,4,1,1,2412,-92,-88,-4,bc:98:df:ff:0f:8b,18191340,976,1972,18190364,18191340
5730,4,1,1,2412,-92,-88,-4,bc:98:df:ff:0f:8b,18192326,976,10,18191350,18192326
5731,6,6,1,2412,-60,-88,28,10:86:8c:5f:93:1e,18193414,344,744,18193070,18193414
5732,6,24,1,2412,-87,-88,1,,18200548,28,7106,18200520,18200548
5733,4,11,1,2412,-78,-88,10,48:dd:0c:7d:86:27,18204286,362,3376,18203924,18204286
5734,4,11,1,2412,-76,-88,12,48:dd:0c:7d:86:23,18204661,323,52,18204338,18204661
5735,4,11,1,2412,-80,-88,8,48:dd:0c:7d:86:25,18204996,382,-47,18204614,18204996
5736,6,24,1,2412,-86,-88,2,,18205968,28,944,18205940,18205968
5737,6,6,1,2412,-61,-88,27,12:86:8c:5f:93:1e,18209159,332,2859,18208827,18209159
5738,4,11,1,2412,-85,-88,3,4c:01:43:ec:a0:69,18227946,361,18426,18227585,18227946
5739,4,11,1,2412,-84,-88,4,4c:01:43:ec:a0:63,18228320,322,52,18227998,18228320
5740,4,11,1,2412,-87,-88,1,4c:01:43:ec:a0:66,18228654,387,-53,18228267,18228654
5741,4,11,1,2412,-83,-88,5,48:dd:0c:90:e3:87,18229323,362,307,18228961,18229323
5742,4,11,1,2412,-84,-88,4,48:dd:0c:90:e3:83,18229698,323,52,18229375,18229698
5743,4,11,1,2412,-83,-88,5,48:dd:0c:90:e3:85,18230033,382,-47,18229651,18230033
5744,6,6,1,2412,-83,-88,5,,18251213,44,21136,18251169,18251213
5745,6,6,1,2412,-59,-88,29,32:86:8c:5f:93:1e,18273728,332,22183,18273396,18273728
5746,4,1,1,2412,-84,-88,4,78:67:0e:c4:a8:42,18278283,352,4203,18277931,18278283
5747,4,1,1,2412,-65,-88,23,b0:e4:d5:32:ec:8a,18281971,1960,1728,18280011,18281971
5748,6,6,1,2412,-61,-88,27,10:86:8c:5f:93:1e,18287262,344,4947,18286918,18287262
5749,4,1,1,2412,-55,-88,33,94:a6:7e:c9:98:67,18289033,2464,-693,18286569,18289033
5750,4,11,1,2412,-87,-88,1,4c:01:43:d7:f3:23,18292594,322,3239,18292272,18292594
5751,4,11,1,2412,-89,-88,-1,4c:01:43:d7:f3:26,18292929,387,-52,18292542,18292929
5752,4,1,1,2412,-89,-88,-1,00:26:62:eb:ea:74,18300340,872,6539,18299468,18300340
5753,4,1,1,2412,-90,-88,-2,00:26:62:eb:ea:74,18301333,872,121,18300461,18301333
5754,4,11,1,2412,-74,-88,14,48:dd:0c:7d:86:27,18307621,362,5926,18307259,18307621
5755,4,11,1,2412,-75,-88,13,48:dd:0c:7d:86:23,18307996,323,52,18307673,18307996
5756,4,11,1,2412,-77,-88,11,48:dd:0c:7d:86:25,18308331,382,-47,18307949,18308331
5757,6,24,1,2412,-85,-88,3,,18311087,28,2728,18311059,18311087
5758,6,6,1,2412,-60,-88,28,12:86:8c:5f:93:1e,18315788,332,4369,18315456,18315788
5759,6,24,1,2412,-85,-88,3,,18317279,28,1463,18317251,18317279
5760,6,6,1,2412,-87,-88,1,e2:db:d1:d1:b0:4a,18326020,632,8109,18325388,18326020
5761,4,1,1,2412,-92,-88,-4,00:26:62:eb:ea:74,18327824,968,836,18326856,18327824
5762,4,11,1,2412,-88,-88,0,4c:01:43:ec:a0:69,18330345,361,2160,18329984,18330345
5763,4,11,1,2412,-90,-88,-2,4c:01:43:ec:a0:63,18330719,322,52,18330397,18330719
5764,4,11,1,2412,-89,-88,-1,4c:01:43:ec:a0:66,18331053,387,-53,18330666,18331053
5765,4,11,1,2412,-84,-88,4,48:dd:0c:90:e3:87,18331723,362,308,18331361,18331723
5766,4,11,1,2412,-83,-88,5,48:dd:0c:90:e3:83,18332098,323,52,18331775,18332098
5767,4,11,1,2412,-84,-88,4,48:dd:0c:90:e3:85,18332433,382,-47,18332051,18332433
5768,4,11,1,2412,-83,-88,5,48:dd:0c:90:e3:83,18351937,254,19250,18351683,18351937
5769,6,24,1,2412,-85,-88,3,,18352667,28,702,18352639,18352667
5770,6,6,1,2412,-60,-88,28,32:86:8c:5f:93:1e,18362852,332,9853,18362520,18362852
5771,6,6,1,2412,-87,-88,1,,18374789,44,11893,18374745,18374789
5772,6,6,1,2412,-88,-88,0,,18375629,44,796,18375585,18375629
5773,6,6,1,2412,-87,-88,1,,18376954,44,1281,18376910,18376954
5774,6,6,1,2412,-88,-88,0,,18380301,44,3303,18380257,18380301
5775,4,1,1,2412,-68,-88,20,b0:e4:d5:32:ec:8a,18384370,1960,2109,18382410,18384370
5776,4,1,1,2412,-87,-88,1,bc:98:df:ff:0f:8b,18388494,2568,1556,18385926,18388494
5777,6,24,1,2412,-84,-88,4,,18391089,28,2567,18391061,18391089
5778,4,1,1,2412,-62,-88,26,94:a6:7e:c9:98:67,18391416,2464,-2137,18388952,18391416
5779,6,6,1,2412,-58,-88,30,10:86:8c:5f:93:1e,18393736,344,1976,18393392,18393736
5780,6,24,1,2412,-82,-88,6,,18403888,28,10124,18403860,18403888
5781,4,11,1,2412,-80,-88,8,48:dd:0c:7d:86:23,18409413,323,5202,18409090,18409413
5782,4,11,1,2412,-81,-88,7,48:dd:0c:7d:86:25,18409748,382,-47,18409366,18409748
5783,6,6,1,2412,-58,-88,30,12:86:8c:5f:93:1e,18413960,332,3880,18413628,18413960
5784,6,6,1,2412,-87,-88,1,e2:db:d1:d1:b0:4a,18424837,444,10433,18424393,18424837
5785,6,6,1,2412,-86,-88,2,e2:db:d1:d1:b0:4b,18425305,408,60,18424897,18425305
5786,6,6,1,2412,-86,-88,2,e2:db:d1:d1:b0:4d,18425764,408,51,18425356,18425764
5787,6,6,1,2412,-86,-88,2,e2:db:d1:d1:b0:4f,18426196,408,24,18425788,18426196
5788,6,6,1,2412,-87,-88,1,e2:db:d1:d1:b0:4a,18426681,224,261,18426457,18426681
5789,6,6,1,2412,-88,-88,0,e2:db:d1:d1:b0:4a,18426983,248,54,18426735,18426983
5790,4,1,1,2412,-79,-88,9,38:01:46:30:1a:ca,18427729,416,330,18427313,18427729
5791,6,6,1,2412,-86,-88,2,,18429910,44,2137,18429866,18429910
5792,6,6,1,2412,-86,-88,2,,18431226,44,1272,18431182,18431226
5793,4,11,1,2412,-85,-88,3,4c:01:43:ec:a0:66,18433487,387,1874,18433100,18433487
5794,6,24,1,2412,-86,-88,2,,18449148,28,15633,18449120,18449148
5795,6,24,1,2412,-85,-88,3,,18456954,28,7778,18456926,18456954
5796,6,6,1,2412,-58,-88,30,32:86:8c:5f:93:1e,18465161,332,7875,18464829,18465161
5797,6,6,1,2412,-87,-88,1,3c:bd:c5:ee:96:6d,18480592,68,15363,18480524,18480592
5798,6,6,1,2412,-88,-88,0,,18482815,44,2179,18482771,18482815
5799,6,6,1,2412,-86,-88,2,,18485113,44,2254,18485069,18485113
5800,4,1,1,2412,-68,-88,20,b0:e4:d5:32:ec:8a,18486769,1960,-304,18484809,18486769
5801,4,1,1,2412,-89,-88,-1,bc:98:df:ff:0f:8b,18490885,2568,1548,18488317,18490885
5802,4,1,1,2412,-62,-88,26,94:a6:7e:c9:98:67,18493772,2464,423,18491308,18493772
5803,4,11,1,2412,-84,-88,4,4c:01:43:d7:f3:29,18497019,362,2885,18496657,18497019
5804,4,11,1,2412,-87,-88,1,4c:01:43:d7:f3:23,18497393,322,52,18497071,18497393
5805,4,11,1,2412,-86,-88,2,4c:01:43:d7:f3:26,18497728,387,-52,18497341,18497728
5806,6,24,1,2412,-89,-88,-1,,18501032,28,3276,18501004,18501032
5807,6,6,1,2412,-59,-88,29,10:86:8c:5f:93:1e,18508309,344,6933,18507965,18508309
5808,4,11,1,2412,-82,-88,6,48:dd:0c:7d:86:27,18511604,362,2933,18511242,18511604
5809,4,11,1,2412,-78,-88,10,48:dd:0c:7d:86:25,18512314,382,328,18511932,18512314
5810,6,6,1,2412,-88,-88,0,40:b0:34:b7:01:d5,18514673,576,1783,18514097,18514673
5811,6,6,1,2412,-59,-88,29,12:86:8c:5f:93:1e,18516361,332,1356,18516029,18516361
5812,4,1,1,2412,-91,-88,-3,70:3a:cb:63:35:b2,18516886,2216,-1691,18514670,18516886
5813,6,6,1,2412,-90,-88,-2,e2:db:d1:d1:b0:4f,18528584,408,11290,18528176,18528584
5814,6,6,1,2412,-90,-88,-2,e2:db:d1:d1:b0:4a,18529025,1332,-891,18527693,18529025
5815,6,6,1,2412,-90,-88,-2,e2:db:d1:d1:b0:4a,18530390,1360,5,18529030,18530390
5816,6,6,1,2412,-88,-88,0,,18532010,44,1576,18531966,18532010
5817,4,11,1,2412,-86,-88,2,4c:01:43:ec:a0:66,18535851,387,3454,18535464,18535851
5818,4,11,1,2412,-84,-88,4,48:dd:0c:90:e3:87,18536523,362,310,18536161,18536523
5819,4,11,1,2412,-84,-88,4,48:dd:0c:90:e3:83,18536897,323,51,18536574,18536897
5820,4,11,1,2412,-85,-88,3,48:dd:0c:90:e3:85,18537232,382,-47,18536850,18537232
5821,4,1,1,2412,-83,-88,5,,18546110,304,8574,18545806,18546110
5822,6,6,1,2412,-88,-88,0,,18546637,44,483,18546593,18546637
5823,6,6,1,2412,-59,-88,29,52:86:8c:5f:93:1e,18546961,332,-8,18546629,18546961
5824,4,1,1,2412,-89,-88,-1,78:67:0e:c4:a8:42,18548723,2736,-974,18545987,18548723
5825,6,6,1,2412,-89,-88,-1,e2:db:d1:d1:b0:4a,18556737,68,7946,18556669,18556737
5826,6,24,1,2412,-85,-88,3,,18564820,28,8055,18564792,18564820
5827,6,6,1,2412,-59,-88,29,32:86:8c:5f:93:1e,18567629,332,2477,18567297,18567629
5828,4,1,1,2412,-90,-88,-2,78:67:0e:c4:a8:42,18568871,352,890,18568519,18568871
5829,4,1,1,2412,-83,-88,5,,18570982,304,1807,18570678,18570982
5830,4,1,1,2412,-69,-88,19,b0:e4:d5:32:ec:8a,18589168,1960,16226,18587208,18589168
5831,4,11,1,2412,-88,-88,0,4c:01:43:d7:f3:29,18599418,362,9888,18599056,18599418
5832,4,11,1,2412,-87,-88,1,4c:01:43:d7:f3:23,18599793,322,53,18599471,18599793
5833,4,11,1,2412,-85,-88,3,4c:01:43:d7:f3:26,18600127,387,-53,18599740,18600127
5834,6,6,1,2412,-89,-88,-1,,18608213,44,8042,18608169,18608213
5835,4,1,1,2412,-83,-88,5,78:67:0e:38:6c:d3,18611080,2736,131,18608344,18611080
5836,4,11,1,2412,-75,-88,13,48:dd:0c:7d:86:27,18613839,362,2397,18613477,18613839
5837,4,11,1,2412,-74,-88,14,48:dd:0c:7d:86:23,18614213,323,51,18613890,18614213
5838,6,6,1,2412,-59,-88,29,12:86:8c:5f:93:1e,18618762,332,4217,18618430,18618762
5839,4,1,1,2412,-90,-88,-2,78:67:0e:c4:a8:42,18632506,352,13392,18632154,18632506
5840,4,11,1,2412,-89,-88,-1,4c:01:43:ec:a0:69,18637542,361,4675,18637181,18637542
5841,4,11,1,2412,-86,-88,2,4c:01:43:ec:a0:63,18637915,322,51,18637593,18637915
5842,4,11,1,2412,-84,-88,4,48:dd:0c:90:e3:87,18638923,362,646,18638561,18638923
5843,4,11,1,2412,-76,-88,12,48:dd:0c:90:e3:83,18639297,323,51,18638974,18639297
5844,4,11,1,2412,-86,-88,2,48:dd:0c:90:e3:85,18639632,382,-47,18639250,18639632
5845,4,1,1,2412,-88,-88,0,78:67:0e:c4:a8:42,18651123,2736,8755,18648387,18651123
5846,4,11,1,2412,-86,-88,2,4c:01:43:d7:f3:23,18675860,277,24460,18675583,18675860
5847,4,11,1,2412,-87,-88,1,4c:01:43:ec:a0:63,18676332,284,188,18676048,18676332
5848,4,1,1,2412,-70,-88,18,b0:e4:d5:32:ec:8a,18691575,1960,13283,18689615,18691575
5849,4,1,1,2412,-89,-88,-1,bc:98:df:ff:0f:8b,18695678,2568,1535,18693110,18695678
5850,4,1,1,2412,-52,-88,36,94:a6:7e:c9:98:67,18698556,2464,414,18696092,18698556
5851,6,24,1,2412,-84,-88,4,,18700888,28,2304,18700860,18700888
5852,4,11,1,2412,-86,-88,2,4c:01:43:d7:f3:29,18701818,362,568,18701456,18701818
5853,6,6,1,2412,-60,-88,28,,18718160,44,16298,18718116,18718160
5854,4,1,1,2412,-92,-88,-4,d8:9c:8e:01:4c:6a,18726297,3000,5137,18723297,18726297
5855,6,6,1,2412,-87,-88,1,e2:db:d1:d1:b0:4a,18732021,444,5280,18731577,18732021
5856,4,1,1,2412,-59,-88,29,76:70:82:5b:67:2c,18733309,1296,-8,18732013,18733309
5857,4,1,1,2412,-60,-88,28,46:42:f8:b8:eb:07,18735094,1160,625,18733934,18735094
5858,4,11,1,2412,-79,-88,9,48:dd:0c:7d:86:23,18736350,254,1002,18736096,18736350
5859,4,1,1,2412,-60,-88,28,06:b6:f8:1c:58:70,18736771,1128,-707,18735643,18736771
5860,4,1,1,2412,-54,-88,34,94:a6:7e:c9:98:67,18737948,3072,-1895,18734876,18737948
5861,4,1,1,2412,-73,-88,15,,18746363,304,8111,18746059,18746363
5862,4,1,1,2412,-56,-88,32,94:a6:7e:c9:98:67,18748429,3072,-1006,18745357,18748429
5863,4,1,1,2412,-65,-88,23,,18751513,304,2780,18751209,18751513
5864,4,1,1,2412,-62,-88,26,10:86:8c:5f:93:1e,18752307,3088,-2294,18749219,18752307
5865,6,6,1,2412,-61,-88,27,52:86:8c:5f:93:1e,18755306,332,2667,18754974,18755306
5866,4,1,1,2412,-63,-88,25,10:86:8c:5f:93:1e,18761979,3088,3585,18758891,18761979
5867,4,1,1,2412,-64,-88,24,46:42:f8:b8:eb:07,18766595,1160,3456,18765435,18766595
5868,4,1,1,2412,-65,-88,23,06:b6:f8:1c:58:70,18768057,1128,334,18766929,18768057
5869,4,1,1,2412,-60,-88,28,94:a6:7e:c9:98:67,18769216,3072,-1913,18766144,18769216
5870,6,6,1,2412,-61,-88,27,32:86:8c:5f:93:1e,18774567,332,5019,18774235,18774567
5871,4,1,1,2412,-87,-88,1,b0:e4:d5:32:ec:8a,18775111,1912,-1368,18773199,18775111
5872,4,1,1,2412,-87,-88,1,78:67:0e:c4:a8:42,18785949,3472,7366,18782477,18785949
5873,6,24,1,2412,-86,-88,2,,18792320,28,6343,18792292,18792320
5874,4,1,1,2412,-70,-88,18,b0:e4:d5:32:ec:8a,18793967,1960,-313,18792007,18793967
5875,4,1,1,2412,-90,-88,-2,bc:98:df:ff:0f:8b,18798079,2568,1544,18795511,18798079
5876,4,1,1,2412,-68,-88,20,94:a6:7e:c9:98:67,18800948,2464,405,18798484,18800948
5877,4,11,1,2412,-87,-88,1,4c:01:43:d7:f3:29,18804217,362,2907,18803855,18804217
5878,4,11,1,2412,-87,-88,1,4c:01:43:d7:f3:23,18804592,322,53,18804270,18804592
5879,6,24,1,2412,-86,-88,2,,18808441,28,3821,18808413,18808441
5880,6,6,1,2412,-63,-88,25,10:86:8c:5f:93:1e,18808955,344,170,18808611,18808955
5881,6,6,1,2412,-87,-88,1,,18812312,44,3313,18812268,18812312
5882,4,1,1,2412,-86,-88,2,78:67:0e:38:6c:d3,18815880,2736,832,18813144,18815880
5883,4,11,1,2412,-78,-88,10,48:dd:0c:7d:86:27,18818639,362,2397,18818277,18818639
5884,4,11,1,2412,-77,-88,11,48:dd:0c:7d:86:23,18819014,323,52,18818691,18819014
5885,4,11,1,2412,-87,-88,1,4c:01:43:d7:f3:23,18819835,284,537,18819551,18819835
5886,6,6,1,2412,-63,-88,25,12:86:8c:5f:93:1e,18826572,332,6405,18826240,18826572
5887,6,6,1,2412,-85,-88,3,e2:db:d1:d1:b0:4a,18834431,444,7415,18833987,18834431
5888,6,6,1,2412,-84,-88,4,e2:db:d1:d1:b0:4b,18834899,408,60,18834491,18834899
5889,6,6,1,2412,-85,-88,3,e2:db:d1:d1:b0:4d,18835340,408,33,18834932,18835340
5890,6,6,1,2412,-86,-88,2,e2:db:d1:d1:b0:4f,18835798,408,50,18835390,18835798
5891,6,6,1,2412,-86,-88,2,,18837232,44,1390,18837188,18837232
5892,4,11,1,2412,-86,-88,2,4c:01:43:ec:a0:69,18842339,361,4746,18841978,18842339
5893,4,11,1,2412,-84,-88,4,4c:01:43:ec:a0:63,18842713,322,52,18842391,18842713
5894,4,11,1,2412,-86,-88,2,4c:01:43:ec:a0:66,18843048,387,-52,18842661,18843048
5895,4,11,1,2412,-87,-88,1,48:dd:0c:90:e3:87,18843722,362,312,18843360,18843722
5896,4,11,1,2412,-87,-88,1,48:dd:0c:90:e3:83,18844096,323,51,18843773,18844096
5897,4,1,1,2412,-84,-88,4,3c:bd:c5:ee:96:6d,18849356,2512,2748,18846844,18849356
5898,6,6,1,2412,-65,-88,23,52:86:8c:5f:93:1e,18851957,332,2269,18851625,18851957
5899,4,1,1,2412,-86,-88,2,78:67:0e:c4:a8:42,18855936,2736,1243,18853200,18855936
5900,6,24,1,2412,-88,-88,0,,18871090,28,15126,18871062,18871090
5901,6,6,1,2412,-65,-88,23,32:86:8c:5f:93:1e,18874764,332,3342,18874432,18874764
5902,6,24,1,2412,-87,-88,1,,18883668,28,8876,18883640,18883668
5903,6,6,1,2412,-63,-88,25,,18890857,44,7145,18890813,18890857
5904,4,1,1,2412,-61,-88,27,b0:e4:d5:32:ec:8a,18896366,1960,3549,18894406,18896366
5905,6,24,1,2412,-87,-88,1,,18898752,28,2358,18898724,18898752
5906,4,1,1,2412,-54,-88,34,94:a6:7e:c9:98:67,18903353,2464,2137,18900889,18903353
5907,6,6,1,2412,-63,-88,25,10:86:8c:5f:93:1e,18905818,344,2121,18905474,18905818
5908,4,1,1,2412,-62,-88,26,fe:e8:5a:97:f0:61,18910427,1296,3313,18909131,18910427
5909,4,1,1,2412,-62,-88,26,96:fb:c1:27:38:91,18911782,1160,195,18910622,18911782
5910,4,1,1,2412,-62,-88,26,32:d5:c8:53:62:c4,18913239,1128,329,18912111,18913239
5911,4,1,1,2412,-65,-88,23,10:86:8c:5f:93:1e,18915080,3088,-1247,18911992,18915080
5912,4,1,1,2412,-63,-88,25,10:86:8c:5f:93:1e,18918286,3088,118,18915198,18918286
5913,4,11,1,2412,-81,-88,7,48:dd:0c:7d:86:27,18921710,362,3062,18921348,18921710
5914,4,11,1,2412,-80,-88,8,48:dd:0c:7d:86:23,18922085,323,52,18921762,18922085
5915,6,6,1,2412,-84,-88,4,,18924442,44,2313,18924398,18924442
5916,4,1,1,2412,-61,-88,27,10:86:8c:5f:93:1e,18924670,3088,-2860,18921582,18924670
5917,6,6,1,2412,-63,-88,25,12:86:8c:5f:93:1e,18928012,332,3010,18927680,18928012
5918,4,1,1,2412,-66,-88,22,10:86:8c:5f:93:1e,18928931,3088,-2169,18925843,18928931
5919,4,1,1,2412,-67,-88,21,96:fb:c1:27:38:91,18934166,1160,4075,18933006,18934166
5920,6,6,1,2412,-56,-88,32,b4:e6:2d:b4:ff:71,18937251,64,3021,18937187,18937251
5921,6,6,1,2412,-56,-88,32,b4:e6:2d:b4:ff:71,18937656,64,341,18937592,18937656
5922,4,1,1,2412,-57,-88,31,b4:e6:2d:b4:ff:71,18938019,416,-53,18937603,18938019
5923,4,1,1,2412,-59,-88,29,b4:e6:2d:b4:ff:71,18938587,416,152,18938171,18938587
5924,4,1,1,2412,-65,-88,23,,18939013,304,122,18938709,18939013
5925,4,11,1,2412,-85,-88,3,4c:01:43:ec:a0:69,18944738,361,5364,18944377,18944738
5926,4,11,1,2412,-83,-88,5,4c:01:43:ec:a0:63,18945112,322,52,18944790,18945112
5927,4,11,1,2412,-83,-88,5,4c:01:43:ec:a0:66,18945446,387,-53,18945059,18945446
5928,4,11,1,2412,-84,-88,4,48:dd:0c:90:e3:87,18946122,362,314,18945760,18946122
5929,4,11,1,2412,-83,-88,5,48:dd:0c:90:e3:83,18946496,323,51,18946173,18946496
5930,4,11,1,2412,-85,-88,3,48:dd:0c:90:e3:85,18946831,382,-47,18946449,18946831
5931,4,1,1,2412,-87,-88,1,3c:bd:c5:ee:96:6d,18951793,2512,2450,18949281,18951793
5932,6,6,1,2412,-65,-88,23,52:86:8c:5f:93:1e,18963241,332,11116,18962909,18963241
5933,4,1,1,2412,-60,-88,28,f6:50:63:e1:1b:0a,18977220,1128,12851,18976092,18977220
5934,4,1,1,2412,-56,-88,32,94:a6:7e:c9:98:67,18978379,3072,-1913,18975307,18978379
5935,4,1,1,2412,-54,-88,34,94:a6:7e:c9:98:67,18981788,3072,337,18978716,18981788
5936,4,1,1,2412,-54,-88,34,94:a6:7e:c9:98:67,18988739,3072,3879,18985667,18988739
5937,4,1,1,2412,-63,-88,25,,18991823,304,2780,18991519,18991823
5938,4,1,1,2412,-65,-88,23,10:86:8c:5f:93:1e,18992165,3088,-2746,18989077,18992165
5939,4,1,1,2412,-70,-88,18,b0:e4:d5:32:ec:8a,18998765,1960,4640,18996805,18998765
5940,4,1,1,2412,-54,-88,34,94:a6:7e:c9:98:67,19005766,2464,4537,19003302,19005766
5941,4,11,1,2412,-88,-88,0,4c:01:43:d7:f3:29,19009016,362,2888,19008654,19009016
5942,4,11,1,2412,-77,-88,11,4c:01:43:d7:f3:23,19009391,322,53,19009069,19009391
5943,4,11,1,2412,-78,-91,13,48:dd:0c:7d:86:23,19023815,323,14101,19023492,19023815
5944,6,6,1,2412,-63,-91,28,12:86:8c:5f:93:1e,19028570,332,4423,19028238,19028570
5945,4,11,1,2412,-86,-91,5,48:dd:0c:90:e3:85,19049231,382,20279,19048849,19049231
5946,4,1,1,2412,-92,-91,-1,3c:bd:c5:ee:96:6d,19054155,2512,2412,19051643,19054155
5947,6,6,1,2412,-62,-91,29,52:86:8c:5f:93:1e,19056590,332,2103,19056258,19056590
5948,4,11,1,2412,-81,-91,10,48:dd:0c:7d:86:23,19071774,254,14930,19071520,19071774
5949,6,6,1,2412,-61,-91,30,32:86:8c:5f:93:1e,19080375,332,8269,19080043,19080375
5950,6,6,1,2412,-62,-91,29,b4:e6:2d:b4:ff:71,19091430,64,10991,19091366,19091430
5951,6,6,1,2412,-60,-91,31,,19091510,44,36,19091466,19091510
5952,4,1,1,2412,-69,-91,22,b0:e4:d5:32:ec:8a,19101165,1960,7695,19099205,19101165
5953,6,24,1,2412,-83,-91,8,,19105089,28,3896,19105061,19105089
5954,6,6,1,2412,-60,-91,31,10:86:8c:5f:93:1e,19105364,344,-69,19105020,19105364
5955,4,1,1,2412,-56,-91,35,94:a6:7e:c9:98:67,19108341,2464,513,19105877,19108341
5956,4,1,1,2412,-91,-91,0,78:67:0e:c4:a8:42,19116033,352,7340,19115681,19116033
5957,4,11,1,2412,-80,-91,11,48:dd:0c:7d:86:27,19125840,362,9445,19125478,19125840
5958,4,11,1,2412,-80,-91,11,48:dd:0c:7d:86:23,19126214,323,51,19125891,19126214
5959,4,11,1,2412,-80,-91,11,48:dd:0c:7d:86:25,19126550,382,-46,19126168,19126550
5960,6,6,1,2412,-59,-91,32,12:86:8c:5f:93:1e,19130765,332,3883,19130433,19130765
5961,4,1,1,2412,-91,-91,0,70:3a:cb:63:35:b2,19131290,2216,-1691,19129074,19131290
5962,4,1,1,2412,-89,-91,2,78:67:0e:c4:a8:42,19137072,352,5430,19136720,19137072
5963,6,6,1,2412,-60,-91,31,b4:e6:2d:b4:ff:71,19137317,64,181,19137253,19137317
5964,6,6,1,2412,-60,-91,31,b4:e6:2d:b4:ff:71,19138461,64,1080,19138397,19138461
5965,6,6,1,2412,-60,-91,31,b4:e6:2d:b4:ff:71,19138686,64,161,19138622,19138686
5966,6,6,1,2412,-60,-91,31,b4:e6:2d:b4:ff:71,19138857,64,107,19138793,19138857
5967,6,6,1,2412,-60,-91,31,b4:e6:2d:b4:ff:71,19139037,64,116,19138973,19139037
5968,6,6,1,2412,-60,-91,31,b4:e6:2d:b4:ff:71,19139199,64,98,19139135,19139199
5969,4,1,1,2412,-61,-91,30,b4:e6:2d:b4:ff:71,19139552,416,-63,19139136,19139552
5970,4,1,1,2412,-58,-91,33,,19139979,304,123,19139675,19139979
5971,4,11,1,2412,-82,-91,9,48:dd:0c:90:e3:87,19150921,362,10580,19150559,19150921
5972,4,11,1,2412,-83,-91,8,48:dd:0c:90:e3:83,19151296,323,52,19150973,19151296
5973,4,11,1,2412,-82,-91,9,48:dd:0c:90:e3:85,19151631,382,-47,19151249,19151631
5974,4,1,1,2412,-91,-91,0,,19152901,304,966,19152597,19152901
5975,6,24,1,2412,-83,-91,8,,19154467,28,1538,19154439,19154467
5976,4,1,1,2412,-92,-91,-1,3c:bd:c5:ee:96:6d,19156552,2512,-427,19154040,19156552
5977,6,6,1,2412,-59,-91,32,52:86:8c:5f:93:1e,19158919,332,2035,19158587,19158919
5978,6,6,1,2412,-59,-91,32,32:86:8c:5f:93:1e,19182202,332,22951,19181870,19182202
5979,4,1,1,2412,-68,-91,23,b0:e4:d5:32:ec:8a,19203564,1960,19402,19201604,19203564
5980,6,6,1,2412,-58,-91,33,10:86:8c:5f:93:1e,19207846,344,3938,19207502,19207846
5981,4,1,1,2412,-51,-91,40,94:a6:7e:c9:98:67,19210563,2464,253,19208099,19210563
5982,4,1,1,2412,-91,-91,0,78:67:0e:c4:a8:42,19220931,3472,6896,19217459,19220931
5983,4,1,1,2412,-83,-91,8,,19224421,304,3186,19224117,19224421
5984,4,11,1,2412,-78,-91,13,48:dd:0c:7d:86:27,19225802,362,1019,19225440,19225802
5985,4,11,1,2412,-78,-91,13,48:dd:0c:7d:86:23,19226176,323,51,19225853,19226176
5986,4,11,1,2412,-78,-91,13,48:dd:0c:7d:86:25,19226511,382,-47,19226129,19226511
5987,6,6,1,2412,-58,-91,33,12:86:8c:5f:93:1e,19234735,332,7892,19234403,19234735
5988,4,1,1,2412,-83,-91,8,,19241274,304,6235,19240970,19241274
5989,6,6,1,2412,-86,-91,5,,19250692,44,9374,19250648,19250692
5990,4,11,1,2412,-82,-91,9,48:dd:0c:90:e3:87,19253321,362,2267,19252959,19253321
5991,4,11,1,2412,-82,-91,9,48:dd:0c:90:e3:85,19254031,382,328,19253649,19254031
5992,4,1,1,2412,-68,-91,23,b0:e4:d5:32:ec:8a,19261537,1912,5594,19259625,19261537
5993,4,11,1,2412,-77,-91,14,48:dd:0c:7d:86:25,19272400,377,10486,19272023,19272400
5994,4,11,1,2412,-77,-91,14,48:dd:0c:7d:86:25,19273395,377,618,19273018,19273395
5995,4,11,1,2412,-88,-91,3,,19274378,107,876,19274271,19274378
5996,4,1,1,2412,-89,-91,2,78:67:0e:c4:a8:42,19278137,352,3407,19277785,19278137
5997,4,1,1,2412,-82,-91,9,,19284641,304,6200,19284337,19284641
5998,6,6,1,2412,-66,-91,25,b4:e6:2d:b4:ff:71,19293873,64,9168,19293809,19293873
5999,6,6,1,2412,-60,-91,31,,19293953,44,36,19293909,19293953
6000,4,1,1,2412,-71,-91,20,3c:bd:c5:ee:96:6d,19298099,3280,866,19294819,19298099
6001,4,1,1,2412,-68,-91,23,b0:e4:d5:32:ec:8a,19305963,1960,5904,19304003,19305963
6002,4,1,1,2412,-54,-91,37,94:a6:7e:c9:98:67,19312949,2464,4522,19310485,19312949
6003,6,6,1,2412,-61,-91,30,10:86:8c:5f:93:1e,19315394,344,2101,19315050,19315394
6004,4,1,1,2412,-86,-91,5,78:67:0e:38:6c:d3,19327882,2736,9752,19325146,19327882
6005,4,11,1,2412,-79,-91,12,48:dd:0c:7d:86:27,19330640,362,2396,19330278,19330640
6006,4,11,1,2412,-79,-91,12,48:dd:0c:7d:86:23,19331015,323,52,19330692,19331015
6007,4,11,1,2412,-79,-91,12,48:dd:0c:7d:86:25,19331350,382,-47,19330968,19331350
6008,6,24,1,2412,-86,-91,5,,19332942,28,1564,19332914,19332942
6009,6,6,1,2412,-90,-91,1,40:b0:34:b7:01:d5,19333759,576,241,19333183,19333759
6010,6,6,1,2412,-61,-91,30,12:86:8c:5f:93:1e,19335567,332,1476,19335235,19335567
6011,4,11,1,2412,-78,-91,13,48:dd:0c:7d:86:25,19338355,377,2411,19337978,19338355
6012,4,11,1,2412,-79,-91,12,48:dd:0c:7d:86:25,19340577,377,1845,19340200,19340577
6013,4,11,1,2412,-75,-91,16,48:dd:0c:7d:86:25,19346145,377,5191,19345768,19346145
6014,4,1,1,2412,-85,-91,6,cc:95:d7:da:da:18,19352083,2232,3706,19349851,19352083
6015,4,11,1,2412,-90,-91,1,4c:01:43:ec:a0:66,19355042,387,2572,19354655,19355042
6016,4,11,1,2412,-83,-91,8,48:dd:0c:90:e3:87,19355721,362,317,19355359,19355721
6017,4,11,1,2412,-85,-91,6,48:dd:0c:90:e3:83,19356095,323,51,19355772,19356095
6018,4,11,1,2412,-85,-91,6,48:dd:0c:90:e3:85,19356430,382,-47,19356048,19356430
6019,6,6,1,2412,-61,-91,30,52:86:8c:5f:93:1e,19361167,332,4405,19360835,19361167
6020,4,1,1,2412,-90,-91,1,,19370652,304,9181,19370348,19370652
6021,4,1,1,2412,-87,-91,4,,19371912,304,956,19371608,19371912
6022,4,11,1,2412,-89,-91,2,,19372190,203,75,19371987,19372190
6023,4,1,1,2412,-91,-91,0,78:67:0e:c4:a8:42,19373737,352,1195,19373385,19373737
6024,4,11,1,2412,-91,-91,0,,19374734,107,890,19374627,19374734
6025,6,24,1,2412,-86,-91,5,78:67:0e:c4:a8:42,19374850,32,84,19374818,19374850
6026,6,6,1,2412,-62,-91,29,32:86:8c:5f:93:1e,19387095,332,11913,19386763,19387095
6027,6,24,1,2412,-87,-91,4,,19399416,28,12293,19399388,19399416
6028,4,1,1,2412,-68,-91,23,b0:e4:d5:32:ec:8a,19408362,1960,6986,19406402,19408362
6029,4,1,1,2412,-55,-91,36,94:a6:7e:c9:98:67,19417180,2464,6354,19414716,19417180
6030,4,1,1,2412,-64,-91,27,3c:06:30:47:83:74,19421396,416,3800,19420980,19421396
6031,4,1,1,2412,-56,-91,35,,19421825,304,125,19421521,19421825
6032,6,24,1,2412,-60,-91,31,94:a6:7e:c9:98:67,19422004,28,151,19421976,19422004
6033,6,24,1,2412,-64,-91,27,,19422048,28,16,19422020,19422048
6034,7,26,1,2412,-60,-91,31,94:a6:7e:c9:98:67,19422102,84,-30,19422018,19422102
6035,6,24,1,2412,-65,-91,26,3c:06:30:47:83:74,19422198,32,64,19422166,19422198
6036,6,6,1,2412,-63,-91,28,10:86:8c:5f:93:1e,19423929,344,1387,19423585,19423929
6037,6,6,1,2412,-87,-91,4,40:b0:34:b7:01:d5,19436161,576,11656,19435585,19436161
6038,4,1,1,2412,-65,-91,26,3c:06:30:47:83:74,19438645,416,2068,19438229,19438645
6039,4,1,1,2412,-58,-91,33,,19439073,304,124,19438769,19439073
6040,6,6,1,2412,-65,-91,26,12:86:8c:5f:93:1e,19441651,332,2246,19441319,19441651
6041,4,1,1,2412,-91,-91,0,00:26:62:eb:ea:74,19443478,968,859,19442510,19443478
6042,6,24,1,2412,-87,-91,4,,19444807,28,1301,19444779,19444807
6043,4,11,1,2412,-89,-91,2,4c:01:43:ec:a0:63,19457106,322,11977,19456784,19457106
6044,4,11,1,2412,-88,-91,3,4c:01:43:ec:a0:66,19457441,387,-52,19457054,19457441
6045,4,11,1,2412,-76,-91,15,48:dd:0c:90:e3:85,19458830,382,1007,19458448,19458830
6046,6,6,1,2412,-66,-91,25,52:86:8c:5f:93:1e,19466583,332,7421,19466251,19466583
6047,4,11,1,2412,-88,-91,3,4c:01:43:ec:a0:63,19467429,278,568,19467151,19467429
6048,4,1,1,2412,-92,-91,-1,78:67:0e:c4:a8:42,19470322,2736,157,19467586,19470322
6049,6,6,1,2412,-66,-91,25,32:86:8c:5f:93:1e,19489178,332,18524,19488846,19489178
6050,4,1,1,2412,-91,-91,0,,19498753,304,9271,19498449,19498753
6051,4,1,1,2412,-67,-91,24,b0:e4:d5:32:ec:8a,19510822,1960,10109,19508862,19510822
6052,4,1,1,2412,-56,-91,35,94:a6:7e:c9:98:67,19517816,2464,4530,19515352,19517816
6053,6,6,1,2412,-68,-91,23,10:86:8c:5f:93:1e,19520136,344,1976,19519792,19520136
6054,6,24,1,2412,-86,-91,5,,19528835,28,8671,19528807,19528835
6055,4,11,1,2412,-77,-91,14,48:dd:0c:7d:86:27,19535441,362,6244,19535079,19535441
6056,4,11,1,2412,-77,-91,14,48:dd:0c:7d:86:23,19535816,323,52,19535493,19535816
6057,4,11,1,2412,-77,-91,14,48:dd:0c:7d:86:25,19536151,382,-47,19535769,19536151
6058,6,6,1,2412,-87,-91,4,,19537966,44,1771,19537922,19537966
6059,6,24,1,2412,-85,-91,6,,19538384,28,390,19538356,19538384
6060,4,1,1,2412,-90,-91,1,,19541861,304,3173,19541557,19541861
6061,6,6,1,2412,-67,-91,24,12:86:8c:5f:93:1e,19544715,332,2522,19544383,19544715
6062,4,11,1,2412,-84,-91,7,48:dd:0c:90:e3:87,19560520,362,15443,19560158,19560520
6063,4,11,1,2412,-82,-91,9,48:dd:0c:90:e3:85,19561230,382,328,19560848,19561230
6064,4,1,1,2412,-91,-91,0,3c:bd:c5:ee:96:6d,19568748,976,6542,19567772,19568748
6065,4,1,1,2412,-90,-91,1,78:67:0e:c4:a8:42,19572809,2736,1325,19570073,19572809
6066,6,6,1,2412,-87,-91,4,,19575965,44,3112,19575921,19575965
6067,4,11,1,2412,-90,-91,1,,19576452,203,284,19576249,19576452
6068,6,24,1,2412,-88,-91,3,,19591107,28,14627,19591079,19591107
6069,6,6,1,2412,-63,-91,28,32:86:8c:5f:93:1e,19591767,332,328,19591435,19591767
6070,4,1,1,2412,-71,-91,20,c0:8d:51:da:5c:ef,19594586,416,2403,19594170,19594586
6071,4,1,1,2412,-64,-91,27,,19595013,304,123,19594709,19595013
6072,4,1,1,2412,-87,-91,4,,19599290,304,3973,19598986,19599290
6073,4,1,1,2412,-71,-91,20,b0:e4:d5:32:ec:8a,19613161,1960,11911,19611201,19613161
6074,4,1,1,2412,-54,-91,37,94:a6:7e:c9:98:67,19620150,2464,4525,19617686,19620150
6075,4,1,1,2412,-85,-91,6,,19626264,304,5810,19625960,19626264
6076,4,11,1,2412,-86,-91,5,4c:01:43:ec:a0:63,19632865,254,6347,19632611,19632865
6077,4,11,1,2412,-73,-91,18,4c:01:43:d7:f3:23,19634007,254,888,19633753,19634007
6078,4,1,1,2412,-85,-91,6,78:67:0e:38:6c:d3,19635082,2736,-1661,19632346,19635082
6079,4,11,1,2412,-73,-91,18,48:dd:0c:7d:86:27,19641660,362,6216,19641298,19641660
6080,4,11,1,2412,-73,-91,18,48:dd:0c:7d:86:23,19642034,323,51,19641711,19642034
6081,4,11,1,2412,-74,-91,17,48:dd:0c:7d:86:25,19642370,382,-46,19641988,19642370
6082,6,6,1,2412,-62,-91,29,12:86:8c:5f:93:1e,19654515,332,11813,19654183,19654515
6083,4,11,1,2412,-87,-91,4,4c:01:43:ec:a0:69,19661530,361,6654,19661169,19661530
6084,4,11,1,2412,-87,-91,4,4c:01:43:ec:a0:63,19661904,322,52,19661582,19661904
6085,4,11,1,2412,-87,-91,4,4c:01:43:ec:a0:66,19662238,387,-53,19661851,19662238
6086,4,11,1,2412,-83,-91,8,48:dd:0c:90:e3:87,19662920,362,320,19662558,19662920
6087,4,11,1,2412,-83,-91,8,48:dd:0c:90:e3:83,19663294,323,51,19662971,19663294
6088,4,11,1,2412,-82,-91,9,48:dd:0c:90:e3:85,19663630,382,-46,19663248,19663630
6089,4,1,1,2412,-83,-91,8,78:67:0e:c4:a8:42,19677912,832,13450,19677080,19677912
6090,6,6,1,2412,-61,-91,30,52:86:8c:5f:93:1e,19679667,332,1423,19679335,19679667
6091,4,1,1,2412,-91,-91,0,bc:98:df:ff:0f:8b,19688615,3176,5772,19685439,19688615
6092,6,24,1,2412,-67,-91,24,0a:83:14:5e:8f:39,19691718,28,3075,19691690,19691718
6093,6,24,1,2412,-67,-91,24,0a:83:14:5e:8f:39,19691835,32,85,19691803,19691835
6094,6,24,1,2412,-54,-91,37,,19691885,28,22,19691857,19691885
6095,6,24,1,2412,-67,-91,24,0a:83:14:5e:8f:39,19691983,28,70,19691955,19691983
6096,6,24,1,2412,-56,-91,35,,19692030,28,19,19692002,19692030
6097,7,72.2222,1,2412,-67,-91,24,0a:83:14:5e:8f:39,19692082,47,5,19692035,19692082
6098,6,24,1,2412,-55,-91,36,94:a6:7e:c9:98:67,19692140,32,26,19692108,19692140
6099,6,6,1,2412,-60,-91,31,32:86:8c:5f:93:1e,19695465,332,2993,19695133,19695465
6100,7,65,1,2412,-55,-91,36,94:a6:7e:c9:98:67,19703581,48,8068,19703533,19703581
6101,6,24,1,2412,-68,-91,23,,19703638,28,29,19703610,19703638
6102,6,24,1,2412,-86,-91,5,,19711204,28,7538,19711176,19711204
6103,4,1,1,2412,-69,-91,22,b0:e4:d5:32:ec:8a,19715560,1960,2396,19713600,19715560
6104,4,1,1,2412,-50,-91,41,94:a6:7e:c9:98:67,19722563,2464,4539,19720099,19722563
6105,6,24,1,2412,-68,-91,23,0a:83:14:5e:8f:39,19724913,32,2318,19724881,19724913
6106,6,24,1,2412,-46,-91,45,,19724963,28,22,19724935,19724963
6107,4,11,1,2412,-87,-91,4,4c:01:43:d7:f3:23,19726188,322,903,19725866,19726188
6108,6,24,1,2412,-87,-91,4,4c:01:43:d7:f3:26,19732827,32,6607,19732795,19732827
6109,4,11,1,2412,-71,-91,20,48:dd:0c:7d:86:27,19740242,362,7053,19739880,19740242
6110,4,11,1,2412,-73,-91,18,48:dd:0c:7d:86:23,19740616,323,51,19740293,19740616
6111,4,11,1,2412,-74,-91,17,48:dd:0c:7d:86:25,19740952,382,-46,19740570,19740952
6112,6,6,1,2412,-86,-91,5,40:b0:34:b7:01:d5,19743363,576,1835,19742787,19743363
6113,6,24,1,2412,-83,-91,8,,19748527,28,5136,19748499,19748527
6114,6,6,1,2412,-57,-91,34,12:86:8c:5f:93:1e,19748977,332,118,19748645,19748977
6115,6,6,1,2412,-86,-91,5,e2:db:d1:d1:b0:4b,19756554,408,7169,19756146,19756554
6116,4,11,1,2412,-86,-91,5,48:dd:0c:90:e3:87,19765320,362,8404,19764958,19765320
6117,4,11,1,2412,-85,-91,6,48:dd:0c:90:e3:83,19765694,323,51,19765371,19765694
6118,6,6,1,2412,-59,-91,32,52:86:8c:5f:93:1e,19773540,332,7514,19773208,19773540
6119,4,1,1,2412,-86,-91,5,78:67:0e:c4:a8:42,19777521,2736,1245,19774785,19777521
6120,6,6,1,2412,-59,-91,32,32:86:8c:5f:93:1e,19796370,332,18517,19796038,19796370
6121,6,6,1,2412,-82,-91,9,,19803882,44,7468,19803838,19803882
6122,6,24,1,2412,-83,-91,8,,19805093,28,1183,19805065,19805093
6123,6,24,1,2412,-87,-91,4,e2:db:d1:d1:b0:4a,19810783,28,5662,19810755,19810783
6124,6,6,1,2412,-88,-91,3,,19811005,44,178,19810961,19811005
6125,6,24,1,2412,-88,-91,3,e2:db:d1:d1:b0:4a,19811856,28,823,19811828,19811856
6126,6,6,1,2412,-87,-91,4,,19813299,44,1399,19813255,19813299
6127,6,6,1,2412,-87,-91,4,e2:db:d1:d1:b0:4a,19815368,68,2001,19815300,19815368
6128,6,24,1,2412,-88,-91,3,,19816060,28,664,19816032,19816060
6129,4,1,1,2412,-68,-91,23,b0:e4:d5:32:ec:8a,19817960,1960,-60,19816000,19817960
6130,4,1,1,2412,-54,-91,37,94:a6:7e:c9:98:67,19825100,2464,4676,19822636,19825100
6131,4,11,1,2412,-78,-91,13,48:dd:0c:7d:86:27,19842642,362,17180,19842280,19842642
6132,4,11,1,2412,-78,-91,13,48:dd:0c:7d:86:25,19843351,382,327,19842969,19843351
6133,4,1,1,2412,-87,-91,4,78:67:0e:38:6c:d3,19847113,848,2914,19846265,19847113
6134,6,6,1,2412,-87,-91,4,40:b0:34:b7:01:d5,19849999,576,2310,19849423,19849999
6135,6,6,1,2412,-60,-91,31,12:86:8c:5f:93:1e,19851776,332,1445,19851444,19851776
6136,4,1,1,2412,-90,-91,1,00:26:62:eb:ea:74,19853077,968,333,19852109,19853077
6137,6,6,1,2412,-87,-91,4,e2:db:d1:d1:b0:4d,19859495,408,6010,19859087,19859495
6138,4,11,1,2412,-86,-91,5,4c:01:43:ec:a0:69,19866741,361,6885,19866380,19866741
6139,4,11,1,2412,-86,-91,5,4c:01:43:ec:a0:63,19867115,322,52,19866793,19867115
6140,4,11,1,2412,-89,-91,2,48:dd:0c:90:e3:83,19868094,323,656,19867771,19868094
6141,4,11,1,2412,-87,-91,4,48:dd:0c:90:e3:85,19868429,382,-47,19868047,19868429
6142,6,6,1,2412,-87,-91,4,,19871027,44,2554,19870983,19871027
6143,4,1,1,2412,-87,-91,4,3c:bd:c5:ee:96:6d,19875943,1056,3860,19874887,19875943
6144,6,6,1,2412,-61,-91,30,32:86:8c:5f:93:1e,19898771,332,22496,19898439,19898771
6145,6,24,1,2412,-84,-91,7,,19905940,28,7141,19905912,19905940
6146,6,24,1,2412,-81,-91,10,,19911568,28,5600,19911540,19911568
6147,6,24,1,2412,-61,-91,30,10:86:8c:5f:93:1e,19911680,32,80,19911648,19911680
6148,4,1,1,2412,-81,-91,10,c0:8d:51:da:5c:ef,19913476,416,1380,19913060,19913476
6149,4,1,1,2412,-60,-91,31,,19913902,304,122,19913598,19913902
6150,4,1,1,2412,-66,-91,25,b0:e4:d5:32:ec:8a,19920359,1960,4497,19918399,19920359
6151,6,6,1,2412,-61,-91,30,10:86:8c:5f:93:1e,19926182,344,5479,19925838,19926182
6152,4,1,1,2412,-54,-91,37,94:a6:7e:c9:98:67,19927402,2464,-1244,19924938,19927402
6153,6,6,1,2412,-61,-91,30,b4:e6:2d:b4:ff:71,19930376,64,2910,19930312,19930376
6154,4,11,1,2412,-91,-91,0,4c:01:43:d7:f3:26,19931395,387,632,19931008,19931395
6155,6,6,1,2412,-61,-91,30,b4:e6:2d:b4:ff:71,19931699,64,240,19931635,19931699
6156,6,6,1,2412,-61,-91,30,b4:e6:2d:b4:ff:71,19931942,64,179,19931878,19931942
6157,6,6,1,2412,-61,-91,30,,19932022,44,36,19931978,19932022
6158,4,1,1,2412,-87,-91,4,78:67:0e:38:6c:d3,19942283,2736,7525,19939547,19942283
6159,4,11,1,2412,-73,-91,18,48:dd:0c:7d:86:27,19945041,362,2396,19944679,19945041
6160,4,11,1,2412,-74,-91,17,48:dd:0c:7d:86:23,19945416,323,52,19945093,19945416
6161,4,11,1,2412,-74,-91,17,48:dd:0c:7d:86:25,19945751,382,-47,19945369,19945751
6162,4,1,1,2412,-89,-91,2,bc:98:df:ff:0f:8b,19946937,3176,-1990,19943761,19946937
6163,6,6,1,2412,-62,-91,29,12:86:8c:5f:93:1e,19950118,332,2849,19949786,19950118
6164,4,1,1,2412,-63,-91,28,,19955113,304,4691,19954809,19955113
6165,7,72.2222,1,2412,-61,-91,30,10:86:8c:5f:93:1e,19955264,50,101,19955214,19955264
6166,6,24,1,2412,-82,-91,9,,19955330,28,38,19955302,19955330
6167,6,6,1,2412,-89,-91,2,e2:db:d1:d1:b0:4b,19961564,408,5826,19961156,19961564
6168,4,11,1,2412,-86,-91,5,4c:01:43:ec:a0:69,19968727,361,6802,19968366,19968727
6169,4,11,1,2412,-89,-91,2,4c:01:43:ec:a0:63,19969100,322,51,19968778,19969100
6170,4,11,1,2412,-90,-91,1,4c:01:43:ec:a0:66,19969435,387,-52,19969048,19969435
6171,4,11,1,2412,-83,-91,8,48:dd:0c:90:e3:87,19970119,362,322,19969757,19970119
6172,4,11,1,2412,-83,-91,8,48:dd:0c:90:e3:83,19970494,323,52,19970171,19970494
6173,4,11,1,2412,-82,-91,9,48:dd:0c:90:e3:85,19970829,382,-47,19970447,19970829
6174,6,24,1,2412,-82,-91,9,,19973129,28,2272,19973101,19973129
6175,6,24,1,2412,-82,-91,9,,19973792,28,635,19973764,19973792
6176,6,24,1,2412,-76,-91,15,,19974069,28,249,19974041,19974069
6177,7,58.5,1,2412,-78,-91,13,c0:8d:51:da:5c:ef,19974122,52,1,19974070,19974122
6178,6,24,1,2412,-63,-91,28,10:86:8c:5f:93:1e,19978293,32,4139,19978261,19978293
6179,6,24,1,2412,-87,-91,4,,19980988,28,2667,19980960,19980988
6180,6,6,1,2412,-65,-91,26,32:86:8c:5f:93:1e,20001215,332,19895,20000883,20001215
6181,6,6,1,2412,-92,-91,-1,,20001778,44,519,20001734,20001778
6182,4,1,1,2412,-68,-91,23,b0:e4:d5:32:ec:8a,20022758,1960,19020,20020798,20022758
6183,4,1,1,2412,-50,-91,41,94:a6:7e:c9:98:67,20031409,2464,6187,20028945,20031409
6184,4,1,1,2412,-85,-91,6,78:67:0e:38:6c:d3,20044683,2736,10538,20041947,20044683
6185,4,11,1,2412,-74,-91,17,48:dd:0c:7d:86:27,20047442,362,2397,20047080,20047442
6186,4,11,1,2412,-75,-91,16,48:dd:0c:7d:86:23,20047817,323,52,20047494,20047817
6187,4,11,1,2412,-74,-91,17,48:dd:0c:7d:86:25,20048152,382,-47,20047770,20048152
6188,6,6,1,2412,-88,-91,3,40:b0:34:b7:01:d5,20050567,576,1839,20049991,20050567
6189,6,6,1,2412,-66,-91,25,12:86:8c:5f:93:1e,20052473,332,1574,20052141,20052473
6190,4,11,1,2412,-86,-91,5,4c:01:43:ec:a0:69,20071126,361,18292,20070765,20071126
6191,4,11,1,2412,-85,-91,6,4c:01:43:ec:a0:63,20071499,322,51,20071177,20071499
6192,4,11,1,2412,-86,-91,5,4c:01:43:ec:a0:66,20071834,387,-52,20071447,20071834
6193,6,6,1,2412,-91,-91,0,,20074409,44,2531,20074365,20074409
6194,4,1,1,2412,-89,-91,2,,20075031,304,318,20074727,20075031
6195,6,6,1,2412,-84,-91,7,,20087621,44,12546,20087577,20087621
6196,4,1,1,2412,-85,-91,6,,20092549,304,4624,20092245,20092549
6197,6,6,1,2412,-66,-91,25,32:86:8c:5f:93:1e,20103744,332,10863,20103412,20103744
6198,6,6,1,2412,-59,-91,32,b4:e6:2d:b4:ff:71,20114139,64,10331,20114075,20114139
6199,6,6,1,2412,-59,-91,32,b4:e6:2d:b4:ff:71,20114427,64,224,20114363,20114427
6200,6,6,1,2412,-60,-91,31,b4:e6:2d:b4:ff:71,20114589,64,98,20114525,20114589
6201,6,6,1,2412,-59,-91,32,b4:e6:2d:b4:ff:71,20115272,64,619,20115208,20115272
6202,6,6,1,2412,-59,-91,32,b4:e6:2d:b4:ff:71,20115443,64,107,20115379,20115443
6203,6,6,1,2412,-59,-91,32,b4:e6:2d:b4:ff:71,20115632,64,125,20115568,20115632
6204,4,1,1,2412,-62,-91,29,b4:e6:2d:b4:ff:71,20116026,416,-22,20115610,20116026
6205,4,1,1,2412,-69,-91,22,,20116453,304,123,20116149,20116453
6206,4,1,1,2412,-65,-91,26,b0:e4:d5:32:ec:8a,20125157,1960,6744,20123197,20125157
6207,4,1,1,2412,-92,-91,-1,bc:98:df:ff:0f:8b,20129309,2568,1584,20126741,20129309
6208,4,1,1,2412,-51,-91,40,94:a6:7e:c9:98:67,20132212,2464,439,20129748,20132212
6209,6,6,1,2412,-66,-91,25,10:86:8c:5f:93:1e,20134532,344,1976,20134188,20134532
6210,4,11,1,2412,-86,-91,5,4c:01:43:d7:f3:29,20135411,362,517,20135049,20135411
6211,4,11,1,2412,-88,-91,3,4c:01:43:d7:f3:23,20135786,322,53,20135464,20135786
6212,4,11,1,2412,-78,-91,13,48:dd:0c:7d:86:27,20149842,362,13694,20149480,20149842
6213,4,1,1,2412,-89,-91,2,,20151049,304,903,20150745,20151049
6214,4,1,1,2412,-88,-91,3,,20151981,304,628,20151677,20151981
6215,6,24,1,2412,-88,-91,3,,20152255,28,246,20152227,20152255
6216,6,6,1,2412,-89,-91,2,e2:db:d1:d1:b0:4a,20153755,68,1432,20153687,20153755
6217,6,6,1,2412,-87,-91,4,40:b0:34:b7:01:d5,20157909,576,3578,20157333,20157909
6218,6,6,1,2412,-65,-91,26,12:86:8c:5f:93:1e,20158998,332,757,20158666,20158998
6219,6,24,1,2412,-88,-91,3,,20164833,28,5807,20164805,20164833
6220,6,6,1,2412,-90,-91,1,e2:db:d1:d1:b0:4b,20166121,408,880,20165713,20166121
6221,4,11,1,2412,-88,-91,3,4c:01:43:ec:a0:69,20173524,361,7042,20173163,20173524
6222,4,11,1,2412,-90,-91,1,4c:01:43:ec:a0:63,20173898,322,52,20173576,20173898
6223,4,11,1,2412,-84,-91,7,48:dd:0c:90:e3:87,20174919,362,659,20174557,20174919
6224,4,11,1,2412,-86,-91,5,48:dd:0c:90:e3:85,20175628,382,327,20175246,20175628
6225,4,1,1,2412,-88,-91,3,38:01:46:30:1a:ca,20179449,416,3405,20179033,20179449
6226,6,6,1,2412,-66,-91,25,32:86:8c:5f:93:1e,20205973,332,26192,20205641,20205973
6227,4,1,1,2412,-69,-91,22,b0:e4:d5:32:ec:8a,20227557,1960,19624,20225597,20227557
6228,4,1,1,2412,-55,-91,36,94:a6:7e:c9:98:67,20234598,2464,4577,20232134,20234598
6229,6,24,1,2412,-90,-91,1,,20244127,28,9501,20244099,20244127
6230,6,24,1,2412,-88,-91,3,,20245826,28,1671,20245798,20245826
6231,4,1,1,2412,-86,-91,5,78:67:0e:38:6c:d3,20249484,2736,922,20246748,20249484
6232,4,11,1,2412,-74,-91,17,48:dd:0c:7d:86:27,20252243,362,2397,20251881,20252243
6233,4,11,1,2412,-73,-91,18,48:dd:0c:7d:86:23,20252617,323,51,20252294,20252617
6234,4,11,1,2412,-74,-91,17,48:dd:0c:7d:86:25,20252953,382,-46,20252571,20252953
6235,6,6,1,2412,-64,-91,27,12:86:8c:5f:93:1e,20257173,332,3888,20256841,20257173
6236,4,1,1,2412,-86,-91,5,,20258376,304,899,20258072,20258376
6237,6,24,1,2412,-87,-91,4,,20266471,28,8067,20266443,20266471
6238,6,6,1,2412,-91,-91,0,e2:db:d1:d1:b0:4b,20268542,408,1663,20268134,20268542
6239,4,11,1,2412,-84,-91,7,,20275045,107,6396,20274938,20275045
6240,4,11,1,2412,-90,-91,1,4c:01:43:ec:a0:63,20276297,322,930,20275975,20276297
6241,4,11,1,2412,-91,-91,0,4c:01:43:ec:a0:66,20276631,387,-53,20276244,20276631
6242,4,11,1,2412,-85,-91,6,48:dd:0c:90:e3:87,20277318,362,325,20276956,20277318
6243,4,11,1,2412,-84,-91,7,48:dd:0c:90:e3:83,20277693,323,52,20277370,20277693
6244,4,11,1,2412,-85,-91,6,48:dd:0c:90:e3:85,20278028,382,-47,20277646,20278028
6245,4,1,1,2412,-86,-91,5,78:67:0e:c4:a8:42,20278840,352,460,20278488,20278840
6246,4,1,1,2412,-89,-91,2,3c:bd:c5:ee:96:6d,20282981,2512,1629,20280469,20282981
6247,6,6,1,2412,-65,-91,26,52:86:8c:5f:93:1e,20287191,332,3878,20286859,20287191
6248,6,24,1,2412,-88,-91,3,4c:01:43:d7:f3:26,20292598,32,5375,20292566,20292598
6249,6,24,1,2412,-87,-91,4,,20306351,28,13725,20306323,20306351
6250,6,6,1,2412,-64,-91,27,32:86:8c:5f:93:1e,20308396,332,1713,20308064,20308396
6251,4,1,1,2412,-72,-91,19,c0:8d:51:da:5c:ef,20316974,416,8162,20316558,20316974
6252,4,1,1,2412,-74,-91,17,c0:8d:51:da:5c:ef,20317725,416,335,20317309,20317725
6253,4,1,1,2412,-63,-91,28,,20318152,304,123,20317848,20318152
6254,4,1,1,2412,-89,-91,2,,20322920,304,4464,20322616,20322920
6255,6,24,1,2412,-87,-91,4,,20323684,28,736,20323656,20323684
6256,6,24,1,2412,-86,-91,5,,20328610,28,4898,20328582,20328610
6257,4,1,1,2412,-66,-91,25,b0:e4:d5:32:ec:8a,20329956,1960,-614,20327996,20329956
6258,6,6,1,2412,-65,-91,26,10:86:8c:5f:93:1e,20336508,344,6208,20336164,20336508
6259,4,1,1,2412,-57,-91,34,94:a6:7e:c9:98:67,20337071,2464,-1901,20334607,20337071
6260,6,24,1,2412,-86,-91,5,,20348498,28,11399,20348470,20348498
6261,4,1,1,2412,-90,-91,1,78:67:0e:38:6c:d3,20351884,2736,650,20349148,20351884
6262,4,11,1,2412,-74,-91,17,48:dd:0c:7d:86:27,20354643,362,2397,20354281,20354643
6263,4,11,1,2412,-75,-91,16,48:dd:0c:7d:86:23,20355017,323,51,20354694,20355017
6264,4,11,1,2412,-75,-91,16,48:dd:0c:7d:86:25,20355352,382,-47,20354970,20355352
6265,6,24,1,2412,-86,-91,5,,20356213,28,833,20356185,20356213
6266,6,24,1,2412,-86,-91,5,,20357001,28,760,20356973,20357001
6267,6,24,1,2412,-86,-91,5,4c:01:43:d7:f3:26,20358510,32,1477,20358478,20358510
6268,6,6,1,2412,-63,-91,28,12:86:8c:5f:93:1e,20359574,332,732,20359242,20359574
6269,6,24,1,2412,-85,-91,6,4c:01:43:d7:f3:26,20374992,32,15386,20374960,20374992
6270,4,11,1,2412,-89,-91,2,4c:01:43:ec:a0:69,20378322,361,2969,20377961,20378322
6271,4,11,1,2412,-88,-91,3,4c:01:43:ec:a0:63,20378696,322,52,20378374,20378696
6272,4,11,1,2412,-90,-91,1,4c:01:43:ec:a0:66,20379030,387,-53,20378643,20379030
6273,4,11,1,2412,-89,-91,2,48:dd:0c:90:e3:87,20379718,362,326,20379356,20379718
6274,4,11,1,2412,-90,-91,1,48:dd:0c:90:e3:85,20380428,382,328,20380046,20380428
6275,4,1,1,2412,-88,-91,3,,20382663,304,1931,20382359,20382663
6276,4,1,1,2412,-90,-91,1,,20384680,304,1713,20384376,20384680
6277,6,24,1,2412,-85,-91,6,,20391113,28,6405,20391085,20391113
6278,4,1,1,2412,-88,-91,3,78:67:0e:c4:a8:42,20392037,2736,-1812,20389301,20392037
6279,6,24,1,2412,-82,-91,9,,20396545,28,4480,20396517,20396545
6280,4,1,1,2412,-85,-91,6,,20398181,304,1332,20397877,20398181
6281,6,24,1,2412,-84,-91,7,,20404817,28,6608,20404789,20404817
6282,4,11,1,2412,-88,-91,3,48:dd:0c:90:e3:83,20407067,254,1996,20406813,20407067
6283,6,6,1,2412,-62,-91,29,32:86:8c:5f:93:1e,20410851,332,3452,20410519,20410851
6284,6,24,1,2412,-81,-91,10,4c:01:43:d7:f3:26,20414843,32,3960,20414811,20414843
6285,4,1,1,2412,-69,-91,22,b0:e4:d5:32:ec:8a,20432355,1960,15552,20430395,20432355
6286,6,6,1,2412,-63,-91,28,10:86:8c:5f:93:1e,20436375,344,3676,20436031,20436375
6287,6,24,1,2412,-81,-91,10,,20437301,28,898,20437273,20437301
6288,4,1,1,2412,-59,-91,32,94:a6:7e:c9:98:67,20441063,2464,1298,20438599,20441063
6289,4,1,1,2412,-90,-91,1,,20451431,304,10064,20451127,20451431
6290,6,24,1,2412,-85,-91,6,4c:01:43:d7:f3:26,20452244,32,781,20452212,20452244
6291,4,1,1,2412,-83,-91,8,78:67:0e:38:6c:d3,20454284,2736,-696,20451548,20454284
6292,4,11,1,2412,-76,-91,15,48:dd:0c:7d:86:27,20457043,362,2397,20456681,20457043
6293,4,11,1,2412,-76,-91,15,48:dd:0c:7d:86:23,20457418,323,52,20457095,20457418
6294,6,6,1,2412,-62,-91,29,12:86:8c:5f:93:1e,20477275,332,19525,20476943,20477275
6295,4,11,1,2412,-86,-91,5,4c:01:43:ec:a0:63,20481095,322,3498,20480773,20481095
6296,4,11,1,2412,-89,-91,2,4c:01:43:ec:a0:66,20481429,387,-53,20481042,20481429
6297,4,11,1,2412,-86,-91,5,48:dd:0c:90:e3:87,20482118,362,327,20481756,20482118
6298,4,11,1,2412,-87,-91,4,48:dd:0c:90:e3:83,20482492,323,51,20482169,20482492
6299,4,11,1,2412,-86,-91,5,48:dd:0c:90:e3:85,20482828,382,-46,20482446,20482828
6300,4,1,1,2412,-88,-91,3,3c:bd:c5:ee:96:6d,20487770,2512,2430,20485258,20487770
6301,6,6,1,2412,-61,-91,30,52:86:8c:5f:93:1e,20490201,332,2099,20489869,20490201
6302,4,1,1,2412,-90,-91,1,,20491918,304,1413,20491614,20491918
6303,4,1,1,2412,-88,-91,3,78:67:0e:c4:a8:42,20494320,2736,-334,20491584,20494320
6304,6,24,1,2412,-84,-91,7,4c:01:43:d7:f3:26,20497102,32,2750,20497070,20497102
6305,4,1,1,2412,-89,-91,2,38:01:46:30:1a:ca,20510816,416,13298,20510400,20510816
6306,6,6,1,2412,-61,-91,30,32:86:8c:5f:93:1e,20513176,332,2028,20512844,20513176
6307,4,1,1,2412,-86,-91,5,,20526694,304,13214,20526390,20526694
6308,6,24,1,2412,-86,-91,5,,20532192,28,5470,20532164,20532192
6309,4,1,1,2412,-71,-91,20,b0:e4:d5:32:ec:8a,20534754,1960,602,20532794,20534754
6310,6,24,1,2412,-86,-91,5,4c:01:43:d7:f3:26,20537730,32,2944,20537698,20537730
6311,6,6,1,2412,-62,-91,29,10:86:8c:5f:93:1e,20539591,344,1517,20539247,20539591
6312,4,1,1,2412,-59,-91,32,94:a6:7e:c9:98:67,20542964,2464,909,20540500,20542964
6313,4,11,1,2412,-84,-91,7,4c:01:43:d7:f3:26,20545736,387,2385,20545349,20545736
6314,4,1,1,2412,-71,-91,20,78:67:0e:38:6c:d3,20556684,2736,8212,20553948,20556684
6315,4,11,1,2412,-72,-91,19,48:dd:0c:7d:86:27,20559443,362,2397,20559081,20559443
6316,4,1,1,2412,-87,-91,4,78:67:0e:c4:a8:42,20561873,432,1998,20561441,20561873
6317,6,6,1,2412,-66,-91,25,12:86:8c:5f:93:1e,20566969,332,4764,20566637,20566969
6318,4,11,1,2412,-86,-91,5,4c:01:43:ec:a0:63,20583493,322,16202,20583171,20583493
6319,4,11,1,2412,-86,-91,5,4c:01:43:ec:a0:66,20583828,387,-52,20583441,20583828
6320,4,11,1,2412,-86,-91,5,48:dd:0c:90:e3:87,20584517,362,327,20584155,20584517
6321,6,6,1,2412,-62,-91,29,52:86:8c:5f:93:1e,20590080,332,5231,20589748,20590080
6322,6,24,1,2412,-87,-91,4,,20596357,28,6249,20596329,20596357
6323,4,1,1,2412,-89,-91,2,78:67:0e:c4:a8:42,20596776,2736,-2317,20594040,20596776
6324,4,1,1,2412,-90,-91,1,,20600359,304,3279,20600055,20600359
6325,6,6,1,2412,-62,-91,29,32:86:8c:5f:93:1e,20615872,332,15181,20615540,20615872
6326,6,24,1,2412,-83,-91,8,,20631745,28,15845,20631717,20631745
6327,4,1,1,2412,-65,-91,26,b0:e4:d5:32:ec:8a,20637154,1960,3449,20635194,20637154
6328,4,1,1,2412,-54,-91,37,94:a6:7e:c9:98:67,20644218,2464,4600,20641754,20644218
6329,4,1,1,2412,-55,-91,36,94:a6:7e:c9:98:67,20646710,1888,604,20644822,20646710
6330,6,6,1,2412,-62,-91,29,10:86:8c:5f:93:1e,20648454,344,1400,20648110,20648454
6331,6,24,1,2412,-89,-91,2,,20652569,28,4087,20652541,20652569
6332,4,11,1,2412,-75,-91,16,48:dd:0c:7d:86:27,20661843,362,8912,20661481,20661843
6333,4,11,1,2412,-77,-91,14,48:dd:0c:7d:86:23,20662218,323,52,20661895,20662218
6334,4,11,1,2412,-76,-91,15,48:dd:0c:7d:86:25,20662553,382,-47,20662171,20662553
6335,6,6,1,2412,-90,-91,1,40:b0:34:b7:01:d5,20665136,576,2007,20664560,20665136
6336,6,6,1,2412,-65,-91,26,12:86:8c:5f:93:1e,20670672,332,5204,20670340,20670672
6337,4,1,1,2412,-89,-91,2,78:67:0e:c4:a8:42,20676211,352,5187,20675859,20676211
6338,4,1,1,2412,-77,-91,14,78:67:0e:c4:a8:42,20677657,352,1094,20677305,20677657
6339,4,11,1,2412,-87,-91,4,48:dd:0c:90:e3:83,20687292,323,9312,20686969,20687292
6340,4,11,1,2412,-87,-91,4,48:dd:0c:90:e3:85,20687627,382,-47,20687245,20687627
6341,4,11,1,2412,-87,-91,4,4c:01:43:ec:a0:69,20690576,361,2588,20690215,20690576
6342,4,11,1,2412,-87,-91,4,4c:01:43:ec:a0:63,20690949,322,51,20690627,20690949
6343,6,6,1,2412,-65,-91,26,52:86:8c:5f:93:1e,20692574,332,1293,20692242,20692574
6344,4,1,1,2412,-86,-91,5,78:67:0e:c4:a8:42,20699120,2736,3810,20696384,20699120
6345,4,1,1,2412,-92,-91,-1,04:a2:22:bf:24:52,20703319,2512,1687,20700807,20703319
6346,6,24,1,2412,-84,-91,7,,20711120,28,7773,20711092,20711120
6347,6,6,1,2412,-65,-91,26,32:86:8c:5f:93:1e,20719077,332,7625,20718745,20719077
6348,4,1,1,2412,-89,-91,2,,20719558,304,177,20719254,20719558
6349,6,24,1,2412,-85,-91,6,,20723698,28,4112,20723670,20723698
6350,6,6,1,2412,-84,-91,7,4c:01:43:d7:f3:26,20737045,68,13279,20736977,20737045
6351,4,1,1,2412,-53,-91,38,94:a6:7e:c9:98:67,20746604,2464,7095,20744140,20746604
6352,6,24,1,2412,-87,-91,4,,20748929,28,2297,20748901,20748929
6353,6,6,1,2412,-67,-91,24,10:86:8c:5f:93:1e,20749376,344,103,20749032,20749376
6354,4,11,1,2412,-89,-91,2,4c:01:43:d7:f3:29,20749912,362,174,20749550,20749912
6355,4,11,1,2412,-87,-91,4,4c:01:43:d7:f3:23,20750286,322,52,20749964,20750286
6356,4,11,1,2412,-88,-91,3,4c:01:43:d7:f3:26,20750621,387,-52,20750234,20750621
6357,4,11,1,2412,-76,-91,15,48:dd:0c:7d:86:27,20764244,362,13261,20763882,20764244
6358,4,11,1,2412,-76,-91,15,48:dd:0c:7d:86:23,20764618,323,51,20764295,20764618
6359,4,11,1,2412,-77,-91,14,48:dd:0c:7d:86:25,20764954,382,-46,20764572,20764954
6360,6,6,1,2412,-85,-91,6,40:b0:34:b7:01:d5,20767374,576,1844,20766798,20767374
6361,6,6,1,2412,-65,-91,26,12:86:8c:5f:93:1e,20769224,332,1518,20768892,20769224
6362,6,24,1,2412,-85,-91,6,4c:01:43:d7:f3:26,20776093,32,6837,20776061,20776093
6363,4,11,1,2412,-90,-91,1,48:dd:0c:90:e3:83,20789692,323,13276,20789369,20789692
6364,4,11,1,2412,-76,-91,15,48:dd:0c:7d:86:23,20791963,254,2017,20791709,20791963
6365,6,6,1,2412,-67,-91,24,52:86:8c:5f:93:1e,20798448,332,6153,20798116,20798448
6366,6,24,1,2412,-87,-91,4,,20804255,28,5779,20804227,20804255
6367,6,6,1,2412,-88,-91,3,,20804625,44,326,20804581,20804625
6368,6,6,1,2412,-67,-91,24,32:86:8c:5f:93:1e,20820377,332,15420,20820045,20820377
6369,4,1,1,2412,-90,-91,1,,20821968,304,1287,20821664,20821968
6370,4,1,1,2412,-63,-91,28,b0:e4:d5:32:ec:8a,20841952,1960,18024,20839992,20841952
6371,4,1,1,2412,-53,-91,38,94:a6:7e:c9:98:67,20849977,2464,5561,20847513,20849977
6372,4,11,1,2412,-91,-91,0,4c:01:43:d7:f3:26,20853058,387,2694,20852671,20853058
6373,4,11,1,2412,-79,-91,12,48:dd:0c:7d:86:23,20867018,323,13637,20866695,20867018
6374,4,11,1,2412,-78,-91,13,48:dd:0c:7d:86:25,20867353,382,-47,20866971,20867353
6375,6,24,1,2412,-85,-91,6,,20868385,28,1004,20868357,20868385
6376,6,6,1,2412,-86,-91,5,40:b0:34:b7:01:d5,20869776,576,815,20869200,20869776
6377,6,24,1,2412,-88,-91,3,,20871123,28,1319,20871095,20871123
6378,6,6,1,2412,-67,-91,24,12:86:8c:5f:93:1e,20871627,332,172,20871295,20871627
6379,4,1,1,2412,-90,-91,1,,20887142,304,15211,20886838,20887142
6380,4,11,1,2412,-87,-91,4,4c:01:43:ec:a0:66,20891025,387,3496,20890638,20891025
6381,4,11,1,2412,-77,-91,14,48:dd:0c:90:e3:85,20892427,382,1020,20892045,20892427
6382,4,1,1,2412,-89,-91,2,3c:bd:c5:ee:96:6d,20897341,2512,2402,20894829,20897341
6383,6,6,1,2412,-66,-91,25,52:86:8c:5f:93:1e,20899868,332,2195,20899536,20899868
6384,4,1,1,2412,-87,-91,4,78:67:0e:c4:a8:42,20905983,2736,3379,20903247,20905983
6385,4,1,1,2412,-85,-91,6,78:67:0e:c4:a8:42,20908801,1184,1634,20907617,20908801
6386,4,11,1,2412,-83,-91,8,,20911140,107,2232,20911033,20911140
6387,4,1,1,2412,-85,-91,6,78:67:0e:c4:a8:42,20915838,352,4346,20915486,20915838
6388,6,6,1,2412,-66,-91,25,32:86:8c:5f:93:1e,20922778,332,6608,20922446,20922778
6389,4,11,1,2412,-90,-91,1,4c:01:43:d7:f3:23,20932600,284,9538,20932316,20932600
6390,4,11,1,2412,-86,-91,5,4c:01:43:ec:a0:63,20932941,284,57,20932657,20932941
6391,4,11,1,2412,-87,-91,4,4c:01:43:ec:a0:63,20933668,284,443,20933384,20933668
6392,4,1,1,2412,-66,-91,25,b0:e4:d5:32:ec:8a,20944351,1960,8723,20942391,20944351
6393,4,1,1,2412,-90,-91,1,,20947845,304,3190,20947541,20947845
6394,4,1,1,2412,-57,-91,34,94:a6:7e:c9:98:67,20951349,2464,1040,20948885,20951349
6395,6,6,1,2412,-66,-91,25,10:86:8c:5f:93:1e,20954913,344,3220,20954569,20954913
6396,4,11,1,2412,-91,-91,0,4c:01:43:d7:f3:26,20955839,274,652,20955565,20955839
6397,6,24,1,2412,-84,-91,7,,20958624,28,2757,20958596,20958624
6398,4,1,1,2412,-91,-91,0,,20962629,304,3701,20962325,20962629
6399,6,6,1,2412,-83,-91,8,40:b0:34:b7:01:d5,20973278,576,10073,20972702,20973278
6400,4,1,1,2412,-90,-91,1,00:26:62:eb:ea:74,20986357,968,12111,20985389,20986357
6401,4,11,1,2412,-87,-91,4,4c:01:43:ec:a0:69,20992715,361,5997,20992354,20992715
6402,4,11,1,2412,-88,-91,3,4c:01:43:ec:a0:63,20993089,322,52,20992767,20993089
6403,4,11,1,2412,-86,-91,5,4c:01:43:ec:a0:66,20993423,387,-53,20993036,20993423
6404,4,11,1,2412,-84,-91,7,48:dd:0c:90:e3:87,20994116,362,331,20993754,20994116
6405,4,11,1,2412,-86,-91,5,48:dd:0c:90:e3:83,20994491,323,52,20994168,20994491
6406,4,11,1,2412,-85,-91,6,48:dd:0c:90:e3:85,20994826,382,-47,20994444,20994826
6407,4,1,1,2412,-90,-91,1,,21009743,304,14613,21009439,21009743
6408,6,6,1,2412,-66,-93,27,32:86:8c:5f:93:1e,21025179,332,15104,21024847,21025179
6409,4,1,1,2412,-89,-93,4,,21027813,304,2330,21027509,21027813
6410,6,24,1,2412,-85,-93,8,,21032410,28,4569,21032382,21032410
6411,4,1,1,2412,-64,-93,29,b0:e4:d5:32:ec:8a,21046751,1960,12381,21044791,21046751
6412,4,1,1,2412,-53,-93,40,94:a6:7e:c9:98:67,21053827,2464,4612,21051363,21053827
6413,4,1,1,2412,-89,-93,4,78:67:0e:38:6c:d3,21068686,2736,12123,21065950,21068686
6414,4,11,1,2412,-75,-93,18,48:dd:0c:7d:86:27,21071444,362,2396,21071082,21071444
6415,4,11,1,2412,-74,-93,19,48:dd:0c:7d:86:23,21071819,323,52,21071496,21071819
6416,4,11,1,2412,-75,-93,18,48:dd:0c:7d:86:25,21072154,382,-47,21071772,21072154
6417,6,6,1,2412,-66,-93,27,12:86:8c:5f:93:1e,21076379,332,3893,21076047,21076379
6418,4,11,1,2412,-85,-93,8,4c:01:43:ec:a0:69,21095114,361,18374,21094753,21095114
6419,4,11,1,2412,-84,-93,9,4c:01:43:ec:a0:63,21095488,322,52,21095166,21095488
6420,4,11,1,2412,-85,-93,8,4c:01:43:ec:a0:66,21095822,387,-53,21095435,21095822
6421,4,11,1,2412,-86,-93,7,48:dd:0c:90:e3:83,21096891,323,746,21096568,21096891
6422,4,11,1,2412,-86,-93,7,48:dd:0c:90:e3:85,21097226,382,-47,21096844,21097226
6423,6,24,1,2412,-85,-93,8,,21098988,28,1734,21098960,21098988
6424,4,1,1,2412,-86,-93,7,,21106117,304,6825,21105813,21106117
6425,4,1,1,2412,-86,-93,7,3c:bd:c5:ee:96:6d,21106439,752,-430,21105687,21106439
6426,6,24,1,2412,-86,-93,7,,21119448,28,12981,21119420,21119448
6427,6,24,1,2412,-87,-93,6,4c:01:43:d7:f3:26,21126045,32,6565,21126013,21126045
6428,6,6,1,2412,-65,-93,28,32:86:8c:5f:93:1e,21127579,332,1202,21127247,21127579
6429,4,11,1,2412,-77,-93,16,48:dd:0c:7d:86:23,21128129,254,296,21127875,21128129
6430,4,1,1,2412,-86,-93,7,bc:98:df:ff:0f:8b,21153301,2568,22604,21150733,21153301
6431,6,6,1,2412,-63,-93,30,10:86:8c:5f:93:1e,21155794,344,2149,21155450,21155794
6432,4,1,1,2412,-52,-93,41,94:a6:7e:c9:98:67,21156347,2464,-1911,21153883,21156347
6433,4,1,1,2412,-84,-93,9,78:67:0e:38:6c:d3,21171086,2736,12003,21168350,21171086
6434,4,11,1,2412,-77,-93,16,48:dd:0c:7d:86:27,21173845,362,2397,21173483,21173845
6435,4,11,1,2412,-79,-93,14,48:dd:0c:7d:86:23,21174220,323,52,21173897,21174220
6436,4,11,1,2412,-79,-93,14,48:dd:0c:7d:86:25,21174555,382,-47,21174173,21174555
6437,4,1,1,2412,-85,-93,8,78:67:0e:c4:a8:42,21176266,352,1359,21175914,21176266
6438,6,6,1,2412,-87,-93,6,40:b0:34:b7:01:d5,21176978,576,136,21176402,21176978
6439,4,11,1,2412,-87,-93,6,,21178154,107,1069,21178047,21178154
6440,6,24,1,2412,-87,-93,6,78:67:0e:c4:a8:42,21178267,32,81,21178235,21178267
6441,6,6,1,2412,-63,-93,30,12:86:8c:5f:93:1e,21178780,332,181,21178448,21178780
6442,6,6,1,2412,-86,-93,7,28:f0:76:29:a4:fe,21188863,52,10031,21188811,21188863
6443,6,24,1,2412,-87,-93,6,,21189478,28,587,21189450,21189478
6444,6,6,1,2412,-82,-93,11,28:f0:76:29:a4:fe,21190747,192,1077,21190555,21190747
6445,4,11,1,2412,-84,-93,9,4c:01:43:ec:a0:69,21197513,361,6405,21197152,21197513
6446,4,11,1,2412,-85,-93,8,4c:01:43:ec:a0:63,21197887,322,52,21197565,21197887
6447,4,11,1,2412,-84,-93,9,4c:01:43:ec:a0:66,21198221,387,-53,21197834,21198221
6448,4,11,1,2412,-89,-93,4,48:dd:0c:90:e3:87,21198916,362,333,21198554,21198916
6449,4,1,1,2412,-92,-93,1,40:ca:63:2d:74:be,21200747,1896,-65,21198851,21200747
6450,6,6,1,2412,-63,-93,30,52:86:8c:5f:93:1e,21210236,332,9157,21209904,21210236
6451,4,11,1,2412,-85,-93,8,4c:01:43:d7:f3:23,21223372,331,12805,21223041,21223372
6452,4,11,1,2412,-85,-93,8,4c:01:43:d7:f3:23,21223787,346,69,21223441,21223787
6453,4,11,1,2412,-81,-93,12,4c:01:43:ec:a0:63,21225800,346,1667,21225454,21225800
6454,4,1,1,2412,-89,-93,4,,21231780,304,5676,21231476,21231780
6455,6,6,1,2412,-64,-93,29,32:86:8c:5f:93:1e,21232129,332,17,21231797,21232129
6456,4,1,1,2412,-65,-93,28,b0:e4:d5:32:ec:8a,21251549,1960,17460,21249589,21251549
6457,6,24,1,2412,-83,-93,10,4c:01:43:d7:f3:26,21254057,32,2476,21254025,21254057
6458,4,1,1,2412,-51,-93,42,94:a6:7e:c9:98:67,21258537,2464,2016,21256073,21258537
6459,4,11,1,2412,-82,-93,11,4c:01:43:d7:f3:29,21261848,362,2949,21261486,21261848
6460,4,11,1,2412,-82,-93,11,4c:01:43:d7:f3:23,21262223,322,53,21261901,21262223
6461,4,11,1,2412,-81,-93,12,4c:01:43:d7:f3:26,21262557,387,-53,21262170,21262557
6462,6,6,1,2412,-67,-93,26,10:86:8c:5f:93:1e,21265074,344,2173,21264730,21265074
6463,6,24,1,2412,-82,-93,11,,21271131,28,6029,21271103,21271131
6464,4,1,1,2412,-82,-93,11,78:67:0e:38:6c:d3,21273486,2736,-381,21270750,21273486
6465,4,11,1,2412,-80,-93,13,48:dd:0c:7d:86:27,21276245,362,2397,21275883,21276245
6466,4,11,1,2412,-81,-93,12,48:dd:0c:7d:86:23,21276620,323,52,21276297,21276620
6467,4,11,1,2412,-81,-93,12,48:dd:0c:7d:86:25,21276955,382,-47,21276573,21276955
6468,4,11,1,2412,-89,-93,4,,21278254,107,1192,21278147,21278254
6469,6,24,1,2412,-87,-93,6,78:67:0e:c4:a8:42,21279014,32,728,21278982,21279014
6470,6,6,1,2412,-68,-93,25,12:86:8c:5f:93:1e,21281180,332,1834,21280848,21281180
6471,4,1,1,2412,-90,-93,3,00:26:62:eb:ea:74,21293852,968,11704,21292884,21293852
6472,6,24,1,2412,-81,-93,12,4c:01:43:d7:f3:26,21294880,32,996,21294848,21294880
6473,4,11,1,2412,-79,-93,14,4c:01:43:d7:f3:23,21299824,254,4690,21299570,21299824
6474,4,11,1,2412,-85,-93,8,4c:01:43:ec:a0:63,21300474,322,328,21300152,21300474
6475,4,11,1,2412,-85,-93,8,4c:01:43:ec:a0:66,21300809,387,-52,21300422,21300809
6476,6,6,1,2412,-86,-93,7,4d:01:43:ec:a0:63,21302747,52,1886,21302695,21302747
6477,6,6,1,2412,-83,-93,10,,21302816,44,25,21302772,21302816
6478,4,1,1,2412,-89,-93,4,3c:bd:c5:ee:96:6d,21307013,2512,1685,21304501,21307013
6479,6,6,1,2412,-67,-93,26,52:86:8c:5f:93:1e,21309448,332,2103,21309116,21309448
6480,4,1,1,2412,-87,-93,6,,21310000,304,248,21309696,21310000
6481,6,6,1,2412,-68,-93,25,32:86:8c:5f:93:1e,21332381,332,22049,21332049,21332381
6482,6,24,1,2412,-82,-93,11,4c:01:43:d7:f3:26,21335685,32,3272,21335653,21335685
6483,6,24,1,2412,-83,-93,10,,21351131,28,15418,21351103,21351131
6484,4,1,1,2412,-71,-93,22,b0:e4:d5:32:ec:8a,21353949,1960,858,21351989,21353949
6485,4,1,1,2412,-52,-93,41,94:a6:7e:c9:98:67,21360966,2464,4553,21358502,21360966
6486,4,11,1,2412,-85,-93,8,4c:01:43:d7:f3:29,21364267,362,2939,21363905,21364267
6487,4,11,1,2412,-86,-93,7,4c:01:43:d7:f3:23,21364641,322,52,21364319,21364641
6488,4,11,1,2412,-84,-93,9,4c:01:43:d7:f3:26,21364976,387,-52,21364589,21364976
6489,4,11,1,2412,-86,-93,7,4c:01:43:d7:f3:26,21365409,321,112,21365088,21365409
6490,4,11,1,2412,-85,-93,8,4c:01:43:d7:f3:26,21365978,336,233,21365642,21365978
6491,4,1,1,2412,-84,-93,9,78:67:0e:38:6c:d3,21375932,2736,7218,21373196,21375932
6492,4,11,1,2412,-79,-93,14,48:dd:0c:7d:86:27,21378691,362,2397,21378329,21378691
6493,4,11,1,2412,-77,-93,16,48:dd:0c:7d:86:23,21379065,323,51,21378742,21379065
6494,4,11,1,2412,-74,-93,19,48:dd:0c:7d:86:25,21379401,382,-46,21379019,21379401
6495,6,6,1,2412,-68,-93,25,12:86:8c:5f:93:1e,21386932,332,7199,21386600,21386932
6496,4,11,1,2412,-84,-93,9,4c:01:43:ec:a0:69,21402311,361,15018,21401950,21402311
6497,4,11,1,2412,-83,-93,10,4c:01:43:ec:a0:63,21402684,322,51,21402362,21402684
6498,4,11,1,2412,-83,-93,10,4c:01:43:ec:a0:66,21403019,387,-52,21402632,21403019
6499,4,11,1,2412,-69,-93,24,48:dd:0c:90:e3:87,21403715,362,334,21403353,21403715
6500,4,11,1,2412,-86,-93,7,48:dd:0c:90:e3:83,21404090,323,52,21403767,21404090
6501,4,11,1,2412,-85,-93,8,48:dd:0c:90:e3:85,21404425,382,-47,21404043,21404425
6502,4,1,1,2412,-84,-93,9,3c:bd:c5:ee:96:6d,21411878,976,6477,21410902,21411878
6503,6,24,1,2412,-83,-93,10,,21431755,28,19849,21431727,21431755
6504,6,6,1,2412,-63,-93,30,32:86:8c:5f:93:1e,21434781,332,2694,21434449,21434781
6505,4,11,1,2412,-85,-93,8,4c:01:43:ec:a0:63,21443631,254,8596,21443377,21443631
6506,4,11,1,2412,-85,-93,8,4c:01:43:d7:f3:23,21444137,254,252,21443883,21444137
6507,6,24,1,2412,-83,-93,10,,21444291,28,126,21444263,21444291
6508,6,24,1,2412,-82,-93,11,4c:01:43:d7:f3:26,21446641,32,2318,21446609,21446641
6509,6,24,1,2412,-82,-93,11,4c:01:43:d7:f3:26,21451873,32,5200,21451841,21451873
6510,4,1,1,2412,-66,-93,27,b0:e4:d5:32:ec:8a,21456695,1960,2862,21454735,21456695
6511,4,1,1,2412,-91,-93,2,,21459811,304,2812,21459507,21459811
6512,4,1,1,2412,-90,-93,3,bc:98:df:ff:0f:8b,21460507,2568,-1872,21457939,21460507
6513,6,6,1,2412,-61,-93,32,10:86:8c:5f:93:1e,21463089,344,2238,21462745,21463089
6514,4,1,1,2412,-58,-93,35,94:a6:7e:c9:98:67,21463679,2464,-1874,21461215,21463679
6515,4,11,1,2412,-80,-93,13,4c:01:43:d7:f3:29,21466605,362,2564,21466243,21466605
6516,4,11,1,2412,-81,-93,12,4c:01:43:d7:f3:23,21466980,322,53,21466658,21466980
6517,4,11,1,2412,-82,-93,11,4c:01:43:d7:f3:26,21467314,387,-53,21466927,21467314
6518,4,11,1,2412,-87,-93,6,48:dd:0c:92:4b:e3,21470032,323,2395,21469709,21470032
6519,4,1,1,2412,-84,-93,9,78:67:0e:38:6c:d3,21478360,2736,5592,21475624,21478360
6520,4,11,1,2412,-78,-93,15,48:dd:0c:7d:86:27,21481119,362,2397,21480757,21481119
6521,4,11,1,2412,-78,-93,15,48:dd:0c:7d:86:23,21481493,323,51,21481170,21481493
6522,4,11,1,2412,-77,-93,16,48:dd:0c:7d:86:25,21481828,382,-47,21481446,21481828
6523,6,6,1,2412,-82,-93,11,40:b0:34:b7:01:d5,21484182,576,1778,21483606,21484182
6524,6,6,1,2412,-60,-93,33,12:86:8c:5f:93:1e,21486136,332,1622,21485804,21486136
6525,6,24,1,2412,-81,-93,12,,21504485,28,18321,21504457,21504485
6526,6,6,1,2412,-60,-93,33,52:86:8c:5f:93:1e,21511708,332,6891,21511376,21511708
6527,4,1,1,2412,-89,-93,4,78:67:0e:c4:a8:42,21518319,2736,3875,21515583,21518319
6528,4,1,1,2412,-90,-93,3,78:67:0e:c4:a8:42,21521102,896,1887,21520206,21521102
6529,6,6,1,2412,-61,-93,32,32:86:8c:5f:93:1e,21537182,332,15748,21536850,21537182
6530,6,24,1,2412,-82,-93,11,,21547117,28,9907,21547089,21547117
6531,4,1,1,2412,-64,-93,29,b0:e4:d5:32:ec:8a,21558747,1960,9670,21556787,21558747
6532,4,1,1,2412,-90,-93,3,bc:98:df:ff:0f:8b,21562900,2568,1585,21560332,21562900
6533,4,1,1,2412,-57,-93,36,94:a6:7e:c9:98:67,21565724,2464,360,21563260,21565724
6534,6,24,1,2412,-83,-93,10,,21568095,28,2343,21568067,21568095
6535,4,11,1,2412,-78,-93,15,48:dd:0c:7d:86:25,21584155,382,15678,21583773,21584155
6536,6,6,1,2412,-84,-93,9,40:b0:34:b7:01:d5,21586583,576,1852,21586007,21586583
6537,6,24,1,2412,-82,-93,11,,21587310,28,699,21587282,21587310
6538,4,1,1,2412,-89,-93,4,70:3a:cb:63:35:b2,21588721,2216,-805,21586505,21588721
6539,6,6,1,2412,-61,-93,32,12:86:8c:5f:93:1e,21590792,332,1739,21590460,21590792
6540,6,24,1,2412,-84,-93,9,,21603868,28,13048,21603840,21603868
6541,4,11,1,2412,-85,-93,8,4c:01:43:ec:a0:69,21607108,361,2879,21606747,21607108
6542,4,11,1,2412,-85,-93,8,4c:01:43:ec:a0:63,21607482,322,52,21607160,21607482
6543,6,6,1,2412,-63,-93,30,52:86:8c:5f:93:1e,21614172,332,6358,21613840,21614172
6544,4,1,1,2412,-91,-93,2,78:67:0e:c4:a8:42,21620719,2736,3811,21617983,21620719
6545,6,6,1,2412,-65,-93,28,32:86:8c:5f:93:1e,21639583,332,18532,21639251,21639583
6546,6,24,1,2412,-85,-93,8,,21646656,28,7045,21646628,21646656
6547,6,24,1,2412,-85,-93,8,,21652282,28,5598,21652254,21652282
6548,4,1,1,2412,-90,-93,3,,21658467,304,5881,21658163,21658467
6549,6,6,1,2412,-66,-93,27,10:86:8c:5f:93:1e,21665183,344,6372,21664839,21665183
6550,4,1,1,2412,-53,-93,40,94:a6:7e:c9:98:67,21668122,2464,475,21665658,21668122
6551,4,11,1,2412,-89,-93,4,48:dd:0c:92:4b:e7,21674457,362,5973,21674095,21674457
6552,4,11,1,2412,-88,-93,5,48:dd:0c:92:4b:e3,21674831,323,51,21674508,21674831
6553,4,11,1,2412,-88,-93,5,48:dd:0c:92:4b:e5,21675166,382,-47,21674784,21675166
6554,4,1,1,2412,-91,-93,2,78:67:0e:c4:a8:42,21682778,352,7260,21682426,21682778
6555,4,11,1,2412,-79,-93,14,48:dd:0c:7d:86:27,21686411,362,3271,21686049,21686411
6556,4,11,1,2412,-79,-93,14,48:dd:0c:7d:86:23,21686786,323,52,21686463,21686786
6557,4,11,1,2412,-78,-93,15,48:dd:0c:7d:86:25,21687121,382,-47,21686739,21687121
6558,4,11,1,2412,-90,-93,3,,21687647,107,419,21687540,21687647
6559,4,11,1,2412,-88,-93,5,4c:01:43:ec:a0:63,21688894,254,993,21688640,21688894
6560,6,6,1,2412,-87,-93,6,40:b0:34:b7:01:d5,21689021,576,-449,21688445,21689021
6561,4,11,1,2412,-85,-93,8,4c:01:43:d7:f3:23,21689893,254,618,21689639,21689893
6562,6,6,1,2412,-70,-93,23,12:86:8c:5f:93:1e,21690897,332,672,21690565,21690897
6563,4,1,1,2412,-91,-93,2,70:3a:cb:63:35:b2,21691422,2216,-1691,21689206,21691422
6564,4,1,1,2412,-91,-93,2,ac:67:84:84:8a:07,21708540,448,16670,21708092,21708540
6565,4,11,1,2412,-88,-93,5,4c:01:43:ec:a0:69,21709507,361,606,21709146,21709507
6566,4,11,1,2412,-86,-93,7,4c:01:43:ec:a0:66,21710215,387,321,21709828,21710215
6567,4,11,1,2412,-83,-93,10,48:dd:0c:90:e3:83,21711289,323,751,21710966,21711289
6568,4,11,1,2412,-82,-93,11,48:dd:0c:90:e3:85,21711624,382,-47,21711242,21711624
6569,4,1,1,2412,-86,-93,7,3c:bd:c5:ee:96:6d,21716548,2512,2412,21714036,21716548
6570,6,6,1,2412,-70,-93,23,52:86:8c:5f:93:1e,21722853,332,5973,21722521,21722853
6571,4,1,1,2412,-90,-93,3,,21729698,304,6541,21729394,21729698
6572,6,24,1,2412,-86,-93,7,,21737312,28,7586,21737284,21737312
6573,4,1,1,2412,-85,-93,8,98:de:d0:16:18:dc,21738720,664,744,21738056,21738720
6574,6,6,1,2412,-70,-93,23,32:86:8c:5f:93:1e,21742247,332,3195,21741915,21742247
6575,4,1,1,2412,-79,-93,14,98:de:d0:16:18:dc,21762497,664,19586,21761833,21762497
6576,4,1,1,2412,-67,-93,26,b0:e4:d5:32:ec:8a,21763546,1960,-911,21761586,21763546
6577,4,1,1,2412,-53,-93,40,94:a6:7e:c9:98:67,21770541,2464,4531,21768077,21770541
6578,4,11,1,2412,-88,-93,5,4c:01:43:d7:f3:29,21773804,362,2901,21773442,21773804
6579,4,11,1,2412,-88,-93,5,4c:01:43:d7:f3:26,21774513,387,322,21774126,21774513
6580,6,6,1,2412,-68,-93,25,,21776207,44,1650,21776163,21776207
6581,6,6,1,2412,-69,-93,24,10:86:8c:5f:93:1e,21776276,344,-275,21775932,21776276
6582,4,1,1,2412,-80,-93,13,78:67:0e:38:6c:d3,21785487,2736,6475,21782751,21785487
6583,4,11,1,2412,-80,-93,13,48:dd:0c:7d:86:27,21788246,362,2397,21787884,21788246
6584,4,11,1,2412,-80,-93,13,48:dd:0c:7d:86:23,21788621,323,52,21788298,21788621
6585,4,11,1,2412,-79,-93,14,48:dd:0c:7d:86:25,21788956,382,-47,21788574,21788956
6586,4,1,1,2412,-90,-93,3,ac:67:84:84:8a:07,21789527,448,123,21789079,21789527
6587,4,1,1,2412,-93,-93,0,,21789986,304,155,21789682,21789986
6588,6,6,1,2412,-89,-93,4,40:b0:34:b7:01:d5,21791385,576,823,21790809,21791385
6589,6,24,1,2412,-80,-93,13,,21797531,28,6118,21797503,21797531
6590,6,12,1,2412,-81,-93,12,4c:01:43:ec:a0:66,21800020,44,2445,21799976,21800020
6591,6,24,1,2412,-87,-93,6,,21800242,28,194,21800214,21800242
6592,6,24,1,2412,-81,-93,12,,21800523,28,253,21800495,21800523
6593,6,24,1,2412,-81,-93,12,,21803415,28,2864,21803387,21803415
6594,6,24,1,2412,-80,-93,13,,21803896,28,453,21803868,21803896
6595,6,24,1,2412,-81,-93,12,,21804340,28,416,21804312,21804340
6596,4,11,1,2412,-82,-93,11,4c:01:43:ec:a0:69,21811906,361,7205,21811545,21811906
6597,4,11,1,2412,-82,-93,11,4c:01:43:ec:a0:63,21812280,322,52,21811958,21812280
6598,4,11,1,2412,-82,-93,11,4c:01:43:ec:a0:66,21812614,387,-53,21812227,21812614
6599,4,11,1,2412,-85,-93,8,48:dd:0c:90:e3:83,21813689,323,752,21813366,21813689
6600,4,1,1,2412,-86,-93,7,78:67:0e:c4:a8:42,21825519,2736,9094,21822783,21825519
6601,6,24,1,2412,-84,-93,9,,21831764,28,6217,21831736,21831764
6602,6,24,1,2412,-85,-93,8,,21837317,28,5525,21837289,21837317
6603,6,24,1,2412,-86,-93,7,,21843711,28,6366,21843683,21843711
6604,4,1,1,2412,-92,-93,1,,21844162,304,147,21843858,21844162
6605,6,6,1,2412,-69,-93,24,32:86:8c:5f:93:1e,21844422,332,-72,21844090,21844422
6606,6,6,1,2412,-62,-93,31,b4:e6:2d:b4:ff:71,21859570,64,15084,21859506,21859570
6607,6,6,1,2412,-62,-93,31,b4:e6:2d:b4:ff:71,21859867,64,233,21859803,21859867
6608,6,6,1,2412,-62,-93,31,b4:e6:2d:b4:ff:71,21860083,64,152,21860019,21860083
6609,6,6,1,2412,-62,-93,31,b4:e6:2d:b4:ff:71,21860245,64,98,21860181,21860245
6610,6,6,1,2412,-67,-93,26,,21860325,44,36,21860281,21860325
6611,6,6,1,2412,-62,-93,31,b4:e6:2d:b4:ff:71,21860496,64,107,21860432,21860496
6612,6,6,1,2412,-62,-93,31,b4:e6:2d:b4:ff:71,21860694,64,134,21860630,21860694
6613,6,6,1,2412,-68,-93,25,,21860774,44,36,21860730,21860774
6614,4,1,1,2412,-64,-93,29,b0:e4:d5:32:ec:8a,21865945,1960,3211,21863985,21865945
6615,4,1,1,2412,-90,-93,3,ac:67:84:84:8a:07,21868712,448,2319,21868264,21868712
6616,6,6,1,2412,-68,-93,25,10:86:8c:5f:93:1e,21871502,344,2446,21871158,21871502
6617,4,1,1,2412,-53,-93,40,94:a6:7e:c9:98:67,21872943,2464,-1023,21870479,21872943
6618,4,11,1,2412,-85,-93,8,4c:01:43:d7:f3:29,21876203,362,2898,21875841,21876203
6619,4,11,1,2412,-85,-93,8,4c:01:43:d7:f3:26,21876912,387,322,21876525,21876912
6620,4,11,1,2412,-73,-93,20,48:dd:0c:7d:86:27,21890647,362,13373,21890285,21890647
6621,4,11,1,2412,-75,-93,18,48:dd:0c:7d:86:23,21891021,323,51,21890698,21891021
6622,4,11,1,2412,-75,-93,18,48:dd:0c:7d:86:25,21891357,382,-46,21890975,21891357
6623,6,6,1,2412,-84,-93,9,40:b0:34:b7:01:d5,21893786,576,1853,21893210,21893786
6624,6,6,1,2412,-70,-93,23,12:86:8c:5f:93:1e,21895697,332,1579,21895365,21895697
6625,6,6,1,2412,-63,-93,30,b4:e6:2d:b4:ff:71,21903912,64,8151,21903848,21903912
6626,6,6,1,2412,-63,-93,30,b4:e6:2d:b4:ff:71,21904146,64,170,21904082,21904146
6627,6,6,1,2412,-62,-93,31,b4:e6:2d:b4:ff:71,21904692,64,482,21904628,21904692
6628,6,6,1,2412,-62,-93,31,b4:e6:2d:b4:ff:71,21905575,64,819,21905511,21905575
6629,6,6,1,2412,-62,-93,31,b4:e6:2d:b4:ff:71,21905773,64,134,21905709,21905773
6630,4,1,1,2412,-66,-93,27,b4:e6:2d:b4:ff:71,21906126,416,-63,21905710,21906126
6631,4,1,1,2412,-66,-93,27,b4:e6:2d:b4:ff:71,21906676,416,134,21906260,21906676
6632,4,1,1,2412,-67,-93,26,,21907103,304,123,21906799,21907103
6633,4,11,1,2412,-77,-93,16,4c:01:43:ec:a0:69,21914305,361,6841,21913944,21914305
6634,4,11,1,2412,-83,-93,10,4c:01:43:ec:a0:63,21914679,322,52,21914357,21914679
6635,4,11,1,2412,-83,-93,10,4c:01:43:ec:a0:66,21915013,387,-53,21914626,21915013
6636,4,11,1,2412,-86,-93,7,48:dd:0c:90:e3:87,21915714,362,339,21915352,21915714
6637,4,11,1,2412,-87,-93,6,48:dd:0c:90:e3:83,21916089,323,52,21915766,21916089
6638,4,11,1,2412,-86,-93,7,48:dd:0c:90:e3:85,21916424,382,-47,21916042,21916424
6639,6,24,1,2412,-84,-93,9,,21924357,28,7905,21924329,21924357
6640,4,1,1,2412,-88,-93,5,78:67:0e:c4:a8:42,21927919,2736,826,21925183,21927919
6641,6,24,1,2412,-84,-93,9,,21937314,28,9367,21937286,21937314
6642,4,1,1,2412,-90,-93,3,,21946882,304,9264,21946578,21946882
6643,6,6,1,2412,-68,-93,25,32:86:8c:5f:93:1e,21947140,332,-74,21946808,21947140
6644,6,24,1,2412,-84,-93,9,,21954474,28,7306,21954446,21954474
6645,4,1,1,2412,-64,-93,29,b0:e4:d5:32:ec:8a,21968344,1960,11910,21966384,21968344
6646,4,1,1,2412,-56,-93,37,94:a6:7e:c9:98:67,21975321,2464,4513,21972857,21975321
6647,6,6,1,2412,-67,-93,26,10:86:8c:5f:93:1e,21977854,344,2189,21977510,21977854
6648,4,11,1,2412,-84,-93,9,4c:01:43:d7:f3:29,21978603,362,387,21978241,21978603
6649,4,11,1,2412,-84,-93,9,4c:01:43:d7:f3:23,21978977,322,52,21978655,21978977
6650,4,11,1,2412,-84,-93,9,4c:01:43:d7:f3:26,21979312,387,-52,21978925,21979312
6651,4,11,1,2412,-84,-93,9,48:dd:0c:7d:86:23,21993421,323,13786,21993098,21993421
6652,4,11,1,2412,-74,-93,19,48:dd:0c:7d:86:25,21993756,382,-47,21993374,21993756
6653,6,6,1,2412,-84,-93,9,40:b0:34:b7:01:d5,21996187,576,1855,21995611,21996187
6654,6,24,1,2412,-86,-93,7,,21997286,28,1071,21997258,21997286
6655,6,6,1,2412,-66,-93,27,12:86:8c:5f:93:1e,21997989,332,371,21997657,21997989
6656,4,1,1,2412,-93,-93,0,00:26:62:eb:ea:74,22006169,968,7212,22005201,22006169
6657,4,1,1,2412,-89,-93,4,,22008706,304,2233,22008402,22008706
6658,4,1,1,2412,-91,-93,2,,22012065,304,3055,22011761,22012065
6659,4,11,1,2412,-83,-93,10,4c:01:43:ec:a0:69,22016704,361,4278,22016343,22016704
6660,4,11,1,2412,-84,-93,9,4c:01:43:ec:a0:63,22017077,322,51,22016755,22017077
6661,4,11,1,2412,-84,-93,9,4c:01:43:ec:a0:66,22017412,387,-52,22017025,22017412
6662,4,11,1,2412,-89,-93,4,48:dd:0c:90:e3:87,22018114,362,340,22017752,22018114
6663,4,11,1,2412,-87,-93,6,48:dd:0c:90:e3:83,22018488,323,51,22018165,22018488
6664,4,11,1,2412,-89,-93,4,48:dd:0c:90:e3:85,22018824,382,-46,22018442,22018824
6665,4,1,1,2412,-89,-93,4,78:67:0e:c4:a8:42,22030319,2736,8759,22027583,22030319
6666,6,6,1,2412,-64,-93,29,b4:e6:2d:b4:ff:71,22059734,64,29351,22059670,22059734
6667,6,6,1,2412,-64,-93,29,b4:e6:2d:b4:ff:71,22060004,64,206,22059940,22060004
6668,6,6,1,2412,-64,-93,29,,22060085,44,37,22060041,22060085
6669,4,1,1,2412,-90,-93,3,,22069921,304,9532,22069617,22069921
6670,4,1,1,2412,-65,-93,28,b0:e4:d5:32:ec:8a,22070743,1960,-1138,22068783,22070743
6671,6,6,1,2412,-65,-93,28,10:86:8c:5f:93:1e,22077315,344,6228,22076971,22077315
6672,4,1,1,2412,-55,-93,38,94:a6:7e:c9:98:67,22077851,2464,-1928,22075387,22077851
6673,4,11,1,2412,-86,-93,7,4c:01:43:d7:f3:26,22081711,387,3473,22081324,22081711
6674,6,24,1,2412,-85,-93,8,,22082897,28,1158,22082869,22082897
6675,4,11,1,2412,-88,-93,5,48:dd:0c:92:4b:e3,22084431,323,1211,22084108,22084431
6676,4,11,1,2412,-88,-93,5,48:dd:0c:92:4b:e5,22084766,382,-47,22084384,22084766
6677,4,1,1,2412,-84,-93,9,78:67:0e:38:6c:d3,22092688,2736,5186,22089952,22092688
6678,4,11,1,2412,-76,-93,17,48:dd:0c:7d:86:27,22095447,362,2397,22095085,22095447
6679,4,11,1,2412,-77,-93,16,48:dd:0c:7d:86:23,22095821,323,51,22095498,22095821
6680,4,11,1,2412,-77,-93,16,48:dd:0c:7d:86:25,22096156,382,-47,22095774,22096156
6681,6,6,1,2412,-83,-93,10,40:b0:34:b7:01:d5,22098588,576,1856,22098012,22098588
6682,4,1,1,2412,-92,-93,1,70:3a:cb:63:35:b2,22100718,2216,-86,22098502,22100718
6683,6,6,1,2412,-65,-93,28,12:86:8c:5f:93:1e,22102790,332,1740,22102458,22102790
6684,4,11,1,2412,-84,-93,9,4c:01:43:ec:a0:69,22119102,361,15951,22118741,22119102
6685,4,11,1,2412,-84,-93,9,4c:01:43:ec:a0:66,22119811,387,322,22119424,22119811
6686,4,11,1,2412,-88,-93,5,48:dd:0c:90:e3:83,22120888,323,754,22120565,22120888
6687,4,11,1,2412,-89,-93,4,48:dd:0c:90:e3:85,22121223,382,-47,22120841,22121223
6688,4,1,1,2412,-92,-93,1,,22129138,304,7611,22128834,22129138
6689,4,1,1,2412,-88,-93,5,,22132241,304,2799,22131937,22132241
6690,4,1,1,2412,-83,-93,10,78:67:0e:c4:a8:42,22132719,2736,-2258,22129983,22132719
6691,4,1,1,2412,-88,-93,5,,22138753,304,5730,22138449,22138753
6692,6,24,1,2412,-83,-93,10,,22146729,28,7948,22146701,22146729
6693,6,24,1,2412,-89,-93,4,,22151135,28,4378,22151107,22151135
6694,6,6,1,2412,-64,-93,29,32:86:8c:5f:93:1e,22151586,332,119,22151254,22151586
6695,6,24,1,2412,-88,-93,5,,22164093,28,12479,22164065,22164093
6696,4,1,1,2412,-66,-93,27,b0:e4:d5:32:ec:8a,22173143,1960,7090,22171183,22173143
6697,4,1,1,2412,-55,-93,38,94:a6:7e:c9:98:67,22180131,2464,4524,22177667,22180131
6698,4,11,1,2412,-88,-93,5,4c:01:43:d7:f3:26,22184111,387,3593,22183724,22184111
6699,4,11,1,2412,-88,-93,5,48:dd:0c:92:4b:e5,22187166,382,2673,22186784,22187166
6700,6,6,1,2412,-67,-93,26,b4:e6:2d:b4:ff:71,22187418,64,188,22187354,22187418
6701,6,6,1,2412,-67,-93,26,b4:e6:2d:b4:ff:71,22187706,64,224,22187642,22187706
6702,6,6,1,2412,-62,-93,31,,22187786,44,36,22187742,22187786
6703,4,1,1,2412,-83,-93,10,78:67:0e:c4:a8:42,22191017,352,2879,22190665,22191017
6704,4,1,1,2412,-84,-93,9,78:67:0e:c4:a8:42,22191487,352,118,22191135,22191487
6705,4,1,1,2412,-84,-93,9,78:67:0e:c4:a8:42,22191948,352,109,22191596,22191948
6706,4,1,1,2412,-62,-93,31,78:67:0e:c4:a8:42,22192879,352,579,22192527,22192879
6707,4,1,1,2412,-83,-93,10,78:67:0e:c4:a8:42,22193340,352,109,22192988,22193340
6708,4,1,1,2412,-84,-93,9,78:67:0e:c4:a8:42,22193810,352,118,22193458,22193810
6709,4,1,1,2412,-82,-93,11,78:67:0e:c4:a8:42,22194262,352,100,22193910,22194262
6710,4,1,1,2412,-82,-93,11,78:67:0e:c4:a8:42,22194723,352,109,22194371,22194723
6711,4,1,1,2412,-84,-93,9,78:67:0e:c4:a8:42,22195175,352,100,22194823,22195175
6712,4,1,1,2412,-84,-93,9,78:67:0e:c4:a8:42,22195627,352,100,22195275,22195627
6713,4,1,1,2412,-69,-93,24,78:67:0e:c4:a8:42,22196079,352,100,22195727,22196079
6714,4,1,1,2412,-71,-93,22,78:67:0e:c4:a8:42,22196528,352,97,22196176,22196528
6715,4,1,1,2412,-69,-93,24,78:67:0e:c4:a8:42,22196980,352,100,22196628,22196980
6716,4,11,1,2412,-70,-93,23,48:dd:0c:7d:86:27,22197785,362,443,22197423,22197785
6717,4,11,1,2412,-71,-93,22,48:dd:0c:7d:86:23,22198160,323,52,22197837,22198160
6718,4,11,1,2412,-84,-93,9,48:dd:0c:7d:86:25,22198495,382,-47,22198113,22198495
6719,4,1,1,2412,-83,-93,10,78:67:0e:38:6c:d3,22200006,2736,-1225,22197270,22200006
6720,4,1,1,2412,-83,-93,10,78:67:0e:c4:a8:42,22202908,352,2550,22202556,22202908
6721,6,6,1,2412,-65,-93,28,12:86:8c:5f:93:1e,22203644,332,404,22203312,22203644
6722,4,1,1,2412,-82,-93,11,78:67:0e:c4:a8:42,22205379,352,1383,22205027,22205379
6723,4,11,1,2412,-92,-93,1,,22207240,107,1754,22207133,22207240
6724,4,1,1,2412,-84,-93,9,78:67:0e:c4:a8:42,22207600,352,8,22207248,22207600
6725,4,11,1,2412,-85,-93,8,4c:01:43:ec:a0:69,22221501,361,13540,22221140,22221501
6726,4,11,1,2412,-84,-93,9,4c:01:43:ec:a0:63,22221875,322,52,22221553,22221875
6727,4,11,1,2412,-86,-93,7,4c:01:43:ec:a0:66,22222210,387,-52,22221823,22222210
6728,4,11,1,2412,-85,-93,8,48:dd:0c:90:e3:87,22222913,362,341,22222551,22222913
6729,4,11,1,2412,-88,-93,5,48:dd:0c:90:e3:83,22223288,323,52,22222965,22223288
6730,4,11,1,2412,-86,-93,7,48:dd:0c:90:e3:85,22223623,382,-47,22223241,22223623
6731,4,11,1,2412,-91,-93,2,4c:01:43:d7:f3:23,22225794,331,1840,22225463,22225794
6732,4,11,1,2412,-69,-93,24,4c:01:43:ec:a0:63,22227028,331,903,22226697,22227028
6733,4,11,1,2412,-84,-93,9,4c:01:43:ec:a0:63,22228258,346,884,22227912,22228258
6734,6,6,1,2412,-62,-93,31,52:86:8c:5f:93:1e,22228459,332,-131,22228127,22228459
6735,4,1,1,2412,-83,-93,10,78:67:0e:c4:a8:42,22235119,2736,3924,22232383,22235119
6736,6,24,1,2412,-89,-93,4,,22243716,28,8569,22243688,22243716
6737,6,24,1,2412,-83,-93,10,,22247004,28,3260,22246976,22247004
6738,6,6,1,2412,-65,-93,28,32:86:8c:5f:93:1e,22253987,332,6651,22253655,22253987
6739,4,1,1,2412,-73,-93,20,c0:8d:51:da:5c:ef,22264312,416,9909,22263896,22264312
6740,4,1,1,2412,-62,-93,31,,22264739,304,123,22264435,22264739
6741,4,1,1,2412,-88,-93,5,,22265633,304,590,22265329,22265633
6742,6,24,1,2412,-83,-93,10,,22267626,28,1965,22267598,22267626
6743,4,11,1,2412,-80,-93,13,,22272225,107,4492,22272118,22272225
6744,6,24,1,2412,-82,-93,11,78:67:0e:c4:a8:42,22272338,32,81,22272306,22272338
6745,4,1,1,2412,-83,-93,10,78:67:0e:c4:a8:42,22274489,352,1799,22274137,22274489
6746,4,1,1,2412,-66,-93,27,b0:e4:d5:32:ec:8a,22275542,1960,-907,22273582,22275542
6747,4,1,1,2412,-54,-93,39,94:a6:7e:c9:98:67,22282520,2464,4514,22280056,22282520
6748,4,11,1,2412,-93,-93,0,4c:01:43:d7:f3:29,22285871,362,2989,22285509,22285871
6749,4,11,1,2412,-92,-93,1,4c:01:43:d7:f3:26,22286580,387,322,22286193,22286580
6750,4,11,1,2412,-88,-93,5,48:dd:0c:92:4b:e7,22288856,362,1914,22288494,22288856
6751,4,11,1,2412,-74,-93,19,48:dd:0c:92:4b:e3,22289230,323,51,22288907,22289230
6752,4,11,1,2412,-85,-93,8,48:dd:0c:92:4b:e5,22289565,382,-47,22289183,22289565
6753,4,1,1,2412,-85,-93,8,78:67:0e:38:6c:d3,22297488,2736,5187,22294752,22297488
6754,4,11,1,2412,-77,-93,16,48:dd:0c:7d:86:27,22300247,362,2397,22299885,22300247
6755,4,11,1,2412,-78,-93,15,48:dd:0c:7d:86:23,22300622,323,52,22300299,22300622
6756,4,11,1,2412,-75,-93,18,48:dd:0c:7d:86:25,22300957,382,-47,22300575,22300957
6757,6,6,1,2412,-90,-93,3,40:b0:34:b7:01:d5,22303391,576,1858,22302815,22303391
6758,6,6,1,2412,-62,-93,31,12:86:8c:5f:93:1e,22305323,332,1600,22304991,22305323
6759,6,24,1,2412,-82,-93,11,,22306984,28,1633,22306956,22306984
6760,4,11,1,2412,-89,-93,4,4c:01:43:d7:f3:23,22318741,310,11447,22318431,22318741
6761,4,11,1,2412,-84,-93,9,4c:01:43:ec:a0:63,22320236,296,1199,22319940,22320236
6762,4,11,1,2412,-84,-93,9,4c:01:43:ec:a0:63,22321029,310,483,22320719,22321029
6763,4,11,1,2412,-84,-93,9,4c:01:43:ec:a0:63,22321745,377,339,22321368,22321745
6764,4,11,1,2412,-83,-93,10,4c:01:43:ec:a0:69,22324024,361,1918,22323663,22324024
6765,4,11,1,2412,-74,-93,19,4c:01:43:ec:a0:63,22324398,322,52,22324076,22324398
6766,4,11,1,2412,-85,-93,8,4c:01:43:ec:a0:66,22324732,387,-53,22324345,22324732
6767,4,11,1,2412,-81,-93,12,48:dd:0c:90:e3:85,22326023,382,909,22325641,22326023
6768,4,11,1,2412,-86,-93,7,4c:01:43:ec:a0:66,22326430,286,121,22326144,22326430
6769,4,11,1,2412,-84,-93,9,4c:01:43:ec:a0:66,22326791,300,61,22326491,22326791
6770,4,1,1,2412,-91,-93,2,3c:bd:c5:ee:96:6d,22330931,2512,1628,22328419,22330931
6771,6,6,1,2412,-65,-93,28,52:86:8c:5f:93:1e,22333985,332,2722,22333653,22333985
6772,4,1,1,2412,-83,-93,10,78:67:0e:c4:a8:42,22337518,2736,797,22334782,22337518
6773,6,24,1,2412,-83,-93,10,,22348754,28,11208,22348726,22348754
6774,6,6,1,2412,-63,-93,30,32:86:8c:5f:93:1e,22356388,332,7302,22356056,22356388
6775,6,24,1,2412,-83,-93,10,,22369391,28,12975,22369363,22369391
6776,4,1,1,2412,-92,-93,1,,22375872,304,6177,22375568,22375872
6777,4,1,1,2412,-66,-93,27,b0:e4:d5:32:ec:8a,22377941,1960,109,22375981,22377941
6778,4,1,1,2412,-55,-93,38,94:a6:7e:c9:98:67,22385009,2464,4604,22382545,22385009
6779,6,24,1,2412,-82,-93,11,,22387346,28,2309,22387318,22387346
6780,4,11,1,2412,-87,-93,6,4c:01:43:d7:f3:29,22388201,362,493,22387839,22388201
6781,4,11,1,2412,-88,-93,5,4c:01:43:d7:f3:23,22388576,322,53,22388254,22388576
6782,4,11,1,2412,-88,-93,5,4c:01:43:d7:f3:26,22389343,321,446,22389022,22389343
6783,4,11,1,2412,-88,-93,5,4c:01:43:d7:f3:26,22390149,286,520,22389863,22390149
6784,4,11,1,2412,-75,-93,18,4c:01:43:d7:f3:26,22390507,300,58,22390207,22390507
6785,4,11,1,2412,-88,-93,5,4c:01:43:d7:f3:26,22390882,367,8,22390515,22390882
6786,4,1,1,2412,-85,-93,8,78:67:0e:38:6c:d3,22399889,2736,6271,22397153,22399889
6787,4,11,1,2412,-72,-93,21,48:dd:0c:7d:86:27,22402648,362,2397,22402286,22402648
6788,4,11,1,2412,-72,-93,21,48:dd:0c:7d:86:23,22403022,323,51,22402699,22403022
6789,4,11,1,2412,-71,-93,22,48:dd:0c:7d:86:25,22403358,382,-46,22402976,22403358
6790,6,6,1,2412,-88,-93,5,40:b0:34:b7:01:d5,22405792,576,1858,22405216,22405792
6791,6,24,1,2412,-83,-93,10,,22406979,28,1159,22406951,22406979
6792,6,6,1,2412,-64,-93,29,12:86:8c:5f:93:1e,22407588,332,277,22407256,22407588
6793,4,11,1,2412,-85,-93,8,4c:01:43:ec:a0:69,22426299,361,18350,22425938,22426299
6794,4,11,1,2412,-85,-93,8,4c:01:43:ec:a0:63,22426673,322,52,22426351,22426673
6795,4,11,1,2412,-81,-93,12,48:dd:0c:90:e3:87,22427713,362,678,22427351,22427713
6796,4,11,1,2412,-80,-93,13,48:dd:0c:90:e3:83,22428087,323,51,22427764,22428087
6797,6,24,1,2412,-83,-93,10,,22448939,28,20824,22448911,22448939
6798,6,24,1,2412,-85,-93,8,,22456923,28,7956,22456895,22456923
6799,6,24,1,2412,-86,-93,7,,22457257,28,306,22457229,22457257
6800,6,12,1,2412,-85,-93,8,4c:01:43:d7:f3:26,22457593,44,292,22457549,22457593
6801,6,24,1,2412,-85,-93,8,,22457783,28,162,22457755,22457783
6802,6,6,1,2412,-63,-93,30,32:86:8c:5f:93:1e,22458788,332,673,22458456,22458788
6803,4,11,1,2412,-81,-93,12,48:dd:0c:90:e3:83,22463040,254,3998,22462786,22463040
6804,4,11,1,2412,-89,-93,4,48:dd:0c:92:4b:e3,22463757,254,463,22463503,22463757
6805,6,6,1,2412,-64,-93,29,b4:e6:2d:b4:ff:71,22466420,64,2599,22466356,22466420
6806,6,6,1,2412,-62,-93,31,,22466500,44,36,22466456,22466500
6807,6,24,1,2412,-81,-93,12,,22469567,28,3039,22469539,22469567
6808,6,24,1,2412,-86,-93,7,,22471147,28,1552,22471119,22471147
6809,4,1,1,2412,-66,-93,27,b0:e4:d5:32:ec:8a,22480341,1960,7234,22478381,22480341
6810,4,1,1,2412,-54,-93,39,94:a6:7e:c9:98:67,22487422,2464,4617,22484958,22487422
6811,6,6,1,2412,-62,-93,31,10:86:8c:5f:93:1e,22489741,344,1975,22489397,22489741
6812,4,11,1,2412,-76,-93,17,4c:01:43:d7:f3:29,22490601,362,498,22490239,22490601
6813,4,11,1,2412,-85,-93,8,4c:01:43:d7:f3:23,22490975,322,52,22490653,22490975
6814,4,11,1,2412,-86,-93,7,4c:01:43:d7:f3:26,22491310,387,-52,22490923,22491310
6815,4,1,1,2412,-92,-93,1,,22502421,304,10807,22502117,22502421
6816,4,11,1,2412,-72,-93,21,48:dd:0c:7d:86:27,22502847,362,64,22502485,22502847
6817,4,11,1,2412,-69,-93,24,48:dd:0c:7d:86:23,22503221,323,51,22502898,22503221
6818,4,11,1,2412,-69,-93,24,48:dd:0c:7d:86:25,22503557,382,-46,22503175,22503557
6819,4,1,1,2412,-70,-93,23,48:5d:36:d8:ef:52,22508052,832,3663,22507220,22508052
6820,6,6,1,2412,-80,-93,13,40:b0:34:b7:01:d5,22508778,576,150,22508202,22508778
6821,6,6,1,2412,-63,-93,30,12:86:8c:5f:93:1e,22509989,332,879,22509657,22509989
6822,4,11,1,2412,-83,-93,10,4c:01:43:ec:a0:69,22528698,361,18348,22528337,22528698
6823,4,11,1,2412,-82,-93,11,4c:01:43:ec:a0:63,22529072,322,52,22528750,22529072
6824,4,11,1,2412,-83,-93,10,4c:01:43:ec:a0:66,22529406,387,-53,22529019,22529406
6825,4,11,1,2412,-81,-93,12,48:dd:0c:90:e3:87,22530113,362,345,22529751,22530113
6826,4,11,1,2412,-81,-93,12,48:dd:0c:90:e3:83,22530487,323,51,22530164,22530487
6827,4,11,1,2412,-81,-93,12,48:dd:0c:90:e3:85,22530822,382,-47,22530440,22530822
6828,4,1,1,2412,-85,-93,8,78:67:0e:c4:a8:42,22542318,2736,8760,22539582,22542318
6829,6,24,1,2412,-85,-93,8,,22550615,28,8269,22550587,22550615
6830,6,24,1,2412,-86,-93,7,4c:01:43:d7:f3:26,22550734,32,87,22550702,22550734
6831,6,24,1,2412,-86,-93,7,,22551148,28,386,22551120,22551148
6832,6,6,1,2412,-63,-93,30,32:86:8c:5f:93:1e,22563703,332,12223,22563371,22563703
6833,6,24,1,2412,-87,-93,6,,22564625,28,894,22564597,22564625
6834,4,1,1,2412,-92,-93,1,,22566559,304,1630,22566255,22566559
6835,4,1,1,2412,-66,-93,27,b0:e4:d5:32:ec:8a,22582740,1960,14221,22580780,22582740
6836,4,1,1,2412,-54,-93,39,94:a6:7e:c9:98:67,22590117,2464,4913,22587653,22590117
6837,4,11,1,2412,-87,-93,6,4c:01:43:d7:f3:29,22593000,362,2521,22592638,22593000
6838,6,6,1,2412,-63,-93,30,10:86:8c:5f:93:1e,22596608,344,3264,22596264,22596608
6839,6,24,1,2412,-82,-93,11,,22598483,28,1847,22598455,22598483
6840,6,6,1,2412,-77,-93,16,40:b0:34:b7:01:d5,22610731,576,11672,22610155,22610731
6841,6,6,1,2412,-63,-93,30,12:86:8c:5f:93:1e,22612503,332,1440,22612171,22612503
6842,4,1,1,2412,-93,-93,0,70:3a:cb:63:35:b2,22613027,2216,-1692,22610811,22613027
6843,4,1,1,2412,-90,-93,3,00:26:62:eb:ea:74,22622633,968,8638,22621665,22622633
6844,4,1,1,2412,-90,-93,3,,22627000,304,4063,22626696,22627000
6845,4,1,1,2412,-85,-93,8,,22628214,304,910,22627910,22628214
6846,4,11,1,2412,-88,-93,5,4c:01:43:ec:a0:63,22631471,322,2935,22631149,22631471
6847,4,11,1,2412,-87,-93,6,4c:01:43:ec:a0:66,22631805,387,-53,22631418,22631805
6848,6,24,1,2412,-86,-93,7,,22632091,28,258,22632063,22632091
6849,4,11,1,2412,-85,-93,8,48:dd:0c:90:e3:87,22632512,362,59,22632150,22632512
6850,4,11,1,2412,-85,-93,8,48:dd:0c:90:e3:83,22632887,323,52,22632564,22632887
6851,4,11,1,2412,-86,-93,7,48:dd:0c:90:e3:85,22633222,382,-47,22632840,22633222
6852,4,1,1,2412,-91,-93,2,,22634751,304,1225,22634447,22634751
6853,6,6,1,2412,-65,-93,28,52:86:8c:5f:93:1e,22638799,332,3716,22638467,22638799
6854,6,6,1,2412,-63,-93,30,32:86:8c:5f:93:1e,22663590,332,24459,22663258,22663590
6855,4,1,1,2412,-73,-93,20,,22679839,304,15945,22679535,22679839
6856,4,1,1,2412,-84,-93,9,,22681317,304,1174,22681013,22681317
6857,4,1,1,2412,-69,-93,24,b0:e4:d5:32:ec:8a,22685584,1960,2307,22683624,22685584
6858,6,6,1,2412,-62,-93,31,10:86:8c:5f:93:1e,22691729,344,5801,22691385,22691729
6859,4,1,1,2412,-57,-93,36,94:a6:7e:c9:98:67,22692561,2464,-1632,22690097,22692561
6860,4,11,1,2412,-84,-93,9,4c:01:43:d7:f3:29,22695400,362,2477,22695038,22695400
6861,4,11,1,2412,-83,-93,10,4c:01:43:d7:f3:23,22695774,322,52,22695452,22695774
6862,4,11,1,2412,-83,-93,10,4c:01:43:d7:f3:26,22696109,387,-52,22695722,22696109
6863,4,1,1,2412,-62,-93,31,c0:95:6d:3d:17:26,22700229,1640,2480,22698589,22700229
6864,4,11,1,2412,-72,-93,21,48:dd:0c:7d:86:27,22709848,362,9257,22709486,22709848
6865,4,11,1,2412,-71,-93,22,48:dd:0c:7d:86:23,22710223,323,52,22709900,22710223
6866,4,11,1,2412,-71,-93,22,48:dd:0c:7d:86:25,22710558,382,-47,22710176,22710558
6867,4,1,1,2412,-81,-93,12,,22712142,304,1280,22711838,22712142
6868,4,11,1,2412,-82,-93,11,48:dd:0c:90:e3:85,22713414,377,895,22713037,22713414
6869,4,1,1,2412,-82,-93,11,78:67:0e:c4:a8:42,22713869,352,103,22713517,22713869
6870,6,6,1,2412,-80,-93,13,40:b0:34:b7:01:d5,22714100,576,-345,22713524,22714100
6871,4,11,1,2412,-81,-93,12,,22715944,107,1737,22715837,22715944
6872,6,6,1,2412,-62,-93,31,12:86:8c:5f:93:1e,22718048,332,1772,22717716,22718048
6873,4,11,1,2412,-81,-93,12,,22719026,107,871,22718919,22719026
6874,4,11,1,2412,-72,-93,21,,22719889,107,756,22719782,22719889
6875,4,1,1,2412,-63,-93,30,c0:95:6d:3d:17:26,22720556,1640,-973,22718916,22720556
6876,4,1,1,2412,-82,-93,11,,22722947,304,2087,22722643,22722947
6877,4,11,1,2412,-80,-93,13,4c:01:43:ec:a0:69,22734381,361,11073,22734020,22734381
6878,4,11,1,2412,-80,-93,13,4c:01:43:ec:a0:66,22735089,387,321,22734702,22735089
6879,4,11,1,2412,-87,-93,6,48:dd:0c:90:e3:85,22735622,382,151,22735240,22735622
6880,4,1,1,2412,-82,-93,11,78:67:0e:c4:a8:42,22747118,2736,8760,22744382,22747118
6881,6,24,1,2412,-84,-93,9,,22749754,28,2608,22749726,22749754
6882,4,1,1,2412,-87,-93,6,,22752255,304,2197,22751951,22752255
6883,6,24,1,2412,-82,-93,11,,22757577,28,5294,22757549,22757577
6884,6,6,1,2412,-67,-93,26,32:86:8c:5f:93:1e,22765997,332,8088,22765665,22765997
6885,4,1,1,2412,-82,-93,11,,22772414,304,6113,22772110,22772414
6886,4,11,1,2412,-77,-93,16,48:dd:0c:7d:86:25,22774047,377,1256,22773670,22774047
6887,4,1,1,2412,-86,-93,7,,22775486,304,1135,22775182,22775486
6888,4,1,1,2412,-67,-93,26,b0:e4:d5:32:ec:8a,22789992,1960,12546,22788032,22789992
6889,4,1,1,2412,-50,-93,43,94:a6:7e:c9:98:67,22794057,2464,1601,22791593,22794057
6890,6,6,1,2412,-66,-93,27,10:86:8c:5f:93:1e,22796376,344,1975,22796032,22796376
6891,4,1,1,2412,-86,-93,7,,22802702,304,6022,22802398,22802702
6892,4,11,1,2412,-81,-93,12,48:dd:0c:7d:86:27,22812161,362,9097,22811799,22812161
6893,4,11,1,2412,-78,-93,15,48:dd:0c:7d:86:23,22812536,323,52,22812213,22812536
6894,4,11,1,2412,-79,-93,14,48:dd:0c:7d:86:25,22812871,382,-47,22812489,22812871
6895,4,1,1,2412,-87,-93,6,,22836257,304,23082,22835953,22836257
6896,4,11,1,2412,-88,-93,5,48:dd:0c:90:e3:87,22837312,362,693,22836950,22837312
6897,4,11,1,2412,-87,-93,6,48:dd:0c:90:e3:83,22837686,323,51,22837363,22837686
6898,4,11,1,2412,-87,-93,6,48:dd:0c:90:e3:85,22838022,382,-46,22837640,22838022
6899,4,1,1,2412,-88,-93,5,,22845891,304,7565,22845587,22845891
6900,4,11,1,2412,-85,-93,8,48:dd:0c:92:4b:e3,22847417,254,1272,22847163,22847417
6901,4,11,1,2412,-83,-93,10,48:dd:0c:7d:86:23,22848004,254,333,22847750,22848004
6902,4,11,1,2412,-88,-93,5,48:dd:0c:90:e3:83,22848307,254,49,22848053,22848307
6903,6,24,1,2412,-89,-93,4,,22858234,28,9899,22858206,22858234
6904,6,6,1,2412,-63,-93,30,32:86:8c:5f:93:1e,22868391,332,9825,22868059,22868391
6905,6,24,1,2412,-86,-93,7,,22871151,28,2732,22871123,22871151
6906,4,1,1,2412,-76,-93,17,,22880990,304,9535,22880686,22880990
6907,4,1,1,2412,-92,-93,1,,22886142,304,4848,22885838,22886142
6908,4,1,1,2412,-61,-93,32,b0:e4:d5:32:ec:8a,22889938,1960,1836,22887978,22889938
6909,6,6,1,2412,-64,-93,29,10:86:8c:5f:93:1e,22894294,344,4012,22893950,22894294
6910,4,1,1,2412,-55,-93,38,94:a6:7e:c9:98:67,22897014,2464,256,22894550,22897014
6911,6,6,1,2412,-89,-93,4,,22902002,44,4944,22901958,22902002
6912,4,11,1,2412,-88,-93,5,48:dd:0c:92:4b:e7,22903255,362,891,22902893,22903255
6913,4,11,1,2412,-72,-93,21,48:dd:0c:7d:86:23,22915024,323,11446,22914701,22915024
6914,6,24,1,2412,-85,-93,8,,22917015,28,1963,22916987,22917015
6915,6,6,1,2412,-74,-93,19,40:b0:34:b7:01:d5,22917797,576,206,22917221,22917797
6916,4,1,1,2412,-90,-93,3,00:26:62:eb:ea:74,22927577,968,8812,22926609,22927577
6917,4,1,1,2412,-93,-93,0,00:26:62:eb:ea:74,22932213,912,3724,22931301,22932213
6918,6,24,1,2412,-85,-93,8,,22937316,28,5075,22937288,22937316
6919,4,11,1,2412,-85,-93,8,4c:01:43:ec:a0:69,22938293,361,616,22937932,22938293
6920,4,11,1,2412,-85,-93,8,4c:01:43:ec:a0:63,22938667,322,52,22938345,22938667
6921,4,11,1,2412,-84,-93,9,4c:01:43:ec:a0:66,22939002,387,-52,22938615,22939002
6922,4,11,1,2412,-87,-93,6,48:dd:0c:90:e3:87,22939712,362,348,22939350,22939712
6923,4,11,1,2412,-87,-93,6,48:dd:0c:90:e3:83,22940086,323,51,22939763,22940086
6924,6,24,1,2412,-86,-93,7,,22963723,28,23609,22963695,22963723
6925,4,1,1,2412,-90,-93,3,,22965790,304,1763,22965486,22965790
6926,4,1,1,2412,-90,-93,3,,22989656,304,23562,22989352,22989656
6927,4,1,1,2412,-65,-93,28,b0:e4:d5:32:ec:8a,22992337,1960,721,22990377,22992337
6928,4,11,1,2412,-63,-93,30,10:86:8c:5f:93:1e,22997887,347,5203,22997540,22997887
6929,6,6,1,2412,-66,-93,27,b4:e6:2d:b4:ff:71,22999146,64,1195,22999082,22999146
6930,4,1,1,2412,-53,-93,40,94:a6:7e:c9:98:67,22999471,2464,-2139,22997007,22999471
6931,6,6,1,2412,-66,-93,27,b4:e6:2d:b4:ff:71,23001860,64,2325,23001796,23001860
6932,6,6,1,2412,-66,-93,27,b4:e6:2d:b4:ff:71,23002085,64,161,23002021,23002085
6933,6,6,1,2412,-66,-93,27,,23002166,44,37,23002122,23002166
6934,4,11,1,2412,-80,-93,13,48:dd:0c:7d:86:27,23017049,362,14521,23016687,23017049
6935,4,11,1,2412,-80,-93,13,48:dd:0c:7d:86:23,23017423,323,51,23017100,23017423
6936,4,11,1,2412,-80,-93,13,48:dd:0c:7d:86:25,23017759,382,-46,23017377,23017759
6937,6,24,1,2412,-86,-93,7,,23018778,28,991,23018750,23018778
6938,4,1,1,2412,-88,-93,5,,23020638,304,1556,23020334,23020638
6939,6,6,1,2412,-77,-93,16,40:b0:34:b7:01:d5,23020912,576,-302,23020336,23020912
6940,6,6,1,2412,-66,-93,27,12:86:8c:5f:93:1e,23021992,332,748,23021660,23021992
6941,4,11,1,2412,-83,-93,10,4c:01:43:ec:a0:63,23041066,322,18752,23040744,23041066
6942,4,11,1,2412,-85,-93,8,48:dd:0c:90:e3:87,23042111,362,683,23041749,23042111
6943,4,11,1,2412,-85,-93,8,48:dd:0c:90:e3:83,23042486,323,52,23042163,23042486
6944,4,1,1,2412,-87,-93,6,,23043684,304,894,23043380,23043684
6945,6,6,1,2412,-65,-93,28,52:86:8c:5f:93:1e,23047987,332,3971,23047655,23047987
6946,4,1,1,2412,-86,-93,7,,23054237,304,5946,23053933,23054237
6947,4,1,1,2412,-84,-93,9,,23058120,304,3579,23057816,23058120
6948,6,6,1,2412,-89,-93,4,,23059982,44,1818,23059938,23059982
6949,4,1,1,2412,-89,-93,4,,23062406,304,2120,23062102,23062406
6950,6,6,1,2412,-91,-93,2,e0:db:d1:d0:b0:49,23067388,212,4770,23067176,23067388
6951,4,1,1,2412,-67,-93,26,b0:e4:d5:32:ec:8a,23068047,1912,-1253,23066135,23068047
6952,4,11,1,2412,-77,-93,16,48:dd:0c:7d:86:25,23069901,377,1477,23069524,23069901
6953,4,1,1,2412,-68,-93,25,b0:e4:d5:32:ec:8a,23070647,1912,-1166,23068735,23070647
6954,4,1,1,2412,-67,-93,26,b0:e4:d5:32:ec:8a,23072677,1912,118,23070765,23072677
6955,4,1,1,2412,-86,-93,7,3c:bd:c5:ee:96:6d,23080431,3280,4474,23077151,23080431
6956,4,1,1,2412,-89,-93,4,,23083723,304,2988,23083419,23083723
6957,6,6,1,2412,-90,-93,3,,23086810,44,3043,23086766,23086810
6958,4,1,1,2412,-87,-93,6,,23089099,304,1985,23088795,23089099
6959,6,6,1,2412,-91,-93,2,,23090642,44,1499,23090598,23090642
6960,4,1,1,2412,-89,-93,4,,23091272,304,326,23090968,23091272
6961,6,6,1,2412,-89,-93,4,e2:db:d1:d1:b0:4a,23091546,68,206,23091478,23091546
6962,4,1,1,2412,-67,-93,26,b0:e4:d5:32:ec:8a,23094736,1960,1230,23092776,23094736
6963,4,1,1,2412,-83,-93,10,bc:98:df:ff:0f:8b,23098906,2568,1602,23096338,23098906
6964,4,1,1,2412,-87,-93,6,,23104189,304,4979,23103885,23104189
6965,4,11,1,2412,-74,-93,19,4c:01:43:d7:f3:29,23104998,362,447,23104636,23104998
6966,4,11,1,2412,-83,-93,10,4c:01:43:d7:f3:23,23105372,322,52,23105050,23105372
6967,4,11,1,2412,-83,-93,10,4c:01:43:d7:f3:26,23105707,387,-52,23105320,23105707
6968,6,6,1,2412,-86,-93,7,,23107129,44,1378,23107085,23107129
6969,6,6,1,2412,-66,-93,27,10:86:8c:5f:93:1e,23107496,344,23,23107152,23107496
6970,4,11,1,2412,-90,-93,3,48:dd:0c:92:4b:e7,23108055,362,197,23107693,23108055
6971,6,24,1,2412,-83,-93,10,,23111151,28,3068,23111123,23111151
6972,4,1,1,2412,-88,-93,5,78:67:0e:38:6c:d3,23116690,2736,2803,23113954,23116690
6973,4,11,1,2412,-75,-93,18,48:dd:0c:7d:86:27,23119450,362,2398,23119088,23119450
6974,4,11,1,2412,-73,-93,20,48:dd:0c:7d:86:23,23119824,323,51,23119501,23119824
6975,4,11,1,2412,-75,-93,18,48:dd:0c:7d:86:25,23120159,382,-47,23119777,23120159
6976,6,24,1,2412,-85,-93,8,,23124349,28,4162,23124321,23124349
6977,6,6,1,2412,-91,-93,2,e2:db:d1:d1:b0:4a,23135268,444,10475,23134824,23135268
6978,4,11,1,2412,-83,-93,10,4c:01:43:ec:a0:69,23143091,361,7462,23142730,23143091
6979,4,11,1,2412,-82,-93,11,4c:01:43:ec:a0:63,23143465,322,52,23143143,23143465
6980,4,11,1,2412,-83,-93,10,4c:01:43:ec:a0:66,23143799,387,-53,23143412,23143799
6981,4,11,1,2412,-84,-93,9,48:dd:0c:90:e3:87,23144511,362,350,23144149,23144511
6982,4,11,1,2412,-86,-93,7,48:dd:0c:90:e3:83,23144886,323,52,23144563,23144886
6983,4,11,1,2412,-83,-93,10,48:dd:0c:90:e3:85,23145221,382,-47,23144839,23145221
6984,6,6,1,2412,-89,-93,4,e2:db:d1:d1:b0:4a,23154729,52,9456,23154677,23154729
6985,4,1,1,2412,-88,-93,5,,23160136,304,5103,23159832,23160136
6986,6,6,1,2412,-88,-93,5,,23173368,44,13188,23173324,23173368
6987,6,6,1,2412,-89,-93,4,,23178678,44,5266,23178634,23178678
6988,6,6,1,2412,-89,-93,4,3c:bd:c5:ee:96:6d,23180492,68,1746,23180424,23180492
6989,4,11,1,2412,-72,-93,21,48:dd:0c:7d:86:23,23183729,254,2983,23183475,23183729
6990,6,6,1,2412,-64,-93,29,b4:e6:2d:b4:ff:71,23189383,64,5590,23189319,23189383
6991,6,6,1,2412,-64,-93,29,b4:e6:2d:b4:ff:71,23189671,64,224,23189607,23189671
6992,6,6,1,2412,-63,-93,30,b4:e6:2d:b4:ff:71,23189833,64,98,23189769,23189833
6993,6,6,1,2412,-63,-93,30,b4:e6:2d:b4:ff:71,23190049,64,152,23189985,23190049
6994,6,6,1,2412,-64,-93,29,b4:e6:2d:b4:ff:71,23190256,64,143,23190192,23190256
6995,6,6,1,2412,-64,-93,29,b4:e6:2d:b4:ff:71,23190418,64,98,23190354,23190418
6996,4,1,1,2412,-66,-93,27,b4:e6:2d:b4:ff:71,23190762,416,-72,23190346,23190762
6997,4,1,1,2412,-65,-93,28,b4:e6:2d:b4:ff:71,23191312,416,134,23190896,23191312
6998,4,1,1,2412,-65,-93,28,,23191739,304,123,23191435,23191739
6999,4,1,1,2412,-67,-93,26,b0:e4:d5:32:ec:8a,23197135,1960,3436,23195175,23197135
7000,6,6,1,2412,-66,-93,27,10:86:8c:5f:93:1e,23201193,344,3714,23200849,23201193
7001,6,24,1,2412,-84,-93,9,,23203732,28,2511,23203704,23203732
7002,4,1,1,2412,-54,-93,39,94:a6:7e:c9:98:67,23204112,2464,-2084,23201648,23204112
7003,4,11,1,2412,-84,-93,9,4c:01:43:d7:f3:29,23207397,362,2923,23207035,23207397
7004,4,1,1,2412,-87,-93,6,bc:98:df:ff:0f:8b,23209850,976,1477,23208874,23209850
7005,6,6,1,2412,-90,-93,3,,23213014,44,3120,23212970,23213014
7006,4,1,1,2412,-92,-93,1,,23215163,304,1845,23214859,23215163
7007,4,1,1,2412,-90,-93,3,bc:98:df:ff:0f:8b,23216490,432,895,23216058,23216490
7008,4,11,1,2412,-74,-93,19,48:dd:0c:7d:86:27,23221867,362,5015,23221505,23221867
7009,4,11,1,2412,-72,-93,21,48:dd:0c:7d:86:23,23222241,323,51,23221918,23222241
7010,4,11,1,2412,-70,-93,23,48:dd:0c:7d:86:25,23222576,382,-47,23222194,23222576
7011,4,1,1,2412,-89,-93,4,,23223197,304,317,23222893,23223197
7012,6,6,1,2412,-84,-93,9,40:b0:34:b7:01:d5,23225000,576,1227,23224424,23225000
7013,6,6,1,2412,-64,-93,29,12:86:8c:5f:93:1e,23227688,332,2356,23227356,23227688
7014,6,6,1,2412,-63,-93,30,b4:e6:2d:b4:ff:71,23233305,64,5553,23233241,23233305
7015,6,6,1,2412,-64,-93,29,b4:e6:2d:b4:ff:71,23236278,64,2909,23236214,23236278
7016,6,6,1,2412,-64,-93,29,b4:e6:2d:b4:ff:71,23236608,64,266,23236544,23236608
7017,4,1,1,2412,-63,-93,30,b4:e6:2d:b4:ff:71,23236988,416,-36,23236572,23236988
7018,4,1,1,2412,-64,-93,29,b4:e6:2d:b4:ff:71,23237783,416,379,23237367,23237783
7019,4,1,1,2412,-64,-93,29,b4:e6:2d:b4:ff:71,23238315,416,116,23237899,23238315
7020,4,1,1,2412,-64,-93,29,b4:e6:2d:b4:ff:71,23238865,416,134,23238449,23238865
7021,4,1,1,2412,-65,-93,28,b4:e6:2d:b4:ff:71,23239442,416,161,23239026,23239442
7022,6,6,1,2412,-64,-93,29,b4:e6:2d:b4:ff:71,23240179,64,673,23240115,23240179
7023,6,6,1,2412,-64,-93,29,,23240259,44,36,23240215,23240259
7024,4,11,1,2412,-83,-93,10,4c:01:43:ec:a0:69,23245490,361,4870,23245129,23245490
7025,4,11,1,2412,-83,-93,10,4c:01:43:ec:a0:63,23245864,322,52,23245542,23245864
7026,4,11,1,2412,-82,-93,11,4c:01:43:ec:a0:66,23246198,387,-53,23245811,23246198
7027,4,11,1,2412,-82,-93,11,48:dd:0c:90:e3:87,23246911,362,351,23246549,23246911
7028,4,11,1,2412,-82,-93,11,48:dd:0c:90:e3:83,23247285,323,51,23246962,23247285
7029,4,11,1,2412,-83,-93,10,48:dd:0c:90:e3:85,23247621,382,-46,23247239,23247621
7030,4,1,1,2412,-94,-93,-1,40:ca:63:2d:74:be,23248740,1896,-777,23246844,23248740
7031,6,6,1,2412,-65,-93,28,52:86:8c:5f:93:1e,23255742,332,6670,23255410,23255742
7032,4,1,1,2412,-88,-93,5,78:67:0e:c4:a8:42,23259118,2736,640,23256382,23259118
7033,4,1,1,2412,-91,-93,2,,23268381,304,8959,23268077,23268381
7034,4,1,1,2412,-92,-93,1,,23272733,304,4048,23272429,23272733
7035,4,1,1,2412,-92,-93,1,,23274109,304,1072,23273805,23274109
7036,4,1,1,2412,-89,-93,4,78:67:0e:c4:a8:42,23274573,352,112,23274221,23274573
7037,4,1,1,2412,-92,-93,1,,23286877,304,12000,23286573,23286877
7038,4,1,1,2412,-88,-93,5,78:67:0e:c4:a8:42,23294626,3472,4277,23291154,23294626
7039,4,1,1,2412,-70,-93,23,b0:e4:d5:32:ec:8a,23299535,1960,2949,23297575,23299535
7040,4,1,1,2412,-53,-93,40,94:a6:7e:c9:98:67,23306531,2464,4532,23304067,23306531
7041,4,11,1,2412,-89,-93,4,4c:01:43:d7:f3:23,23310172,322,3319,23309850,23310172
7042,4,11,1,2412,-86,-93,7,48:dd:0c:92:4b:e3,23313229,323,2734,23312906,23313229
7043,6,24,1,2412,-86,-93,7,,23321035,28,7778,23321007,23321035
7044,4,11,1,2412,-67,-93,26,48:dd:0c:7d:86:27,23324249,362,2852,23323887,23324249
7045,4,11,1,2412,-69,-93,24,48:dd:0c:7d:86:23,23324624,323,52,23324301,23324624
7046,4,11,1,2412,-69,-93,24,48:dd:0c:7d:86:25,23324959,382,-47,23324577,23324959
7047,4,1,1,2412,-92,-93,1,70:3a:cb:63:35:b2,23329512,2216,2337,23327296,23329512
7048,6,6,1,2412,-65,-93,28,12:86:8c:5f:93:1e,23346108,332,16264,23345776,23346108
7049,4,11,1,2412,-83,-93,10,4c:01:43:ec:a0:63,23348263,322,1833,23347941,23348263
7050,4,11,1,2412,-83,-93,10,4c:01:43:ec:a0:66,23348597,387,-53,23348210,23348597
7051,4,11,1,2412,-80,-93,13,48:dd:0c:90:e3:83,23349685,323,765,23349362,23349685
7052,6,24,1,2412,-85,-93,8,,23353859,28,4146,23353831,23353859
7053,4,1,1,2412,-87,-93,6,78:67:0e:c4:a8:42,23361608,2736,5013,23358872,23361608
7054,4,1,1,2412,-88,-93,5,78:67:0e:c4:a8:42,23365513,2232,1673,23363281,23365513
7055,4,1,1,2412,-91,-93,2,78:67:0e:38:6c:d3,23372822,3472,3837,23369350,23372822
7056,4,11,1,2412,-88,-93,5,4c:01:43:d7:f3:26,23376661,383,3456,23376278,23376661
7057,4,1,1,2412,-90,-93,3,,23379644,304,2679,23379340,23379644
7058,6,6,1,2412,-65,-93,28,32:86:8c:5f:93:1e,23380395,332,419,23380063,23380395
7059,4,11,1,2412,-86,-93,7,4c:01:43:ec:a0:66,23383195,382,2418,23382813,23383195
7060,6,6,1,2412,-65,-93,28,,23388102,44,4863,23388058,23388102
7061,6,24,1,2412,-84,-93,9,,23396632,28,8502,23396604,23396632
7062,4,1,1,2412,-70,-93,23,b0:e4:d5:32:ec:8a,23401934,1960,3342,23399974,23401934
7063,6,6,1,2412,-67,-93,26,10:86:8c:5f:93:1e,23408521,344,6243,23408177,23408521
7064,4,1,1,2412,-53,-93,40,94:a6:7e:c9:98:67,23409084,2464,-1901,23406620,23409084
7065,4,1,1,2412,-88,-93,5,,23413692,304,4304,23413388,23413692
7066,4,1,1,2412,-89,-93,4,78:67:0e:38:6c:d3,23423891,2736,7463,23421155,23423891
7067,4,11,1,2412,-68,-93,25,48:dd:0c:7d:86:27,23426650,362,2397,23426288,23426650
7068,4,11,1,2412,-69,-93,24,48:dd:0c:7d:86:23,23427025,323,52,23426702,23427025
7069,4,11,1,2412,-68,-93,25,48:dd:0c:7d:86:25,23427360,382,-47,23426978,23427360
7070,6,6,1,2412,-67,-93,26,12:86:8c:5f:93:1e,23431712,332,4020,23431380,23431712
7071,6,24,1,2412,-86,-93,7,,23448991,28,17251,23448963,23448991
7072,4,11,1,2412,-88,-93,5,4c:01:43:ec:a0:69,23450288,361,936,23449927,23450288
7073,4,11,1,2412,-88,-93,5,4c:01:43:ec:a0:66,23450996,387,321,23450609,23450996
7074,4,11,1,2412,-82,-93,11,48:dd:0c:90:e3:87,23451710,362,352,23451348,23451710
7075,4,11,1,2412,-82,-93,11,48:dd:0c:90:e3:83,23452085,323,52,23451762,23452085
7076,4,11,1,2412,-82,-93,11,48:dd:0c:90:e3:85,23452420,382,-47,23452038,23452420
7077,4,1,1,2412,-91,-93,2,78:67:0e:c4:a8:42,23463917,2736,8761,23461181,23463917
7078,4,1,1,2412,-89,-93,4,,23468636,304,4415,23468332,23468636
7079,6,6,1,2412,-89,-93,4,e2:db:d1:d1:b0:4a,23468897,68,193,23468829,23468897
7080,6,24,1,2412,-87,-93,6,,23477167,28,8242,23477139,23477167
7081,6,6,1,2412,-66,-93,27,32:86:8c:5f:93:1e,23482795,332,5296,23482463,23482795
7082,4,11,1,2412,-85,-93,8,4c:01:43:ec:a0:63,23499932,254,16883,23499678,23499932
7083,4,1,1,2412,-67,-93,26,b0:e4:d5:32:ec:8a,23504333,1960,2441,23502373,23504333
7084,4,1,1,2412,-52,-93,41,94:a6:7e:c9:98:67,23511317,2464,4520,23508853,23511317
7085,4,11,1,2412,-87,-93,6,4c:01:43:d7:f3:29,23514596,362,2917,23514234,23514596
7086,4,11,1,2412,-88,-93,5,4c:01:43:d7:f3:26,23515305,387,322,23514918,23515305
7087,4,1,1,2412,-88,-93,5,78:67:0e:38:6c:d3,23526291,2736,8250,23523555,23526291
7088,4,11,1,2412,-71,-93,22,48:dd:0c:7d:86:27,23529050,362,2397,23528688,23529050
7089,4,11,1,2412,-71,-93,22,48:dd:0c:7d:86:23,23529425,323,52,23529102,23529425
7090,4,11,1,2412,-70,-93,23,48:dd:0c:7d:86:25,23529760,382,-47,23529378,23529760
7091,6,6,1,2412,-64,-93,29,12:86:8c:5f:93:1e,23533996,332,3904,23533664,23533996
7092,4,11,1,2412,-85,-93,8,4c:01:43:ec:a0:69,23552822,361,18465,23552461,23552822
7093,4,11,1,2412,-85,-93,8,4c:01:43:ec:a0:63,23553196,322,52,23552874,23553196
7094,4,11,1,2412,-83,-93,10,48:dd:0c:90:e3:87,23554193,362,635,23553831,23554193
7095,4,11,1,2412,-83,-93,10,48:dd:0c:90:e3:83,23554568,323,52,23554245,23554568
7096,4,11,1,2412,-84,-93,9,48:dd:0c:90:e3:85,23554903,382,-47,23554521,23554903
7097,6,6,1,2412,-62,-93,31,32:86:8c:5f:93:1e,23585231,332,29996,23584899,23585231
7098,4,1,1,2412,-89,-93,4,,23588219,304,2684,23587915,23588219
7099,6,6,1,2412,-89,-93,4,,23588444,44,181,23588400,23588444
7100,4,1,1,2412,-87,-93,6,78:67:0e:c4:a8:42,23592474,352,3678,23592122,23592474
7101,4,1,1,2412,-87,-93,6,78:67:0e:c4:a8:42,23593457,352,631,23593105,23593457
7102,4,1,1,2412,-83,-93,10,78:67:0e:c4:a8:42,23594368,352,559,23594016,23594368
7103,4,1,1,2412,-87,-93,6,78:67:0e:c4:a8:42,23598569,352,3849,23598217,23598569
7104,4,1,1,2412,-85,-93,8,,23599958,304,1085,23599654,23599958
7105,4,1,1,2412,-70,-93,23,b0:e4:d5:32:ec:8a,23606732,1960,4814,23604772,23606732
7106,6,6,1,2412,-68,-93,25,10:86:8c:5f:93:1e,23610827,344,3751,23610483,23610827
7107,4,1,1,2412,-44,-93,49,94:a6:7e:c9:98:67,23613946,2464,655,23611482,23613946
7108,4,1,1,2412,-87,-93,6,,23619641,304,5391,23619337,23619641
7109,4,1,1,2412,-85,-93,8,78:67:0e:c4:a8:42,23621108,352,1115,23620756,23621108
7110,4,1,1,2412,-87,-93,6,78:67:0e:c4:a8:42,23622089,352,629,23621737,23622089
7111,4,1,1,2412,-86,-93,7,78:67:0e:c4:a8:42,23623349,352,908,23622997,23623349
7112,4,1,1,2412,-88,-93,5,78:67:0e:c4:a8:42,23624600,352,899,23624248,23624600
7113,4,1,1,2412,-86,-93,7,78:67:0e:c4:a8:42,23625941,352,989,23625589,23625941
7114,4,11,1,2412,-85,-93,8,,23627555,107,1507,23627448,23627555
7115,6,24,1,2412,-84,-93,9,78:67:0e:c4:a8:42,23627668,32,81,23627636,23627668
7116,6,24,1,2412,-83,-93,10,78:67:0e:c4:a8:42,23628138,32,438,23628106,23628138
7117,4,11,1,2412,-78,-93,15,48:dd:0c:7d:86:27,23631451,362,2951,23631089,23631451
7118,4,11,1,2412,-78,-93,15,48:dd:0c:7d:86:23,23631825,323,51,23631502,23631825
7119,4,11,1,2412,-78,-93,15,48:dd:0c:7d:86:25,23632161,382,-46,23631779,23632161
7120,6,6,1,2412,-83,-93,10,40:b0:34:b7:01:d5,23634605,576,1868,23634029,23634605
7121,6,6,1,2412,-66,-93,27,12:86:8c:5f:93:1e,23636397,332,1460,23636065,23636397
7122,4,1,1,2412,-81,-93,12,70:3a:cb:63:35:b2,23636921,2216,-1692,23634705,23636921
7123,6,6,1,2412,-89,-93,4,,23646901,44,9936,23646857,23646901
7124,6,6,1,2412,-89,-93,4,e2:db:d1:d1:b0:4b,23648075,408,766,23647667,23648075
7125,6,6,1,2412,-87,-93,6,e2:db:d1:d1:b0:4f,23649202,408,719,23648794,23649202
7126,6,6,1,2412,-89,-93,4,e2:db:d1:d1:b0:4a,23650228,52,974,23650176,23650228
7127,4,1,1,2412,-86,-93,7,,23652379,304,1847,23652075,23652379
7128,4,11,1,2412,-84,-93,9,4c:01:43:ec:a0:63,23655459,322,2758,23655137,23655459
7129,4,1,1,2412,-88,-93,5,,23656184,304,421,23655880,23656184
7130,4,11,1,2412,-84,-93,9,48:dd:0c:90:e3:87,23656510,362,-36,23656148,23656510
7131,4,11,1,2412,-82,-93,11,48:dd:0c:90:e3:85,23657220,382,328,23656838,23657220
7132,4,1,1,2412,-87,-93,6,,23659302,304,1778,23658998,23659302
7133,4,1,1,2412,-88,-93,5,78:67:0e:c4:a8:42,23671508,2240,9966,23669268,23671508
7134,4,1,1,2412,-88,-93,5,78:67:0e:c4:a8:42,23687615,352,15755,23687263,23687615
7135,6,6,1,2412,-68,-93,25,32:86:8c:5f:93:1e,23688273,332,326,23687941,23688273
7136,4,1,1,2412,-88,-93,5,78:67:0e:c4:a8:42,23688691,352,66,23688339,23688691
7137,4,1,1,2412,-87,-93,6,78:67:0e:c4:a8:42,23691175,352,2132,23690823,23691175
7138,6,6,1,2412,-64,-93,29,10:86:8c:5f:93:1e,23715730,344,24211,23715386,23715730
7139,4,1,1,2412,-63,-93,30,94:a6:7e:c9:98:67,23716228,2464,-1966,23713764,23716228
7140,4,1,1,2412,-90,-93,3,,23721051,304,4519,23720747,23721051
7141,4,11,1,2412,-83,-93,10,48:dd:0c:92:4b:e3,23722828,323,1454,23722505,23722828
7142,4,11,1,2412,-66,-93,27,48:dd:0c:7d:86:27,23733851,362,10661,23733489,23733851
7143,4,11,1,2412,-65,-93,28,48:dd:0c:7d:86:23,23734225,323,51,23733902,23734225
7144,4,11,1,2412,-65,-93,28,48:dd:0c:7d:86:25,23734560,382,-47,23734178,23734560
7145,6,6,1,2412,-84,-93,9,40:b0:34:b7:01:d5,23737518,576,2382,23736942,23737518
7146,6,6,1,2412,-90,-93,3,e2:db:d1:d1:b0:4a,23751546,548,13480,23750998,23751546
7147,4,1,1,2412,-88,-93,5,bc:98:df:ff:0f:8b,23752195,3176,-2527,23749019,23752195
7148,4,11,1,2412,-85,-93,8,4c:01:43:ec:a0:69,23757484,361,4928,23757123,23757484
7149,4,11,1,2412,-85,-93,8,4c:01:43:ec:a0:66,23758192,387,321,23757805,23758192
7150,4,11,1,2412,-80,-93,13,48:dd:0c:90:e3:87,23758909,362,355,23758547,23758909
7151,4,11,1,2412,-80,-93,13,48:dd:0c:90:e3:83,23759284,323,52,23758961,23759284
7152,4,11,1,2412,-81,-93,12,48:dd:0c:90:e3:85,23759619,382,-47,23759237,23759619
7153,6,6,1,2412,-88,-93,5,,23781262,44,21599,23781218,23781262
7154,4,1,1,2412,-93,-93,0,,23783291,304,1725,23782987,23783291
7155,4,1,1,2412,-92,-93,1,,23791195,304,7600,23790891,23791195
7156,4,1,1,2412,-75,-93,18,b0:e4:d5:32:ec:8a,23811531,1960,18376,23809571,23811531
7157,4,1,1,2412,-53,-93,40,94:a6:7e:c9:98:67,23818524,2464,4529,23816060,23818524
7158,6,6,1,2412,-67,-93,26,10:86:8c:5f:93:1e,23820855,344,1987,23820511,23820855
7159,4,11,1,2412,-86,-93,7,4c:01:43:d7:f3:29,23821795,362,578,23821433,23821795
7160,4,11,1,2412,-87,-93,6,4c:01:43:d7:f3:23,23822169,322,52,23821847,23822169
7161,4,11,1,2412,-85,-93,8,48:dd:0c:92:4b:e7,23824853,362,2322,23824491,23824853
7162,4,11,1,2412,-85,-93,8,48:dd:0c:92:4b:e5,23825563,382,328,23825181,23825563
7163,6,24,1,2412,-86,-93,7,,23831166,28,5575,23831138,23831166
7164,4,11,1,2412,-72,-93,21,48:dd:0c:7d:86:27,23836250,362,4722,23835888,23836250
7165,4,11,1,2412,-71,-93,22,48:dd:0c:7d:86:23,23836625,323,52,23836302,23836625
7166,4,11,1,2412,-72,-93,21,48:dd:0c:7d:86:25,23836960,382,-47,23836578,23836960
7167,6,6,1,2412,-76,-93,17,40:b0:34:b7:01:d5,23839407,576,1871,23838831,23839407
7168,6,6,1,2412,-69,-93,24,12:86:8c:5f:93:1e,23841230,332,1491,23840898,23841230
7169,4,11,1,2412,-84,-93,9,48:dd:0c:90:e3:83,23861684,323,20131,23861361,23861684
7170,4,1,1,2412,-88,-93,5,3c:bd:c5:ee:96:6d,23869486,1640,6162,23867846,23869486
7171,6,6,1,2412,-88,-93,5,0a:a7:c0:a3:8d:75,23872561,408,2667,23872153,23872561
7172,4,1,1,2412,-84,-93,9,78:67:0e:c4:a8:42,23873517,2736,-1780,23870781,23873517
7173,6,6,1,2412,-68,-93,25,32:86:8c:5f:93:1e,23892462,332,18613,23892130,23892462
7174,6,24,1,2412,-87,-93,6,,23911165,28,18675,23911137,23911165
7175,4,11,1,2412,-89,-93,4,4c:01:43:ec:a0:63,23912823,277,1381,23912546,23912823
7176,4,1,1,2412,-65,-93,28,b0:e4:d5:32:ec:8a,23913930,1960,-853,23911970,23913930
7177,4,1,1,2412,-94,-93,-1,bc:98:df:ff:0f:8b,23918103,2568,1605,23915535,23918103
7178,6,6,1,2412,-68,-93,25,10:86:8c:5f:93:1e,23920527,344,2080,23920183,23920527
7179,4,1,1,2412,-58,-93,35,94:a6:7e:c9:98:67,23921081,2464,-1910,23918617,23921081
7180,4,11,1,2412,-83,-93,10,48:dd:0c:92:4b:e7,23927253,362,5810,23926891,23927253
7181,4,11,1,2412,-84,-93,9,48:dd:0c:92:4b:e3,23927628,323,52,23927305,23927628
7182,4,11,1,2412,-85,-93,8,48:dd:0c:92:4b:e5,23927963,382,-47,23927581,23927963
7183,4,1,1,2412,-91,-93,2,,23933658,304,5391,23933354,23933658
7184,6,6,1,2412,-84,-93,9,40:b0:34:b7:01:d5,23941808,576,7574,23941232,23941808
7185,6,24,1,2412,-84,-93,9,,23947439,28,5603,23947411,23947439
7186,4,1,1,2412,-90,-93,3,00:26:62:eb:ea:74,23951955,968,3548,23950987,23951955
7187,6,24,1,2412,-83,-93,10,,23955160,28,3177,23955132,23955160
7188,4,11,1,2412,-86,-93,7,4c:01:43:ec:a0:69,23962282,361,6761,23961921,23962282
7189,4,11,1,2412,-86,-93,7,4c:01:43:ec:a0:63,23962656,322,52,23962334,23962656
7190,4,11,1,2412,-84,-93,9,48:dd:0c:90:e3:87,23963709,362,691,23963347,23963709
7191,4,11,1,2412,-85,-93,8,48:dd:0c:90:e3:83,23964084,323,52,23963761,23964084
7192,4,1,1,2412,-85,-93,8,78:67:0e:c4:a8:42,23975917,2736,9097,23973181,23975917
7193,4,1,1,2412,-86,-93,7,78:67:0e:c4:a8:42,23978691,848,1926,23977843,23978691
7194,6,6,1,2412,-68,-93,25,52:86:8c:5f:93:1e,23979394,332,371,23979062,23979394
7195,4,1,1,2412,-92,-93,1,,23989946,304,10248,23989642,23989946
7196,6,24,1,2412,-83,-93,10,,24006647,28,16673,24006619,24006647
7197,4,1,1,2412,-71,-94,23,b0:e4:d5:32:ec:8a,24016330,1960,7723,24014370,24016330
7198,4,1,1,2412,-46,-94,48,94:a6:7e:c9:98:67,24023418,2464,4624,24020954,24023418
7199,4,11,1,2412,-88,-94,6,4c:01:43:d7:f3:26,24027303,387,3498,24026916,24027303
7200,4,11,1,2412,-86,-94,8,48:dd:0c:92:4b:e7,24029653,362,1988,24029291,24029653
7201,4,11,1,2412,-86,-94,8,48:dd:0c:92:4b:e3,24030028,323,52,24029705,24030028
7202,4,11,1,2412,-86,-94,8,48:dd:0c:92:4b:e5,24030363,382,-47,24029981,24030363
7203,4,1,1,2412,-86,-94,8,78:67:0e:38:6c:d3,24038292,2736,5193,24035556,24038292
7204,4,11,1,2412,-65,-94,29,48:dd:0c:7d:86:27,24041051,362,2397,24040689,24041051
7205,4,11,1,2412,-67,-94,27,48:dd:0c:7d:86:23,24041426,323,52,24041103,24041426
7206,4,11,1,2412,-67,-94,27,48:dd:0c:7d:86:25,24041761,382,-47,24041379,24041761
7207,6,6,1,2412,-69,-94,25,12:86:8c:5f:93:1e,24046061,332,3968,24045729,24046061
7208,4,11,1,2412,-82,-94,12,48:dd:0c:90:e3:87,24066109,362,19686,24065747,24066109
7209,4,11,1,2412,-82,-94,12,48:dd:0c:90:e3:83,24066483,323,51,24066160,24066483
7210,4,11,1,2412,-82,-94,12,48:dd:0c:90:e3:85,24066818,382,-47,24066436,24066818
7211,6,6,1,2412,-67,-94,27,52:86:8c:5f:93:1e,24072600,332,5450,24072268,24072600
7212,4,1,1,2412,-76,-94,18,b8:09:8a:db:7b:89,24091978,664,18714,24091314,24091978
7213,6,6,1,2412,-69,-94,25,32:86:8c:5f:93:1e,24097200,332,4890,24096868,24097200
7214,4,1,1,2412,-89,-94,5,78:67:0e:c4:a8:42,24104994,352,7442,24104642,24104994
7215,4,11,1,2412,-88,-94,6,,24106662,107,1561,24106555,24106662
7216,6,24,1,2412,-85,-94,9,78:67:0e:c4:a8:42,24106776,32,82,24106744,24106776
7217,4,11,1,2412,-87,-94,7,,24107210,107,327,24107103,24107210
7218,6,24,1,2412,-84,-94,10,78:67:0e:c4:a8:42,24107335,32,93,24107303,24107335
7219,4,1,1,2412,-75,-94,19,b8:09:8a:db:7b:89,24114995,664,6996,24114331,24114995
7220,4,1,1,2412,-75,-94,19,b0:e4:d5:32:ec:8a,24118729,1960,1774,24116769,24118729
7221,4,1,1,2412,-46,-94,48,94:a6:7e:c9:98:67,24125830,2464,4637,24123366,24125830
7222,6,6,1,2412,-67,-94,27,10:86:8c:5f:93:1e,24128150,344,1976,24127806,24128150
7223,4,11,1,2412,-88,-94,6,4c:01:43:d7:f3:29,24128993,362,481,24128631,24128993
7224,4,11,1,2412,-88,-94,6,4c:01:43:d7:f3:23,24129368,322,53,24129046,24129368
7225,4,11,1,2412,-89,-94,5,4c:01:43:d7:f3:26,24129702,387,-53,24129315,24129702
7226,4,11,1,2412,-74,-94,20,48:dd:0c:7d:86:27,24143522,362,13458,24143160,24143522
7227,4,11,1,2412,-75,-94,19,48:dd:0c:7d:86:23,24143896,323,51,24143573,24143896
7228,4,11,1,2412,-73,-94,21,48:dd:0c:7d:86:25,24144232,382,-46,24143850,24144232
7229,4,1,1,2412,-87,-94,7,,24145784,304,1248,24145480,24145784
7230,6,6,1,2412,-66,-94,28,12:86:8c:5f:93:1e,24150775,332,4659,24150443,24150775
7231,4,1,1,2412,-89,-94,5,78:67:0e:c4:a8:42,24158526,352,7399,24158174,24158526
7232,6,24,1,2412,-85,-94,9,,24164851,28,6297,24164823,24164851
7233,4,11,1,2412,-84,-94,10,4c:01:43:ec:a0:69,24167080,361,1868,24166719,24167080
7234,4,11,1,2412,-85,-94,9,4c:01:43:ec:a0:63,24167453,322,51,24167131,24167453
7235,4,11,1,2412,-82,-94,12,48:dd:0c:90:e3:87,24168508,362,693,24168146,24168508
7236,4,11,1,2412,-82,-94,12,48:dd:0c:90:e3:83,24168883,323,52,24168560,24168883
7237,4,11,1,2412,-82,-94,12,48:dd:0c:90:e3:85,24169218,382,-47,24168836,24169218
7238,6,6,1,2412,-61,-94,33,32:86:8c:5f:93:1e,24199601,332,30051,24199269,24199601
7239,6,6,1,2412,-90,-94,4,,24203926,44,4281,24203882,24203926
7240,6,24,1,2412,-89,-94,5,,24206661,28,2707,24206633,24206661
7241,4,1,1,2412,-68,-94,26,b0:e4:d5:32:ec:8a,24221128,1960,12507,24219168,24221128
7242,6,6,1,2412,-61,-94,33,10:86:8c:5f:93:1e,24227728,344,6256,24227384,24227728
7243,4,1,1,2412,-51,-94,43,94:a6:7e:c9:98:67,24228282,2464,-1910,24225818,24228282
7244,6,24,1,2412,-87,-94,7,,24231168,28,2858,24231140,24231168
7245,4,11,1,2412,-87,-94,7,4c:01:43:d7:f3:23,24231768,322,278,24231446,24231768
7246,4,11,1,2412,-88,-94,6,4c:01:43:d7:f3:26,24232103,387,-52,24231716,24232103
7247,4,1,1,2412,-88,-94,6,78:67:0e:38:6c:d3,24243093,2736,8254,24240357,24243093
7248,4,11,1,2412,-73,-94,21,48:dd:0c:7d:86:27,24245852,362,2397,24245490,24245852
7249,4,11,1,2412,-73,-94,21,48:dd:0c:7d:86:23,24246226,323,51,24245903,24246226
7250,4,11,1,2412,-73,-94,21,48:dd:0c:7d:86:25,24246561,382,-47,24246179,24246561
7251,6,6,1,2412,-66,-94,28,12:86:8c:5f:93:1e,24250902,332,4009,24250570,24250902
7252,6,24,1,2412,-87,-94,7,,24255737,28,4807,24255709,24255737
7253,4,11,1,2412,-85,-94,9,48:dd:0c:90:e3:83,24271283,323,15223,24270960,24271283
7254,4,11,1,2412,-84,-94,10,48:dd:0c:90:e3:85,24271618,382,-47,24271236,24271618
7255,6,24,1,2412,-85,-94,9,,24299327,28,27681,24299299,24299327
7256,6,6,1,2412,-64,-94,30,32:86:8c:5f:93:1e,24302048,332,2389,24301716,24302048
7257,6,24,1,2412,-87,-94,7,,24311171,28,9095,24311143,24311171
7258,4,1,1,2412,-72,-94,22,b0:e4:d5:32:ec:8a,24323527,1960,10396,24321567,24323527
7259,4,1,1,2412,-56,-94,38,94:a6:7e:c9:98:67,24330444,2464,4453,24327980,24330444
7260,4,11,1,2412,-88,-94,6,4c:01:43:d7:f3:29,24333792,362,2986,24333430,24333792
7261,4,11,1,2412,-88,-94,6,4c:01:43:d7:f3:23,24334167,322,53,24333845,24334167
7262,4,11,1,2412,-88,-94,6,4c:01:43:d7:f3:26,24334501,387,-53,24334114,24334501
7263,4,11,1,2412,-86,-94,8,48:dd:0c:92:4b:e7,24336853,362,1990,24336491,24336853
7264,4,11,1,2412,-84,-94,10,48:dd:0c:92:4b:e3,24337227,323,51,24336904,24337227
7265,4,11,1,2412,-84,-94,10,48:dd:0c:92:4b:e5,24337563,382,-46,24337181,24337563
7266,4,11,1,2412,-73,-94,21,48:dd:0c:7d:86:27,24348252,362,10327,24347890,24348252
7267,4,11,1,2412,-73,-94,21,48:dd:0c:7d:86:23,24348627,323,52,24348304,24348627
7268,4,11,1,2412,-73,-94,21,48:dd:0c:7d:86:25,24348962,382,-47,24348580,24348962
7269,6,6,1,2412,-86,-94,8,40:b0:34:b7:01:d5,24351412,576,1874,24350836,24351412
7270,6,6,1,2412,-68,-94,26,12:86:8c:5f:93:1e,24353202,332,1458,24352870,24353202
7271,4,1,1,2412,-91,-94,3,70:3a:cb:63:35:b2,24353726,2216,-1692,24351510,24353726
7272,4,11,1,2412,-85,-94,9,4c:01:43:ec:a0:69,24371877,361,17790,24371516,24371877
7273,4,11,1,2412,-88,-94,6,4c:01:43:ec:a0:63,24372251,322,52,24371929,24372251
7274,4,11,1,2412,-83,-94,11,48:dd:0c:90:e3:87,24373308,362,695,24372946,24373308
7275,4,11,1,2412,-83,-94,11,48:dd:0c:90:e3:83,24373682,323,51,24373359,24373682
7276,4,11,1,2412,-82,-94,12,48:dd:0c:90:e3:85,24374018,382,-46,24373636,24374018
7277,4,1,1,2412,-90,-94,4,3c:bd:c5:ee:96:6d,24378950,2512,2420,24376438,24378950
7278,6,6,1,2412,-65,-94,29,52:86:8c:5f:93:1e,24381317,332,2035,24380985,24381317
7279,6,6,1,2412,-90,-94,4,0a:a7:c0:a3:8d:71,24382120,408,395,24381712,24382120
7280,4,1,1,2412,-87,-94,7,78:67:0e:c4:a8:42,24385516,2736,660,24382780,24385516
7281,6,24,1,2412,-85,-94,9,,24403900,28,18356,24403872,24403900
7282,6,6,1,2412,-62,-94,32,32:86:8c:5f:93:1e,24404402,332,170,24404070,24404402
7283,6,6,1,2412,-90,-94,4,,24405687,44,1241,24405643,24405687
7284,4,1,1,2412,-66,-94,28,b0:e4:d5:32:ec:8a,24425927,1960,18280,24423967,24425927
7285,4,1,1,2412,-50,-94,44,94:a6:7e:c9:98:67,24433024,2464,4633,24430560,24433024
7286,6,24,1,2412,-86,-94,8,,24435323,28,2271,24435295,24435323
7287,6,6,1,2412,-66,-94,28,b4:e6:2d:b4:ff:71,24435705,64,318,24435641,24435705
7288,6,6,1,2412,-66,-94,28,b4:e6:2d:b4:ff:71,24435867,64,98,24435803,24435867
7289,4,11,1,2412,-88,-94,6,4c:01:43:d7:f3:29,24436192,362,-37,24435830,24436192
7290,4,11,1,2412,-85,-94,9,4c:01:43:d7:f3:23,24436566,322,52,24436244,24436566
7291,4,11,1,2412,-87,-94,7,4c:01:43:d7:f3:26,24436901,387,-52,24436514,24436901
7292,6,6,1,2412,-66,-94,28,b4:e6:2d:b4:ff:71,24437204,64,239,24437140,24437204
7293,6,6,1,2412,-66,-94,28,b4:e6:2d:b4:ff:71,24437429,64,161,24437365,24437429
7294,6,6,1,2412,-67,-94,27,b4:e6:2d:b4:ff:71,24437591,64,98,24437527,24437591
7295,4,1,1,2412,-69,-94,25,b4:e6:2d:b4:ff:71,24437926,416,-81,24437510,24437926
7296,4,1,1,2412,-68,-94,26,b4:e6:2d:b4:ff:71,24439032,416,690,24438616,24439032
7297,4,1,1,2412,-62,-94,32,,24439458,304,122,24439154,24439458
7298,4,11,1,2412,-88,-94,6,48:dd:0c:92:4b:e7,24439784,362,-36,24439422,24439784
7299,4,11,1,2412,-87,-94,7,48:dd:0c:92:4b:e3,24440158,323,51,24439835,24440158
7300,4,11,1,2412,-87,-94,7,48:dd:0c:92:4b:e5,24440493,382,-47,24440111,24440493
7301,4,11,1,2412,-69,-94,25,48:dd:0c:7d:86:27,24450652,362,9797,24450290,24450652
7302,4,11,1,2412,-68,-94,26,48:dd:0c:7d:86:23,24451027,323,52,24450704,24451027
7303,4,1,1,2412,-92,-94,2,70:3a:cb:63:35:b2,24455907,2216,2664,24453691,24455907
7304,6,6,1,2412,-62,-94,32,12:86:8c:5f:93:1e,24457979,332,1740,24457647,24457979
7305,6,24,1,2412,-81,-94,13,,24471246,28,13239,24471218,24471246
7306,4,11,1,2412,-89,-94,5,48:dd:0c:90:e3:87,24475708,362,4100,24475346,24475708
7307,4,11,1,2412,-90,-94,4,48:dd:0c:90:e3:83,24476082,323,51,24475759,24476082
7308,4,11,1,2412,-90,-94,4,48:dd:0c:90:e3:85,24476417,382,-47,24476035,24476417
7309,6,6,1,2412,-64,-94,30,52:86:8c:5f:93:1e,24481271,332,4522,24480939,24481271
7310,6,24,1,2412,-81,-94,13,,24485904,28,4605,24485876,24485904
7311,4,1,1,2412,-89,-94,5,78:67:0e:c4:a8:42,24487916,2736,-724,24485180,24487916
7312,6,6,1,2412,-69,-94,25,32:86:8c:5f:93:1e,24506833,332,18585,24506501,24506833
7313,6,24,1,2412,-86,-94,8,,24508858,28,1997,24508830,24508858
7314,4,11,1,2412,-86,-94,8,48:dd:0c:90:e3:83,24519029,254,9917,24518775,24519029
7315,4,11,1,2412,-89,-94,5,48:dd:0c:92:4b:e3,24519607,254,324,24519353,24519607
7316,4,1,1,2412,-70,-94,24,b0:e4:d5:32:ec:8a,24528326,1960,6759,24526366,24528326
7317,4,1,1,2412,-52,-94,42,94:a6:7e:c9:98:67,24535672,2464,4882,24533208,24535672
7318,4,11,1,2412,-87,-94,7,48:dd:0c:92:4b:e7,24541653,362,5619,24541291,24541653
7319,4,11,1,2412,-87,-94,7,48:dd:0c:92:4b:e3,24542027,323,51,24541704,24542027
7320,4,11,1,2412,-87,-94,7,48:dd:0c:92:4b:e5,24542362,382,-47,24541980,24542362
7321,4,11,1,2412,-65,-94,29,48:dd:0c:7d:86:27,24550592,362,7868,24550230,24550592
7322,4,11,1,2412,-64,-94,30,48:dd:0c:7d:86:23,24550967,323,52,24550644,24550967
7323,4,11,1,2412,-64,-94,30,48:dd:0c:7d:86:25,24551302,382,-47,24550920,24551302
7324,6,6,1,2412,-78,-94,16,40:b0:34:b7:01:d5,24556214,576,4336,24555638,24556214
7325,6,6,1,2412,-67,-94,27,12:86:8c:5f:93:1e,24558003,332,1457,24557671,24558003
7326,4,1,1,2412,-80,-94,14,00:26:62:eb:ea:74,24566023,968,7052,24565055,24566023
7327,4,1,1,2412,-87,-94,7,78:67:0e:c4:a8:42,24574639,3472,5144,24571167,24574639
7328,4,11,1,2412,-84,-94,10,48:dd:0c:90:e3:87,24578107,362,3106,24577745,24578107
7329,4,11,1,2412,-83,-94,11,48:dd:0c:90:e3:83,24578482,323,52,24578159,24578482
7330,4,11,1,2412,-83,-94,11,48:dd:0c:90:e3:85,24578817,382,-47,24578435,24578817
7331,4,1,1,2412,-87,-94,7,78:67:0e:38:6c:d3,24595872,3472,13583,24592400,24595872
7332,4,1,1,2412,-90,-94,4,78:67:0e:c4:a8:42,24602461,2232,4357,24600229,24602461
7333,4,1,1,2412,-89,-94,5,78:67:0e:c4:a8:42,24604704,2240,3,24602464,24604704
7334,6,6,1,2412,-66,-94,28,b4:e6:2d:b4:ff:71,24616713,64,11945,24616649,24616713
7335,6,6,1,2412,-66,-94,28,,24616793,44,36,24616749,24616793
7336,4,1,1,2412,-54,-94,40,94:a6:7e:c9:98:67,24637910,2464,18653,24635446,24637910
7337,4,11,1,2412,-86,-94,8,4c:01:43:d7:f3:29,24640991,362,2719,24640629,24640991
7338,4,11,1,2412,-85,-94,9,4c:01:43:d7:f3:23,24641365,322,52,24641043,24641365
7339,4,11,1,2412,-85,-94,9,4c:01:43:d7:f3:26,24641700,387,-52,24641313,24641700
7340,4,11,1,2412,-89,-94,5,48:dd:0c:92:4b:e7,24644052,362,1990,24643690,24644052
7341,4,11,1,2412,-82,-94,12,48:dd:0c:92:4b:e3,24644427,323,52,24644104,24644427
7342,4,11,1,2412,-82,-94,12,48:dd:0c:92:4b:e5,24644762,382,-47,24644380,24644762
7343,6,24,1,2412,-84,-94,10,,24645318,28,528,24645290,24645318
7344,4,11,1,2412,-65,-94,29,48:dd:0c:7d:86:27,24655453,362,9773,24655091,24655453
7345,4,11,1,2412,-66,-94,28,48:dd:0c:7d:86:23,24655827,323,51,24655504,24655827
7346,4,11,1,2412,-64,-94,30,48:dd:0c:7d:86:25,24656163,382,-46,24655781,24656163
7347,6,6,1,2412,-72,-94,22,40:b0:34:b7:01:d5,24658615,576,1876,24658039,24658615
7348,6,6,1,2412,-68,-94,26,12:86:8c:5f:93:1e,24660536,332,1589,24660204,24660536
7349,4,11,1,2412,-86,-94,8,48:dd:0c:90:e3:85,24681217,382,20299,24680835,24681217
7350,4,1,1,2412,-92,-94,2,,24685816,304,4295,24685512,24685816
7351,6,6,1,2412,-67,-94,27,52:86:8c:5f:93:1e,24689364,332,3216,24689032,24689364
7352,4,1,1,2412,-89,-94,5,,24700167,304,10499,24699863,24700167
7353,6,24,1,2412,-84,-94,10,,24711181,28,10986,24711153,24711181
7354,6,6,1,2412,-68,-94,26,32:86:8c:5f:93:1e,24711604,332,91,24711272,24711604
7355,6,24,1,2412,-86,-94,8,,24713003,28,1371,24712975,24713003
7356,4,1,1,2412,-89,-94,5,bc:98:df:ff:0f:8b,24737320,2568,21749,24734752,24737320
7357,4,1,1,2412,-50,-94,44,94:a6:7e:c9:98:67,24739928,2464,144,24737464,24739928
7358,4,11,1,2412,-88,-94,6,4c:01:43:d7:f3:26,24744100,387,3785,24743713,24744100
7359,4,11,1,2412,-78,-94,16,48:dd:0c:92:4b:e7,24746452,362,1990,24746090,24746452
7360,4,11,1,2412,-84,-94,10,48:dd:0c:92:4b:e3,24746827,323,52,24746504,24746827
7361,4,11,1,2412,-86,-94,8,48:dd:0c:92:4b:e5,24747162,382,-47,24746780,24747162
7362,4,1,1,2412,-91,-94,3,ac:67:84:84:8a:07,24754554,416,6976,24754138,24754554
7363,4,1,1,2412,-86,-94,8,78:67:0e:38:6c:d3,24755094,2736,-2196,24752358,24755094
7364,4,11,1,2412,-67,-94,27,48:dd:0c:7d:86:23,24758227,323,2810,24757904,24758227
7365,4,11,1,2412,-67,-94,27,48:dd:0c:7d:86:25,24758562,382,-47,24758180,24758562
7366,4,1,1,2412,-88,-94,6,78:67:0e:c4:a8:42,24761429,352,2515,24761077,24761429
7367,6,6,1,2412,-70,-94,24,12:86:8c:5f:93:1e,24766939,332,5178,24766607,24766939
7368,4,11,1,2412,-86,-94,8,48:dd:0c:90:e3:85,24783617,382,16296,24783235,24783617
7369,6,24,1,2412,-83,-94,11,,24783914,28,269,24783886,24783914
7370,6,24,1,2412,-88,-94,6,,24791178,28,7236,24791150,24791178
7371,6,24,1,2412,-82,-94,12,,24798998,28,7792,24798970,24798998
7372,6,6,1,2412,-66,-94,28,32:86:8c:5f:93:1e,24814015,332,14685,24813683,24814015
7373,4,1,1,2412,-75,-94,19,b0:e4:d5:32:ec:8a,24835524,1960,19549,24833564,24835524
7374,6,6,1,2412,-64,-94,30,10:86:8c:5f:93:1e,24839605,344,3737,24839261,24839605
7375,4,1,1,2412,-51,-94,43,94:a6:7e:c9:98:67,24842634,2464,565,24840170,24842634
7376,4,11,1,2412,-89,-94,5,4c:01:43:d7:f3:23,24846165,322,3209,24845843,24846165
7377,4,11,1,2412,-88,-94,6,48:dd:0c:92:4b:e7,24848852,362,2325,24848490,24848852
7378,4,11,1,2412,-78,-94,16,48:dd:0c:92:4b:e3,24849227,323,52,24848904,24849227
7379,4,11,1,2412,-90,-94,4,48:dd:0c:92:4b:e5,24849562,382,-47,24849180,24849562
7380,6,24,1,2412,-84,-94,10,,24853863,28,4273,24853835,24853863
7381,4,11,1,2412,-70,-94,24,48:dd:0c:7d:86:23,24860628,323,6442,24860305,24860628
7382,6,6,1,2412,-76,-94,18,40:b0:34:b7:01:d5,24863417,576,2213,24862841,24863417
7383,6,6,1,2412,-64,-94,30,12:86:8c:5f:93:1e,24865223,332,1474,24864891,24865223
7384,4,1,1,2412,-89,-94,5,70:3a:cb:63:35:b2,24865747,2216,-1692,24863531,24865747
7385,4,1,1,2412,-95,-94,-1,54:65:de:91:d4:c0,24872587,2632,4208,24869955,24872587
7386,4,11,1,2412,-81,-94,13,4c:01:43:ec:a0:69,24883871,361,10923,24883510,24883871
7387,4,11,1,2412,-82,-94,12,48:dd:0c:90:e3:83,24885681,323,1487,24885358,24885681
7388,4,11,1,2412,-80,-94,14,48:dd:0c:90:e3:85,24886016,382,-47,24885634,24886016
7389,4,1,1,2412,-88,-94,6,78:67:0e:c4:a8:42,24897571,2736,8819,24894835,24897571
7390,4,11,1,2412,-90,-94,4,,24902343,203,4569,24902140,24902343
7391,4,11,1,2412,-81,-94,13,48:dd:0c:90:e3:83,24904006,254,1409,24903752,24904006
7392,6,6,1,2412,-74,-94,20,49:dd:0c:7d:86:23,24904452,52,394,24904400,24904452
7393,6,6,1,2412,-74,-94,20,49:dd:0c:7d:86:23,24905361,52,857,24905309,24905361
7394,6,24,1,2412,-85,-94,9,,24906416,28,1027,24906388,24906416
7395,6,6,1,2412,-85,-94,9,,24906614,44,154,24906570,24906614
7396,6,6,1,2412,-75,-94,19,49:dd:0c:7d:86:23,24907015,52,349,24906963,24907015
7397,6,6,1,2412,-75,-94,19,49:dd:0c:7d:86:23,24908874,52,1807,24908822,24908874
7398,6,6,1,2412,-63,-94,31,32:86:8c:5f:93:1e,24916470,332,7264,24916138,24916470
7399,4,1,1,2412,-74,-94,20,b0:e4:d5:32:ec:8a,24937923,1960,19493,24935963,24937923
7400,6,6,1,2412,-64,-94,30,10:86:8c:5f:93:1e,24942152,344,3885,24941808,24942152
7401,4,1,1,2412,-55,-94,39,94:a6:7e:c9:98:67,24945080,2464,464,24942616,24945080
7402,4,11,1,2412,-88,-94,6,4c:01:43:d7:f3:23,24948564,322,3162,24948242,24948564
7403,4,11,1,2412,-86,-94,8,48:dd:0c:92:4b:e3,24952844,323,3957,24952521,24952844
7404,4,11,1,2412,-86,-94,8,48:dd:0c:92:4b:e5,24953180,382,-46,24952798,24953180
7405,4,1,1,2412,-86,-94,8,78:67:0e:38:6c:d3,24959895,2736,3979,24957159,24959895
7406,4,11,1,2412,-66,-94,28,48:dd:0c:7d:86:27,24962653,362,2396,24962291,24962653
7407,4,11,1,2412,-66,-94,28,48:dd:0c:7d:86:23,24963028,323,52,24962705,24963028
7408,4,11,1,2412,-65,-94,29,48:dd:0c:7d:86:25,24963363,382,-47,24962981,24963363
7409,6,6,1,2412,-74,-94,20,40:b0:34:b7:01:d5,24965818,576,1879,24965242,24965818
7410,6,6,1,2412,-63,-94,31,12:86:8c:5f:93:1e,24967606,332,1456,24967274,24967606
7411,4,1,1,2412,-93,-94,1,00:26:62:eb:ea:74,24980002,968,11428,24979034,24980002
7412,4,11,1,2412,-86,-94,8,4c:01:43:ec:a0:69,24986270,361,5907,24985909,24986270
7413,4,11,1,2412,-85,-94,9,4c:01:43:ec:a0:63,24986644,322,52,24986322,24986644
7414,6,6,1,2412,-90,-94,4,0a:a7:c0:a3:8d:71,24996738,408,9686,24996330,24996738
7415,6,6,1,2412,-89,-94,5,0a:a7:c0:a3:8d:73,24997180,408,34,24996772,24997180
7416,6,6,1,2412,-88,-94,6,0a:a7:c0:a3:8d:75,24997629,408,41,24997221,24997629
7417,6,6,1,2412,-91,-94,3,,25002654,44,4981,25002610,25002654
7418,6,24,1,2412,-90,-94,4,,25003865,28,1183,25003837,25003865
7419,4,1,1,2412,-72,-94,22,b0:e4:d5:32:ec:8a,25040322,1960,34497,25038362,25040322
7420,4,1,1,2412,-54,-94,40,94:a6:7e:c9:98:67,25047417,2464,4631,25044953,25047417
7421,4,11,1,2412,-88,-94,6,4c:01:43:d7:f3:29,25050589,362,2810,25050227,25050589
7422,4,11,1,2412,-89,-94,5,4c:01:43:d7:f3:26,25051298,387,322,25050911,25051298
7423,6,24,1,2412,-90,-94,4,,25060218,28,8892,25060190,25060218
7424,4,1,1,2412,-87,-94,7,78:67:0e:38:6c:d3,25062295,2736,-659,25059559,25062295
7425,4,11,1,2412,-67,-94,27,48:dd:0c:7d:86:27,25065054,362,2397,25064692,25065054
7426,4,11,1,2412,-67,-94,27,48:dd:0c:7d:86:23,25065429,323,52,25065106,25065429
7427,4,11,1,2412,-68,-94,26,48:dd:0c:7d:86:25,25065764,382,-47,25065382,25065764
7428,4,1,1,2412,-89,-94,5,78:67:0e:38:6c:d3,25067392,1056,572,25066336,25067392
7429,6,6,1,2412,-74,-94,20,40:b0:34:b7:01:d5,25068336,576,368,25067760,25068336
7430,6,6,1,2412,-70,-94,24,12:86:8c:5f:93:1e,25070007,332,1339,25069675,25070007
7431,4,11,1,2412,-87,-94,7,4c:01:43:ec:a0:69,25088669,361,18301,25088308,25088669
7432,4,11,1,2412,-87,-94,7,4c:01:43:ec:a0:63,25089043,322,52,25088721,25089043
7433,4,11,1,2412,-87,-94,7,4c:01:43:ec:a0:66,25089377,387,-53,25088990,25089377
7434,4,11,1,2412,-84,-94,10,48:dd:0c:90:e3:83,25090481,323,781,25090158,25090481
7435,4,11,1,2412,-82,-94,12,48:dd:0c:90:e3:85,25090816,382,-47,25090434,25090816
7436,6,6,1,2412,-66,-94,28,52:86:8c:5f:93:1e,25096374,332,5226,25096042,25096374
7437,6,6,1,2412,-91,-94,3,0a:a7:c0:a3:8d:73,25099388,408,2606,25098980,25099388
7438,6,24,1,2412,-86,-94,8,4c:01:43:d7:f3:26,25105316,32,5896,25105284,25105316
7439,4,11,1,2412,-89,-94,5,,25108085,203,2566,25107882,25108085
7440,6,6,1,2412,-85,-94,9,,25123874,44,15745,25123830,25123874
7441,6,24,1,2412,-86,-94,8,,25124971,28,1069,25124943,25124971
7442,6,6,1,2412,-63,-94,31,32:86:8c:5f:93:1e,25125031,332,-272,25124699,25125031
7443,4,1,1,2412,-68,-94,26,b0:e4:d5:32:ec:8a,25142721,1960,15730,25140761,25142721
7444,4,1,1,2412,-88,-94,6,bc:98:df:ff:0f:8b,25146911,2568,1622,25144343,25146911
7445,6,6,1,2412,-64,-94,30,10:86:8c:5f:93:1e,25149334,344,2079,25148990,25149334
7446,4,11,1,2412,-87,-94,7,4c:01:43:d7:f3:29,25152989,362,3293,25152627,25152989
7447,4,11,1,2412,-87,-94,7,4c:01:43:d7:f3:23,25153363,322,52,25153041,25153363
7448,4,11,1,2412,-87,-94,7,4c:01:43:d7:f3:26,25153698,387,-52,25153311,25153698
7449,6,24,1,2412,-85,-94,9,,25154918,28,1192,25154890,25154918
7450,4,11,1,2412,-78,-94,16,48:dd:0c:92:4b:e7,25156052,362,772,25155690,25156052
7451,4,11,1,2412,-87,-94,7,48:dd:0c:92:4b:e3,25156426,323,51,25156103,25156426
7452,4,11,1,2412,-85,-94,9,48:dd:0c:92:4b:e5,25156761,382,-47,25156379,25156761
7453,4,1,1,2412,-84,-94,10,78:67:0e:38:6c:d3,25164695,2736,5198,25161959,25164695
7454,4,11,1,2412,-70,-94,24,48:dd:0c:7d:86:27,25167454,362,2397,25167092,25167454
7455,4,11,1,2412,-70,-94,24,48:dd:0c:7d:86:23,25167829,323,52,25167506,25167829
7456,4,11,1,2412,-69,-94,25,48:dd:0c:7d:86:25,25168164,382,-47,25167782,25168164
7457,6,6,1,2412,-76,-94,18,40:b0:34:b7:01:d5,25170621,576,1881,25170045,25170621
7458,6,6,1,2412,-60,-94,34,12:86:8c:5f:93:1e,25172436,332,1483,25172104,25172436
7459,6,6,1,2412,-92,-94,2,,25178803,44,6323,25178759,25178803
7460,4,11,1,2412,-86,-94,8,,25182574,107,3664,25182467,25182574
7461,6,6,1,2412,-92,-94,2,e2:db:d1:d1:b0:4a,25184114,444,1096,25183670,25184114
7462,6,6,1,2412,-90,-94,4,e2:db:d1:d1:b0:4d,25185041,408,519,25184633,25185041
7463,4,1,1,2412,-87,-94,7,78:67:0e:c4:a8:42,25187382,352,1989,25187030,25187382
7464,4,1,1,2412,-86,-94,8,78:67:0e:c4:a8:42,25188446,352,712,25188094,25188446
7465,4,11,1,2412,-80,-94,14,4c:01:43:ec:a0:69,25191068,361,2261,25190707,25191068
7466,4,11,1,2412,-83,-94,11,4c:01:43:ec:a0:63,25191442,322,52,25191120,25191442
7467,4,11,1,2412,-83,-94,11,4c:01:43:ec:a0:66,25191776,387,-53,25191389,25191776
7468,6,24,1,2412,-83,-94,11,,25192062,28,258,25192034,25192062
7469,4,11,1,2412,-85,-94,9,48:dd:0c:90:e3:87,25192506,362,82,25192144,25192506
7470,4,11,1,2412,-86,-94,8,48:dd:0c:90:e3:83,25192880,323,51,25192557,25192880
7471,4,11,1,2412,-84,-94,10,48:dd:0c:90:e3:85,25193216,382,-46,25192834,25193216
7472,6,24,1,2412,-87,-94,7,,25195818,28,2574,25195790,25195818
7473,6,6,1,2412,-86,-94,8,,25196016,44,154,25195972,25196016
7474,4,1,1,2412,-84,-94,10,78:67:0e:c4:a8:42,25204715,2736,5963,25201979,25204715
7475,6,24,1,2412,-86,-94,8,,25207370,28,2627,25207342,25207370
7476,6,6,1,2412,-90,-94,4,,25208251,44,837,25208207,25208251
7477,6,6,1,2412,-90,-94,4,,25209184,44,889,25209140,25209184
7478,6,6,1,2412,-63,-94,31,32:86:8c:5f:93:1e,25223608,332,14092,25223276,25223608
7479,4,1,1,2412,-82,-94,12,78:67:0e:c4:a8:42,25231115,352,7155,25230763,25231115
7480,4,11,1,2412,-84,-94,10,4c:01:43:ec:a0:63,25232035,331,589,25231704,25232035
7481,4,11,1,2412,-85,-94,9,,25233181,107,1039,25233074,25233181
7482,6,24,1,2412,-86,-94,8,78:67:0e:c4:a8:42,25233294,32,81,25233262,25233294
7483,4,11,1,2412,-84,-94,10,4c:01:43:d7:f3:23,25233856,346,216,25233510,25233856
7484,4,11,1,2412,-83,-94,11,4c:01:43:ec:a0:63,25234417,346,215,25234071,25234417
7485,4,11,1,2412,-65,-94,29,48:dd:0c:7d:86:23,25239732,254,5061,25239478,25239732
7486,4,1,1,2412,-68,-94,26,b0:e4:d5:32:ec:8a,25245121,1960,3429,25243161,25245121
7487,4,1,1,2412,-54,-94,40,94:a6:7e:c9:98:67,25252097,2464,4512,25249633,25252097
7488,6,6,1,2412,-86,-94,8,,25254541,44,2400,25254497,25254541
7489,4,11,1,2412,-83,-94,11,4c:01:43:d7:f3:29,25255388,362,485,25255026,25255388
7490,4,11,1,2412,-81,-94,13,4c:01:43:d7:f3:23,25255763,322,53,25255441,25255763
7491,4,11,1,2412,-83,-94,11,4c:01:43:d7:f3:26,25256097,387,-53,25255710,25256097
7492,4,11,1,2412,-80,-94,14,4c:01:43:d7:f3:26,25256530,321,112,25256209,25256530
7493,4,11,1,2412,-83,-94,11,4c:01:43:d7:f3:26,25256928,336,62,25256592,25256928
7494,4,11,1,2412,-88,-94,6,48:dd:0c:92:4b:e3,25258826,323,1575,25258503,25258826
7495,4,1,1,2412,-72,-94,22,78:67:0e:38:6c:d3,25267095,2736,5533,25264359,25267095
7496,4,11,1,2412,-70,-94,24,48:dd:0c:7d:86:27,25269854,362,2397,25269492,25269854
7497,4,11,1,2412,-70,-94,24,48:dd:0c:7d:86:23,25270228,323,51,25269905,25270228
7498,6,24,1,2412,-83,-94,11,,25272162,28,1906,25272134,25272162
7499,6,6,1,2412,-86,-94,8,,25272307,44,101,25272263,25272307
7500,4,11,1,2412,-90,-94,4,,25272596,107,182,25272489,25272596
7501,6,24,1,2412,-86,-94,8,78:67:0e:c4:a8:42,25272710,32,82,25272678,25272710
7502,6,6,1,2412,-79,-94,15,40:b0:34:b7:01:d5,25273087,576,-199,25272511,25273087
7503,6,6,1,2412,-63,-94,31,12:86:8c:5f:93:1e,25274865,332,1446,25274533,25274865
7504,6,6,1,2412,-87,-94,7,e2:db:d1:d1:b0:4f,25287100,408,11827,25286692,25287100
7505,6,6,1,2412,-88,-94,6,,25288522,44,1378,25288478,25288522
7506,4,11,1,2412,-85,-94,9,4c:01:43:ec:a0:63,25293841,322,4997,25293519,25293841
7507,4,11,1,2412,-86,-94,8,4c:01:43:ec:a0:66,25294175,387,-53,25293788,25294175
7508,4,11,1,2412,-85,-94,9,48:dd:0c:90:e3:87,25294906,362,369,25294544,25294906
7509,4,11,1,2412,-85,-94,9,48:dd:0c:90:e3:83,25295280,323,51,25294957,25295280
7510,4,11,1,2412,-84,-94,10,48:dd:0c:90:e3:85,25295615,382,-47,25295233,25295615
7511,4,1,1,2412,-87,-94,7,78:67:0e:c4:a8:42,25307115,2736,8764,25304379,25307115
7512,6,6,1,2412,-88,-94,6,,25312099,44,4940,25312055,25312099
7513,6,6,1,2412,-88,-94,6,,25312748,44,605,25312704,25312748
7514,6,6,1,2412,-65,-94,29,32:86:8c:5f:93:1e,25326008,332,12928,25325676,25326008
7515,6,24,1,2412,-82,-94,12,,25337317,28,11281,25337289,25337317
7516,6,6,1,2412,-87,-94,7,0a:a7:c0:a3:8d:70,25346311,608,8386,25345703,25346311
7517,4,1,1,2412,-67,-94,27,b0:e4:d5:32:ec:8a,25347520,1960,-751,25345560,25347520
7518,4,1,1,2412,-48,-94,46,94:a6:7e:c9:98:67,25354496,2464,4512,25352032,25354496
7519,4,11,1,2412,-87,-94,7,4c:01:43:d7:f3:29,25357788,362,2930,25357426,25357788
7520,4,11,1,2412,-87,-94,7,4c:01:43:d7:f3:23,25358162,322,52,25357840,25358162
7521,4,11,1,2412,-85,-94,9,4c:01:43:d7:f3:26,25358497,387,-52,25358110,25358497
7522,4,11,1,2412,-88,-94,6,48:dd:0c:92:4b:e5,25361561,382,2682,25361179,25361561
7523,6,24,1,2412,-84,-94,10,,25364849,28,3260,25364821,25364849
7524,4,11,1,2412,-71,-94,23,48:dd:0c:7d:86:27,25372255,362,7044,25371893,25372255
7525,4,11,1,2412,-70,-94,24,48:dd:0c:7d:86:23,25372629,323,51,25372306,25372629
7526,4,11,1,2412,-72,-94,22,48:dd:0c:7d:86:25,25372964,382,-47,25372582,25372964
7527,6,6,1,2412,-80,-94,14,40:b0:34:b7:01:d5,25375423,576,1883,25374847,25375423
7528,6,6,1,2412,-62,-94,32,12:86:8c:5f:93:1e,25377209,332,1454,25376877,25377209
7529,4,1,1,2412,-90,-94,4,00:26:62:eb:ea:74,25387435,968,9258,25386467,25387435
7530,4,11,1,2412,-87,-94,7,4c:01:43:ec:a0:69,25395866,361,8070,25395505,25395866
7531,4,11,1,2412,-83,-94,11,4c:01:43:ec:a0:66,25396574,387,321,25396187,25396574
7532,4,11,1,2412,-83,-94,11,48:dd:0c:90:e3:83,25397680,323,783,25397357,25397680
7533,6,6,1,2412,-88,-94,6,,25398335,44,611,25398291,25398335
7534,6,6,1,2412,-88,-94,6,,25398871,44,492,25398827,25398871
7535,6,6,1,2412,-62,-94,32,52:86:8c:5f:93:1e,25402972,332,3769,25402640,25402972
7536,4,11,1,2412,-86,-94,8,4c:01:43:ec:a0:63,25412360,254,9134,25412106,25412360
7537,4,11,1,2412,-88,-94,6,4c:01:43:db:2d:83,25412661,254,47,25412407,25412661
7538,4,1,1,2412,-90,-94,4,,25416906,304,3941,25416602,25416906
7539,6,6,1,2412,-87,-94,7,,25425308,44,8358,25425264,25425308
7540,6,6,1,2412,-66,-94,28,32:86:8c:5f:93:1e,25428409,332,2769,25428077,25428409
7541,6,24,1,2412,-85,-94,9,,25431187,28,2750,25431159,25431187
7542,6,24,1,2412,-84,-94,10,,25443764,28,12549,25443736,25443764
7543,6,24,1,2412,-84,-94,10,,25448693,28,4901,25448665,25448693
7544,6,6,1,2412,-66,-94,28,10:86:8c:5f:93:1e,25455119,344,6082,25454775,25455119
7545,4,1,1,2412,-44,-94,50,94:a6:7e:c9:98:67,25457014,2464,-569,25454550,25457014
7546,4,11,1,2412,-84,-94,10,4c:01:43:d7:f3:29,25460187,362,2811,25459825,25460187
7547,4,11,1,2412,-85,-94,9,4c:01:43:d7:f3:23,25460562,322,53,25460240,25460562
7548,4,11,1,2412,-86,-94,8,4c:01:43:d7:f3:26,25460896,387,-53,25460509,25460896
7549,4,11,1,2412,-63,-94,31,48:dd:0c:7d:86:27,25474654,362,13396,25474292,25474654
7550,4,11,1,2412,-64,-94,30,48:dd:0c:7d:86:23,25475029,323,52,25474706,25475029
7551,4,11,1,2412,-64,-94,30,48:dd:0c:7d:86:25,25475364,382,-47,25474982,25475364
7552,6,24,1,2412,-88,-94,6,,25477064,28,1672,25477036,25477064
7553,4,11,1,2412,-90,-94,4,4c:01:43:db:2d:83,25483156,322,5770,25482834,25483156
7554,6,6,1,2412,-88,-94,6,e2:db:d1:d1:b0:4a,25490511,444,6911,25490067,25490511
7555,4,11,1,2412,-85,-94,9,4c:01:43:ec:a0:63,25498638,322,7805,25498316,25498638
7556,4,11,1,2412,-81,-94,13,48:dd:0c:90:e3:87,25499705,362,705,25499343,25499705
7557,4,11,1,2412,-82,-94,12,48:dd:0c:90:e3:83,25500080,323,52,25499757,25500080
7558,4,11,1,2412,-82,-94,12,48:dd:0c:90:e3:85,25500415,382,-47,25500033,25500415
7559,6,6,1,2412,-84,-94,10,,25509823,44,9364,25509779,25509823
7560,6,6,1,2412,-87,-94,7,,25510303,44,436,25510259,25510303
7561,4,1,1,2412,-85,-94,9,78:67:0e:c4:a8:42,25514706,2232,2171,25512474,25514706
7562,4,1,1,2412,-82,-94,12,78:67:0e:c4:a8:42,25516949,2240,3,25514709,25516949
7563,6,24,1,2412,-86,-94,8,,25524850,28,7873,25524822,25524850
7564,6,6,1,2412,-64,-94,30,32:86:8c:5f:93:1e,25530810,332,5628,25530478,25530810
7565,6,6,1,2412,-89,-94,5,,25542298,44,11444,25542254,25542298
7566,4,1,1,2412,-88,-94,6,,25549145,304,6543,25548841,25549145
7567,4,1,1,2412,-69,-94,25,b0:e4:d5:32:ec:8a,25552319,1960,1214,25550359,25552319
7568,4,11,1,2412,-85,-94,9,4c:01:43:ec:a0:63,25555572,254,2999,25555318,25555572
7569,4,11,1,2412,-87,-94,7,4c:01:43:d7:f3:23,25555874,254,48,25555620,25555874
7570,6,6,1,2412,-88,-94,6,4d:01:43:d7:f3:23,25556009,52,83,25555957,25556009
7571,4,1,1,2412,-47,-94,47,94:a6:7e:c9:98:67,25559295,2464,822,25556831,25559295
7572,6,6,1,2412,-66,-94,28,10:86:8c:5f:93:1e,25561615,344,1976,25561271,25561615
7573,4,11,1,2412,-88,-94,6,4c:01:43:d7:f3:29,25562610,362,633,25562248,25562610
7574,4,11,1,2412,-89,-94,5,4c:01:43:d7:f3:23,25562984,322,52,25562662,25562984
7575,4,11,1,2412,-89,-94,5,4c:01:43:d7:f3:26,25563319,387,-52,25562932,25563319
7576,4,1,1,2412,-85,-94,9,78:67:0e:38:6c:d3,25574296,2736,8241,25571560,25574296
7577,4,11,1,2412,-69,-94,25,48:dd:0c:7d:86:27,25577055,362,2397,25576693,25577055
7578,4,11,1,2412,-79,-94,15,48:dd:0c:7d:86:25,25577765,382,328,25577383,25577765
7579,4,1,1,2412,-89,-94,5,,25579342,304,1273,25579038,25579342
7580,6,6,1,2412,-83,-94,11,40:b0:34:b7:01:d5,25580225,576,307,25579649,25580225
7581,6,6,1,2412,-67,-94,27,12:86:8c:5f:93:1e,25582108,332,1551,25581776,25582108
7582,6,24,1,2412,-86,-94,8,,25591932,28,9796,25591904,25591932
7583,4,1,1,2412,-91,-94,3,00:26:62:eb:ea:74,25593083,968,183,25592115,25593083
7584,4,11,1,2412,-84,-94,10,4c:01:43:ec:a0:69,25600663,361,7219,25600302,25600663
7585,4,11,1,2412,-84,-94,10,4c:01:43:ec:a0:63,25601037,322,52,25600715,25601037
7586,4,11,1,2412,-84,-94,10,4c:01:43:ec:a0:66,25601372,387,-52,25600985,25601372
7587,4,11,1,2412,-84,-94,10,48:dd:0c:90:e3:87,25602105,362,371,25601743,25602105
7588,4,11,1,2412,-82,-94,12,48:dd:0c:90:e3:83,25602479,323,51,25602156,25602479
7589,6,24,1,2412,-87,-94,7,,25604995,28,2488,25604967,25604995
7590,4,1,1,2412,-87,-94,7,78:67:0e:c4:a8:42,25614315,2736,6584,25611579,25614315
7591,4,1,1,2412,-73,-94,21,,25632570,304,17951,25632266,25632570
7592,6,6,1,2412,-65,-94,29,32:86:8c:5f:93:1e,25633232,332,330,25632900,25633232
7593,4,1,1,2412,-70,-94,24,b0:e4:d5:32:ec:8a,25654718,1960,19526,25652758,25654718
7594,4,1,1,2412,-54,-94,40,94:a6:7e:c9:98:67,25661695,2464,4513,25659231,25661695
7595,4,11,1,2412,-81,-94,13,4c:01:43:d7:f3:29,25664986,362,2929,25664624,25664986
7596,4,11,1,2412,-82,-94,12,4c:01:43:d7:f3:23,25665361,322,53,25665039,25665361
7597,4,11,1,2412,-81,-94,13,4c:01:43:d7:f3:26,25665695,387,-53,25665308,25665695
7598,6,24,1,2412,-82,-94,12,,25671188,28,5465,25671160,25671188
7599,4,11,1,2412,-67,-94,27,48:dd:0c:7d:86:27,25676990,362,5440,25676628,25676990
7600,4,11,1,2412,-66,-94,28,48:dd:0c:7d:86:23,25677365,323,52,25677042,25677365
7601,4,11,1,2412,-66,-94,28,48:dd:0c:7d:86:25,25677700,382,-47,25677318,25677700
7602,6,6,1,2412,-90,-94,4,40:b0:34:b7:01:d5,25682626,576,4350,25682050,25682626
7603,6,6,1,2412,-69,-94,25,10:86:8c:5f:93:1e,25687797,344,4827,25687453,25687797
7604,4,1,1,2412,-90,-94,4,,25698810,304,10709,25698506,25698810
7605,4,11,1,2412,-86,-94,8,4c:01:43:ec:a0:66,25703953,387,4756,25703566,25703953
7606,4,11,1,2412,-86,-94,8,48:dd:0c:90:e3:83,25704879,323,603,25704556,25704879
7607,4,11,1,2412,-85,-94,9,48:dd:0c:90:e3:85,25705214,382,-47,25704832,25705214
7608,4,1,1,2412,-88,-94,6,78:67:0e:c4:a8:42,25717305,2736,9355,25714569,25717305
7609,6,6,1,2412,-91,-94,3,,25720392,44,3043,25720348,25720392
7610,6,6,1,2412,-87,-94,7,,25721566,44,1130,25721522,25721566
7611,6,6,1,2412,-87,-94,7,,25722198,44,588,25722154,25722198
7612,6,6,1,2412,-67,-94,27,32:86:8c:5f:93:1e,25735645,332,13115,25735313,25735645
7613,4,1,1,2412,-89,-94,5,78:67:0e:c4:a8:42,25736112,352,115,25735760,25736112
7614,6,24,1,2412,-85,-94,9,78:67:0e:c4:a8:42,25738081,32,1937,25738049,25738081
7615,6,6,1,2412,-88,-94,6,,25749822,44,11697,25749778,25749822
7616,6,24,1,2412,-84,-94,10,,25755492,28,5642,25755464,25755492
7617,4,1,1,2412,-78,-94,16,b0:e4:d5:32:ec:8a,25757117,1960,-335,25755157,25757117
7618,6,6,1,2412,-68,-94,26,10:86:8c:5f:93:1e,25763729,344,6268,25763385,25763729
7619,4,1,1,2412,-44,-94,50,94:a6:7e:c9:98:67,25764292,2464,-1901,25761828,25764292
7620,6,6,1,2412,-89,-94,5,,25766761,44,2425,25766717,25766761
7621,4,11,1,2412,-88,-94,6,48:dd:0c:92:4b:e7,25770451,362,3328,25770089,25770451
7622,4,1,1,2412,-89,-94,5,78:67:0e:38:6c:d3,25779098,2736,5911,25776362,25779098
7623,4,11,1,2412,-73,-94,21,48:dd:0c:7d:86:27,25781857,362,2397,25781495,25781857
7624,4,11,1,2412,-72,-94,22,48:dd:0c:7d:86:23,25782231,323,51,25781908,25782231
7625,4,11,1,2412,-71,-94,23,48:dd:0c:7d:86:25,25782567,382,-46,25782185,25782567
7626,6,6,1,2412,-67,-94,27,12:86:8c:5f:93:1e,25786811,332,3912,25786479,25786811
7627,4,11,1,2412,-90,-94,4,4c:01:43:ec:a0:63,25805835,322,18702,25805513,25805835
7628,4,11,1,2412,-89,-94,5,4c:01:43:ec:a0:66,25806169,387,-53,25805782,25806169
7629,4,11,1,2412,-86,-94,8,48:dd:0c:90:e3:87,25806904,362,373,25806542,25806904
7630,4,11,1,2412,-88,-94,6,48:dd:0c:90:e3:83,25807279,323,52,25806956,25807279
7631,4,1,1,2412,-81,-94,13,,25816538,304,8955,25816234,25816538
7632,4,1,1,2412,-90,-94,4,78:67:0e:c4:a8:42,25819115,2736,-159,25816379,25819115
7633,6,24,1,2412,-87,-94,7,,25831191,28,12048,25831163,25831191
7634,6,6,1,2412,-63,-94,31,32:86:8c:5f:93:1e,25841150,332,9627,25840818,25841150
7635,6,24,1,2412,-86,-94,8,,25843769,28,2591,25843741,25843769
7636,6,24,1,2412,-84,-94,10,,25848149,28,4352,25848121,25848149
7637,4,1,1,2412,-67,-94,27,b0:e4:d5:32:ec:8a,25859516,1960,9407,25857556,25859516
7638,6,6,1,2412,-64,-94,30,10:86:8c:5f:93:1e,25863612,344,3752,25863268,25863612
7639,4,1,1,2412,-47,-94,47,94:a6:7e:c9:98:67,25866657,2464,581,25864193,25866657
7640,4,11,1,2412,-66,-94,28,4c:01:43:d7:f3:26,25870495,387,3451,25870108,25870495
7641,4,1,1,2412,-88,-94,6,78:67:0e:38:6c:d3,25881497,2736,8266,25878761,25881497
7642,4,11,1,2412,-77,-94,17,48:dd:0c:7d:86:27,25884256,362,2397,25883894,25884256
7643,4,11,1,2412,-78,-94,16,48:dd:0c:7d:86:23,25884630,323,51,25884307,25884630
7644,4,11,1,2412,-77,-94,17,48:dd:0c:7d:86:25,25884966,382,-46,25884584,25884966
7645,4,1,1,2412,-90,-94,4,00:26:62:eb:ea:74,25897093,968,11159,25896125,25897093
7646,4,11,1,2412,-90,-94,4,4c:01:43:ec:a0:63,25908368,322,10953,25908046,25908368
7647,4,11,1,2412,-88,-94,6,4c:01:43:ec:a0:66,25908702,387,-53,25908315,25908702
7648,4,11,1,2412,-86,-94,8,48:dd:0c:90:e3:87,25909304,362,240,25908942,25909304
7649,4,11,1,2412,-84,-94,10,48:dd:0c:90:e3:85,25910014,382,328,25909632,25910014
7650,6,24,1,2412,-85,-94,9,,25911195,28,1153,25911167,25911195
7651,4,1,1,2412,-91,-94,3,78:67:0e:c4:a8:42,25921515,2736,7584,25918779,25921515
7652,6,24,1,2412,-85,-94,9,,25924798,28,3255,25924770,25924798
7653,6,6,1,2412,-66,-94,28,32:86:8c:5f:93:1e,25940412,332,15282,25940080,25940412
7654,4,1,1,2412,-63,-94,31,b0:e4:d5:32:ec:8a,25961916,1960,19544,25959956,25961916
7655,6,6,1,2412,-64,-94,30,10:86:8c:5f:93:1e,25966013,344,3753,25965669,25966013
7656,4,11,1,2412,-63,-94,31,10:86:8c:5f:93:1e,25969057,347,2697,25968710,25969057
7657,4,1,1,2412,-50,-94,44,94:a6:7e:c9:98:67,25969443,2464,-2078,25966979,25969443
7658,6,6,1,2412,-68,-94,26,b4:e6:2d:b4:ff:71,25971794,64,2287,25971730,25971794
7659,6,6,1,2412,-65,-94,29,,25971874,44,36,25971830,25971874
7660,4,11,1,2412,-91,-94,3,4c:01:43:d7:f3:23,25972560,322,364,25972238,25972560
7661,4,11,1,2412,-92,-94,2,4c:01:43:d7:f3:26,25972894,387,-53,25972507,25972894
7662,4,11,1,2412,-73,-94,21,48:dd:0c:7d:86:27,25986656,362,13400,25986294,25986656
7663,6,6,1,2412,-82,-94,12,40:b0:34:b7:01:d5,25989829,576,2597,25989253,25989829
7664,6,24,1,2412,-87,-94,7,,25991199,28,1342,25991171,25991199
7665,6,6,1,2412,-63,-94,31,12:86:8c:5f:93:1e,25991613,332,82,25991281,25991613
7666,6,24,1,2412,-87,-94,7,,26004344,28,12703,26004316,26004344
7667,4,11,1,2412,-84,-93,9,48:dd:0c:90:e3:83,26012078,323,7411,26011755,26012078
7668,4,11,1,2412,-82,-93,11,48:dd:0c:90:e3:85,26012414,382,-46,26012032,26012414
7669,6,6,1,2412,-63,-93,30,52:86:8c:5f:93:1e,26017358,332,4612,26017026,26017358
7670,4,1,1,2412,-90,-93,3,78:67:0e:c4:a8:42,26023915,2736,3821,26021179,26023915
7671,6,24,1,2412,-89,-93,4,,26027024,28,3081,26026996,26027024
7672,6,6,1,2412,-91,-93,2,,26039804,44,12736,26039760,26039804
7673,6,6,1,2412,-91,-93,2,,26041161,44,1313,26041117,26041161
7674,6,6,1,2412,-66,-93,27,32:86:8c:5f:93:1e,26042813,332,1320,26042481,26042813
7675,6,6,1,2412,-91,-93,2,,26051011,44,8154,26050967,26051011
7676,4,1,1,2412,-63,-93,30,b0:e4:d5:32:ec:8a,26064315,1960,11344,26062355,26064315
7677,4,1,1,2412,-47,-93,46,94:a6:7e:c9:98:67,26071674,2464,4895,26069210,26071674
7678,4,11,1,2412,-86,-93,7,4c:01:43:d7:f3:23,26074959,322,2963,26074637,26074959
7679,4,11,1,2412,-83,-93,10,4c:01:43:d7:f3:26,26075294,387,-52,26074907,26075294
7680,4,11,1,2412,-90,-93,3,48:dd:0c:92:4b:e3,26078025,323,2408,26077702,26078025
7681,4,11,1,2412,-91,-93,2,48:dd:0c:92:4b:e5,26078360,382,-47,26077978,26078360
7682,6,6,1,2412,-90,-93,3,,26079164,44,760,26079120,26079164
7683,4,1,1,2412,-91,-93,2,cc:95:d7:da:da:18,26079892,2312,-1584,26077580,26079892
7684,4,1,1,2412,-92,-93,1,ac:67:84:84:8a:07,26082902,448,2562,26082454,26082902
7685,6,24,1,2412,-83,-93,10,,26083770,28,840,26083742,26083770
7686,4,11,1,2412,-74,-93,19,48:dd:0c:7d:86:27,26089056,362,4924,26088694,26089056
7687,4,11,1,2412,-74,-93,19,48:dd:0c:7d:86:23,26089431,323,52,26089108,26089431
7688,4,11,1,2412,-75,-93,18,48:dd:0c:7d:86:25,26089766,382,-47,26089384,26089766
7689,6,6,1,2412,-83,-93,10,40:b0:34:b7:01:d5,26092230,576,1888,26091654,26092230
7690,6,6,1,2412,-70,-93,23,12:86:8c:5f:93:1e,26094014,332,1452,26093682,26094014
7691,6,24,1,2412,-85,-93,8,,26098220,28,4178,26098192,26098220
7692,4,1,1,2412,-93,-93,0,ac:67:84:84:8a:07,26098826,416,190,26098410,26098826
7693,6,24,1,2412,-88,-93,5,,26103849,28,4995,26103821,26103849
7694,6,6,1,2412,-89,-93,4,e2:db:d1:d1:b0:4b,26105370,408,1113,26104962,26105370
7695,4,11,1,2412,-88,-93,5,4c:01:43:ec:a0:63,26113032,322,7340,26112710,26113032
7696,4,11,1,2412,-88,-93,5,4c:01:43:ec:a0:66,26113366,387,-53,26112979,26113366
7697,4,11,1,2412,-84,-93,9,48:dd:0c:90:e3:87,26114104,362,376,26113742,26114104
7698,4,11,1,2412,-79,-93,14,48:dd:0c:90:e3:83,26114478,323,51,26114155,26114478
7699,4,11,1,2412,-82,-93,11,48:dd:0c:90:e3:85,26114813,382,-47,26114431,26114813
7700,6,6,1,2412,-67,-93,26,52:86:8c:5f:93:1e,26119934,332,4789,26119602,26119934
7701,4,1,1,2412,-91,-93,2,3c:bd:c5:ee:96:6d,26121470,2512,-976,26118958,26121470
7702,4,1,1,2412,-87,-93,6,78:67:0e:c4:a8:42,26126315,2736,2109,26123579,26126315
7703,4,1,1,2412,-88,-93,5,78:67:0e:c4:a8:42,26129089,848,1926,26128241,26129089
7704,6,24,1,2412,-86,-93,7,,26148071,28,18954,26148043,26148071
7705,6,24,1,2412,-89,-93,4,,26151199,28,3100,26151171,26151199
7706,6,6,1,2412,-68,-93,25,b4:e6:2d:b4:ff:71,26152938,64,1675,26152874,26152938
7707,6,6,1,2412,-66,-93,27,,26153019,44,37,26152975,26153019
7708,6,24,1,2412,-85,-93,8,,26157454,28,4407,26157426,26157454
7709,4,1,1,2412,-62,-93,31,b0:e4:d5:32:ec:8a,26166714,1960,7300,26164754,26166714
7710,4,1,1,2412,-49,-93,44,94:a6:7e:c9:98:67,26173844,2464,4666,26171380,26173844
7711,6,6,1,2412,-67,-93,26,10:86:8c:5f:93:1e,26176234,344,2046,26175890,26176234
7712,4,11,1,2412,-88,-93,5,4c:01:43:d7:f3:26,26177693,387,1072,26177306,26177693
7713,4,11,1,2412,-90,-93,3,48:dd:0c:92:4b:e7,26180050,362,1995,26179688,26180050
7714,4,1,1,2412,-88,-93,5,78:67:0e:38:6c:d3,26188697,2736,5911,26185961,26188697
7715,4,11,1,2412,-77,-93,16,48:dd:0c:7d:86:27,26191456,362,2397,26191094,26191456
7716,6,6,1,2412,-68,-93,25,12:86:8c:5f:93:1e,26196414,332,4626,26196082,26196414
7717,6,24,1,2412,-81,-93,12,,26200449,28,4007,26200421,26200449
7718,6,6,1,2412,-91,-93,2,,26205100,44,4607,26205056,26205100
7719,6,24,1,2412,-81,-93,12,,26207251,28,2123,26207223,26207251
7720,4,1,1,2412,-90,-93,3,00:26:62:eb:ea:74,26208926,968,707,26207958,26208926
7721,6,6,1,2412,-86,-93,7,e2:db:d1:d1:b0:4a,26214296,52,5318,26214244,26214296
7722,6,6,1,2412,-90,-93,3,,26214782,44,442,26214738,26214782
7723,4,11,1,2412,-91,-93,2,4c:01:43:ec:a0:69,26215057,361,-86,26214696,26215057
7724,4,11,1,2412,-86,-93,7,4c:01:43:ec:a0:63,26215430,322,51,26215108,26215430
7725,4,11,1,2412,-87,-93,6,4c:01:43:ec:a0:66,26215765,387,-52,26215378,26215765
7726,4,11,1,2412,-85,-93,8,48:dd:0c:90:e3:87,26216503,362,376,26216141,26216503
7727,4,11,1,2412,-84,-93,9,48:dd:0c:90:e3:83,26216878,323,52,26216555,26216878
7728,6,6,1,2412,-68,-93,25,52:86:8c:5f:93:1e,26225260,332,8050,26224928,26225260
7729,6,6,1,2412,-90,-93,3,,26227657,44,2353,26227613,26227657
7730,4,1,1,2412,-87,-93,6,78:67:0e:c4:a8:42,26243249,352,15240,26242897,26243249
7731,6,24,1,2412,-88,-93,5,,26243964,28,687,26243936,26243964
7732,6,6,1,2412,-68,-93,25,32:86:8c:5f:93:1e,26247627,332,3331,26247295,26247627
7733,6,6,1,2412,-90,-93,3,,26252746,44,5075,26252702,26252746
7734,4,1,1,2412,-66,-93,27,b0:e4:d5:32:ec:8a,26269148,1960,14442,26267188,26269148
7735,6,6,1,2412,-69,-93,24,10:86:8c:5f:93:1e,26273388,344,3896,26273044,26273388
7736,4,1,1,2412,-92,-93,1,78:67:0e:c4:a8:42,26274777,352,1037,26274425,26274777
7737,4,1,1,2412,-53,-93,40,94:a6:7e:c9:98:67,26276231,2464,-1010,26273767,26276231
7738,4,11,1,2412,-87,-93,6,4c:01:43:d7:f3:23,26279758,322,3205,26279436,26279758
7739,4,11,1,2412,-85,-93,8,4c:01:43:d7:f3:26,26280093,387,-52,26279706,26280093
7740,4,11,1,2412,-91,-93,2,48:dd:0c:92:4b:e5,26283160,382,2685,26282778,26283160
7741,6,24,1,2412,-87,-93,6,,26283508,28,320,26283480,26283508
7742,4,1,1,2412,-85,-93,8,78:67:0e:38:6c:d3,26293882,832,9542,26293050,26293882
7743,6,6,1,2412,-86,-93,7,40:b0:34:b7:01:d5,26297033,576,2575,26296457,26297033
7744,6,6,1,2412,-69,-93,24,12:86:8c:5f:93:1e,26298815,332,1450,26298483,26298815
7745,4,11,1,2412,-87,-93,6,4c:01:43:ec:a0:69,26317455,361,18279,26317094,26317455
7746,4,11,1,2412,-87,-93,6,4c:01:43:ec:a0:63,26317829,322,52,26317507,26317829
7747,4,11,1,2412,-86,-93,7,4c:01:43:ec:a0:66,26318164,387,-52,26317777,26318164
7748,4,11,1,2412,-83,-93,10,48:dd:0c:90:e3:87,26318903,362,377,26318541,26318903
7749,4,11,1,2412,-83,-93,10,48:dd:0c:90:e3:83,26319278,323,52,26318955,26319278
7750,4,11,1,2412,-84,-93,9,48:dd:0c:90:e3:85,26319613,382,-47,26319231,26319613
7751,4,1,1,2412,-89,-93,4,3c:bd:c5:ee:96:6d,26324591,2512,2466,26322079,26324591
7752,6,6,1,2412,-72,-93,21,52:86:8c:5f:93:1e,26328602,332,3679,26328270,26328602
7753,6,24,1,2412,-84,-93,9,,26348961,28,20331,26348933,26348961
7754,6,6,1,2412,-72,-93,21,32:86:8c:5f:93:1e,26350015,332,722,26349683,26350015
7755,4,1,1,2412,-67,-93,26,b0:e4:d5:32:ec:8a,26371811,1960,19836,26369851,26371811
7756,4,1,1,2412,-44,-93,49,94:a6:7e:c9:98:67,26378810,2464,4535,26376346,26378810
7757,4,11,1,2412,-85,-93,8,4c:01:43:d7:f3:29,26381783,362,2611,26381421,26381783
7758,4,11,1,2412,-85,-93,8,4c:01:43:d7:f3:23,26382158,322,53,26381836,26382158
7759,4,11,1,2412,-85,-93,8,4c:01:43:d7:f3:26,26382492,387,-53,26382105,26382492
7760,4,11,1,2412,-90,-93,3,48:dd:0c:92:4b:e7,26384850,362,1996,26384488,26384850
7761,6,6,1,2412,-65,-93,28,b4:e6:2d:b4:ff:71,26385729,64,815,26385665,26385729
7762,6,6,1,2412,-69,-93,24,,26385809,44,36,26385765,26385809
7763,6,24,1,2412,-83,-93,10,,26387312,28,1475,26387284,26387312
7764,6,24,1,2412,-85,-93,8,,26391205,28,3865,26391177,26391205
7765,6,6,1,2412,-84,-93,9,40:b0:34:b7:01:d5,26399434,576,7653,26398858,26399434
7766,6,6,1,2412,-88,-93,5,e2:db:d1:d1:b0:4a,26419424,52,19938,26419372,26419424
7767,4,11,1,2412,-80,-93,13,4c:01:43:ec:a0:69,26419854,361,69,26419493,26419854
7768,4,11,1,2412,-81,-93,12,4c:01:43:ec:a0:63,26420228,322,52,26419906,26420228
7769,4,11,1,2412,-80,-93,13,4c:01:43:ec:a0:66,26420563,387,-52,26420176,26420563
7770,4,11,1,2412,-84,-93,9,48:dd:0c:90:e3:87,26421303,362,378,26420941,26421303
7771,4,11,1,2412,-84,-93,9,48:dd:0c:90:e3:83,26421677,323,51,26421354,26421677
7772,4,11,1,2412,-84,-93,9,48:dd:0c:90:e3:85,26422013,382,-46,26421631,26422013
7773,4,1,1,2412,-86,-93,7,,26431639,304,9322,26431335,26431639
7774,6,6,1,2412,-89,-93,4,e2:db:d1:d1:b0:4a,26440914,68,9207,26440846,26440914
7775,6,6,1,2412,-87,-93,6,,26441067,44,109,26441023,26441067
7776,6,6,1,2412,-87,-93,6,,26442293,44,1182,26442249,26442293
7777,6,6,1,2412,-68,-93,25,32:86:8c:5f:93:1e,26454736,332,12111,26454404,26454736
7778,6,6,1,2412,-89,-93,4,,26456054,44,1274,26456010,26456054
7779,6,6,1,2412,-88,-93,5,,26456759,44,661,26456715,26456759
7780,6,6,1,2412,-88,-93,5,,26456884,44,81,26456840,26456884
7781,4,1,1,2412,-68,-93,25,b0:e4:d5:32:ec:8a,26474879,1960,16035,26472919,26474879
7782,6,6,1,2412,-68,-93,25,10:86:8c:5f:93:1e,26478638,344,3415,26478294,26478638
7783,4,1,1,2412,-47,-93,46,94:a6:7e:c9:98:67,26481856,2464,754,26479392,26481856
7784,6,6,1,2412,-89,-93,4,e2:db:d1:d1:b0:4a,26489562,52,7654,26489510,26489562
7785,4,11,1,2412,-81,-93,12,48:dd:0c:7d:86:25,26498243,382,8299,26497861,26498243
7786,6,6,1,2412,-90,-93,3,e2:db:d1:d1:b0:4a,26501278,52,2983,26501226,26501278
7787,6,6,1,2412,-86,-93,7,40:b0:34:b7:01:d5,26501835,576,-19,26501259,26501835
7788,6,6,1,2412,-69,-93,24,12:86:8c:5f:93:1e,26503616,332,1449,26503284,26503616
7789,6,6,1,2412,-89,-93,4,,26509917,44,6257,26509873,26509917
7790,6,6,1,2412,-89,-93,4,,26511266,44,1305,26511222,26511266
7791,6,6,1,2412,-91,-93,2,e2:db:d1:d1:b0:4a,26514934,444,3224,26514490,26514934
7792,6,6,1,2412,-91,-93,2,e2:db:d1:d1:b0:4b,26515402,408,60,26514994,26515402
7793,4,11,1,2412,-88,-93,5,4c:01:43:ec:a0:69,26522253,361,6490,26521892,26522253
7794,4,11,1,2412,-88,-93,5,4c:01:43:ec:a0:63,26522627,322,52,26522305,26522627
7795,4,11,1,2412,-88,-93,5,4c:01:43:ec:a0:66,26522961,387,-53,26522574,26522961
7796,4,11,1,2412,-83,-93,10,48:dd:0c:90:e3:87,26523702,362,379,26523340,26523702
7797,4,11,1,2412,-82,-93,11,48:dd:0c:90:e3:83,26524077,323,52,26523754,26524077
7798,4,11,1,2412,-83,-93,10,48:dd:0c:90:e3:85,26524412,382,-47,26524030,26524412
7799,6,6,1,2412,-67,-93,26,52:86:8c:5f:93:1e,26529422,332,4678,26529090,26529422
7800,4,1,1,2412,-86,-93,7,3c:bd:c5:ee:96:6d,26532411,2512,477,26529899,26532411
7801,6,6,1,2412,-90,-93,3,e2:db:d1:d1:b0:4a,26553443,52,20980,26553391,26553443
7802,6,6,1,2412,-68,-93,25,32:86:8c:5f:93:1e,26554817,332,1042,26554485,26554817
7803,6,6,1,2412,-89,-93,4,e2:db:d1:d1:b0:4a,26563274,52,8405,26563222,26563274
7804,6,6,1,2412,-89,-93,4,e2:db:d1:d1:b0:4a,26567612,52,4286,26567560,26567612
7805,6,6,1,2412,-90,-93,3,e2:db:d1:d1:b0:4a,26568082,52,418,26568030,26568082
7806,6,6,1,2412,-87,-93,6,e2:db:d1:d1:b0:4a,26571198,52,3064,26571146,26571198
7807,6,6,1,2412,-89,-93,4,,26572728,44,1486,26572684,26572728
7808,6,6,1,2412,-90,-93,3,e2:db:d1:d1:b0:4a,26572991,68,195,26572923,26572991
7809,4,1,1,2412,-72,-93,21,b0:e4:d5:32:ec:8a,26578440,1960,3489,26576480,26578440
7810,4,1,1,2412,-49,-93,44,94:a6:7e:c9:98:67,26583246,2464,2342,26580782,26583246
7811,6,6,1,2412,-69,-93,24,10:86:8c:5f:93:1e,26585668,344,2078,26585324,26585668
7812,4,11,1,2412,-87,-93,6,4c:01:43:d7:f3:29,26586582,362,552,26586220,26586582
7813,4,11,1,2412,-88,-93,5,4c:01:43:d7:f3:23,26586957,322,53,26586635,26586957
7814,4,11,1,2412,-90,-93,3,4c:01:43:d7:f3:26,26587291,387,-53,26586904,26587291
7815,4,11,1,2412,-77,-93,16,48:dd:0c:7d:86:27,26601996,362,14343,26601634,26601996
7816,4,11,1,2412,-78,-93,15,48:dd:0c:7d:86:23,26602370,323,51,26602047,26602370
7817,4,11,1,2412,-77,-93,16,48:dd:0c:7d:86:25,26602705,382,-47,26602323,26602705
7818,6,6,1,2412,-77,-93,16,40:b0:34:b7:01:d5,26604236,576,955,26603660,26604236
7819,6,6,1,2412,-88,-93,5,,26605039,44,759,26604995,26605039
7820,6,6,1,2412,-90,-93,3,,26605499,44,416,26605455,26605499
7821,6,6,1,2412,-89,-93,4,e2:db:d1:d1:b0:4a,26605621,52,70,26605569,26605621
7822,6,6,1,2412,-69,-93,24,12:86:8c:5f:93:1e,26606197,332,244,26605865,26606197
7823,4,11,1,2412,-87,-93,6,4c:01:43:ec:a0:69,26624652,361,18094,26624291,26624652
7824,4,11,1,2412,-86,-93,7,4c:01:43:ec:a0:63,26625026,322,52,26624704,26625026
7825,4,11,1,2412,-86,-93,7,4c:01:43:ec:a0:66,26625360,387,-53,26624973,26625360
7826,4,11,1,2412,-88,-93,5,48:dd:0c:90:e3:87,26626102,362,380,26625740,26626102
7827,4,11,1,2412,-87,-93,6,48:dd:0c:90:e3:83,26626477,323,52,26626154,26626477
7828,6,6,1,2412,-69,-93,24,32:86:8c:5f:93:1e,26657218,332,30409,26656886,26657218
7829,6,6,1,2412,-89,-93,4,e2:db:d1:d1:b0:4a,26668375,52,11105,26668323,26668375
7830,4,1,1,2412,-67,-93,26,b0:e4:d5:32:ec:8a,26681122,1960,10787,26679162,26681122
7831,6,6,1,2412,-67,-93,26,10:86:8c:5f:93:1e,26682938,344,1472,26682594,26682938
7832,4,1,1,2412,-54,-93,39,94:a6:7e:c9:98:67,26685523,2464,121,26683059,26685523
7833,4,11,1,2412,-87,-93,6,4c:01:43:d7:f3:29,26688982,362,3097,26688620,26688982
7834,4,11,1,2412,-85,-93,8,4c:01:43:d7:f3:23,26689356,322,52,26689034,26689356
7835,4,11,1,2412,-87,-93,6,4c:01:43:d7:f3:26,26689691,387,-52,26689304,26689691
7836,4,11,1,2412,-64,-93,29,48:dd:0c:7d:86:27,26702414,362,12361,26702052,26702414
7837,4,11,1,2412,-65,-93,28,48:dd:0c:7d:86:23,26702789,323,52,26702466,26702789
7838,4,11,1,2412,-64,-93,29,48:dd:0c:7d:86:25,26703124,382,-47,26702742,26703124
7839,6,6,1,2412,-84,-93,9,,26705322,44,2154,26705278,26705322
7840,6,6,1,2412,-66,-93,27,12:86:8c:5f:93:1e,26708500,332,2846,26708168,26708500
7841,6,24,1,2412,-84,-93,9,,26724315,28,15787,26724287,26724315
7842,6,6,1,2412,-65,-93,28,52:86:8c:5f:93:1e,26734812,332,10165,26734480,26734812
7843,4,1,1,2412,-89,-93,4,3c:bd:c5:ee:96:6d,26735919,2512,-1405,26733407,26735919
7844,4,11,1,2412,-88,-93,5,,26776627,203,40505,26776424,26776627
7845,4,1,1,2412,-60,-93,33,b0:e4:d5:32:ec:8a,26781110,1960,2523,26779150,26781110
7846,4,1,1,2412,-53,-93,40,94:a6:7e:c9:98:67,26788137,2464,4563,26785673,26788137
7847,4,11,1,2412,-88,-93,5,4c:01:43:d7:f3:29,26791381,362,2882,26791019,26791381
7848,4,11,1,2412,-89,-93,4,4c:01:43:d7:f3:23,26791756,322,53,26791434,26791756
7849,4,11,1,2412,-89,-93,4,4c:01:43:d7:f3:26,26792090,387,-53,26791703,26792090
7850,4,11,1,2412,-69,-93,24,48:dd:0c:7d:86:27,26805741,362,13289,26805379,26805741
7851,4,11,1,2412,-71,-93,22,48:dd:0c:7d:86:23,26806116,323,52,26805793,26806116
7852,4,11,1,2412,-70,-93,23,48:dd:0c:7d:86:25,26806451,382,-47,26806069,26806451
7853,6,6,1,2412,-82,-93,11,,26807614,44,1119,26807570,26807614
7854,6,24,1,2412,-81,-93,12,,26808239,28,597,26808211,26808239
7855,6,6,1,2412,-76,-93,17,40:b0:34:b7:01:d5,26809038,576,223,26808462,26809038
7856,6,6,1,2412,-69,-93,24,12:86:8c:5f:93:1e,26810920,332,1550,26810588,26810920
7857,6,6,1,2412,-89,-93,4,e2:db:d1:d1:b0:4a,26820782,68,9794,26820714,26820782
7858,6,6,1,2412,-90,-93,3,e2:db:d1:d1:b0:4b,26822188,408,998,26821780,26822188
7859,4,11,1,2412,-83,-93,10,4c:01:43:ec:a0:69,26829450,361,6901,26829089,26829450
7860,4,11,1,2412,-76,-93,17,4c:01:43:ec:a0:63,26829823,322,51,26829501,26829823
7861,4,11,1,2412,-86,-93,7,4c:01:43:ec:a0:66,26830158,387,-52,26829771,26830158
7862,4,11,1,2412,-82,-93,11,48:dd:0c:90:e3:87,26830902,362,382,26830540,26830902
7863,4,11,1,2412,-83,-93,10,48:dd:0c:90:e3:83,26831276,323,51,26830953,26831276
7864,4,11,1,2412,-81,-93,12,48:dd:0c:90:e3:85,26831611,382,-47,26831229,26831611
7865,6,24,1,2412,-86,-93,7,,26834260,28,2621,26834232,26834260
7866,6,24,1,2412,-86,-93,7,,26834482,28,194,26834454,26834482
7867,6,24,1,2412,-85,-93,8,,26834679,28,169,26834651,26834679
7868,6,24,1,2412,-87,-93,6,,26834978,28,271,26834950,26834978
7869,6,24,1,2412,-85,-93,8,,26835293,28,287,26835265,26835293
7870,6,12,1,2412,-85,-93,8,4c:01:43:ec:a0:66,26835412,44,75,26835368,26835412
7871,6,24,1,2412,-84,-93,9,,26835815,28,375,26835787,26835815
7872,6,24,1,2412,-84,-93,9,,26836098,28,255,26836070,26836098
7873,6,24,1,2412,-84,-93,9,4c:01:43:ec:a0:66,26836222,32,92,26836190,26836222
7874,4,1,1,2412,-88,-93,5,3c:bd:c5:ee:96:6d,26836525,2512,-2209,26834013,26836525
7875,6,6,1,2412,-69,-93,24,52:86:8c:5f:93:1e,26839335,332,2478,26839003,26839335
7876,6,24,1,2412,-84,-93,9,,26848407,28,9044,26848379,26848407
7877,6,24,1,2412,-83,-93,10,,26856356,28,7921,26856328,26856356
7878,6,6,1,2412,-71,-93,22,32:86:8c:5f:93:1e,26862031,332,5343,26861699,26862031
7879,6,24,1,2412,-83,-93,10,,26871207,28,9148,26871179,26871207
7880,4,1,1,2412,-61,-93,32,b0:e4:d5:32:ec:8a,26883509,1960,10342,26881549,26883509
7881,6,6,1,2412,-68,-93,25,10:86:8c:5f:93:1e,26887619,344,3766,26887275,26887619
7882,4,1,1,2412,-89,-93,4,bc:98:df:ff:0f:8b,26888067,2568,-2120,26885499,26888067
7883,4,1,1,2412,-51,-93,42,94:a6:7e:c9:98:67,26890675,2464,144,26888211,26890675
7884,4,11,1,2412,-84,-93,9,4c:01:43:d7:f3:23,26894155,322,3158,26893833,26894155
7885,4,11,1,2412,-84,-93,9,4c:01:43:d7:f3:26,26894490,387,-52,26894103,26894490
7886,6,24,1,2412,-86,-93,7,,26899080,28,4562,26899052,26899080
7887,4,11,1,2412,-72,-93,21,48:dd:0c:7d:86:23,26908633,323,9230,26908310,26908633
7888,6,6,1,2412,-65,-93,28,12:86:8c:5f:93:1e,26913415,332,4450,26913083,26913415
7889,6,6,1,2412,-88,-93,5,,26916301,44,2842,26916257,26916301
7890,6,6,1,2412,-87,-93,6,,26920909,44,4564,26920865,26920909
7891,4,11,1,2412,-85,-93,8,4c:01:43:ec:a0:69,26931849,361,10579,26931488,26931849
7892,4,11,1,2412,-85,-93,8,4c:01:43:ec:a0:63,26932222,322,51,26931900,26932222
7893,4,11,1,2412,-86,-93,7,4c:01:43:ec:a0:66,26932557,387,-52,26932170,26932557
7894,4,11,1,2412,-84,-93,9,48:dd:0c:90:e3:87,26933301,362,382,26932939,26933301
7895,4,11,1,2412,-83,-93,10,48:dd:0c:90:e3:83,26933676,323,52,26933353,26933676
7896,4,11,1,2412,-84,-93,9,48:dd:0c:90:e3:85,26934011,382,-47,26933629,26934011
7897,6,6,1,2412,-89,-93,4,e2:db:d1:d1:b0:4a,26942092,52,8029,26942040,26942092
7898,6,6,1,2412,-89,-93,4,,26942382,44,246,26942338,26942382
7899,6,24,1,2412,-85,-93,8,,26944673,28,2263,26944645,26944673
7900,4,1,1,2412,-88,-93,5,78:67:0e:c4:a8:42,26945514,2736,-1895,26942778,26945514
7901,6,6,1,2412,-92,-93,1,e2:db:d1:d1:b0:4a,26948843,68,3261,26948775,26948843
7902,4,11,1,2412,-75,-93,18,48:dd:0c:7d:86:23,26960187,254,11090,26959933,26960187
7903,6,6,1,2412,-92,-93,1,49:dd:0c:90:e3:83,26960669,52,430,26960617,26960669
7904,6,6,1,2412,-89,-93,4,49:dd:0c:90:e3:83,26961726,52,1005,26961674,26961726
7905,6,6,1,2412,-90,-93,3,49:dd:0c:90:e3:83,26962377,52,599,26962325,26962377
7906,6,6,1,2412,-91,-93,2,49:dd:0c:90:e3:83,26964127,52,1698,26964075,26964127
7907,6,6,1,2412,-67,-93,26,32:86:8c:5f:93:1e,26964443,332,-16,26964111,26964443
7908,6,6,1,2412,-91,-93,2,49:dd:0c:90:e3:83,26965485,52,990,26965433,26965485
7909,6,6,1,2412,-91,-93,2,e2:db:d1:d1:b0:4a,26972958,52,7421,26972906,26972958
7910,6,6,1,2412,-91,-93,2,,26973232,44,230,26973188,26973232
7911,6,6,1,2412,-91,-93,2,e2:db:d1:d1:b0:4a,26976072,68,2772,26976004,26976072
7912,6,6,1,2412,-87,-93,6,3c:bd:c5:ee:96:6d,26979838,68,3698,26979770,26979838
7913,4,1,1,2412,-63,-93,30,b0:e4:d5:32:ec:8a,26985908,1960,4110,26983948,26985908
7914,6,6,1,2412,-86,-93,7,,26988053,44,2101,26988009,26988053
7915,6,6,1,2412,-70,-93,23,10:86:8c:5f:93:1e,26990020,344,1623,26989676,26990020
7916,4,1,1,2412,-54,-93,39,94:a6:7e:c9:98:67,26993060,2464,576,26990596,26993060
7917,4,11,1,2412,-91,-93,2,48:dd:0c:92:4b:e5,26999959,382,6517,26999577,26999959
7918,4,1,1,2412,-86,-93,7,78:67:0e:38:6c:d3,27007899,2736,5204,27005163,27007899
7919,6,6,1,2412,-75,-90,15,40:b0:34:b7:01:d5,27013840,576,5365,27013264,27013840
7920,6,6,1,2412,-67,-90,23,12:86:8c:5f:93:1e,27015620,332,1448,27015288,27015620
7921,6,6,1,2412,-88,-90,2,,27020455,44,4791,27020411,27020455
7922,4,11,1,2412,-88,-90,2,4c:01:43:ec:a0:69,27034247,361,13431,27033886,27034247
7923,4,11,1,2412,-86,-90,4,4c:01:43:ec:a0:63,27034621,322,52,27034299,27034621
7924,4,11,1,2412,-86,-90,4,4c:01:43:ec:a0:66,27034956,387,-52,27034569,27034956
7925,4,11,1,2412,-85,-90,5,48:dd:0c:90:e3:87,27035701,362,383,27035339,27035701
7926,4,11,1,2412,-86,-90,4,48:dd:0c:90:e3:83,27036076,323,52,27035753,27036076
7927,6,6,1,2412,-66,-90,24,52:86:8c:5f:93:1e,27043693,332,7285,27043361,27043693
7928,6,24,1,2412,-88,-90,2,,27050550,28,6829,27050522,27050550
7929,6,6,1,2412,-90,-90,0,3c:bd:c5:ee:96:6d,27063710,68,13092,27063642,27063710
7930,6,6,1,2412,-66,-90,24,32:86:8c:5f:93:1e,27066821,332,2779,27066489,27066821
7931,6,6,1,2412,-91,-90,-1,,27067199,44,334,27067155,27067199
7932,6,6,1,2412,-89,-90,1,,27068377,44,1134,27068333,27068377
7933,4,1,1,2412,-66,-90,24,b0:e4:d5:32:ec:8a,27088308,1960,17971,27086348,27088308
7934,6,6,1,2412,-90,-90,0,e2:db:d1:d1:b0:4a,27092928,68,4552,27092860,27092928
7935,6,6,1,2412,-66,-90,24,10:86:8c:5f:93:1e,27094937,344,1665,27094593,27094937
7936,4,1,1,2412,-57,-90,33,94:a6:7e:c9:98:67,27095482,2464,-1919,27093018,27095482
7937,4,11,1,2412,-86,-90,4,4c:01:43:d7:f3:29,27098580,362,2736,27098218,27098580
7938,4,11,1,2412,-85,-90,5,4c:01:43:d7:f3:23,27098954,322,52,27098632,27098954
7939,4,11,1,2412,-85,-90,5,4c:01:43:d7:f3:26,27099289,387,-52,27098902,27099289
7940,4,1,1,2412,-93,-90,-3,ac:67:84:84:8a:07,27107371,416,7666,27106955,27107371
7941,4,11,1,2412,-77,-90,13,48:dd:0c:7d:86:27,27113059,362,5326,27112697,27113059
7942,4,11,1,2412,-77,-90,13,48:dd:0c:7d:86:23,27113433,323,51,27113110,27113433
7943,4,11,1,2412,-76,-90,14,48:dd:0c:7d:86:25,27113768,382,-47,27113386,27113768
7944,6,6,1,2412,-80,-90,10,40:b0:34:b7:01:d5,27116241,576,1897,27115665,27116241
7945,6,6,1,2412,-65,-90,25,12:86:8c:5f:93:1e,27118078,332,1505,27117746,27118078
7946,4,1,1,2412,-92,-90,-2,00:26:62:eb:ea:74,27127828,968,8782,27126860,27127828
7947,6,6,1,2412,-90,-90,0,e2:db:d1:d1:b0:4a,27128914,444,642,27128470,27128914
7948,6,6,1,2412,-91,-90,-1,e2:db:d1:d1:b0:4b,27129381,408,59,27128973,27129381
7949,6,6,1,2412,-91,-90,-1,,27131669,44,2244,27131625,27131669
7950,4,11,1,2412,-89,-90,1,4c:01:43:ec:a0:63,27137020,322,5029,27136698,27137020
7951,4,11,1,2412,-81,-90,9,4c:01:43:ec:a0:66,27137354,387,-53,27136967,27137354
7952,4,11,1,2412,-85,-90,5,48:dd:0c:90:e3:87,27138101,362,385,27137739,27138101
7953,4,11,1,2412,-86,-90,4,48:dd:0c:90:e3:83,27138475,323,51,27138152,27138475
7954,4,11,1,2412,-86,-90,4,48:dd:0c:90:e3:85,27138811,382,-46,27138429,27138811
7955,6,6,1,2412,-86,-90,4,,27153045,44,14190,27153001,27153045
7956,6,6,1,2412,-86,-90,4,,27153192,44,103,27153148,27153192
7957,6,24,1,2412,-88,-90,2,,27153845,28,625,27153817,27153845
7958,6,6,1,2412,-63,-90,27,32:86:8c:5f:93:1e,27169328,332,15151,27168996,27169328
7959,6,6,1,2412,-89,-90,1,,27170612,44,1240,27170568,27170612
7960,6,6,1,2412,-89,-90,1,3c:bd:c5:ee:96:6d,27172201,68,1521,27172133,27172201
7961,6,6,1,2412,-89,-90,1,3c:bd:c5:ee:96:6d,27180563,68,8294,27180495,27180563
7962,4,1,1,2412,-65,-90,25,b0:e4:d5:32:ec:8a,27190707,1960,8184,27188747,27190707
7963,6,6,1,2412,-61,-90,29,10:86:8c:5f:93:1e,27197060,344,6009,27196716,27197060
7964,6,6,1,2412,-89,-90,1,3c:bd:c5:ee:96:6d,27197503,52,391,27197451,27197503
7965,4,1,1,2412,-53,-90,37,94:a6:7e:c9:98:67,27197825,2464,-2142,27195361,27197825
7966,4,11,1,2412,-89,-90,1,,27210585,107,12653,27210478,27210585
7967,6,24,1,2412,-85,-90,5,78:67:0e:c4:a8:42,27210698,32,81,27210666,27210698
7968,4,11,1,2412,-87,-90,3,,27211742,107,937,27211635,27211742
7969,4,1,1,2412,-87,-90,3,78:67:0e:38:6c:d3,27212700,2736,-1778,27209964,27212700
7970,4,11,1,2412,-77,-90,13,48:dd:0c:7d:86:27,27215458,362,2396,27215096,27215458
7971,4,11,1,2412,-78,-90,12,48:dd:0c:7d:86:23,27215833,323,52,27215510,27215833
7972,4,11,1,2412,-77,-90,13,48:dd:0c:7d:86:25,27216168,382,-47,27215786,27216168
7973,4,1,1,2412,-84,-90,6,78:67:0e:38:6c:d3,27217871,832,871,27217039,27217871
7974,6,24,1,2412,-86,-90,4,3c:bd:c5:ee:96:6d,27225400,28,7501,27225372,27225400
7975,6,6,1,2412,-88,-90,2,,27225680,44,236,27225636,27225680
7976,6,6,1,2412,-89,-90,1,3c:bd:c5:ee:96:6d,27227152,68,1404,27227084,27227152
7977,4,1,1,2412,-92,-90,-2,00:26:62:eb:ea:74,27228460,968,340,27227492,27228460
7978,6,6,1,2412,-87,-90,3,3c:bd:c5:ee:96:6d,27237005,68,8477,27236937,27237005
7979,4,11,1,2412,-89,-90,1,4c:01:43:ec:a0:69,27239045,361,1679,27238684,27239045
7980,4,11,1,2412,-88,-90,2,4c:01:43:ec:a0:63,27239419,322,52,27239097,27239419
7981,4,11,1,2412,-89,-90,1,4c:01:43:ec:a0:66,27239753,387,-53,27239366,27239753
7982,4,11,1,2412,-87,-90,3,48:dd:0c:90:e3:87,27240501,362,386,27240139,27240501
7983,4,11,1,2412,-87,-90,3,48:dd:0c:90:e3:83,27240875,323,51,27240552,27240875
7984,4,11,1,2412,-86,-90,4,48:dd:0c:90:e3:85,27241210,382,-47,27240828,27241210
7985,6,6,1,2412,-86,-90,4,e2:db:d1:d1:b0:4a,27249693,52,8431,27249641,27249693
7986,6,6,1,2412,-88,-90,2,,27250487,44,750,27250443,27250487
7987,6,6,1,2412,-88,-90,2,,27250919,44,388,27250875,27250919
7988,6,6,1,2412,-88,-90,2,3c:bd:c5:ee:96:6d,27253227,68,2240,27253159,27253227
7989,4,1,1,2412,-90,-90,0,78:67:0e:c4:a8:42,27253757,2736,-2206,27251021,27253757
7990,4,1,1,2412,-90,-90,0,78:67:0e:c4:a8:42,27259555,352,5446,27259203,27259555
7991,4,11,1,2412,-90,-90,0,,27261485,107,1823,27261378,27261485
7992,6,24,1,2412,-86,-90,4,78:67:0e:c4:a8:42,27261599,32,82,27261567,27261599
7993,6,6,1,2412,-88,-90,2,3c:bd:c5:ee:96:6d,27263220,68,1553,27263152,27263220
7994,6,24,1,2412,-89,-90,1,,27271211,28,7963,27271183,27271211
7995,4,11,1,2412,-91,-90,-1,,27272630,107,1312,27272523,27272630
7996,6,24,1,2412,-86,-90,4,78:67:0e:c4:a8:42,27272744,32,82,27272712,27272744
7997,6,6,1,2412,-88,-90,2,,27274201,44,1413,27274157,27274201
7998,4,1,1,2412,-89,-90,1,78:67:0e:c4:a8:42,27275272,352,719,27274920,27275272
7999,6,6,1,2412,-88,-90,2,,27276720,44,1404,27276676,27276720
8000,6,6,1,2412,-86,-90,4,,27277428,44,664,27277384,27277428
8001,6,24,1,2412,-87,-90,3,,27278583,28,1127,27278555,27278583
8002,6,6,1,2412,-88,-90,2,3c:bd:c5:ee:96:6d,27279115,68,464,27279047,27279115
8003,6,24,1,2412,-88,-90,2,,27284062,28,4919,27284034,27284062
8004,6,6,1,2412,-88,-90,2,3c:bd:c5:ee:96:6d,27289319,68,5189,27289251,27289319
8005,4,1,1,2412,-62,-90,28,b0:e4:d5:32:ec:8a,27293106,1960,1827,27291146,27293106
8006,4,1,1,2412,-54,-90,36,94:a6:7e:c9:98:67,27300088,2464,4518,27297624,27300088
8007,6,24,1,2412,-87,-90,3,3c:bd:c5:ee:96:6d,27302467,28,2351,27302439,27302467
8008,6,6,1,2412,-87,-90,3,,27302746,44,235,27302702,27302746
8009,4,11,1,2412,-89,-90,1,4c:01:43:d7:f3:29,27303379,362,271,27303017,27303379
8010,4,11,1,2412,-90,-90,0,4c:01:43:d7:f3:23,27303754,322,53,27303432,27303754
8011,6,6,1,2412,-86,-90,4,3c:bd:c5:ee:96:6d,27306000,68,2178,27305932,27306000
8012,6,6,1,2412,-66,-90,24,10:86:8c:5f:93:1e,27306208,344,-136,27305864,27306208
8013,4,11,1,2412,-88,-90,2,48:dd:0c:92:4b:e7,27306744,362,174,27306382,27306744
8014,4,11,1,2412,-91,-90,-1,48:dd:0c:92:4b:e3,27307118,323,51,27306795,27307118
8015,4,11,1,2412,-89,-90,1,48:dd:0c:92:4b:e5,27307453,382,-47,27307071,27307453
8016,6,6,1,2412,-87,-90,3,e2:db:d1:d1:b0:4a,27309459,52,1954,27309407,27309459
8017,6,6,1,2412,-87,-90,3,,27309733,44,230,27309689,27309733
8018,6,24,1,2412,-89,-90,1,,27310560,28,799,27310532,27310560
8019,6,6,1,2412,-88,-90,2,e2:db:d1:d1:b0:4a,27311008,68,380,27310940,27311008
8020,4,1,1,2412,-88,-90,2,78:67:0e:38:6c:d3,27315100,2736,1356,27312364,27315100
8021,4,11,1,2412,-77,-90,13,48:dd:0c:7d:86:27,27317859,362,2397,27317497,27317859
8022,4,11,1,2412,-75,-90,15,48:dd:0c:7d:86:23,27318234,323,52,27317911,27318234
8023,4,11,1,2412,-75,-90,15,48:dd:0c:7d:86:25,27318569,382,-47,27318187,27318569
8024,6,24,1,2412,-87,-90,3,,27319497,28,900,27319469,27319497
8025,6,6,1,2412,-87,-90,3,,27319993,44,452,27319949,27319993
8026,6,6,1,2412,-84,-90,6,40:b0:34:b7:01:d5,27321043,576,474,27320467,27321043
8027,6,6,1,2412,-66,-90,24,12:86:8c:5f:93:1e,27322883,332,1508,27322551,27322883
8028,4,1,1,2412,-93,-90,-3,00:26:62:eb:ea:74,27330808,968,6957,27329840,27330808
8029,6,6,1,2412,-87,-90,3,e2:db:d1:d1:b0:4a,27333740,444,2488,27333296,27333740
8030,6,6,1,2412,-89,-90,1,e2:db:d1:d1:b0:4b,27334235,408,87,27333827,27334235
8031,6,6,1,2412,-89,-90,1,,27335181,44,902,27335137,27335181
8032,6,6,1,2412,-88,-90,2,e2:db:d1:d1:b0:4f,27335258,408,-331,27334850,27335258
8033,6,6,1,2412,-87,-90,3,e2:db:d1:d1:b0:4a,27335699,548,-107,27335151,27335699
8034,6,6,1,2412,-87,-90,3,e2:db:d1:d1:b0:4a,27336280,576,5,27335704,27336280
8035,4,11,1,2412,-88,-90,2,4c:01:43:ec:a0:69,27341444,361,4803,27341083,27341444
8036,4,11,1,2412,-87,-90,3,4c:01:43:ec:a0:63,27341818,322,52,27341496,27341818
8037,4,11,1,2412,-87,-90,3,4c:01:43:ec:a0:66,27342152,387,-53,27341765,27342152
8038,4,11,1,2412,-84,-90,6,48:dd:0c:90:e3:87,27342900,362,386,27342538,27342900
8039,4,11,1,2412,-84,-90,6,48:dd:0c:90:e3:83,27343275,323,52,27342952,27343275
8040,4,11,1,2412,-84,-90,6,48:dd:0c:90:e3:85,27343610,382,-47,27343228,27343610
8041,6,6,1,2412,-87,-90,3,,27345592,44,1938,27345548,27345592
8042,6,6,1,2412,-89,-90,1,e2:db:d1:d1:b0:4a,27346920,68,1260,27346852,27346920
8043,6,24,1,2412,-86,-90,4,,27351217,28,4269,27351189,27351217
8044,6,6,1,2412,-66,-90,24,52:86:8c:5f:93:1e,27352193,332,644,27351861,27352193
8045,4,1,1,2412,-91,-90,-1,bc:98:df:ff:0f:8b,27370555,3176,15186,27367379,27370555
8046,4,1,1,2412,-90,-90,0,bc:98:df:ff:0f:8b,27374093,3176,362,27370917,27374093
8047,4,1,1,2412,-90,-90,0,bc:98:df:ff:0f:8b,27378600,3176,1331,27375424,27378600
8048,4,1,1,2412,-65,-90,25,b0:e4:d5:32:ec:8a,27395505,1960,14945,27393545,27395505
8049,6,6,1,2412,-89,-90,1,,27399499,44,3950,27399455,27399499
8050,6,6,1,2412,-64,-90,26,10:86:8c:5f:93:1e,27399967,344,124,27399623,27399967
8051,4,1,1,2412,-51,-90,39,94:a6:7e:c9:98:67,27402499,2464,68,27400035,27402499
8052,4,11,1,2412,-86,-90,4,4c:01:43:d7:f3:23,27406153,322,3332,27405831,27406153
8053,4,11,1,2412,-86,-90,4,4c:01:43:d7:f3:26,27406488,387,-52,27406101,27406488
8054,6,6,1,2412,-88,-90,2,,27410220,44,3688,27410176,27410220
8055,4,11,1,2412,-86,-90,4,48:dd:0c:7d:86:23,27420634,323,10091,27420311,27420634
8056,6,6,1,2412,-84,-90,6,40:b0:34:b7:01:d5,27423444,576,2234,27422868,27423444
8057,6,6,1,2412,-69,-90,21,12:86:8c:5f:93:1e,27425223,332,1447,27424891,27425223
8058,6,6,1,2412,-91,-90,-1,e2:db:d1:d1:b0:4b,27436621,408,10990,27436213,27436621
8059,6,6,1,2412,-89,-90,1,e2:db:d1:d1:b0:4a,27437980,632,727,27437348,27437980
8060,6,6,1,2412,-90,-90,0,,27438710,44,686,27438666,27438710
8061,6,6,1,2412,-90,-90,0,,27443128,44,4374,27443084,27443128
8062,4,11,1,2412,-86,-90,4,4c:01:43:ec:a0:69,27443843,361,354,27443482,27443843
8063,4,11,1,2412,-87,-90,3,4c:01:43:ec:a0:63,27444216,322,51,27443894,27444216
8064,4,11,1,2412,-89,-90,1,4c:01:43:ec:a0:66,27444551,387,-52,27444164,27444551
8065,4,11,1,2412,-88,-90,2,48:dd:0c:90:e3:85,27446010,382,1077,27445628,27446010
8066,4,1,1,2412,-93,-90,-3,40:ca:63:2d:74:be,27447070,1896,-836,27445174,27447070
8067,6,6,1,2412,-89,-90,1,e2:db:d1:d1:b0:4a,27467055,52,19933,27467003,27467055
8068,6,6,1,2412,-90,-90,0,,27467325,44,226,27467281,27467325
8069,4,11,1,2412,-85,-90,5,4c:01:43:d7:f3:23,27467754,254,175,27467500,27467754
8070,6,6,1,2412,-72,-90,18,32:86:8c:5f:93:1e,27476423,332,8337,27476091,27476423
8071,6,24,1,2412,-85,-90,5,,27482719,28,6268,27482691,27482719
8072,6,6,1,2412,-90,-90,0,e2:db:d1:d1:b0:4a,27494450,52,11679,27494398,27494450
8073,6,6,1,2412,-89,-90,1,,27495124,44,630,27495080,27495124
8074,4,1,1,2412,-65,-90,25,b0:e4:d5:32:ec:8a,27497905,1960,821,27495945,27497905
8075,4,1,1,2412,-52,-90,38,94:a6:7e:c9:98:67,27504941,2464,4572,27502477,27504941
8076,4,11,1,2412,-86,-90,4,4c:01:43:d7:f3:29,27508178,362,2875,27507816,27508178
8077,4,11,1,2412,-85,-90,5,4c:01:43:d7:f3:23,27508553,322,53,27508231,27508553
8078,4,1,1,2412,-89,-90,1,78:67:0e:38:6c:d3,27519921,2736,8632,27517185,27519921
8079,4,11,1,2412,-77,-90,13,48:dd:0c:7d:86:27,27522680,362,2397,27522318,27522680
8080,4,11,1,2412,-76,-90,14,48:dd:0c:7d:86:23,27523054,323,51,27522731,27523054
8081,4,11,1,2412,-78,-90,12,48:dd:0c:7d:86:25,27523390,382,-46,27523008,27523390
8082,6,6,1,2412,-86,-90,4,40:b0:34:b7:01:d5,27525845,576,1879,27525269,27525845
8083,6,6,1,2412,-90,-90,0,e2:db:d1:d1:b0:4b,27539012,408,12759,27538604,27539012
8084,4,11,1,2412,-89,-90,1,4c:01:43:ec:a0:66,27546950,387,7551,27546563,27546950
8085,4,11,1,2412,-85,-90,5,48:dd:0c:90:e3:87,27547700,362,388,27547338,27547700
8086,4,11,1,2412,-84,-90,6,48:dd:0c:90:e3:83,27548074,323,51,27547751,27548074
8087,4,11,1,2412,-85,-90,5,48:dd:0c:90:e3:85,27548410,382,-46,27548028,27548410
8088,4,1,1,2412,-91,-90,-1,3c:bd:c5:ee:96:6d,27555863,976,6477,27554887,27555863
8089,4,1,1,2412,-93,-90,-3,78:67:0e:c4:a8:42,27559913,2736,1314,27557177,27559913
8090,6,6,1,2412,-69,-90,21,32:86:8c:5f:93:1e,27580594,332,20349,27580262,27580594
8091,4,1,1,2412,-60,-90,30,b0:e4:d5:32:ec:8a,27600304,1960,17750,27598344,27600304
8092,4,1,1,2412,-52,-90,38,94:a6:7e:c9:98:67,27607468,2464,4700,27605004,27607468
8093,6,6,1,2412,-67,-90,23,10:86:8c:5f:93:1e,27610795,344,2983,27610451,27610795
8094,4,1,1,2412,-91,-90,-1,78:67:0e:c4:a8:42,27621263,3472,6996,27617791,27621263
8095,4,11,1,2412,-73,-90,17,48:dd:0c:7d:86:27,27625071,362,3446,27624709,27625071
8096,4,11,1,2412,-75,-90,15,48:dd:0c:7d:86:23,27625445,323,51,27625122,27625445
8097,4,11,1,2412,-74,-90,16,48:dd:0c:7d:86:25,27625780,382,-47,27625398,27625780
8098,4,11,1,2412,-84,-90,6,4c:01:43:ec:a0:66,27626106,382,-56,27625724,27626106
8099,4,1,1,2412,-89,-90,1,,27639132,304,12722,27638828,27639132
8100,6,6,1,2412,-67,-90,23,12:86:8c:5f:93:1e,27639769,332,305,27639437,27639769
8101,4,5.5,1,2412,-87,-90,3,,27640874,117,988,27640757,27640874
8102,4,5.5,1,2412,-86,-90,4,,27641290,117,299,27641173,27641290
8103,4,11,1,2412,-86,-90,4,48:dd:0c:90:e3:87,27650100,362,8448,27649738,27650100
8104,4,11,1,2412,-88,-90,2,48:dd:0c:90:e3:83,27650474,323,51,27650151,27650474
8105,4,11,1,2412,-88,-90,2,48:dd:0c:90:e3:85,27650809,382,-47,27650427,27650809
8106,6,24,1,2412,-87,-90,3,,27651832,28,995,27651804,27651832
8107,4,1,1,2412,-86,-90,4,78:67:0e:38:6c:d3,27652396,352,212,27652044,27652396
8108,6,24,1,2412,-84,-90,6,,27671222,28,18798,27671194,27671222
8109,6,6,1,2412,-63,-90,27,32:86:8c:5f:93:1e,27681225,332,9671,27680893,27681225
8110,6,24,1,2412,-86,-90,4,,27689779,28,8526,27689751,27689779
8111,6,24,1,2412,-85,-90,5,,27701190,28,11383,27701162,27701190
8112,4,1,1,2412,-59,-90,31,b0:e4:d5:32:ec:8a,27702703,1960,-447,27700743,27702703
8113,4,1,1,2412,-49,-90,41,94:a6:7e:c9:98:67,27709863,2464,4696,27707399,27709863
8114,4,11,1,2412,-81,-90,9,4c:01:43:d7:f3:29,27712977,362,2752,27712615,27712977
8115,4,11,1,2412,-82,-90,8,4c:01:43:d7:f3:23,27713352,322,53,27713030,27713352
8116,4,1,1,2412,-91,-90,-1,78:67:0e:38:6c:d3,27724701,2736,8613,27721965,27724701
8117,4,11,1,2412,-76,-90,14,48:dd:0c:7d:86:27,27727460,362,2397,27727098,27727460
8118,4,11,1,2412,-75,-90,15,48:dd:0c:7d:86:23,27727834,323,51,27727511,27727834
8119,4,11,1,2412,-75,-90,15,48:dd:0c:7d:86:25,27728169,382,-47,27727787,27728169
8120,6,6,1,2412,-89,-90,1,,27729565,44,1352,27729521,27729565
8121,6,6,1,2412,-82,-90,8,40:b0:34:b7:01:d5,27730647,576,506,27730071,27730647
8122,6,6,1,2412,-63,-90,27,12:86:8c:5f:93:1e,27732425,332,1446,27732093,27732425
8123,6,6,1,2412,-90,-90,0,e2:db:d1:d1:b0:4b,27743815,408,10982,27743407,27743815
8124,6,6,1,2412,-90,-90,0,e2:db:d1:d1:b0:4d,27744247,408,24,27743839,27744247
8125,6,6,1,2412,-90,-90,0,e2:db:d1:d1:b0:4f,27744697,408,42,27744289,27744697
8126,6,6,1,2412,-90,-90,0,e2:db:d1:d1:b0:4a,27745968,392,879,27745576,27745968
8127,6,6,1,2412,-90,-90,0,e2:db:d1:d1:b0:4a,27746392,380,44,27746012,27746392
8128,6,6,1,2412,-88,-90,2,,27747003,44,567,27746959,27747003
8129,4,11,1,2412,-87,-90,3,4c:01:43:ec:a0:69,27751039,361,3675,27750678,27751039
8130,4,11,1,2412,-87,-90,3,4c:01:43:ec:a0:66,27751748,387,322,27751361,27751748
8131,6,24,1,2412,-85,-90,5,,27752043,28,267,27752015,27752043
8132,4,11,1,2412,-86,-90,4,48:dd:0c:90:e3:87,27752499,362,94,27752137,27752499
8133,6,24,1,2412,-87,-90,3,,27763792,28,11265,27763764,27763792
8134,4,1,1,2412,-87,-90,3,78:67:0e:c4:a8:42,27764713,2736,-1815,27761977,27764713
8135,4,1,1,2412,-87,-90,3,78:67:0e:c4:a8:42,27768344,352,3279,27767992,27768344
8136,4,11,1,2412,-87,-90,3,,27770147,107,1696,27770040,27770147
8137,6,24,1,2412,-85,-90,5,,27771413,28,1238,27771385,27771413
8138,4,11,1,2412,-88,-90,2,4c:01:43:d7:f3:23,27775886,659,3814,27775227,27775886
8139,4,11,1,2412,-86,-90,4,4c:01:43:ec:a0:63,27776850,659,305,27776191,27776850
8140,6,6,1,2412,-63,-90,27,32:86:8c:5f:93:1e,27783625,332,6443,27783293,27783625
8141,6,24,1,2412,-88,-90,2,,27788173,28,4520,27788145,27788173
8142,6,6,1,2412,-89,-90,1,,27788662,44,445,27788618,27788662
8143,6,24,1,2412,-85,-90,5,,27791217,28,2527,27791189,27791217
8144,4,1,1,2412,-62,-90,28,b0:e4:d5:32:ec:8a,27805102,1960,11925,27803142,27805102
8145,4,1,1,2412,-50,-90,40,94:a6:7e:c9:98:67,27812271,2464,4705,27809807,27812271
8146,4,11,1,2412,-73,-90,17,48:dd:0c:92:4b:e7,27818448,362,5815,27818086,27818448
8147,4,11,1,2412,-89,-90,1,48:dd:0c:92:4b:e5,27819158,382,328,27818776,27819158
8148,6,24,1,2412,-83,-90,7,,27822254,28,3068,27822226,27822254
8149,6,24,1,2412,-85,-90,5,,27822368,28,86,27822340,27822368
8150,4,11,1,2412,-88,-90,2,48:dd:0c:7d:86:25,27830570,382,7820,27830188,27830570
8151,4,1,1,2412,-68,-90,22,78:67:0e:38:6c:d3,27831728,1640,-482,27830088,27831728
8152,6,6,1,2412,-80,-90,10,40:b0:34:b7:01:d5,27833223,576,919,27832647,27833223
8153,6,6,1,2412,-66,-90,24,12:86:8c:5f:93:1e,27834826,332,1271,27834494,27834826
8154,6,24,1,2412,-83,-90,7,,27837820,28,2966,27837792,27837820
8155,4,1,1,2412,-91,-90,-1,00:26:62:eb:ea:74,27845075,968,6287,27844107,27845075
8156,4,11,1,2412,-84,-90,6,4c:01:43:ec:a0:63,27853812,322,8415,27853490,27853812
8157,4,11,1,2412,-83,-90,7,4c:01:43:ec:a0:66,27854147,387,-52,27853760,27854147
8158,4,11,1,2412,-87,-90,3,48:dd:0c:90:e3:85,27855609,382,1080,27855227,27855609
8159,4,11,1,2412,-84,-90,6,4c:01:43:ec:a0:63,27856803,254,940,27856549,27856803
8160,4,11,1,2412,-90,-90,0,4c:01:43:d7:f3:23,27857532,254,475,27857278,27857532
8161,4,1,1,2412,-88,-90,2,3c:bd:c5:ee:96:6d,27863063,1056,4475,27862007,27863063
8162,4,1,1,2412,-88,-90,2,78:67:0e:c4:a8:42,27867113,2736,1314,27864377,27867113
8163,4,1,1,2412,-60,-90,30,b0:e4:d5:32:ec:8a,27907502,1960,38429,27905542,27907502
8164,6,24,1,2412,-88,-90,2,,27911220,28,3690,27911192,27911220
8165,4,1,1,2412,-48,-90,42,94:a6:7e:c9:98:67,27914655,2464,971,27912191,27914655
8166,4,11,1,2412,-76,-90,14,48:dd:0c:7d:86:27,27932260,362,17243,27931898,27932260
8167,4,11,1,2412,-75,-90,15,48:dd:0c:7d:86:23,27932635,323,52,27932312,27932635
8168,4,11,1,2412,-74,-90,16,48:dd:0c:7d:86:25,27932970,382,-47,27932588,27932970
8169,6,6,1,2412,-80,-90,10,40:b0:34:b7:01:d5,27935450,576,1904,27934874,27935450
8170,4,1,1,2412,-88,-90,2,78:67:0e:c4:a8:42,27969630,2736,31444,27966894,27969630
8171,4,1,1,2412,-86,-90,4,78:67:0e:c4:a8:42,27972404,832,1942,27971572,27972404
8172,4,1,1,2412,-87,-90,3,78:67:0e:c4:a8:42,27973247,848,-5,27972399,27973247
8173,4,11,1,2412,-87,-90,3,,27974169,107,815,27974062,27974169
8174,6,6,1,2412,-66,-90,24,32:86:8c:5f:93:1e,27988427,332,13926,27988095,27988427
8175,6,24,1,2412,-86,-90,4,,28003800,28,15345,28003772,28003800
8176,6,6,1,2412,-65,-90,25,10:86:8c:5f:93:1e,28016542,344,12398,28016198,28016542
8177,4,1,1,2412,-51,-90,39,94:a6:7e:c9:98:67,28017688,2464,-1318,28015224,28017688
8178,4,11,1,2412,-90,-90,0,4c:01:43:d7:f3:29,28020176,362,2126,28019814,28020176
8179,6,6,1,2412,-89,-90,1,e2:db:d1:d1:b0:4a,28027799,52,7571,28027747,28027799
8180,6,6,1,2412,-89,-90,1,,28028127,44,284,28028083,28028127
8181,6,6,1,2412,-90,-90,0,e2:db:d1:d1:b0:4a,28029733,52,1554,28029681,28029733
8182,4,1,1,2412,-88,-90,2,78:67:0e:38:6c:d3,28031998,2736,-471,28029262,28031998
8183,4,11,1,2412,-71,-90,19,48:dd:0c:7d:86:27,28034757,362,2397,28034395,28034757
8184,4,11,1,2412,-70,-90,20,48:dd:0c:7d:86:23,28035131,323,51,28034808,28035131
8185,4,11,1,2412,-70,-90,20,48:dd:0c:7d:86:25,28035467,382,-46,28035085,28035467
8186,6,24,1,2412,-87,-90,3,,28037179,28,1684,28037151,28037179
8187,6,6,1,2412,-79,-90,11,40:b0:34:b7:01:d5,28037851,576,96,28037275,28037851
8188,4,1,1,2412,-90,-90,0,70:3a:cb:63:35:b2,28039890,2216,-177,28037674,28039890
8189,6,6,1,2412,-66,-90,24,12:86:8c:5f:93:1e,28041962,332,1740,28041630,28041962
8190,6,24,1,2412,-87,-90,3,,28047557,28,5567,28047529,28047557
8191,6,6,1,2412,-90,-90,0,e2:db:d1:d1:b0:4a,28048307,52,698,28048255,28048307
8192,6,6,1,2412,-87,-90,3,,28048577,44,226,28048533,28048577
8193,6,6,1,2412,-88,-90,2,e2:db:d1:d1:b0:4a,28048743,52,114,28048691,28048743
8194,6,6,1,2412,-88,-90,2,,28049072,44,285,28049028,28049072
8195,6,12,1,2412,-86,-90,4,,28052420,32,3316,28052388,28052420
8196,6,6,1,2412,-88,-90,2,,28053089,44,625,28053045,28053089
8197,4,1,1,2412,-92,-90,-2,ac:67:84:84:8a:07,28056767,416,3262,28056351,28056767
8198,4,11,1,2412,-89,-90,1,4c:01:43:ec:a0:63,28058610,322,1521,28058288,28058610
8199,6,6,1,2412,-87,-90,3,e2:db:d1:d1:b0:4a,28062253,52,3591,28062201,28062253
8200,6,6,1,2412,-89,-90,1,,28063957,44,1660,28063913,28063957
8201,6,6,1,2412,-65,-90,25,52:86:8c:5f:93:1e,28069514,332,5225,28069182,28069514
8202,6,6,1,2412,-89,-90,1,,28070700,44,1142,28070656,28070700
8203,6,6,1,2412,-89,-90,1,e2:db:d1:d1:b0:4a,28075522,52,4770,28075470,28075522
8204,6,6,1,2412,-89,-90,1,,28075792,44,226,28075748,28075792
8205,4,1,1,2412,-90,-90,0,,28077323,304,1227,28077019,28077323
8206,6,6,1,2412,-89,-90,1,,28077548,44,181,28077504,28077548
8207,6,6,1,2412,-89,-90,1,e2:db:d1:d1:b0:4a,28089313,52,11713,28089261,28089313
8208,6,6,1,2412,-88,-90,2,e2:db:d1:d1:b0:4a,28089795,52,430,28089743,28089795
8209,6,6,1,2412,-90,-90,0,,28090093,44,254,28090049,28090093
8210,6,6,1,2412,-88,-90,2,,28093428,44,3291,28093384,28093428
8211,4,1,1,2412,-90,-90,0,ac:67:84:84:8a:07,28101469,416,7625,28101053,28101469
8212,4,1,1,2412,-68,-90,22,b0:e4:d5:32:ec:8a,28112300,1960,8871,28110340,28112300
8213,4,1,1,2412,-92,-90,-2,bc:98:df:ff:0f:8b,28116531,2568,1663,28113963,28116531
8214,6,6,1,2412,-66,-90,24,10:86:8c:5f:93:1e,28118954,344,2079,28118610,28118954
8215,4,1,1,2412,-53,-90,37,94:a6:7e:c9:98:67,28119517,2464,-1901,28117053,28119517
8216,6,6,1,2412,-89,-90,1,e2:db:d1:d1:b0:4a,28123588,52,4019,28123536,28123588
8217,6,6,1,2412,-89,-90,1,,28124261,44,629,28124217,28124261
8218,6,6,1,2412,-89,-90,1,,28126585,44,2280,28126541,28126585
8219,4,1,1,2412,-83,-90,7,78:67:0e:38:6c:d3,28134302,2736,4981,28131566,28134302
8220,4,11,1,2412,-76,-90,14,48:dd:0c:7d:86:27,28137061,362,2397,28136699,28137061
8221,6,6,1,2412,-88,-90,2,,28145683,44,8578,28145639,28145683
8222,6,6,1,2412,-90,-90,0,e2:db:d1:d1:b0:4a,28153008,444,6881,28152564,28153008
8223,6,6,1,2412,-89,-90,1,e2:db:d1:d1:b0:4b,28153476,408,60,28153068,28153476
8224,6,6,1,2412,-87,-90,3,e2:db:d1:d1:b0:4a,28155597,52,2069,28155545,28155597
8225,4,11,1,2412,-89,-90,1,4c:01:43:ec:a0:63,28161009,322,5090,28160687,28161009
8226,4,11,1,2412,-88,-90,2,4c:01:43:ec:a0:66,28161343,387,-53,28160956,28161343
8227,4,11,1,2412,-86,-90,4,48:dd:0c:90:e3:87,28162098,362,393,28161736,28162098
8228,6,6,1,2412,-89,-90,1,e2:db:d1:d1:b0:4a,28170169,52,8019,28170117,28170169
8229,6,6,1,2412,-90,-90,0,,28170439,44,226,28170395,28170439
8230,6,6,1,2412,-87,-90,3,e2:db:d1:d1:b0:4a,28170651,52,160,28170599,28170651
8231,6,6,1,2412,-87,-90,3,,28171102,44,407,28171058,28171102
8232,4,1,1,2412,-88,-90,2,,28172939,304,1533,28172635,28172939
8233,6,6,1,2412,-89,-90,1,,28173164,44,181,28173120,28173164
8234,4,1,1,2412,-88,-90,2,78:67:0e:c4:a8:42,28174312,2736,-1588,28171576,28174312
8235,4,1,1,2412,-92,-90,-2,,28177717,304,3101,28177413,28177717
8236,6,6,1,2412,-89,-90,1,e2:db:d1:d1:b0:4a,28178467,52,698,28178415,28178467
8237,6,6,1,2412,-87,-90,3,,28178737,44,226,28178693,28178737
8238,6,6,1,2412,-88,-90,2,e2:db:d1:d1:b0:4a,28178914,52,125,28178862,28178914
8239,6,6,1,2412,-88,-90,2,,28179586,44,628,28179542,28179586
8240,6,6,1,2412,-88,-90,2,,28187915,44,8285,28187871,28187915
8241,6,24,1,2412,-84,-90,6,,28191394,28,3451,28191366,28191394
8242,6,6,1,2412,-68,-90,22,32:86:8c:5f:93:1e,28193228,332,1502,28192896,28193228
8243,6,6,1,2412,-89,-90,1,e2:db:d1:d1:b0:4a,28195888,52,2608,28195836,28195888
8244,6,6,1,2412,-89,-90,1,,28196154,44,222,28196110,28196154
8245,6,6,1,2412,-88,-90,2,e2:db:d1:d1:b0:4a,28204342,52,8136,28204290,28204342
8246,4,1,1,2412,-89,-90,1,,28207211,304,2565,28206907,28207211
8247,6,6,1,2412,-87,-90,3,,28207436,44,181,28207392,28207436
8248,4,1,1,2412,-63,-90,27,b0:e4:d5:32:ec:8a,28214699,1960,5303,28212739,28214699
8249,4,1,1,2412,-89,-90,1,,28218092,304,3089,28217788,28218092
8250,6,6,1,2412,-67,-90,23,10:86:8c:5f:93:1e,28221348,344,2912,28221004,28221348
8251,4,1,1,2412,-26,-90,64,94:a6:7e:c9:98:67,28222761,2464,-1051,28220297,28222761
8252,4,1,1,2412,-82,-90,8,78:67:0e:38:6c:d3,28236702,2736,11205,28233966,28236702
8253,4,11,1,2412,-73,-90,17,48:dd:0c:7d:86:27,28239462,362,2398,28239100,28239462
8254,4,11,1,2412,-75,-90,15,48:dd:0c:7d:86:23,28239836,323,51,28239513,28239836
8255,4,11,1,2412,-76,-90,14,48:dd:0c:7d:86:25,28240171,382,-47,28239789,28240171
8256,4,1,1,2412,-90,-90,0,,28240693,304,218,28240389,28240693
8257,6,6,1,2412,-86,-90,4,,28240918,44,181,28240874,28240918
8258,6,6,1,2412,-88,-90,2,,28241440,44,478,28241396,28241440
8259,6,6,1,2412,-90,-90,0,e2:db:d1:d1:b0:4a,28241860,52,368,28241808,28241860
8260,6,6,1,2412,-87,-90,3,e2:db:d1:d1:b0:4a,28242320,52,408,28242268,28242320
8261,6,6,1,2412,-87,-90,3,,28242587,44,223,28242543,28242587
8262,4,1,1,2412,-87,-90,3,,28243723,304,832,28243419,28243723
8263,6,6,1,2412,-90,-90,0,,28243947,44,180,28243903,28243947
8264,4,1,1,2412,-88,-90,2,,28246763,304,2512,28246459,28246763
8265,6,6,1,2412,-86,-90,4,e2:db:d1:d1:b0:4a,28247008,68,177,28246940,28247008
8266,6,6,1,2412,-90,-90,0,e2:db:d1:d1:b0:4b,28255820,408,8404,28255412,28255820
8267,6,6,1,2412,-87,-90,3,e2:db:d1:d1:b0:4d,28256252,408,24,28255844,28256252
8268,6,6,1,2412,-88,-90,2,e2:db:d1:d1:b0:4f,28256684,408,24,28256276,28256684
8269,6,6,1,2412,-88,-90,2,,28257459,44,731,28257415,28257459
8270,6,6,1,2412,-89,-90,1,e2:db:d1:d1:b0:4a,28264197,52,6686,28264145,28264197
8271,6,6,1,2412,-87,-90,3,e2:db:d1:d1:b0:4a,28264898,52,649,28264846,28264898
8272,6,6,1,2412,-88,-90,2,e2:db:d1:d1:b0:4a,28266546,52,1596,28266494,28266546
8273,6,6,1,2412,-88,-90,2,e2:db:d1:d1:b0:4a,28267259,52,661,28267207,28267259
8274,4,1,1,2412,-91,-90,-1,,28273667,304,6104,28273363,28273667
8275,6,6,1,2412,-88,-90,2,e2:db:d1:d1:b0:4a,28274498,52,779,28274446,28274498
8276,6,6,1,2412,-66,-90,24,12:86:8c:5f:93:1e,28275292,332,462,28274960,28275292
8277,4,1,1,2412,-87,-90,3,,28279437,304,3841,28279133,28279437
8278,4,1,1,2412,-88,-90,2,78:67:0e:c4:a8:42,28279761,2736,-2412,28277025,28279761
8279,4,1,1,2412,-88,-90,2,78:67:0e:c4:a8:42,28283380,352,3267,28283028,28283380
8280,4,1,1,2412,-89,-90,1,78:67:0e:c4:a8:42,28284226,352,494,28283874,28284226
8281,4,11,1,2412,-68,-90,22,,28285527,107,1194,28285420,28285527
8282,4,1,1,2412,-90,-90,0,78:67:0e:c4:a8:42,28287953,352,2074,28287601,28287953
8283,6,6,1,2412,-90,-90,0,,28295928,44,7931,28295884,28295928
8284,6,6,1,2412,-66,-90,24,32:86:8c:5f:93:1e,28298347,332,2087,28298015,28298347
8285,4,1,1,2412,-87,-90,3,,28300746,304,2095,28300442,28300746
8286,4,1,1,2412,-81,-90,9,,28302186,304,1136,28301882,28302186
8287,6,24,1,2412,-85,-90,5,,28311833,28,9619,28311805,28311833
8288,4,1,1,2412,-64,-90,26,b0:e4:d5:32:ec:8a,28317099,1960,3306,28315139,28317099
8289,6,6,1,2412,-67,-90,23,10:86:8c:5f:93:1e,28323739,344,6296,28323395,28323739
8290,6,24,1,2412,-86,-90,4,,28324153,28,386,28324125,28324153
8291,4,11,1,2412,-88,-90,2,4c:01:43:d7:f3:29,28327374,362,2859,28327012,28327374
8292,4,11,1,2412,-88,-90,2,4c:01:43:d7:f3:23,28327749,322,53,28327427,28327749
8293,4,11,1,2412,-87,-90,3,4c:01:43:d7:f3:26,28328083,387,-53,28327696,28328083
8294,4,11,1,2412,-75,-90,15,48:dd:0c:7d:86:27,28341861,362,13416,28341499,28341861
8295,4,11,1,2412,-81,-90,9,48:dd:0c:7d:86:23,28342236,323,52,28341913,28342236
8296,4,11,1,2412,-80,-90,10,48:dd:0c:7d:86:25,28342571,382,-47,28342189,28342571
8297,6,6,1,2412,-67,-90,23,12:86:8c:5f:93:1e,28346829,332,3926,28346497,28346829
8298,6,6,1,2412,-87,-90,3,,28356874,44,10001,28356830,28356874
8299,4,11,1,2412,-84,-90,6,4c:01:43:ec:a0:63,28365806,322,8610,28365484,28365806
8300,4,11,1,2412,-86,-90,4,4c:01:43:ec:a0:66,28366141,387,-52,28365754,28366141
8301,4,11,1,2412,-89,-90,1,48:dd:0c:90:e3:87,28366898,362,395,28366536,28366898
8302,4,11,1,2412,-90,-90,0,48:dd:0c:90:e3:83,28367272,323,51,28366949,28367272
8303,4,1,1,2412,-90,-90,0,,28384010,304,16434,28383706,28384010
8304,6,24,1,2412,-87,-90,3,,28391234,28,7196,28391206,28391234
8305,6,6,1,2412,-69,-90,21,32:86:8c:5f:93:1e,28398096,332,6530,28397764,28398096
8306,4,1,1,2412,-90,-90,0,,28405834,304,7434,28405530,28405834
8307,4,1,1,2412,-65,-90,25,b0:e4:d5:32:ec:8a,28419498,1960,11704,28417538,28419498
8308,4,1,1,2412,-54,-90,36,94:a6:7e:c9:98:67,28427309,2464,5347,28424845,28427309
8309,4,1,1,2412,-89,-90,1,,28431082,304,3469,28430778,28431082
8310,6,6,1,2412,-67,-90,23,12:86:8c:5f:93:1e,28449260,332,17846,28448928,28449260
8311,4,11,1,2412,-89,-90,1,48:dd:0c:90:e3:87,28469298,362,19676,28468936,28469298
8312,4,11,1,2412,-88,-90,2,48:dd:0c:90:e3:83,28469672,323,51,28469349,28469672
8313,4,11,1,2412,-86,-90,4,48:dd:0c:90:e3:85,28470007,382,-47,28469625,28470007
8314,4,1,1,2412,-88,-90,2,,28487290,304,16979,28486986,28487290
8315,4,1,1,2412,-89,-90,1,,28494794,304,7200,28494490,28494794
8316,6,6,1,2412,-68,-90,22,32:86:8c:5f:93:1e,28501276,332,6150,28500944,28501276
8317,4,1,1,2412,-84,-90,6,,28513546,304,11966,28513242,28513546
8318,4,1,1,2412,-61,-90,29,b0:e4:d5:32:ec:8a,28521897,1960,6391,28519937,28521897
8319,4,1,1,2412,-50,-90,40,94:a6:7e:c9:98:67,28528882,2464,4521,28526418,28528882
8320,6,6,1,2412,-68,-90,22,10:86:8c:5f:93:1e,28531557,344,2331,28531213,28531557
8321,6,6,1,2412,-65,-90,25,b4:e6:2d:b4:ff:71,28533377,64,1756,28533313,28533377
8322,6,6,1,2412,-66,-90,24,b4:e6:2d:b4:ff:71,28533682,64,241,28533618,28533682
8323,6,6,1,2412,-66,-90,24,b4:e6:2d:b4:ff:71,28533899,64,153,28533835,28533899
8324,6,6,1,2412,-65,-90,25,b4:e6:2d:b4:ff:71,28534079,64,116,28534015,28534079
8325,6,6,1,2412,-66,-90,24,b4:e6:2d:b4:ff:71,28534241,64,98,28534177,28534241
8326,6,6,1,2412,-66,-90,24,b4:e6:2d:b4:ff:71,28534457,64,152,28534393,28534457
8327,4,1,1,2412,-69,-90,21,b4:e6:2d:b4:ff:71,28534801,416,-72,28534385,28534801
8328,4,1,1,2412,-69,-90,21,b4:e6:2d:b4:ff:71,28536724,416,1507,28536308,28536724
8329,4,1,1,2412,-69,-90,21,,28537151,304,123,28536847,28537151
8330,4,11,1,2412,-77,-90,13,48:dd:0c:7d:86:23,28546882,323,9408,28546559,28546882
8331,6,6,1,2412,-80,-90,10,40:b0:34:b7:01:d5,28549856,576,2398,28549280,28549856
8332,6,24,1,2412,-83,-90,7,,28554490,28,4606,28554462,28554490
8333,4,11,1,2412,-89,-90,1,4c:01:43:ec:a0:63,28570604,322,15792,28570282,28570604
8334,4,11,1,2412,-85,-90,5,48:dd:0c:90:e3:87,28571697,362,731,28571335,28571697
8335,4,11,1,2412,-86,-90,4,48:dd:0c:90:e3:83,28572072,323,52,28571749,28572072
8336,6,24,1,2412,-83,-90,7,,28597578,28,25478,28597550,28597578
8337,4,1,1,2412,-89,-90,1,,28617193,304,19311,28616889,28617193
8338,6,6,1,2412,-90,-90,0,,28617418,44,181,28617374,28617418
8339,6,24,1,2412,-83,-90,7,,28618131,28,685,28618103,28618131
8340,4,1,1,2412,-90,-90,0,,28619433,304,998,28619129,28619433
8341,4,1,1,2412,-60,-90,30,b0:e4:d5:32:ec:8a,28624297,1960,2904,28622337,28624297
8342,4,11,1,2412,-83,-90,7,48:dd:0c:90:e3:83,28631012,254,6461,28630758,28631012
8343,4,1,1,2412,-53,-90,37,94:a6:7e:c9:98:67,28631288,2464,-2188,28628824,28631288
8344,6,24,1,2412,-83,-90,7,,28637320,28,6004,28637292,28637320
8345,4,11,1,2412,-77,-90,13,48:dd:0c:7d:86:27,28649062,362,11380,28648700,28649062
8346,4,11,1,2412,-76,-90,14,48:dd:0c:7d:86:23,28649436,323,51,28649113,28649436
8347,4,11,1,2412,-74,-90,16,48:dd:0c:7d:86:25,28649772,382,-46,28649390,28649772
8348,4,1,1,2412,-89,-90,1,,28653801,304,3725,28653497,28653801
8349,6,6,1,2412,-71,-90,19,12:86:8c:5f:93:1e,28654053,332,-80,28653721,28654053
8350,4,1,1,2412,-86,-90,4,78:67:0e:c4:a8:42,28658373,352,3968,28658021,28658373
8351,4,1,1,2412,-88,-90,2,00:26:62:eb:ea:74,28660437,968,1096,28659469,28660437
8352,4,11,1,2412,-87,-90,3,48:dd:0c:90:e3:87,28674097,362,13298,28673735,28674097
8353,4,11,1,2412,-86,-90,4,48:dd:0c:90:e3:83,28674472,323,52,28674149,28674472
8354,4,11,1,2412,-87,-90,3,48:dd:0c:90:e3:85,28674807,382,-47,28674425,28674807
8355,4,1,1,2412,-86,-90,4,78:67:0e:c4:a8:42,28686491,2736,8948,28683755,28686491
8356,4,1,1,2412,-89,-90,1,,28689715,304,2920,28689411,28689715
8357,6,24,1,2412,-82,-90,8,,28699492,28,9749,28699464,28699492
8358,6,6,1,2412,-69,-90,21,32:86:8c:5f:93:1e,28705353,332,5529,28705021,28705353
8359,6,24,1,2412,-82,-90,8,,28707084,28,1703,28707056,28707084
8360,4,1,1,2412,-87,-90,3,78:67:0e:c4:a8:42,28709073,352,1637,28708721,28709073
8361,6,6,1,2412,-70,-90,20,,28713340,44,4223,28713296,28713340
8362,4,1,1,2412,-87,-90,3,,28722633,304,8989,28722329,28722633
8363,4,1,1,2412,-57,-90,33,94:a6:7e:c9:98:67,28733691,2464,8594,28731227,28733691
8364,4,11,1,2412,-88,-90,2,4c:01:43:d7:f3:26,28737682,387,3604,28737295,28737682
8365,4,11,1,2412,-75,-90,15,48:dd:0c:7d:86:27,28751463,362,13419,28751101,28751463
8366,4,11,1,2412,-75,-90,15,48:dd:0c:7d:86:23,28751837,323,51,28751514,28751837
8367,4,11,1,2412,-74,-90,16,48:dd:0c:7d:86:25,28752172,382,-47,28751790,28752172
8368,6,24,1,2412,-82,-90,8,,28771128,28,18928,28771100,28771128
8369,4,11,1,2412,-86,-90,4,48:dd:0c:90:e3:87,28776497,362,5007,28776135,28776497
8370,4,11,1,2412,-85,-90,5,48:dd:0c:90:e3:83,28776871,323,51,28776548,28776871
8371,4,11,1,2412,-84,-90,6,48:dd:0c:90:e3:85,28777207,382,-46,28776825,28777207
8372,4,1,1,2412,-86,-90,4,,28786217,304,8706,28785913,28786217
8373,4,1,1,2412,-87,-90,3,78:67:0e:c4:a8:42,28787635,352,1066,28787283,28787635
8374,4,1,1,2412,-88,-90,2,78:67:0e:c4:a8:42,28788712,2736,-1659,28785976,28788712
8375,4,1,1,2412,-90,-90,0,78:67:0e:c4:a8:42,28791485,352,2421,28791133,28791485
8376,4,1,1,2412,-86,-90,4,78:67:0e:c4:a8:42,28791937,352,100,28791585,28791937
8377,4,1,1,2412,-88,-90,2,78:67:0e:c4:a8:42,28792398,352,109,28792046,28792398
8378,4,1,1,2412,-87,-90,3,78:67:0e:c4:a8:42,28792868,352,118,28792516,28792868
8379,4,1,1,2412,-87,-90,3,78:67:0e:c4:a8:42,28793340,352,120,28792988,28793340
8380,4,1,1,2412,-86,-90,4,78:67:0e:c4:a8:42,28793810,352,118,28793458,28793810
8381,4,1,1,2412,-87,-90,3,78:67:0e:c4:a8:42,28794262,352,100,28793910,28794262
8382,4,1,1,2412,-86,-90,4,78:67:0e:c4:a8:42,28794714,352,100,28794362,28794714
8383,4,1,1,2412,-87,-90,3,78:67:0e:c4:a8:42,28795166,352,100,28794814,28795166
8384,4,1,1,2412,-88,-90,2,78:67:0e:c4:a8:42,28795627,352,109,28795275,28795627
8385,4,1,1,2412,-62,-90,28,78:67:0e:c4:a8:42,28796088,352,109,28795736,28796088
8386,4,1,1,2412,-86,-90,4,78:67:0e:c4:a8:42,28796540,352,100,28796188,28796540
8387,4,1,1,2412,-87,-90,3,78:67:0e:c4:a8:42,28797012,352,120,28796660,28797012
8388,4,1,1,2412,-89,-90,1,78:67:0e:c4:a8:42,28797464,352,100,28797112,28797464
8389,4,1,1,2412,-89,-90,1,78:67:0e:c4:a8:42,28797925,352,109,28797573,28797925
8390,4,1,1,2412,-89,-90,1,78:67:0e:c4:a8:42,28798377,352,100,28798025,28798377
8391,4,1,1,2412,-88,-90,2,78:67:0e:c4:a8:42,28798829,352,100,28798477,28798829
8392,4,1,1,2412,-87,-90,3,78:67:0e:c4:a8:42,28799299,352,118,28798947,28799299
8393,4,1,1,2412,-86,-90,4,78:67:0e:c4:a8:42,28799751,352,100,28799399,28799751
8394,4,1,1,2412,-86,-90,4,78:67:0e:c4:a8:42,28801127,352,1024,28800775,28801127
8395,4,1,1,2412,-86,-90,4,78:67:0e:c4:a8:42,28801597,352,118,28801245,28801597
8396,4,1,1,2412,-87,-90,3,78:67:0e:c4:a8:42,28802067,352,118,28801715,28802067
8397,4,1,1,2412,-87,-90,3,78:67:0e:c4:a8:42,28802519,352,100,28802167,28802519
8398,4,1,1,2412,-88,-90,2,78:67:0e:c4:a8:42,28802968,352,97,28802616,28802968
8399,4,1,1,2412,-87,-90,3,78:67:0e:c4:a8:42,28803438,352,118,28803086,28803438
8400,4,1,1,2412,-89,-90,1,78:67:0e:c4:a8:42,28803890,352,100,28803538,28803890
8401,4,1,1,2412,-85,-90,5,,28806868,304,2674,28806564,28806868
8402,4,1,1,2412,-87,-90,3,78:67:0e:c4:a8:42,28808267,352,1047,28807915,28808267
8403,4,1,1,2412,-88,-90,2,78:67:0e:c4:a8:42,28809113,352,494,28808761,28809113
8404,4,11,1,2412,-87,-90,3,,28811080,107,1860,28810973,28811080
8405,6,24,1,2412,-83,-90,7,78:67:0e:c4:a8:42,28811193,32,81,28811161,28811193
8406,4,1,1,2412,-90,-90,0,,28825064,304,13567,28824760,28825064
8407,4,1,1,2412,-62,-90,28,b0:e4:d5:32:ec:8a,28829095,1960,2071,28827135,28829095
8408,4,1,1,2412,-60,-90,30,94:a6:7e:c9:98:67,28836257,2464,4698,28833793,28836257
8409,6,6,1,2412,-68,-90,22,10:86:8c:5f:93:1e,28838576,344,1975,28838232,28838576
8410,4,11,1,2412,-87,-90,3,4c:01:43:d7:f3:23,28839747,322,849,28839425,28839747
8411,4,1,1,2412,-88,-90,2,,28841960,304,1909,28841656,28841960
8412,6,24,1,2412,-83,-90,7,,28847090,28,5102,28847062,28847090
8413,4,1,1,2412,-88,-90,2,78:67:0e:38:6c:d3,28851104,2736,1278,28848368,28851104
8414,4,11,1,2412,-76,-90,14,48:dd:0c:7d:86:27,28853862,362,2396,28853500,28853862
8415,4,11,1,2412,-76,-90,14,48:dd:0c:7d:86:23,28854237,323,52,28853914,28854237
8416,4,11,1,2412,-76,-90,14,48:dd:0c:7d:86:25,28854572,382,-47,28854190,28854572
8417,6,6,1,2412,-82,-90,8,,28855653,44,1037,28855609,28855653
8418,6,6,1,2412,-81,-90,9,40:b0:34:b7:01:d5,28857059,576,830,28856483,28857059
8419,6,6,1,2412,-69,-90,21,12:86:8c:5f:93:1e,28858833,332,1442,28858501,28858833
8420,4,11,1,2412,-86,-90,4,48:dd:0c:90:e3:87,28878897,362,19702,28878535,28878897
8421,4,11,1,2412,-85,-90,5,48:dd:0c:90:e3:83,28879271,323,51,28878948,28879271
8422,4,1,1,2412,-82,-90,8,c0:8d:51:da:5c:ef,28890856,416,11169,28890440,28890856
8423,4,1,1,2412,-70,-90,20,,28891282,304,122,28890978,28891282
8424,4,1,1,2412,-86,-90,4,78:67:0e:c4:a8:42,28891608,2736,-2410,28888872,28891608
8425,6,24,1,2412,-82,-90,8,,28896542,28,4906,28896514,28896542
8426,4,1,1,2412,-88,-90,2,,28901221,304,4375,28900917,28901221
8427,4,1,1,2412,-89,-90,1,,28903944,304,2419,28903640,28903944
8428,6,24,1,2412,-83,-90,7,,28905120,28,1148,28905092,28905120
8429,6,6,1,2412,-69,-90,21,32:86:8c:5f:93:1e,28910033,332,4581,28909701,28910033
8430,4,1,1,2412,-88,-90,2,,28926111,304,15774,28925807,28926111
8431,6,6,1,2412,-91,-90,-1,,28926377,44,222,28926333,28926377
8432,4,1,1,2412,-62,-90,28,b0:e4:d5:32:ec:8a,28931494,1960,3157,28929534,28931494
8433,4,1,1,2412,-92,-90,-2,bc:98:df:ff:0f:8b,28935739,2568,1677,28933171,28935739
8434,6,6,1,2412,-66,-90,24,10:86:8c:5f:93:1e,28938163,344,2080,28937819,28938163
8435,4,1,1,2412,-61,-90,29,94:a6:7e:c9:98:67,28938707,2464,-1920,28936243,28938707
8436,4,11,1,2412,-85,-90,5,4c:01:43:d7:f3:29,28941772,362,2703,28941410,28941772
8437,4,11,1,2412,-83,-90,7,4c:01:43:d7:f3:26,28942481,387,322,28942094,28942481
8438,4,11,1,2412,-84,-90,6,4c:01:43:d7:f3:26,28942914,274,159,28942640,28942914
8439,4,11,1,2412,-89,-90,1,,28944374,107,1353,28944267,28944374
8440,6,24,1,2412,-83,-90,7,78:67:0e:c4:a8:42,28944509,32,103,28944477,28944509
8441,4,11,1,2412,-90,-90,0,48:dd:0c:92:4b:e5,28945556,382,665,28945174,28945556
8442,6,24,1,2412,-83,-90,7,,28947251,28,1667,28947223,28947251
8443,6,24,1,2412,-83,-90,7,4c:01:43:d7:f3:26,28951069,32,3786,28951037,28951069
8444,6,24,1,2412,-84,-90,6,,28951240,28,143,28951212,28951240
8445,4,1,1,2412,-90,-90,0,,28957600,304,6056,28957296,28957600
8446,6,6,1,2412,-68,-90,22,12:86:8c:5f:93:1e,28961234,332,3302,28960902,28961234
8447,6,24,1,2412,-84,-90,6,,28963817,28,2555,28963789,28963817
8448,4,1,1,2412,-89,-90,1,,28965928,304,1807,28965624,28965928
8449,6,6,1,2412,-90,-90,0,,28967209,44,1237,28967165,28967209
8450,6,24,1,2412,-84,-90,6,,28968990,28,1753,28968962,28968990
8451,4,1,1,2412,-88,-90,2,78:67:0e:c4:a8:42,28971462,352,2120,28971110,28971462
8452,4,11,1,2412,-86,-90,4,,28973240,107,1671,28973133,28973240
8453,4,1,1,2412,-87,-90,3,00:26:62:eb:ea:74,28973556,968,-652,28972588,28973556
8454,6,6,1,2412,-89,-90,1,e2:db:d1:d1:b0:4a,28986437,52,12829,28986385,28986437
8455,4,1,1,2412,-84,-90,6,,28990976,304,4235,28990672,28990976
8456,6,6,1,2412,-88,-90,2,,28991385,44,365,28991341,28991385
8457,4,1,1,2412,-85,-90,5,78:67:0e:c4:a8:42,28993511,2736,-610,28990775,28993511
8458,6,6,1,2412,-90,-90,0,3c:bd:c5:ee:96:6d,28996229,68,2650,28996161,28996229
8459,4,1,1,2412,-89,-90,1,,28996914,304,381,28996610,28996914
8460,6,6,1,2412,-83,-90,7,,28999635,44,2677,28999591,28999635
8461,6,6,1,2412,-88,-90,2,3c:bd:c5:ee:96:6d,29000168,68,465,29000100,29000168
8462,6,24,1,2412,-84,-90,6,,29004497,28,4301,29004469,29004497
8463,6,6,1,2412,-88,-90,2,3c:bd:c5:ee:96:6d,29005242,68,677,29005174,29005242
8464,6,6,1,2412,-89,-90,1,,29011359,44,6073,29011315,29011359
8465,4,1,1,2412,-87,-90,3,,29012296,304,633,29011992,29012296
8466,6,6,1,2412,-66,-90,24,32:86:8c:5f:93:1e,29012588,332,-40,29012256,29012588
8467,6,6,1,2412,-88,-90,2,3c:bd:c5:ee:96:6d,29014350,68,1694,29014282,29014350
8468,4,11,1,2412,-87,-90,3,48:dd:0c:92:4b:e3,29015385,254,781,29015131,29015385
8469,4,11,1,2412,-84,-90,6,48:dd:0c:90:e3:83,29016025,254,386,29015771,29016025
8470,4,11,1,2412,-74,-90,16,48:dd:0c:7d:86:23,29016332,254,53,29016078,29016332
8471,6,24,1,2412,-88,-90,2,3c:bd:c5:ee:96:6d,29026351,28,9991,29026323,29026351
8472,6,6,1,2412,-87,-90,3,,29026566,44,171,29026522,29026566
8473,6,24,1,2412,-83,-90,7,,29031246,28,4652,29031218,29031246
8474,6,6,1,2412,-66,-90,24,,29043856,44,12566,29043812,29043856
8475,4,11,1,2412,-83,-90,7,4c:01:43:d7:f3:23,29044546,322,368,29044224,29044546
8476,4,11,1,2412,-82,-90,8,4c:01:43:d7:f3:26,29044880,387,-53,29044493,29044880
8477,4,11,1,2412,-89,-90,1,48:dd:0c:92:4b:e3,29047621,323,2418,29047298,29047621
8478,4,1,1,2412,-84,-90,6,78:67:0e:38:6c:d3,29055904,2736,5547,29053168,29055904
8479,4,11,1,2412,-74,-90,16,48:dd:0c:7d:86:27,29058663,362,2397,29058301,29058663
8480,4,11,1,2412,-74,-90,16,48:dd:0c:7d:86:23,29059038,323,52,29058715,29059038
8481,4,11,1,2412,-74,-90,16,48:dd:0c:7d:86:25,29059373,382,-47,29058991,29059373
8482,6,6,1,2412,-81,-90,9,40:b0:34:b7:01:d5,29061862,576,1913,29061286,29061862
8483,6,6,1,2412,-68,-90,22,12:86:8c:5f:93:1e,29063634,332,1440,29063302,29063634
8484,4,1,1,2412,-92,-90,-2,00:26:62:eb:ea:74,29074452,968,9850,29073484,29074452
8485,6,6,1,2412,-87,-90,3,,29075488,44,992,29075444,29075488
8486,6,6,1,2412,-87,-90,3,3c:bd:c5:ee:96:6d,29077744,68,2188,29077676,29077744
8487,4,11,1,2412,-88,-90,2,4c:01:43:ec:a0:69,29082224,361,4119,29081863,29082224
8488,4,11,1,2412,-89,-90,1,4c:01:43:ec:a0:63,29082598,322,52,29082276,29082598
8489,4,11,1,2412,-90,-90,0,4c:01:43:ec:a0:66,29082933,387,-52,29082546,29082933
8490,4,11,1,2412,-83,-90,7,48:dd:0c:90:e3:83,29084071,323,815,29083748,29084071
8491,6,6,1,2412,-87,-90,3,3c:bd:c5:ee:96:6d,29094081,68,9942,29094013,29094081
8492,6,6,1,2412,-87,-90,3,3c:bd:c5:ee:96:6d,29099000,68,4851,29098932,29099000
8493,6,24,1,2412,-82,-90,8,,29111247,28,12219,29111219,29111247
8494,4,1,1,2412,-86,-90,4,78:67:0e:c4:a8:42,29114620,352,3021,29114268,29114620
8495,6,6,1,2412,-67,-90,23,32:86:8c:5f:93:1e,29115649,332,697,29115317,29115649
8496,4,11,1,2412,-87,-90,3,,29116152,107,396,29116045,29116152
8497,6,24,1,2412,-85,-90,5,78:67:0e:c4:a8:42,29116265,32,81,29116233,29116265
8498,4,11,1,2412,-87,-90,3,,29116548,107,176,29116441,29116548
8499,4,1,1,2412,-87,-90,3,,29117448,304,596,29117144,29117448
8500,4,1,1,2412,-86,-90,4,,29118983,304,1231,29118679,29118983
8501,4,1,1,2412,-59,-90,31,b0:e4:d5:32:ec:8a,29136293,1960,15350,29134333,29136293
8502,4,1,1,2412,-91,-90,-1,bc:98:df:ff:0f:8b,29140519,2568,1658,29137951,29140519
8503,4,1,1,2412,-59,-90,31,94:a6:7e:c9:98:67,29143280,2464,297,29140816,29143280
8504,6,6,1,2412,-69,-90,21,10:86:8c:5f:93:1e,29145667,344,2043,29145323,29145667
8505,4,11,1,2412,-82,-90,8,4c:01:43:d7:f3:29,29146571,362,542,29146209,29146571
8506,4,11,1,2412,-76,-90,14,4c:01:43:d7:f3:23,29146945,322,52,29146623,29146945
8507,4,11,1,2412,-82,-90,8,4c:01:43:d7:f3:26,29147280,387,-52,29146893,29147280
8508,4,11,1,2412,-74,-90,16,48:dd:0c:7d:86:23,29161437,323,13834,29161114,29161437
8509,4,11,1,2412,-74,-90,16,48:dd:0c:7d:86:25,29161773,382,-46,29161391,29161773
8510,6,6,1,2412,-81,-90,9,40:b0:34:b7:01:d5,29164263,576,1914,29163687,29164263
8511,6,6,1,2412,-70,-90,20,12:86:8c:5f:93:1e,29166035,332,1440,29165703,29166035
8512,4,1,1,2412,-93,-90,-3,70:3a:cb:63:35:b2,29166559,2216,-1692,29164343,29166559
8513,4,1,1,2412,-88,-90,2,,29181287,304,14424,29180983,29181287
8514,4,1,1,2412,-87,-90,3,,29183208,304,1617,29182904,29183208
8515,6,24,1,2412,-86,-90,4,,29198244,28,15008,29198216,29198244
8516,6,24,1,2412,-82,-90,8,,29204960,28,6688,29204932,29204960
8517,6,24,1,2412,-87,-90,3,,29207661,28,2673,29207633,29207661
8518,6,6,1,2412,-88,-90,2,3c:bd:c5:ee:96:6d,29214940,68,7211,29214872,29214940
8519,6,6,1,2412,-68,-90,22,32:86:8c:5f:93:1e,29217235,332,1963,29216903,29217235
8520,6,6,1,2412,-65,-90,25,b4:e6:2d:b4:ff:71,29227576,64,10277,29227512,29227576
8521,6,6,1,2412,-68,-90,22,,29227656,44,36,29227612,29227656
8522,6,24,1,2412,-88,-90,2,3c:bd:c5:ee:96:6d,29232371,28,4687,29232343,29232371
8523,6,6,1,2412,-87,-90,3,,29232606,44,191,29232562,29232606
8524,6,6,1,2412,-87,-90,3,3c:bd:c5:ee:96:6d,29233728,68,1054,29233660,29233728
8525,4,1,1,2412,-59,-90,31,b0:e4:d5:32:ec:8a,29238692,1960,3004,29236732,29238692
8526,4,1,1,2412,-86,-90,4,,29241927,304,2931,29241623,29241927
8527,6,6,1,2412,-68,-90,22,10:86:8c:5f:93:1e,29245370,344,3099,29245026,29245370
8528,4,1,1,2412,-60,-90,30,94:a6:7e:c9:98:67,29245852,2464,-1982,29243388,29245852
8529,4,11,1,2412,-83,-90,7,4c:01:43:d7:f3:29,29248970,362,2756,29248608,29248970
8530,6,6,1,2412,-81,-90,9,40:b0:34:b7:01:d5,29266664,576,17118,29266088,29266664
8531,4,1,1,2412,-91,-90,-1,70:3a:cb:63:35:b2,29268685,2216,-195,29266469,29268685
8532,6,24,1,2412,-83,-90,7,,29271244,28,2531,29271216,29271244
8533,6,24,1,2412,-87,-90,3,,29272062,28,790,29272034,29272062
8534,4,11,1,2412,-87,-90,3,,29272860,107,691,29272753,29272860
8535,6,24,1,2412,-86,-90,4,78:67:0e:c4:a8:42,29272973,32,81,29272941,29272973
8536,6,6,1,2412,-86,-90,4,e0:db:d1:37:3f:8f,29276081,212,2896,29275869,29276081
8537,4,1,1,2412,-86,-90,4,78:67:0e:c4:a8:42,29278455,352,2022,29278103,29278455
8538,4,1,1,2412,-84,-90,6,78:67:0e:c4:a8:42,29279484,352,677,29279132,29279484
8539,4,1,1,2412,-86,-90,4,,29279890,304,102,29279586,29279890
8540,4,1,1,2412,-90,-90,0,,29283672,304,3478,29283368,29283672
8541,6,24,1,2412,-84,-90,6,,29284867,28,1167,29284839,29284867
8542,4,11,1,2412,-85,-90,5,4c:01:43:ec:a0:69,29287022,361,1794,29286661,29287022
8543,4,11,1,2412,-87,-90,3,4c:01:43:ec:a0:63,29287396,322,52,29287074,29287396
8544,4,11,1,2412,-85,-90,5,4c:01:43:ec:a0:66,29287730,387,-53,29287343,29287730
8545,4,11,1,2412,-84,-90,6,48:dd:0c:90:e3:87,29288496,362,404,29288134,29288496
8546,4,11,1,2412,-85,-90,5,48:dd:0c:90:e3:83,29288870,323,51,29288547,29288870
8547,4,11,1,2412,-83,-90,7,48:dd:0c:90:e3:85,29289205,382,-47,29288823,29289205
8548,6,24,1,2412,-84,-90,6,,29289837,28,604,29289809,29289837
8549,4,1,1,2412,-85,-90,5,78:67:0e:c4:a8:42,29296787,352,6598,29296435,29296787
8550,4,1,1,2412,-85,-90,5,78:67:0e:c4:a8:42,29297235,352,96,29296883,29297235
8551,4,1,1,2412,-86,-90,4,78:67:0e:c4:a8:42,29297696,352,109,29297344,29297696
8552,4,1,1,2412,-84,-90,6,78:67:0e:c4:a8:42,29298157,352,109,29297805,29298157
8553,4,1,1,2412,-86,-90,4,78:67:0e:c4:a8:42,29298609,352,100,29298257,29298609
8554,4,1,1,2412,-86,-90,4,78:67:0e:c4:a8:42,29299085,352,124,29298733,29299085
8555,4,1,1,2412,-85,-90,5,78:67:0e:c4:a8:42,29304009,352,4572,29303657,29304009
8556,4,1,1,2412,-84,-90,6,78:67:0e:c4:a8:42,29304461,352,100,29304109,29304461
8557,4,1,1,2412,-85,-90,5,78:67:0e:c4:a8:42,29305307,352,494,29304955,29305307
8558,4,1,1,2412,-85,-90,5,78:67:0e:c4:a8:42,29312127,352,6468,29311775,29312127
8559,6,24,1,2412,-83,-90,7,,29317366,28,5211,29317338,29317366
8560,4,1,1,2412,-88,-90,2,,29318567,304,897,29318263,29318567
8561,6,6,1,2412,-69,-90,21,32:86:8c:5f:93:1e,29319636,332,737,29319304,29319636
8562,4,1,1,2412,-89,-90,1,,29322211,304,2271,29321907,29322211
8563,6,6,1,2412,-55,-90,35,,29326939,44,4684,29326895,29326939
8564,6,6,1,2412,-56,-90,34,,29330698,44,3715,29330654,29330698
8565,6,6,1,2412,-56,-90,34,,29331940,44,1198,29331896,29331940
8566,4,1,1,2412,-69,-90,21,10:86:8c:5f:93:1e,29339459,3088,4431,29336371,29339459
8567,4,1,1,2412,-64,-90,26,10:86:8c:5f:93:1e,29342656,3088,109,29339568,29342656
8568,6,6,1,2412,-56,-90,34,,29345686,44,2986,29345642,29345686
8569,4,1,1,2412,-58,-90,32,94:a6:7e:c9:98:67,29349741,2464,1591,29347277,29349741
8570,4,1,1,2412,-61,-90,29,b0:e4:d5:32:ec:8a,29353553,1960,1852,29351593,29353553
8571,6,6,1,2412,-55,-90,35,,29360698,44,7101,29360654,29360698
8572,4,1,1,2412,-84,-90,6,78:67:0e:38:6c:d3,29363105,2736,-329,29360369,29363105
8573,6,6,1,2412,-54,-90,36,,29365686,44,2537,29365642,29365686
8574,4,11,1,2412,-71,-90,19,48:dd:0c:7d:86:27,29365864,362,-184,29365502,29365864
8575,4,11,1,2412,-70,-90,20,48:dd:0c:7d:86:23,29366238,323,51,29365915,29366238
8576,4,11,1,2412,-70,-90,20,48:dd:0c:7d:86:25,29366573,382,-47,29366191,29366573
8577,4,1,1,2412,-85,-90,5,78:67:0e:38:6c:d3,29366956,832,-449,29366124,29366956
8578,6,6,1,2412,-81,-90,9,40:b0:34:b7:01:d5,29369065,576,1533,29368489,29369065
8579,6,6,1,2412,-70,-90,20,12:86:8c:5f:93:1e,29370978,332,1581,29370646,29370978
8580,6,6,1,2412,-90,-90,0,e2:db:d1:d1:b0:4a,29383574,224,12372,29383350,29383574
8581,6,6,1,2412,-52,-90,38,,29385686,44,2068,29385642,29385686
8582,4,1,1,2412,-75,-90,15,,29388743,304,2753,29388439,29388743
8583,4,11,1,2412,-86,-90,4,4c:01:43:ec:a0:69,29389421,361,317,29389060,29389421
8584,4,11,1,2412,-81,-90,9,4c:01:43:ec:a0:63,29389795,322,52,29389473,29389795
8585,6,6,1,2412,-51,-90,39,,29390697,44,858,29390653,29390697
8586,4,11,1,2412,-85,-90,5,48:dd:0c:90:e3:87,29390895,362,-164,29390533,29390895
8587,4,11,1,2412,-86,-90,4,48:dd:0c:90:e3:83,29391270,323,52,29390947,29391270
8588,4,11,1,2412,-86,-90,4,48:dd:0c:90:e3:85,29391605,382,-47,29391223,29391605
8589,6,6,1,2412,-51,-90,39,,29398885,44,7236,29398841,29398885
8590,4,1,1,2412,-67,-90,23,3c:bd:c5:ee:96:6d,29399083,1184,-986,29397899,29399083
8591,4,1,1,2412,-85,-90,5,3c:bd:c5:ee:96:6d,29405133,1216,4834,29403917,29405133
8592,6,6,1,2412,-51,-90,39,,29406198,44,1021,29406154,29406198
8593,4,1,1,2412,-78,-90,12,7e:a6:25:c5:a8:c8,29412010,1152,4660,29410858,29412010
8594,4,1,1,2412,-51,-90,39,94:a6:7e:c9:98:67,29413193,3072,-1889,29410121,29413193
8595,4,1,1,2412,-79,-90,11,,29416278,304,2781,29415974,29416278
8596,6,6,1,2412,-70,-90,20,32:86:8c:5f:93:1e,29422098,332,5488,29421766,29422098
8597,4,1,1,2412,-87,-90,3,38:01:46:30:1a:ca,29422664,416,150,29422248,29422664
8598,6,24,1,2412,-89,-90,1,3c:bd:c5:ee:96:6d,29435566,28,12874,29435538,29435566
8599,6,6,1,2412,-89,-90,1,,29435781,44,171,29435737,29435781
8600,6,6,1,2412,-89,-90,1,,29436843,44,1018,29436799,29436843
8601,6,6,1,2412,-88,-90,2,3c:bd:c5:ee:96:6d,29437998,68,1087,29437930,29437998
8602,6,6,1,2412,-90,-90,0,3c:bd:c5:ee:96:6d,29442454,68,4388,29442386,29442454
8603,4,1,1,2412,-60,-90,30,b0:e4:d5:32:ec:8a,29443491,1960,-923,29441531,29443491
8604,4,1,1,2412,-86,-90,4,,29449574,304,5779,29449270,29449574
8605,6,6,1,2412,-70,-90,20,10:86:8c:5f:93:1e,29450160,344,242,29449816,29450160
8606,4,1,1,2412,-59,-90,31,94:a6:7e:c9:98:67,29450714,2464,-1910,29448250,29450714
8607,4,1,1,2412,-89,-90,1,,29455398,304,4380,29455094,29455398
8608,4,1,1,2412,-85,-90,5,38:01:46:30:1a:ca,29464243,416,8429,29463827,29464243
8609,6,6,1,2412,-85,-90,5,,29470612,44,6325,29470568,29470612
8610,6,6,1,2412,-85,-90,5,40:b0:34:b7:01:d5,29471466,576,278,29470890,29471466
8611,6,6,1,2412,-69,-90,21,12:86:8c:5f:93:1e,29473237,332,1439,29472905,29473237
8612,4,1,1,2412,-90,-90,0,70:3a:cb:63:35:b2,29473762,2216,-1691,29471546,29473762
8613,4,11,1,2412,-83,-90,7,48:dd:0c:90:e3:87,29493295,362,19171,29492933,29493295
8614,4,11,1,2412,-83,-90,7,48:dd:0c:90:e3:83,29493669,323,51,29493346,29493669
8615,4,11,1,2412,-82,-90,8,48:dd:0c:90:e3:85,29494005,382,-46,29493623,29494005
8616,4,1,1,2412,-64,-90,26,a4:cf:99:64:6d:2b,29496803,416,2382,29496387,29496803
8617,4,1,1,2412,-58,-90,32,,29497231,304,124,29496927,29497231
8618,6,24,1,2412,-66,-90,24,a4:cf:99:64:6d:2b,29497467,28,208,29497439,29497467
8619,6,24,1,2412,-61,-90,29,,29497513,28,18,29497485,29497513
8620,7,104,1,2412,-66,-90,24,a4:cf:99:64:6d:2b,29497565,48,4,29497517,29497565
8621,6,24,1,2412,-60,-90,30,94:a6:7e:c9:98:67,29497623,32,26,29497591,29497623
8622,6,6,1,2412,-90,-90,0,3c:bd:c5:ee:96:6d,29501610,52,3935,29501558,29501610
8623,6,6,1,2412,-90,-90,0,,29501866,44,212,29501822,29501866
8624,4,1,1,2412,-65,-90,25,a4:cf:99:64:6d:2b,29523249,416,20967,29522833,29523249
8625,4,1,1,2412,-59,-90,31,,29523678,304,125,29523374,29523678
8626,4,11,1,2412,-90,-90,0,4c:01:43:d7:f3:23,29524290,254,358,29524036,29524290
8627,6,6,1,2412,-68,-90,22,32:86:8c:5f:93:1e,29524437,332,-185,29524105,29524437
8628,4,11,1,2412,-88,-90,2,4c:01:43:ec:a0:63,29524987,254,296,29524733,29524987
8629,4,1,1,2412,-86,-90,4,78:67:0e:c4:a8:42,29535329,352,9990,29534977,29535329
8630,4,11,1,2412,-87,-90,3,,29536936,107,1500,29536829,29536936
8631,6,24,1,2412,-86,-90,4,,29537328,28,364,29537300,29537328
8632,4,1,1,2412,-60,-90,30,b0:e4:d5:32:ec:8a,29545890,1960,6602,29543930,29545890
8633,4,1,1,2412,-61,-90,29,94:a6:7e:c9:98:67,29553377,2464,5023,29550913,29553377
8634,4,11,1,2412,-88,-90,2,4c:01:43:d7:f3:29,29556169,362,2430,29555807,29556169
8635,4,11,1,2412,-89,-90,1,4c:01:43:d7:f3:23,29556543,322,52,29556221,29556543
8636,4,11,1,2412,-86,-90,4,4c:01:43:d7:f3:26,29556878,387,-52,29556491,29556878
8637,4,11,1,2412,-88,-90,2,,29557474,107,489,29557367,29557474
8638,6,24,1,2412,-86,-90,4,78:67:0e:c4:a8:42,29557594,32,88,29557562,29557594
8639,4,1,1,2412,-89,-90,1,,29558278,304,380,29557974,29558278
8640,4,11,1,2412,-76,-90,14,48:dd:0c:7d:86:23,29571039,323,12438,29570716,29571039
8641,4,11,1,2412,-76,-90,14,48:dd:0c:7d:86:25,29571374,382,-47,29570992,29571374
8642,4,1,1,2412,-89,-90,1,78:67:0e:c4:a8:42,29573211,352,1485,29572859,29573211
8643,6,6,1,2412,-80,-90,10,40:b0:34:b7:01:d5,29573867,576,80,29573291,29573867
8644,6,6,1,2412,-92,-90,-2,,29574594,44,683,29574550,29574594
8645,4,11,1,2412,-89,-90,1,,29574938,107,237,29574831,29574938
8646,6,24,1,2412,-88,-90,2,78:67:0e:c4:a8:42,29575051,32,81,29575019,29575051
8647,6,6,1,2412,-67,-90,23,12:86:8c:5f:93:1e,29575638,332,255,29575306,29575638
8648,4,11,1,2412,-87,-90,3,4c:01:43:ec:a0:69,29594219,361,18220,29593858,29594219
8649,4,11,1,2412,-88,-90,2,4c:01:43:ec:a0:63,29594592,322,51,29594270,29594592
8650,4,11,1,2412,-86,-90,4,48:dd:0c:90:e3:87,29595695,362,741,29595333,29595695
8651,4,11,1,2412,-83,-90,7,48:dd:0c:90:e3:83,29596069,323,51,29595746,29596069
8652,4,11,1,2412,-84,-90,6,48:dd:0c:90:e3:85,29596404,382,-47,29596022,29596404
8653,6,6,1,2412,-68,-90,22,52:86:8c:5f:93:1e,29601238,332,4502,29600906,29601238
8654,6,6,1,2412,-68,-90,22,32:86:8c:5f:93:1e,29630018,332,28448,29629686,29630018
8655,6,24,1,2412,-87,-90,3,,29630616,28,570,29630588,29630616
8656,4,1,1,2412,-58,-90,32,b0:e4:d5:32:ec:8a,29648289,1960,15713,29646329,29648289
8657,4,1,1,2412,-91,-90,-1,bc:98:df:ff:0f:8b,29652526,2568,1669,29649958,29652526
8658,4,1,1,2412,-54,-90,36,94:a6:7e:c9:98:67,29655280,2464,290,29652816,29655280
8659,4,1,1,2412,-54,-90,36,94:a6:7e:c9:98:67,29657781,1320,1181,29656461,29657781
8660,4,1,1,2412,-54,-90,36,94:a6:7e:c9:98:67,29659138,1480,-123,29657658,29659138
8661,4,11,1,2412,-74,-90,16,48:dd:0c:7d:86:25,29673774,382,14254,29673392,29673774
8662,4,1,1,2412,-82,-90,8,78:67:0e:38:6c:d3,29677645,416,3455,29677229,29677645
8663,4,1,1,2412,-86,-90,4,,29678917,304,968,29678613,29678917
8664,4,1,1,2412,-87,-90,3,,29682277,304,3056,29681973,29682277
8665,6,24,1,2412,-86,-90,4,,29683831,28,1526,29683803,29683831
8666,4,11,1,2412,-86,-90,4,4c:01:43:ec:a0:69,29696618,361,12426,29696257,29696618
8667,4,11,1,2412,-88,-90,2,4c:01:43:ec:a0:66,29697326,387,321,29696939,29697326
8668,4,11,1,2412,-86,-90,4,48:dd:0c:90:e3:83,29698469,323,820,29698146,29698469
8669,4,11,1,2412,-85,-90,5,48:dd:0c:90:e3:85,29698804,382,-47,29698422,29698804
8670,6,6,1,2412,-66,-90,24,52:86:8c:5f:93:1e,29703639,332,4503,29703307,29703639
8671,4,1,1,2412,-86,-90,4,78:67:0e:c4:a8:42,29710311,2736,3936,29707575,29710311
8672,6,6,1,2412,-89,-90,1,,29714736,44,4381,29714692,29714736
8673,6,6,1,2412,-86,-90,4,,29715729,44,949,29715685,29715729
8674,6,6,1,2412,-88,-90,2,,29716064,44,291,29716020,29716064
8675,6,6,1,2412,-66,-90,24,32:86:8c:5f:93:1e,29729239,332,12843,29728907,29729239
8676,4,1,1,2412,-88,-90,2,,29736325,304,6782,29736021,29736325
8677,4,1,1,2412,-89,-90,1,,29737862,304,1233,29737558,29737862
8678,4,1,1,2412,-59,-90,31,b0:e4:d5:32:ec:8a,29750688,1960,10866,29748728,29750688
8679,6,6,1,2412,-66,-90,24,10:86:8c:5f:93:1e,29755054,344,4022,29754710,29755054
8680,4,1,1,2412,-91,-90,-1,bc:98:df:ff:0f:8b,29756273,2568,-1349,29753705,29756273
8681,4,1,1,2412,-45,-90,45,94:a6:7e:c9:98:67,29758890,2464,153,29756426,29758890
8682,6,24,1,2412,-85,-90,5,,29763828,28,4910,29763800,29763828
8683,4,11,1,2412,-72,-90,18,48:dd:0c:7d:86:27,29775465,362,11275,29775103,29775465
8684,4,11,1,2412,-70,-90,20,48:dd:0c:7d:86:23,29775839,323,51,29775516,29775839
8685,4,11,1,2412,-74,-90,16,48:dd:0c:7d:86:25,29776175,382,-46,29775793,29776175
8686,6,6,1,2412,-83,-90,7,40:b0:34:b7:01:d5,29778669,576,1918,29778093,29778669
8687,6,6,1,2412,-63,-90,27,12:86:8c:5f:93:1e,29780439,332,1438,29780107,29780439
8688,4,11,1,2412,-89,-90,1,4c:01:43:ec:a0:66,29799769,387,18943,29799382,29799769
8689,4,11,1,2412,-86,-90,4,48:dd:0c:90:e3:87,29800494,362,363,29800132,29800494
8690,4,11,1,2412,-87,-90,3,48:dd:0c:90:e3:83,29800869,323,52,29800546,29800869
8691,4,11,1,2412,-88,-90,2,48:dd:0c:90:e3:85,29801204,382,-47,29800822,29801204
8692,6,24,1,2412,-86,-90,4,,29831258,28,30026,29831230,29831258
8693,6,6,1,2412,-64,-90,26,32:86:8c:5f:93:1e,29831639,332,49,29831307,29831639
8694,6,24,1,2412,-87,-90,3,,29844241,28,12574,29844213,29844241
8695,6,24,1,2412,-86,-90,4,4c:01:43:d7:f3:26,29845054,32,781,29845022,29845054
8696,4,1,1,2412,-49,-90,41,94:a6:7e:c9:98:67,29860087,2464,12569,29857623,29860087
8697,6,6,1,2412,-64,-90,26,10:86:8c:5f:93:1e,29862406,344,1975,29862062,29862406
8698,4,11,1,2412,-89,-90,1,4c:01:43:d7:f3:29,29863368,362,600,29863006,29863368
8699,6,24,1,2412,-87,-90,3,4c:01:43:d7:f3:26,29867778,32,4378,29867746,29867778
8700,4,1,1,2412,-87,-90,3,78:67:0e:38:6c:d3,29875209,2736,4695,29872473,29875209
8701,4,11,1,2412,-73,-90,17,48:dd:0c:7d:86:27,29877968,362,2397,29877606,29877968
8702,4,11,1,2412,-74,-90,16,48:dd:0c:7d:86:23,29878342,323,51,29878019,29878342
8703,4,11,1,2412,-74,-90,16,48:dd:0c:7d:86:25,29878677,382,-47,29878295,29878677
8704,4,11,1,2412,-88,-90,2,4c:01:43:ec:a0:69,29901481,361,22443,29901120,29901481
8705,4,11,1,2412,-89,-90,1,4c:01:43:ec:a0:63,29901855,322,52,29901533,29901855
8706,4,11,1,2412,-88,-90,2,4c:01:43:ec:a0:66,29902189,387,-53,29901802,29902189
8707,6,24,1,2412,-88,-90,2,,29918778,28,16561,29918750,29918778
8708,4,1,1,2412,-87,-90,3,,29928517,304,9435,29928213,29928517
8709,4,1,1,2412,-64,-90,26,b0:e4:d5:32:ec:8a,29955487,1960,25010,29953527,29955487
8710,4,1,1,2412,-49,-90,41,94:a6:7e:c9:98:67,29962654,2464,4703,29960190,29962654
8711,4,11,1,2412,-90,-90,0,48:dd:0c:92:4b:e7,29968845,362,5829,29968483,29968845
8712,4,1,1,2412,-82,-90,8,78:67:0e:38:6c:d3,29977506,2736,5925,29974770,29977506
8713,4,11,1,2412,-79,-90,11,48:dd:0c:7d:86:27,29980266,362,2398,29979904,29980266
8714,4,11,1,2412,-77,-90,13,48:dd:0c:7d:86:23,29980640,323,51,29980317,29980640
8715,4,11,1,2412,-78,-90,12,48:dd:0c:7d:86:25,29980975,382,-47,29980593,29980975
8716,6,6,1,2412,-64,-90,26,12:86:8c:5f:93:1e,29986304,332,4997,29985972,29986304
8717,4,1,1,2412,-87,-90,3,,30000548,304,13940,30000244,30000548
8718,4,11,1,2412,-81,-90,9,4c:01:43:ec:a0:69,30003814,361,2905,30003453,30003814
8719,4,11,1,2412,-88,-90,2,4c:01:43:ec:a0:63,30004188,322,52,30003866,30004188
8720,6,24,1,2412,-88,-90,2,,30004871,28,655,30004843,30004871
8721,4,11,1,2412,-87,-90,3,48:dd:0c:90:e3:87,30005294,362,61,30004932,30005294
8722,4,11,1,2412,-87,-90,3,48:dd:0c:90:e3:83,30005668,323,51,30005345,30005668
8723,4,11,1,2412,-86,-90,4,48:dd:0c:90:e3:85,30006003,382,-47,30005621,30006003
8724,6,6,1,2412,-88,-90,2,3c:bd:c5:ee:96:6d,30027518,68,21447,30027450,30027518
8725,4,1,1,2412,-88,-90,2,,30032228,304,4406,30031924,30032228
8726,6,6,1,2412,-68,-90,22,32:86:8c:5f:93:1e,30036441,332,3881,30036109,30036441
8727,6,6,1,2412,-87,-90,3,,30041440,44,4955,30041396,30041440
8728,6,6,1,2412,-88,-90,2,3c:bd:c5:ee:96:6d,30043457,68,1949,30043389,30043457
8729,4,1,1,2412,-68,-90,22,b0:e4:d5:32:ec:8a,30057886,1960,12469,30055926,30057886
8730,6,6,1,2412,-90,-90,0,,30060278,44,2348,30060234,30060278
8731,4,1,1,2412,-88,-90,2,,30062040,304,1458,30061736,30062040
8732,4,1,1,2412,-90,-90,0,,30064228,304,1884,30063924,30064228
8733,6,6,1,2412,-66,-90,24,10:86:8c:5f:93:1e,30064570,344,-2,30064226,30064570
8734,4,1,1,2412,-47,-90,43,94:a6:7e:c9:98:67,30065133,2464,-1901,30062669,30065133
8735,4,11,1,2412,-88,-90,2,4c:01:43:d7:f3:29,30068167,362,2672,30067805,30068167
8736,4,11,1,2412,-88,-90,2,4c:01:43:d7:f3:23,30068541,322,52,30068219,30068541
8737,4,11,1,2412,-87,-90,3,4c:01:43:d7:f3:26,30068876,387,-52,30068489,30068876
8738,6,6,1,2412,-89,-90,1,3c:bd:c5:ee:96:6d,30078214,68,9270,30078146,30078214
8739,4,11,1,2412,-75,-90,15,48:dd:0c:7d:86:25,30083375,382,4779,30082993,30083375
8740,6,6,1,2412,-88,-90,2,40:b0:34:b7:01:d5,30086737,576,2786,30086161,30086737
8741,6,6,1,2412,-67,-90,23,12:86:8c:5f:93:1e,30087693,332,624,30087361,30087693
8742,6,6,1,2412,-88,-90,2,,30090489,44,2752,30090445,30090489
8743,6,6,1,2412,-89,-90,1,3c:bd:c5:ee:96:6d,30093147,68,2590,30093079,30093147
8744,6,6,1,2412,-88,-90,2,3c:bd:c5:ee:96:6d,30104110,68,10895,30104042,30104110
8745,4,11,1,2412,-89,-90,1,48:dd:0c:90:e3:87,30107694,362,3222,30107332,30107694
8746,4,11,1,2412,-89,-90,1,48:dd:0c:90:e3:83,30108068,323,51,30107745,30108068
8747,4,1,1,2412,-90,-90,0,78:67:0e:c4:a8:42,30122701,848,13785,30121853,30122701
8748,6,6,1,2412,-89,-90,1,,30130530,44,7785,30130486,30130530
8749,6,6,1,2412,-90,-90,0,3c:bd:c5:ee:96:6d,30132975,68,2377,30132907,30132975
8750,6,6,1,2412,-68,-90,22,32:86:8c:5f:93:1e,30138842,332,5535,30138510,30138842
8751,6,24,1,2412,-81,-90,9,,30140202,28,1332,30140174,30140202
8752,6,24,1,2412,-69,-90,21,10:86:8c:5f:93:1e,30140314,32,80,30140282,30140314
8753,6,6,1,2412,-88,-90,2,,30156556,44,16198,30156512,30156556
8754,6,6,1,2412,-90,-90,0,3c:bd:c5:ee:96:6d,30158298,68,1674,30158230,30158298
8755,4,1,1,2412,-65,-90,25,b0:e4:d5:32:ec:8a,30160286,1960,28,30158326,30160286
8756,4,11,1,2412,-85,-90,5,4c:01:43:d7:f3:29,30170566,362,9918,30170204,30170566
8757,4,11,1,2412,-87,-90,3,4c:01:43:d7:f3:23,30170941,322,53,30170619,30170941
8758,4,11,1,2412,-88,-90,2,4c:01:43:d7:f3:26,30171275,387,-53,30170888,30171275
8759,6,6,1,2412,-88,-90,2,3c:bd:c5:ee:96:6d,30171788,68,445,30171720,30171788
8760,4,11,1,2412,-72,-90,18,48:dd:0c:7d:86:27,30185066,362,12916,30184704,30185066
8761,4,11,1,2412,-72,-90,18,48:dd:0c:7d:86:23,30185441,323,52,30185118,30185441
8762,4,11,1,2412,-72,-90,18,48:dd:0c:7d:86:25,30185776,382,-47,30185394,30185776
8763,6,6,1,2412,-68,-90,22,12:86:8c:5f:93:1e,30190042,332,3934,30189710,30190042
8764,4,11,1,2412,-87,-90,3,4c:01:43:ec:a0:69,30208612,361,18209,30208251,30208612
8765,4,11,1,2412,-87,-90,3,4c:01:43:ec:a0:63,30208986,322,52,30208664,30208986
8766,4,11,1,2412,-87,-90,3,4c:01:43:ec:a0:66,30209320,387,-53,30208933,30209320
8767,4,11,1,2412,-87,-90,3,48:dd:0c:90:e3:87,30210093,362,411,30209731,30210093
8768,4,11,1,2412,-88,-90,2,48:dd:0c:90:e3:85,30210803,382,328,30210421,30210803
8769,4,1,1,2412,-89,-90,1,78:67:0e:c4:a8:42,30211953,352,798,30211601,30211953
8770,4,1,1,2412,-88,-90,2,78:67:0e:c4:a8:42,30222310,2736,7621,30219574,30222310
8771,4,11,1,2412,-86,-90,4,48:dd:0c:90:e3:83,30231116,277,8529,30230839,30231116
8772,4,11,1,2412,-72,-90,18,48:dd:0c:7d:86:23,30231638,284,238,30231354,30231638
8773,6,6,1,2412,-67,-90,23,32:86:8c:5f:93:1e,30241242,332,9272,30240910,30241242
8774,4,1,1,2412,-62,-90,28,b0:e4:d5:32:ec:8a,30262685,1960,19483,30260725,30262685
8775,4,1,1,2412,-48,-90,42,94:a6:7e:c9:98:67,30269678,2464,4529,30267214,30269678
8776,6,6,1,2412,-85,-90,5,,30272153,44,2431,30272109,30272153
8777,4,1,1,2412,-87,-90,3,78:67:0e:c4:a8:42,30275261,352,2756,30274909,30275261
8778,4,1,1,2412,-87,-90,3,78:67:0e:c4:a8:42,30276120,352,507,30275768,30276120
8779,4,1,1,2412,-87,-90,3,78:67:0e:c4:a8:42,30276970,352,498,30276618,30276970
8780,4,11,1,2412,-90,-90,0,48:dd:0c:92:4b:e3,30277763,323,470,30277440,30277763
8781,4,11,1,2412,-89,-90,1,48:dd:0c:92:4b:e5,30278098,382,-47,30277716,30278098
8782,4,1,1,2412,-86,-90,4,78:67:0e:38:6c:d3,30284707,2736,3873,30281971,30284707
8783,4,11,1,2412,-73,-90,17,48:dd:0c:7d:86:27,30287466,362,2397,30287104,30287466
8784,4,11,1,2412,-73,-90,17,48:dd:0c:7d:86:23,30287840,323,51,30287517,30287840
8785,4,11,1,2412,-72,-90,18,48:dd:0c:7d:86:25,30288176,382,-46,30287794,30288176
8786,6,6,1,2412,-90,-90,0,e2:db:d1:d1:b0:4a,30291304,52,3076,30291252,30291304
8787,6,6,1,2412,-69,-90,21,12:86:8c:5f:93:1e,30292443,332,807,30292111,30292443
8788,6,6,1,2412,-90,-90,0,,30305996,44,13509,30305952,30305996
8789,6,6,1,2412,-85,-90,5,,30307613,44,1573,30307569,30307613
8790,4,11,1,2412,-87,-90,3,4c:01:43:ec:a0:69,30311011,361,3037,30310650,30311011
8791,4,11,1,2412,-88,-90,2,4c:01:43:ec:a0:63,30311384,322,51,30311062,30311384
8792,4,11,1,2412,-87,-90,3,4c:01:43:ec:a0:66,30311719,387,-52,30311332,30311719
8793,4,11,1,2412,-83,-90,7,48:dd:0c:90:e3:87,30312493,362,412,30312131,30312493
8794,4,11,1,2412,-83,-90,7,48:dd:0c:90:e3:83,30312867,323,51,30312544,30312867
8795,4,11,1,2412,-87,-90,3,,30315377,107,2403,30315270,30315377
8796,4,1,1,2412,-87,-90,3,78:67:0e:c4:a8:42,30324710,2736,6597,30321974,30324710
8797,6,6,1,2412,-70,-90,20,32:86:8c:5f:93:1e,30343643,332,18601,30343311,30343643
8798,6,6,1,2412,-88,-90,2,e2:db:d1:d1:b0:4a,30351869,52,8174,30351817,30351869
8799,6,6,1,2412,-89,-90,1,e2:db:d1:d1:b0:4a,30352709,52,788,30352657,30352709
8800,6,6,1,2412,-90,-90,0,,30352976,44,223,30352932,30352976
8801,4,1,1,2412,-62,-90,28,b0:e4:d5:32:ec:8a,30365084,1960,10148,30363124,30365084
8802,4,1,1,2412,-78,-90,12,c0:8d:51:da:5c:ef,30368138,416,2638,30367722,30368138
8803,4,1,1,2412,-66,-90,24,,30368565,304,123,30368261,30368565
8804,4,1,1,2412,-49,-90,41,94:a6:7e:c9:98:67,30372263,2464,1234,30369799,30372263
8805,4,11,1,2412,-71,-90,19,48:dd:0c:7d:86:27,30389866,362,17241,30389504,30389866
8806,4,11,1,2412,-72,-90,18,48:dd:0c:7d:86:23,30390240,323,51,30389917,30390240
8807,4,11,1,2412,-74,-90,16,48:dd:0c:7d:86:25,30390576,382,-46,30390194,30390576
8808,4,1,1,2412,-72,-90,18,c0:8d:51:da:5c:ef,30407353,416,16361,30406937,30407353
8809,4,1,1,2412,-69,-90,21,,30407780,304,123,30407476,30407780
8810,4,1,1,2412,-88,-90,2,78:67:0e:c4:a8:42,30427110,2736,16594,30424374,30427110
8811,6,6,1,2412,-89,-90,1,,30440708,44,13554,30440664,30440708
8812,6,6,1,2412,-66,-90,24,32:86:8c:5f:93:1e,30446044,332,5004,30445712,30446044
8813,4,1,1,2412,-62,-90,28,b0:e4:d5:32:ec:8a,30467483,1960,19479,30465523,30467483
8814,4,1,1,2412,-49,-90,41,94:a6:7e:c9:98:67,30474485,2464,4538,30472021,30474485
8815,6,6,1,2412,-67,-90,23,10:86:8c:5f:93:1e,30476869,344,2040,30476525,30476869
8816,4,1,1,2412,-63,-90,27,,30477625,304,452,30477321,30477625
8817,4,1,1,2412,-64,-90,26,,30479346,304,1417,30479042,30479346
8818,7,72.2222,1,2412,-65,-90,25,10:86:8c:5f:93:1e,30479498,50,102,30479448,30479498
8819,6,24,1,2412,-73,-90,17,,30479563,28,37,30479535,30479563
8820,6,24,1,2412,-73,-90,17,,30480212,28,621,30480184,30480212
8821,7,72.2222,1,2412,-75,-90,15,c0:8d:51:da:5c:ef,30480265,50,3,30480215,30480265
8822,6,24,1,2412,-66,-90,24,10:86:8c:5f:93:1e,30480324,32,27,30480292,30480324
8823,4,11,1,2412,-92,-90,-2,48:dd:0c:92:4b:e3,30481219,323,572,30480896,30481219
8824,6,24,1,2412,-87,-90,3,,30483842,28,2595,30483814,30483842
8825,4,1,1,2412,-78,-90,12,78:67:0e:38:6c:d3,30489508,2736,2930,30486772,30489508
8826,4,11,1,2412,-72,-90,18,48:dd:0c:7d:86:27,30492267,362,2397,30491905,30492267
8827,4,11,1,2412,-74,-90,16,48:dd:0c:7d:86:23,30492641,323,51,30492318,30492641
8828,4,11,1,2412,-72,-90,18,48:dd:0c:7d:86:25,30492976,382,-47,30492594,30492976
8829,6,6,1,2412,-81,-90,9,40:b0:34:b7:01:d5,30495477,576,1925,30494901,30495477
8830,6,6,1,2412,-66,-90,24,12:86:8c:5f:93:1e,30497244,332,1435,30496912,30497244
8831,6,6,1,2412,-90,-90,0,e2:db:d1:d1:b0:4a,30503008,68,5696,30502940,30503008
8832,4,11,1,2412,-82,-90,8,4c:01:43:ec:a0:69,30515808,361,12439,30515447,30515808
8833,4,11,1,2412,-84,-90,6,4c:01:43:ec:a0:63,30516182,322,52,30515860,30516182
8834,4,11,1,2412,-78,-90,12,48:dd:0c:90:e3:87,30517292,362,748,30516930,30517292
8835,4,11,1,2412,-81,-90,9,48:dd:0c:90:e3:85,30518002,382,328,30517620,30518002
8836,4,1,1,2412,-89,-90,1,78:67:0e:c4:a8:42,30529510,2736,8772,30526774,30529510
8837,6,6,1,2412,-66,-90,24,32:86:8c:5f:93:1e,30548444,332,18602,30548112,30548444
8838,6,24,1,2412,-88,-90,2,,30551267,28,2795,30551239,30551267
8839,6,24,1,2412,-86,-90,4,,30553970,28,2675,30553942,30553970
8840,4,1,1,2412,-60,-90,30,b0:e4:d5:32:ec:8a,30569883,1960,13953,30567923,30569883
8841,4,1,1,2412,-55,-90,35,94:a6:7e:c9:98:67,30576385,2464,4038,30573921,30576385
8842,4,11,1,2412,-90,-90,0,4c:01:43:d7:f3:23,30580539,322,3832,30580217,30580539
8843,4,11,1,2412,-88,-90,2,4c:01:43:d7:f3:26,30580873,387,-53,30580486,30580873
8844,4,11,1,2412,-92,-90,-2,48:dd:0c:92:4b:e7,30583244,362,2009,30582882,30583244
8845,4,11,1,2412,-90,-90,0,48:dd:0c:92:4b:e3,30583618,323,51,30583295,30583618
8846,4,11,1,2412,-89,-90,1,48:dd:0c:92:4b:e5,30583954,382,-46,30583572,30583954
8847,4,1,1,2412,-81,-90,9,78:67:0e:38:6c:d3,30591908,2736,5218,30589172,30591908
8848,4,11,1,2412,-73,-90,17,48:dd:0c:7d:86:27,30594666,362,2396,30594304,30594666
8849,4,11,1,2412,-71,-90,19,48:dd:0c:7d:86:25,30595376,382,328,30594994,30595376
8850,6,6,1,2412,-83,-90,7,40:b0:34:b7:01:d5,30598801,576,2849,30598225,30598801
8851,6,6,1,2412,-63,-90,27,12:86:8c:5f:93:1e,30599776,332,643,30599444,30599776
8852,6,24,1,2412,-86,-90,4,,30617074,28,17270,30617046,30617074
8853,4,11,1,2412,-85,-90,5,4c:01:43:ec:a0:69,30618207,361,772,30617846,30618207
8854,4,11,1,2412,-85,-90,5,4c:01:43:ec:a0:66,30618915,387,321,30618528,30618915
8855,4,11,1,2412,-85,-90,5,48:dd:0c:90:e3:87,30619692,362,415,30619330,30619692
8856,4,11,1,2412,-86,-90,4,48:dd:0c:90:e3:83,30620067,323,52,30619744,30620067
8857,4,11,1,2412,-85,-90,5,48:dd:0c:90:e3:85,30620402,382,-47,30620020,30620402
8858,6,6,1,2412,-65,-90,25,32:86:8c:5f:93:1e,30650845,332,30111,30650513,30650845
8859,6,6,1,2412,-66,-90,24,10:86:8c:5f:93:1e,30676445,344,25256,30676101,30676445
8860,4,1,1,2412,-53,-90,37,94:a6:7e:c9:98:67,30679272,2464,363,30676808,30679272
8861,4,11,1,2412,-85,-90,5,4c:01:43:d7:f3:29,30682564,362,2930,30682202,30682564
8862,4,11,1,2412,-86,-90,4,4c:01:43:d7:f3:23,30682938,322,52,30682616,30682938
8863,4,11,1,2412,-80,-90,10,4c:01:43:d7:f3:26,30683273,387,-52,30682886,30683273
8864,4,11,1,2412,-89,-90,1,48:dd:0c:90:e3:83,30687094,254,3567,30686840,30687094
8865,4,1,1,2412,-84,-90,6,78:67:0e:38:6c:d3,30694308,2736,4478,30691572,30694308
8866,4,11,1,2412,-71,-90,19,48:dd:0c:7d:86:27,30697067,362,2397,30696705,30697067
8867,4,11,1,2412,-71,-90,19,48:dd:0c:7d:86:23,30697442,323,52,30697119,30697442
8868,4,11,1,2412,-72,-90,18,48:dd:0c:7d:86:25,30697777,382,-47,30697395,30697777
8869,6,6,1,2412,-90,-90,0,3c:bd:c5:ee:96:6d,30698875,68,1030,30698807,30698875
8870,6,6,1,2412,-84,-90,6,40:b0:34:b7:01:d5,30700279,576,828,30699703,30700279
8871,6,6,1,2412,-66,-90,24,12:86:8c:5f:93:1e,30702046,332,1435,30701714,30702046
8872,4,11,1,2412,-84,-90,6,4c:01:43:ec:a0:63,30708301,250,6005,30708051,30708301
8873,4,11,1,2412,-88,-90,2,,30708563,203,59,30708360,30708563
8874,6,6,1,2412,-89,-90,1,,30712034,44,3427,30711990,30712034
8875,6,6,1,2412,-92,-90,-2,3c:bd:c5:ee:96:6d,30715463,52,3377,30715411,30715463
8876,4,11,1,2412,-84,-90,6,4c:01:43:ec:a0:69,30720606,361,4782,30720245,30720606
8877,4,11,1,2412,-83,-90,7,4c:01:43:ec:a0:63,30720980,322,52,30720658,30720980
8878,4,11,1,2412,-82,-90,8,4c:01:43:ec:a0:66,30721314,387,-53,30720927,30721314
8879,4,11,1,2412,-89,-90,1,48:dd:0c:90:e3:85,30722802,382,1106,30722420,30722802
8880,6,6,1,2412,-88,-90,2,,30731232,44,8386,30731188,30731232
8881,6,6,1,2412,-88,-90,2,3c:bd:c5:ee:96:6d,30732660,68,1360,30732592,30732660
8882,4,1,1,2412,-86,-90,4,78:67:0e:c4:a8:42,30734310,2736,-1086,30731574,30734310
8883,6,6,1,2412,-89,-90,1,3c:bd:c5:ee:96:6d,30748254,68,13876,30748186,30748254
8884,6,6,1,2412,-88,-90,2,,30761436,44,13138,30761392,30761436
8885,6,24,1,2412,-84,-90,6,,30768406,28,6942,30768378,30768406
8886,6,6,1,2412,-88,-90,2,3c:bd:c5:ee:96:6d,30773008,68,4534,30772940,30773008
8887,6,6,1,2412,-67,-90,23,10:86:8c:5f:93:1e,30781360,344,8008,30781016,30781360
8888,4,1,1,2412,-54,-90,36,94:a6:7e:c9:98:67,30781923,2464,-1901,30779459,30781923
8889,4,1,1,2412,-85,-90,5,78:67:0e:38:6c:d3,30796708,2736,12049,30793972,30796708
8890,4,11,1,2412,-73,-90,17,48:dd:0c:7d:86:27,30799467,362,2397,30799105,30799467
8891,4,11,1,2412,-75,-90,15,48:dd:0c:7d:86:23,30799842,323,52,30799519,30799842
8892,4,11,1,2412,-74,-90,16,48:dd:0c:7d:86:25,30800177,382,-47,30799795,30800177
8893,6,6,1,2412,-88,-90,2,40:b0:34:b7:01:d5,30803002,576,2249,30802426,30803002
8894,6,6,1,2412,-85,-90,5,,30803913,44,867,30803869,30803913
8895,6,6,1,2412,-68,-90,22,12:86:8c:5f:93:1e,30804446,332,201,30804114,30804446
8896,4,1,1,2412,-74,-90,16,c0:8d:51:da:5c:ef,30811685,416,6823,30811269,30811685
8897,4,1,1,2412,-76,-90,14,c0:8d:51:da:5c:ef,30813235,416,1134,30812819,30813235
8898,4,1,1,2412,-74,-90,16,c0:8d:51:da:5c:ef,30815147,416,1496,30814731,30815147
8899,4,1,1,2412,-74,-90,16,c0:8d:51:da:5c:ef,30817533,416,1970,30817117,30817533
8900,4,1,1,2412,-73,-90,17,c0:8d:51:da:5c:ef,30819265,416,1316,30818849,30819265
8901,4,1,1,2412,-90,-90,0,78:67:0e:c4:a8:42,30820639,352,1022,30820287,30820639
8902,4,1,1,2412,-93,-90,-3,78:67:0e:c4:a8:42,30821499,352,508,30821147,30821499
8903,4,11,1,2412,-89,-90,1,4c:01:43:ec:a0:69,30823005,361,1145,30822644,30823005
8904,4,11,1,2412,-90,-90,0,4c:01:43:ec:a0:66,30823713,387,321,30823326,30823713
8905,4,1,1,2412,-91,-90,-1,78:67:0e:c4:a8:42,30836709,2736,10260,30833973,30836709
8906,6,24,1,2412,-85,-90,5,,30846876,28,10139,30846848,30846876
8907,6,6,1,2412,-71,-90,19,32:86:8c:5f:93:1e,30855647,332,8439,30855315,30855647
8908,4,1,1,2412,-60,-90,30,b0:e4:d5:32:ec:8a,30877080,1960,19473,30875120,30877080
8909,4,1,1,2412,-91,-90,-1,bc:98:df:ff:0f:8b,30881340,2568,1692,30878772,30881340
8910,6,6,1,2412,-75,-90,15,10:86:8c:5f:93:1e,30883764,344,2080,30883420,30883764
8911,4,1,1,2412,-49,-90,41,94:a6:7e:c9:98:67,30884318,2464,-1910,30881854,30884318
8912,4,11,1,2412,-91,-90,-1,,30886774,107,2349,30886667,30886774
8913,4,11,1,2412,-75,-90,15,48:dd:0c:7d:86:23,30895835,284,8777,30895551,30895835
8914,4,11,1,2412,-87,-90,3,48:dd:0c:90:e3:83,30896176,284,57,30895892,30896176
8915,4,1,1,2412,-87,-90,3,78:67:0e:38:6c:d3,30899108,2736,196,30896372,30899108
8916,4,11,1,2412,-77,-90,13,48:dd:0c:7d:86:27,30901867,362,2397,30901505,30901867
8917,4,11,1,2412,-78,-90,12,48:dd:0c:7d:86:23,30902241,323,51,30901918,30902241
8918,4,11,1,2412,-78,-90,12,48:dd:0c:7d:86:25,30902577,382,-46,30902195,30902577
8919,6,6,1,2412,-83,-90,7,40:b0:34:b7:01:d5,30905081,576,1928,30904505,30905081
8920,6,6,1,2412,-75,-90,15,12:86:8c:5f:93:1e,30906847,332,1434,30906515,30906847
8921,4,11,1,2412,-85,-90,5,48:dd:0c:90:e3:87,30926891,362,19682,30926529,30926891
8922,4,11,1,2412,-84,-90,6,48:dd:0c:90:e3:83,30927266,323,52,30926943,30927266
8923,4,11,1,2412,-85,-90,5,48:dd:0c:90:e3:85,30927601,382,-47,30927219,30927601
8924,6,6,1,2412,-73,-90,17,52:86:8c:5f:93:1e,30932516,332,4583,30932184,30932516
8925,6,6,1,2412,-72,-90,18,32:86:8c:5f:93:1e,30958047,332,25199,30957715,30958047
8926,4,1,1,2412,-61,-90,29,b0:e4:d5:32:ec:8a,30979480,1960,19473,30977520,30979480
8927,6,6,1,2412,-71,-90,19,10:86:8c:5f:93:1e,30986160,344,6336,30985816,30986160
8928,4,1,1,2412,-55,-90,35,94:a6:7e:c9:98:67,30986705,2464,-1919,30984241,30986705
8929,6,6,1,2412,-71,-90,19,b4:e6:2d:b4:ff:71,30989426,64,2657,30989362,30989426
8930,6,6,1,2412,-71,-90,19,b4:e6:2d:b4:ff:71,30990783,64,1293,30990719,30990783
8931,6,6,1,2412,-72,-90,18,,30990864,44,37,30990820,30990864
8932,4,1,1,2412,-87,-90,3,78:67:0e:38:6c:d3,31001509,2736,7909,30998773,31001509
8933,4,11,1,2412,-77,-90,13,48:dd:0c:7d:86:27,31004268,362,2397,31003906,31004268
8934,6,6,1,2412,-69,-90,21,12:86:8c:5f:93:1e,31009248,332,4648,31008916,31009248
8935,4,11,1,2412,-83,-90,7,48:dd:0c:90:e3:87,31029291,362,19681,31028929,31029291
8936,4,11,1,2412,-83,-90,7,48:dd:0c:90:e3:83,31029666,323,52,31029343,31029666
8937,4,11,1,2412,-84,-90,6,48:dd:0c:90:e3:85,31030001,382,-47,31029619,31030001
8938,4,1,1,2412,-85,-90,5,,31039046,304,8741,31038742,31039046
8939,4,1,1,2412,-86,-90,4,3c:bd:c5:ee:96:6d,31039385,752,-413,31038633,31039385
8940,4,11,1,2412,-86,-90,4,48:dd:0c:90:e3:83,31071962,254,32323,31071708,31071962
8941,4,11,1,2412,-77,-90,13,48:dd:0c:7d:86:23,31072265,254,49,31072011,31072265
8942,6,6,1,2412,-88,-90,2,48:dd:0c:90:e3:83,31073041,56,720,31072985,31073041
8943,6,6,1,2412,-85,-90,5,,31073679,44,594,31073635,31073679
8944,6,24,1,2412,-86,-90,4,48:dd:0c:7d:86:23,31074885,32,1174,31074853,31074885
8945,6,6,1,2412,-86,-90,4,,31075155,44,226,31075111,31075155
8946,6,24,1,2412,-86,-90,4,48:dd:0c:7d:86:23,31076973,32,1786,31076941,31076973
8947,6,6,1,2412,-88,-90,2,,31080782,44,3765,31080738,31080782
8948,4,1,1,2412,-68,-90,22,b0:e4:d5:32:ec:8a,31082584,1960,-158,31080624,31082584
8949,6,6,1,2412,-67,-90,23,10:86:8c:5f:93:1e,31088408,344,5480,31088064,31088408
8950,4,11,1,2412,-87,-90,3,4c:01:43:d7:f3:26,31092871,387,4076,31092484,31092871
8951,6,24,1,2412,-86,-90,4,,31095774,28,2875,31095746,31095774
8952,4,1,1,2412,-85,-90,5,78:67:0e:38:6c:d3,31103909,2736,5399,31101173,31103909
8953,4,11,1,2412,-73,-90,17,48:dd:0c:7d:86:27,31106667,362,2396,31106305,31106667
8954,4,11,1,2412,-80,-90,10,48:dd:0c:7d:86:23,31107042,323,52,31106719,31107042
8955,4,11,1,2412,-80,-90,10,48:dd:0c:7d:86:25,31107377,382,-47,31106995,31107377
8956,6,6,1,2412,-71,-90,19,12:86:8c:5f:93:1e,31115628,332,7919,31115296,31115628
8957,4,11,1,2412,-92,-90,-2,4c:01:43:ec:a0:66,31131045,387,15030,31130658,31131045
8958,4,11,1,2412,-65,-90,25,48:dd:0c:90:e3:83,31132065,323,697,31131742,31132065
8959,6,6,1,2412,-67,-90,23,32:86:8c:5f:93:1e,31162849,332,30452,31162517,31162849
8960,6,6,1,2412,-66,-90,24,b4:e6:2d:b4:ff:71,31170167,64,7254,31170103,31170167
8961,6,6,1,2412,-66,-90,24,,31170247,44,36,31170203,31170247
8962,4,1,1,2412,-61,-90,29,b0:e4:d5:32:ec:8a,31184278,1960,12071,31182318,31184278
8963,4,1,1,2412,-53,-90,37,94:a6:7e:c9:98:67,31191255,2464,4513,31188791,31191255
8964,4,11,1,2412,-86,-90,4,4c:01:43:d7:f3:23,31194936,322,3359,31194614,31194936
8965,4,11,1,2412,-88,-90,2,4c:01:43:d7:f3:26,31195271,387,-52,31194884,31195271
8966,6,6,1,2412,-91,-90,-1,,31202385,44,7070,31202341,31202385
8967,6,24,1,2412,-86,-90,4,,31203853,28,1440,31203825,31203853
8968,6,6,1,2412,-91,-90,-1,,31205337,44,1440,31205293,31205337
8969,6,6,1,2412,-65,-90,25,12:86:8c:5f:93:1e,31214049,332,8380,31213717,31214049
8970,4,11,1,2412,-90,-90,0,4c:01:43:ec:a0:63,31232974,322,18603,31232652,31232974
8971,4,11,1,2412,-90,-90,0,4c:01:43:ec:a0:66,31233309,387,-52,31232922,31233309
8972,4,11,1,2412,-87,-90,3,48:dd:0c:90:e3:87,31234091,362,420,31233729,31234091
8973,4,11,1,2412,-86,-90,4,48:dd:0c:90:e3:83,31234465,323,51,31234142,31234465
8974,4,11,1,2412,-85,-90,5,48:dd:0c:90:e3:85,31234800,382,-47,31234418,31234800
8975,4,11,1,2412,-85,-90,5,,31237950,107,3043,31237843,31237950
8976,6,6,1,2412,-66,-90,24,52:86:8c:5f:93:1e,31239698,332,1416,31239366,31239698
8977,4,1,1,2412,-86,-90,4,78:67:0e:c4:a8:42,31246309,2736,3875,31243573,31246309
8978,6,24,1,2412,-87,-90,3,,31253252,28,6915,31253224,31253252
8979,6,6,1,2412,-64,-90,26,32:86:8c:5f:93:1e,31265249,332,11665,31264917,31265249
8980,6,24,1,2412,-90,-90,0,,31271276,28,5999,31271248,31271276
8981,4,1,1,2412,-87,-90,3,78:67:0e:c4:a8:42,31277761,352,6133,31277409,31277761
8982,4,1,1,2412,-67,-90,23,b0:e4:d5:32:ec:8a,31286677,1960,6956,31284717,31286677
8983,6,6,1,2412,-63,-90,27,10:86:8c:5f:93:1e,31293354,344,6333,31293010,31293354
8984,4,1,1,2412,-53,-90,37,94:a6:7e:c9:98:67,31293907,2464,-1911,31291443,31293907
8985,4,11,1,2412,-91,-90,-1,4c:01:43:d7:f3:29,31296987,362,2718,31296625,31296987
8986,4,11,1,2412,-90,-90,0,4c:01:43:d7:f3:26,31297696,387,322,31297309,31297696
8987,4,1,1,2412,-90,-90,0,78:67:0e:38:6c:d3,31308709,2736,8277,31305973,31308709
8988,4,11,1,2412,-74,-90,16,48:dd:0c:7d:86:25,31312178,382,3087,31311796,31312178
8989,6,6,1,2412,-84,-90,6,40:b0:34:b7:01:d5,31314685,576,1931,31314109,31314685
8990,6,6,1,2412,-64,-90,26,12:86:8c:5f:93:1e,31316450,332,1433,31316118,31316450
8991,4,1,1,2412,-90,-90,0,78:67:0e:c4:a8:42,31329779,352,12977,31329427,31329779
8992,4,1,1,2412,-88,-90,2,78:67:0e:c4:a8:42,31330944,352,813,31330592,31330944
8993,4,11,1,2412,-91,-90,-1,,31334376,107,3325,31334269,31334376
8994,4,11,1,2412,-84,-90,6,4c:01:43:ec:a0:69,31334999,361,262,31334638,31334999
8995,4,11,1,2412,-85,-90,5,4c:01:43:ec:a0:63,31335373,322,52,31335051,31335373
8996,4,11,1,2412,-85,-90,5,4c:01:43:ec:a0:66,31335707,387,-53,31335320,31335707
8997,4,11,1,2412,-81,-90,9,48:dd:0c:90:e3:87,31336490,362,421,31336128,31336490
8998,4,11,1,2412,-81,-90,9,48:dd:0c:90:e3:83,31336865,323,52,31336542,31336865
8999,4,11,1,2412,-83,-90,7,48:dd:0c:90:e3:85,31337200,382,-47,31336818,31337200
9000,4,1,1,2412,-89,-90,1,78:67:0e:c4:a8:42,31351483,864,13419,31350619,31351483
9001,6,24,1,2412,-89,-90,1,,31355124,28,3613,31355096,31355124
9002,6,6,1,2412,-93,-90,-3,,31358739,44,3571,31358695,31358739
9003,6,6,1,2412,-93,-90,-3,e2:db:d1:d1:b0:4a,31360592,68,1785,31360524,31360592
9004,6,6,1,2412,-63,-90,27,32:86:8c:5f:93:1e,31367650,332,6726,31367318,31367650
9005,6,6,1,2412,-92,-90,-2,,31375846,44,8152,31375802,31375846
9006,6,6,1,2412,-92,-90,-2,e2:db:d1:d1:b0:4a,31375999,68,85,31375931,31375999
9007,4,1,1,2412,-62,-90,28,b0:e4:d5:32:ec:8a,31389084,1960,11125,31387124,31389084
9008,4,1,1,2412,-58,-90,32,94:a6:7e:c9:98:67,31396305,2464,4757,31393841,31396305
9009,4,11,1,2412,-86,-90,4,4c:01:43:d7:f3:29,31399370,362,2703,31399008,31399370
9010,4,11,1,2412,-90,-90,0,4c:01:43:d7:f3:23,31399744,322,52,31399422,31399744
9011,4,11,1,2412,-80,-90,10,48:dd:0c:7d:86:23,31407682,254,7684,31407428,31407682
9012,4,11,1,2412,-80,-90,10,48:dd:0c:7d:86:27,31413869,362,5825,31413507,31413869
9013,4,11,1,2412,-80,-90,10,48:dd:0c:7d:86:23,31414244,323,52,31413921,31414244
9014,4,11,1,2412,-80,-90,10,48:dd:0c:7d:86:25,31414579,382,-47,31414197,31414579
9015,6,6,1,2412,-88,-90,2,40:b0:34:b7:01:d5,31417086,576,1931,31416510,31417086
9016,6,6,1,2412,-65,-90,25,12:86:8c:5f:93:1e,31418850,332,1432,31418518,31418850
9017,6,6,1,2412,-90,-90,0,e2:db:d1:d1:b0:4d,31430703,408,11445,31430295,31430703
9018,4,11,1,2412,-89,-90,1,4c:01:43:ec:a0:69,31437398,361,6334,31437037,31437398
9019,4,11,1,2412,-88,-90,2,4c:01:43:ec:a0:63,31437772,322,52,31437450,31437772
9020,4,11,1,2412,-87,-90,3,4c:01:43:ec:a0:66,31438106,387,-53,31437719,31438106
9021,4,11,1,2412,-87,-90,3,48:dd:0c:90:e3:87,31438890,362,422,31438528,31438890
9022,6,6,1,2412,-91,-90,-1,,31447821,44,8887,31447777,31447821
9023,6,6,1,2412,-66,-90,24,32:86:8c:5f:93:1e,31470050,332,21897,31469718,31470050
9024,4,1,1,2412,-66,-90,24,b0:e4:d5:32:ec:8a,31491476,1960,19466,31489516,31491476
9025,6,6,1,2412,-68,-90,22,10:86:8c:5f:93:1e,31498296,344,6476,31497952,31498296
9026,4,1,1,2412,-57,-90,33,94:a6:7e:c9:98:67,31498850,2464,-1910,31496386,31498850
9027,4,1,1,2412,-85,-90,5,78:67:0e:38:6c:d3,31513510,2736,11924,31510774,31513510
9028,4,11,1,2412,-81,-90,9,48:dd:0c:7d:86:27,31516269,362,2397,31515907,31516269
9029,4,11,1,2412,-81,-90,9,48:dd:0c:7d:86:23,31516643,323,51,31516320,31516643
9030,4,11,1,2412,-81,-90,9,48:dd:0c:7d:86:25,31516979,382,-46,31516597,31516979
9031,6,6,1,2412,-90,-90,0,,31518395,44,1372,31518351,31518395
9032,4,1,1,2412,-88,-90,2,78:67:0e:38:6c:d3,31518699,1840,-1536,31516859,31518699
9033,4,1,1,2412,-86,-90,4,78:67:0e:38:6c:d3,31524753,3928,2126,31520825,31524753
9034,4,1,1,2412,-85,-90,5,78:67:0e:38:6c:d3,31528692,3808,131,31524884,31528692
9035,4,1,1,2412,-85,-90,5,78:67:0e:38:6c:d3,31536402,3760,3950,31532642,31536402
9036,6,6,1,2412,-69,-90,21,12:86:8c:5f:93:1e,31540018,332,3284,31539686,31540018
9037,4,11,1,2412,-86,-90,4,48:dd:0c:90:e3:87,31541290,362,910,31540928,31541290
9038,4,11,1,2412,-85,-90,5,48:dd:0c:90:e3:83,31541664,323,51,31541341,31541664
9039,4,11,1,2412,-84,-90,6,48:dd:0c:90:e3:85,31542000,382,-46,31541618,31542000
9040,4,1,1,2412,-88,-90,2,3c:bd:c5:ee:96:6d,31549800,976,6824,31548824,31549800
9041,6,6,1,2412,-70,-90,20,32:86:8c:5f:93:1e,31572452,332,22320,31572120,31572452
9042,4,1,1,2412,-63,-90,27,b0:e4:d5:32:ec:8a,31593875,1960,19463,31591915,31593875
9043,4,1,1,2412,-91,-90,-1,,31597447,304,3268,31597143,31597447
9044,6,6,1,2412,-68,-90,22,10:86:8c:5f:93:1e,31600552,344,2761,31600208,31600552
9045,4,1,1,2412,-55,-90,35,94:a6:7e:c9:98:67,31601105,2464,-1911,31598641,31601105
9046,4,11,1,2412,-80,-90,10,48:dd:0c:7d:86:27,31618669,362,17202,31618307,31618669
9047,4,11,1,2412,-81,-90,9,48:dd:0c:7d:86:23,31619043,323,51,31618720,31619043
9048,4,11,1,2412,-81,-90,9,48:dd:0c:7d:86:25,31619378,382,-47,31618996,31619378
9049,6,6,1,2412,-69,-90,21,12:86:8c:5f:93:1e,31623652,332,3942,31623320,31623652
9050,6,6,1,2412,-90,-90,0,e2:db:d1:d1:b0:4d,31635494,408,11434,31635086,31635494
9051,6,6,1,2412,-89,-90,1,e2:db:d1:d1:b0:4f,31635953,408,51,31635545,31635953
9052,6,6,1,2412,-90,-90,0,,31637339,44,1342,31637295,31637339
9053,4,11,1,2412,-85,-90,5,4c:01:43:ec:a0:69,31642196,361,4496,31641835,31642196
9054,4,11,1,2412,-84,-90,6,4c:01:43:ec:a0:63,31642569,322,51,31642247,31642569
9055,4,11,1,2412,-85,-90,5,4c:01:43:ec:a0:66,31642904,387,-52,31642517,31642904
9056,4,11,1,2412,-83,-90,7,48:dd:0c:90:e3:87,31643690,362,424,31643328,31643690
9057,4,11,1,2412,-84,-90,6,48:dd:0c:90:e3:83,31644064,323,51,31643741,31644064
9058,6,6,1,2412,-66,-90,24,52:86:8c:5f:93:1e,31649340,332,4944,31649008,31649340
9059,4,11,1,2412,-89,-90,1,4c:01:43:d7:f3:26,31654389,383,4666,31654006,31654389
9060,4,11,1,2412,-90,-90,0,4c:01:43:d7:f3:26,31654895,383,123,31654512,31654895
9061,4,1,1,2412,-91,-90,-1,78:67:0e:38:6c:d3,31679627,3472,21260,31676155,31679627
9062,6,6,1,2412,-66,-90,24,32:86:8c:5f:93:1e,31683270,332,3311,31682938,31683270
9063,4,1,1,2412,-62,-90,28,b0:e4:d5:32:ec:8a,31696275,1960,11045,31694315,31696275
9064,6,6,1,2412,-65,-90,25,10:86:8c:5f:93:1e,31700453,344,3834,31700109,31700453
9065,4,1,1,2412,-55,-90,35,94:a6:7e:c9:98:67,31703652,2464,735,31701188,31703652
9066,4,1,1,2412,-66,-90,24,c0:8d:51:da:5c:ef,31706211,416,2143,31705795,31706211
9067,4,1,1,2412,-63,-90,27,,31706638,304,123,31706334,31706638
9068,4,11,1,2412,-73,-90,17,48:dd:0c:7d:86:27,31721069,362,14069,31720707,31721069
9069,4,11,1,2412,-75,-90,15,48:dd:0c:7d:86:25,31721779,382,328,31721397,31721779
9070,4,11,1,2412,-73,-90,17,4c:01:43:d7:f3:23,31723809,254,1776,31723555,31723809
9071,6,6,1,2412,-68,-90,22,12:86:8c:5f:93:1e,31726052,332,1911,31725720,31726052
9072,4,11,1,2412,-84,-90,6,48:dd:0c:90:e3:87,31746089,362,19675,31745727,31746089
9073,4,11,1,2412,-85,-90,5,48:dd:0c:90:e3:83,31746464,323,52,31746141,31746464
9074,4,11,1,2412,-85,-90,5,48:dd:0c:90:e3:85,31746799,382,-47,31746417,31746799
9075,4,1,1,2412,-91,-90,-1,,31749698,304,2595,31749394,31749698
9076,6,24,1,2412,-90,-90,0,,31751282,28,1556,31751254,31751282
9077,4,1,1,2412,-85,-90,5,78:67:0e:c4:a8:42,31758309,2736,4291,31755573,31758309
9078,6,6,1,2412,-90,-90,0,,31769263,44,10910,31769219,31769263
9079,6,6,1,2412,-69,-90,21,32:86:8c:5f:93:1e,31777253,332,7658,31776921,31777253
9080,4,1,1,2412,-84,-90,6,,31791925,304,14368,31791621,31791925
9081,4,1,1,2412,-61,-90,29,b0:e4:d5:32:ec:8a,31798674,1960,4789,31796714,31798674
9082,6,6,1,2412,-70,-90,20,10:86:8c:5f:93:1e,31805352,344,6334,31805008,31805352
9083,4,1,1,2412,-50,-90,40,94:a6:7e:c9:98:67,31805897,2464,-1919,31803433,31805897
9084,4,1,1,2412,-86,-90,4,78:67:0e:38:6c:d3,31820711,2736,12078,31817975,31820711
9085,4,11,1,2412,-78,-90,12,48:dd:0c:7d:86:27,31823469,362,2396,31823107,31823469
9086,4,11,1,2412,-77,-90,13,48:dd:0c:7d:86:23,31823844,323,52,31823521,31823844
9087,4,11,1,2412,-77,-90,13,48:dd:0c:7d:86:25,31824179,382,-47,31823797,31824179
9088,6,6,1,2412,-86,-90,4,40:b0:34:b7:01:d5,31826691,576,1936,31826115,31826691
9089,6,6,1,2412,-68,-90,22,12:86:8c:5f:93:1e,31828453,332,1430,31828121,31828453
9090,4,1,1,2412,-87,-90,3,,31836610,304,7853,31836306,31836610
9091,4,11,1,2412,-84,-90,6,48:dd:0c:90:e3:87,31848489,362,11517,31848127,31848489
9092,4,11,1,2412,-85,-90,5,48:dd:0c:90:e3:85,31849199,382,328,31848817,31849199
9093,6,24,1,2412,-88,-90,2,,31853886,28,4659,31853858,31853886
9094,4,1,1,2412,-88,-90,2,,31857401,304,3211,31857097,31857401
9095,4,1,1,2412,-87,-90,3,3c:bd:c5:ee:96:6d,31858073,1056,-384,31857017,31858073
9096,6,24,1,2412,-87,-90,3,,31859410,28,1309,31859382,31859410
9097,6,24,1,2412,-88,-90,2,,31859671,28,233,31859643,31859671
9098,6,12,1,2412,-87,-90,3,4c:01:43:ec:a0:66,31859790,44,75,31859746,31859790
9099,4,1,1,2412,-88,-90,2,4c:01:43:ec:a0:66,31867881,448,7643,31867433,31867881
9100,6,24,1,2412,-86,-90,4,,31876363,28,8454,31876335,31876363
9101,6,6,1,2412,-66,-90,24,32:86:8c:5f:93:1e,31879654,332,2959,31879322,31879654
9102,6,24,1,2412,-86,-90,4,,31880886,28,1204,31880858,31880886
9103,4,1,1,2412,-68,-90,22,b0:e4:d5:32:ec:8a,31901073,1960,18227,31899113,31901073
9104,4,1,1,2412,-94,-90,-4,bc:98:df:ff:0f:8b,31905329,2568,1688,31902761,31905329
9105,6,6,1,2412,-65,-90,25,10:86:8c:5f:93:1e,31907752,344,2079,31907408,31907752
9106,4,1,1,2412,-54,-90,36,94:a6:7e:c9:98:67,31908297,2464,-1919,31905833,31908297
9107,4,1,1,2412,-87,-90,3,78:67:0e:38:6c:d3,31923111,2736,12078,31920375,31923111
9108,4,11,1,2412,-71,-90,19,48:dd:0c:7d:86:27,31925870,362,2397,31925508,31925870
9109,4,11,1,2412,-72,-90,18,48:dd:0c:7d:86:23,31926245,323,52,31925922,31926245
9110,4,11,1,2412,-71,-90,19,48:dd:0c:7d:86:25,31926580,382,-47,31926198,31926580
9111,6,6,1,2412,-88,-90,2,40:b0:34:b7:01:d5,31929092,576,1936,31928516,31929092
9112,6,6,1,2412,-63,-90,27,12:86:8c:5f:93:1e,31930854,332,1430,31930522,31930854
9113,4,11,1,2412,-89,-90,1,4c:01:43:ec:a0:69,31949392,361,18177,31949031,31949392
9114,4,11,1,2412,-87,-90,3,48:dd:0c:90:e3:87,31950889,362,1135,31950527,31950889
9115,4,11,1,2412,-85,-90,5,48:dd:0c:90:e3:83,31951263,323,51,31950940,31951263
9116,4,11,1,2412,-86,-90,4,48:dd:0c:90:e3:85,31951599,382,-46,31951217,31951599
9117,4,1,1,2412,-91,-90,-1,78:67:0e:c4:a8:42,31963108,2736,8773,31960372,31963108
9118,4,1,1,2412,-90,-90,0,78:67:0e:c4:a8:42,31965882,848,1926,31965034,31965882
9119,6,6,1,2412,-64,-90,26,32:86:8c:5f:93:1e,31984053,332,17839,31983721,31984053
9120,4,1,1,2412,-66,-90,24,b0:e4:d5:32:ec:8a,32003472,1960,17459,32001512,32003472
9121,4,11,1,2412,-65,-90,25,10:86:8c:5f:93:1e,32008515,347,4696,32008168,32008515
9122,4,1,1,2412,-56,-90,34,94:a6:7e:c9:98:67,32010841,2464,-138,32008377,32010841
9123,4,11,1,2412,-90,-90,0,4c:01:43:d7:f3:29,32013758,362,2555,32013396,32013758
9124,4,11,1,2412,-92,-90,-2,4c:01:43:d7:f3:23,32014132,322,52,32013810,32014132
9125,6,6,1,2412,-67,-90,23,b4:e6:2d:b4:ff:71,32014770,64,574,32014706,32014770
9126,6,6,1,2412,-67,-90,23,b4:e6:2d:b4:ff:71,32015093,64,259,32015029,32015093
9127,6,6,1,2412,-67,-90,23,b4:e6:2d:b4:ff:71,32015318,64,161,32015254,32015318
9128,6,6,1,2412,-67,-90,23,b4:e6:2d:b4:ff:71,32016067,64,685,32016003,32016067
9129,4,1,1,2412,-67,-90,23,b4:e6:2d:b4:ff:71,32017215,416,732,32016799,32017215
9130,4,1,1,2412,-68,-90,22,b4:e6:2d:b4:ff:71,32017977,416,346,32017561,32017977
9131,4,1,1,2412,-70,-90,20,,32018403,304,122,32018099,32018403
9132,4,1,1,2412,-88,-90,2,78:67:0e:38:6c:d3,32025511,2736,4372,32022775,32025511
9133,4,11,1,2412,-73,-90,17,48:dd:0c:7d:86:27,32028270,362,2397,32027908,32028270
9134,4,11,1,2412,-72,-90,18,48:dd:0c:7d:86:23,32028644,323,51,32028321,32028644
9135,4,11,1,2412,-74,-90,16,48:dd:0c:7d:86:25,32028980,382,-46,32028598,32028980
9136,4,1,1,2412,-88,-90,2,78:67:0e:c4:a8:42,32032185,352,2853,32031833,32032185
9137,6,6,1,2412,-66,-90,24,12:86:8c:5f:93:1e,32036084,332,3567,32035752,32036084
9138,6,6,1,2412,-91,-90,-1,e2:db:d1:d1:b0:4b,32044955,408,8463,32044547,32044955
9139,4,11,1,2412,-89,-90,1,4c:01:43:ec:a0:66,32052499,387,7157,32052112,32052499
9140,4,11,1,2412,-88,-90,2,48:dd:0c:90:e3:87,32053289,362,428,32052927,32053289
9141,4,11,1,2412,-88,-90,2,48:dd:0c:90:e3:83,32053663,323,51,32053340,32053663
9142,4,1,1,2412,-88,-90,2,78:67:0e:c4:a8:42,32065508,2736,9109,32062772,32065508
9143,6,24,1,2412,-85,-90,5,,32072341,28,6805,32072313,32072341
9144,6,6,1,2412,-66,-90,24,32:86:8c:5f:93:1e,32084455,332,11782,32084123,32084455
9145,6,6,1,2412,-90,-90,0,,32092438,44,7939,32092394,32092438
9146,4,1,1,2412,-62,-90,28,b0:e4:d5:32:ec:8a,32105872,1960,11474,32103912,32105872
9147,6,6,1,2412,-66,-90,24,10:86:8c:5f:93:1e,32112554,344,6338,32112210,32112554
9148,4,1,1,2412,-55,-90,35,94:a6:7e:c9:98:67,32113159,2464,-1859,32110695,32113159
9149,4,1,1,2412,-56,-90,34,94:a6:7e:c9:98:67,32115660,2416,85,32113244,32115660
9150,4,1,1,2412,-55,-90,35,94:a6:7e:c9:98:67,32118131,2576,-105,32115555,32118131
9151,4,1,1,2412,-56,-90,34,94:a6:7e:c9:98:67,32120735,1984,620,32118751,32120735
9152,4,1,1,2412,-56,-90,34,94:a6:7e:c9:98:67,32122775,2144,-104,32120631,32122775
9153,4,1,1,2412,-74,-90,16,78:67:0e:38:6c:d3,32127911,2736,2400,32125175,32127911
9154,4,11,1,2412,-74,-90,16,48:dd:0c:7d:86:27,32130671,362,2398,32130309,32130671
9155,4,11,1,2412,-72,-90,18,48:dd:0c:7d:86:23,32131045,323,51,32130722,32131045
9156,4,11,1,2412,-74,-90,16,48:dd:0c:7d:86:25,32131380,382,-47,32130998,32131380
9157,4,11,1,2412,-75,-90,15,48:dd:0c:7d:86:23,32138145,277,6488,32137868,32138145
9158,4,1,1,2412,-89,-90,1,78:67:0e:38:6c:d3,32152165,4416,9604,32147749,32152165
9159,4,1,1,2412,-87,-90,3,78:67:0e:38:6c:d3,32160708,4528,4015,32156180,32160708
9160,4,1,1,2412,-87,-90,3,78:67:0e:38:6c:d3,32165247,4544,-5,32160703,32165247
9161,4,1,1,2412,-90,-90,0,78:67:0e:38:6c:d3,32174453,4672,4534,32169781,32174453
9162,4,1,1,2412,-88,-90,2,78:67:0e:38:6c:d3,32183691,2208,7030,32181483,32183691
9163,4,1,1,2412,-87,-90,3,,32187965,304,3970,32187661,32187965
9164,6,6,1,2412,-63,-90,27,b4:e6:2d:b4:ff:71,32194424,64,6395,32194360,32194424
9165,6,6,1,2412,-63,-90,27,,32194504,44,36,32194460,32194504
9166,6,6,1,2412,-89,-90,1,,32205504,44,10956,32205460,32205504
9167,4,1,1,2412,-57,-90,33,b0:e4:d5:32:ec:8a,32208271,1960,807,32206311,32208271
9168,4,11,1,2412,-86,-90,4,,32211644,107,3266,32211537,32211644
9169,4,1,1,2412,-55,-90,35,94:a6:7e:c9:98:67,32215497,2464,1389,32213033,32215497
9170,4,1,1,2412,-88,-90,2,78:67:0e:c4:a8:42,32218480,352,2631,32218128,32218480
9171,4,11,1,2412,-90,-90,0,4c:01:43:d7:f3:26,32219266,387,399,32218879,32219266
9172,6,6,1,2412,-89,-90,1,3c:bd:c5:ee:96:6d,32220142,68,808,32220074,32220142
9173,4,1,1,2412,-91,-90,-1,78:67:0e:38:6c:d3,32230312,2736,7434,32227576,32230312
9174,4,11,1,2412,-80,-90,10,48:dd:0c:7d:86:27,32233071,362,2397,32232709,32233071
9175,4,11,1,2412,-80,-90,10,48:dd:0c:7d:86:23,32233445,323,51,32233122,32233445
9176,4,11,1,2412,-79,-90,11,48:dd:0c:7d:86:25,32233780,382,-47,32233398,32233780
9177,6,6,1,2412,-89,-90,1,3c:bd:c5:ee:96:6d,32235624,68,1776,32235556,32235624
9178,6,6,1,2412,-88,-90,2,,32245094,44,9426,32245050,32245094
9179,6,6,1,2412,-87,-90,3,e2:db:d1:d1:b0:4b,32250414,408,4912,32250006,32250414
9180,6,6,1,2412,-88,-90,2,e2:db:d1:d1:b0:4a,32252165,632,1119,32251533,32252165
9181,6,6,1,2412,-88,-90,2,e2:db:d1:d1:b0:4a,32252893,656,72,32252237,32252893
9182,6,6,1,2412,-88,-90,2,e2:db:d1:d1:b0:4a,32254699,156,1650,32254543,32254699
9183,6,6,1,2412,-88,-90,2,e2:db:d1:d1:b0:4a,32254952,196,57,32254756,32254952
9184,6,6,1,2412,-88,-90,2,e2:db:d1:d1:b0:4a,32255243,156,135,32255087,32255243
9185,4,11,1,2412,-87,-90,3,4c:01:43:ec:a0:69,32256589,361,985,32256228,32256589
9186,4,11,1,2412,-88,-90,2,4c:01:43:ec:a0:63,32256963,322,52,32256641,32256963
9187,4,11,1,2412,-88,-90,2,48:dd:0c:90:e3:87,32258088,362,763,32257726,32258088
9188,4,11,1,2412,-88,-90,2,48:dd:0c:90:e3:83,32258463,323,52,32258140,32258463
9189,4,11,1,2412,-88,-90,2,48:dd:0c:90:e3:85,32258798,382,-47,32258416,32258798
9190,6,6,1,2412,-90,-90,0,,32259631,44,789,32259587,32259631
9191,6,6,1,2412,-88,-90,2,,32266834,44,7159,32266790,32266834
9192,6,24,1,2412,-85,-90,5,,32270110,28,3248,32270082,32270110
9193,4,1,1,2412,-87,-90,3,78:67:0e:c4:a8:42,32270336,2736,-2510,32267600,32270336
9194,4,11,1,2412,-88,-90,2,,32273256,107,2813,32273149,32273256
9195,6,24,1,2412,-85,-90,5,78:67:0e:c4:a8:42,32273369,32,81,32273337,32273369
9196,6,6,1,2412,-87,-90,3,,32280049,44,6636,32280005,32280049
9197,6,6,1,2412,-90,-90,0,,32285653,44,5560,32285609,32285653
9198,6,6,1,2412,-89,-90,1,3c:bd:c5:ee:96:6d,32287969,68,2248,32287901,32287969
9199,6,6,1,2412,-88,-90,2,,32288308,44,295,32288264,32288308
9200,6,6,1,2412,-87,-90,3,,32288711,44,359,32288667,32288711
9201,6,6,1,2412,-66,-90,24,32:86:8c:5f:93:1e,32289257,332,214,32288925,32289257
9202,4,1,1,2412,-88,-90,2,,32290140,304,579,32289836,32290140
9203,6,6,1,2412,-90,-90,0,,32290361,44,177,32290317,32290361
9204,4,1,1,2412,-58,-90,32,b0:e4:d5:32:ec:8a,32310670,1960,18349,32308710,32310670
9205,6,6,1,2412,-65,-90,25,10:86:8c:5f:93:1e,32314857,344,3843,32314513,32314857
9206,4,1,1,2412,-53,-90,37,94:a6:7e:c9:98:67,32317654,2464,333,32315190,32317654
9207,4,1,1,2412,-53,-90,37,94:a6:7e:c9:98:67,32320165,1688,823,32318477,32320165
9208,4,1,1,2412,-53,-90,37,94:a6:7e:c9:98:67,32321908,1848,-105,32320060,32321908
9209,4,1,1,2412,-87,-90,3,78:67:0e:38:6c:d3,32332712,2736,8068,32329976,32332712
9210,6,6,1,2412,-86,-90,4,,32336704,44,3948,32336660,32336704
9211,6,6,1,2412,-65,-90,25,12:86:8c:5f:93:1e,32340457,332,3421,32340125,32340457
9212,4,11,1,2412,-89,-90,1,4c:01:43:db:2d:89,32343530,362,2711,32343168,32343530
9213,4,11,1,2412,-87,-90,3,4c:01:43:db:2d:83,32343905,322,53,32343583,32343905
9214,4,11,1,2412,-88,-90,2,4c:01:43:db:2d:86,32344239,387,-53,32343852,32344239
9215,6,6,1,2412,-86,-90,4,3c:bd:c5:ee:96:6d,32350801,68,6494,32350733,32350801
9216,6,6,1,2412,-91,-90,-1,e2:db:d1:d1:b0:4d,32352320,408,1111,32351912,32352320
9217,6,24,1,2412,-89,-90,1,,32355511,28,3163,32355483,32355511
9218,4,1,1,2412,-87,-90,3,78:67:0e:c4:a8:42,32357236,352,1373,32356884,32357236
9219,4,11,1,2412,-88,-90,2,4c:01:43:ec:a0:63,32359361,322,1803,32359039,32359361
9220,4,11,1,2412,-89,-90,1,4c:01:43:ec:a0:66,32359696,387,-52,32359309,32359696
9221,4,11,1,2412,-86,-90,4,48:dd:0c:90:e3:87,32360488,362,430,32360126,32360488
9222,6,6,1,2412,-67,-90,23,32:86:8c:5f:93:1e,32391657,332,30837,32391325,32391657
9223,6,24,1,2412,-88,-90,2,,32397396,28,5711,32397368,32397396
9224,4,1,1,2412,-65,-90,25,b0:e4:d5:32:ec:8a,32413069,1960,13713,32411109,32413069
9225,4,1,1,2412,-60,-90,30,94:a6:7e:c9:98:67,32420047,2464,4514,32417583,32420047
9226,4,1,1,2412,-86,-90,4,78:67:0e:38:6c:d3,32435112,2736,12329,32432376,32435112
9227,4,11,1,2412,-82,-90,8,48:dd:0c:7d:86:27,32437871,362,2397,32437509,32437871
9228,4,11,1,2412,-82,-90,8,48:dd:0c:7d:86:23,32438246,323,52,32437923,32438246
9229,4,11,1,2412,-83,-90,7,48:dd:0c:7d:86:25,32438581,382,-47,32438199,32438581
9230,4,1,1,2412,-87,-90,3,,32440176,304,1291,32439872,32440176
9231,4,11,1,2412,-81,-90,9,48:dd:0c:90:e3:83,32463262,323,22763,32462939,32463262
9232,4,1,1,2412,-87,-90,3,78:67:0e:38:6c:d3,32475923,4576,8085,32471347,32475923
9233,4,1,1,2412,-87,-90,3,78:67:0e:38:6c:d3,32489244,4032,9289,32485212,32489244
9234,6,6,1,2412,-72,-90,18,12:86:8c:5f:93:1e,32493132,332,3556,32492800,32493132
9235,6,6,1,2412,-87,-90,3,,32501813,44,8637,32501769,32501813
9236,6,6,1,2412,-89,-90,1,,32506867,44,5010,32506823,32506867
9237,4,1,1,2412,-91,-90,-1,38:01:46:30:1a:ca,32507995,416,712,32507579,32507995
9238,6,6,1,2412,-88,-90,2,3c:bd:c5:ee:96:6d,32508274,68,211,32508206,32508274
9239,6,6,1,2412,-88,-90,2,3c:bd:c5:ee:96:6d,32512993,68,4651,32512925,32512993
9240,4,1,1,2412,-62,-90,28,b0:e4:d5:32:ec:8a,32515469,1960,516,32513509,32515469
9241,6,6,1,2412,-68,-90,22,10:86:8c:5f:93:1e,32519658,344,3845,32519314,32519658
9242,4,1,1,2412,-55,-90,35,94:a6:7e:c9:98:67,32522466,2464,344,32520002,32522466
9243,4,1,1,2412,-87,-90,3,78:67:0e:38:6c:d3,32537512,2736,12310,32534776,32537512
9244,4,11,1,2412,-73,-90,17,48:dd:0c:7d:86:27,32540271,362,2397,32539909,32540271
9245,4,11,1,2412,-75,-90,15,48:dd:0c:7d:86:23,32540645,323,51,32540322,32540645
9246,4,11,1,2412,-73,-90,17,48:dd:0c:7d:86:25,32540981,382,-46,32540599,32540981
9247,6,6,1,2412,-82,-90,8,40:b0:34:b7:01:d5,32544922,576,3365,32544346,32544922
9248,6,6,1,2412,-67,-90,23,12:86:8c:5f:93:1e,32545524,332,270,32545192,32545524
9249,6,24,1,2412,-86,-90,4,,32560890,28,15338,32560862,32560890
9250,4,11,1,2412,-80,-90,10,48:dd:0c:90:e3:87,32565287,362,4035,32564925,32565287
9251,4,1,1,2412,-87,-90,3,78:67:0e:c4:a8:42,32580291,1488,13516,32578803,32580291
9252,4,1,1,2412,-87,-90,3,78:67:0e:c4:a8:42,32581790,1648,-149,32580142,32581790
9253,6,6,1,2412,-67,-90,23,32:86:8c:5f:93:1e,32596459,332,14337,32596127,32596459
9254,6,6,1,2412,-68,-90,22,10:86:8c:5f:93:1e,32622543,344,25740,32622199,32622543
9255,4,1,1,2412,-54,-90,36,94:a6:7e:c9:98:67,32625081,2464,74,32622617,32625081
9256,4,11,1,2412,-88,-90,2,4c:01:43:d7:f3:23,32628530,322,3127,32628208,32628530
9257,4,1,1,2412,-86,-90,4,78:67:0e:38:6c:d3,32639912,2736,8646,32637176,32639912
9258,4,11,1,2412,-76,-90,14,48:dd:0c:7d:86:27,32642672,362,2398,32642310,32642672
9259,4,11,1,2412,-77,-90,13,48:dd:0c:7d:86:23,32643046,323,51,32642723,32643046
9260,4,11,1,2412,-77,-90,13,48:dd:0c:7d:86:25,32643382,382,-46,32643000,32643382
9261,6,6,1,2412,-85,-90,5,40:b0:34:b7:01:d5,32645899,576,1941,32645323,32645899
9262,6,6,1,2412,-91,-90,-1,,32647008,44,1065,32646964,32647008
9263,6,6,1,2412,-67,-90,23,12:86:8c:5f:93:1e,32647659,332,319,32647327,32647659
9264,6,6,1,2412,-92,-90,-2,3c:bd:c5:ee:96:6d,32648094,68,367,32648026,32648094
9265,6,6,1,2412,-90,-90,0,,32649008,44,870,32648964,32649008
9266,4,1,1,2412,-92,-90,-2,00:26:62:eb:ea:74,32653197,968,3221,32652229,32653197
9267,4,11,1,2412,-87,-90,3,4c:01:43:ec:a0:69,32666184,361,12626,32665823,32666184
9268,4,11,1,2412,-87,-90,3,4c:01:43:ec:a0:63,32666558,322,52,32666236,32666558
9269,4,11,1,2412,-86,-90,4,48:dd:0c:90:e3:87,32667687,362,767,32667325,32667687
9270,4,11,1,2412,-84,-90,6,48:dd:0c:90:e3:83,32668062,323,52,32667739,32668062
9271,6,6,1,2412,-92,-90,-2,,32676093,44,7987,32676049,32676093
9272,6,6,1,2412,-90,-90,0,3c:bd:c5:ee:96:6d,32677286,68,1125,32677218,32677286
9273,4,1,1,2412,-88,-90,2,78:67:0e:c4:a8:42,32679908,2736,-114,32677172,32679908
9274,6,6,1,2412,-66,-90,24,32:86:8c:5f:93:1e,32698859,332,18619,32698527,32698859
9275,4,1,1,2412,-90,-90,0,3c:bd:c5:ee:96:6d,32710659,3280,8520,32707379,32710659
9276,4,1,1,2412,-90,-90,0,3c:bd:c5:ee:96:6d,32718273,3280,4334,32714993,32718273
9277,4,1,1,2412,-62,-90,28,b0:e4:d5:32:ec:8a,32721888,1960,1655,32719928,32721888
9278,4,1,1,2412,-59,-90,31,94:a6:7e:c9:98:67,32727173,2464,2821,32724709,32727173
9279,4,1,1,2412,-57,-90,33,94:a6:7e:c9:98:67,32729675,1688,814,32727987,32729675
9280,4,1,1,2412,-59,-90,31,94:a6:7e:c9:98:67,32731418,1848,-105,32729570,32731418
9281,4,1,1,2412,-86,-90,4,78:67:0e:38:6c:d3,32745088,2208,11462,32742880,32745088
9282,4,1,1,2412,-83,-90,7,78:67:0e:38:6c:d3,32747307,1840,379,32745467,32747307
9283,4,1,1,2412,-86,-90,4,78:67:0e:38:6c:d3,32749158,4192,-2341,32744966,32749158
9284,4,1,1,2412,-87,-90,3,78:67:0e:38:6c:d3,32753361,3928,275,32749433,32753361
9285,4,1,1,2412,-87,-90,3,78:67:0e:38:6c:d3,32765010,3760,7889,32761250,32765010
9286,6,6,1,2412,-64,-90,26,12:86:8c:5f:93:1e,32768625,332,3283,32768293,32768625
9287,4,11,1,2412,-88,-90,2,4c:01:43:ec:a0:63,32769166,322,219,32768844,32769166
9288,4,11,1,2412,-84,-90,6,48:dd:0c:90:e3:87,32770087,362,559,32769725,32770087
9289,4,11,1,2412,-84,-90,6,48:dd:0c:90:e3:83,32770461,323,51,32770138,32770461
9290,4,11,1,2412,-82,-90,8,48:dd:0c:90:e3:85,32770796,382,-47,32770414,32770796
9291,4,1,1,2412,-89,-90,1,78:67:0e:c4:a8:42,32782436,2736,8904,32779700,32782436
9292,6,24,1,2412,-86,-90,4,,32791299,28,8835,32791271,32791299
9293,6,6,1,2412,-62,-90,28,32:86:8c:5f:93:1e,32804778,332,13147,32804446,32804778
9294,4,1,1,2412,-68,-90,22,b0:e4:d5:32:ec:8a,32822667,1960,15929,32820707,32822667
9295,6,6,1,2412,-90,-90,0,3c:bd:c5:ee:96:6d,32825642,68,2907,32825574,32825642
9296,4,1,1,2412,-56,-90,34,94:a6:7e:c9:98:67,32829543,2464,1437,32827079,32829543
9297,6,24,1,2412,-88,-90,2,,32835592,28,6021,32835564,32835592
9298,6,24,1,2412,-86,-90,4,4c:01:43:d7:f3:26,32841519,32,5895,32841487,32841519
9299,4,1,1,2412,-82,-90,8,78:67:0e:38:6c:d3,32844783,2736,528,32842047,32844783
9300,4,11,1,2412,-80,-90,10,48:dd:0c:7d:86:27,32847541,362,2396,32847179,32847541
9301,4,11,1,2412,-80,-90,10,48:dd:0c:7d:86:23,32847916,323,52,32847593,32847916
9302,4,11,1,2412,-79,-90,11,48:dd:0c:7d:86:25,32848251,382,-47,32847869,32848251
9303,4,1,1,2412,-89,-90,1,78:67:0e:c4:a8:42,32852358,352,3755,32852006,32852358
9304,6,6,1,2412,-64,-90,26,12:86:8c:5f:93:1e,32853097,332,407,32852765,32853097
9305,6,6,1,2412,-89,-90,1,,32855177,44,2036,32855133,32855177
9306,6,6,1,2412,-89,-90,1,,32855221,44,,32855177,32855221
9307,6,6,1,2412,-87,-90,3,3c:bd:c5:ee:96:6d,32857033,68,1744,32856965,32857033
9308,4,1,1,2412,-90,-90,0,78:67:0e:c4:a8:42,32858189,352,804,32857837,32858189
9309,6,24,1,2412,-84,-90,6,,32871976,28,13759,32871948,32871976
9310,4,11,1,2412,-79,-90,11,48:dd:0c:90:e3:87,32872486,362,148,32872124,32872486
9311,4,11,1,2412,-80,-90,10,48:dd:0c:90:e3:83,32872861,323,52,32872538,32872861
9312,4,11,1,2412,-78,-90,12,48:dd:0c:90:e3:85,32873196,382,-47,32872814,32873196
9313,6,6,1,2412,-63,-90,27,32:86:8c:5f:93:1e,32904119,332,30591,32903787,32904119
9314,4,1,1,2412,-61,-90,29,b0:e4:d5:32:ec:8a,32925066,1960,18987,32923106,32925066
9315,6,6,1,2412,-64,-90,26,10:86:8c:5f:93:1e,32929261,344,3851,32928917,32929261
9316,4,1,1,2412,-62,-90,28,94:a6:7e:c9:98:67,32932050,2464,325,32929586,32932050
9317,4,1,1,2412,-61,-90,29,94:a6:7e:c9:98:67,32934561,1888,623,32932673,32934561
9318,4,1,1,2412,-63,-90,27,94:a6:7e:c9:98:67,32936486,3552,-1627,32932934,32936486
9319,4,1,1,2412,-61,-90,29,94:a6:7e:c9:98:67,32940093,3712,-105,32936381,32940093
9320,4,1,1,2412,-82,-90,8,78:67:0e:38:6c:d3,32951308,3472,7743,32947836,32951308
9321,6,6,1,2412,-64,-90,26,12:86:8c:5f:93:1e,32955008,332,3368,32954676,32955008
9322,4,11,1,2412,-87,-90,3,4c:01:43:db:2d:86,32958635,387,3240,32958248,32958635
9323,4,1,1,2412,-90,-90,0,,32968370,304,9431,32968066,32968370
9324,4,11,1,2412,-87,-90,3,4c:01:43:ec:a0:63,32973755,322,5063,32973433,32973755
9325,4,11,1,2412,-85,-90,5,4c:01:43:ec:a0:66,32974089,387,-53,32973702,32974089
9326,4,11,1,2412,-85,-90,5,48:dd:0c:90:e3:87,32974886,362,435,32974524,32974886
9327,4,11,1,2412,-85,-90,5,48:dd:0c:90:e3:83,32975261,323,52,32974938,32975261
9328,4,11,1,2412,-84,-90,6,48:dd:0c:90:e3:85,32975596,382,-47,32975214,32975596
9329,6,6,1,2412,-63,-90,27,52:86:8c:5f:93:1e,32980461,332,4533,32980129,32980461
9330,6,24,1,2412,-92,-90,-2,,32998418,28,17929,32998390,32998418
9331,6,24,1,2412,-86,-90,4,,33018894,28,20448,33018866,33018894
9332,4,1,1,2412,-58,-90,32,b0:e4:d5:32:ec:8a,33027465,1960,6611,33025505,33027465
9333,6,6,1,2412,-66,-90,24,10:86:8c:5f:93:1e,33031662,344,3853,33031318,33031662
9334,4,1,1,2412,-54,-90,36,94:a6:7e:c9:98:67,33034443,2464,317,33031979,33034443
9335,6,24,1,2412,-88,-90,2,,33037344,28,2873,33037316,33037344
9336,4,1,1,2412,-71,-90,19,78:67:0e:38:6c:d3,33049514,2736,9434,33046778,33049514
9337,4,11,1,2412,-74,-90,16,48:dd:0c:7d:86:27,33052272,362,2396,33051910,33052272
9338,4,11,1,2412,-74,-90,16,48:dd:0c:7d:86:25,33052982,382,328,33052600,33052982
9339,6,6,1,2412,-85,-90,5,40:b0:34:b7:01:d5,33056358,576,2800,33055782,33056358
9340,6,6,1,2412,-69,-90,21,12:86:8c:5f:93:1e,33057262,332,572,33056930,33057262
9341,6,6,1,2412,-88,-90,2,,33058587,44,1281,33058543,33058587
9342,4,1,1,2412,-92,-90,-2,00:26:62:eb:ea:74,33062884,968,3329,33061916,33062884
9343,4,11,1,2412,-85,-90,5,4c:01:43:ec:a0:69,33075780,361,12535,33075419,33075780
9344,4,11,1,2412,-85,-90,5,4c:01:43:ec:a0:63,33076154,322,52,33075832,33076154
9345,4,11,1,2412,-84,-90,6,4c:01:43:ec:a0:66,33076488,387,-53,33076101,33076488
9346,4,11,1,2412,-83,-90,7,48:dd:0c:90:e3:87,33077286,362,436,33076924,33077286
9347,4,11,1,2412,-84,-90,6,48:dd:0c:90:e3:83,33077661,323,52,33077338,33077661
9348,4,11,1,2412,-83,-90,7,48:dd:0c:90:e3:85,33077996,382,-47,33077614,33077996
9349,4,1,1,2412,-93,-90,-3,40:ca:63:2d:74:be,33079045,1896,-847,33077149,33079045
9350,4,1,1,2412,-68,-90,22,10:86:8c:5f:93:1e,33088940,3088,6807,33085852,33088940
9351,4,1,1,2412,-68,-90,22,10:86:8c:5f:93:1e,33095300,3088,3272,33092212,33095300
9352,6,24,1,2412,-87,-90,3,,33098283,28,2955,33098255,33098283
9353,4,1,1,2412,-89,-90,1,78:67:0e:c4:a8:42,33098724,2736,-2295,33095988,33098724
9354,4,1,1,2412,-66,-90,24,10:86:8c:5f:93:1e,33101498,3088,-314,33098410,33101498
9355,6,24,1,2412,-84,-90,6,,33111303,28,9777,33111275,33111303
9356,4,1,1,2412,-87,-90,3,,33122426,304,10819,33122122,33122426
9357,6,24,1,2412,-83,-90,7,,33124115,28,1661,33124087,33124115
9358,4,1,1,2412,-89,-90,1,,33124410,304,-9,33124106,33124410
9359,4,11,1,2412,-77,-90,13,48:dd:0c:7d:86:23,33127910,254,3246,33127656,33127910
9360,4,11,1,2412,-83,-90,7,48:dd:0c:90:e3:83,33128213,254,49,33127959,33128213
9361,6,24,1,2412,-85,-90,5,,33128808,28,567,33128780,33128808
9362,4,1,1,2412,-66,-90,24,b0:e4:d5:32:ec:8a,33129864,1960,-904,33127904,33129864
9363,4,1,1,2412,-60,-90,30,94:a6:7e:c9:98:67,33137099,2464,4771,33134635,33137099
9364,4,1,1,2412,-60,-90,30,94:a6:7e:c9:98:67,33139609,1968,542,33137641,33139609
9365,4,1,1,2412,-61,-90,29,94:a6:7e:c9:98:67,33141623,2128,-114,33139495,33141623
9366,4,1,1,2412,-60,-90,30,94:a6:7e:c9:98:67,33143806,1600,583,33142206,33143806
9367,4,1,1,2412,-61,-90,29,94:a6:7e:c9:98:67,33145444,1760,-122,33143684,33145444
9368,6,6,1,2412,-67,-90,23,b4:e6:2d:b4:ff:71,33147164,64,1656,33147100,33147164
9369,6,6,1,2412,-66,-90,24,,33147244,44,36,33147200,33147244
9370,4,1,1,2412,-84,-90,6,78:67:0e:38:6c:d3,33151914,2736,1934,33149178,33151914
9371,6,24,1,2412,-87,-90,3,,33157032,28,5090,33157004,33157032
9372,6,6,1,2412,-63,-90,27,12:86:8c:5f:93:1e,33159663,332,2299,33159331,33159663
9373,6,24,1,2412,-85,-90,5,4c:01:43:d7:f3:26,33165085,32,5390,33165053,33165085
9374,6,6,1,2412,-91,-90,-1,e2:db:d1:d1:b0:4d,33171553,408,6060,33171145,33171553
9375,7,39,1,2412,-67,-90,23,b4:e6:2d:b4:ff:71,33175537,80,3904,33175457,33175537
9376,7,39,1,2412,-67,-90,23,b4:e6:2d:b4:ff:71,33176026,80,409,33175946,33176026
9377,7,39,1,2412,-67,-90,23,b4:e6:2d:b4:ff:71,33176393,80,287,33176313,33176393
9378,7,26,1,2412,-67,-90,23,b4:e6:2d:b4:ff:71,33177187,100,694,33177087,33177187
9379,4,11,1,2412,-84,-90,6,4c:01:43:ec:a0:69,33178178,361,630,33177817,33178178
9380,4,11,1,2412,-85,-90,5,4c:01:43:ec:a0:63,33178552,322,52,33178230,33178552
9381,4,11,1,2412,-84,-90,6,4c:01:43:ec:a0:66,33178887,387,-52,33178500,33178887
9382,4,11,1,2412,-84,-90,6,48:dd:0c:90:e3:87,33179686,362,437,33179324,33179686
9383,4,11,1,2412,-83,-90,7,48:dd:0c:90:e3:83,33180060,323,51,33179737,33180060
9384,4,11,1,2412,-83,-90,7,48:dd:0c:90:e3:85,33180396,382,-46,33180014,33180396
9385,7,26,1,2412,-67,-90,23,b4:e6:2d:b4:ff:71,33181010,100,514,33180910,33181010
9386,6,24,1,2412,-63,-90,27,10:86:8c:5f:93:1e,33181118,32,76,33181086,33181118
9387,4,1,1,2412,-91,-90,-1,,33189645,304,8223,33189341,33189645
9388,6,24,1,2412,-87,-90,3,,33191306,28,1633,33191278,33191306
9389,4,1,1,2412,-92,-90,-2,78:67:0e:c4:a8:42,33191907,2736,-2135,33189171,33191907
9390,4,1,1,2412,-89,-90,1,,33198086,304,5875,33197782,33198086
9391,4,1,1,2412,-89,-90,1,,33199417,304,1027,33199113,33199417
9392,6,6,1,2412,-63,-90,27,32:86:8c:5f:93:1e,33210863,332,11114,33210531,33210863
9393,6,6,1,2412,-91,-90,-1,,33231734,44,20827,33231690,33231734
9394,4,1,1,2412,-58,-90,32,b0:e4:d5:32:ec:8a,33232264,1960,-1430,33230304,33232264
9395,6,6,1,2412,-92,-90,-2,,33235375,44,3067,33235331,33235375
9396,6,24,1,2412,-87,-90,3,,33248198,28,12795,33248170,33248198
9397,4,1,1,2412,-89,-90,1,,33253305,304,4803,33253001,33253305
9398,6,6,1,2412,-90,-90,0,e2:db:d1:d1:b0:4a,33253554,68,181,33253486,33253554
9399,4,1,1,2412,-89,-90,1,78:67:0e:38:6c:d3,33254314,2736,-1976,33251578,33254314
9400,4,11,1,2412,-78,-90,12,48:dd:0c:7d:86:27,33257073,362,2397,33256711,33257073
9401,4,11,1,2412,-66,-90,24,48:dd:0c:7d:86:23,33257447,323,51,33257124,33257447
9402,4,11,1,2412,-78,-90,12,48:dd:0c:7d:86:25,33257782,382,-47,33257400,33257782
9403,6,6,1,2412,-86,-90,4,4c:01:43:d7:f3:26,33258179,52,345,33258127,33258179
9404,6,6,1,2412,-87,-90,3,,33260112,44,1889,33260068,33260112
9405,6,6,1,2412,-65,-90,25,12:86:8c:5f:93:1e,33262063,332,1619,33261731,33262063
9406,6,6,1,2412,-86,-90,4,40:b0:34:b7:01:d5,33262420,576,-219,33261844,33262420
9407,6,24,1,2412,-84,-90,6,,33263938,28,1490,33263910,33263938
9408,6,24,1,2412,-85,-90,5,,33264165,28,199,33264137,33264165
9409,6,6,1,2412,-60,-90,30,,33265154,44,945,33265110,33265154
9410,6,6,1,2412,-90,-90,0,,33268887,44,3689,33268843,33268887
9411,6,24,1,2412,-84,-90,6,,33272115,28,3200,33272087,33272115
9412,4,11,1,2412,-84,-90,6,,33273174,107,952,33273067,33273174
9413,4,1,1,2412,-89,-90,1,,33273401,304,-77,33273097,33273401
9414,6,6,1,2412,-91,-90,-1,e2:db:d1:d1:b0:4a,33273558,444,-287,33273114,33273558
9415,6,6,1,2412,-89,-90,1,e2:db:d1:d1:b0:4b,33274133,408,167,33273725,33274133
9416,6,6,1,2412,-90,-90,0,e2:db:d1:d1:b0:4d,33274573,408,32,33274165,33274573
9417,6,6,1,2412,-89,-90,1,e2:db:d1:d1:b0:4a,33276827,548,1706,33276279,33276827
9418,6,6,1,2412,-90,-90,0,e2:db:d1:d1:b0:4a,33277408,576,5,33276832,33277408
9419,4,1,1,2412,-89,-90,1,,33278966,304,1254,33278662,33278966
9420,6,6,1,2412,-91,-90,-1,e2:db:d1:d1:b0:4a,33279211,68,177,33279143,33279211
9421,4,1,1,2412,-86,-90,4,78:67:0e:c4:a8:42,33279481,352,-82,33279129,33279481
9422,4,11,1,2412,-82,-90,8,4c:01:43:ec:a0:69,33280577,361,735,33280216,33280577
9423,4,11,1,2412,-84,-90,6,4c:01:43:ec:a0:63,33280951,322,52,33280629,33280951
9424,4,11,1,2412,-83,-90,7,4c:01:43:ec:a0:66,33281286,387,-52,33280899,33281286
9425,4,11,1,2412,-83,-90,7,48:dd:0c:90:e3:87,33282085,362,437,33281723,33282085
9426,4,11,1,2412,-84,-90,6,48:dd:0c:90:e3:83,33282460,323,52,33282137,33282460
9427,4,1,1,2412,-86,-90,4,,33289785,304,7021,33289481,33289785
9428,6,6,1,2412,-91,-90,-1,,33291095,44,1266,33291051,33291095
9429,4,1,1,2412,-90,-90,0,,33292057,304,658,33291753,33292057
9430,4,1,1,2412,-86,-90,4,78:67:0e:c4:a8:42,33294307,2736,-486,33291571,33294307
9431,6,24,1,2412,-84,-90,6,,33303176,28,8841,33303148,33303176
9432,4,1,1,2412,-89,-90,1,,33304889,304,1409,33304585,33304889
9433,6,6,1,2412,-66,-90,24,32:86:8c:5f:93:1e,33313263,332,8042,33312931,33313263
9434,4,1,1,2412,-89,-90,1,,33326329,304,12762,33326025,33326329
9435,4,1,1,2412,-89,-90,1,,33331357,304,4724,33331053,33331357
9436,4,1,1,2412,-90,-90,0,,33333593,304,1932,33333289,33333593
9437,4,1,1,2412,-66,-90,24,b0:e4:d5:32:ec:8a,33334663,1960,-890,33332703,33334663
9438,4,1,1,2412,-88,-90,2,,33339801,304,4834,33339497,33339801
9439,4,1,1,2412,-87,-90,3,,33340889,304,784,33340585,33340889
9440,6,6,1,2412,-66,-90,24,10:86:8c:5f:93:1e,33341172,344,-61,33340828,33341172
9441,4,1,1,2412,-57,-90,33,94:a6:7e:c9:98:67,33341916,2464,-1720,33339452,33341916
9442,6,6,1,2412,-63,-90,27,,33344349,44,2389,33344305,33344349
9443,4,11,1,2412,-89,-90,1,4c:01:43:d7:f3:26,33345661,387,925,33345274,33345661
9444,4,1,1,2412,-65,-90,25,,33349286,304,3321,33348982,33349286
9445,7,52,1,2412,-63,-90,27,10:86:8c:5f:93:1e,33349437,68,83,33349369,33349437
9446,4,1,1,2412,-63,-90,27,,33349770,304,29,33349466,33349770
9447,7,52,1,2412,-62,-90,28,10:86:8c:5f:93:1e,33349921,68,83,33349853,33349921
9448,4,1,1,2412,-63,-90,27,,33350254,304,29,33349950,33350254
9449,7,39,1,2412,-63,-90,27,10:86:8c:5f:93:1e,33350405,80,71,33350325,33350405
9450,6,24,1,2412,-85,-90,5,,33351311,28,878,33351283,33351311
9451,6,24,1,2412,-85,-90,5,,33352642,28,1303,33352614,33352642
9452,6,24,1,2412,-62,-90,28,10:86:8c:5f:93:1e,33353184,32,510,33353152,33353184
9453,6,6,1,2412,-88,-90,2,3c:bd:c5:ee:96:6d,33355444,68,2192,33355376,33355444
9454,4,11,1,2412,-73,-90,17,48:dd:0c:7d:86:27,33359474,362,3668,33359112,33359474
9455,4,1,1,2412,-87,-90,3,,33360524,304,746,33360220,33360524
9456,4,1,1,2412,-89,-90,1,,33363935,304,3107,33363631,33363935
9457,6,6,1,2412,-63,-90,27,12:86:8c:5f:93:1e,33364491,332,224,33364159,33364491
9458,4,1,1,2412,-88,-90,2,,33367021,304,2226,33366717,33367021
9459,6,6,1,2412,-87,-90,3,,33371243,44,4178,33371199,33371243
9460,4,1,1,2412,-87,-90,3,,33371587,304,40,33371283,33371587
9461,4,1,1,2412,-86,-90,4,,33373563,304,1672,33373259,33373563
9462,4,11,1,2412,-83,-90,7,4c:01:43:ec:a0:66,33383684,387,9734,33383297,33383684
9463,4,11,1,2412,-84,-90,6,48:dd:0c:90:e3:85,33385195,382,1129,33384813,33385195
9464,6,6,1,2412,-65,-90,25,52:86:8c:5f:93:1e,33390135,332,4608,33389803,33390135
9465,4,1,1,2412,-82,-90,8,3c:bd:c5:ee:96:6d,33391049,2512,-1598,33388537,33391049
9466,4,1,1,2412,-86,-90,4,78:67:0e:c4:a8:42,33396707,2736,2922,33393971,33396707
9467,4,1,1,2412,-88,-90,2,,33401677,304,4666,33401373,33401677
9468,6,6,1,2412,-67,-90,23,32:86:8c:5f:93:1e,33415664,332,13655,33415332,33415664
9469,4,1,1,2412,-88,-90,2,,33430618,304,14650,33430314,33430618
9470,6,24,1,2412,-82,-90,8,,33431313,28,667,33431285,33431313
9471,6,6,1,2412,-67,-90,23,b4:e6:2d:b4:ff:71,33434312,64,2935,33434248,33434312
9472,6,6,1,2412,-67,-90,23,,33434392,44,36,33434348,33434392
9473,4,1,1,2412,-65,-90,25,b0:e4:d5:32:ec:8a,33437090,1960,738,33435130,33437090
9474,6,6,1,2412,-68,-90,22,10:86:8c:5f:93:1e,33441265,344,3831,33440921,33441265
9475,4,1,1,2412,-87,-90,3,,33442173,304,604,33441869,33442173
9476,4,1,1,2412,-61,-90,29,94:a6:7e:c9:98:67,33444085,2464,-552,33441621,33444085
9477,4,11,1,2412,-68,-90,22,4c:01:43:d7:f3:29,33447351,362,2904,33446989,33447351
9478,4,11,1,2412,-67,-90,23,4c:01:43:d7:f3:23,33447726,322,53,33447404,33447726
9479,4,11,1,2412,-67,-90,23,4c:01:43:d7:f3:26,33448060,387,-53,33447673,33448060
9480,4,1,1,2412,-88,-90,2,,33453902,304,5538,33453598,33453902
9481,4,11,1,2412,-82,-90,8,48:dd:0c:7d:86:23,33463668,254,9512,33463414,33463668
9482,6,24,1,2412,-82,-90,8,,33470965,28,7269,33470937,33470965
9483,4,11,1,2412,-82,-90,8,4c:01:43:ec:a0:63,33485749,322,14462,33485427,33485749
9484,4,11,1,2412,-83,-90,7,4c:01:43:ec:a0:66,33486083,387,-53,33485696,33486083
9485,6,6,1,2412,-67,-90,23,52:86:8c:5f:93:1e,33492465,332,6050,33492133,33492465
9486,4,1,1,2412,-82,-90,8,3c:bd:c5:ee:96:6d,33493815,2512,-1162,33491303,33493815
9487,4,1,1,2412,-83,-90,7,3c:bd:c5:ee:96:6d,33503987,3280,6892,33500707,33503987
9488,4,1,1,2412,-82,-90,8,3c:bd:c5:ee:96:6d,33507626,3280,359,33504346,33507626
9489,4,1,1,2412,-63,-90,27,b0:e4:d5:32:ec:8a,33512419,1912,2881,33510507,33512419
9490,4,1,1,2412,-62,-90,28,b0:e4:d5:32:ec:8a,33514872,1912,541,33512960,33514872
9491,4,1,1,2412,-63,-90,27,b0:e4:d5:32:ec:8a,33516902,1912,118,33514990,33516902
9492,6,6,1,2412,-63,-90,27,32:86:8c:5f:93:1e,33518984,332,1750,33518652,33518984
9493,6,24,1,2412,-85,-90,5,,33523883,28,4871,33523855,33523883
9494,4,1,1,2412,-62,-90,28,b0:e4:d5:32:ec:8a,33539461,1960,13618,33537501,33539461
9495,4,1,1,2412,-52,-90,38,94:a6:7e:c9:98:67,33546461,2464,4536,33543997,33546461
9496,4,1,1,2412,-88,-90,2,,33548933,304,2168,33548629,33548933
9497,4,1,1,2412,-89,-90,1,78:67:0e:38:6c:d3,33561515,2736,9846,33558779,33561515
9498,4,11,1,2412,-80,-90,10,48:dd:0c:7d:86:27,33564273,362,2396,33563911,33564273
9499,4,11,1,2412,-80,-90,10,48:dd:0c:7d:86:23,33564648,323,52,33564325,33564648
9500,4,11,1,2412,-79,-90,11,48:dd:0c:7d:86:25,33564983,382,-47,33564601,33564983
9501,6,6,1,2412,-90,-90,0,40:b0:34:b7:01:d5,33568435,576,2876,33567859,33568435
9502,4,1,1,2412,-91,-90,-1,,33569093,304,354,33568789,33569093
9503,6,6,1,2412,-62,-90,28,12:86:8c:5f:93:1e,33569265,332,-160,33568933,33569265
9504,4,1,1,2412,-90,-90,0,,33582410,304,12841,33582106,33582410
9505,4,11,1,2412,-82,-90,8,4c:01:43:ec:a0:69,33587774,361,5003,33587413,33587774
9506,4,11,1,2412,-83,-90,7,4c:01:43:ec:a0:63,33588148,322,52,33587826,33588148
9507,4,11,1,2412,-83,-90,7,4c:01:43:ec:a0:66,33588482,387,-53,33588095,33588482
9508,4,11,1,2412,-73,-90,17,48:dd:0c:90:e3:83,33589659,323,854,33589336,33589659
9509,4,1,1,2412,-88,-90,2,,33592792,304,2829,33592488,33592792
9510,6,6,1,2412,-61,-90,29,52:86:8c:5f:93:1e,33595547,332,2423,33595215,33595547
9511,4,1,1,2412,-88,-90,2,3c:bd:c5:ee:96:6d,33598030,2512,-29,33595518,33598030
9512,4,1,1,2412,-89,-90,1,,33612886,304,14552,33612582,33612886
9513,6,6,1,2412,-61,-90,29,32:86:8c:5f:93:1e,33620466,332,7248,33620134,33620466
9514,4,1,1,2412,-89,-90,1,,33625867,304,5097,33625563,33625867
9515,4,11,1,2412,-86,-90,4,4c:01:43:d7:f3:23,33635744,254,9623,33635490,33635744
9516,4,11,1,2412,-82,-90,8,4c:01:43:ec:a0:63,33636720,254,722,33636466,33636720
9517,6,6,1,2412,-84,-90,6,,33638080,44,1316,33638036,33638080
9518,4,1,1,2412,-89,-90,1,,33638866,304,482,33638562,33638866
9519,6,6,1,2412,-84,-90,6,,33639040,44,130,33638996,33639040
9520,6,6,1,2412,-84,-90,6,,33640445,44,1361,33640401,33640445
9521,4,1,1,2412,-66,-90,24,b0:e4:d5:32:ec:8a,33642973,1960,568,33641013,33642973
9522,6,6,1,2412,-60,-90,30,10:86:8c:5f:93:1e,33646066,344,2749,33645722,33646066
9523,4,1,1,2412,-56,-90,34,94:a6:7e:c9:98:67,33649953,2464,1423,33647489,33649953
9524,4,11,1,2412,-86,-90,4,4c:01:43:d7:f3:23,33652525,322,2250,33652203,33652525
9525,4,11,1,2412,-86,-90,4,4c:01:43:d7:f3:26,33652860,387,-52,33652473,33652860
9526,4,11,1,2412,-83,-90,7,4c:01:43:ec:a0:63,33653636,284,492,33653352,33653636
9527,6,6,1,2412,-60,-90,30,12:86:8c:5f:93:1e,33671666,332,17698,33671334,33671666
9528,4,1,1,2412,-91,-90,-1,,33686765,304,14795,33686461,33686765
9529,4,11,1,2412,-81,-90,9,4c:01:43:ec:a0:69,33690173,361,3047,33689812,33690173
9530,4,11,1,2412,-84,-90,6,4c:01:43:ec:a0:63,33690547,322,52,33690225,33690547
9531,4,11,1,2412,-86,-90,4,48:dd:0c:90:e3:87,33691684,362,775,33691322,33691684
9532,4,11,1,2412,-84,-90,6,48:dd:0c:90:e3:83,33692059,323,52,33691736,33692059
9533,4,11,1,2412,-85,-90,5,48:dd:0c:90:e3:85,33692394,382,-47,33692012,33692394
9534,6,6,1,2412,-60,-90,30,52:86:8c:5f:93:1e,33697334,332,4608,33697002,33697334
9535,4,1,1,2412,-83,-90,7,3c:bd:c5:ee:96:6d,33701093,976,2783,33700117,33701093
9536,6,6,1,2412,-86,-90,4,,33707124,44,5987,33707080,33707124
9537,6,6,1,2412,-85,-90,5,3c:bd:c5:ee:96:6d,33710024,68,2832,33709956,33710024
9538,4,1,1,2412,-80,-90,10,3c:bd:c5:ee:96:6d,33714976,432,4520,33714544,33714976
9539,6,6,1,2412,-87,-90,3,,33718595,44,3575,33718551,33718595
9540,6,6,1,2412,-60,-90,30,32:86:8c:5f:93:1e,33722867,332,3940,33722535,33722867
9541,4,1,1,2412,-89,-90,1,,33731684,304,8513,33731380,33731684
9542,4,1,1,2412,-82,-90,8,,33732635,304,647,33732331,33732635
9543,6,6,1,2412,-86,-90,4,3c:bd:c5:ee:96:6d,33733884,68,1181,33733816,33733884
9544,4,1,1,2412,-88,-90,2,78:67:0e:c4:a8:42,33736870,352,2634,33736518,33736870
9545,4,1,1,2412,-90,-90,0,78:67:0e:c4:a8:42,33737741,3472,-2601,33734269,33737741
9546,6,6,1,2412,-85,-90,5,,33750726,44,12941,33750682,33750726
9547,4,1,1,2412,-55,-90,35,94:a6:7e:c9:98:67,33751258,2464,-1932,33748794,33751258
9548,4,1,1,2412,-87,-90,3,,33764076,304,12514,33763772,33764076
9549,6,24,1,2412,-86,-90,4,,33764624,28,520,33764596,33764624
9550,6,6,1,2412,-85,-90,5,,33765201,44,533,33765157,33765201
9551,4,11,1,2412,-81,-90,9,48:dd:0c:7d:86:23,33769307,323,3783,33768984,33769307
9552,4,11,1,2412,-81,-90,9,48:dd:0c:7d:86:25,33769643,382,-46,33769261,33769643
9553,6,6,1,2412,-61,-90,29,12:86:8c:5f:93:1e,33774067,332,4092,33773735,33774067
9554,4,11,1,2412,-86,-90,4,4c:01:43:d7:f3:23,33779831,254,5510,33779577,33779831
9555,4,1,1,2412,-85,-90,5,,33788928,304,8793,33788624,33788928
9556,4,11,1,2412,-83,-90,7,4c:01:43:ec:a0:63,33795470,284,6258,33795186,33795470
9557,6,6,1,2412,-61,-90,29,52:86:8c:5f:93:1e,33799734,332,3932,33799402,33799734
9558,4,1,1,2412,-86,-90,4,3c:bd:c5:ee:96:6d,33801678,2512,-568,33799166,33801678
9559,6,6,1,2412,-90,-90,0,e2:db:d1:d1:b0:4a,33804594,68,2848,33804526,33804594
9560,4,1,1,2412,-86,-90,4,,33817317,304,12419,33817013,33817317
9561,4,1,1,2412,-87,-90,3,,33828335,304,10714,33828031,33828335
9562,4,1,1,2412,-86,-90,4,,33839571,304,10932,33839267,33839571
9563,4,1,1,2412,-58,-90,32,b0:e4:d5:32:ec:8a,33848253,1960,6722,33846293,33848253
9564,6,6,1,2412,-62,-90,28,10:86:8c:5f:93:1e,33850867,344,2270,33850523,33850867
9565,4,1,1,2412,-85,-90,5,,33851588,304,417,33851284,33851588
9566,4,1,1,2412,-56,-90,34,94:a6:7e:c9:98:67,33853609,2464,-443,33851145,33853609
9567,4,1,1,2412,-86,-90,4,,33862678,304,8765,33862374,33862678
9568,4,1,1,2412,-89,-90,1,,33873622,304,10640,33873318,33873622
9569,6,6,1,2412,-61,-90,29,12:86:8c:5f:93:1e,33876468,332,2514,33876136,33876468
9570,4,1,1,2412,-87,-90,3,,33884650,304,7878,33884346,33884650
9571,6,6,1,2412,-83,-90,7,28:f0:76:29:a4:fe,33886478,52,1776,33886426,33886478
9572,6,6,1,2412,-83,-90,7,28:f0:76:29:a4:fe,33887410,136,796,33887274,33887410
9573,4,1,1,2412,-86,-90,4,,33893975,304,6261,33893671,33893975
9574,6,6,1,2412,-88,-90,2,e2:db:d1:d1:b0:4a,33894280,68,237,33894212,33894280
9575,4,11,1,2412,-84,-90,6,4c:01:43:ec:a0:66,33895679,387,1012,33895292,33895679
9576,4,1,1,2412,-91,-90,-1,78:67:0e:c4:a8:42,33904677,352,8646,33904325,33904677
9577,4,1,1,2412,-87,-90,3,,33917935,304,12954,33917631,33917935
9578,4,1,1,2412,-87,-90,3,,33922037,304,3798,33921733,33922037
9579,6,6,1,2412,-86,-90,4,,33932443,44,10362,33932399,33932443
9580,4,1,1,2412,-86,-90,4,,33932776,304,29,33932472,33932776
9581,4,1,1,2412,-86,-90,4,,33937575,304,4495,33937271,33937575
9582,4,1,1,2412,-88,-90,2,,33944402,304,6523,33944098,33944402
9583,4,1,1,2412,-59,-90,31,b0:e4:d5:32:ec:8a,33950598,1960,4236,33948638,33950598
9584,6,6,1,2412,-61,-90,29,10:86:8c:5f:93:1e,33953268,344,2326,33952924,33953268
9585,4,1,1,2412,-55,-90,35,94:a6:7e:c9:98:67,33956048,2464,316,33953584,33956048
9586,4,1,1,2412,-56,-90,34,94:a6:7e:c9:98:67,33958541,3552,-1059,33954989,33958541
9587,4,1,1,2412,-55,-90,35,94:a6:7e:c9:98:67,33962130,3712,-123,33958418,33962130
9588,6,6,1,2412,-66,-90,24,b4:e6:2d:b4:ff:71,33965767,64,3573,33965703,33965767
9589,6,6,1,2412,-63,-90,27,,33965847,44,36,33965803,33965847
9590,4,1,1,2412,-64,-90,26,,33967248,304,1097,33966944,33967248
9591,7,52,1,2412,-60,-90,30,10:86:8c:5f:93:1e,33967399,68,83,33967331,33967399
9592,4,1,1,2412,-60,-90,30,,33967741,304,38,33967437,33967741
9593,7,52,1,2412,-60,-90,30,10:86:8c:5f:93:1e,33967892,68,83,33967824,33967892
9594,4,1,1,2412,-65,-90,25,,33968225,304,29,33967921,33968225
9595,7,39,1,2412,-61,-90,29,10:86:8c:5f:93:1e,33968376,80,71,33968296,33968376
9596,4,1,1,2412,-60,-90,30,,33969392,304,712,33969088,33969392
9597,7,39,1,2412,-61,-90,29,10:86:8c:5f:93:1e,33969543,80,71,33969463,33969543
9598,6,24,1,2412,-66,-90,24,,33969639,28,68,33969611,33969639
9599,4,11,1,2412,-84,-90,6,48:dd:0c:7d:86:23,33971750,323,1788,33971427,33971750
9600,7,26,1,2412,-66,-90,24,b4:e6:2d:b4:ff:71,33976280,68,4462,33976212,33976280
9601,7,26,1,2412,-66,-90,24,b4:e6:2d:b4:ff:71,33976717,68,369,33976649,33976717
9602,6,24,1,2412,-63,-90,27,10:86:8c:5f:93:1e,33976793,32,44,33976761,33976793
9603,4,1,1,2412,-84,-90,6,,33977535,304,438,33977231,33977535
9604,4,1,1,2412,-86,-90,4,,33978717,304,878,33978413,33978717
9605,6,6,1,2412,-61,-90,29,12:86:8c:5f:93:1e,33978877,332,-172,33978545,33978877
9606,4,1,1,2412,-89,-90,1,,33983283,304,4102,33982979,33983283
9607,4,11,1,2412,-86,-90,4,48:dd:0c:90:e3:87,33998884,362,15239,33998522,33998884
9608,4,11,1,2412,-85,-90,5,48:dd:0c:90:e3:83,33999258,323,51,33998935,33999258
9609,6,24,1,2412,-86,-90,4,,34003898,28,4612,34003870,34003898
9610,6,6,1,2412,-64,-90,26,52:86:8c:5f:93:1e,34004602,332,372,34004270,34004602
9611,6,24,1,2412,-81,-91,10,,34018976,28,14346,34018948,34018976
9612,4,1,1,2412,-91,-91,0,38:01:46:30:1a:ca,34030069,640,10453,34029429,34030069
9613,6,6,1,2412,-64,-91,27,32:86:8c:5f:93:1e,34030888,332,487,34030556,34030888
9614,4,1,1,2412,-92,-91,-1,38:01:46:30:1a:ca,34033465,640,1937,34032825,34033465
9615,6,24,1,2412,-85,-91,6,,34034284,28,791,34034256,34034284
9616,4,1,1,2412,-93,-91,-2,38:01:46:30:1a:ca,34034484,640,-440,34033844,34034484
9617,4,1,1,2412,-91,-91,0,,34038773,304,3985,34038469,34038773
9618,4,1,1,2412,-86,-91,5,38:01:46:30:1a:ca,34048851,416,9662,34048435,34048851
9619,4,1,1,2412,-90,-91,1,,34049424,304,269,34049120,34049424
9620,4,1,1,2412,-60,-91,31,b0:e4:d5:32:ec:8a,34053497,1960,2113,34051537,34053497
9621,6,6,1,2412,-62,-91,29,10:86:8c:5f:93:1e,34058167,344,4326,34057823,34058167
9622,4,1,1,2412,-56,-91,35,94:a6:7e:c9:98:67,34058729,2464,-1902,34056265,34058729
9623,4,11,1,2412,-89,-91,2,4c:01:43:d7:f3:29,34061749,362,2658,34061387,34061749
9624,6,6,1,2412,-62,-91,29,b4:e6:2d:b4:ff:71,34062725,64,912,34062661,34062725
9625,6,6,1,2412,-65,-91,26,,34062805,44,36,34062761,34062805
9626,6,24,1,2412,-85,-91,6,,34070988,28,8155,34070960,34070988
9627,6,6,1,2412,-64,-91,27,12:86:8c:5f:93:1e,34081269,332,9949,34080937,34081269
9628,4,1,1,2412,-91,-91,0,,34095520,304,13947,34095216,34095520
9629,4,11,1,2412,-83,-91,8,4c:01:43:ec:a0:69,34099768,361,3887,34099407,34099768
9630,4,11,1,2412,-80,-91,11,4c:01:43:ec:a0:63,34100142,322,52,34099820,34100142
9631,4,11,1,2412,-82,-91,9,4c:01:43:ec:a0:66,34100476,387,-53,34100089,34100476
9632,4,11,1,2412,-87,-91,4,48:dd:0c:90:e3:87,34101283,362,445,34100921,34101283
9633,6,6,1,2412,-63,-91,28,52:86:8c:5f:93:1e,34107034,332,5419,34106702,34107034
9634,4,1,1,2412,-89,-91,2,78:67:0e:c4:a8:42,34116280,848,8398,34115432,34116280
9635,4,1,1,2412,-89,-91,2,,34123277,304,6693,34122973,34123277
9636,6,6,1,2412,-63,-91,28,32:86:8c:5f:93:1e,34132469,332,8860,34132137,34132469
9637,4,1,1,2412,-91,-91,0,,34136231,304,3458,34135927,34136231
9638,4,1,1,2412,-91,-91,0,,34146729,304,10194,34146425,34146729
9639,4,1,1,2412,-90,-91,1,,34147888,304,855,34147584,34147888
9640,4,1,1,2412,-58,-91,33,b0:e4:d5:32:ec:8a,34155498,1960,5650,34153538,34155498
9641,6,6,1,2412,-62,-91,29,10:86:8c:5f:93:1e,34158228,344,2386,34157884,34158228
9642,4,1,1,2412,-90,-91,1,,34159149,304,617,34158845,34159149
9643,4,1,1,2412,-59,-91,32,94:a6:7e:c9:98:67,34161044,2464,-569,34158580,34161044
9644,4,1,1,2412,-91,-91,0,,34186395,304,25047,34186091,34186395
9645,6,6,1,2412,-62,-91,29,12:86:8c:5f:93:1e,34186647,332,-80,34186315,34186647
9646,4,1,1,2412,-92,-91,-1,,34187858,304,907,34187554,34187858
9647,6,6,1,2412,-90,-91,1,3c:bd:c5:ee:96:6d,34188176,68,250,34188108,34188176
9648,4,1,1,2412,-89,-91,2,,34212079,304,23599,34211775,34212079
9649,4,1,1,2412,-91,-91,0,,34224240,304,11857,34223936,34224240
9650,6,6,1,2412,-62,-91,29,32:86:8c:5f:93:1e,34234870,332,10298,34234538,34234870
9651,4,1,1,2412,-90,-91,1,,34235769,304,595,34235465,34235769
9652,4,1,1,2412,-89,-91,2,,34246872,304,10799,34246568,34246872
9653,4,1,1,2412,-90,-91,1,,34247946,304,770,34247642,34247946
9654,6,6,1,2412,-89,-91,2,,34248690,44,700,34248646,34248690
9655,4,1,1,2412,-90,-91,1,,34249044,304,50,34248740,34249044
9656,4,1,1,2412,-89,-91,2,,34250046,304,698,34249742,34250046
9657,4,1,1,2412,-86,-91,5,,34251075,304,725,34250771,34251075
9658,4,1,1,2412,-57,-91,34,b0:e4:d5:32:ec:8a,34258216,1960,5181,34256256,34258216
9659,4,1,1,2412,-88,-91,3,,34261868,304,3348,34261564,34261868
9660,4,1,1,2412,-61,-91,30,94:a6:7e:c9:98:67,34263451,2464,-881,34260987,34263451
9661,4,1,1,2412,-90,-91,1,,34272964,304,9209,34272660,34272964
9662,6,6,1,2412,-93,-91,-2,e2:db:d1:d1:b0:4a,34273545,68,513,34273477,34273545
9663,4,1,1,2412,-88,-91,3,78:67:0e:38:6c:d3,34278316,2736,2035,34275580,34278316
9664,4,11,1,2412,-80,-91,11,48:dd:0c:7d:86:27,34281075,362,2397,34280713,34281075
9665,4,11,1,2412,-80,-91,11,48:dd:0c:7d:86:23,34281449,323,51,34281126,34281449
9666,4,11,1,2412,-79,-91,12,48:dd:0c:7d:86:25,34281785,382,-46,34281403,34281785
9667,4,1,1,2412,-86,-91,5,,34284600,304,2511,34284296,34284600
9668,6,6,1,2412,-63,-91,28,12:86:8c:5f:93:1e,34286070,332,1138,34285738,34286070
9669,6,6,1,2412,-60,-91,31,b4:e6:2d:b4:ff:71,34288381,64,2247,34288317,34288381
9670,6,6,1,2412,-61,-91,30,b4:e6:2d:b4:ff:71,34288696,64,251,34288632,34288696
9671,6,6,1,2412,-63,-91,28,,34288776,44,36,34288732,34288776
9672,6,24,1,2412,-85,-91,6,,34291964,28,3160,34291936,34291964
9673,7,26,1,2412,-61,-91,30,b4:e6:2d:b4:ff:71,34293403,100,1339,34293303,34293403
9674,7,26,1,2412,-61,-91,30,b4:e6:2d:b4:ff:71,34293799,100,296,34293699,34293799
9675,7,26,1,2412,-61,-91,30,b4:e6:2d:b4:ff:71,34294276,100,377,34294176,34294276
9676,6,24,1,2412,-63,-91,28,10:86:8c:5f:93:1e,34294384,32,76,34294352,34294384
9677,4,1,1,2412,-88,-91,3,,34300078,304,5390,34299774,34300078
9678,4,11,1,2412,-79,-91,12,4c:01:43:ec:a0:69,34304566,361,4127,34304205,34304566
9679,4,11,1,2412,-80,-91,11,4c:01:43:ec:a0:66,34305274,387,321,34304887,34305274
9680,4,1,1,2412,-88,-91,3,,34311335,304,5757,34311031,34311335
9681,6,6,1,2412,-63,-91,28,52:86:8c:5f:93:1e,34311671,332,4,34311339,34311671
9682,4,1,1,2412,-86,-91,5,3c:bd:c5:ee:96:6d,34312530,2512,-1653,34310018,34312530
9683,4,1,1,2412,-85,-91,6,,34325904,304,13070,34325600,34325904
9684,4,1,1,2412,-67,-91,24,,34335854,304,9646,34335550,34335854
9685,7,39,1,2412,-64,-91,27,10:86:8c:5f:93:1e,34336005,60,91,34335945,34336005
9686,6,24,1,2412,-62,-91,29,,34336081,28,48,34336053,34336081
9687,4,1,1,2412,-63,-91,28,,34336445,304,60,34336141,34336445
9688,7,52,1,2412,-64,-91,27,10:86:8c:5f:93:1e,34336596,68,83,34336528,34336596
9689,4,1,1,2412,-63,-91,28,,34336920,304,20,34336616,34336920
9690,7,39,1,2412,-64,-91,27,10:86:8c:5f:93:1e,34337071,80,71,34336991,34337071
9691,6,24,1,2412,-62,-91,29,,34337166,28,67,34337138,34337166
9692,6,6,1,2412,-65,-91,26,32:86:8c:5f:93:1e,34337271,332,-227,34336939,34337271
9693,4,1,1,2412,-92,-91,-1,,34337809,304,234,34337505,34337809
9694,4,1,1,2412,-88,-91,3,,34349231,304,11118,34348927,34349231
9695,4,1,1,2412,-60,-91,31,b0:e4:d5:32:ec:8a,34361151,1960,9960,34359191,34361151
9696,6,6,1,2412,-64,-91,27,10:86:8c:5f:93:1e,34362966,344,1471,34362622,34362966
9697,4,1,1,2412,-60,-91,31,94:a6:7e:c9:98:67,34366161,2464,731,34363697,34366161
9698,7,26,1,2412,-62,-91,29,b4:e6:2d:b4:ff:71,34368506,108,2237,34368398,34368506
9699,6,24,1,2412,-64,-91,27,10:86:8c:5f:93:1e,34368623,32,85,34368591,34368623
9700,4,11,1,2412,-86,-91,5,4c:01:43:d7:f3:29,34368947,362,-38,34368585,34368947
9701,4,11,1,2412,-88,-91,3,4c:01:43:d7:f3:23,34369322,322,53,34369000,34369322
9702,4,1,1,2412,-85,-91,6,,34374197,304,4571,34373893,34374197
9703,6,6,1,2412,-85,-91,6,,34383413,44,9172,34383369,34383413
9704,4,1,1,2412,-84,-91,7,,34387032,304,3315,34386728,34387032
9705,6,6,1,2412,-65,-91,26,12:86:8c:5f:93:1e,34388471,332,1107,34388139,34388471
9706,4,1,1,2412,-85,-91,6,,34390496,304,1721,34390192,34390496
9707,4,11,1,2412,-81,-91,10,4c:01:43:ec:a0:69,34406986,361,16129,34406625,34406986
9708,4,11,1,2412,-82,-91,9,4c:01:43:ec:a0:63,34407359,322,51,34407037,34407359
9709,4,11,1,2412,-82,-91,9,4c:01:43:ec:a0:66,34407694,387,-52,34407307,34407694
9710,4,11,1,2412,-88,-91,3,48:dd:0c:90:e3:87,34408483,362,427,34408121,34408483
9711,4,11,1,2412,-85,-91,6,48:dd:0c:90:e3:83,34408857,323,51,34408534,34408857
9712,4,11,1,2412,-88,-91,3,48:dd:0c:90:e3:85,34409192,382,-47,34408810,34409192
9713,4,1,1,2412,-87,-91,4,,34427521,304,18025,34427217,34427521
9714,6,24,1,2412,-84,-91,7,,34434432,28,6883,34434404,34434432
9715,4,1,1,2412,-84,-91,7,,34438045,304,3309,34437741,34438045
9716,6,6,1,2412,-67,-91,24,32:86:8c:5f:93:1e,34439671,332,1294,34439339,34439671
9717,6,6,1,2412,-84,-91,7,3c:bd:c5:ee:96:6d,34440386,52,663,34440334,34440386
9718,6,6,1,2412,-84,-91,7,3c:bd:c5:ee:96:6d,34440552,52,114,34440500,34440552
9719,6,6,1,2412,-84,-91,7,3c:bd:c5:ee:96:6d,34441054,52,450,34441002,34441054
9720,6,6,1,2412,-84,-91,7,3c:bd:c5:ee:96:6d,34441526,52,420,34441474,34441526
9721,6,6,1,2412,-85,-91,6,3c:bd:c5:ee:96:6d,34442102,52,524,34442050,34442102
9722,6,6,1,2412,-84,-91,7,3c:bd:c5:ee:96:6d,34442304,52,150,34442252,34442304
9723,6,6,1,2412,-84,-91,7,3c:bd:c5:ee:96:6d,34443670,52,1314,34443618,34443670
9724,6,6,1,2412,-86,-91,5,3c:bd:c5:ee:96:6d,34444089,68,351,34444021,34444089
9725,6,6,1,2412,-83,-91,8,3c:bd:c5:ee:96:6d,34449681,52,5540,34449629,34449681
9726,6,6,1,2412,-70,-91,21,b4:e6:2d:b4:ff:71,34450142,64,397,34450078,34450142
9727,6,6,1,2412,-66,-91,25,,34450222,44,36,34450178,34450222
9728,6,6,1,2412,-85,-91,6,3c:bd:c5:ee:96:6d,34450745,52,471,34450693,34450745
9729,6,6,1,2412,-85,-91,6,,34451182,44,393,34451138,34451182
9730,4,1,1,2412,-85,-91,6,,34451593,304,107,34451289,34451593
9731,4,1,1,2412,-66,-91,25,b0:e4:d5:32:ec:8a,34462814,1960,9261,34460854,34462814
9732,4,1,1,2412,-56,-91,35,94:a6:7e:c9:98:67,34468003,2464,2725,34465539,34468003
9733,4,11,1,2412,-86,-91,5,4c:01:43:d7:f3:29,34471347,362,2982,34470985,34471347
9734,4,11,1,2412,-87,-91,4,4c:01:43:d7:f3:23,34471721,322,52,34471399,34471721
9735,4,1,1,2412,-86,-91,5,,34474959,304,2934,34474655,34474959
9736,4,11,1,2412,-78,-91,13,48:dd:0c:7d:86:27,34483375,362,8054,34483013,34483375
9737,4,11,1,2412,-77,-91,14,48:dd:0c:7d:86:23,34483749,323,51,34483426,34483749
9738,4,11,1,2412,-78,-91,13,48:dd:0c:7d:86:25,34484084,382,-47,34483702,34484084
9739,6,6,1,2412,-89,-91,2,e2:db:d1:d1:b0:4a,34488604,68,4452,34488536,34488604
9740,6,6,1,2412,-88,-91,3,,34488966,44,318,34488922,34488966
9741,6,6,1,2412,-63,-91,28,12:86:8c:5f:93:1e,34493132,332,3834,34492800,34493132
9742,6,6,1,2412,-87,-91,4,e2:db:d1:d1:b0:4a,34494967,68,1767,34494899,34494967
9743,4,1,1,2412,-86,-91,5,,34495699,304,428,34495395,34495699
9744,6,6,1,2412,-88,-91,3,e2:db:d1:d1:b0:4a,34496096,68,329,34496028,34496096
9745,6,6,1,2412,-88,-91,3,e2:db:d1:d1:b0:4a,34505096,444,8556,34504652,34505096
9746,6,6,1,2412,-89,-91,2,e2:db:d1:d1:b0:4b,34505591,408,87,34505183,34505591
9747,6,6,1,2412,-88,-91,3,e2:db:d1:d1:b0:4a,34507052,68,1393,34506984,34507052
9748,4,1,1,2412,-74,-91,17,,34507760,304,404,34507456,34507760
9749,6,6,1,2412,-89,-91,2,e2:db:d1:d1:b0:4a,34508137,68,309,34508069,34508137
9750,6,6,1,2412,-90,-91,1,,34508357,44,176,34508313,34508357
9751,4,11,1,2412,-82,-91,9,4c:01:43:ec:a0:69,34509364,361,646,34509003,34509364
9752,4,11,1,2412,-82,-91,9,4c:01:43:ec:a0:63,34509737,322,51,34509415,34509737
9753,4,11,1,2412,-81,-91,10,4c:01:43:ec:a0:66,34510072,387,-52,34509685,34510072
9754,6,6,1,2412,-61,-91,30,52:86:8c:5f:93:1e,34516472,332,6068,34516140,34516472
9755,4,1,1,2412,-79,-91,12,3c:bd:c5:ee:96:6d,34517488,2512,-1496,34514976,34517488
9756,4,1,1,2412,-86,-91,5,,34535862,304,18070,34535558,34535862
9757,6,6,1,2412,-61,-91,30,32:86:8c:5f:93:1e,34542072,332,5878,34541740,34542072
9758,6,6,1,2412,-88,-91,3,e2:db:d1:d1:b0:4a,34545421,52,3297,34545369,34545421
9759,4,1,1,2412,-86,-91,5,,34545956,304,231,34545652,34545956
9760,6,6,1,2412,-90,-91,1,e2:db:d1:d1:b0:4a,34546609,68,585,34546541,34546609
9761,6,6,1,2412,-90,-91,1,e2:db:d1:d1:b0:4a,34546854,52,193,34546802,34546854
9762,4,1,1,2412,-89,-91,2,,34555244,304,8086,34554940,34555244
9763,4,1,1,2412,-87,-91,4,,34556423,304,875,34556119,34556423
9764,6,6,1,2412,-91,-91,0,,34557160,44,693,34557116,34557160
9765,6,6,1,2412,-90,-91,1,e2:db:d1:d1:b0:4a,34557312,68,84,34557244,34557312
9766,6,6,1,2412,-90,-91,1,e2:db:d1:d1:b0:4a,34561237,52,3873,34561185,34561237
9767,4,1,1,2412,-57,-91,34,b0:e4:d5:32:ec:8a,34570341,1960,7144,34568381,34570341
9768,6,6,1,2412,-61,-91,30,10:86:8c:5f:93:1e,34572157,344,1472,34571813,34572157
9769,4,1,1,2412,-55,-91,36,94:a6:7e:c9:98:67,34572692,2464,-1929,34570228,34572692
9770,4,11,1,2412,-80,-91,11,48:dd:0c:7d:86:27,34586256,362,13202,34585894,34586256
9771,4,11,1,2412,-81,-91,10,48:dd:0c:7d:86:23,34586631,323,52,34586308,34586631
9772,4,11,1,2412,-81,-91,10,48:dd:0c:7d:86:25,34586966,382,-47,34586584,34586966
9773,4,1,1,2412,-89,-91,2,,34589549,304,2279,34589245,34589549
9774,6,6,1,2412,-62,-91,29,12:86:8c:5f:93:1e,34593273,332,3392,34592941,34593273
9775,4,1,1,2412,-83,-91,8,78:67:0e:38:6c:d3,34594759,352,1134,34594407,34594759
9776,4,1,1,2412,-89,-91,2,,34595126,304,63,34594822,34595126
9777,6,6,1,2412,-91,-91,0,,34597694,44,2524,34597650,34597694
9778,4,1,1,2412,-87,-91,4,,34598351,304,353,34598047,34598351
9779,6,6,1,2412,-91,-91,0,e2:db:d1:d1:b0:4a,34598656,68,237,34598588,34598656
9780,4,11,1,2412,-82,-91,9,4c:01:43:ec:a0:69,34611762,361,12745,34611401,34611762
9781,4,11,1,2412,-82,-91,9,4c:01:43:ec:a0:63,34612136,322,52,34611814,34612136
9782,4,11,1,2412,-80,-91,11,4c:01:43:ec:a0:66,34612471,387,-52,34612084,34612471
9783,4,11,1,2412,-86,-91,5,48:dd:0c:90:e3:83,34613657,323,863,34613334,34613657
9784,6,6,1,2412,-62,-91,29,52:86:8c:5f:93:1e,34618931,332,4942,34618599,34618931
9785,4,5.5,1,2412,-84,-91,7,,34629844,117,10796,34629727,34629844
9786,4,1,1,2412,-87,-91,4,,34633682,304,3534,34633378,34633682
9787,6,6,1,2412,-65,-91,26,32:86:8c:5f:93:1e,34644473,332,10459,34644141,34644473
9788,6,6,1,2412,-84,-91,7,4c:01:43:d7:f3:26,34653004,52,8479,34652952,34653004
9789,6,6,1,2412,-85,-91,6,4c:01:43:d7:f3:26,34653817,68,745,34653749,34653817
9790,4,1,1,2412,-87,-91,4,,34657261,304,3140,34656957,34657261
9791,4,1,1,2412,-87,-91,4,,34660194,304,2629,34659890,34660194
9792,4,1,1,2412,-60,-91,31,b0:e4:d5:32:ec:8a,34665853,1960,3699,34663893,34665853
9793,6,6,1,2412,-67,-91,24,10:86:8c:5f:93:1e,34670073,344,3876,34669729,34670073
9794,4,1,1,2412,-86,-91,5,,34670735,304,358,34670431,34670735
9795,4,1,1,2412,-59,-91,32,94:a6:7e:c9:98:67,34672842,2464,-357,34670378,34672842
9796,4,11,1,2412,-83,-91,8,4c:01:43:d7:f3:29,34676146,362,2942,34675784,34676146
9797,4,11,1,2412,-83,-91,8,4c:01:43:d7:f3:23,34676520,322,52,34676198,34676520
9798,4,1,1,2412,-86,-91,5,,34678331,304,1507,34678027,34678331
9799,4,11,1,2412,-80,-91,11,48:dd:0c:7d:86:23,34691640,323,12986,34691317,34691640
9800,6,6,1,2412,-68,-91,23,12:86:8c:5f:93:1e,34695673,332,3701,34695341,34695673
9801,4,1,1,2412,-87,-91,4,,34704330,304,8353,34704026,34704330
9802,4,1,1,2412,-86,-91,5,,34709130,304,4496,34708826,34709130
9803,4,11,1,2412,-82,-91,9,4c:01:43:ec:a0:69,34714161,361,4670,34713800,34714161
9804,4,11,1,2412,-83,-91,8,4c:01:43:ec:a0:63,34714535,322,52,34714213,34714535
9805,4,11,1,2412,-81,-91,10,4c:01:43:ec:a0:66,34714870,387,-52,34714483,34714870
9806,4,1,1,2412,-87,-91,4,,34731294,304,16120,34730990,34731294
9807,4,1,1,2412,-88,-91,3,,34743821,304,12223,34743517,34743821
9808,6,6,1,2412,-65,-91,26,32:86:8c:5f:93:1e,34746874,332,2721,34746542,34746874
9809,4,1,1,2412,-86,-91,5,,34759992,304,12814,34759688,34759992
9810,4,1,1,2412,-88,-91,3,,34761199,304,903,34760895,34761199
9811,4,1,1,2412,-88,-91,3,,34766861,304,5358,34766557,34766861
9812,4,1,1,2412,-53,-91,38,94:a6:7e:c9:98:67,34775229,2464,5904,34772765,34775229
9813,4,1,1,2412,-61,-91,30,b0:e4:d5:32:ec:8a,34777719,1960,530,34775759,34777719
9814,6,6,1,2412,-85,-91,6,,34779724,44,1961,34779680,34779724
9815,4,1,1,2412,-83,-91,8,78:67:0e:38:6c:d3,34780164,2208,-1768,34777956,34780164
9816,6,6,1,2412,-88,-91,3,3c:bd:c5:ee:96:6d,34795377,68,15145,34795309,34795377
9817,4,1,1,2412,-88,-91,3,78:67:0e:38:6c:d3,34795615,2208,-1970,34793407,34795615
9818,6,6,1,2412,-62,-91,29,12:86:8c:5f:93:1e,34798315,332,2368,34797983,34798315
9819,4,11,1,2412,-84,-91,7,48:dd:0c:90:e3:83,34801051,254,2482,34800797,34801051
9820,4,1,1,2412,-89,-91,2,,34804862,304,3507,34804558,34804862
9821,4,11,1,2412,-82,-91,9,4c:01:43:ec:a0:69,34816560,361,11337,34816199,34816560
9822,4,11,1,2412,-87,-91,4,48:dd:0c:90:e3:83,34818456,323,1573,34818133,34818456
9823,6,6,1,2412,-63,-91,28,52:86:8c:5f:93:1e,34823674,332,4886,34823342,34823674
9824,4,1,1,2412,-88,-91,3,3c:bd:c5:ee:96:6d,34827417,2512,1231,34824905,34827417
9825,4,1,1,2412,-85,-91,6,78:67:0e:c4:a8:42,34830305,2736,152,34827569,34830305
9826,6,6,1,2412,-63,-91,28,32:86:8c:5f:93:1e,34849274,332,18637,34848942,34849274
9827,6,6,1,2412,-83,-91,8,4c:01:43:d7:f3:26,34858329,68,8987,34858261,34858329
9828,4,1,1,2412,-87,-91,4,,34869655,304,11022,34869351,34869655
9829,4,1,1,2412,-61,-91,30,b0:e4:d5:32:ec:8a,34870652,1960,-963,34868692,34870652
9830,6,6,1,2412,-88,-91,3,,34872578,44,1882,34872534,34872578
9831,4,1,1,2412,-86,-91,5,78:67:0e:c4:a8:42,34875575,352,2645,34875223,34875575
9832,4,1,1,2412,-60,-91,31,94:a6:7e:c9:98:67,34877648,2464,-391,34875184,34877648
9833,4,1,1,2412,-83,-91,8,,34881606,304,3654,34881302,34881606
9834,4,11,1,2412,-74,-91,17,48:dd:0c:7d:86:27,34893479,362,11511,34893117,34893479
9835,4,11,1,2412,-75,-91,16,48:dd:0c:7d:86:23,34893853,323,51,34893530,34893853
9836,4,11,1,2412,-75,-91,16,48:dd:0c:7d:86:25,34894189,382,-46,34893807,34894189
9837,4,1,1,2412,-84,-91,7,,34898588,304,4095,34898284,34898588
9838,6,24,1,2412,-86,-91,5,,34898857,28,241,34898829,34898857
9839,6,6,1,2412,-66,-91,25,12:86:8c:5f:93:1e,34900588,332,1399,34900256,34900588
9840,4,1,1,2412,-84,-91,7,,34903061,304,2169,34902757,34903061
9841,6,6,1,2412,-90,-91,1,e2:db:d1:d1:b0:4d,34913296,408,9827,34912888,34913296
9842,4,1,1,2412,-84,-91,7,,34914712,304,1112,34914408,34914712
9843,4,1,1,2412,-83,-91,8,,34937635,304,22619,34937331,34937635
9844,4,1,1,2412,-83,-91,8,,34950906,304,12967,34950602,34950906
9845,6,6,1,2412,-66,-91,25,32:86:8c:5f:93:1e,34951675,332,437,34951343,34951675
9846,4,1,1,2412,-84,-91,7,,34962340,304,10361,34962036,34962340
9847,4,1,1,2412,-65,-91,26,b0:e4:d5:32:ec:8a,34975985,1960,11685,34974025,34975985
9848,4,1,1,2412,-62,-91,29,94:a6:7e:c9:98:67,34979960,2464,1511,34977496,34979960
9849,4,1,1,2412,-84,-91,7,,34988856,304,8592,34988552,34988856
9850,4,1,1,2412,-84,-91,7,,34999465,304,10305,34999161,34999465
9851,4,1,1,2412,-90,-91,1,,35000099,304,330,34999795,35000099
9852,6,6,1,2412,-88,-91,3,e2:db:d1:d1:b0:4a,35000258,68,91,35000190,35000258
9853,4,1,1,2412,-85,-92,7,,35013009,304,12447,35012705,35013009
9854,6,6,1,2412,-87,-92,5,e2:db:d1:d1:b0:4a,35016875,444,3422,35016431,35016875
9855,6,24,1,2412,-83,-92,9,,35031334,28,14431,35031306,35031334
9856,4,1,1,2412,-85,-92,7,,35031560,304,-78,35031256,35031560
9857,4,1,1,2412,-86,-92,6,,35050724,304,18860,35050420,35050724
9858,4,1,1,2412,-92,-92,0,,35052350,304,1322,35052046,35052350
9859,6,6,1,2412,-62,-92,30,32:86:8c:5f:93:1e,35054076,332,1394,35053744,35054076
9860,4,1,1,2412,-86,-92,6,,35065397,304,11017,35065093,35065397
9861,4,1,1,2412,-86,-92,6,,35068624,304,2923,35068320,35068624
9862,4,1,1,2412,-61,-92,31,b0:e4:d5:32:ec:8a,35080903,1960,10319,35078943,35080903
9863,4,1,1,2412,-61,-92,31,94:a6:7e:c9:98:67,35082935,2464,-432,35080471,35082935
9864,6,6,1,2412,-64,-92,28,b4:e6:2d:b4:ff:71,35085276,64,2277,35085212,35085276
9865,6,6,1,2412,-61,-92,31,,35087178,44,1858,35087134,35087178
9866,4,1,1,2412,-87,-92,5,,35095008,304,7526,35094704,35095008
9867,4,1,1,2412,-90,-92,2,,35102847,304,7535,35102543,35102847
9868,6,6,1,2412,-61,-92,31,12:86:8c:5f:93:1e,35105276,332,2097,35104944,35105276
9869,4,1,1,2412,-86,-92,6,,35113029,304,7449,35112725,35113029
9870,4,1,1,2412,-86,-92,6,,35115690,304,2357,35115386,35115690
9871,4,11,1,2412,-87,-92,5,48:dd:0c:90:e3:87,35125281,362,9229,35124919,35125281
9872,4,11,1,2412,-86,-92,6,48:dd:0c:90:e3:83,35125655,323,51,35125332,35125655
9873,4,11,1,2412,-88,-92,4,48:dd:0c:90:e3:85,35125991,382,-46,35125609,35125991
9874,6,6,1,2412,-61,-92,31,52:86:8c:5f:93:1e,35131047,332,4724,35130715,35131047
9875,4,1,1,2412,-89,-92,3,3c:bd:c5:ee:96:6d,35131755,2512,-1804,35129243,35131755
9876,6,6,1,2412,-61,-92,31,32:86:8c:5f:93:1e,35156476,332,24389,35156144,35156476
9877,4,1,1,2412,-86,-92,6,,35164735,304,7955,35164431,35164735
9878,4,1,1,2412,-86,-92,6,,35166604,304,1565,35166300,35166604
9879,4,1,1,2412,-86,-92,6,,35168741,304,1833,35168437,35168741
9880,4,1,1,2412,-89,-92,3,,35170309,304,1264,35170005,35170309
9881,4,1,1,2412,-60,-92,32,b0:e4:d5:32:ec:8a,35177903,1960,5634,35175943,35177903
9882,4,1,1,2412,-64,-92,28,94:a6:7e:c9:98:67,35185089,2464,4722,35182625,35185089
9883,4,1,1,2412,-63,-92,29,94:a6:7e:c9:98:67,35187599,3848,-1338,35183751,35187599
9884,4,1,1,2412,-62,-92,30,94:a6:7e:c9:98:67,35191493,4008,-114,35187485,35191493
9885,4,1,1,2412,-84,-92,8,78:67:0e:38:6c:d3,35199918,2736,5689,35197182,35199918
9886,4,1,1,2412,-86,-92,6,,35203108,304,2886,35202804,35203108
9887,4,1,1,2412,-87,-92,5,,35206609,304,3197,35206305,35206609
9888,6,6,1,2412,-62,-92,30,12:86:8c:5f:93:1e,35207725,332,784,35207393,35207725
9889,4,1,1,2412,-87,-92,5,,35210317,304,2288,35210013,35210317
9890,4,1,1,2412,-86,-92,6,,35213154,304,2533,35212850,35213154
9891,6,6,1,2412,-84,-92,8,3c:bd:c5:ee:96:6d,35213663,68,441,35213595,35213663
9892,4,1,1,2412,-86,-92,6,,35218566,304,4599,35218262,35218566
9893,4,1,1,2412,-85,-92,7,,35221075,304,2205,35220771,35221075
9894,4,1,1,2412,-89,-92,3,78:67:0e:c4:a8:42,35222134,352,707,35221782,35222134
9895,4,1,1,2412,-90,-92,2,78:67:0e:c4:a8:42,35223148,352,662,35222796,35223148
9896,6,24,1,2412,-85,-92,7,3c:bd:c5:ee:96:6d,35246126,28,22950,35246098,35246126
9897,6,6,1,2412,-85,-92,7,,35246405,44,235,35246361,35246405
9898,6,6,1,2412,-62,-92,30,32:86:8c:5f:93:1e,35258877,332,12140,35258545,35258877
9899,6,6,1,2412,-68,-92,24,b4:e6:2d:b4:ff:71,35267447,64,8506,35267383,35267447
9900,6,6,1,2412,-68,-92,24,b4:e6:2d:b4:ff:71,35268059,64,548,35267995,35268059
9901,6,6,1,2412,-62,-92,30,,35268139,44,36,35268095,35268139
9902,4,1,1,2412,-87,-92,5,,35268958,304,515,35268654,35268958
9903,4,1,1,2412,-86,-92,6,,35270413,304,1151,35270109,35270413
9904,6,24,1,2412,-86,-92,6,,35271340,28,899,35271312,35271340
9905,4,1,1,2412,-88,-92,4,,35272590,304,946,35272286,35272590
9906,4,1,1,2412,-87,-92,5,,35274117,304,1223,35273813,35274117
9907,4,1,1,2412,-87,-92,5,,35276616,304,2195,35276312,35276616
9908,4,1,1,2412,-59,-92,33,b0:e4:d5:32:ec:8a,35280268,1960,1692,35278308,35280268
9909,4,1,1,2412,-86,-92,6,,35285116,304,4544,35284812,35285116
9910,4,1,1,2412,-58,-92,34,94:a6:7e:c9:98:67,35287253,2464,-327,35284789,35287253
9911,4,11,1,2412,-88,-92,4,4c:01:43:d7:f3:26,35291252,387,3612,35290865,35291252
9912,4,1,1,2412,-86,-92,6,,35291789,304,233,35291485,35291789
9913,4,1,1,2412,-86,-92,6,,35299073,304,6980,35298769,35299073
9914,6,6,1,2412,-86,-92,6,,35300158,44,1041,35300114,35300158
9915,4,1,1,2412,-83,-92,9,78:67:0e:38:6c:d3,35302319,2736,-575,35299583,35302319
9916,4,11,1,2412,-82,-92,10,48:dd:0c:7d:86:27,35305078,362,2397,35304716,35305078
9917,4,11,1,2412,-81,-92,11,48:dd:0c:7d:86:23,35305453,323,52,35305130,35305453
9918,4,11,1,2412,-82,-92,10,48:dd:0c:7d:86:25,35305788,382,-47,35305406,35305788
9919,6,6,1,2412,-62,-92,30,12:86:8c:5f:93:1e,35317710,332,11590,35317378,35317710
9920,4,1,1,2412,-71,-92,21,,35322006,304,3992,35321702,35322006
9921,4,1,1,2412,-87,-92,5,,35325113,304,2803,35324809,35325113
9922,4,11,1,2412,-85,-92,7,4c:01:43:ec:a0:69,35328554,361,3080,35328193,35328554
9923,4,11,1,2412,-85,-92,7,4c:01:43:ec:a0:63,35328928,322,52,35328606,35328928
9924,6,6,1,2412,-62,-92,30,52:86:8c:5f:93:1e,35335729,332,6469,35335397,35335729
9925,4,1,1,2412,-84,-92,8,3c:bd:c5:ee:96:6d,35338425,2512,184,35335913,35338425
9926,6,6,1,2412,-63,-92,29,32:86:8c:5f:93:1e,35361278,332,22521,35360946,35361278
9927,4,1,1,2412,-86,-92,6,,35373166,304,11584,35372862,35373166
9928,6,24,1,2412,-85,-92,7,4c:01:43:d7:f3:26,35373520,32,322,35373488,35373520
9929,4,1,1,2412,-87,-92,5,,35375233,304,1409,35374929,35375233
9930,4,1,1,2412,-85,-92,7,,35376814,304,1277,35376510,35376814
9931,4,1,1,2412,-90,-92,2,78:67:0e:c4:a8:42,35379693,352,2527,35379341,35379693
9932,4,11,1,2412,-89,-92,3,,35381837,107,2037,35381730,35381837
9933,6,24,1,2412,-88,-92,4,78:67:0e:c4:a8:42,35381951,32,82,35381919,35381951
9934,4,1,1,2412,-57,-92,35,b0:e4:d5:32:ec:8a,35382648,1960,-1263,35380688,35382648
9935,4,1,1,2412,-85,-92,7,,35386546,304,3594,35386242,35386546
9936,6,6,1,2412,-63,-92,29,10:86:8c:5f:93:1e,35386878,344,-12,35386534,35386878
9937,4,1,1,2412,-86,-92,6,,35389203,304,2021,35388899,35389203
9938,4,1,1,2412,-58,-92,34,94:a6:7e:c9:98:67,35389656,2464,-2011,35387192,35389656
9939,4,1,1,2412,-87,-92,5,,35397012,304,7052,35396708,35397012
9940,4,1,1,2412,-86,-92,6,,35404012,304,6696,35403708,35404012
9941,4,1,1,2412,-86,-92,6,,35411861,304,7545,35411557,35411861
9942,6,6,1,2412,-62,-92,30,12:86:8c:5f:93:1e,35413060,332,867,35412728,35413060
9943,4,1,1,2412,-85,-92,7,,35416794,304,3430,35416490,35416794
9944,4,1,1,2412,-87,-92,5,,35421005,304,3907,35420701,35421005
9945,4,11,1,2412,-84,-92,8,4c:01:43:ec:a0:69,35430953,361,9587,35430592,35430953
9946,4,11,1,2412,-84,-92,8,4c:01:43:ec:a0:66,35431662,387,322,35431275,35431662
9947,4,11,1,2412,-86,-92,6,48:dd:0c:90:e3:85,35433190,382,1146,35432808,35433190
9948,4,1,1,2412,-87,-92,5,,35433842,304,348,35433538,35433842
9949,6,24,1,2412,-85,-92,7,,35443918,28,10048,35443890,35443918
9950,4,1,1,2412,-87,-92,5,,35452909,304,8687,35452605,35452909
9951,6,24,1,2412,-85,-92,7,4c:01:43:d7:f3:26,35454347,32,1406,35454315,35454347
9952,4,1,1,2412,-92,-92,0,,35455250,304,599,35454946,35455250
9953,4,1,1,2412,-88,-92,4,,35459343,304,3789,35459039,35459343
9954,4,1,1,2412,-58,-92,34,b0:e4:d5:32:ec:8a,35485048,1960,23745,35483088,35485048
9955,6,6,1,2412,-61,-92,31,10:86:8c:5f:93:1e,35489572,344,4180,35489228,35489572
9956,4,1,1,2412,-92,-92,0,b8:f8:53:cb:31:f2,35491046,912,562,35490134,35491046
9957,4,1,1,2412,-62,-92,30,94:a6:7e:c9:98:67,35492274,2464,-1236,35489810,35492274
9958,6,24,1,2412,-86,-92,6,4c:01:43:d7:f3:26,35494807,32,2501,35494775,35494807
9959,6,24,1,2412,-88,-92,4,,35497824,28,2989,35497796,35497824
9960,4,1,1,2412,-92,-92,0,,35498578,304,450,35498274,35498578
9961,4,1,1,2412,-85,-92,7,78:67:0e:38:6c:d3,35507119,2736,5805,35504383,35507119
9962,4,11,1,2412,-84,-92,8,48:dd:0c:7d:86:27,35509878,362,2397,35509516,35509878
9963,4,11,1,2412,-85,-92,7,48:dd:0c:7d:86:25,35510588,382,328,35510206,35510588
9964,6,6,1,2412,-61,-92,31,12:86:8c:5f:93:1e,35514879,332,3959,35514547,35514879
9965,6,24,1,2412,-86,-92,6,,35524862,28,9955,35524834,35524862
9966,4,11,1,2412,-86,-92,6,48:dd:0c:90:e3:85,35535590,382,10346,35535208,35535590
9967,6,24,1,2412,-87,-92,5,4c:01:43:d7:f3:26,35554776,32,19154,35554744,35554776
9968,6,6,1,2412,-62,-92,30,32:86:8c:5f:93:1e,35566079,332,10971,35565747,35566079
9969,6,24,1,2412,-87,-92,5,4c:01:43:d7:f3:26,35578850,32,12739,35578818,35578850
9970,4,1,1,2412,-61,-92,31,b0:e4:d5:32:ec:8a,35587447,1960,6637,35585487,35587447
9971,6,6,1,2412,-63,-92,29,10:86:8c:5f:93:1e,35591740,344,3949,35591396,35591740
9972,4,1,1,2412,-61,-92,31,94:a6:7e:c9:98:67,35596289,2464,2085,35593825,35596289
9973,4,11,1,2412,-89,-92,3,4c:01:43:d7:f3:23,35598690,322,2079,35598368,35598690
9974,4,11,1,2412,-88,-92,4,4c:01:43:d7:f3:26,35599025,387,-52,35598638,35599025
9975,6,6,1,2412,-67,-92,25,b4:e6:2d:b4:ff:71,35599528,64,439,35599464,35599528
9976,6,6,1,2412,-62,-92,30,,35599608,44,36,35599564,35599608
9977,7,26,1,2412,-68,-92,24,b4:e6:2d:b4:ff:71,35601836,68,2160,35601768,35601836
9978,7,26,1,2412,-68,-92,24,b4:e6:2d:b4:ff:71,35602329,68,425,35602261,35602329
9979,7,26,1,2412,-68,-92,24,b4:e6:2d:b4:ff:71,35602711,68,314,35602643,35602711
9980,6,24,1,2412,-62,-92,30,10:86:8c:5f:93:1e,35602787,32,44,35602755,35602787
9981,6,24,1,2412,-87,-92,5,,35603917,28,1102,35603889,35603917
9982,6,24,1,2412,-87,-92,5,,35604413,28,468,35604385,35604413
9983,4,1,1,2412,-86,-92,6,78:67:0e:38:6c:d3,35609519,2736,2370,35606783,35609519
9984,6,6,1,2412,-62,-92,30,12:86:8c:5f:93:1e,35617280,332,7429,35616948,35617280
9985,6,24,1,2412,-86,-92,6,4c:01:43:d7:f3:26,35618591,32,1279,35618559,35618591
9986,4,11,1,2412,-86,-92,6,4c:01:43:ec:a0:69,35635751,361,16799,35635390,35635751
9987,4,11,1,2412,-89,-92,3,4c:01:43:ec:a0:66,35636459,387,321,35636072,35636459
9988,4,11,1,2412,-86,-92,6,48:dd:0c:90:e3:87,35637280,362,459,35636918,35637280
9989,4,11,1,2412,-86,-92,6,48:dd:0c:90:e3:83,35637654,323,51,35637331,35637654
9990,4,11,1,2412,-85,-92,7,48:dd:0c:90:e3:85,35637989,382,-47,35637607,35637989
9991,6,6,1,2412,-63,-92,29,52:86:8c:5f:93:1e,35642880,332,4559,35642548,35642880
9992,4,1,1,2412,-86,-92,6,,35647282,304,4098,35646978,35647282
9993,4,1,1,2412,-86,-92,6,78:67:0e:c4:a8:42,35649504,2736,-514,35646768,35649504
9994,6,24,1,2412,-89,-92,3,,35657072,28,7540,35657044,35657072
9995,4,1,1,2412,-89,-92,3,,35662577,304,5201,35662273,35662577
9996,4,1,1,2412,-88,-92,4,,35663841,304,960,35663537,35663841
9997,4,1,1,2412,-90,-92,2,,35668113,304,3968,35667809,35668113
9998,6,6,1,2412,-63,-92,29,32:86:8c:5f:93:1e,35668480,332,35,35668148,35668480
9999,6,24,1,2412,-87,-92,5,,35671348,28,2840,35671320,35671348
10000,6,24,1,2412,-87,-92,5,,35685311,28,13935,35685283,35685311
10001,6,24,1,2412,-85,-92,7,,35688844,28,3505,35688816,35688844
10002,4,1,1,2412,-62,-92,30,b0:e4:d5:32:ec:8a,35689846,1960,-958,35687886,35689846
10003,4,11,1,2412,-88,-92,4,4c:01:43:ec:a0:63,35692603,254,2503,35692349,35692603
10004,4,1,1,2412,-88,-92,4,,35693649,304,742,35693345,35693649
10005,6,6,1,2412,-63,-92,29,10:86:8c:5f:93:1e,35694080,344,87,35693736,35694080
10006,6,6,1,2412,-87,-92,5,4d:01:43:ec:a0:63,35695713,52,1581,35695661,35695713
10007,4,1,1,2412,-62,-92,30,94:a6:7e:c9:98:67,35696823,2464,-1354,35694359,35696823
10008,6,6,1,2412,-89,-92,3,4d:01:43:ec:a0:63,35699349,52,2474,35699297,35699349
10009,4,11,1,2412,-87,-92,5,4c:01:43:d7:f3:29,35700531,362,820,35700169,35700531
10010,4,11,1,2412,-87,-92,5,4c:01:43:d7:f3:26,35701240,387,322,35700853,35701240
10011,4,1,1,2412,-88,-92,4,,35710545,304,9001,35710241,35710545
10012,4,11,1,2412,-87,-92,5,48:dd:0c:7d:86:27,35714678,362,3771,35714316,35714678
10013,4,11,1,2412,-88,-92,4,48:dd:0c:7d:86:23,35715053,323,52,35714730,35715053
10014,4,11,1,2412,-86,-92,6,48:dd:0c:7d:86:25,35715388,382,-47,35715006,35715388
10015,6,24,1,2412,-86,-92,6,,35717062,28,1646,35717034,35717062
10016,6,6,1,2412,-65,-92,27,12:86:8c:5f:93:1e,35719680,332,2286,35719348,35719680
10017,6,6,1,2412,-88,-92,4,4c:01:43:db:2d:86,35723829,52,4097,35723777,35723829
10018,4,1,1,2412,-87,-92,5,,35733235,304,9102,35732931,35733235
10019,4,1,1,2412,-89,-92,3,,35736209,304,2670,35735905,35736209
10020,4,11,1,2412,-89,-92,3,4c:01:43:ec:a0:69,35738150,361,1580,35737789,35738150
10021,4,11,1,2412,-89,-92,3,4c:01:43:ec:a0:63,35738524,322,52,35738202,35738524
10022,4,11,1,2412,-90,-92,2,4c:01:43:ec:a0:66,35738858,387,-53,35738471,35738858
10023,6,24,1,2412,-86,-92,6,4c:01:43:d7:f3:26,35739246,32,356,35739214,35739246
10024,4,11,1,2412,-87,-92,5,48:dd:0c:90:e3:85,35740389,382,761,35740007,35740389
10025,4,1,1,2412,-89,-92,3,,35742737,304,2044,35742433,35742737
10026,4,1,1,2412,-88,-92,4,,35743921,304,880,35743617,35743921
10027,6,24,1,2412,-87,-92,5,,35751345,28,7396,35751317,35751345
10028,4,1,1,2412,-86,-92,6,78:67:0e:c4:a8:42,35755443,2736,1362,35752707,35755443
10029,6,24,1,2412,-86,-92,6,,35764733,28,9262,35764705,35764733
10030,6,24,1,2412,-86,-92,6,4c:01:43:d7:f3:26,35779982,32,15217,35779950,35779982
10031,6,24,1,2412,-86,-92,6,,35784131,28,4121,35784103,35784131
10032,4,1,1,2412,-62,-92,30,b0:e4:d5:32:ec:8a,35792245,1960,6154,35790285,35792245
10033,7,26,1,2412,-68,-92,24,b4:e6:2d:b4:ff:71,35794159,108,1806,35794051,35794159
10034,6,24,1,2412,-65,-92,27,10:86:8c:5f:93:1e,35794275,32,84,35794243,35794275
10035,4,1,1,2412,-89,-92,3,,35795793,304,1214,35795489,35795793
10036,6,24,1,2412,-87,-92,5,,35797280,28,1459,35797252,35797280
10037,4,1,1,2412,-63,-92,29,94:a6:7e:c9:98:67,35800153,2464,409,35797689,35800153
10038,4,11,1,2412,-80,-92,12,4c:01:43:d7:f3:23,35802916,322,2441,35802594,35802916
10039,4,11,1,2412,-88,-92,4,4c:01:43:d7:f3:26,35803250,387,-53,35802863,35803250
10040,4,11,1,2412,-87,-92,5,48:dd:0c:7d:86:27,35817079,362,13467,35816717,35817079
10041,4,11,1,2412,-88,-92,4,48:dd:0c:7d:86:23,35817454,323,52,35817131,35817454
10042,4,11,1,2412,-87,-92,5,48:dd:0c:7d:86:25,35817789,382,-47,35817407,35817789
10043,6,6,1,2412,-88,-92,4,4c:01:43:db:2d:86,35818761,68,904,35818693,35818761
10044,6,24,1,2412,-86,-92,6,4c:01:43:d7:f3:26,35819576,32,783,35819544,35819576
10045,6,6,1,2412,-87,-92,5,,35820386,44,766,35820342,35820386
10046,6,6,1,2412,-89,-92,3,3c:bd:c5:ee:96:6d,35820890,68,436,35820822,35820890
10047,6,6,1,2412,-90,-92,2,3c:bd:c5:ee:96:6d,35821763,68,805,35821695,35821763
10048,6,6,1,2412,-65,-92,27,12:86:8c:5f:93:1e,35822081,332,-14,35821749,35822081
10049,4,1,1,2412,-90,-92,2,,35822513,304,128,35822209,35822513
10050,6,6,1,2412,-91,-92,1,3c:bd:c5:ee:96:6d,35823058,68,477,35822990,35823058
10051,6,24,1,2412,-86,-92,6,4c:01:43:d7:f3:26,35824016,32,926,35823984,35824016
10052,4,11,1,2412,-88,-92,4,4c:01:43:ec:a0:63,35836053,254,11783,35835799,35836053
10053,6,6,1,2412,-90,-92,2,4d:01:43:d7:f3:23,35836888,52,783,35836836,35836888
10054,6,6,1,2412,-87,-92,5,,35836957,44,25,35836913,35836957
10055,6,6,1,2412,-86,-92,6,4d:01:43:d7:f3:23,35837968,52,959,35837916,35837968
10056,6,6,1,2412,-86,-92,6,,35838037,44,25,35837993,35838037
10057,4,1,1,2412,-89,-92,3,,35838769,304,428,35838465,35838769
10058,4,11,1,2412,-88,-92,4,4c:01:43:ec:a0:69,35840549,361,1419,35840188,35840549
10059,4,11,1,2412,-90,-92,2,4c:01:43:ec:a0:63,35840922,322,51,35840600,35840922
10060,4,11,1,2412,-89,-92,3,4c:01:43:ec:a0:66,35841257,387,-52,35840870,35841257
10061,6,6,1,2412,-88,-92,4,4d:01:43:d7:f3:23,35841527,52,218,35841475,35841527
10062,6,6,1,2412,-87,-92,5,,35841596,44,25,35841552,35841596
10063,4,11,1,2412,-89,-92,3,48:dd:0c:90:e3:87,35842079,362,121,35841717,35842079
10064,6,6,1,2412,-89,-92,3,3c:bd:c5:ee:96:6d,35843148,52,1017,35843096,35843148
10065,6,6,1,2412,-89,-92,3,3c:bd:c5:ee:96:6d,35843386,52,186,35843334,35843386
10066,6,6,1,2412,-90,-92,2,,35843502,44,72,35843458,35843502
10067,6,6,1,2412,-89,-92,3,3c:bd:c5:ee:96:6d,35843840,52,286,35843788,35843840
10068,6,6,1,2412,-89,-92,3,,35847484,44,3600,35847440,35847484
10069,4,1,1,2412,-90,-92,2,,35850353,304,2565,35850049,35850353
10070,4,1,1,2412,-86,-92,6,78:67:0e:c4:a8:42,35854304,2736,1215,35851568,35854304
10071,6,24,1,2412,-86,-92,6,4c:01:43:d7:f3:26,35857615,32,3279,35857583,35857615
10072,6,6,1,2412,-90,-92,2,,35859180,44,1521,35859136,35859180
10073,6,6,1,2412,-91,-92,1,3c:bd:c5:ee:96:6d,35861414,68,2166,35861346,35861414
10074,6,6,1,2412,-86,-92,6,,35863897,44,2439,35863853,35863897
10075,4,1,1,2412,-70,-92,22,,35864447,304,246,35864143,35864447
10076,7,52,1,2412,-64,-92,28,10:86:8c:5f:93:1e,35864598,52,99,35864546,35864598
10077,4,1,1,2412,-71,-92,21,,35865013,304,111,35864709,35865013
10078,7,39,1,2412,-65,-92,27,10:86:8c:5f:93:1e,35865164,60,91,35865104,35865164
10079,6,24,1,2412,-69,-92,23,,35865240,28,48,35865212,35865240
10080,6,6,1,2412,-90,-92,2,,35866110,44,826,35866066,35866110
10081,6,6,1,2412,-89,-92,3,3c:bd:c5:ee:96:6d,35870776,68,4598,35870708,35870776
10082,6,6,1,2412,-66,-92,26,32:86:8c:5f:93:1e,35873281,332,2173,35872949,35873281
10083,4,1,1,2412,-90,-92,2,,35875569,304,1984,35875265,35875569
10084,6,6,1,2412,-90,-92,2,3c:bd:c5:ee:96:6d,35876928,68,1291,35876860,35876928
10085,6,6,1,2412,-90,-92,2,3c:bd:c5:ee:96:6d,35878505,68,1509,35878437,35878505
10086,6,6,1,2412,-90,-92,2,,35888134,44,9585,35888090,35888134
10087,4,1,1,2412,-85,-92,7,78:67:0e:c4:a8:42,35890167,352,1681,35889815,35890167
10088,4,1,1,2412,-91,-92,1,,35893809,304,3338,35893505,35893809
10089,4,1,1,2412,-67,-92,25,b0:e4:d5:32:ec:8a,35894645,1960,-1124,35892685,35894645
10090,6,6,1,2412,-66,-92,26,10:86:8c:5f:93:1e,35901382,344,6393,35901038,35901382
10091,4,1,1,2412,-59,-92,33,94:a6:7e:c9:98:67,35901918,2464,-1928,35899454,35901918
10092,4,11,1,2412,-89,-92,3,4c:01:43:d7:f3:23,35905315,322,3075,35904993,35905315
10093,6,6,1,2412,-89,-92,3,3c:bd:c5:ee:96:6d,35916201,68,10818,35916133,35916201
10094,4,11,1,2412,-87,-92,5,48:dd:0c:7d:86:23,35919854,323,3330,35919531,35919854
10095,4,1,1,2412,-91,-92,1,,35922993,304,2835,35922689,35922993
10096,4,1,1,2412,-90,-92,2,,35924209,304,912,35923905,35924209
10097,6,6,1,2412,-67,-92,25,12:86:8c:5f:93:1e,35924482,332,-59,35924150,35924482
10098,6,24,1,2412,-88,-92,4,,35925118,28,608,35925090,35925118
10099,4,1,1,2412,-85,-92,7,,35929360,304,3938,35929056,35929360
10100,6,6,1,2412,-85,-92,7,,35932754,44,3350,35932710,35932754
10101,4,11,1,2412,-88,-92,4,4c:01:43:ec:a0:69,35942947,361,9832,35942586,35942947
10102,4,11,1,2412,-89,-92,3,4c:01:43:ec:a0:66,35943656,387,322,35943269,35943656
10103,6,6,1,2412,-89,-92,3,,35949678,44,5978,35949634,35949678
10104,4,1,1,2412,-82,-92,10,,35954736,304,4754,35954432,35954736
10105,6,24,1,2412,-85,-92,7,,35955279,28,515,35955251,35955279
10106,4,1,1,2412,-89,-92,3,,35955792,304,209,35955488,35955792
10107,6,6,1,2412,-89,-92,3,3c:bd:c5:ee:96:6d,35963249,68,7389,35963181,35963249
10108,6,6,1,2412,-90,-92,2,,35975285,44,11992,35975241,35975285
10109,6,6,1,2412,-66,-92,26,32:86:8c:5f:93:1e,35975682,332,65,35975350,35975682
10110,6,6,1,2412,-89,-92,3,3c:bd:c5:ee:96:6d,35977096,68,1346,35977028,35977096
10111,6,24,1,2412,-87,-92,5,4c:01:43:d7:f3:26,35978008,32,880,35977976,35978008
10112,4,1,1,2412,-89,-92,3,,35994608,304,16296,35994304,35994608
10113,4,1,1,2412,-62,-92,30,b0:e4:d5:32:ec:8a,35997044,1960,476,35995084,35997044
10114,6,6,1,2412,-68,-92,24,10:86:8c:5f:93:1e,36003783,344,6395,36003439,36003783
10115,4,1,1,2412,-58,-92,34,94:a6:7e:c9:98:67,36004337,2464,-1910,36001873,36004337
10116,6,24,1,2412,-88,-92,4,4c:01:43:d7:f3:26,36018572,32,14203,36018540,36018572
10117,4,1,1,2412,-90,-92,2,78:67:0e:38:6c:d3,36019120,2736,-2188,36016384,36019120
10118,4,11,1,2412,-83,-92,9,48:dd:0c:7d:86:27,36021880,362,2398,36021518,36021880
10119,4,11,1,2412,-84,-92,8,48:dd:0c:7d:86:23,36022254,323,51,36021931,36022254
10120,4,11,1,2412,-81,-92,11,48:dd:0c:7d:86:25,36022590,382,-46,36022208,36022590
10121,6,6,1,2412,-67,-92,25,12:86:8c:5f:93:1e,36026882,332,3960,36026550,36026882
10122,4,1,1,2412,-90,-92,2,,36031408,304,4222,36031104,36031408
10123,4,1,1,2412,-92,-92,0,,36035910,304,4198,36035606,36035910
10124,4,11,1,2412,-89,-92,3,4c:01:43:ec:a0:69,36045346,361,9075,36044985,36045346
10125,4,11,1,2412,-90,-92,2,4c:01:43:ec:a0:63,36045720,322,52,36045398,36045720
10126,4,11,1,2412,-89,-92,3,4c:01:43:ec:a0:66,36046055,387,-52,36045668,36046055
10127,4,11,1,2412,-91,-92,1,48:dd:0c:90:e3:85,36047588,382,1151,36047206,36047588
10128,4,1,1,2412,-90,-92,2,,36051152,304,3260,36050848,36051152
10129,4,1,1,2412,-91,-92,1,,36055468,304,4012,36055164,36055468
10130,4,1,1,2412,-86,-92,6,78:67:0e:c4:a8:42,36059104,2736,900,36056368,36059104
10131,6,24,1,2412,-88,-92,4,4c:01:43:d7:f3:26,36061877,32,2741,36061845,36061877
10132,6,6,1,2412,-89,-92,3,,36069070,44,7149,36069026,36069070
10133,6,6,1,2412,-68,-92,24,32:86:8c:5f:93:1e,36078083,332,8681,36077751,36078083
10134,4,11,1,2412,-89,-92,3,4c:01:43:ec:a0:63,36080775,254,2438,36080521,36080775
10135,4,1,1,2412,-88,-92,4,,36081680,304,601,36081376,36081680
10136,6,6,1,2412,-85,-92,7,,36082316,44,592,36082272,36082316
10137,6,24,1,2412,-88,-92,4,,36084328,28,1984,36084300,36084328
10138,4,1,1,2412,-70,-92,22,b0:e4:d5:32:ec:8a,36099443,1960,13155,36097483,36099443
10139,6,6,1,2412,-67,-92,25,10:86:8c:5f:93:1e,36103683,344,3896,36103339,36103683
10140,4,11,1,2412,-90,-92,2,4c:01:43:d7:f3:29,36109740,362,5695,36109378,36109740
10141,4,11,1,2412,-90,-92,2,4c:01:43:d7:f3:23,36110114,322,52,36109792,36110114
10142,4,1,1,2412,-87,-92,5,78:67:0e:38:6c:d3,36121521,2736,8671,36118785,36121521
10143,4,11,1,2412,-82,-92,10,48:dd:0c:7d:86:27,36124280,362,2397,36123918,36124280
10144,4,11,1,2412,-81,-92,11,48:dd:0c:7d:86:23,36124654,323,51,36124331,36124654
10145,4,11,1,2412,-81,-92,11,48:dd:0c:7d:86:25,36124989,382,-47,36124607,36124989
10146,6,6,1,2412,-68,-92,24,12:86:8c:5f:93:1e,36129283,332,3962,36128951,36129283
10147,4,1,1,2412,-89,-92,3,,36131889,304,2302,36131585,36131889
10148,6,12,1,2412,-87,-92,5,,36146964,32,15043,36146932,36146964
10149,4,11,1,2412,-87,-92,5,4c:01:43:ec:a0:63,36148119,322,833,36147797,36148119
10150,4,11,1,2412,-88,-92,4,4c:01:43:ec:a0:66,36148453,387,-53,36148066,36148453
10151,4,11,1,2412,-91,-92,1,48:dd:0c:90:e3:87,36149278,362,463,36148916,36149278
10152,4,11,1,2412,-91,-92,1,48:dd:0c:90:e3:83,36149653,323,52,36149330,36149653
10153,4,11,1,2412,-91,-92,1,48:dd:0c:90:e3:85,36149988,382,-47,36149606,36149988
10154,6,24,1,2412,-87,-92,5,,36163927,28,13911,36163899,36163927
10155,6,24,1,2412,-85,-92,7,,36170034,28,6079,36170006,36170034
10156,6,6,1,2412,-67,-92,25,32:86:8c:5f:93:1e,36180579,332,10213,36180247,36180579
10157,4,1,1,2412,-63,-92,29,b0:e4:d5:32:ec:8a,36201842,1960,19303,36199882,36201842
10158,6,6,1,2412,-68,-92,24,10:86:8c:5f:93:1e,36208569,344,6383,36208225,36208569
10159,4,1,1,2412,-58,-92,34,94:a6:7e:c9:98:67,36209132,2464,-1901,36206668,36209132
10160,4,1,1,2412,-59,-92,33,94:a6:7e:c9:98:67,36211642,1968,542,36209674,36211642
10161,4,1,1,2412,-59,-92,33,94:a6:7e:c9:98:67,36213666,2128,-104,36211538,36213666
10162,4,1,1,2412,-89,-92,3,38:01:46:30:1a:ca,36215875,416,1793,36215459,36215875
10163,4,11,1,2412,-80,-92,12,48:dd:0c:7d:86:23,36227054,323,10856,36226731,36227054
10164,4,11,1,2412,-79,-92,13,48:dd:0c:7d:86:25,36227389,382,-47,36227007,36227389
10165,6,24,1,2412,-91,-92,1,,36231355,28,3938,36231327,36231355
10166,6,6,1,2412,-68,-92,24,12:86:8c:5f:93:1e,36231684,332,-3,36231352,36231684
10167,4,1,1,2412,-89,-92,3,38:01:46:30:1a:ca,36237135,416,5035,36236719,36237135
10168,4,11,1,2412,-86,-92,6,4c:01:43:ec:a0:69,36250144,361,12648,36249783,36250144
10169,4,11,1,2412,-86,-92,6,4c:01:43:ec:a0:63,36250518,322,52,36250196,36250518
10170,4,11,1,2412,-88,-92,4,4c:01:43:ec:a0:66,36250852,387,-53,36250465,36250852
10171,4,11,1,2412,-93,-92,-1,48:dd:0c:90:e3:87,36251678,362,464,36251316,36251678
10172,4,11,1,2412,-90,-92,2,48:dd:0c:90:e3:83,36252053,323,52,36251730,36252053
10173,4,11,1,2412,-91,-92,1,48:dd:0c:90:e3:85,36252388,382,-47,36252006,36252388
10174,4,1,1,2412,-86,-92,6,78:67:0e:c4:a8:42,36263904,2736,8780,36261168,36263904
10175,6,6,1,2412,-91,-92,1,3c:bd:c5:ee:96:6d,36275832,68,11860,36275764,36275832
10176,6,24,1,2412,-84,-92,8,,36277663,28,1803,36277635,36277663
10177,4,11,1,2412,-86,-92,6,,36278048,107,278,36277941,36278048
10178,6,24,1,2412,-84,-92,8,78:67:0e:c4:a8:42,36278163,32,83,36278131,36278163
10179,4,1,1,2412,-87,-92,5,78:67:0e:c4:a8:42,36281474,352,2959,36281122,36281474
10180,6,6,1,2412,-68,-92,24,32:86:8c:5f:93:1e,36282884,332,1078,36282552,36282884
10181,4,1,1,2412,-61,-92,31,b0:e4:d5:32:ec:8a,36304242,1960,19398,36302282,36304242
10182,6,6,1,2412,-68,-92,24,10:86:8c:5f:93:1e,36308484,344,3898,36308140,36308484
10183,4,1,1,2412,-58,-92,34,94:a6:7e:c9:98:67,36312420,2464,1472,36309956,36312420
10184,6,6,1,2412,-90,-92,2,,36318632,44,6168,36318588,36318632
10185,6,24,1,2412,-84,-92,8,,36322012,28,3352,36321984,36322012
10186,6,24,1,2412,-87,-92,5,,36323931,28,1891,36323903,36323931
10187,4,1,1,2412,-90,-92,2,78:67:0e:38:6c:d3,36326321,2736,-346,36323585,36326321
10188,4,11,1,2412,-78,-92,14,48:dd:0c:7d:86:27,36329080,362,2397,36328718,36329080
10189,4,11,1,2412,-79,-92,13,48:dd:0c:7d:86:23,36329455,323,52,36329132,36329455
10190,4,11,1,2412,-78,-92,14,48:dd:0c:7d:86:25,36329790,382,-47,36329408,36329790
10191,6,6,1,2412,-69,-92,23,12:86:8c:5f:93:1e,36334085,332,3963,36333753,36334085
10192,4,1,1,2412,-89,-92,3,,36342298,304,7909,36341994,36342298
10193,6,24,1,2412,-86,-92,6,4c:01:43:d7:f3:26,36344525,32,2195,36344493,36344525
10194,4,11,1,2412,-87,-92,5,4c:01:43:ec:a0:69,36352543,361,7657,36352182,36352543
10195,4,11,1,2412,-91,-92,1,48:dd:0c:90:e3:83,36354452,323,1586,36354129,36354452
10196,4,11,1,2412,-91,-92,1,48:dd:0c:90:e3:85,36354788,382,-46,36354406,36354788
10197,6,24,1,2412,-84,-92,8,,36355784,28,968,36355756,36355784
10198,6,24,1,2412,-87,-92,5,4c:01:43:d7:f3:26,36383011,32,27195,36382979,36383011
10199,6,6,1,2412,-67,-92,25,32:86:8c:5f:93:1e,36385285,332,1942,36384953,36385285
10200,4,1,1,2412,-86,-92,6,78:67:0e:c4:a8:42,36391079,352,5442,36390727,36391079
10201,4,11,1,2412,-85,-92,7,,36393060,107,1874,36392953,36393060
10202,6,24,1,2412,-89,-92,3,,36404949,28,11861,36404921,36404949
10203,4,1,1,2412,-61,-92,31,b0:e4:d5:32:ec:8a,36406641,1960,-268,36404681,36406641
10204,6,6,1,2412,-68,-92,24,10:86:8c:5f:93:1e,36410885,344,3900,36410541,36410885
10205,4,1,1,2412,-58,-92,34,94:a6:7e:c9:98:67,36413626,2464,277,36411162,36413626
10206,4,11,1,2412,-88,-92,4,4c:01:43:d7:f3:29,36416981,362,2993,36416619,36416981
10207,4,11,1,2412,-88,-92,4,4c:01:43:d7:f3:26,36417690,387,322,36417303,36417690
10208,4,1,1,2412,-89,-92,3,78:67:0e:38:6c:d3,36428721,2736,8295,36425985,36428721
10209,4,11,1,2412,-78,-92,14,48:dd:0c:7d:86:27,36431480,362,2397,36431118,36431480
10210,4,11,1,2412,-79,-92,13,48:dd:0c:7d:86:23,36431855,323,52,36431532,36431855
10211,4,11,1,2412,-78,-92,14,48:dd:0c:7d:86:25,36432190,382,-47,36431808,36432190
10212,4,11,1,2412,-78,-92,14,48:dd:0c:7d:86:25,36434044,377,1477,36433667,36434044
10213,4,11,1,2412,-92,-92,0,48:dd:0c:90:e3:85,36434785,377,364,36434408,36434785
10214,6,6,1,2412,-88,-92,4,40:b0:34:b7:01:d5,36435329,576,-32,36434753,36435329
10215,6,6,1,2412,-67,-92,25,12:86:8c:5f:93:1e,36436485,332,824,36436153,36436485
10216,6,24,1,2412,-85,-92,7,,36451454,28,14941,36451426,36451454
10217,4,11,1,2412,-84,-92,8,4c:01:43:ec:a0:63,36455316,322,3540,36454994,36455316
10218,4,11,1,2412,-86,-92,6,4c:01:43:ec:a0:66,36455650,387,-53,36455263,36455650
10219,4,11,1,2412,-91,-92,1,48:dd:0c:90:e3:87,36456478,362,466,36456116,36456478
10220,6,24,1,2412,-84,-92,8,,36484932,28,28426,36484904,36484932
10221,6,24,1,2412,-84,-92,8,,36485206,28,246,36485178,36485206
10222,6,24,1,2412,-84,-92,8,,36485664,28,430,36485636,36485664
10223,6,24,1,2412,-84,-92,8,,36486475,28,783,36486447,36486475
10224,6,24,1,2412,-84,-92,8,,36486823,28,320,36486795,36486823
10225,6,12,1,2412,-84,-92,8,4c:01:43:ec:a0:66,36487002,44,135,36486958,36487002
10226,6,24,1,2412,-84,-92,8,,36487723,28,693,36487695,36487723
10227,6,6,1,2412,-67,-92,25,32:86:8c:5f:93:1e,36488169,332,114,36487837,36488169
10228,4,11,1,2412,-77,-92,15,48:dd:0c:7d:86:25,36489344,377,798,36488967,36489344
10229,6,24,1,2412,-84,-92,8,,36505158,28,15786,36505130,36505158
10230,6,24,1,2412,-87,-92,5,4c:01:43:d7:f3:26,36506350,32,1160,36506318,36506350
10231,4,1,1,2412,-61,-92,31,b0:e4:d5:32:ec:8a,36509040,1960,730,36507080,36509040
10232,6,6,1,2412,-69,-92,23,10:86:8c:5f:93:1e,36515771,344,6387,36515427,36515771
10233,4,1,1,2412,-58,-92,34,94:a6:7e:c9:98:67,36516315,2464,-1920,36513851,36516315
10234,4,11,1,2412,-89,-92,3,4c:01:43:d7:f3:29,36519338,362,2661,36518976,36519338
10235,4,11,1,2412,-87,-92,5,4c:01:43:d7:f3:23,36519712,322,52,36519390,36519712
10236,7,13,1,2412,0,-92,92,4c:01:43:ec:a0:66,36523997,260,4025,36523737,36523997
10237,7,13,1,2412,-84,-92,8,4c:01:43:ec:a0:66,36523997,228,-228,36523769,36523997
10238,4,11,1,2412,-78,-92,14,48:dd:0c:7d:86:27,36533881,362,9522,36533519,36533881
10239,4,11,1,2412,-78,-92,14,48:dd:0c:7d:86:23,36534255,323,51,36533932,36534255
10240,4,11,1,2412,-79,-92,13,48:dd:0c:7d:86:25,36534591,382,-46,36534209,36534591
10241,4,1,1,2412,-87,-92,5,,36534930,304,35,36534626,36534930
10242,6,6,1,2412,-87,-92,5,40:b0:34:b7:01:d5,36537140,576,1634,36536564,36537140
10243,4,1,1,2412,-90,-92,2,,36553326,304,15882,36553022,36553326
10244,4,11,1,2412,-84,-92,8,4c:01:43:ec:a0:69,36557341,361,3654,36556980,36557341
10245,4,11,1,2412,-84,-92,8,4c:01:43:ec:a0:63,36557714,322,51,36557392,36557714
10246,4,11,1,2412,-84,-92,8,4c:01:43:ec:a0:66,36558049,387,-52,36557662,36558049
10247,4,11,1,2412,-91,-92,1,48:dd:0c:90:e3:87,36558877,362,466,36558515,36558877
10248,4,11,1,2412,-92,-92,0,48:dd:0c:90:e3:83,36559252,323,52,36558929,36559252
10249,6,6,1,2412,-90,-92,2,3c:bd:c5:ee:96:6d,36562524,68,3204,36562456,36562524
10250,6,24,1,2412,-87,-92,5,,36564256,28,1704,36564228,36564256
10251,4,1,1,2412,-85,-92,7,78:67:0e:c4:a8:42,36571104,2736,4112,36568368,36571104
10252,4,1,1,2412,-86,-92,6,78:67:0e:c4:a8:42,36573895,1488,1303,36572407,36573895
10253,4,1,1,2412,-87,-92,5,78:67:0e:c4:a8:42,36575393,1648,-150,36573745,36575393
10254,6,24,1,2412,-86,-92,6,4c:01:43:d7:f3:26,36587870,32,12445,36587838,36587870
10255,6,6,1,2412,-69,-92,23,32:86:8c:5f:93:1e,36590086,332,1884,36589754,36590086
10256,7,13,1,2412,-84,-92,8,4c:01:43:ec:a0:66,36594869,268,4515,36594601,36594869
10257,6,6,1,2412,-83,-92,9,4c:01:43:ec:a0:66,36596306,52,1385,36596254,36596306
10258,7,13,1,2412,-85,-92,7,4c:01:43:ec:a0:66,36596438,268,-136,36596170,36596438
10259,6,6,1,2412,-83,-92,9,4c:01:43:ec:a0:66,36597489,52,999,36597437,36597489
10260,6,6,1,2412,-84,-92,8,4c:01:43:ec:a0:66,36598403,52,862,36598351,36598403
10261,7,13,1,2412,-85,-92,7,4c:01:43:ec:a0:66,36598535,268,-136,36598267,36598535
10262,4,1,1,2412,-87,-92,5,,36600110,304,1271,36599806,36600110
10263,4,1,1,2412,-61,-92,31,b0:e4:d5:32:ec:8a,36611440,1960,9370,36609480,36611440
10264,6,6,1,2412,-67,-92,25,10:86:8c:5f:93:1e,36615686,344,3902,36615342,36615686
10265,4,1,1,2412,-57,-92,35,94:a6:7e:c9:98:67,36619267,2464,1117,36616803,36619267
10266,4,11,1,2412,-88,-92,4,4c:01:43:d7:f3:29,36622104,362,2475,36621742,36622104
10267,4,11,1,2412,-88,-92,4,4c:01:43:d7:f3:23,36622479,322,53,36622157,36622479
10268,6,24,1,2412,-87,-92,5,4c:01:43:d7:f3:26,36627996,32,5485,36627964,36627996
10269,6,24,1,2412,-88,-92,4,,36631362,28,3338,36631334,36631362
10270,4,11,1,2412,-78,-92,14,48:dd:0c:7d:86:27,36636281,362,4557,36635919,36636281
10271,4,11,1,2412,-78,-92,14,48:dd:0c:7d:86:23,36636655,323,51,36636332,36636655
10272,4,11,1,2412,-79,-92,13,48:dd:0c:7d:86:25,36636991,382,-46,36636609,36636991
10273,6,6,1,2412,-66,-92,26,12:86:8c:5f:93:1e,36641287,332,3964,36640955,36641287
10274,6,24,1,2412,-87,-92,5,,36643931,28,2616,36643903,36643931
10275,4,1,1,2412,-84,-92,8,,36653207,304,8972,36652903,36653207
10276,4,1,1,2412,-84,-92,8,,36657628,304,4117,36657324,36657628
10277,4,11,1,2412,-86,-92,6,4c:01:43:ec:a0:69,36659740,361,1751,36659379,36659740
10278,4,11,1,2412,-86,-92,6,4c:01:43:ec:a0:66,36660448,387,321,36660061,36660448
10279,4,11,1,2412,-91,-92,1,48:dd:0c:90:e3:87,36661277,362,467,36660915,36661277
10280,4,1,1,2412,-89,-92,3,,36670935,304,9354,36670631,36670935
10281,4,1,1,2412,-86,-92,6,78:67:0e:c4:a8:42,36673532,2736,-139,36670796,36673532
10282,6,6,1,2412,-67,-92,25,32:86:8c:5f:93:1e,36692487,332,18623,36692155,36692487
10283,4,1,1,2412,-86,-92,6,,36696614,304,3823,36696310,36696614
10284,6,6,1,2412,-90,-92,2,,36703939,44,7281,36703895,36703939
10285,6,6,1,2412,-91,-92,1,3c:bd:c5:ee:96:6d,36706591,68,2584,36706523,36706591
10286,4,1,1,2412,-88,-92,4,,36708203,304,1308,36707899,36708203
10287,6,6,1,2412,-86,-92,6,4c:01:43:d7:f3:26,36708705,68,434,36708637,36708705
10288,4,1,1,2412,-62,-92,30,b0:e4:d5:32:ec:8a,36713839,1960,3174,36711879,36713839
10289,4,1,1,2412,-59,-92,33,94:a6:7e:c9:98:67,36720825,2464,4522,36718361,36720825
10290,6,24,1,2412,-87,-92,5,,36723938,28,3085,36723910,36723938
10291,4,11,1,2412,-90,-92,2,4c:01:43:d7:f3:29,36724165,362,-135,36723803,36724165
10292,4,11,1,2412,-88,-92,4,4c:01:43:d7:f3:26,36724874,387,322,36724487,36724874
10293,6,6,1,2412,-92,-92,0,3c:bd:c5:ee:96:6d,36734644,68,9702,36734576,36734644
10294,4,11,1,2412,-72,-92,20,48:dd:0c:7d:86:23,36736545,323,1578,36736222,36736545
10295,4,11,1,2412,-78,-92,14,48:dd:0c:7d:86:25,36736880,382,-47,36736498,36736880
10296,6,6,1,2412,-86,-92,6,40:b0:34:b7:01:d5,36741942,576,4486,36741366,36741942
10297,6,6,1,2412,-68,-92,24,12:86:8c:5f:93:1e,36743688,332,1414,36743356,36743688
10298,4,1,1,2412,-86,-92,6,,36750242,304,6250,36749938,36750242
10299,6,6,1,2412,-67,-92,25,52:86:8c:5f:93:1e,36769937,332,19363,36769605,36769937
10300,4,1,1,2412,-86,-92,6,78:67:0e:c4:a8:42,36775903,2736,3230,36773167,36775903
10301,4,1,1,2412,-89,-92,3,78:67:0e:38:6c:d3,36784709,3472,5334,36781237,36784709
10302,4,11,1,2412,-89,-92,3,4c:01:43:d7:f3:26,36788548,383,3456,36788165,36788548
10303,6,6,1,2412,-67,-92,25,32:86:8c:5f:93:1e,36794888,332,6008,36794556,36794888
10304,4,11,1,2412,-84,-92,8,4c:01:43:ec:a0:66,36798995,382,3725,36798613,36798995
10305,6,24,1,2412,-83,-92,9,,36800922,28,1899,36800894,36800922
10306,6,24,1,2412,-88,-92,4,,36804319,28,3369,36804291,36804319
10307,4,1,1,2412,-61,-92,31,b0:e4:d5:32:ec:8a,36816238,1960,9959,36814278,36816238
10308,6,6,1,2412,-92,-92,0,,36818433,44,2151,36818389,36818433
10309,6,6,1,2412,-68,-92,24,10:86:8c:5f:93:1e,36822984,344,4207,36822640,36822984
10310,4,1,1,2412,-60,-92,32,94:a6:7e:c9:98:67,36823547,2464,-1901,36821083,36823547
10311,4,11,1,2412,-85,-92,7,4c:01:43:d7:f3:29,36826536,362,2627,36826174,36826536
10312,4,11,1,2412,-89,-92,3,4c:01:43:d7:f3:23,36826911,322,53,36826589,36826911
10313,4,11,1,2412,-89,-92,3,4c:01:43:d7:f3:26,36827245,387,-53,36826858,36827245
10314,4,1,1,2412,-86,-92,6,,36831240,304,3691,36830936,36831240
10315,4,11,1,2412,-41,-92,51,48:dd:0c:7d:86:23,36841456,323,9893,36841133,36841456
10316,4,11,1,2412,-78,-92,14,48:dd:0c:7d:86:25,36841791,382,-47,36841409,36841791
10317,6,6,1,2412,-87,-92,5,40:b0:34:b7:01:d5,36844343,576,1976,36843767,36844343
10318,6,6,1,2412,-67,-92,25,12:86:8c:5f:93:1e,36846088,332,1413,36845756,36846088
10319,4,1,1,2412,-87,-92,5,,36857412,304,11020,36857108,36857412
10320,6,6,1,2412,-89,-92,3,,36859091,44,1635,36859047,36859091
10321,6,6,1,2412,-88,-92,4,,36864160,44,5025,36864116,36864160
10322,6,24,1,2412,-83,-92,9,,36864301,28,113,36864273,36864301
10323,4,11,1,2412,-86,-92,6,4c:01:43:ec:a0:69,36864537,361,-125,36864176,36864537
10324,4,11,1,2412,-85,-92,7,4c:01:43:ec:a0:63,36864911,322,52,36864589,36864911
10325,4,11,1,2412,-85,-92,7,4c:01:43:ec:a0:66,36865246,387,-52,36864859,36865246
10326,6,24,1,2412,-84,-92,8,,36868490,28,3216,36868462,36868490
10327,6,24,1,2412,-84,-92,8,,36868790,28,272,36868762,36868790
10328,4,1,1,2412,-84,-92,8,4c:01:43:ec:a0:66,36870023,448,785,36869575,36870023
10329,6,24,1,2412,-87,-92,5,,36871360,28,1309,36871332,36871360
10330,4,1,1,2412,-87,-92,5,78:67:0e:c4:a8:42,36878303,2736,4207,36875567,36878303
10331,6,24,1,2412,-87,-92,5,,36882919,28,4588,36882891,36882919
10332,6,24,1,2412,-88,-92,4,,36883180,28,233,36883152,36883180
10333,4,1,1,2412,-88,-92,4,,36896663,304,13179,36896359,36896663
10334,6,6,1,2412,-68,-92,24,32:86:8c:5f:93:1e,36898687,332,1692,36898355,36898687
10335,4,1,1,2412,-87,-92,5,78:67:0e:c4:a8:42,36909285,352,10246,36908933,36909285
10336,4,11,1,2412,-85,-92,7,,36911197,107,1805,36911090,36911197
10337,6,24,1,2412,-84,-92,8,78:67:0e:c4:a8:42,36911312,32,83,36911280,36911312
10338,4,1,1,2412,-62,-92,30,b0:e4:d5:32:ec:8a,36918637,1960,5365,36916677,36918637
10339,6,6,1,2412,-67,-92,25,10:86:8c:5f:93:1e,36925372,344,6391,36925028,36925372
10340,4,1,1,2412,-58,-92,34,94:a6:7e:c9:98:67,36925908,2464,-1928,36923444,36925908
10341,4,1,1,2412,-89,-92,3,78:67:0e:38:6c:d3,36940723,2736,12079,36937987,36940723
10342,4,11,1,2412,-79,-92,13,48:dd:0c:7d:86:27,36943481,362,2396,36943119,36943481
10343,4,11,1,2412,-79,-92,13,48:dd:0c:7d:86:23,36943856,323,52,36943533,36943856
10344,6,6,1,2412,-68,-92,24,12:86:8c:5f:93:1e,36948489,332,4301,36948157,36948489
10345,6,24,1,2412,-88,-92,4,,36951362,28,2845,36951334,36951362
10346,4,1,1,2412,-90,-92,2,,36957485,304,5819,36957181,36957485
10347,6,24,1,2412,-89,-92,3,,36963941,28,6428,36963913,36963941
10348,4,11,1,2412,-84,-92,8,4c:01:43:ec:a0:69,36966941,361,2639,36966580,36966941
10349,6,24,1,2412,-87,-92,5,,36996434,28,29465,36996406,36996434
10350,6,6,1,2412,-68,-92,24,32:86:8c:5f:93:1e,36999689,332,2923,36999357,36999689
10351,6,24,1,2412,-84,-92,8,,37000500,28,783,37000472,37000500
10352,4,1,1,2412,-62,-93,31,b0:e4:d5:32:ec:8a,37021037,1960,18577,37019077,37021037
10353,4,1,1,2412,-90,-93,3,,37023373,304,2032,37023069,37023373
10354,6,6,1,2412,-68,-93,25,10:86:8c:5f:93:1e,37027775,344,4058,37027431,37027775
10355,4,1,1,2412,-57,-93,36,94:a6:7e:c9:98:67,37028329,2464,-1910,37025865,37028329
10356,4,11,1,2412,-88,-93,5,4c:01:43:d7:f3:29,37031335,362,2644,37030973,37031335
10357,4,11,1,2412,-89,-93,4,4c:01:43:d7:f3:23,37031710,322,53,37031388,37031710
10358,4,11,1,2412,-89,-93,4,4c:01:43:d7:f3:26,37032044,387,-53,37031657,37032044
10359,6,24,1,2412,-84,-93,9,,37037360,28,5288,37037332,37037360
10360,4,1,1,2412,-88,-93,5,78:67:0e:38:6c:d3,37043123,2736,3027,37040387,37043123
10361,4,11,1,2412,-79,-93,14,48:dd:0c:7d:86:27,37045882,362,2397,37045520,37045882
10362,4,11,1,2412,-79,-93,14,48:dd:0c:7d:86:23,37046257,323,52,37045934,37046257
10363,4,11,1,2412,-79,-93,14,48:dd:0c:7d:86:25,37046592,382,-47,37046210,37046592
10364,4,1,1,2412,-89,-93,4,78:67:0e:38:6c:d3,37048337,1056,689,37047281,37048337
10365,4,1,1,2412,-80,-93,13,78:67:0e:38:6c:d3,37049404,2208,-1141,37047196,37049404
10366,6,6,1,2412,-68,-93,25,12:86:8c:5f:93:1e,37051467,332,1731,37051135,37051467
10367,4,1,1,2412,-89,-93,4,,37064768,304,12997,37064464,37064768
10368,6,24,1,2412,-83,-93,10,,37069312,28,4516,37069284,37069312
10369,4,11,1,2412,-84,-93,9,4c:01:43:ec:a0:69,37069539,361,-134,37069178,37069539
10370,4,11,1,2412,-85,-93,8,4c:01:43:ec:a0:63,37069913,322,52,37069591,37069913
10371,4,11,1,2412,-89,-93,4,48:dd:0c:90:e3:87,37070876,362,601,37070514,37070876
10372,4,1,1,2412,-86,-93,7,,37075477,304,4297,37075173,37075477
10373,6,6,1,2412,-90,-93,3,3c:bd:c5:ee:96:6d,37075899,68,354,37075831,37075899
10374,4,1,1,2412,-86,-93,7,78:67:0e:c4:a8:42,37085251,2736,6616,37082515,37085251
10375,6,6,1,2412,-68,-93,25,32:86:8c:5f:93:1e,37102090,332,16507,37101758,37102090
10376,6,24,1,2412,-87,-93,6,,37111365,28,9247,37111337,37111365
10377,6,24,1,2412,-84,-93,9,,37122499,28,11106,37122471,37122499
10378,4,1,1,2412,-62,-93,31,b0:e4:d5:32:ec:8a,37123436,1960,-1023,37121476,37123436
10379,6,6,1,2412,-67,-93,26,10:86:8c:5f:93:1e,37127690,344,3910,37127346,37127690
10380,4,1,1,2412,-58,-93,35,94:a6:7e:c9:98:67,37130413,2464,259,37127949,37130413
10381,4,11,1,2412,-91,-93,2,4c:01:43:d7:f3:29,37133735,362,2960,37133373,37133735
10382,4,11,1,2412,-89,-93,4,4c:01:43:d7:f3:23,37134110,322,53,37133788,37134110
10383,4,1,1,2412,-91,-93,2,78:67:0e:38:6c:d3,37145523,2736,8677,37142787,37145523
10384,4,11,1,2412,-77,-93,16,48:dd:0c:7d:86:27,37148282,362,2397,37147920,37148282
10385,4,11,1,2412,-79,-93,14,48:dd:0c:7d:86:23,37148656,323,51,37148333,37148656
10386,4,11,1,2412,-79,-93,14,48:dd:0c:7d:86:25,37148992,382,-46,37148610,37148992
10387,6,6,1,2412,-85,-93,8,40:b0:34:b7:01:d5,37151547,576,1979,37150971,37151547
10388,6,24,1,2412,-85,-93,8,,37153989,28,2414,37153961,37153989
10389,4,1,1,2412,-91,-93,2,,37155756,304,1463,37155452,37155756
10390,6,6,1,2412,-69,-93,24,12:86:8c:5f:93:1e,37156051,332,-37,37155719,37156051
10391,4,11,1,2412,-84,-93,9,4c:01:43:ec:a0:69,37171734,361,15322,37171373,37171734
10392,4,11,1,2412,-84,-93,9,4c:01:43:ec:a0:63,37172108,322,52,37171786,37172108
10393,4,11,1,2412,-85,-93,8,4c:01:43:ec:a0:66,37172442,387,-53,37172055,37172442
10394,4,11,1,2412,-90,-93,3,48:dd:0c:90:e3:83,37173650,323,885,37173327,37173650
10395,4,1,1,2412,-86,-93,7,,37183039,304,9085,37182735,37183039
10396,4,1,1,2412,-89,-93,4,,37183309,304,-34,37183005,37183309
10397,6,6,1,2412,-90,-93,3,,37184445,44,1092,37184401,37184445
10398,6,24,1,2412,-88,-93,5,,37191369,28,6896,37191341,37191369
10399,6,24,1,2412,-84,-93,9,,37196463,28,5066,37196435,37196463
10400,6,6,1,2412,-66,-93,27,32:86:8c:5f:93:1e,37204491,332,7696,37204159,37204491
10401,6,24,1,2412,-89,-93,4,,37206278,28,1759,37206250,37206278
10402,4,11,1,2412,-86,-93,7,,37214380,107,7995,37214273,37214380
10403,6,24,1,2412,-85,-93,8,78:67:0e:c4:a8:42,37214495,32,83,37214463,37214495
10404,4,1,1,2412,-62,-93,31,b0:e4:d5:32:ec:8a,37225835,1960,9380,37223875,37225835
10405,6,6,1,2412,-66,-93,27,10:86:8c:5f:93:1e,37230183,344,4004,37229839,37230183
10406,4,1,1,2412,-61,-93,32,94:a6:7e:c9:98:67,37233057,2464,410,37230593,37233057
10407,4,11,1,2412,-87,-93,6,4c:01:43:d7:f3:29,37236135,362,2716,37235773,37236135
10408,4,11,1,2412,-87,-93,6,4c:01:43:d7:f3:23,37236509,322,52,37236187,37236509
10409,4,11,1,2412,-89,-93,4,4c:01:43:d7:f3:26,37236844,387,-52,37236457,37236844
10410,4,1,1,2412,-89,-93,4,,37239852,304,2704,37239548,37239852
10411,4,11,1,2412,-78,-93,15,48:dd:0c:7d:86:23,37251057,323,10882,37250734,37251057
10412,4,11,1,2412,-79,-93,14,48:dd:0c:7d:86:25,37251392,382,-47,37251010,37251392
10413,4,1,1,2412,-87,-93,6,,37253016,304,1320,37252712,37253016
10414,6,6,1,2412,-86,-93,7,40:b0:34:b7:01:d5,37253948,576,356,37253372,37253948
10415,6,6,1,2412,-68,-93,25,12:86:8c:5f:93:1e,37258394,332,4114,37258062,37258394
10416,4,1,1,2412,-89,-93,4,54:65:de:91:d4:c0,37262903,2632,1877,37260271,37262903
10417,4,11,1,2412,-84,-93,9,4c:01:43:ec:a0:69,37274133,361,10869,37273772,37274133
10418,4,11,1,2412,-83,-93,10,4c:01:43:ec:a0:63,37274506,322,51,37274184,37274506
10419,4,11,1,2412,-85,-93,8,4c:01:43:ec:a0:66,37274841,387,-52,37274454,37274841
10420,4,11,1,2412,-91,-93,2,48:dd:0c:90:e3:87,37275676,362,473,37275314,37275676
10421,4,11,1,2412,-91,-93,2,48:dd:0c:90:e3:83,37276050,323,51,37275727,37276050
10422,4,1,1,2412,-87,-93,6,78:67:0e:c4:a8:42,37278929,352,2527,37278577,37278929
10423,6,24,1,2412,-88,-93,5,,37284312,28,5355,37284284,37284312
10424,6,24,1,2412,-84,-93,9,,37308980,28,24640,37308952,37308980
10425,4,1,1,2412,-90,-93,3,,37318476,304,9192,37318172,37318476
10426,4,1,1,2412,-60,-93,33,b0:e4:d5:32:ec:8a,37328234,1960,7798,37326274,37328234
10427,4,11,1,2412,-87,-93,6,4c:01:43:d7:f3:29,37338534,362,9938,37338172,37338534
10428,4,11,1,2412,-72,-93,21,4c:01:43:d7:f3:26,37339243,387,322,37338856,37339243
10429,6,6,1,2412,-89,-93,4,3c:bd:c5:ee:96:6d,37339742,68,431,37339674,37339742
10430,4,1,1,2412,-89,-93,4,,37349452,304,9406,37349148,37349452
10431,4,1,1,2412,-88,-93,5,78:67:0e:38:6c:d3,37350324,2736,-1864,37347588,37350324
10432,4,11,1,2412,-80,-93,13,48:dd:0c:7d:86:27,37353083,362,2397,37352721,37353083
10433,4,11,1,2412,-78,-93,15,48:dd:0c:7d:86:23,37353457,323,51,37353134,37353457
10434,4,11,1,2412,-80,-93,13,48:dd:0c:7d:86:25,37353792,382,-47,37353410,37353792
10435,6,24,1,2412,-85,-93,8,,37354849,28,1029,37354821,37354849
10436,4,1,1,2412,-90,-93,3,78:67:0e:38:6c:d3,37355513,2208,-1544,37353305,37355513
10437,6,6,1,2412,-85,-93,8,40:b0:34:b7:01:d5,37357602,576,1513,37357026,37357602
10438,6,6,1,2412,-66,-93,27,12:86:8c:5f:93:1e,37358204,332,270,37357872,37358204
10439,4,1,1,2412,-89,-93,4,,37371411,304,12903,37371107,37371411
10440,4,1,1,2412,-89,-93,4,,37374380,304,2665,37374076,37374380
10441,6,6,1,2412,-92,-93,1,3c:bd:c5:ee:96:6d,37374897,68,449,37374829,37374897
10442,4,11,1,2412,-85,-93,8,4c:01:43:ec:a0:69,37376531,361,1273,37376170,37376531
10443,4,11,1,2412,-83,-93,10,4c:01:43:ec:a0:63,37376905,322,52,37376583,37376905
10444,4,1,1,2412,-87,-93,6,,37377708,304,499,37377404,37377708
10445,6,24,1,2412,-85,-93,8,,37387369,28,9633,37387341,37387369
10446,4,1,1,2412,-87,-93,6,78:67:0e:c4:a8:42,37390303,2736,198,37387567,37390303
10447,4,1,1,2412,-89,-93,4,,37397388,304,6781,37397084,37397388
10448,6,24,1,2412,-85,-93,8,,37403908,28,6492,37403880,37403908
10449,4,1,1,2412,-87,-93,6,78:67:0e:c4:a8:42,37405258,352,998,37404906,37405258
10450,4,11,1,2412,-87,-93,6,,37407136,107,1771,37407029,37407136
10451,6,6,1,2412,-67,-93,26,32:86:8c:5f:93:1e,37409292,332,1824,37408960,37409292
10452,4,1,1,2412,-62,-93,31,b0:e4:d5:32:ec:8a,37430634,1960,19382,37428674,37430634
10453,4,1,1,2412,-89,-93,4,,37434092,304,3154,37433788,37434092
10454,6,6,1,2412,-67,-93,26,10:86:8c:5f:93:1e,37437387,344,2951,37437043,37437387
10455,4,1,1,2412,-59,-93,34,94:a6:7e:c9:98:67,37437922,2464,-1929,37435458,37437922
10456,4,11,1,2412,-85,-93,8,4c:01:43:d7:f3:23,37441308,322,3064,37440986,37441308
10457,4,11,1,2412,-89,-93,4,4c:01:43:d7:f3:26,37441643,387,-52,37441256,37441643
10458,6,6,1,2412,-68,-93,25,b4:e6:2d:b4:ff:71,37442317,64,610,37442253,37442317
10459,6,6,1,2412,-68,-93,25,,37442397,44,36,37442353,37442397
10460,4,1,1,2412,-89,-93,4,,37447948,304,5247,37447644,37447948
10461,4,1,1,2412,-88,-93,5,,37451500,304,3248,37451196,37451500
10462,4,1,1,2412,-86,-93,7,,37455468,304,3664,37455164,37455468
10463,6,6,1,2412,-68,-93,25,12:86:8c:5f:93:1e,37462718,332,6918,37462386,37462718
10464,4,1,1,2412,-89,-93,4,,37471756,304,8734,37471452,37471756
10465,4,1,1,2412,-90,-93,3,,37476563,304,4503,37476259,37476563
10466,4,1,1,2412,-90,-93,3,,37478572,304,1705,37478268,37478572
10467,4,11,1,2412,-85,-93,8,4c:01:43:ec:a0:63,37479304,322,410,37478982,37479304
10468,4,11,1,2412,-85,-93,8,4c:01:43:ec:a0:66,37479639,387,-52,37479252,37479639
10469,4,1,1,2412,-90,-93,3,,37490892,304,10949,37490588,37490892
10470,4,1,1,2412,-88,-93,5,78:67:0e:c4:a8:42,37492703,2736,-925,37489967,37492703
10471,4,1,1,2412,-89,-93,4,,37496086,304,3079,37495782,37496086
10472,4,1,1,2412,-90,-93,3,,37497420,304,1030,37497116,37497420
10473,6,24,1,2412,-84,-93,9,,37503921,28,6473,37503893,37503921
10474,4,1,1,2412,-89,-93,4,,37504620,304,395,37504316,37504620
10475,6,24,1,2412,-88,-93,5,,37511369,28,6721,37511341,37511369
10476,6,6,1,2412,-67,-93,26,32:86:8c:5f:93:1e,37511693,332,-8,37511361,37511693
10477,4,1,1,2412,-87,-93,6,,37513483,304,1486,37513179,37513483
10478,4,1,1,2412,-88,-93,5,,37515982,304,2195,37515678,37515982
10479,4,1,1,2412,-90,-93,3,,37519049,304,2763,37518745,37519049
10480,4,1,1,2412,-89,-93,4,,37521323,304,1970,37521019,37521323
10481,4,1,1,2412,-89,-93,4,,37528780,304,7153,37528476,37528780
10482,4,1,1,2412,-88,-93,5,,37531212,304,2128,37530908,37531212
10483,4,1,1,2412,-61,-93,32,b0:e4:d5:32:ec:8a,37533033,1960,-139,37531073,37533033
10484,4,1,1,2412,-88,-93,5,,37539428,304,6091,37539124,37539428
10485,6,6,1,2412,-69,-93,24,10:86:8c:5f:93:1e,37539775,344,3,37539431,37539775
10486,4,1,1,2412,-58,-93,35,94:a6:7e:c9:98:67,37541001,2464,-1238,37538537,37541001
10487,4,11,1,2412,-86,-93,7,4c:01:43:d7:f3:26,37544042,387,2654,37543655,37544042
10488,4,1,1,2412,-87,-93,6,,37545989,304,1643,37545685,37545989
10489,4,1,1,2412,-87,-93,6,,37547180,304,887,37546876,37547180
10490,6,24,1,2412,-84,-93,9,,37547998,28,790,37547970,37547998
10491,4,1,1,2412,-88,-93,5,,37553580,304,5278,37553276,37553580
10492,4,1,1,2412,-90,-93,3,78:67:0e:38:6c:d3,37555124,2736,-1192,37552388,37555124
10493,4,11,1,2412,-79,-93,14,48:dd:0c:7d:86:23,37558258,323,2811,37557935,37558258
10494,4,11,1,2412,-74,-93,19,48:dd:0c:7d:86:25,37558593,382,-47,37558211,37558593
10495,6,6,1,2412,-67,-93,26,12:86:8c:5f:93:1e,37562893,332,3968,37562561,37562893
10496,4,1,1,2412,-86,-93,7,,37573579,304,10382,37573275,37573579
10497,4,11,1,2412,-78,-93,15,48:dd:0c:7d:86:23,37575651,254,1818,37575397,37575651
10498,4,1,1,2412,-87,-93,6,,37579461,304,3506,37579157,37579461
10499,4,11,1,2412,-84,-93,9,4c:01:43:ec:a0:63,37581703,322,1920,37581381,37581703
10500,4,11,1,2412,-84,-93,9,4c:01:43:ec:a0:66,37582037,387,-53,37581650,37582037
10501,4,1,1,2412,-89,-93,4,,37582475,304,134,37582171,37582475
10502,4,1,1,2412,-89,-93,4,,37585468,304,2689,37585164,37585468
10503,4,1,1,2412,-88,-93,5,,37586572,304,800,37586268,37586572
10504,4,1,1,2412,-89,-93,4,,37587915,304,1039,37587611,37587915
10505,6,24,1,2412,-89,-93,4,,37591379,28,3436,37591351,37591379
10506,6,24,1,2412,-84,-93,9,,37591411,28,4,37591383,37591411
10507,4,1,1,2412,-89,-93,4,,37598486,304,6771,37598182,37598486
10508,4,1,1,2412,-88,-93,5,,37602731,304,3941,37602427,37602731
10509,6,24,1,2412,-86,-93,7,,37603947,28,1188,37603919,37603947
10510,6,6,1,2412,-90,-93,3,3c:bd:c5:ee:96:6d,37608253,68,4238,37608185,37608253
10511,6,24,1,2412,-85,-93,8,,37611988,28,3707,37611960,37611988
10512,6,6,1,2412,-69,-93,24,32:86:8c:5f:93:1e,37614094,332,1774,37613762,37614094
10513,4,1,1,2412,-85,-93,8,,37616683,304,2285,37616379,37616683
10514,4,1,1,2412,-89,-93,4,,37618955,304,1968,37618651,37618955
10515,6,6,1,2412,-90,-93,3,3c:bd:c5:ee:96:6d,37623834,68,4811,37623766,37623834
10516,4,1,1,2412,-89,-93,4,,37627147,304,3009,37626843,37627147
10517,4,1,1,2412,-88,-93,5,,37629292,304,1841,37628988,37629292
10518,4,1,1,2412,-88,-93,5,,37633747,304,4151,37633443,37633747
10519,4,1,1,2412,-61,-93,32,b0:e4:d5:32:ec:8a,37635432,1960,-275,37633472,37635432
10520,4,1,1,2412,-88,-93,5,,37641185,304,5449,37640881,37641185
10521,6,6,1,2412,-67,-93,26,10:86:8c:5f:93:1e,37642199,344,670,37641855,37642199
10522,4,1,1,2412,-59,-93,34,94:a6:7e:c9:98:67,37642753,2464,-1910,37640289,37642753
10523,4,1,1,2412,-90,-93,3,,37656715,304,13658,37656411,37656715
10524,4,11,1,2412,-89,-93,4,48:dd:0c:7d:86:23,37658144,323,1106,37657821,37658144
10525,4,11,1,2412,-78,-93,15,48:dd:0c:7d:86:25,37658479,382,-47,37658097,37658479
10526,6,6,1,2412,-67,-93,26,12:86:8c:5f:93:1e,37667517,332,8706,37667185,37667517
10527,4,1,1,2412,-87,-93,6,,37674187,304,6366,37673883,37674187
10528,4,11,1,2412,-85,-93,8,4c:01:43:ec:a0:69,37683728,361,9180,37683367,37683728
10529,4,11,1,2412,-86,-93,7,4c:01:43:ec:a0:63,37684102,322,52,37683780,37684102
10530,4,11,1,2412,-86,-93,7,4c:01:43:ec:a0:66,37684436,387,-53,37684049,37684436
10531,4,1,1,2412,-85,-93,8,3c:bd:c5:ee:96:6d,37693538,976,8126,37692562,37693538
10532,4,1,1,2412,-87,-93,6,78:67:0e:c4:a8:42,37697502,2736,1228,37694766,37697502
10533,4,1,1,2412,-88,-93,5,,37700885,304,3079,37700581,37700885
10534,6,6,1,2412,-89,-93,4,3c:bd:c5:ee:96:6d,37704027,68,3074,37703959,37704027
10535,6,24,1,2412,-84,-93,9,,37704571,28,516,37704543,37704571
10536,4,1,1,2412,-88,-93,5,,37716332,304,11457,37716028,37716332
10537,6,6,1,2412,-70,-93,23,32:86:8c:5f:93:1e,37716494,332,-170,37716162,37716494
10538,4,1,1,2412,-88,-93,5,,37722539,304,5741,37722235,37722539
10539,4,1,1,2412,-61,-93,32,b0:e4:d5:32:ec:8a,37737831,1960,13332,37735871,37737831
10540,4,1,1,2412,-55,-93,38,94:a6:7e:c9:98:67,37744820,2464,4525,37742356,37744820
10541,6,24,1,2412,-85,-93,8,,37747445,28,2597,37747417,37747445
10542,6,24,1,2412,-88,-93,5,,37752433,28,4960,37752405,37752433
10543,4,11,1,2412,-77,-93,16,48:dd:0c:7d:86:27,37762684,362,9889,37762322,37762684
10544,4,11,1,2412,-78,-93,15,48:dd:0c:7d:86:23,37763058,323,51,37762735,37763058
10545,4,11,1,2412,-69,-93,24,48:dd:0c:7d:86:25,37763394,382,-46,37763012,37763394
10546,6,6,1,2412,-69,-93,24,12:86:8c:5f:93:1e,37769917,332,6191,37769585,37769917
10547,4,1,1,2412,-87,-93,6,,37773643,304,3422,37773339,37773643
10548,6,6,1,2412,-82,-93,11,,37802703,44,29016,37802659,37802703
10549,6,24,1,2412,-86,-93,7,,37803917,28,1186,37803889,37803917
10550,4,1,1,2412,-86,-93,7,,37816619,304,12398,37816315,37816619
10551,6,6,1,2412,-67,-93,26,32:86:8c:5f:93:1e,37818895,332,1944,37818563,37818895
10552,4,1,1,2412,-87,-93,6,,37824075,304,4876,37823771,37824075
10553,6,24,1,2412,-88,-93,5,,37831375,28,7272,37831347,37831375
10554,4,1,1,2412,-63,-93,30,b0:e4:d5:32:ec:8a,37840231,1960,6896,37838271,37840231
10555,6,24,1,2412,-88,-93,5,,37843952,28,3693,37843924,37843952
10556,4,1,1,2412,-58,-93,35,94:a6:7e:c9:98:67,37847480,2464,1064,37845016,37847480
10557,6,6,1,2412,-68,-93,25,10:86:8c:5f:93:1e,37849800,344,1976,37849456,37849800
10558,4,1,1,2412,-59,-93,34,94:a6:7e:c9:98:67,37850420,3848,-3228,37846572,37850420
10559,4,1,1,2412,-58,-93,35,94:a6:7e:c9:98:67,37854314,4008,-114,37850306,37854314
10560,6,6,1,2412,-68,-93,25,12:86:8c:5f:93:1e,37870095,332,15449,37869763,37870095
10561,6,6,1,2412,-90,-93,3,3c:bd:c5:ee:96:6d,37887019,68,16856,37886951,37887019
10562,4,11,1,2412,-86,-93,7,4c:01:43:ec:a0:69,37888526,361,1146,37888165,37888526
10563,4,11,1,2412,-85,-93,8,4c:01:43:ec:a0:63,37888899,322,51,37888577,37888899
10564,4,11,1,2412,-85,-93,8,4c:01:43:ec:a0:66,37889234,387,-52,37888847,37889234
10565,4,11,1,2412,-86,-93,7,4c:01:43:ec:a0:63,37891535,254,2047,37891281,37891535
10566,4,11,1,2412,-90,-93,3,4c:01:43:d7:f3:23,37891842,254,53,37891588,37891842
10567,6,6,1,2412,-90,-93,3,,37906121,44,14235,37906077,37906121
10568,6,24,1,2412,-89,-93,4,,37911383,28,5234,37911355,37911383
10569,4,1,1,2412,-86,-93,7,,37912290,304,603,37911986,37912290
10570,4,11,1,2412,-85,-93,8,,37914318,107,1921,37914211,37914318
10571,6,24,1,2412,-85,-93,8,78:67:0e:c4:a8:42,37914431,32,81,37914399,37914431
10572,6,6,1,2412,-68,-93,25,32:86:8c:5f:93:1e,37921295,332,6532,37920963,37921295
10573,6,24,1,2412,-88,-93,5,,37923954,28,2631,37923926,37923954
10574,4,1,1,2412,-62,-93,31,b0:e4:d5:32:ec:8a,37942630,1960,16716,37940670,37942630
10575,6,6,1,2412,-68,-93,25,10:86:8c:5f:93:1e,37949401,344,6427,37949057,37949401
10576,4,1,1,2412,-58,-93,35,94:a6:7e:c9:98:67,37949937,2464,-1928,37947473,37949937
10577,4,11,1,2412,-89,-93,4,4c:01:43:d7:f3:23,37953333,322,3074,37953011,37953333
10578,4,11,1,2412,-89,-93,4,4c:01:43:d7:f3:26,37953667,387,-53,37953280,37953667
10579,4,11,1,2412,-78,-93,15,48:dd:0c:7d:86:25,37968193,382,14144,37967811,37968193
10580,4,1,1,2412,-92,-93,1,70:3a:cb:63:35:b2,37972644,2216,2235,37970428,37972644
10581,6,6,1,2412,-67,-93,26,12:86:8c:5f:93:1e,37974716,332,1740,37974384,37974716
10582,4,11,1,2412,-79,-93,14,4c:01:43:ec:a0:69,37990925,361,15848,37990564,37990925
10583,4,11,1,2412,-86,-93,7,4c:01:43:ec:a0:63,37991298,322,51,37990976,37991298
10584,4,11,1,2412,-86,-93,7,4c:01:43:ec:a0:66,37991633,387,-52,37991246,37991633
10585,6,24,1,2412,-88,-93,5,,37991919,28,258,37991891,37991919
10586,6,24,1,2412,-88,-93,5,,38004488,28,12541,38004460,38004488
10587,6,6,1,2412,-84,-93,9,,38007949,44,3417,38007905,38007949
10588,4,1,1,2412,-66,-93,27,,38018046,304,9793,38017742,38018046
10589,7,52,1,2412,-68,-93,25,10:86:8c:5f:93:1e,38018197,52,99,38018145,38018197
10590,4,1,1,2412,-65,-93,28,,38018541,304,40,38018237,38018541
10591,7,39,1,2412,-67,-93,26,10:86:8c:5f:93:1e,38018693,60,92,38018633,38018693
10592,6,24,1,2412,-67,-93,26,,38018769,28,48,38018741,38018769
10593,7,26,1,2412,-67,-93,26,b4:e6:2d:b4:ff:71,38020485,68,1648,38020417,38020485
10594,6,24,1,2412,-68,-93,25,10:86:8c:5f:93:1e,38020561,32,44,38020529,38020561
10595,6,6,1,2412,-67,-93,26,32:86:8c:5f:93:1e,38023696,332,2803,38023364,38023696
10596,4,1,1,2412,-87,-93,6,,38024747,304,747,38024443,38024747
10597,4,1,1,2412,-60,-93,33,b0:e4:d5:32:ec:8a,38045029,1960,18322,38043069,38045029
10598,6,24,1,2412,-84,-93,9,,38049080,28,4023,38049052,38049080
10599,6,6,1,2412,-68,-93,25,10:86:8c:5f:93:1e,38049437,344,13,38049093,38049437
10600,4,1,1,2412,-59,-93,34,94:a6:7e:c9:98:67,38052271,2464,370,38049807,38052271
10601,4,11,1,2412,-69,-93,24,10:86:8c:5f:93:1e,38054995,347,2377,38054648,38054995
10602,4,11,1,2412,-89,-93,4,4c:01:43:d7:f3:29,38055364,362,7,38055002,38055364
10603,4,11,1,2412,-86,-93,7,4c:01:43:d7:f3:26,38056073,387,322,38055686,38056073
10604,4,1,1,2412,-82,-93,11,78:67:0e:38:6c:d3,38067125,2736,8316,38064389,38067125
10605,4,11,1,2412,-78,-93,15,48:dd:0c:7d:86:27,38069884,362,2397,38069522,38069884
10606,4,11,1,2412,-77,-93,16,48:dd:0c:7d:86:25,38070594,382,328,38070212,38070594
10607,6,24,1,2412,-87,-93,6,,38072164,28,1542,38072136,38072164
10608,6,6,1,2412,-67,-93,26,12:86:8c:5f:93:1e,38074897,332,2401,38074565,38074897
10609,4,1,1,2412,-89,-93,4,,38088763,304,13562,38088459,38088763
10610,4,11,1,2412,-84,-93,9,4c:01:43:ec:a0:69,38093323,361,4199,38092962,38093323
10611,4,11,1,2412,-86,-93,7,4c:01:43:ec:a0:63,38093697,322,52,38093375,38093697
10612,4,11,1,2412,-86,-93,7,4c:01:43:ec:a0:66,38094032,387,-52,38093645,38094032
10613,4,1,1,2412,-90,-93,3,,38117898,304,23562,38117594,38117898
10614,6,6,1,2412,-68,-93,25,32:86:8c:5f:93:1e,38126097,332,7867,38125765,38126097
10615,6,6,1,2412,-90,-93,3,3c:bd:c5:ee:96:6d,38133782,68,7617,38133714,38133782
10616,4,11,1,2412,-85,-93,8,4c:01:43:ec:a0:63,38136708,254,2672,38136454,38136708
10617,4,11,1,2412,-89,-93,4,4c:01:43:d7:f3:23,38138118,254,1156,38137864,38138118
10618,6,24,1,2412,-85,-93,8,,38147069,28,8923,38147041,38147069
10619,4,1,1,2412,-61,-93,32,b0:e4:d5:32:ec:8a,38148147,1960,-882,38146187,38148147
10620,6,6,1,2412,-67,-93,26,10:86:8c:5f:93:1e,38151697,344,3206,38151353,38151697
10621,4,1,1,2412,-59,-93,34,94:a6:7e:c9:98:67,38155139,2464,978,38152675,38155139
10622,4,11,1,2412,-87,-93,6,4c:01:43:d7:f3:23,38158105,322,2644,38157783,38158105
10623,4,11,1,2412,-88,-93,5,4c:01:43:d7:f3:26,38158439,387,-53,38158052,38158439
10624,6,6,1,2412,-91,-93,2,,38163447,44,4964,38163403,38163447
10625,6,24,1,2412,-87,-93,6,,38163955,28,480,38163927,38163955
10626,4,1,1,2412,-83,-93,10,,38166090,304,1831,38165786,38166090
10627,6,24,1,2412,-86,-93,7,,38169205,28,3087,38169177,38169205
10628,4,11,1,2412,-77,-93,16,48:dd:0c:7d:86:23,38172858,323,3330,38172535,38172858
10629,4,11,1,2412,-77,-93,16,48:dd:0c:7d:86:25,38173193,382,-47,38172811,38173193
10630,6,6,1,2412,-67,-93,26,12:86:8c:5f:93:1e,38177297,332,3772,38176965,38177297
10631,6,24,1,2412,-86,-93,7,,38187373,28,10048,38187345,38187373
10632,4,11,1,2412,-86,-93,7,4c:01:43:ec:a0:69,38195722,361,7988,38195361,38195722
10633,4,11,1,2412,-86,-93,7,4c:01:43:ec:a0:63,38196096,322,52,38195774,38196096
10634,4,1,1,2412,-87,-93,6,,38202569,304,6169,38202265,38202569
10635,4,1,1,2412,-88,-93,5,,38218387,304,15514,38218083,38218387
10636,4,1,1,2412,-85,-93,8,,38220297,304,1606,38219993,38220297
10637,6,24,1,2412,-87,-93,6,,38231383,28,11058,38231355,38231383
10638,6,24,1,2412,-86,-93,7,,38243961,28,12550,38243933,38243961
10639,6,6,1,2412,-89,-93,4,3c:bd:c5:ee:96:6d,38244035,68,6,38243967,38244035
10640,6,6,1,2412,-89,-93,4,3c:bd:c5:ee:96:6d,38244719,68,616,38244651,38244719
10641,6,24,1,2412,-88,-93,5,,38248889,28,4142,38248861,38248889
10642,6,6,1,2412,-91,-93,2,3c:bd:c5:ee:96:6d,38249538,68,581,38249470,38249538
10643,4,1,1,2412,-61,-93,32,b0:e4:d5:32:ec:8a,38249828,1960,-1670,38247868,38249828
10644,6,6,1,2412,-68,-93,25,10:86:8c:5f:93:1e,38254098,344,3926,38253754,38254098
10645,4,1,1,2412,-59,-93,34,94:a6:7e:c9:98:67,38262763,2464,6201,38260299,38262763
10646,4,11,1,2412,-77,-93,16,48:dd:0c:7d:86:27,38272168,362,9043,38271806,38272168
10647,4,11,1,2412,-77,-93,16,48:dd:0c:7d:86:23,38272542,323,51,38272219,38272542
10648,4,11,1,2412,-79,-93,14,48:dd:0c:7d:86:25,38272878,382,-46,38272496,38272878
10649,4,11,1,2412,-85,-93,8,4c:01:43:ec:a0:69,38298121,361,24882,38297760,38298121
10650,4,11,1,2412,-85,-93,8,4c:01:43:ec:a0:63,38298495,322,52,38298173,38298495
10651,4,11,1,2412,-84,-93,9,4c:01:43:ec:a0:66,38298829,387,-53,38298442,38298829
10652,4,1,1,2412,-86,-93,7,,38303218,304,4085,38302914,38303218
10653,4,11,1,2412,-86,-93,7,,38303589,107,264,38303482,38303589
10654,6,24,1,2412,-86,-93,7,78:67:0e:c4:a8:42,38303702,32,81,38303670,38303702
10655,6,6,1,2412,-90,-93,3,3c:bd:c5:ee:96:6d,38308095,68,4325,38308027,38308095
10656,6,24,1,2412,-85,-93,8,,38311383,28,3260,38311355,38311383
10657,4,1,1,2412,-87,-93,6,78:67:0e:c4:a8:42,38315311,2736,1192,38312575,38315311
10658,6,6,1,2412,-90,-93,3,3c:bd:c5:ee:96:6d,38321076,68,5697,38321008,38321076
10659,4,1,1,2412,-87,-93,6,,38321641,304,261,38321337,38321641
10660,6,6,1,2412,-68,-93,25,32:86:8c:5f:93:1e,38330898,332,8925,38330566,38330898
10661,4,1,1,2412,-87,-93,6,,38335049,304,3847,38334745,38335049
10662,6,6,1,2412,-91,-93,2,3c:bd:c5:ee:96:6d,38338802,68,3685,38338734,38338802
10663,6,6,1,2412,-90,-93,3,,38339328,44,482,38339284,38339328
10664,4,1,1,2412,-62,-93,31,b0:e4:d5:32:ec:8a,38352227,1960,10939,38350267,38352227
10665,6,24,1,2412,-86,-93,7,,38355176,28,2921,38355148,38355176
10666,6,6,1,2412,-70,-93,23,10:86:8c:5f:93:1e,38358979,344,3459,38358635,38358979
10667,4,1,1,2412,-59,-93,34,94:a6:7e:c9:98:67,38359515,2464,-1928,38357051,38359515
10668,4,11,1,2412,-87,-93,6,4c:01:43:d7:f3:23,38362904,322,3067,38362582,38362904
10669,4,11,1,2412,-87,-93,6,4c:01:43:d7:f3:26,38363239,387,-52,38362852,38363239
10670,4,1,1,2412,-88,-93,5,78:67:0e:38:6c:d3,38374326,2736,8351,38371590,38374326
10671,4,11,1,2412,-78,-93,15,48:dd:0c:7d:86:27,38377085,362,2397,38376723,38377085
10672,4,11,1,2412,-78,-93,15,48:dd:0c:7d:86:23,38377459,323,51,38377136,38377459
10673,4,11,1,2412,-76,-93,17,48:dd:0c:7d:86:25,38377795,382,-46,38377413,38377795
10674,6,6,1,2412,-69,-93,24,12:86:8c:5f:93:1e,38384314,332,6187,38383982,38384314
10675,6,6,1,2412,-90,-93,3,3c:bd:c5:ee:96:6d,38397374,68,12992,38397306,38397374
10676,6,24,1,2412,-86,-93,7,,38398898,28,1496,38398870,38398898
10677,4,1,1,2412,-89,-93,4,,38399241,304,39,38398937,38399241
10678,4,11,1,2412,-87,-93,6,4c:01:43:ec:a0:69,38400520,361,918,38400159,38400520
10679,6,24,1,2412,-86,-93,7,,38404268,28,3720,38404240,38404268
10680,4,1,1,2412,-87,-93,6,,38406802,304,2230,38406498,38406802
10681,6,6,1,2412,-90,-93,3,,38412690,44,5844,38412646,38412690
10682,4,1,1,2412,-84,-93,9,78:67:0e:c4:a8:42,38414302,2736,-1124,38411566,38414302
10683,4,1,1,2412,-89,-93,4,,38417683,304,3077,38417379,38417683
10684,6,6,1,2412,-90,-93,3,,38421684,44,3957,38421640,38421684
10685,4,11,1,2412,-87,-93,6,,38422426,107,635,38422319,38422426
10686,6,6,1,2412,-91,-93,2,3c:bd:c5:ee:96:6d,38422705,68,211,38422637,38422705
10687,4,1,1,2412,-88,-93,5,,38432457,304,9448,38432153,38432457
10688,4,1,1,2412,-87,-93,6,,38433929,304,1168,38433625,38433929
10689,4,1,1,2412,-87,-93,6,,38435433,304,1200,38435129,38435433
10690,6,6,1,2412,-70,-93,23,32:86:8c:5f:93:1e,38438274,332,2509,38437942,38438274
10691,4,1,1,2412,-88,-93,5,,38448873,304,10295,38448569,38448873
10692,4,1,1,2412,-61,-93,32,b0:e4:d5:32:ec:8a,38454626,1960,3793,38452666,38454626
10693,4,11,1,2412,-89,-93,4,4c:01:43:d7:f3:29,38464929,362,9941,38464567,38464929
10694,4,11,1,2412,-87,-93,6,4c:01:43:d7:f3:23,38465304,322,53,38464982,38465304
10695,4,11,1,2412,-88,-93,5,4c:01:43:d7:f3:26,38465638,387,-53,38465251,38465638
10696,4,1,1,2412,-73,-93,20,c0:8d:51:da:5c:ef,38466291,416,237,38465875,38466291
10697,4,1,1,2412,-66,-93,27,,38466718,304,123,38466414,38466718
10698,4,1,1,2412,-91,-93,2,,38471593,304,4571,38471289,38471593
10699,6,24,1,2412,-88,-93,5,,38471857,28,236,38471829,38471857
10700,6,6,1,2412,-90,-93,3,,38474575,44,2674,38474531,38474575
10701,4,1,1,2412,-87,-93,6,,38474952,304,73,38474648,38474952
10702,6,6,1,2412,-90,-93,3,3c:bd:c5:ee:96:6d,38475675,68,655,38475607,38475675
10703,4,11,1,2412,-78,-93,15,48:dd:0c:7d:86:27,38479486,362,3449,38479124,38479486
10704,4,11,1,2412,-77,-93,16,48:dd:0c:7d:86:23,38479860,323,51,38479537,38479860
10705,4,11,1,2412,-79,-93,14,48:dd:0c:7d:86:25,38480195,382,-47,38479813,38480195
10706,6,24,1,2412,-86,-93,7,,38482071,28,1848,38482043,38482071
10707,6,6,1,2412,-87,-93,6,40:b0:34:b7:01:d5,38482761,576,114,38482185,38482761
10708,6,6,1,2412,-68,-93,25,12:86:8c:5f:93:1e,38484500,332,1407,38484168,38484500
10709,6,24,1,2412,-87,-93,6,,38484901,28,373,38484873,38484901
10710,4,1,1,2412,-87,-93,6,,38489879,304,4674,38489575,38489879
10711,4,1,1,2412,-87,-93,6,,38492681,304,2498,38492377,38492681
10712,4,11,1,2412,-86,-93,7,4c:01:43:ec:a0:69,38502919,361,9877,38502558,38502919
10713,4,11,1,2412,-86,-93,7,4c:01:43:ec:a0:63,38503293,322,52,38502971,38503293
10714,4,11,1,2412,-85,-93,8,4c:01:43:ec:a0:66,38503627,387,-53,38503240,38503627
10715,4,1,1,2412,-85,-93,8,78:67:0e:c4:a8:42,38516702,2736,10339,38513966,38516702
10716,4,1,1,2412,-90,-93,3,,38524233,304,7227,38523929,38524233
10717,6,6,1,2412,-68,-93,25,32:86:8c:5f:93:1e,38535700,332,11135,38535368,38535700
10718,4,1,1,2412,-86,-93,7,,38538798,304,2794,38538494,38538798
10719,4,1,1,2412,-88,-93,5,,38541480,304,2378,38541176,38541480
10720,6,24,1,2412,-85,-93,8,,38548615,28,7107,38548587,38548615
10721,6,24,1,2412,-87,-93,6,,38551391,28,2748,38551363,38551391
10722,4,1,1,2412,-61,-93,32,b0:e4:d5:32:ec:8a,38557026,1960,3675,38555066,38557026
10723,6,6,1,2412,-67,-93,26,10:86:8c:5f:93:1e,38561300,344,3930,38560956,38561300
10724,6,24,1,2412,-88,-93,5,,38564266,28,2938,38564238,38564266
10725,4,1,1,2412,-60,-93,33,94:a6:7e:c9:98:67,38564743,2464,-1987,38562279,38564743
10726,6,24,1,2412,-87,-93,6,,38568766,28,3995,38568738,38568766
10727,6,6,1,2412,-86,-93,7,4c:01:43:d7:f3:26,38570973,52,2155,38570921,38570973
10728,6,6,1,2412,-86,-93,7,4c:01:43:d7:f3:26,38572328,52,1303,38572276,38572328
10729,6,6,1,2412,-87,-93,6,4c:01:43:d7:f3:26,38575697,52,3317,38575645,38575697
10730,6,6,1,2412,-86,-93,7,40:b0:34:b7:01:d5,38585162,576,8889,38584586,38585162
10731,6,6,1,2412,-67,-93,26,12:86:8c:5f:93:1e,38586900,332,1406,38586568,38586900
10732,4,1,1,2412,-88,-93,5,,38588696,304,1492,38588392,38588696
10733,6,6,1,2412,-87,-93,6,4c:01:43:d7:f3:26,38590908,52,2160,38590856,38590908
10734,4,1,1,2412,-89,-93,4,,38591917,304,705,38591613,38591917
10735,4,1,1,2412,-89,-93,4,,38597849,304,5628,38597545,38597849
10736,6,24,1,2412,-86,-93,7,,38598188,28,311,38598160,38598188
10737,4,11,1,2412,-93,-93,0,4c:01:43:ec:a0:69,38605318,361,6769,38604957,38605318
10738,4,11,1,2412,-86,-93,7,4c:01:43:ec:a0:63,38605692,322,52,38605370,38605692
10739,4,11,1,2412,-85,-93,8,4c:01:43:ec:a0:66,38606026,387,-53,38605639,38606026
10740,4,11,1,2412,-86,-93,7,48:dd:0c:90:e3:83,38607247,323,898,38606924,38607247
10741,4,1,1,2412,-88,-93,5,78:67:0e:c4:a8:42,38619101,2736,9118,38616365,38619101
10742,4,1,1,2412,-88,-93,5,,38626664,304,7259,38626360,38626664
10743,4,1,1,2412,-89,-93,4,,38629256,304,2288,38628952,38629256
10744,6,24,1,2412,-87,-93,6,,38631394,28,2110,38631366,38631394
10745,6,6,1,2412,-67,-93,26,32:86:8c:5f:93:1e,38638100,332,6374,38637768,38638100
10746,4,1,1,2412,-88,-93,5,,38643624,304,5220,38643320,38643624
10747,4,1,1,2412,-62,-93,31,b0:e4:d5:32:ec:8a,38660232,1960,14648,38658272,38660232
10748,4,1,1,2412,-88,-93,5,,38662968,304,2432,38662664,38662968
10749,6,6,1,2412,-68,-93,25,10:86:8c:5f:93:1e,38666179,344,2867,38665835,38666179
10750,4,1,1,2412,-89,-93,4,,38670984,304,4501,38670680,38670984
10751,4,1,1,2412,-73,-93,20,,38677416,304,6128,38677112,38677416
10752,4,1,1,2412,-88,-93,5,78:67:0e:38:6c:d3,38681527,2736,1375,38678791,38681527
10753,4,11,1,2412,-78,-93,15,48:dd:0c:7d:86:27,38684285,362,2396,38683923,38684285
10754,4,11,1,2412,-78,-93,15,48:dd:0c:7d:86:23,38684660,323,52,38684337,38684660
10755,4,11,1,2412,-79,-93,14,48:dd:0c:7d:86:25,38684995,382,-47,38684613,38684995
10756,4,1,1,2412,-88,-93,5,78:67:0e:c4:a8:42,38687120,352,1773,38686768,38687120
10757,4,11,1,2412,-88,-93,5,,38689371,107,2144,38689264,38689371
10758,6,6,1,2412,-67,-93,26,12:86:8c:5f:93:1e,38689463,332,-240,38689131,38689463
10759,4,11,1,2412,-87,-93,6,,38690038,107,468,38689931,38690038
10760,4,1,1,2412,-86,-93,7,,38692904,304,2562,38692600,38692904
10761,6,12,1,2412,-87,-93,6,78:67:0e:c4:a8:42,38694334,44,1386,38694290,38694334
10762,4,1,1,2412,-88,-93,5,,38696986,304,2348,38696682,38696986
10763,4,1,1,2412,-91,-93,2,,38699208,304,1918,38698904,38699208
10764,6,6,1,2412,-91,-93,2,,38702510,44,3258,38702466,38702510
10765,6,6,1,2412,-89,-93,4,3c:bd:c5:ee:96:6d,38704062,68,1484,38703994,38704062
10766,4,1,1,2412,-87,-93,6,78:67:0e:c4:a8:42,38721501,2736,14703,38718765,38721501
10767,4,1,1,2412,-87,-93,6,,38730632,304,8827,38730328,38730632
10768,4,1,1,2412,-88,-93,5,,38732168,304,1232,38731864,38732168
10769,6,6,1,2412,-67,-93,26,32:86:8c:5f:93:1e,38740501,332,8001,38740169,38740501
10770,4,1,1,2412,-87,-93,6,,38747455,304,6650,38747151,38747455
10771,4,1,1,2412,-90,-93,3,,38750856,304,3097,38750552,38750856
10772,6,6,1,2412,-91,-93,2,3c:bd:c5:ee:96:6d,38752247,68,1323,38752179,38752247
10773,4,1,1,2412,-88,-93,5,,38755516,304,2965,38755212,38755516
10774,4,1,1,2412,-89,-93,4,,38761199,304,5379,38760895,38761199
10775,4,1,1,2412,-62,-93,31,b0:e4:d5:32:ec:8a,38761845,1960,-1314,38759885,38761845
10776,4,1,1,2412,-60,-93,33,94:a6:7e:c9:98:67,38768844,2464,4535,38766380,38768844
10777,4,11,1,2412,-85,-93,8,4c:01:43:d7:f3:29,38772128,362,2922,38771766,38772128
10778,4,11,1,2412,-87,-93,6,4c:01:43:d7:f3:23,38772502,322,52,38772180,38772502
10779,4,11,1,2412,-87,-93,6,4c:01:43:d7:f3:26,38772837,387,-52,38772450,38772837
10780,4,1,1,2412,-87,-93,6,,38776925,304,3784,38776621,38776925
10781,4,1,1,2412,-87,-93,6,,38780104,304,2875,38779800,38780104
10782,6,24,1,2412,-89,-93,4,,38791395,28,11263,38791367,38791395
10783,6,6,1,2412,-67,-93,26,12:86:8c:5f:93:1e,38791701,332,-26,38791369,38791701
10784,4,1,1,2412,-88,-93,5,,38793416,304,1411,38793112,38793416
10785,6,24,1,2412,-86,-93,7,,38805586,28,12142,38805558,38805586
10786,4,1,1,2412,-88,-93,5,,38832440,304,26550,38832136,38832440
10787,4,1,1,2412,-86,-93,7,,38835545,304,2801,38835241,38835545
10788,4,1,1,2412,-88,-93,5,,38839230,304,3381,38838926,38839230
10789,4,1,1,2412,-88,-93,5,,38841802,304,2268,38841498,38841802
10790,6,6,1,2412,-69,-93,24,32:86:8c:5f:93:1e,38842902,332,768,38842570,38842902
10791,4,1,1,2412,-87,-93,6,,38854322,304,11116,38854018,38854322
10792,4,1,1,2412,-88,-93,5,,38862759,304,8133,38862455,38862759
10793,4,1,1,2412,-60,-93,33,b0:e4:d5:32:ec:8a,38864223,1960,-496,38862263,38864223
10794,4,1,1,2412,-58,-93,35,94:a6:7e:c9:98:67,38871459,2464,4772,38868995,38871459
10795,6,6,1,2412,-68,-93,25,10:86:8c:5f:93:1e,38873779,344,1976,38873435,38873779
10796,4,11,1,2412,-88,-93,5,4c:01:43:d7:f3:29,38874527,362,386,38874165,38874527
10797,6,24,1,2412,-88,-93,5,,38884116,28,9561,38884088,38884116
10798,4,1,1,2412,-91,-93,2,78:67:0e:38:6c:d3,38886327,2736,-525,38883591,38886327
10799,4,11,1,2412,-78,-93,15,48:dd:0c:7d:86:27,38889086,362,2397,38888724,38889086
10800,4,11,1,2412,-78,-93,15,48:dd:0c:7d:86:23,38889460,323,51,38889137,38889460
10801,4,11,1,2412,-79,-93,14,48:dd:0c:7d:86:25,38889796,382,-46,38889414,38889796
10802,4,11,1,2412,-84,-93,9,4c:01:43:ec:a0:63,38890109,277,36,38889832,38890109
10803,6,6,1,2412,-68,-93,25,12:86:8c:5f:93:1e,38894102,332,3661,38893770,38894102
10804,4,1,1,2412,-87,-93,6,,38895719,304,1313,38895415,38895719
10805,4,1,1,2412,-88,-93,5,,38901160,304,5137,38900856,38901160
10806,6,6,1,2412,-84,-93,9,,38902915,44,1711,38902871,38902915
10807,4,11,1,2412,-86,-93,7,4c:01:43:ec:a0:69,38912514,361,9238,38912153,38912514
10808,4,11,1,2412,-85,-93,8,4c:01:43:ec:a0:63,38912888,322,52,38912566,38912888
10809,4,1,1,2412,-88,-93,5,,38913767,304,575,38913463,38913767
10810,4,1,1,2412,-86,-93,7,78:67:0e:c4:a8:42,38929074,352,14955,38928722,38929074
10811,4,1,1,2412,-87,-93,6,,38929808,304,430,38929504,38929808
10812,4,11,1,2412,-86,-93,7,,38931010,107,1095,38930903,38931010
10813,6,24,1,2412,-84,-93,9,78:67:0e:c4:a8:42,38931123,32,81,38931091,38931123
10814,6,6,1,2412,-92,-93,1,3c:bd:c5:ee:96:6d,38931728,68,537,38931660,38931728
10815,4,1,1,2412,-90,-93,3,,38951111,304,19079,38950807,38951111
10816,4,1,1,2412,-90,-93,3,,38952552,304,1137,38952248,38952552
10817,6,24,1,2412,-85,-93,8,,38957041,28,4461,38957013,38957041
10818,4,1,1,2412,-89,-93,4,,38961864,304,4519,38961560,38961864
10819,4,1,1,2412,-61,-93,32,b0:e4:d5:32:ec:8a,38966623,1960,2799,38964663,38966623
10820,6,6,1,2412,-67,-93,26,10:86:8c:5f:93:1e,38973393,344,6426,38973049,38973393
10821,4,1,1,2412,-58,-93,35,94:a6:7e:c9:98:67,38973928,2464,-1929,38971464,38973928
10822,4,11,1,2412,-91,-93,2,4c:01:43:d7:f3:29,38976927,362,2637,38976565,38976927
10823,4,11,1,2412,-90,-93,3,4c:01:43:d7:f3:23,38977301,322,52,38976979,38977301
10824,4,11,1,2412,-89,-93,4,4c:01:43:d7:f3:26,38977636,387,-52,38977249,38977636
10825,4,1,1,2412,-85,-93,8,,38992791,304,14851,38992487,38992791
10826,6,6,1,2412,-67,-93,26,12:86:8c:5f:93:1e,38996503,332,3380,38996171,38996503
10827,4,1,1,2412,-87,-93,6,,39005127,304,8320,39004823,39005127
10828,4,1,1,2412,-86,-93,7,,39011689,304,6258,39011385,39011689
10829,4,1,1,2412,-88,-93,5,,39013795,304,1802,39013491,39013795
10830,4,1,1,2412,-89,-93,4,,39014720,304,621,39014416,39014720
10831,4,11,1,2412,-84,-93,9,4c:01:43:ec:a0:69,39015077,361,-4,39014716,39015077
10832,4,11,1,2412,-85,-93,8,4c:01:43:ec:a0:63,39015451,322,52,39015129,39015451
10833,4,11,1,2412,-84,-93,9,4c:01:43:ec:a0:66,39015785,387,-53,39015398,39015785
10834,4,1,1,2412,-89,-93,4,,39026311,304,10222,39026007,39026311
10835,4,1,1,2412,-89,-93,4,,39028455,304,1840,39028151,39028455
10836,4,1,1,2412,-87,-93,6,,39032216,304,3457,39031912,39032216
10837,4,1,1,2412,-90,-93,3,,39038087,304,5567,39037783,39038087
10838,6,6,1,2412,-69,-93,24,32:86:8c:5f:93:1e,39047703,332,9284,39047371,39047703
10839,4,1,1,2412,-91,-93,2,,39055047,304,7040,39054743,39055047
10840,4,1,1,2412,-88,-93,5,,39058247,304,2896,39057943,39058247
10841,4,1,1,2412,-88,-93,5,,39067623,304,9072,39067319,39067623
10842,4,1,1,2412,-61,-93,32,b0:e4:d5:32:ec:8a,39069022,1960,-561,39067062,39069022
10843,6,6,1,2412,-68,-93,25,10:86:8c:5f:93:1e,39075804,344,6438,39075460,39075804
10844,4,1,1,2412,-58,-93,35,94:a6:7e:c9:98:67,39076339,2464,-1929,39073875,39076339
10845,4,1,1,2412,-89,-93,4,,39087205,304,10562,39086901,39087205
10846,4,5.5,1,2412,-88,-93,5,,39088551,213,1133,39088338,39088551
10847,6,24,1,2412,-85,-93,8,,39090827,28,2248,39090799,39090827
10848,4,1,1,2412,-90,-93,3,78:67:0e:38:6c:d3,39091347,2736,-2216,39088611,39091347
10849,4,11,1,2412,-78,-93,15,48:dd:0c:7d:86:27,39094105,362,2396,39093743,39094105
10850,4,11,1,2412,-78,-93,15,48:dd:0c:7d:86:23,39094480,323,52,39094157,39094480
10851,4,11,1,2412,-78,-93,15,48:dd:0c:7d:86:25,39094815,382,-47,39094433,39094815
10852,6,6,1,2412,-88,-93,5,40:b0:34:b7:01:d5,39097203,576,1812,39096627,39097203
10853,4,1,1,2412,-88,-93,5,,39098092,304,585,39097788,39098092
10854,6,6,1,2412,-68,-93,25,12:86:8c:5f:93:1e,39098904,332,480,39098572,39098904
10855,4,1,1,2412,-87,-93,6,,39099655,304,447,39099351,39099655
10856,4,1,1,2412,-89,-93,4,,39114214,304,14255,39113910,39114214
10857,4,11,1,2412,-86,-93,7,4c:01:43:ec:a0:69,39117312,361,2737,39116951,39117312
10858,4,11,1,2412,-85,-93,8,4c:01:43:ec:a0:63,39117686,322,52,39117364,39117686
10859,4,11,1,2412,-85,-93,8,4c:01:43:ec:a0:66,39118020,387,-53,39117633,39118020
10860,6,24,1,2412,-85,-93,8,,39124269,28,6221,39124241,39124269
10861,6,6,1,2412,-66,-93,27,52:86:8c:5f:93:1e,39124504,332,-97,39124172,39124504
10862,4,1,1,2412,-71,-93,22,10:86:8c:5f:93:1e,39129169,3088,1577,39126081,39129169
10863,4,1,1,2412,-64,-93,29,10:86:8c:5f:93:1e,39132358,3088,101,39129270,39132358
10864,4,1,1,2412,-90,-93,3,,39135459,304,2797,39135155,39135459
10865,4,1,1,2412,-83,-93,10,78:67:0e:c4:a8:42,39135780,2736,-2415,39133044,39135780
10866,4,11,1,2412,-90,-93,3,4c:01:43:d7:f3:26,39139912,383,3749,39139529,39139912
10867,4,1,1,2412,-88,-93,5,,39140454,304,238,39140150,39140454
10868,4,11,1,2412,-93,-93,0,,39141055,203,398,39140852,39141055
10869,4,1,1,2412,-89,-93,4,,39144550,304,3191,39144246,39144550
10870,4,1,1,2412,-92,-93,1,26:87:8c:21:a4:67,39148767,1152,3065,39147615,39148767
10871,4,1,1,2412,-64,-93,29,10:86:8c:5f:93:1e,39154517,3088,2662,39151429,39154517
10872,4,1,1,2412,-65,-93,28,10:86:8c:5f:93:1e,39157724,3088,119,39154636,39157724
10873,4,1,1,2412,-91,-93,2,,39160824,304,2796,39160520,39160824
10874,4,1,1,2412,-91,-93,2,78:67:0e:38:6c:d3,39161248,3472,-3048,39157776,39161248
10875,4,1,1,2412,-91,-93,2,,39164732,304,3180,39164428,39164732
10876,4,1,1,2412,-88,-93,5,,39171338,304,6302,39171034,39171338
10877,4,1,1,2412,-61,-93,32,b0:e4:d5:32:ec:8a,39171802,1960,-1496,39169842,39171802
10878,4,1,1,2412,-87,-93,6,,39173734,304,1628,39173430,39173734
10879,4,1,1,2412,-59,-93,34,94:a6:7e:c9:98:67,39178798,2464,2600,39176334,39178798
10880,4,11,1,2412,-89,-93,4,4c:01:43:d7:f3:23,39182100,322,2980,39181778,39182100
10881,4,11,1,2412,-90,-93,3,4c:01:43:d7:f3:26,39182435,387,-52,39182048,39182435
10882,6,24,1,2412,-88,-93,5,,39191398,28,8935,39191370,39191398
10883,4,1,1,2412,-88,-93,5,,39191750,304,48,39191446,39191750
10884,6,6,1,2412,-89,-93,4,3c:bd:c5:ee:96:6d,39198587,68,6769,39198519,39198587
10885,6,6,1,2412,-89,-93,4,40:b0:34:b7:01:d5,39199895,576,732,39199319,39199895
10886,6,6,1,2412,-67,-93,26,12:86:8c:5f:93:1e,39201304,332,1077,39200972,39201304
10887,4,1,1,2412,-88,-93,5,,39202918,304,1310,39202614,39202918
10888,6,24,1,2412,-89,-93,4,,39203975,28,1029,39203947,39203975
10889,4,1,1,2412,-88,-93,5,78:67:0e:c4:a8:42,39205645,352,1318,39205293,39205645
10890,4,11,1,2412,-85,-93,8,,39207484,107,1732,39207377,39207484
10891,6,24,1,2412,-85,-93,8,78:67:0e:c4:a8:42,39207597,32,81,39207565,39207597
10892,4,1,1,2412,-87,-93,6,,39213742,304,5841,39213438,39213742
10893,4,1,1,2412,-87,-93,6,,39217596,304,3550,39217292,39217596
10894,4,11,1,2412,-85,-93,8,4c:01:43:ec:a0:69,39219711,361,1754,39219350,39219711
10895,4,11,1,2412,-86,-93,7,4c:01:43:ec:a0:63,39220085,322,52,39219763,39220085
10896,4,1,1,2412,-92,-93,1,f8:51:28:bf:c3:33,39223979,416,3478,39223563,39223979
10897,4,1,1,2412,-87,-93,6,,39233370,304,9087,39233066,39233370
10898,4,1,1,2412,-86,-93,7,78:67:0e:c4:a8:42,39233964,2736,-2142,39231228,39233964
10899,4,1,1,2412,-86,-93,7,,39236979,304,2711,39236675,39236979
10900,4,1,1,2412,-93,-93,0,f8:51:28:bf:c3:33,39246943,416,9548,39246527,39246943
10901,6,24,1,2412,-84,-93,9,,39247295,28,324,39247267,39247295
10902,6,6,1,2412,-67,-93,26,32:86:8c:5f:93:1e,39252505,332,4878,39252173,39252505
10903,4,1,1,2412,-90,-93,3,,39253222,304,413,39252918,39253222
10904,4,1,1,2412,-61,-93,32,b0:e4:d5:32:ec:8a,39259876,1912,4742,39257964,39259876
10905,4,1,1,2412,-78,-93,15,,39261799,304,1619,39261495,39261799
10906,4,1,1,2412,-85,-93,8,10:86:8c:5f:93:1e,39262124,3088,-2763,39259036,39262124
10907,4,1,1,2412,-71,-93,22,10:86:8c:5f:93:1e,39265444,3088,232,39262356,39265444
10908,4,1,1,2412,-67,-93,26,10:86:8c:5f:93:1e,39268651,3088,119,39265563,39268651
10909,4,11,1,2412,-77,-93,16,48:dd:0c:7d:86:25,39272101,377,3073,39271724,39272101
10910,4,1,1,2412,-62,-93,31,b0:e4:d5:32:ec:8a,39276939,1960,2878,39274979,39276939
10911,4,1,1,2412,-77,-93,16,,39286872,304,9629,39286568,39286872
10912,4,1,1,2412,-78,-93,15,,39290896,304,3720,39290592,39290896
10913,4,11,1,2412,-78,-93,15,48:dd:0c:7d:86:23,39297306,254,6156,39297052,39297306
10914,4,1,1,2412,-86,-93,7,3c:bd:c5:ee:96:6d,39298184,3280,-2402,39294904,39298184
10915,6,6,1,2412,-69,-93,24,12:86:8c:5f:93:1e,39303927,332,5411,39303595,39303927
10916,4,1,1,2412,-87,-93,6,,39313479,304,9248,39313175,39313479
10917,4,1,1,2412,-87,-93,6,,39319686,304,5903,39319382,39319686
10918,4,11,1,2412,-87,-93,6,4c:01:43:ec:a0:66,39322818,387,2745,39322431,39322818
10919,4,11,1,2412,-94,-93,-1,48:dd:0c:90:e3:83,39324045,323,904,39323722,39324045
10920,4,11,1,2412,-93,-93,0,48:dd:0c:90:e3:85,39324380,382,-47,39323998,39324380
10921,4,1,1,2412,-88,-93,5,,39327654,304,2970,39327350,39327654
10922,4,1,1,2412,-73,-93,20,,39332454,304,4496,39332150,39332454
10923,4,1,1,2412,-88,-93,5,,39333453,304,695,39333149,39333453
10924,4,1,1,2412,-88,-93,5,,39339280,304,5523,39338976,39339280
10925,4,1,1,2412,-88,-93,5,,39347302,304,7718,39346998,39347302
10926,4,1,1,2412,-89,-93,4,,39350886,304,3280,39350582,39350886
10927,6,24,1,2412,-89,-93,4,,39351406,28,492,39351378,39351406
10928,4,1,1,2412,-89,-93,4,,39353222,304,1512,39352918,39353222
10929,6,6,1,2412,-67,-93,26,32:86:8c:5f:93:1e,39354906,332,1352,39354574,39354906
10930,6,6,1,2412,-66,-93,27,b4:e6:2d:b4:ff:71,39356147,64,1177,39356083,39356147
10931,6,6,1,2412,-68,-93,25,,39356227,44,36,39356183,39356227
10932,6,24,1,2412,-86,-93,7,,39363974,28,7719,39363946,39363974
10933,4,1,1,2412,-89,-93,4,,39367750,304,3472,39367446,39367750
10934,4,1,1,2412,-62,-93,31,b0:e4:d5:32:ec:8a,39376220,1960,6510,39374260,39376220
10935,4,1,1,2412,-89,-93,4,,39379398,304,2874,39379094,39379398
10936,4,1,1,2412,-58,-93,35,94:a6:7e:c9:98:67,39383383,2464,1521,39380919,39383383
10937,4,11,1,2412,-88,-93,5,4c:01:43:d7:f3:23,39386899,322,3194,39386577,39386899
10938,4,11,1,2412,-89,-93,4,4c:01:43:d7:f3:26,39387234,387,-52,39386847,39387234
10939,4,1,1,2412,-87,-93,6,,39394982,304,7444,39394678,39394982
10940,4,1,1,2412,-91,-93,2,78:67:0e:38:6c:d3,39398459,2736,741,39395723,39398459
10941,4,11,1,2412,-78,-93,15,48:dd:0c:7d:86:27,39401218,362,2397,39400856,39401218
10942,4,11,1,2412,-78,-93,15,48:dd:0c:7d:86:23,39401592,323,51,39401269,39401592
10943,4,11,1,2412,-78,-93,15,48:dd:0c:7d:86:25,39401928,382,-46,39401546,39401928
10944,6,6,1,2412,-69,-93,24,12:86:8c:5f:93:1e,39406106,332,3846,39405774,39406106
10945,4,1,1,2412,-87,-93,6,,39412293,304,5883,39411989,39412293
10946,4,1,1,2412,-88,-93,5,,39422088,304,9491,39421784,39422088
10947,4,1,1,2412,-87,-93,6,,39424136,304,1744,39423832,39424136
10948,4,11,1,2412,-86,-93,7,4c:01:43:ec:a0:69,39424509,361,12,39424148,39424509
10949,4,11,1,2412,-84,-93,9,4c:01:43:ec:a0:66,39425217,387,321,39424830,39425217
10950,4,1,1,2412,-88,-93,5,,39428784,304,3263,39428480,39428784
10951,6,24,1,2412,-88,-93,5,,39431408,28,2596,39431380,39431408
10952,6,6,1,2412,-68,-93,25,52:86:8c:5f:93:1e,39431706,332,-34,39431374,39431706
10953,4,1,1,2412,-86,-93,7,78:67:0e:c4:a8:42,39443879,352,11821,39443527,39443879
10954,4,11,1,2412,-87,-93,6,,39445691,107,1705,39445584,39445691
10955,6,24,1,2412,-84,-93,9,78:67:0e:c4:a8:42,39445804,32,81,39445772,39445804
10956,6,6,1,2412,-67,-93,26,32:86:8c:5f:93:1e,39457306,332,11170,39456974,39457306
10957,4,11,1,2412,-85,-93,8,,39468689,203,11180,39468486,39468689
10958,4,1,1,2412,-62,-93,31,b0:e4:d5:32:ec:8a,39480217,1960,9568,39478257,39480217
10959,4,1,1,2412,-58,-93,35,94:a6:7e:c9:98:67,39485871,2464,3190,39483407,39485871
10960,6,6,1,2412,-66,-93,27,b4:e6:2d:b4:ff:71,39488222,64,2287,39488158,39488222
10961,6,6,1,2412,-68,-93,25,,39488302,44,36,39488258,39488302
10962,4,11,1,2412,-89,-93,4,4c:01:43:d7:f3:29,39489051,362,387,39488689,39489051
10963,4,11,1,2412,-87,-93,6,4c:01:43:d7:f3:23,39489425,322,52,39489103,39489425
10964,4,11,1,2412,-89,-93,4,4c:01:43:d7:f3:26,39489760,387,-52,39489373,39489760
10965,4,1,1,2412,-89,-93,4,78:67:0e:38:6c:d3,39500729,2736,8233,39497993,39500729
10966,4,11,1,2412,-80,-93,13,48:dd:0c:7d:86:27,39503488,362,2397,39503126,39503488
10967,4,11,1,2412,-78,-93,15,48:dd:0c:7d:86:23,39503862,323,51,39503539,39503862
10968,4,11,1,2412,-80,-93,13,48:dd:0c:7d:86:25,39504198,382,-46,39503816,39504198
10969,4,1,1,2412,-89,-93,4,,39517093,304,12591,39516789,39517093
10970,4,1,1,2412,-90,-93,3,,39538626,304,21229,39538322,39538626
10971,4,1,1,2412,-85,-93,8,,39539205,304,275,39538901,39539205
10972,4,1,1,2412,-87,-93,6,78:67:0e:c4:a8:42,39540700,2736,-1241,39537964,39540700
10973,4,1,1,2412,-89,-93,4,,39544393,304,3389,39544089,39544393
10974,4,1,1,2412,-88,-93,5,,39555941,304,11244,39555637,39555941
10975,6,6,1,2412,-69,-93,24,32:86:8c:5f:93:1e,39559707,332,3434,39559375,39559707
10976,4,1,1,2412,-89,-93,4,,39569152,304,9141,39568848,39569152
10977,4,1,1,2412,-62,-93,31,b0:e4:d5:32:ec:8a,39581018,1960,9906,39579058,39581018
10978,4,1,1,2412,-89,-93,4,,39585125,304,3803,39584821,39585125
10979,4,1,1,2412,-88,-93,5,,39587173,304,1744,39586869,39587173
10980,6,6,1,2412,-68,-93,25,10:86:8c:5f:93:1e,39587783,344,266,39587439,39587783
10981,4,1,1,2412,-58,-93,35,94:a6:7e:c9:98:67,39588327,2464,-1920,39585863,39588327
10982,4,11,1,2412,-90,-93,3,4c:01:43:d7:f3:29,39591324,362,2635,39590962,39591324
10983,4,11,1,2412,-89,-93,4,4c:01:43:d7:f3:23,39591699,322,53,39591377,39591699
10984,4,11,1,2412,-88,-93,5,4c:01:43:d7:f3:26,39592033,387,-53,39591646,39592033
10985,6,24,1,2412,-84,-93,9,,39594191,28,2130,39594163,39594191
10986,4,1,1,2412,-88,-93,5,,39601328,304,6833,39601024,39601328
10987,6,6,1,2412,-68,-93,25,12:86:8c:5f:93:1e,39610907,332,9247,39610575,39610907
10988,4,1,1,2412,-88,-93,5,,39611782,304,571,39611478,39611782
10989,4,1,1,2412,-80,-93,13,,39625818,304,13732,39625514,39625818
10990,4,1,1,2412,-88,-93,5,,39627941,304,1819,39627637,39627941
10991,4,11,1,2412,-85,-93,8,4c:01:43:ec:a0:63,39629680,322,1417,39629358,39629680
10992,4,11,1,2412,-78,-93,15,48:dd:0c:7d:86:23,39632009,254,2075,39631755,39632009
10993,4,1,1,2412,-87,-93,6,,39633048,304,735,39632744,39633048
10994,4,1,1,2412,-86,-93,7,78:67:0e:c4:a8:42,39643100,2736,7316,39640364,39643100
10995,4,1,1,2412,-86,-93,7,,39646479,304,3075,39646175,39646479
10996,4,1,1,2412,-87,-93,6,,39651453,304,4670,39651149,39651453
10997,4,1,1,2412,-87,-93,6,,39656929,304,5172,39656625,39656929
10998,4,1,1,2412,-87,-93,6,,39661765,304,4532,39661461,39661765
10999,6,6,1,2412,-70,-93,23,32:86:8c:5f:93:1e,39662108,332,11,39661776,39662108
11000,6,6,1,2412,-67,-93,26,b4:e6:2d:b4:ff:71,39671139,64,8967,39671075,39671139
11001,6,6,1,2412,-67,-93,26,,39671219,44,36,39671175,39671219
11002,6,24,1,2412,-88,-93,5,,39671405,28,158,39671377,39671405
11003,4,1,1,2412,-88,-93,5,,39675531,304,3822,39675227,39675531
11004,4,1,1,2412,-62,-93,31,b0:e4:d5:32:ec:8a,39683418,1960,5927,39681458,39683418
11005,6,6,1,2412,-68,-93,25,10:86:8c:5f:93:1e,39690205,344,6443,39689861,39690205
11006,4,1,1,2412,-59,-93,34,94:a6:7e:c9:98:67,39690740,2464,-1929,39688276,39690740
11007,4,11,1,2412,-90,-93,3,4c:01:43:d7:f3:29,39693724,362,2622,39693362,39693724
11008,6,24,1,2412,-85,-93,8,,39700356,28,6604,39700328,39700356
11009,4,11,1,2412,-80,-93,13,48:dd:0c:7d:86:27,39708288,362,7570,39707926,39708288
11010,4,11,1,2412,-78,-93,15,48:dd:0c:7d:86:23,39708663,323,52,39708340,39708663
11011,4,11,1,2412,-78,-93,15,48:dd:0c:7d:86:25,39708998,382,-47,39708616,39708998
11012,6,6,1,2412,-68,-93,25,12:86:8c:5f:93:1e,39713308,332,3978,39712976,39713308
11013,4,1,1,2412,-88,-93,5,,39714501,304,889,39714197,39714501
11014,4,1,1,2412,-86,-93,7,,39720933,304,6128,39720629,39720933
11015,4,11,1,2412,-86,-93,7,4c:01:43:ec:a0:69,39731705,361,10411,39731344,39731705
11016,4,11,1,2412,-84,-93,9,4c:01:43:ec:a0:63,39732079,322,52,39731757,39732079
11017,4,11,1,2412,-85,-93,8,4c:01:43:ec:a0:66,39732413,387,-53,39732026,39732413
11018,4,1,1,2412,-88,-93,5,,39741924,304,9207,39741620,39741924
11019,4,1,1,2412,-85,-93,8,78:67:0e:c4:a8:42,39745500,2736,840,39742764,39745500
11020,4,1,1,2412,-90,-93,3,,39752901,304,7097,39752597,39752901
11021,6,24,1,2412,-88,-93,5,,39765132,28,12203,39765104,39765132
11022,6,6,1,2412,-68,-93,25,32:86:8c:5f:93:1e,39769327,332,3863,39768995,39769327
11023,4,1,1,2412,-88,-93,5,,39771780,304,2149,39771476,39771780
11024,4,1,1,2412,-62,-93,31,b0:e4:d5:32:ec:8a,39785817,1960,12077,39783857,39785817
11025,4,1,1,2412,-59,-93,34,94:a6:7e:c9:98:67,39794155,2464,5874,39791691,39794155
11026,4,11,1,2412,-88,-93,5,4c:01:43:d7:f3:26,39796832,387,2290,39796445,39796832
11027,4,11,1,2412,-79,-93,14,48:dd:0c:7d:86:25,39808875,382,11661,39808493,39808875
11028,6,6,1,2412,-69,-93,24,12:86:8c:5f:93:1e,39817907,332,8700,39817575,39817907
11029,6,24,1,2412,-87,-93,6,,39831411,28,13476,39831383,39831411
11030,4,11,1,2412,-85,-93,8,4c:01:43:ec:a0:69,39834104,361,2332,39833743,39834104
11031,4,11,1,2412,-85,-93,8,4c:01:43:ec:a0:63,39834478,322,52,39834156,39834478
11032,4,11,1,2412,-88,-93,5,4c:01:43:ec:a0:66,39834812,387,-53,39834425,39834812
11033,4,11,1,2412,-91,-93,2,48:dd:0c:90:e3:87,39835669,362,495,39835307,39835669
11034,4,11,1,2412,-93,-93,0,48:dd:0c:90:e3:83,39836044,323,52,39835721,39836044
11035,4,11,1,2412,-92,-93,1,48:dd:0c:90:e3:85,39836379,382,-47,39835997,39836379
11036,4,1,1,2412,-88,-93,5,,39851279,304,14596,39850975,39851279
11037,6,24,1,2412,-87,-93,6,4c:01:43:d7:f3:26,39853312,32,2001,39853280,39853312
11038,6,24,1,2412,-87,-93,6,4c:01:43:d7:f3:26,39853476,32,132,39853444,39853476
11039,6,24,1,2412,-85,-93,8,,39855263,28,1759,39855235,39855263
11040,6,24,1,2412,-85,-93,8,4c:01:43:d7:f3:26,39857825,32,2530,39857793,39857825
11041,6,24,1,2412,-88,-93,5,4c:01:43:d7:f3:26,39858561,32,704,39858529,39858561
11042,6,24,1,2412,-87,-93,6,4c:01:43:d7:f3:26,39861052,32,2459,39861020,39861052
11043,6,24,1,2412,-88,-93,5,4c:01:43:d7:f3:26,39864613,32,3529,39864581,39864613
11044,6,6,1,2412,-68,-93,25,32:86:8c:5f:93:1e,39866990,332,2045,39866658,39866990
11045,4,1,1,2412,-59,-93,34,94:a6:7e:c9:98:67,39895213,2464,25759,39892749,39895213
11046,4,11,1,2412,-87,-93,6,4c:01:43:d7:f3:23,39898897,322,3362,39898575,39898897
11047,4,11,1,2412,-89,-93,4,4c:01:43:d7:f3:26,39899232,387,-52,39898845,39899232
