,phy,data_rate,channel,frequency,signal_dbm,noise_dbm,snr,tx_addr,timestamp,duration,ifs,start_tsf,end_tsf
0,6,12,1,2412,-41,-92,51,40:e3:d6:da:ba:20,496038,160,,495878,496038
1,6,12,1,2412,-41,-92,51,40:e3:d6:da:ba:22,496626,180,408,496446,496626
2,6,12,1,2412,-41,-92,51,40:e3:d6:da:ba:23,496832,184,22,496648,496832
3,6,12,1,2412,-41,-92,51,40:e3:d6:da:ba:24,497068,176,60,496892,497068
4,6,12,1,2412,-41,-92,51,40:e3:d6:da:ba:25,497288,160,60,497128,497288
5,6,6,1,2412,-41,-92,51,40:e3:d6:da:ba:26,497488,380,-180,497108,497488
6,6,6,1,2412,-57,-92,35,e6:aa:ea:c9:ea:33,516154,408,18258,515746,516154
7,6,6,1,2412,-57,-92,35,e6:aa:ea:c9:ea:33,528361,408,11799,527953,528361
8,4,5.5,1,2412,-79,-92,13,52:4e:2d:b5:f1:87,539084,403,10320,538681,539084
9,4,5.5,1,2412,-89,-92,3,,539505,213,208,539292,539505
10,6,12,1,2412,-41,-92,51,40:e3:d6:da:ba:22,544818,156,5157,544662,544818
11,6,12,1,2412,-41,-92,51,40:e3:d6:da:ba:23,545036,156,62,544880,545036
12,6,12,1,2412,-41,-92,51,40:e3:d6:da:ba:25,545235,136,63,545099,545235
13,4,1,1,2412,-68,-92,24,54:e4:3a:ec:fb:64,555337,2160,7942,553177,555337
14,4,1,1,2412,-79,-92,13,52:4e:2d:b5:f1:87,560348,1352,3659,558996,560348
15,6,12,1,2412,-41,-92,51,40:e3:d6:da:ba:20,564045,136,3561,563909,564045
16,6,6,1,2412,-41,-92,51,40:e3:d6:da:ba:21,564231,348,-162,563883,564231
17,6,12,1,2412,-41,-92,51,40:e3:d6:da:ba:25,565760,136,1393,565624,565760
18,6,12,1,2412,-41,-92,51,40:e3:d6:da:ba:20,600552,160,34632,600392,600552
19,6,6,1,2412,-41,-92,51,40:e3:d6:da:ba:21,600770,368,-150,600402,600770
20,6,12,1,2412,-41,-92,51,40:e3:d6:da:ba:22,601338,180,388,601158,601338
21,6,12,1,2412,-41,-92,51,40:e3:d6:da:ba:23,601561,184,39,601377,601561
22,6,12,1,2412,-41,-92,51,40:e3:d6:da:ba:24,601780,176,43,601604,601780
23,6,12,1,2412,-41,-92,51,40:e3:d6:da:ba:25,601999,160,59,601839,601999
24,6,6,1,2412,-41,-92,51,40:e3:d6:da:ba:26,602218,380,-161,601838,602218
25,4,1,1,2412,-67,-92,25,54:e4:3a:ec:fb:64,657735,2160,53357,655575,657735
26,4,1,1,2412,-84,-92,8,b8:3a:5a:88:e6:e0,684855,2360,24760,682495,684855
27,6,12,1,2412,-86,-92,6,,697372,32,12485,697340,697372
28,6,12,1,2412,-41,-92,51,40:e3:d6:da:ba:20,700828,160,3296,700668,700828
29,6,6,1,2412,-41,-92,51,40:e3:d6:da:ba:21,701038,368,-158,700670,701038
30,6,12,1,2412,-41,-92,51,40:e3:d6:da:ba:22,701443,180,225,701263,701443
31,6,12,1,2412,-41,-92,51,40:e3:d6:da:ba:23,701667,184,40,701483,701667
32,6,12,1,2412,-41,-92,51,40:e3:d6:da:ba:24,701885,176,42,701709,701885
33,6,12,1,2412,-41,-92,51,40:e3:d6:da:ba:25,702096,160,51,701936,702096
34,6,6,1,2412,-41,-92,51,40:e3:d6:da:ba:26,702288,380,-188,701908,702288
35,4,1,1,2412,-83,-92,9,de:bb:8d:31:d5:e2,716683,1128,13267,715555,716683
36,4,1,1,2412,-89,-92,3,,717828,304,841,717524,717828
37,6,12,1,2412,-41,-92,51,40:e3:d6:da:ba:20,717992,136,28,717856,717992
38,6,6,1,2412,-41,-92,51,40:e3:d6:da:ba:21,718169,348,-171,717821,718169
39,6,12,1,2412,-41,-92,51,40:e3:d6:da:ba:22,718563,156,238,718407,718563
40,6,12,1,2412,-41,-92,51,40:e3:d6:da:ba:23,718771,156,52,718615,718771
41,6,12,1,2412,-41,-92,51,40:e3:d6:da:ba:25,718962,136,55,718826,718962
42,6,12,1,2412,-85,-92,7,,719380,32,386,719348,719380
43,4,1,1,2412,-81,-92,11,c0:c9:e3:4d:6e:bf,756912,872,36660,756040,756912
44,4,1,1,2412,-90,-92,2,,757801,304,585,757497,757801
45,4,1,1,2412,-68,-92,24,54:e4:3a:ec:fb:64,760134,2160,173,757974,760134
46,4,1,1,2412,-72,-92,20,b8:3a:5a:88:e6:e0,787246,2360,24752,784886,787246
47,4,1,1,2412,-85,-92,7,b8:3a:5a:88:e6:e1,789644,2376,22,787268,789644
48,4,5.5,1,2412,-80,-92,12,ae:6a:50:8c:bb:bd,801289,403,11242,800886,801289
49,6,12,1,2412,-41,-92,51,40:e3:d6:da:ba:20,801677,136,252,801541,801677
50,4,1,1,2412,-84,-92,8,b8:3a:5a:88:e6:e0,801957,2240,-1960,799717,801957
51,6,12,1,2412,-41,-92,51,40:e3:d6:da:ba:20,804048,160,1931,803888,804048
52,6,6,1,2412,-41,-92,51,40:e3:d6:da:ba:21,804258,368,-158,803890,804258
53,6,12,1,2412,-41,-92,51,40:e3:d6:da:ba:22,804645,180,207,804465,804645
54,6,12,1,2412,-41,-92,51,40:e3:d6:da:ba:24,805069,176,248,804893,805069
55,6,12,1,2412,-41,-92,51,40:e3:d6:da:ba:25,805270,160,41,805110,805270
56,6,6,1,2412,-41,-92,51,40:e3:d6:da:ba:26,805462,380,-188,805082,805462
57,6,6,1,2412,-41,-92,51,40:e3:d6:da:ba:21,806387,348,577,806039,806387
58,6,6,1,2412,-58,-92,34,e6:aa:ea:c9:ea:33,807123,408,328,806715,807123
59,6,12,1,2412,-41,-92,51,40:e3:d6:da:ba:22,807677,156,398,807521,807677
60,6,12,1,2412,-41,-92,51,40:e3:d6:da:ba:23,807987,156,154,807831,807987
61,6,12,1,2412,-41,-92,51,40:e3:d6:da:ba:25,808177,136,54,808041,808177
62,6,12,1,2412,-85,-92,7,84:d4:7e:f2:42:23,808848,180,491,808668,808848
63,6,12,1,2412,-85,-92,7,84:d4:7e:f2:42:24,809072,176,48,808896,809072
64,6,12,1,2412,-83,-92,9,84:d4:7e:f2:42:25,809282,160,50,809122,809282
65,6,6,1,2412,-84,-92,8,84:d4:7e:f2:42:26,809474,380,-188,809094,809474
66,6,6,1,2412,-85,-92,7,84:d4:7e:f2:42:21,809888,348,66,809540,809888
67,6,12,1,2412,-86,-92,6,84:d4:7e:f2:42:22,810291,160,243,810131,810291
68,6,12,1,2412,-85,-92,7,84:d4:7e:f2:42:23,810486,160,35,810326,810486
69,6,12,1,2412,-85,-92,7,84:d4:7e:f2:42:25,810680,140,54,810540,810680
70,6,6,1,2412,-58,-92,34,e6:aa:ea:c9:ea:33,819237,408,8149,818829,819237
71,6,6,1,2412,-75,-92,17,e6:aa:ea:b7:4a:dd,830234,408,10589,829826,830234
72,6,6,1,2412,-58,-92,34,e6:aa:ea:c9:ea:33,831411,408,769,831003,831411
73,4,1,1,2412,-82,-92,10,,841700,304,9985,841396,841700
74,6,12,1,2412,-41,-92,51,40:e3:d6:da:ba:20,841864,136,28,841728,841864
75,6,6,1,2412,-41,-92,51,40:e3:d6:da:ba:21,842059,348,-153,841711,842059
76,6,12,1,2412,-41,-92,51,40:e3:d6:da:ba:22,842462,156,247,842306,842462
77,6,12,1,2412,-41,-92,51,40:e3:d6:da:ba:23,842670,156,52,842514,842670
78,6,12,1,2412,-41,-92,51,40:e3:d6:da:ba:25,842870,136,64,842734,842870
79,6,6,1,2412,-57,-92,35,e6:aa:ea:c9:ea:33,843816,408,538,843408,843816
80,4,1,1,2412,-65,-92,27,24:f6:77:10:02:c8,853375,1064,8495,852311,853375
81,4,1,1,2412,-64,-92,28,24:f6:77:10:02:c8,865703,1064,11264,864639,865703
82,6,6,1,2412,-75,-92,17,e6:aa:ea:b7:4a:dd,866658,408,547,866250,866658
83,6,6,1,2412,-80,-92,12,e6:aa:ea:c9:ea:1b,877192,408,10126,876784,877192
84,6,6,1,2412,-74,-92,18,e6:aa:ea:b7:4a:dd,878714,408,1114,878306,878714
85,6,6,1,2412,-79,-92,13,e6:aa:ea:c9:ea:1b,889245,408,10123,888837,889245
86,6,12,1,2412,-41,-92,51,40:e3:d6:da:ba:20,906338,160,16933,906178,906338
87,6,6,1,2412,-41,-92,51,40:e3:d6:da:ba:21,906529,368,-177,906161,906529
88,6,12,1,2412,-41,-92,51,40:e3:d6:da:ba:22,906934,180,225,906754,906934
89,6,12,1,2412,-41,-92,51,40:e3:d6:da:ba:23,907140,184,22,906956,907140
90,6,12,1,2412,-41,-92,51,40:e3:d6:da:ba:24,907349,176,33,907173,907349
91,6,12,1,2412,-41,-92,51,40:e3:d6:da:ba:25,907551,160,42,907391,907551
92,6,6,1,2412,-41,-92,51,40:e3:d6:da:ba:26,907770,380,-161,907390,907770
93,6,12,1,2412,-86,-92,6,84:d4:7e:f2:42:23,908219,180,269,908039,908219
94,6,12,1,2412,-87,-92,5,84:d4:7e:f2:42:24,908425,176,30,908249,908425
95,6,12,1,2412,-85,-92,7,84:d4:7e:f2:42:25,908653,160,68,908493,908653
96,4,1,1,2412,-58,-92,34,24:f6:77:10:02:c8,951709,1064,41992,950645,951709
97,4,1,1,2412,-68,-92,24,54:e4:3a:ec:fb:64,964932,2160,11063,962772,964932
98,6,12,1,2412,-41,-92,51,40:e3:d6:da:ba:20,1008023,160,42931,1007863,1008023
99,6,6,1,2412,-41,-92,51,40:e3:d6:da:ba:21,1008233,368,-158,1007865,1008233
100,6,12,1,2412,-41,-92,51,40:e3:d6:da:ba:22,1008638,180,225,1008458,1008638
101,6,12,1,2412,-41,-92,51,40:e3:d6:da:ba:23,1008852,184,30,1008668,1008852
102,6,12,1,2412,-41,-92,51,40:e3:d6:da:ba:24,1009080,176,52,1008904,1009080
103,6,12,1,2412,-41,-92,51,40:e3:d6:da:ba:25,1009308,160,68,1009148,1009308
104,6,6,1,2412,-41,-92,51,40:e3:d6:da:ba:26,1009500,380,-188,1009120,1009500
105,4,1,1,2412,-68,-92,24,54:e4:3a:ec:fb:64,1067331,2160,55671,1065171,1067331
106,4,1,1,2412,-85,-92,7,b8:3a:5a:88:e6:e1,1096974,2376,27267,1094598,1096974
107,6,6,1,2412,-58,-92,34,e6:aa:ea:c9:ea:33,1110378,408,12996,1109970,1110378
108,6,12,1,2412,-41,-92,51,40:e3:d6:da:ba:20,1110815,160,277,1110655,1110815
109,6,6,1,2412,-41,-92,51,40:e3:d6:da:ba:21,1111034,368,-149,1110666,1111034
110,6,12,1,2412,-41,-92,51,40:e3:d6:da:ba:22,1111430,180,216,1111250,1111430
111,6,12,1,2412,-41,-92,51,40:e3:d6:da:ba:23,1111645,184,31,1111461,1111645
112,6,12,1,2412,-41,-92,51,40:e3:d6:da:ba:24,1111872,176,51,1111696,1111872
113,6,12,1,2412,-41,-92,51,40:e3:d6:da:ba:25,1112074,160,42,1111914,1112074
114,6,6,1,2412,-41,-92,51,40:e3:d6:da:ba:26,1112284,380,-170,1111904,1112284
115,6,6,1,2412,-86,-92,6,84:d4:7e:f2:42:26,1112743,380,79,1112363,1112743
116,6,6,1,2412,-58,-92,34,e6:aa:ea:c9:ea:33,1122472,408,9321,1122064,1122472
117,6,6,1,2412,-58,-92,34,e6:aa:ea:c9:ea:33,1134582,408,11702,1134174,1134582
118,6,6,1,2412,-58,-92,34,e6:aa:ea:c9:ea:33,1146707,408,11717,1146299,1146707
119,6,6,1,2412,-57,-92,35,e6:aa:ea:c9:ea:33,1158825,408,11710,1158417,1158825
120,4,1,1,2412,-67,-92,25,54:e4:3a:ec:fb:64,1169731,2160,8746,1167571,1169731
121,4,1,1,2412,-86,-92,6,b8:3a:5a:88:e6:e1,1199221,2376,27114,1196845,1199221
122,6,6,1,2412,-89,-92,3,40:e3:d6:da:bb:e6,1210997,380,11396,1210617,1210997
123,6,12,1,2412,-41,-92,51,40:e3:d6:da:ba:20,1212841,160,1684,1212681,1212841
124,6,6,1,2412,-41,-92,51,40:e3:d6:da:ba:21,1213051,368,-158,1212683,1213051
125,6,12,1,2412,-41,-92,51,40:e3:d6:da:ba:22,1213493,180,262,1213313,1213493
126,6,12,1,2412,-40,-92,52,40:e3:d6:da:ba:23,1213742,184,65,1213558,1213742
127,6,12,1,2412,-41,-92,51,40:e3:d6:da:ba:24,1213978,176,60,1213802,1213978
128,6,12,1,2412,-41,-92,51,40:e3:d6:da:ba:25,1214180,160,42,1214020,1214180
129,6,6,1,2412,-41,-92,51,40:e3:d6:da:ba:26,1214390,380,-170,1214010,1214390
130,6,6,1,2412,-74,-92,18,e6:aa:ea:b7:4a:dd,1247998,408,33200,1247590,1247998
131,4,1,1,2412,-82,-92,10,c0:c9:e3:4d:6e:bf,1251076,872,2206,1250204,1251076
132,4,1,1,2412,-82,-92,10,,1251965,304,585,1251661,1251965
133,4,1,1,2412,-68,-92,24,54:e4:3a:ec:fb:64,1277601,2160,23476,1275441,1277601
134,6,6,1,2412,-73,-92,19,e6:aa:ea:b7:4a:dd,1284361,408,6352,1283953,1284361
135,4,1,1,2412,-80,-92,12,,1295153,304,10488,1294849,1295153
136,6,12,1,2412,-41,-92,51,40:e3:d6:da:ba:20,1315246,160,19933,1315086,1315246
137,6,12,1,2412,-41,-92,51,40:e3:d6:da:ba:22,1315861,180,435,1315681,1315861
138,6,12,1,2412,-41,-92,51,40:e3:d6:da:ba:24,1316303,176,266,1316127,1316303
139,6,12,1,2412,-41,-92,51,40:e3:d6:da:ba:25,1316523,160,60,1316363,1316523
140,6,6,1,2412,-41,-92,51,40:e3:d6:da:ba:26,1316724,380,-179,1316344,1316724
141,6,12,1,2412,-84,-92,8,84:d4:7e:f2:42:25,1317346,160,462,1317186,1317346
142,6,6,1,2412,-80,-92,12,e6:aa:ea:c9:ea:1b,1323348,408,5594,1322940,1323348
143,4,1,1,2412,-82,-92,10,a6:e5:7c:28:b1:d3,1362049,992,37709,1361057,1362049
144,4,1,1,2412,-68,-92,24,54:e4:3a:ec:fb:64,1374528,2160,10319,1372368,1374528
145,6,12,1,2412,-41,-92,51,40:e3:d6:da:ba:20,1417624,160,42936,1417464,1417624
146,6,6,1,2412,-41,-92,51,40:e3:d6:da:ba:21,1417843,368,-149,1417475,1417843
147,6,12,1,2412,-41,-92,51,40:e3:d6:da:ba:22,1418248,180,225,1418068,1418248
148,6,12,1,2412,-41,-92,51,40:e3:d6:da:ba:23,1418453,184,21,1418269,1418453
149,6,12,1,2412,-40,-92,52,40:e3:d6:da:ba:24,1418663,176,34,1418487,1418663
150,6,12,1,2412,-41,-92,51,40:e3:d6:da:ba:25,1418891,160,68,1418731,1418891
151,6,6,1,2412,-41,-92,51,40:e3:d6:da:ba:26,1419101,380,-170,1418721,1419101
152,6,6,1,2412,-58,-92,34,e6:aa:ea:c9:ea:33,1425404,408,5895,1424996,1425404
153,6,6,1,2412,-58,-92,34,e6:aa:ea:c9:ea:33,1437524,408,11712,1437116,1437524
154,6,6,1,2412,-58,-92,34,e6:aa:ea:c9:ea:33,1449639,408,11707,1449231,1449639
155,6,6,1,2412,-57,-92,35,e6:aa:ea:c9:ea:33,1461747,408,11700,1461339,1461747
156,4,1,1,2412,-81,-92,11,a6:e5:7c:28:b1:d3,1464783,992,2044,1463791,1464783
157,6,6,1,2412,-58,-92,34,e6:aa:ea:c9:ea:33,1473853,408,8662,1473445,1473853
158,4,1,1,2412,-68,-92,24,54:e4:3a:ec:fb:64,1476928,2160,915,1474768,1476928
159,6,12,1,2412,-62,-92,30,40:e3:d6:da:bb:60,1480171,960,2283,1479211,1480171
160,4,1,1,2412,-88,-92,4,,1498999,304,18524,1498695,1498999
161,4,1,1,2412,-85,-92,7,b8:3a:5a:88:e6:e0,1504559,2360,3200,1502199,1504559
162,4,1,1,2412,-86,-92,6,b8:3a:5a:88:e6:e1,1506938,2376,3,1504562,1506938
163,6,12,1,2412,-41,-92,51,40:e3:d6:da:ba:20,1520033,160,12935,1519873,1520033
164,6,6,1,2412,-41,-92,51,40:e3:d6:da:ba:21,1520225,368,-176,1519857,1520225
165,6,12,1,2412,-41,-92,51,40:e3:d6:da:ba:22,1520612,180,207,1520432,1520612
166,6,12,1,2412,-41,-92,51,40:e3:d6:da:ba:23,1520826,184,30,1520642,1520826
167,6,12,1,2412,-41,-92,51,40:e3:d6:da:ba:24,1521045,176,43,1520869,1521045
168,6,12,1,2412,-41,-92,51,40:e3:d6:da:ba:25,1521255,160,50,1521095,1521255
169,6,6,1,2412,-41,-92,51,40:e3:d6:da:ba:26,1521474,380,-161,1521094,1521474
170,6,12,1,2412,-86,-92,6,84:d4:7e:f2:42:24,1521924,176,274,1521748,1521924
171,6,12,1,2412,-85,-92,7,84:d4:7e:f2:42:25,1522134,160,50,1521974,1522134
172,6,6,1,2412,-85,-92,7,84:d4:7e:f2:42:26,1522335,380,-179,1521955,1522335
173,4,1,1,2412,-76,-92,16,,1569945,304,47306,1569641,1569945
174,6,6,1,2412,-74,-92,18,e6:aa:ea:b7:4a:dd,1575513,408,5160,1575105,1575513
175,4,1,1,2412,-68,-92,24,54:e4:3a:ec:fb:64,1579327,2160,1654,1577167,1579327
176,6,6,1,2412,-75,-92,17,e6:aa:ea:b7:4a:dd,1587630,408,7895,1587222,1587630
177,4,1,1,2412,-72,-92,20,b8:3a:5a:88:e6:e0,1606444,2360,16454,1604084,1606444
178,6,6,1,2412,-75,-92,17,e6:aa:ea:b7:4a:dd,1611858,408,5006,1611450,1611858
179,6,12,1,2412,-41,-92,51,40:e3:d6:da:ba:20,1622430,160,10412,1622270,1622430
180,6,6,1,2412,-41,-92,51,40:e3:d6:da:ba:21,1622621,368,-177,1622253,1622621
181,6,12,1,2412,-41,-92,51,40:e3:d6:da:ba:22,1623026,180,225,1622846,1623026
182,6,12,1,2412,-41,-92,51,40:e3:d6:da:ba:23,1623232,184,22,1623048,1623232
183,6,12,1,2412,-41,-92,51,40:e3:d6:da:ba:24,1623666,176,258,1623490,1623666
184,6,12,1,2412,-41,-92,51,40:e3:d6:da:ba:25,1623867,160,41,1623707,1623867
185,6,6,1,2412,-41,-92,51,40:e3:d6:da:ba:26,1624077,380,-170,1623697,1624077
186,6,12,1,2412,-85,-92,7,84:d4:7e:f2:42:25,1627008,160,2771,1626848,1627008
187,6,6,1,2412,-84,-92,8,84:d4:7e:f2:42:26,1627209,380,-179,1626829,1627209
188,4,1,1,2412,-68,-92,24,54:e4:3a:ec:fb:64,1681725,2160,52356,1679565,1681725
189,6,12,1,2412,-41,-92,51,40:e3:d6:da:ba:20,1724841,160,42956,1724681,1724841
190,6,6,1,2412,-41,-92,51,40:e3:d6:da:ba:21,1725042,368,-167,1724674,1725042
191,6,12,1,2412,-41,-92,51,40:e3:d6:da:ba:22,1725447,180,225,1725267,1725447
192,6,12,1,2412,-41,-92,51,40:e3:d6:da:ba:23,1725680,184,49,1725496,1725680
193,6,12,1,2412,-41,-92,51,40:e3:d6:da:ba:24,1725889,176,33,1725713,1725889
194,6,12,1,2412,-41,-92,51,40:e3:d6:da:ba:25,1726118,160,69,1725958,1726118
195,6,6,1,2412,-41,-92,51,40:e3:d6:da:ba:26,1726310,380,-188,1725930,1726310
196,6,12,1,2412,-85,-92,7,84:d4:7e:f2:42:24,1726715,176,229,1726539,1726715
197,6,6,1,2412,-85,-92,7,84:d4:7e:f2:42:26,1727144,380,49,1726764,1727144
198,6,6,1,2412,-80,-92,12,e6:aa:ea:c9:ea:1b,1731758,408,4206,1731350,1731758
199,4,1,1,2412,-81,-92,11,c0:c9:e3:4d:6e:bf,1742768,872,10138,1741896,1742768
200,4,1,1,2412,-81,-92,11,,1743657,304,585,1743353,1743657
201,6,6,1,2412,-80,-92,12,e6:aa:ea:c9:ea:1b,1743879,408,-186,1743471,1743879
202,4,1,1,2412,-69,-92,23,54:e4:3a:ec:fb:64,1784125,2160,38086,1781965,1784125
203,4,1,1,2412,-84,-92,8,b8:3a:5a:88:e6:e1,1813653,2376,27152,1811277,1813653
204,6,12,1,2412,-41,-92,51,40:e3:d6:da:ba:20,1827251,160,13438,1827091,1827251
205,6,6,1,2412,-41,-92,51,40:e3:d6:da:ba:21,1827443,368,-176,1827075,1827443
206,6,12,1,2412,-41,-92,51,40:e3:d6:da:ba:22,1827839,180,216,1827659,1827839
207,6,12,1,2412,-41,-92,51,40:e3:d6:da:ba:23,1828044,184,21,1827860,1828044
208,6,12,1,2412,-41,-92,51,40:e3:d6:da:ba:24,1828253,176,33,1828077,1828253
209,6,12,1,2412,-41,-92,51,40:e3:d6:da:ba:25,1828455,160,42,1828295,1828455
210,6,6,1,2412,-41,-92,51,40:e3:d6:da:ba:26,1828665,380,-170,1828285,1828665
211,4,1,1,2412,-60,-92,32,54:e4:3a:ec:fb:64,1886539,2160,55714,1884379,1886539
212,6,12,1,2412,-41,-92,51,40:e3:d6:da:ba:20,1929634,160,42935,1929474,1929634
213,6,6,1,2412,-41,-92,51,40:e3:d6:da:ba:21,1929844,368,-158,1929476,1929844
214,6,12,1,2412,-41,-92,51,40:e3:d6:da:ba:22,1930240,180,216,1930060,1930240
215,6,12,1,2412,-41,-92,51,40:e3:d6:da:ba:23,1930454,184,30,1930270,1930454
216,6,12,1,2412,-42,-92,50,40:e3:d6:da:ba:24,1930673,176,43,1930497,1930673
217,6,12,1,2412,-41,-92,51,40:e3:d6:da:ba:25,1930874,160,41,1930714,1930874
218,6,6,1,2412,-41,-92,51,40:e3:d6:da:ba:26,1931066,380,-188,1930686,1931066
219,6,6,1,2412,-57,-92,35,e6:aa:ea:c9:ea:33,1945026,408,13552,1944618,1945026
220,6,6,1,2412,-57,-92,35,e6:aa:ea:c9:ea:33,1957030,408,11596,1956622,1957030
221,6,6,1,2412,-57,-92,35,e6:aa:ea:c9:ea:33,1981672,408,24234,1981264,1981672
222,4,1,1,2412,-68,-92,24,54:e4:3a:ec:fb:64,1988922,2160,5090,1986762,1988922
223,6,6,1,2412,-80,-92,12,e6:aa:ea:c9:ea:1b,2024002,408,34672,2023594,2024002
224,6,12,1,2412,-42,-92,50,40:e3:d6:da:ba:20,2032040,160,7878,2031880,2032040
225,6,6,1,2412,-42,-92,50,40:e3:d6:da:ba:21,2032241,368,-167,2031873,2032241
226,6,12,1,2412,-42,-92,50,40:e3:d6:da:ba:22,2032637,180,216,2032457,2032637
227,6,12,1,2412,-42,-92,50,40:e3:d6:da:ba:23,2032842,184,21,2032658,2032842
228,6,12,1,2412,-42,-92,50,40:e3:d6:da:ba:24,2033070,176,52,2032894,2033070
229,6,12,1,2412,-42,-92,50,40:e3:d6:da:ba:25,2033280,160,50,2033120,2033280
230,6,6,1,2412,-42,-92,50,40:e3:d6:da:ba:26,2033499,380,-161,2033119,2033499
231,6,6,1,2412,-80,-92,12,e6:aa:ea:c9:ea:1b,2036122,408,2215,2035714,2036122
232,6,6,1,2412,-81,-92,11,e6:aa:ea:c9:ea:1b,2072454,408,35924,2072046,2072454
233,6,6,1,2412,-71,-92,21,e6:aa:ea:b7:4a:dd,2083697,408,10835,2083289,2083697
234,4,1,1,2412,-67,-92,25,54:e4:3a:ec:fb:64,2091321,2160,5464,2089161,2091321
235,6,6,1,2412,-73,-92,19,e6:aa:ea:b7:4a:dd,2095823,408,4094,2095415,2095823
236,6,6,1,2412,-73,-92,19,e6:aa:ea:b7:4a:dd,2107944,408,11713,2107536,2107944
237,6,12,1,2412,-43,-92,49,40:e3:d6:da:ba:20,2134437,160,26333,2134277,2134437
238,6,6,1,2412,-42,-92,50,40:e3:d6:da:ba:21,2134656,368,-149,2134288,2134656
239,6,12,1,2412,-42,-92,50,40:e3:d6:da:ba:22,2135043,180,207,2134863,2135043
240,6,12,1,2412,-42,-92,50,40:e3:d6:da:ba:23,2135276,184,49,2135092,2135276
241,6,12,1,2412,-42,-92,50,40:e3:d6:da:ba:24,2135503,176,51,2135327,2135503
242,6,12,1,2412,-42,-92,50,40:e3:d6:da:ba:25,2135723,160,60,2135563,2135723
243,6,6,1,2412,-43,-92,49,40:e3:d6:da:ba:26,2135933,380,-170,2135553,2135933
244,6,12,1,2412,-88,-92,4,84:d4:7e:f2:42:24,2136322,176,213,2136146,2136322
245,6,12,1,2412,-86,-92,6,84:d4:7e:f2:42:25,2136532,160,50,2136372,2136532
246,6,6,1,2412,-87,-92,5,84:d4:7e:f2:42:26,2136742,380,-170,2136362,2136742
247,6,6,1,2412,-90,-92,2,40:e3:d6:da:ca:c6,2150938,380,13816,2150558,2150938
248,4,1,1,2412,-68,-92,24,54:e4:3a:ec:fb:64,2193721,2160,40623,2191561,2193721
249,4,1,1,2412,-86,-92,6,b8:3a:5a:88:e6:e0,2220844,2360,24763,2218484,2220844
250,6,12,1,2412,-43,-92,49,40:e3:d6:da:ba:20,2236849,160,15845,2236689,2236849
251,6,12,1,2412,-43,-92,49,40:e3:d6:da:ba:24,2237861,176,836,2237685,2237861
252,6,12,1,2412,-43,-92,49,40:e3:d6:da:ba:25,2238072,160,51,2237912,2238072
253,6,6,1,2412,-43,-92,49,40:e3:d6:da:ba:26,2238264,380,-188,2237884,2238264
254,6,6,1,2412,-63,-92,29,e6:aa:ea:c9:ea:33,2260303,408,21631,2259895,2260303
255,6,6,1,2412,-63,-92,29,e6:aa:ea:c9:ea:33,2272411,408,11700,2272003,2272411
256,6,6,1,2412,-63,-92,29,e6:aa:ea:c9:ea:33,2284418,408,11599,2284010,2284418
257,4,1,1,2412,-64,-92,28,54:e4:3a:ec:fb:64,2296120,2160,9542,2293960,2296120
258,6,12,1,2412,-42,-92,50,40:e3:d6:da:ba:20,2339228,160,42948,2339068,2339228
259,6,6,1,2412,-42,-92,50,40:e3:d6:da:ba:21,2339420,368,-176,2339052,2339420
260,6,12,1,2412,-42,-92,50,40:e3:d6:da:ba:22,2339807,180,207,2339627,2339807
261,6,12,1,2412,-42,-92,50,40:e3:d6:da:ba:23,2340022,184,31,2339838,2340022
262,6,12,1,2412,-40,-92,52,40:e3:d6:da:ba:24,2340249,176,51,2340073,2340249
263,6,6,1,2412,-42,-92,50,40:e3:d6:da:ba:26,2340670,380,41,2340290,2340670
264,6,12,1,2412,-89,-92,3,84:d4:7e:f2:42:24,2341094,176,248,2340918,2341094
265,6,6,1,2412,-80,-92,12,e6:aa:ea:c9:ea:1b,2365554,408,24052,2365146,2365554
266,6,6,1,2412,-81,-92,11,e6:aa:ea:c9:ea:1b,2377669,408,11707,2377261,2377669
267,6,6,1,2412,-79,-92,13,e6:aa:ea:c9:ea:1b,2389779,408,11702,2389371,2389779
268,4,1,1,2412,-63,-92,29,b8:3a:5a:88:e6:e0,2391396,2240,-623,2389156,2391396
269,4,1,1,2412,-86,-92,6,,2397828,304,6128,2397524,2397828
270,4,1,1,2412,-69,-92,23,54:e4:3a:ec:fb:64,2398519,2160,-1469,2396359,2398519
271,4,1,1,2412,-82,-92,10,b8:3a:5a:88:e6:e1,2414493,2256,13718,2412237,2414493
272,4,1,1,2412,-81,-92,11,b8:3a:5a:88:e6:e0,2425766,2360,8913,2423406,2425766
273,4,1,1,2412,-80,-92,12,b8:3a:5a:88:e6:e1,2428197,2376,55,2425821,2428197
274,6,12,1,2412,-42,-92,50,40:e3:d6:da:ba:20,2441628,160,13271,2441468,2441628
275,6,6,1,2412,-42,-92,50,40:e3:d6:da:ba:21,2441820,368,-176,2441452,2441820
276,6,12,1,2412,-42,-92,50,40:e3:d6:da:ba:22,2442207,180,207,2442027,2442207
277,6,12,1,2412,-42,-92,50,40:e3:d6:da:ba:25,2442878,160,511,2442718,2442878
278,6,6,1,2412,-42,-92,50,40:e3:d6:da:ba:26,2443069,380,-189,2442689,2443069
279,4,1,1,2412,-79,-92,13,b8:3a:5a:88:e6:e1,2480933,2256,35608,2478677,2480933
280,4,1,1,2412,-72,-92,20,54:e4:3a:ec:fb:64,2500919,2160,17826,2498759,2500919
281,6,6,1,2412,-85,-92,7,,2540213,44,39250,2540169,2540213
282,6,12,1,2412,-41,-92,51,40:e3:d6:da:ba:20,2544053,160,3680,2543893,2544053
283,6,6,1,2412,-41,-92,51,40:e3:d6:da:ba:21,2544263,368,-158,2543895,2544263
284,6,12,1,2412,-41,-92,51,40:e3:d6:da:ba:23,2544882,184,435,2544698,2544882
285,6,12,1,2412,-41,-92,51,40:e3:d6:da:ba:24,2545119,176,61,2544943,2545119
286,6,12,1,2412,-41,-92,51,40:e3:d6:da:ba:25,2545471,160,192,2545311,2545471
287,6,6,1,2412,-41,-92,51,40:e3:d6:da:ba:26,2545690,380,-161,2545310,2545690
288,6,6,1,2412,-71,-92,21,e6:aa:ea:b7:4a:dd,2615951,408,69853,2615543,2615951
289,6,6,1,2412,-71,-92,21,e6:aa:ea:b7:4a:dd,2640182,408,23823,2639774,2640182
290,6,12,1,2412,-41,-92,51,40:e3:d6:da:ba:20,2646446,160,6104,2646286,2646446
291,6,6,1,2412,-41,-92,51,40:e3:d6:da:ba:21,2646665,368,-149,2646297,2646665
292,6,12,1,2412,-41,-92,51,40:e3:d6:da:ba:22,2647070,180,225,2646890,2647070
293,6,12,1,2412,-41,-92,51,40:e3:d6:da:ba:23,2647275,184,21,2647091,2647275
294,6,12,1,2412,-41,-92,51,40:e3:d6:da:ba:24,2647512,176,61,2647336,2647512
295,6,12,1,2412,-41,-92,51,40:e3:d6:da:ba:25,2647740,160,68,2647580,2647740
296,6,6,1,2412,-41,-92,51,40:e3:d6:da:ba:26,2647941,380,-179,2647561,2647941
297,6,12,1,2412,-89,-92,3,84:d4:7e:f2:42:24,2648360,176,243,2648184,2648360
298,6,12,1,2412,-88,-92,4,84:d4:7e:f2:42:25,2648589,160,69,2648429,2648589
299,6,6,1,2412,-89,-92,3,84:d4:7e:f2:42:26,2648790,380,-179,2648410,2648790
300,6,6,1,2412,-58,-92,34,e6:aa:ea:c9:ea:33,2690670,408,41472,2690262,2690670
301,6,6,1,2412,-59,-92,33,e6:aa:ea:c9:ea:33,2702792,408,11714,2702384,2702792
302,4,1,1,2412,-73,-92,19,54:e4:3a:ec:fb:64,2705973,2160,1021,2703813,2705973
303,6,6,1,2412,-60,-92,32,e6:aa:ea:c9:ea:33,2727465,408,21084,2727057,2727465
304,4,1,1,2412,-81,-92,11,c0:c9:e3:4d:6e:bf,2732716,872,4379,2731844,2732716
305,4,1,1,2412,-80,-92,12,b8:3a:5a:88:e6:e0,2733611,2360,-1465,2731251,2733611
306,4,1,1,2412,-79,-92,13,b8:3a:5a:88:e6:e1,2736018,2376,31,2733642,2736018
307,6,12,1,2412,-40,-92,52,40:e3:d6:da:ba:20,2748832,160,12654,2748672,2748832
308,6,6,1,2412,-41,-92,51,40:e3:d6:da:ba:21,2749033,368,-167,2748665,2749033
309,6,12,1,2412,-40,-92,52,40:e3:d6:da:ba:22,2749429,180,216,2749249,2749429
310,6,12,1,2412,-40,-92,52,40:e3:d6:da:ba:23,2749661,184,48,2749477,2749661
311,6,12,1,2412,-40,-92,52,40:e3:d6:da:ba:24,2749880,176,43,2749704,2749880
312,6,12,1,2412,-40,-92,52,40:e3:d6:da:ba:25,2750099,160,59,2749939,2750099
313,6,6,1,2412,-40,-92,52,40:e3:d6:da:ba:26,2750300,380,-179,2749920,2750300
314,6,12,1,2412,-87,-92,5,84:d4:7e:f2:42:24,2750705,176,229,2750529,2750705
315,4,1,1,2412,-84,-92,8,c0:c9:e3:4d:6e:bf,2778511,872,26934,2777639,2778511
316,4,5.5,1,2412,-65,-92,27,,2784766,213,6042,2784553,2784766
317,4,1,1,2412,-81,-92,11,b8:3a:5a:88:e6:e0,2786227,2240,-779,2783987,2786227
318,4,5.5,1,2412,-87,-92,5,,2805009,213,18569,2804796,2805009
319,4,1,1,2412,-71,-92,21,54:e4:3a:ec:fb:64,2808116,2160,947,2805956,2808116
320,4,1,1,2412,-80,-92,12,b8:3a:5a:88:e6:e0,2835262,2360,24786,2832902,2835262
321,4,1,1,2412,-78,-92,14,b8:3a:5a:88:e6:e1,2837660,2376,22,2835284,2837660
322,6,6,1,2412,-40,-92,52,40:e3:d6:da:ba:21,2851428,368,13400,2851060,2851428
323,6,12,1,2412,-40,-92,52,40:e3:d6:da:ba:22,2851833,180,225,2851653,2851833
324,6,12,1,2412,-40,-92,52,40:e3:d6:da:ba:23,2852039,184,22,2851855,2852039
325,6,12,1,2412,-40,-92,52,40:e3:d6:da:ba:24,2852257,176,42,2852081,2852257
326,6,12,1,2412,-40,-92,52,40:e3:d6:da:ba:25,2852459,160,42,2852299,2852459
327,6,6,1,2412,-40,-92,52,40:e3:d6:da:ba:26,2852659,380,-180,2852279,2852659
328,6,12,1,2412,-80,-92,12,84:d4:7e:f2:42:25,2853354,160,535,2853194,2853354
329,6,6,1,2412,-78,-92,14,e6:aa:ea:c9:ea:1b,2902959,408,49197,2902551,2902959
330,4,1,1,2412,-68,-92,24,54:e4:3a:ec:fb:64,2910833,2160,5714,2908673,2910833
331,4,1,1,2412,-80,-92,12,b8:3a:5a:88:e6:e0,2938409,2360,25216,2936049,2938409
332,6,12,1,2412,-40,-92,52,40:e3:d6:da:ba:20,2953649,160,15080,2953489,2953649
333,6,6,1,2412,-40,-92,52,40:e3:d6:da:ba:21,2953859,368,-158,2953491,2953859
334,6,12,1,2412,-40,-92,52,40:e3:d6:da:ba:22,2954246,180,207,2954066,2954246
335,6,12,1,2412,-40,-92,52,40:e3:d6:da:ba:23,2954451,184,21,2954267,2954451
336,6,12,1,2412,-40,-92,52,40:e3:d6:da:ba:24,2954669,176,42,2954493,2954669
337,6,12,1,2412,-40,-92,52,40:e3:d6:da:ba:25,2954871,160,42,2954711,2954871
338,6,6,1,2412,-40,-92,52,40:e3:d6:da:ba:26,2955072,380,-179,2954692,2955072
339,6,6,1,2412,-86,-92,6,84:d4:7e:f2:42:26,2955875,380,423,2955495,2955875
340,4,1,1,2412,-67,-92,25,54:e4:3a:ec:fb:64,3012976,2160,54941,3010816,3012976
341,4,1,1,2412,-83,-92,9,b8:3a:5a:88:e6:e0,3040047,2360,24711,3037687,3040047
342,6,12,1,2412,-40,-92,52,40:e3:d6:da:ba:20,3056058,160,15851,3055898,3056058
343,6,6,1,2412,-40,-92,52,40:e3:d6:da:ba:21,3056250,368,-176,3055882,3056250
344,6,12,1,2412,-40,-92,52,40:e3:d6:da:ba:22,3056637,180,207,3056457,3056637
345,6,12,1,2412,-40,-92,52,40:e3:d6:da:ba:23,3056870,184,49,3056686,3056870
346,6,12,1,2412,-40,-92,52,40:e3:d6:da:ba:24,3057107,176,61,3056931,3057107
347,6,12,1,2412,-40,-92,52,40:e3:d6:da:ba:25,3057336,160,69,3057176,3057336
348,6,6,1,2412,-40,-92,52,40:e3:d6:da:ba:26,3057546,380,-170,3057166,3057546
349,6,12,1,2412,-87,-92,5,84:d4:7e:f2:42:25,3058136,160,430,3057976,3058136
350,4,1,1,2412,-75,-92,17,a6:e5:7c:28:b1:d3,3102470,992,43342,3101478,3102470
351,4,1,1,2412,-70,-92,22,54:e4:3a:ec:fb:64,3115325,2160,10695,3113165,3115325
352,6,6,1,2412,-71,-92,21,e6:aa:ea:b7:4a:dd,3124274,408,8541,3123866,3124274
353,6,6,1,2412,-70,-92,22,e6:aa:ea:b7:4a:dd,3136392,408,11710,3135984,3136392
354,6,6,1,2412,-70,-92,22,e6:aa:ea:b7:4a:dd,3148511,408,11711,3148103,3148511
355,6,12,1,2412,-39,-92,53,40:e3:d6:da:ba:20,3158439,160,9768,3158279,3158439
356,6,6,1,2412,-39,-92,53,40:e3:d6:da:ba:21,3158631,368,-176,3158263,3158631
357,6,12,1,2412,-39,-92,53,40:e3:d6:da:ba:22,3159036,180,225,3158856,3159036
358,6,12,1,2412,-38,-92,54,40:e3:d6:da:ba:23,3159268,184,48,3159084,3159268
359,6,12,1,2412,-39,-92,53,40:e3:d6:da:ba:24,3159496,176,52,3159320,3159496
360,6,12,1,2412,-39,-92,53,40:e3:d6:da:ba:25,3159706,160,50,3159546,3159706
361,6,6,1,2412,-42,-92,50,40:e3:d6:da:ba:26,3159925,380,-161,3159545,3159925
362,6,6,1,2412,-70,-92,22,e6:aa:ea:b7:4a:dd,3172746,408,12413,3172338,3172746
363,6,6,1,2412,-54,-92,38,e6:aa:ea:c9:ea:33,3210062,408,36908,3209654,3210062
364,4,1,1,2412,-65,-92,27,54:e4:3a:ec:fb:64,3217732,2160,5510,3215572,3217732
365,6,6,1,2412,-55,-92,37,e6:aa:ea:c9:ea:33,3222171,408,4031,3221763,3222171
366,4,1,1,2412,-85,-92,7,c0:c9:e3:4d:6e:bf,3228233,872,5190,3227361,3228233
367,6,12,1,2412,-38,-92,54,40:e3:d6:da:ba:22,3261451,180,33038,3261271,3261451
368,6,12,1,2412,-38,-92,54,40:e3:d6:da:ba:23,3261657,184,22,3261473,3261657
369,6,12,1,2412,-38,-92,54,40:e3:d6:da:ba:24,3261884,176,51,3261708,3261884
370,6,12,1,2412,-38,-92,54,40:e3:d6:da:ba:25,3262112,160,68,3261952,3262112
371,6,6,1,2412,-38,-92,54,40:e3:d6:da:ba:26,3262322,380,-170,3261942,3262322
372,4,1,1,2412,-64,-92,28,54:e4:3a:ec:fb:64,3320110,2160,55628,3317950,3320110
373,4,1,1,2412,-80,-92,12,b8:3a:5a:88:e6:e0,3347244,2360,24774,3344884,3347244
374,4,1,1,2412,-81,-92,11,b8:3a:5a:88:e6:e1,3349742,2376,122,3347366,3349742
375,6,12,1,2412,-40,-92,52,40:e3:d6:da:ba:20,3363247,160,13345,3363087,3363247
376,6,6,1,2412,-40,-92,52,40:e3:d6:da:ba:21,3363448,368,-167,3363080,3363448
377,6,12,1,2412,-40,-92,52,40:e3:d6:da:ba:22,3363835,180,207,3363655,3363835
378,6,12,1,2412,-40,-92,52,40:e3:d6:da:ba:23,3364040,184,21,3363856,3364040
379,6,12,1,2412,-40,-92,52,40:e3:d6:da:ba:24,3364250,176,34,3364074,3364250
380,6,12,1,2412,-40,-92,52,40:e3:d6:da:ba:25,3364451,160,41,3364291,3364451
381,6,6,1,2412,-40,-92,52,40:e3:d6:da:ba:26,3364643,380,-188,3364263,3364643
382,6,12,1,2412,-88,-92,4,84:d4:7e:f2:42:25,3365339,160,536,3365179,3365339
383,4,1,1,2412,-69,-92,23,54:e4:3a:ec:fb:64,3422509,2160,55010,3420349,3422509
384,6,6,1,2412,-70,-92,22,e6:aa:ea:b7:4a:dd,3439777,408,16860,3439369,3439777
385,6,6,1,2412,-88,-92,4,40:e3:d6:da:bb:e1,3462557,368,22412,3462189,3462557
386,6,6,1,2412,-70,-92,22,e6:aa:ea:b7:4a:dd,3464007,408,1042,3463599,3464007
387,6,12,1,2412,-40,-92,52,40:e3:d6:da:ba:20,3465659,160,1492,3465499,3465659
388,6,6,1,2412,-40,-92,52,40:e3:d6:da:ba:21,3465860,368,-167,3465492,3465860
389,6,12,1,2412,-40,-92,52,40:e3:d6:da:ba:22,3466256,180,216,3466076,3466256
390,6,12,1,2412,-40,-92,52,40:e3:d6:da:ba:23,3466470,184,30,3466286,3466470
391,6,12,1,2412,-40,-92,52,40:e3:d6:da:ba:24,3466707,176,61,3466531,3466707
392,6,12,1,2412,-40,-92,52,40:e3:d6:da:ba:25,3466917,160,50,3466757,3466917
393,6,6,1,2412,-40,-92,52,40:e3:d6:da:ba:26,3467136,380,-161,3466756,3467136
394,6,12,1,2412,-87,-92,5,84:d4:7e:f2:42:24,3467552,176,240,3467376,3467552
395,6,12,1,2412,-86,-92,6,84:d4:7e:f2:42:25,3467762,160,50,3467602,3467762
396,6,6,1,2412,-87,-92,5,84:d4:7e:f2:42:26,3467954,380,-188,3467574,3467954
397,6,6,1,2412,-70,-92,22,e6:aa:ea:b7:4a:dd,3476299,408,7937,3475891,3476299
398,6,6,1,2412,-71,-92,21,e6:aa:ea:b7:4a:dd,3488245,408,11538,3487837,3488245
399,6,6,1,2412,-59,-92,33,e6:aa:ea:c9:ea:33,3537684,408,49031,3537276,3537684
400,6,6,1,2412,-61,-92,31,e6:aa:ea:c9:ea:33,3561079,408,22987,3560671,3561079
401,6,12,1,2412,-41,-92,51,40:e3:d6:da:ba:20,3568038,160,6799,3567878,3568038
402,6,6,1,2412,-41,-92,51,40:e3:d6:da:ba:21,3568230,368,-176,3567862,3568230
403,6,12,1,2412,-40,-92,52,40:e3:d6:da:ba:22,3568644,180,234,3568464,3568644
404,6,12,1,2412,-41,-92,51,40:e3:d6:da:ba:23,3568867,184,39,3568683,3568867
405,6,6,1,2412,-41,-92,51,40:e3:d6:da:ba:26,3569585,380,338,3569205,3569585
406,6,12,1,2412,-89,-92,3,84:d4:7e:f2:42:25,3570148,160,403,3569988,3570148
407,6,6,1,2412,-87,-92,5,40:e3:d6:da:ca:c6,3584480,380,13952,3584100,3584480
408,4,1,1,2412,-81,-92,11,a6:e5:7c:28:b1:d3,3615920,992,30448,3614928,3615920
409,4,1,1,2412,-67,-92,25,54:e4:3a:ec:fb:64,3627307,2160,9227,3625147,3627307
410,6,6,1,2412,-41,-92,51,40:e3:d6:da:ba:21,3670817,368,43142,3670449,3670817
411,6,12,1,2412,-41,-92,51,40:e3:d6:da:ba:22,3671213,180,216,3671033,3671213
412,6,12,1,2412,-41,-92,51,40:e3:d6:da:ba:24,3671749,176,360,3671573,3671749
413,6,12,1,2412,-41,-92,51,40:e3:d6:da:ba:25,3671960,160,51,3671800,3671960
414,6,6,1,2412,-41,-92,51,40:e3:d6:da:ba:26,3672170,380,-170,3671790,3672170
415,4,1,1,2412,-67,-92,25,54:e4:3a:ec:fb:64,3729706,2160,55376,3727546,3729706
416,4,1,1,2412,-84,-92,8,,3749217,304,19207,3748913,3749217
417,6,6,1,2412,-74,-92,18,e6:aa:ea:b7:4a:dd,3754451,408,4826,3754043,3754451
418,4,1,1,2412,-74,-92,18,b8:3a:5a:88:e6:e1,3759275,2376,2448,3756899,3759275
419,6,12,1,2412,-40,-92,52,40:e3:d6:da:ba:20,3772834,160,13399,3772674,3772834
420,6,6,1,2412,-40,-92,52,40:e3:d6:da:ba:21,3773035,368,-167,3772667,3773035
421,6,12,1,2412,-40,-92,52,40:e3:d6:da:ba:22,3773422,180,207,3773242,3773422
422,6,12,1,2412,-40,-92,52,40:e3:d6:da:ba:23,3773655,184,49,3773471,3773655
423,6,12,1,2412,-40,-92,52,40:e3:d6:da:ba:24,3773873,176,42,3773697,3773873
424,6,12,1,2412,-40,-92,52,40:e3:d6:da:ba:25,3774174,160,141,3774014,3774174
425,6,6,1,2412,-40,-92,52,40:e3:d6:da:ba:26,3774393,380,-161,3774013,3774393
426,6,6,1,2412,-73,-92,19,e6:aa:ea:b7:4a:dd,3778691,408,3890,3778283,3778691
427,6,6,1,2412,-73,-92,19,e6:aa:ea:b7:4a:dd,3790808,408,11709,3790400,3790808
428,4,1,1,2412,-80,-92,12,b8:3a:5a:88:e6:e0,3859250,2360,66082,3856890,3859250
429,4,1,1,2412,-77,-92,15,b8:3a:5a:88:e6:e1,3861639,2376,13,3859263,3861639
430,6,12,1,2412,-41,-92,51,40:e3:d6:da:ba:20,3875491,160,13692,3875331,3875491
431,6,6,1,2412,-41,-92,51,40:e3:d6:da:ba:21,3875701,368,-158,3875333,3875701
432,6,12,1,2412,-41,-92,51,40:e3:d6:da:ba:22,3876088,180,207,3875908,3876088
433,6,12,1,2412,-41,-92,51,40:e3:d6:da:ba:23,3876338,184,66,3876154,3876338
434,6,12,1,2412,-41,-92,51,40:e3:d6:da:ba:24,3876575,176,61,3876399,3876575
435,6,12,1,2412,-41,-92,51,40:e3:d6:da:ba:25,3876785,160,50,3876625,3876785
436,6,6,1,2412,-41,-92,51,40:e3:d6:da:ba:26,3876986,380,-179,3876606,3876986
437,4,1,1,2412,-64,-92,28,54:e4:3a:ec:fb:64,3934504,2160,55358,3932344,3934504
438,4,1,1,2412,-84,-92,8,b8:3a:5a:88:e6:e0,3961660,2360,24796,3959300,3961660
439,4,1,1,2412,-84,-92,8,b8:3a:5a:88:e6:e1,3964049,2376,13,3961673,3964049
440,6,12,1,2412,-41,-92,51,40:e3:d6:da:ba:20,3977635,160,13426,3977475,3977635
441,6,6,1,2412,-41,-92,51,40:e3:d6:da:ba:21,3977854,368,-149,3977486,3977854
442,6,12,1,2412,-41,-92,51,40:e3:d6:da:ba:22,3978241,180,207,3978061,3978241
443,6,12,1,2412,-41,-92,51,40:e3:d6:da:ba:23,3978464,184,39,3978280,3978464
444,6,12,1,2412,-41,-92,51,40:e3:d6:da:ba:25,3978911,160,287,3978751,3978911
445,6,6,1,2412,-41,-92,51,40:e3:d6:da:ba:26,3979121,380,-170,3978741,3979121
446,6,12,1,2412,-91,-92,1,84:d4:7e:f2:42:25,3979759,160,478,3979599,3979759
447,6,6,1,2412,-89,-92,3,84:d4:7e:f2:42:26,3979968,380,-171,3979588,3979968
448,6,6,1,2412,-55,-92,37,e6:aa:ea:c9:ea:33,4032241,408,51865,4031833,4032241
449,4,1,1,2412,-64,-92,28,54:e4:3a:ec:fb:64,4036903,2160,2502,4034743,4036903
450,6,6,1,2412,-55,-92,37,e6:aa:ea:c9:ea:33,4044378,408,7067,4043970,4044378
451,6,6,1,2412,-55,-92,37,e6:aa:ea:c9:ea:33,4056475,408,11689,4056067,4056475
452,6,6,1,2412,-55,-92,37,e6:aa:ea:c9:ea:33,4068618,408,11735,4068210,4068618
453,4,1,1,2412,-87,-92,5,,4072744,304,3822,4072440,4072744
454,6,12,1,2412,-42,-92,50,40:e3:d6:da:ba:20,4080051,160,7147,4079891,4080051
455,6,6,1,2412,-41,-92,51,40:e3:d6:da:ba:21,4080270,368,-149,4079902,4080270
456,6,12,1,2412,-41,-92,51,40:e3:d6:da:ba:22,4080684,180,234,4080504,4080684
457,6,12,1,2412,-41,-92,51,40:e3:d6:da:ba:23,4080907,184,39,4080723,4080907
458,6,12,1,2412,-41,-92,51,40:e3:d6:da:ba:24,4081126,176,43,4080950,4081126
459,6,12,1,2412,-41,-92,51,40:e3:d6:da:ba:25,4081336,160,50,4081176,4081336
460,6,6,1,2412,-73,-92,19,e6:aa:ea:b7:4a:dd,4081769,408,25,4081361,4081769
461,6,6,1,2412,-41,-92,51,40:e3:d6:da:ba:26,4082217,380,68,4081837,4082217
462,4,1,1,2412,-86,-92,6,,4092040,304,9519,4091736,4092040
463,6,6,1,2412,-73,-92,19,e6:aa:ea:b7:4a:dd,4106006,408,13558,4105598,4106006
464,6,6,1,2412,-73,-92,19,e6:aa:ea:b7:4a:dd,4118115,408,11701,4117707,4118115
465,4,1,1,2412,-65,-92,27,54:e4:3a:ec:fb:64,4139303,2160,19028,4137143,4139303
466,6,6,1,2412,-84,-92,8,e6:aa:ea:c9:ea:1b,4150565,408,10854,4150157,4150565
467,4,1,1,2412,-67,-92,25,3e:90:56:e8:df:e3,4171329,992,19772,4170337,4171329
468,4,1,1,2412,-66,-92,26,54:e4:3a:ec:fb:64,4172435,2112,-1006,4170323,4172435
469,4,1,1,2412,-67,-92,25,,4174562,304,1823,4174258,4174562
470,6,12,1,2412,-66,-92,26,,4174881,32,287,4174849,4174881
471,6,6,1,2412,-41,-92,51,40:e3:d6:da:ba:21,4175021,348,-208,4174673,4175021
472,6,12,1,2412,-65,-92,27,,4176189,32,1136,4176157,4176189
473,6,12,1,2412,-40,-92,52,40:e3:d6:da:ba:23,4176270,156,-75,4176114,4176270
474,6,12,1,2412,-41,-92,51,40:e3:d6:da:ba:25,4176647,136,241,4176511,4176647
475,6,12,1,2412,-66,-92,26,,4180512,32,3833,4180480,4180512
476,6,12,1,2412,-66,-92,26,,4180761,32,217,4180729,4180761
477,6,12,1,2412,-66,-92,26,,4181000,32,207,4180968,4181000
478,6,12,1,2412,-41,-92,51,40:e3:d6:da:ba:20,4182449,160,1289,4182289,4182449
479,6,6,1,2412,-41,-92,51,40:e3:d6:da:ba:21,4182649,368,-168,4182281,4182649
480,6,12,1,2412,-41,-92,51,40:e3:d6:da:ba:22,4183036,180,207,4182856,4183036
481,6,12,1,2412,-41,-92,51,40:e3:d6:da:ba:23,4183260,184,40,4183076,4183260
482,6,12,1,2412,-40,-92,52,40:e3:d6:da:ba:25,4183698,160,278,4183538,4183698
483,4,1,1,2412,-68,-92,24,3e:90:56:e8:df:e3,4192241,992,7551,4191249,4192241
484,4,1,1,2412,-68,-92,24,,4195480,304,2935,4195176,4195480
485,6,12,1,2412,-41,-92,51,40:e3:d6:da:ba:20,4195644,136,28,4195508,4195644
486,6,12,1,2412,-67,-92,25,,4195798,32,122,4195766,4195798
487,6,6,1,2412,-41,-92,51,40:e3:d6:da:ba:21,4195876,348,-270,4195528,4195876
488,6,6,1,2412,-67,-92,25,,4196242,44,322,4196198,4196242
489,6,12,1,2412,-41,-92,51,40:e3:d6:da:ba:22,4196319,156,-79,4196163,4196319
490,6,12,1,2412,-66,-92,26,,4196493,32,142,4196461,4196493
491,6,12,1,2412,-40,-92,52,40:e3:d6:da:ba:23,4196582,156,-67,4196426,4196582
492,6,12,1,2412,-67,-92,25,,4196756,32,142,4196724,4196756
493,6,12,1,2412,-41,-92,51,40:e3:d6:da:ba:25,4196827,136,-65,4196691,4196827
494,6,12,1,2412,-66,-92,26,,4196981,32,122,4196949,4196981
495,4,1,1,2412,-66,-92,26,3e:90:56:e8:df:e3,4220537,992,22564,4219545,4220537
496,4,1,1,2412,-85,-92,7,a6:e5:7c:28:b1:d3,4229301,992,7772,4228309,4229301
497,4,1,1,2412,-67,-92,25,54:e4:3a:ec:fb:64,4241702,2160,10241,4239542,4241702
498,6,12,1,2412,-41,-92,51,40:e3:d6:da:ba:20,4284858,160,42996,4284698,4284858
499,6,6,1,2412,-41,-92,51,40:e3:d6:da:ba:21,4285059,368,-167,4284691,4285059
500,6,12,1,2412,-41,-92,51,40:e3:d6:da:ba:22,4285464,180,225,4285284,4285464
501,6,12,1,2412,-41,-92,51,40:e3:d6:da:ba:23,4285669,184,21,4285485,4285669
502,6,12,1,2412,-41,-92,51,40:e3:d6:da:ba:24,4285888,176,43,4285712,4285888
503,6,12,1,2412,-41,-92,51,40:e3:d6:da:ba:25,4286116,160,68,4285956,4286116
504,6,6,1,2412,-41,-92,51,40:e3:d6:da:ba:26,4286317,380,-179,4285937,4286317
505,6,12,1,2412,-90,-92,2,84:d4:7e:f2:42:25,4286914,160,437,4286754,4286914
506,4,1,1,2412,-88,-92,4,,4317408,304,30190,4317104,4317408
507,4,1,1,2412,-85,-92,7,b8:3a:5a:88:e6:e1,4321201,2256,1537,4318945,4321201
508,6,6,1,2412,-56,-92,36,e6:aa:ea:c9:ea:33,4348800,408,27191,4348392,4348800
509,6,6,1,2412,-56,-92,36,e6:aa:ea:c9:ea:33,4373039,408,23831,4372631,4373039
510,6,12,1,2412,-45,-92,47,40:e3:d6:da:ba:20,4387254,160,14055,4387094,4387254
511,6,6,1,2412,-44,-92,48,40:e3:d6:da:ba:21,4387473,368,-149,4387105,4387473
512,6,12,1,2412,-44,-92,48,40:e3:d6:da:ba:22,4387878,180,225,4387698,4387878
513,6,12,1,2412,-42,-92,50,40:e3:d6:da:ba:24,4388338,176,284,4388162,4388338
514,6,12,1,2412,-42,-92,50,40:e3:d6:da:ba:25,4388548,160,50,4388388,4388548
515,6,6,1,2412,-42,-92,50,40:e3:d6:da:ba:26,4388767,380,-161,4388387,4388767
516,6,6,1,2412,-56,-92,36,e6:aa:ea:c9:ea:33,4397765,408,8590,4397357,4397765
517,4,1,1,2412,-78,-92,14,a6:e5:7c:28:b1:d3,4434086,992,35329,4433094,4434086
518,4,1,1,2412,-68,-92,24,54:e4:3a:ec:fb:64,4446500,2160,10254,4444340,4446500
519,6,6,1,2412,-65,-92,27,e6:aa:ea:b7:4a:dd,4487309,408,40401,4486901,4487309
520,6,12,1,2412,-43,-92,49,40:e3:d6:da:ba:20,4489638,160,2169,4489478,4489638
521,6,6,1,2412,-43,-92,49,40:e3:d6:da:ba:21,4489838,368,-168,4489470,4489838
522,6,12,1,2412,-42,-92,50,40:e3:d6:da:ba:22,4490234,180,216,4490054,4490234
523,6,12,1,2412,-42,-92,50,40:e3:d6:da:ba:23,4490449,184,31,4490265,4490449
524,6,12,1,2412,-43,-92,49,40:e3:d6:da:ba:24,4490658,176,33,4490482,4490658
525,6,12,1,2412,-43,-92,49,40:e3:d6:da:ba:25,4490887,160,69,4490727,4490887
526,6,6,1,2412,-42,-92,50,40:e3:d6:da:ba:26,4491079,380,-188,4490699,4491079
527,6,6,1,2412,-65,-92,27,e6:aa:ea:b7:4a:dd,4511551,408,20064,4511143,4511551
528,6,6,1,2412,-65,-92,27,e6:aa:ea:b7:4a:dd,4523660,408,11701,4523252,4523660
529,6,6,1,2412,-65,-92,27,e6:aa:ea:b7:4a:dd,4535937,408,11869,4535529,4535937
530,6,12,1,2412,-42,-92,50,40:e3:d6:da:ba:20,4594131,160,58034,4593971,4594131
531,6,6,1,2412,-42,-92,50,40:e3:d6:da:ba:21,4594323,368,-176,4593955,4594323
532,6,12,1,2412,-42,-92,50,40:e3:d6:da:ba:22,4594710,180,207,4594530,4594710
533,6,12,1,2412,-42,-92,50,40:e3:d6:da:ba:23,4595084,184,190,4594900,4595084
534,6,12,1,2412,-42,-92,50,40:e3:d6:da:ba:24,4595294,176,34,4595118,4595294
535,6,12,1,2412,-42,-92,50,40:e3:d6:da:ba:25,4595513,160,59,4595353,4595513
536,6,6,1,2412,-42,-92,50,40:e3:d6:da:ba:26,4595723,380,-170,4595343,4595723
537,6,6,1,2412,-83,-92,9,e6:aa:ea:c9:ea:1b,4649123,408,52992,4648715,4649123
538,6,6,1,2412,-83,-92,9,e6:aa:ea:c9:ea:1b,4673355,408,23824,4672947,4673355
539,6,6,1,2412,-81,-92,11,e6:aa:ea:c9:ea:1b,4685467,408,11704,4685059,4685467
540,6,12,1,2412,-42,-92,50,40:e3:d6:da:ba:20,4694455,160,8828,4694295,4694455
541,6,6,1,2412,-42,-92,50,40:e3:d6:da:ba:21,4694665,368,-158,4694297,4694665
542,6,12,1,2412,-42,-92,50,40:e3:d6:da:ba:22,4695052,180,207,4694872,4695052
543,6,12,1,2412,-42,-92,50,40:e3:d6:da:ba:23,4695258,184,22,4695074,4695258
544,6,12,1,2412,-42,-92,50,40:e3:d6:da:ba:24,4695467,176,33,4695291,4695467
545,6,12,1,2412,-42,-92,50,40:e3:d6:da:ba:25,4695668,160,41,4695508,4695668
546,6,6,1,2412,-42,-92,50,40:e3:d6:da:ba:26,4695860,380,-188,4695480,4695860
547,6,12,1,2412,-89,-92,3,84:d4:7e:f2:42:24,4696322,176,286,4696146,4696322
548,4,1,1,2412,-69,-92,23,54:e4:3a:ec:fb:64,4704851,2160,6369,4702691,4704851
549,4,1,1,2412,-83,-92,9,c0:c9:e3:4d:6e:bf,4749483,872,43760,4748611,4749483
550,4,1,1,2412,-69,-92,23,54:e4:3a:ec:fb:64,4758821,2160,7178,4756661,4758821
551,4,1,1,2412,-84,-92,8,12:3c:9c:f5:6c:c7,4765777,1480,5476,4764297,4765777
552,6,6,1,2412,-59,-92,33,e6:aa:ea:c9:ea:33,4767146,408,961,4766738,4767146
553,6,12,1,2412,-43,-92,49,40:e3:d6:da:ba:23,4767583,156,281,4767427,4767583
554,6,6,1,2412,-59,-92,33,e6:aa:ea:c9:ea:33,4779084,408,11093,4778676,4779084
555,4,1,1,2412,-64,-92,28,b8:3a:5a:88:e6:e0,4783208,2360,1764,4780848,4783208
556,6,6,1,2412,-59,-92,33,e6:aa:ea:c9:ea:33,4791202,408,7586,4790794,4791202
557,6,6,1,2412,-43,-92,49,40:e3:d6:da:ba:21,4797035,368,5465,4796667,4797035
558,6,12,1,2412,-43,-92,49,40:e3:d6:da:ba:22,4797449,180,234,4797269,4797449
559,6,12,1,2412,-42,-92,50,40:e3:d6:da:ba:23,4797688,184,55,4797504,4797688
560,6,12,1,2412,-43,-92,49,40:e3:d6:da:ba:24,4797898,176,34,4797722,4797898
561,6,12,1,2412,-42,-92,50,40:e3:d6:da:ba:25,4798099,160,41,4797939,4798099
562,6,6,1,2412,-42,-92,50,40:e3:d6:da:ba:26,4798291,380,-188,4797911,4798291
563,6,6,1,2412,-87,-92,5,84:d4:7e:f2:42:26,4799152,380,481,4798772,4799152
564,6,6,1,2412,-59,-92,33,e6:aa:ea:c9:ea:33,4804379,408,4819,4803971,4804379
565,6,6,1,2412,-66,-92,26,e6:aa:ea:b7:4a:dd,4814729,408,9942,4814321,4814729
566,6,6,1,2412,-60,-92,32,e6:aa:ea:c9:ea:33,4817061,408,1924,4816653,4817061
567,6,6,1,2412,-66,-92,26,e6:aa:ea:b7:4a:dd,4826848,408,9379,4826440,4826848
568,6,6,1,2412,-66,-92,26,e6:aa:ea:b7:4a:dd,4838965,408,11709,4838557,4838965
569,6,6,1,2412,-66,-92,26,e6:aa:ea:b7:4a:dd,4851084,408,11711,4850676,4851084
570,4,1,1,2412,-69,-92,23,54:e4:3a:ec:fb:64,4858710,2160,5466,4856550,4858710
571,6,12,1,2412,-42,-92,50,40:e3:d6:da:ba:20,4899256,160,40386,4899096,4899256
572,6,6,1,2412,-43,-92,49,40:e3:d6:da:ba:21,4899474,368,-150,4899106,4899474
573,6,12,1,2412,-42,-92,50,40:e3:d6:da:ba:22,4899879,180,225,4899699,4899879
574,6,12,1,2412,-43,-92,49,40:e3:d6:da:ba:23,4900112,184,49,4899928,4900112
575,6,12,1,2412,-43,-92,49,40:e3:d6:da:ba:24,4900339,176,51,4900163,4900339
576,6,12,1,2412,-43,-92,49,40:e3:d6:da:ba:25,4900550,160,51,4900390,4900550
577,6,6,1,2412,-43,-92,49,40:e3:d6:da:ba:26,4900742,380,-188,4900362,4900742
578,6,12,1,2412,-88,-92,4,84:d4:7e:f2:42:25,4901342,160,440,4901182,4901342
579,4,1,1,2412,-67,-92,25,54:e4:3a:ec:fb:64,4958523,2160,55021,4956363,4958523
580,4,1,1,2412,-81,-92,11,b8:3a:5a:88:e6:e0,4985702,2360,24819,4983342,4985702
581,4,1,1,2412,-82,-92,10,b8:3a:5a:88:e6:e1,4988100,2376,22,4985724,4988100
582,6,12,1,2412,-42,-92,50,40:e3:d6:da:ba:20,5001650,160,13390,5001490,5001650
583,6,6,1,2412,-43,-92,49,40:e3:d6:da:ba:21,5001851,368,-167,5001483,5001851
584,6,12,1,2412,-42,-92,50,40:e3:d6:da:ba:22,5002265,180,234,5002085,5002265
585,6,12,1,2412,-42,-92,50,40:e3:d6:da:ba:23,5002559,184,110,5002375,5002559
586,6,12,1,2412,-42,-92,50,40:e3:d6:da:ba:24,5002768,176,33,5002592,5002768
587,6,12,1,2412,-43,-92,49,40:e3:d6:da:ba:25,5002979,160,51,5002819,5002979
588,6,6,1,2412,-42,-92,50,40:e3:d6:da:ba:26,5003180,380,-179,5002800,5003180
589,4,1,1,2412,-64,-92,28,54:e4:3a:ec:fb:64,5060893,2160,55553,5058733,5060893
590,6,6,1,2412,-59,-92,33,e6:aa:ea:c9:ea:33,5093862,408,32561,5093454,5093862
591,6,12,1,2412,-42,-92,50,40:e3:d6:da:ba:20,5104063,160,10041,5103903,5104063
592,6,6,1,2412,-43,-92,49,40:e3:d6:da:ba:21,5104273,368,-158,5103905,5104273
593,6,12,1,2412,-43,-92,49,40:e3:d6:da:ba:22,5104687,180,234,5104507,5104687
594,6,12,1,2412,-43,-92,49,40:e3:d6:da:ba:23,5104920,184,49,5104736,5104920
595,6,12,1,2412,-42,-92,50,40:e3:d6:da:ba:24,5105129,176,33,5104953,5105129
596,6,6,1,2412,-59,-92,33,e6:aa:ea:c9:ea:33,5118181,408,12644,5117773,5118181
597,4,1,1,2412,-63,-92,29,54:e4:3a:ec:fb:64,5163294,2160,42953,5161134,5163294
598,6,6,1,2412,-82,-92,10,e6:aa:ea:c9:ea:1b,5184616,408,20914,5184208,5184616
599,4,1,1,2412,-80,-92,12,b8:3a:5a:88:e6:e1,5192929,2376,5937,5190553,5192929
600,4,1,1,2412,-82,-92,10,c0:c9:e3:4d:6e:bf,5196028,872,2227,5195156,5196028
601,6,12,1,2412,-43,-92,49,40:e3:d6:da:ba:20,5206444,160,10256,5206284,5206444
602,6,6,1,2412,-42,-92,50,40:e3:d6:da:ba:21,5206635,368,-177,5206267,5206635
603,6,12,1,2412,-43,-92,49,40:e3:d6:da:ba:22,5207022,180,207,5206842,5207022
604,6,12,1,2412,-42,-92,50,40:e3:d6:da:ba:23,5207237,184,31,5207053,5207237
605,6,12,1,2412,-43,-92,49,40:e3:d6:da:ba:24,5207473,176,60,5207297,5207473
606,6,12,1,2412,-42,-92,50,40:e3:d6:da:ba:25,5207684,160,51,5207524,5207684
607,6,12,1,2412,-88,-92,4,84:d4:7e:f2:42:24,5208339,176,479,5208163,5208339
608,4,1,1,2412,-79,-92,13,,5240743,304,32100,5240439,5240743
609,4,1,1,2412,-67,-92,25,54:e4:3a:ec:fb:64,5265692,2160,22789,5263532,5265692
610,6,6,1,2412,-71,-92,21,e6:aa:ea:b7:4a:dd,5269422,408,3322,5269014,5269422
611,4,1,1,2412,-81,-92,11,b8:3a:5a:88:e6:e1,5295227,2376,23429,5292851,5295227
612,6,12,1,2412,-40,-92,52,40:e3:d6:da:ba:20,5308840,160,13453,5308680,5308840
613,6,6,1,2412,-40,-92,52,40:e3:d6:da:ba:21,5309032,368,-176,5308664,5309032
614,6,12,1,2412,-40,-92,52,40:e3:d6:da:ba:22,5309436,180,224,5309256,5309436
615,6,12,1,2412,-40,-92,52,40:e3:d6:da:ba:23,5309669,184,49,5309485,5309669
616,6,12,1,2412,-41,-92,51,40:e3:d6:da:ba:24,5309887,176,42,5309711,5309887
617,6,12,1,2412,-40,-92,52,40:e3:d6:da:ba:25,5310098,160,51,5309938,5310098
618,6,6,1,2412,-40,-92,52,40:e3:d6:da:ba:26,5310317,380,-161,5309937,5310317
619,4,1,1,2412,-88,-92,4,,5334582,304,23961,5334278,5334582
620,4,1,1,2412,-90,-92,2,,5355774,304,20888,5355470,5355774
621,4,1,1,2412,-67,-92,25,54:e4:3a:ec:fb:64,5368117,2160,10183,5365957,5368117
622,6,12,1,2412,-40,-92,52,40:e3:d6:da:ba:20,5411258,160,42981,5411098,5411258
623,6,6,1,2412,-40,-92,52,40:e3:d6:da:ba:21,5411468,368,-158,5411100,5411468
624,6,12,1,2412,-40,-92,52,40:e3:d6:da:ba:24,5412324,176,680,5412148,5412324
625,6,12,1,2412,-40,-92,52,40:e3:d6:da:ba:25,5412525,160,41,5412365,5412525
626,6,6,1,2412,-86,-92,6,e6:aa:ea:c9:ea:1b,5489836,408,76903,5489428,5489836
627,4,1,1,2412,-68,-92,24,b8:3a:5a:88:e6:e0,5497668,2360,5472,5495308,5497668
628,4,1,1,2412,-69,-92,23,b8:3a:5a:88:e6:e1,5500057,2376,13,5497681,5500057
629,6,6,1,2412,-40,-92,52,40:e3:d6:da:ba:21,5513853,368,13428,5513485,5513853
630,6,12,1,2412,-40,-92,52,40:e3:d6:da:ba:22,5514267,180,234,5514087,5514267
631,6,12,1,2412,-40,-92,52,40:e3:d6:da:ba:23,5514500,184,49,5514316,5514500
632,6,12,1,2412,-40,-92,52,40:e3:d6:da:ba:24,5514718,176,42,5514542,5514718
633,6,12,1,2412,-40,-92,52,40:e3:d6:da:ba:25,5514947,160,69,5514787,5514947
634,6,6,1,2412,-40,-92,52,40:e3:d6:da:ba:26,5515307,380,-20,5514927,5515307
635,4,1,1,2412,-88,-92,4,,5535622,304,20011,5535318,5535622
636,6,6,1,2412,-85,-92,7,e6:aa:ea:c9:ea:1b,5538430,408,2400,5538022,5538430
637,6,6,1,2412,-74,-92,18,e6:aa:ea:b7:4a:dd,5548285,408,9447,5547877,5548285
638,6,6,1,2412,-74,-92,18,e6:aa:ea:b7:4a:dd,5560394,408,11701,5559986,5560394
639,6,6,1,2412,-77,-92,15,,5562116,44,1678,5562072,5562116
640,6,6,1,2412,-72,-92,20,e6:aa:ea:b7:4a:dd,5572512,408,9988,5572104,5572512
641,4,1,1,2412,-65,-92,27,54:e4:3a:ec:fb:64,5573460,2160,-1212,5571300,5573460
642,6,6,1,2412,-76,-92,16,,5578193,44,4689,5578149,5578193
643,6,6,1,2412,-77,-92,15,,5578841,44,604,5578797,5578841
644,6,6,1,2412,-71,-92,21,e6:aa:ea:b7:4a:dd,5584636,408,5387,5584228,5584636
645,6,6,1,2412,-52,-92,40,e6:aa:ea:c9:ea:33,5601792,408,16748,5601384,5601792
646,6,12,1,2412,-90,-92,2,,5610274,32,8450,5610242,5610274
647,6,6,1,2412,-52,-92,40,e6:aa:ea:c9:ea:33,5613923,408,3241,5613515,5613923
648,6,6,1,2412,-41,-92,51,40:e3:d6:da:ba:21,5616280,368,1989,5615912,5616280
649,6,12,1,2412,-41,-92,51,40:e3:d6:da:ba:22,5616694,180,234,5616514,5616694
650,6,12,1,2412,-41,-92,51,40:e3:d6:da:ba:23,5616926,184,48,5616742,5616926
651,6,12,1,2412,-41,-92,51,40:e3:d6:da:ba:24,5617145,176,43,5616969,5617145
652,6,12,1,2412,-40,-92,52,40:e3:d6:da:ba:25,5617364,160,59,5617204,5617364
653,6,6,1,2412,-41,-92,51,40:e3:d6:da:ba:26,5617556,380,-188,5617176,5617556
654,6,6,1,2412,-51,-92,41,e6:aa:ea:c9:ea:33,5626025,408,8061,5625617,5626025
655,6,6,1,2412,-77,-92,15,,5636763,44,10694,5636719,5636763
656,6,6,1,2412,-51,-92,41,e6:aa:ea:c9:ea:33,5638143,408,972,5637735,5638143
657,6,6,1,2412,-51,-92,41,e6:aa:ea:c9:ea:33,5650342,408,11791,5649934,5650342
658,4,1,1,2412,-87,-92,5,,5669530,304,18884,5669226,5669530
659,4,1,1,2412,-70,-92,22,54:e4:3a:ec:fb:64,5675626,2160,3936,5673466,5675626
660,4,1,1,2412,-83,-92,9,c0:c9:e3:4d:6e:bf,5687289,872,10791,5686417,5687289
661,4,1,1,2412,-85,-92,7,,5688178,304,585,5687874,5688178
662,6,12,1,2412,-41,-92,51,40:e3:d6:da:ba:20,5718456,160,30118,5718296,5718456
663,6,6,1,2412,-41,-92,51,40:e3:d6:da:ba:21,5718657,368,-167,5718289,5718657
664,6,12,1,2412,-40,-92,52,40:e3:d6:da:ba:22,5719053,180,216,5718873,5719053
665,6,12,1,2412,-40,-92,52,40:e3:d6:da:ba:23,5719301,184,64,5719117,5719301
666,6,12,1,2412,-41,-92,51,40:e3:d6:da:ba:24,5719520,176,43,5719344,5719520
667,6,12,1,2412,-40,-92,52,40:e3:d6:da:ba:25,5719748,160,68,5719588,5719748
668,6,6,1,2412,-41,-92,51,40:e3:d6:da:ba:26,5719958,380,-170,5719578,5719958
669,6,12,1,2412,-89,-92,3,40:e3:d6:da:ca:c5,5734665,156,14551,5734509,5734665
670,4,1,1,2412,-89,-92,3,,5808004,304,73035,5807700,5808004
671,4,1,1,2412,-89,-92,3,,5808759,304,451,5808455,5808759
672,6,12,1,2412,-41,-92,51,40:e3:d6:da:ba:20,5820856,160,11937,5820696,5820856
673,6,6,1,2412,-41,-92,51,40:e3:d6:da:ba:21,5821066,368,-158,5820698,5821066
674,6,12,1,2412,-41,-92,51,40:e3:d6:da:ba:22,5821453,180,207,5821273,5821453
675,6,12,1,2412,-41,-92,51,40:e3:d6:da:ba:23,5821701,184,64,5821517,5821701
676,6,12,1,2412,-41,-92,51,40:e3:d6:da:ba:24,5821920,176,43,5821744,5821920
677,6,12,1,2412,-41,-92,51,40:e3:d6:da:ba:25,5822121,160,41,5821961,5822121
678,6,6,1,2412,-41,-92,51,40:e3:d6:da:ba:26,5822340,380,-161,5821960,5822340
679,6,12,1,2412,-41,-92,51,40:e3:d6:da:ba:20,5831958,960,8658,5830998,5831958
680,6,6,1,2412,-90,-92,2,40:e3:d6:da:ca:c6,5837254,380,4916,5836874,5837254
681,4,1,1,2412,-72,-92,20,b8:3a:5a:88:e6:e1,5909655,2376,70025,5907279,5909655
682,6,6,1,2412,-55,-92,37,e6:aa:ea:c9:ea:33,5918751,408,8688,5918343,5918751
683,6,12,1,2412,-43,-92,49,40:e3:d6:da:ba:20,5923243,160,4332,5923083,5923243
684,6,12,1,2412,-43,-92,49,40:e3:d6:da:ba:22,5923840,180,417,5923660,5923840
685,6,12,1,2412,-43,-92,49,40:e3:d6:da:ba:23,5924055,184,31,5923871,5924055
686,6,12,1,2412,-42,-92,50,40:e3:d6:da:ba:24,5924291,176,60,5924115,5924291
687,6,12,1,2412,-43,-92,49,40:e3:d6:da:ba:25,5924502,160,51,5924342,5924502
688,6,6,1,2412,-43,-92,49,40:e3:d6:da:ba:26,5924712,380,-170,5924332,5924712
689,6,12,1,2412,-89,-92,3,84:d4:7e:f2:42:24,5925143,176,255,5924967,5925143
690,6,12,1,2412,-89,-92,3,84:d4:7e:f2:42:25,5925353,160,50,5925193,5925353
691,6,6,1,2412,-55,-92,37,e6:aa:ea:c9:ea:33,5930880,408,5119,5930472,5930880
692,6,12,1,2412,-88,-92,4,40:e3:d6:da:ca:c5,5939549,156,8513,5939393,5939549
693,6,6,1,2412,-55,-92,37,e6:aa:ea:c9:ea:33,5942989,408,3032,5942581,5942989
694,6,6,1,2412,-55,-92,37,e6:aa:ea:c9:ea:33,5955103,408,11706,5954695,5955103
695,6,6,1,2412,-54,-92,38,e6:aa:ea:c9:ea:33,5967218,408,11707,5966810,5967218
696,4,1,1,2412,-69,-92,23,54:e4:3a:ec:fb:64,5982485,2160,13107,5980325,5982485
697,4,1,1,2412,-81,-92,11,a4:e5:7c:28:b1:d3,6016833,688,33660,6016145,6016833
698,6,6,1,2412,-84,-92,8,e6:aa:ea:c9:ea:1b,6024359,408,7118,6023951,6024359
699,6,12,1,2412,-42,-92,50,40:e3:d6:da:ba:20,6025666,160,1147,6025506,6025666
700,6,6,1,2412,-42,-92,50,40:e3:d6:da:ba:21,6025858,368,-176,6025490,6025858
701,6,12,1,2412,-42,-92,50,40:e3:d6:da:ba:22,6026272,180,234,6026092,6026272
702,6,12,1,2412,-43,-92,49,40:e3:d6:da:ba:23,6026487,184,31,6026303,6026487
703,6,12,1,2412,-42,-92,50,40:e3:d6:da:ba:24,6026723,176,60,6026547,6026723
704,6,6,1,2412,-88,-92,4,84:d4:7e:f2:42:26,6027929,380,826,6027549,6027929
705,6,6,1,2412,-86,-92,6,e6:aa:ea:c9:ea:1b,6036483,408,8146,6036075,6036483
706,6,6,1,2412,-88,-92,4,e6:aa:ea:c9:ea:1b,6048593,408,11702,6048185,6048593
707,6,6,1,2412,-73,-92,19,e6:aa:ea:b7:4a:dd,6055326,408,6325,6054918,6055326
708,6,6,1,2412,-86,-92,6,e6:aa:ea:c9:ea:1b,6060705,408,4971,6060297,6060705
709,6,6,1,2412,-73,-92,19,e6:aa:ea:b7:4a:dd,6067458,408,6345,6067050,6067458
710,6,6,1,2412,-73,-92,19,e6:aa:ea:b7:4a:dd,6079573,408,11707,6079165,6079573
711,4,1,1,2412,-59,-92,33,54:e4:3a:ec:fb:64,6084885,2160,3152,6082725,6084885
712,6,6,1,2412,-73,-92,19,e6:aa:ea:b7:4a:dd,6091698,408,6405,6091290,6091698
713,4,5.5,1,2412,-88,-92,4,,6098544,213,6633,6098331,6098544
714,4,1,1,2412,-80,-92,12,b8:3a:5a:88:e6:e0,6098789,2240,-1995,6096549,6098789
715,4,1,1,2412,-84,-92,8,b8:3a:5a:88:e6:e1,6114541,2376,13376,6112165,6114541
716,6,12,1,2412,-43,-92,49,40:e3:d6:da:ba:20,6128070,160,13369,6127910,6128070
717,6,6,1,2412,-43,-92,49,40:e3:d6:da:ba:21,6128280,368,-158,6127912,6128280
718,6,12,1,2412,-43,-92,49,40:e3:d6:da:ba:22,6128694,180,234,6128514,6128694
719,6,12,1,2412,-43,-92,49,40:e3:d6:da:ba:23,6128918,184,40,6128734,6128918
720,6,12,1,2412,-43,-92,49,40:e3:d6:da:ba:24,6129249,176,155,6129073,6129249
721,6,12,1,2412,-43,-92,49,40:e3:d6:da:ba:25,6129451,160,42,6129291,6129451
722,6,6,1,2412,-43,-92,49,40:e3:d6:da:ba:26,6129652,380,-179,6129272,6129652
723,4,1,1,2412,-81,-92,11,a6:e5:7c:28:b1:d3,6174975,992,44331,6173983,6174975
724,4,1,1,2412,-75,-92,17,c0:c9:e3:4d:6e:bf,6185829,872,9982,6184957,6185829
725,4,1,1,2412,-79,-92,13,,6186718,304,585,6186414,6186718
726,4,1,1,2412,-63,-92,29,54:e4:3a:ec:fb:64,6187284,2160,-1594,6185124,6187284
727,6,6,1,2412,-80,-92,12,48:e7:da:41:38:ff,6216695,88,29323,6216607,6216695
728,4,1,1,2412,-68,-92,24,,6229740,304,12741,6229436,6229740
729,6,12,1,2412,-44,-92,48,40:e3:d6:da:ba:20,6230470,160,570,6230310,6230470
730,6,12,1,2412,-44,-92,48,40:e3:d6:da:ba:22,6231067,180,417,6230887,6231067
731,6,12,1,2412,-44,-92,48,40:e3:d6:da:ba:23,6231273,184,22,6231089,6231273
732,6,12,1,2412,-44,-92,48,40:e3:d6:da:ba:25,6231720,160,287,6231560,6231720
733,6,6,1,2412,-44,-92,48,40:e3:d6:da:ba:26,6231930,380,-170,6231550,6231930
734,4,1,1,2412,-79,-92,13,a6:e5:7c:28:b1:d3,6276149,992,43227,6275157,6276149
735,4,1,1,2412,-51,-92,41,54:e4:3a:ec:fb:64,6289818,2160,11509,6287658,6289818
736,6,12,1,2412,-44,-92,48,40:e3:d6:da:ba:20,6332907,160,42929,6332747,6332907
737,6,6,1,2412,-44,-92,48,40:e3:d6:da:ba:21,6333117,368,-158,6332749,6333117
738,6,12,1,2412,-44,-92,48,40:e3:d6:da:ba:22,6333522,180,225,6333342,6333522
739,6,12,1,2412,-44,-92,48,40:e3:d6:da:ba:23,6333746,184,40,6333562,6333746
740,6,12,1,2412,-44,-92,48,40:e3:d6:da:ba:24,6333973,176,51,6333797,6333973
741,6,12,1,2412,-44,-92,48,40:e3:d6:da:ba:25,6334193,160,60,6334033,6334193
742,6,6,1,2412,-44,-92,48,40:e3:d6:da:ba:26,6334393,380,-180,6334013,6334393
743,6,12,1,2412,-89,-92,3,84:d4:7e:f2:42:25,6334934,160,381,6334774,6334934
744,6,6,1,2412,-89,-92,3,40:e3:d6:da:ca:c6,6350575,380,15261,6350195,6350575
745,4,1,1,2412,-78,-92,14,a6:e5:7c:28:b1:d3,6379705,992,28138,6378713,6379705
746,4,1,1,2412,-69,-92,23,54:e4:3a:ec:fb:64,6392082,2160,10217,6389922,6392082
747,4,1,1,2412,-80,-92,12,b8:3a:5a:88:e6:e0,6419454,2360,25012,6417094,6419454
748,4,1,1,2412,-81,-92,11,b8:3a:5a:88:e6:e1,6423141,2376,1311,6420765,6423141
749,6,12,1,2412,-45,-92,47,40:e3:d6:da:ba:20,6435264,160,11963,6435104,6435264
750,6,6,1,2412,-45,-92,47,40:e3:d6:da:ba:21,6435483,368,-149,6435115,6435483
751,6,12,1,2412,-45,-92,47,40:e3:d6:da:ba:23,6436093,184,426,6435909,6436093
752,6,12,1,2412,-45,-92,47,40:e3:d6:da:ba:24,6436312,176,43,6436136,6436312
753,6,12,1,2412,-45,-92,47,40:e3:d6:da:ba:25,6436522,160,50,6436362,6436522
754,6,6,1,2412,-45,-92,47,40:e3:d6:da:ba:26,6436714,380,-188,6436334,6436714
755,6,6,1,2412,-90,-92,2,84:d4:7e:f2:42:26,6437578,380,484,6437198,6437578
756,6,6,1,2412,-52,-92,40,e6:aa:ea:c9:ea:33,6438699,408,713,6438291,6438699
757,6,6,1,2412,-53,-92,39,e6:aa:ea:c9:ea:33,6450815,408,11708,6450407,6450815
758,6,6,1,2412,-68,-92,24,e6:aa:ea:b7:4a:dd,6471948,408,20725,6471540,6471948
759,6,6,1,2412,-54,-92,38,e6:aa:ea:c9:ea:33,6475039,408,2683,6474631,6475039
760,4,1,1,2412,-82,-92,10,a6:e5:7c:28:b1:d3,6482105,992,6074,6481113,6482105
761,6,6,1,2412,-68,-92,24,e6:aa:ea:b7:4a:dd,6484068,408,1555,6483660,6484068
762,6,6,1,2412,-54,-92,38,e6:aa:ea:c9:ea:33,6487222,408,2746,6486814,6487222
763,6,6,1,2412,-69,-92,23,e6:aa:ea:b7:4a:dd,6508295,408,20665,6507887,6508295
764,6,12,1,2412,-46,-92,46,40:e3:d6:da:ba:20,6537646,160,29191,6537486,6537646
765,6,6,1,2412,-46,-92,46,40:e3:d6:da:ba:21,6537838,368,-176,6537470,6537838
766,6,12,1,2412,-46,-92,46,40:e3:d6:da:ba:22,6538243,180,225,6538063,6538243
767,6,12,1,2412,-46,-92,46,40:e3:d6:da:ba:23,6538457,184,30,6538273,6538457
768,6,12,1,2412,-46,-92,46,40:e3:d6:da:ba:24,6538685,176,52,6538509,6538685
769,6,12,1,2412,-46,-92,46,40:e3:d6:da:ba:25,6538904,160,59,6538744,6538904
770,6,6,1,2412,-46,-92,46,40:e3:d6:da:ba:26,6539105,380,-179,6538725,6539105
771,6,6,1,2412,-90,-92,2,84:d4:7e:f2:42:26,6539945,380,460,6539565,6539945
772,6,6,1,2412,-83,-92,9,e6:aa:ea:c9:ea:1b,6558381,408,18028,6557973,6558381
773,6,6,1,2412,-87,-92,5,a8:5b:f7:55:1a:40,6560944,72,2491,6560872,6560944
774,6,6,1,2412,-88,-92,4,a8:5b:f7:55:1a:40,6561051,72,35,6560979,6561051
775,6,6,1,2412,-89,-92,3,a8:5b:f7:55:1a:40,6561230,72,107,6561158,6561230
776,6,6,1,2412,-88,-92,4,a8:5b:f7:55:1a:40,6561338,72,36,6561266,6561338
777,6,6,1,2412,-86,-92,6,a8:5b:f7:55:1a:40,6561526,72,116,6561454,6561526
778,6,6,1,2412,-88,-92,4,a8:5b:f7:55:1a:40,6561814,72,216,6561742,6561814
779,6,6,1,2412,-86,-92,6,a8:5b:f7:55:1a:40,6562020,72,134,6561948,6562020
780,6,6,1,2412,-86,-92,6,a8:5b:f7:55:1a:40,6562128,72,36,6562056,6562128
781,6,6,1,2412,-89,-92,3,a8:5b:f7:55:1a:40,6562352,72,152,6562280,6562352
782,6,6,1,2412,-89,-92,3,a8:5b:f7:55:1a:40,6562459,72,35,6562387,6562459
783,6,6,1,2412,-88,-92,4,a8:5b:f7:55:1a:40,6562684,72,153,6562612,6562684
784,4,1,1,2412,-69,-92,23,54:e4:3a:ec:fb:64,6597106,2160,32262,6594946,6597106
785,4,1,1,2412,-82,-92,10,b8:3a:5a:88:e6:e0,6624074,2360,24608,6621714,6624074
786,4,1,1,2412,-82,-92,10,b8:3a:5a:88:e6:e1,6626471,2376,21,6624095,6626471
787,6,12,1,2412,-45,-92,47,40:e3:d6:da:ba:20,6640046,160,13415,6639886,6640046
788,6,6,1,2412,-44,-92,48,40:e3:d6:da:ba:21,6640247,368,-167,6639879,6640247
789,6,12,1,2412,-44,-92,48,40:e3:d6:da:ba:22,6640634,180,207,6640454,6640634
790,6,12,1,2412,-45,-92,47,40:e3:d6:da:ba:23,6640857,184,39,6640673,6640857
791,6,12,1,2412,-44,-92,48,40:e3:d6:da:ba:24,6641085,176,52,6640909,6641085
792,6,12,1,2412,-44,-92,48,40:e3:d6:da:ba:25,6641295,160,50,6641135,6641295
793,6,6,1,2412,-44,-92,48,40:e3:d6:da:ba:26,6641496,380,-179,6641116,6641496
794,4,1,1,2412,-60,-92,32,54:14:f3:e2:8b:eb,6646424,1288,3640,6645136,6646424
795,6,12,1,2412,-44,-92,48,40:e3:d6:da:ba:23,6647701,156,1121,6647545,6647701
796,6,12,1,2412,-58,-92,34,,6647873,32,140,6647841,6647873
797,4,1,1,2412,-58,-92,34,54:14:f3:e2:8b:eb,6662909,1288,13748,6661621,6662909
798,6,12,1,2412,-44,-92,48,40:e3:d6:da:ba:23,6664175,156,1110,6664019,6664175
799,4,1,1,2412,-85,-92,7,,6685513,304,21034,6685209,6685513
800,4,1,1,2412,-63,-92,29,54:e4:3a:ec:fb:64,6699286,2160,11613,6697126,6699286
801,4,1,1,2412,-62,-92,30,54:14:f3:e2:8b:eb,6709226,1288,8652,6707938,6709226
802,4,1,1,2412,-80,-92,12,c0:c9:e3:4d:6e:bf,6720901,872,10803,6720029,6720901
803,4,1,1,2412,-86,-92,6,,6721790,304,585,6721486,6721790
804,6,12,1,2412,-42,-92,50,40:e3:d6:da:ba:20,6742464,160,20514,6742304,6742464
805,6,6,1,2412,-42,-92,50,40:e3:d6:da:ba:21,6742674,368,-158,6742306,6742674
806,6,12,1,2412,-43,-92,49,40:e3:d6:da:ba:22,6743070,180,216,6742890,6743070
807,6,12,1,2412,-43,-92,49,40:e3:d6:da:ba:23,6743294,184,40,6743110,6743294
808,6,12,1,2412,-42,-92,50,40:e3:d6:da:ba:24,6743530,176,60,6743354,6743530
809,6,12,1,2412,-42,-92,50,40:e3:d6:da:ba:25,6743759,160,69,6743599,6743759
810,6,6,1,2412,-42,-92,50,40:e3:d6:da:ba:26,6743969,380,-170,6743589,6743969
811,4,1,1,2412,-62,-92,30,54:e4:3a:ec:fb:64,6801688,2160,55559,6799528,6801688
812,4,1,1,2412,-74,-92,18,,6839171,304,37179,6838867,6839171
813,6,12,1,2412,-43,-92,49,40:e3:d6:da:ba:20,6844868,160,5537,6844708,6844868
814,6,6,1,2412,-44,-92,48,40:e3:d6:da:ba:21,6845087,368,-149,6844719,6845087
815,6,12,1,2412,-44,-92,48,40:e3:d6:da:ba:22,6845492,180,225,6845312,6845492
816,6,12,1,2412,-44,-92,48,40:e3:d6:da:ba:23,6845715,184,39,6845531,6845715
817,6,12,1,2412,-43,-92,49,40:e3:d6:da:ba:24,6845942,176,51,6845766,6845942
818,6,12,1,2412,-43,-92,49,40:e3:d6:da:ba:25,6846144,160,42,6845984,6846144
819,6,6,1,2412,-43,-92,49,40:e3:d6:da:ba:26,6846336,380,-188,6845956,6846336
820,6,12,1,2412,-87,-92,5,84:d4:7e:f2:42:25,6846932,160,436,6846772,6846932
821,6,6,1,2412,-87,-92,5,84:d4:7e:f2:42:26,6847150,380,-162,6846770,6847150
822,6,12,1,2412,-85,-92,7,40:e3:d6:de:16:00,6852498,960,4388,6851538,6852498
823,6,6,1,2412,-52,-92,40,e6:aa:ea:c9:ea:33,6855284,408,2378,6854876,6855284
824,6,6,1,2412,-51,-92,41,e6:aa:ea:c9:ea:33,6867404,408,11712,6866996,6867404
825,6,6,1,2412,-50,-92,42,e6:aa:ea:c9:ea:33,6879521,408,11709,6879113,6879521
826,6,6,1,2412,-50,-92,42,e6:aa:ea:c9:ea:33,6891645,408,11716,6891237,6891645
827,6,6,1,2412,-85,-92,7,84:1b:5e:df:1b:99,6895915,80,4190,6895835,6895915
828,6,6,1,2412,-69,-92,23,e6:aa:ea:b7:4a:dd,6902431,408,6108,6902023,6902431
829,4,1,1,2412,-60,-92,32,54:e4:3a:ec:fb:64,6904077,2160,-514,6901917,6904077
830,6,6,1,2412,-51,-92,41,e6:aa:ea:c9:ea:33,6909945,408,5460,6909537,6909945
831,6,12,1,2412,-88,-92,4,40:e3:d6:da:ca:c3,6924141,156,14040,6923985,6924141
832,6,6,1,2412,-70,-92,22,e6:aa:ea:b7:4a:dd,6926700,408,2151,6926292,6926700
833,4,1,1,2412,-77,-92,15,b8:3a:5a:88:e6:e1,6933678,2376,4602,6931302,6933678
834,6,6,1,2412,-71,-92,21,e6:aa:ea:b7:4a:dd,6938790,408,4704,6938382,6938790
835,6,12,1,2412,-44,-92,48,40:e3:d6:da:ba:20,6947272,160,8322,6947112,6947272
836,6,12,1,2412,-44,-92,48,40:e3:d6:da:ba:22,6947851,180,399,6947671,6947851
837,6,12,1,2412,-44,-92,48,40:e3:d6:da:ba:23,6948074,184,39,6947890,6948074
838,6,12,1,2412,-44,-92,48,40:e3:d6:da:ba:24,6948302,176,52,6948126,6948302
839,6,12,1,2412,-43,-92,49,40:e3:d6:da:ba:25,6948530,160,68,6948370,6948530
840,6,6,1,2412,-44,-92,48,40:e3:d6:da:ba:26,6948731,380,-179,6948351,6948731
841,4,1,1,2412,-79,-92,13,b8:3a:5a:88:e6:e0,6955028,2240,4057,6952788,6955028
842,4,1,1,2412,-81,-92,11,b8:3a:5a:88:e6:e1,6957314,2256,30,6955058,6957314
843,6,6,1,2412,-87,-92,5,40:e3:d6:da:ca:c1,6962420,368,4738,6962052,6962420
844,6,12,1,2412,-88,-92,4,40:e3:d6:da:ca:c2,6962825,176,229,6962649,6962825
845,4,1,1,2412,-64,-92,28,54:e4:3a:ec:fb:64,7006590,2160,41605,7004430,7006590
846,6,12,1,2412,-44,-92,48,40:e3:d6:da:ba:20,7060225,160,53475,7060065,7060225
847,6,6,1,2412,-43,-92,49,40:e3:d6:da:ba:21,7060444,368,-149,7060076,7060444
848,6,12,1,2412,-43,-92,49,40:e3:d6:da:ba:22,7060849,180,225,7060669,7060849
849,6,12,1,2412,-43,-92,49,40:e3:d6:da:ba:23,7061073,184,40,7060889,7061073
850,6,12,1,2412,-43,-92,49,40:e3:d6:da:ba:25,7061493,160,260,7061333,7061493
851,6,6,1,2412,-43,-92,49,40:e3:d6:da:ba:26,7061684,380,-189,7061304,7061684
852,6,6,1,2412,-84,-92,8,e6:aa:ea:c9:ea:1b,7068881,408,6789,7068473,7068881
853,4,1,1,2412,-63,-92,29,54:e4:3a:ec:fb:64,7108878,2160,37837,7106718,7108878
854,4,1,1,2412,-79,-92,13,b8:3a:5a:88:e6:e1,7139197,2376,27943,7136821,7139197
855,6,12,1,2412,-43,-92,49,40:e3:d6:da:ba:20,7152843,160,13486,7152683,7152843
856,6,12,1,2412,-43,-92,49,40:e3:d6:da:ba:23,7153823,184,796,7153639,7153823
857,6,12,1,2412,-43,-92,49,40:e3:d6:da:ba:25,7154243,160,260,7154083,7154243
858,6,6,1,2412,-42,-92,50,40:e3:d6:da:ba:26,7154444,380,-179,7154064,7154444
859,6,12,1,2412,-87,-92,5,40:e3:d6:da:ca:c2,7167640,176,13020,7167464,7167640
860,4,1,1,2412,-80,-92,12,c0:c9:e3:4d:6e:bf,7168156,872,-356,7167284,7168156
861,6,12,1,2412,-87,-92,5,40:e3:d6:da:ca:c4,7169219,172,891,7169047,7169219
862,6,6,1,2412,-88,-92,4,40:e3:d6:da:ca:c6,7169631,380,32,7169251,7169631
863,6,12,1,2412,-88,-92,4,,7185101,36,15434,7185065,7185101
864,4,1,1,2412,-65,-92,27,54:e4:3a:ec:fb:64,7211320,2160,24059,7209160,7211320
865,6,12,1,2412,-88,-92,4,,7223853,44,12489,7223809,7223853
866,6,12,1,2412,-45,-92,47,40:e3:d6:da:ba:20,7254472,160,30459,7254312,7254472
867,6,6,1,2412,-45,-92,47,40:e3:d6:da:ba:21,7254673,368,-167,7254305,7254673
868,6,12,1,2412,-45,-92,47,40:e3:d6:da:ba:22,7255078,180,225,7254898,7255078
869,6,12,1,2412,-45,-92,47,40:e3:d6:da:ba:23,7255310,184,48,7255126,7255310
870,6,12,1,2412,-45,-92,47,40:e3:d6:da:ba:24,7255547,176,61,7255371,7255547
871,6,12,1,2412,-45,-92,47,40:e3:d6:da:ba:25,7255775,160,68,7255615,7255775
872,6,6,1,2412,-45,-92,47,40:e3:d6:da:ba:26,7255976,380,-179,7255596,7255976
873,6,6,1,2412,-52,-92,40,e6:aa:ea:c9:ea:33,7272390,408,16006,7271982,7272390
874,6,6,1,2412,-52,-92,40,e6:aa:ea:c9:ea:33,7284563,408,11765,7284155,7284563
875,6,6,1,2412,-52,-92,40,e6:aa:ea:c9:ea:33,7296636,408,11665,7296228,7296636
876,6,6,1,2412,-70,-92,22,e6:aa:ea:b7:4a:dd,7308548,408,11504,7308140,7308548
877,6,6,1,2412,-52,-92,40,e6:aa:ea:c9:ea:33,7311931,408,2975,7311523,7311931
878,6,6,1,2412,-52,-92,40,e6:aa:ea:c9:ea:33,7321711,408,9372,7321303,7321711
879,4,1,1,2412,-83,-92,9,b8:3a:5a:88:e6:e0,7340950,2360,16879,7338590,7340950
880,6,12,1,2412,-44,-92,48,40:e3:d6:da:ba:20,7356863,160,15753,7356703,7356863
881,6,6,1,2412,-44,-92,48,40:e3:d6:da:ba:21,7357471,368,240,7357103,7357471
882,6,12,1,2412,-43,-92,49,40:e3:d6:da:ba:22,7357885,180,234,7357705,7357885
883,6,12,1,2412,-44,-92,48,40:e3:d6:da:ba:23,7358099,184,30,7357915,7358099
884,6,12,1,2412,-44,-92,48,40:e3:d6:da:ba:24,7358309,176,34,7358133,7358309
885,6,12,1,2412,-44,-92,48,40:e3:d6:da:ba:25,7358537,160,68,7358377,7358537
886,6,6,1,2412,-44,-92,48,40:e3:d6:da:ba:26,7358747,380,-170,7358367,7358747
887,6,6,1,2412,-88,-92,4,e6:aa:ea:c9:ea:1b,7386993,408,27838,7386585,7386993
888,4,1,1,2412,-68,-92,24,54:e4:3a:ec:fb:64,7416082,2160,26929,7413922,7416082
889,4,1,1,2412,-48,-92,44,3e:90:56:e8:df:e3,7428931,992,11857,7427939,7428931
890,4,1,1,2412,-68,-92,24,54:e4:3a:ec:fb:64,7430039,2112,-1004,7427927,7430039
891,4,1,1,2412,-68,-92,24,,7432166,304,1823,7431862,7432166
892,6,12,1,2412,-45,-92,47,40:e3:d6:da:ba:20,7432331,136,29,7432195,7432331
893,6,12,1,2412,-68,-92,24,,7432484,32,121,7432452,7432484
894,6,6,1,2412,-44,-92,48,40:e3:d6:da:ba:21,7432580,348,-252,7432232,7432580
895,6,6,1,2412,-68,-92,24,,7432946,44,322,7432902,7432946
896,6,12,1,2412,-44,-92,48,40:e3:d6:da:ba:22,7435415,156,2313,7435259,7435415
897,6,12,1,2412,-67,-92,25,,7435589,32,142,7435557,7435589
898,6,12,1,2412,-44,-92,48,40:e3:d6:da:ba:23,7435651,156,-94,7435495,7435651
899,6,12,1,2412,-68,-92,24,,7435825,32,142,7435793,7435825
900,6,12,1,2412,-44,-92,48,40:e3:d6:da:ba:25,7435897,136,-64,7435761,7435897
901,6,12,1,2412,-68,-92,24,,7436050,32,121,7436018,7436050
902,4,1,1,2412,-65,-92,27,,7441484,304,5130,7441180,7441484
903,4,1,1,2412,-65,-92,27,7a:aa:0d:81:60:e2,7442037,1128,-575,7440909,7442037
904,6,12,1,2412,-45,-92,47,40:e3:d6:da:ba:20,7443138,136,965,7443002,7443138
905,6,6,1,2412,-44,-92,48,40:e3:d6:da:ba:21,7443324,348,-162,7442976,7443324
906,6,6,1,2412,-67,-92,25,,7452198,44,8830,7452154,7452198
907,6,12,1,2412,-76,-92,16,,7452409,32,179,7452377,7452409
908,4,1,1,2412,-68,-92,24,54:e4:3a:ec:fb:64,7453206,2112,-1315,7451094,7453206
909,4,1,1,2412,-78,-92,14,,7455334,304,1824,7455030,7455334
910,6,12,1,2412,-44,-92,48,40:e3:d6:da:ba:20,7460157,160,4663,7459997,7460157
911,6,6,1,2412,-45,-92,47,40:e3:d6:da:ba:21,7460376,368,-149,7460008,7460376
912,6,12,1,2412,-45,-92,47,40:e3:d6:da:ba:22,7460781,180,225,7460601,7460781
913,6,12,1,2412,-45,-92,47,40:e3:d6:da:ba:23,7461005,184,40,7460821,7461005
914,6,12,1,2412,-44,-92,48,40:e3:d6:da:ba:24,7461223,176,42,7461047,7461223
915,6,12,1,2412,-45,-92,47,40:e3:d6:da:ba:25,7461434,160,51,7461274,7461434
916,6,6,1,2412,-45,-92,47,40:e3:d6:da:ba:26,7461626,380,-188,7461246,7461626
917,6,12,1,2412,-88,-92,4,40:e3:d6:da:ca:c0,7474229,156,12447,7474073,7474229
918,6,6,1,2412,-88,-92,4,40:e3:d6:da:ca:c1,7478045,348,3468,7477697,7478045
919,4,1,1,2412,-69,-92,23,54:e4:3a:ec:fb:64,7523590,2160,43385,7521430,7523590
920,4,1,1,2412,-80,-92,12,b8:3a:5a:88:e6:e1,7548060,2376,22094,7545684,7548060
921,6,12,1,2412,-45,-92,47,40:e3:d6:da:ba:22,7562272,180,14032,7562092,7562272
922,6,12,1,2412,-45,-92,47,40:e3:d6:da:ba:23,7562478,184,22,7562294,7562478
923,6,6,1,2412,-45,-92,47,40:e3:d6:da:ba:26,7563098,380,240,7562718,7563098
924,6,6,1,2412,-87,-92,5,84:d4:7e:f2:42:26,7564165,380,687,7563785,7564165
925,4,1,1,2412,-79,-92,13,b8:3a:5a:88:e6:e0,7648073,2360,81548,7645713,7648073
926,4,1,1,2412,-79,-92,13,b8:3a:5a:88:e6:e1,7650461,2376,12,7648085,7650461
927,6,6,1,2412,-88,-92,4,84:d4:7e:f2:34:26,7653807,380,2966,7653427,7653807
928,6,12,1,2412,-87,-92,5,84:d4:7e:f2:42:25,7659830,140,5883,7659690,7659830
929,6,6,1,2412,-45,-92,47,40:e3:d6:da:ba:21,7664299,368,4101,7663931,7664299
930,6,12,1,2412,-45,-92,47,40:e3:d6:da:ba:23,7664936,184,453,7664752,7664936
931,6,12,1,2412,-45,-92,47,40:e3:d6:da:ba:24,7665164,176,52,7664988,7665164
932,6,12,1,2412,-45,-92,47,40:e3:d6:da:ba:25,7665392,160,68,7665232,7665392
933,6,6,1,2412,-45,-92,47,40:e3:d6:da:ba:26,7665602,380,-170,7665222,7665602
934,6,6,1,2412,-88,-92,4,40:e3:d6:da:ca:c6,7683297,380,17315,7682917,7683297
935,4,1,1,2412,-78,-92,14,a6:e5:7c:28:b1:d3,7710084,992,25795,7709092,7710084
936,6,6,1,2412,-72,-92,20,e6:aa:ea:b7:4a:dd,7726114,408,15622,7725706,7726114
937,4,1,1,2412,-86,-92,6,1a:ba:9d:ae:94:54,7732070,1152,4804,7730918,7732070
938,6,12,1,2412,-87,-92,5,40:e3:d6:da:ca:c0,7736890,136,4684,7736754,7736890
939,6,12,1,2412,-88,-92,4,40:e3:d6:da:ca:c2,7737815,156,769,7737659,7737815
940,6,12,1,2412,-46,-92,46,40:e3:d6:da:ba:20,7768066,160,30091,7767906,7768066
941,6,6,1,2412,-46,-92,46,40:e3:d6:da:ba:21,7768267,368,-167,7767899,7768267
942,6,12,1,2412,-46,-92,46,40:e3:d6:da:ba:22,7768654,180,207,7768474,7768654
943,6,12,1,2412,-46,-92,46,40:e3:d6:da:ba:23,7768877,184,39,7768693,7768877
944,6,12,1,2412,-46,-92,46,40:e3:d6:da:ba:24,7769087,176,34,7768911,7769087
945,6,12,1,2412,-46,-92,46,40:e3:d6:da:ba:25,7769306,160,59,7769146,7769306
946,6,6,1,2412,-46,-92,46,40:e3:d6:da:ba:26,7769525,380,-161,7769145,7769525
947,6,6,1,2412,-54,-92,38,e6:aa:ea:c9:ea:33,7792262,408,22329,7791854,7792262
948,6,6,1,2412,-86,-92,6,e6:aa:ea:c9:ea:1b,7794790,408,2120,7794382,7794790
949,6,6,1,2412,-53,-92,39,e6:aa:ea:c9:ea:33,7804420,408,9222,7804012,7804420
950,6,6,1,2412,-87,-92,5,e6:aa:ea:c9:ea:1b,7806915,408,2087,7806507,7806915
951,6,6,1,2412,-53,-92,39,e6:aa:ea:c9:ea:33,7828595,408,21272,7828187,7828595
952,6,6,1,2412,-53,-92,39,e6:aa:ea:c9:ea:33,7840709,408,11706,7840301,7840709
953,4,1,1,2412,-80,-92,12,b8:3a:5a:88:e6:e0,7852853,2360,9784,7850493,7852853
954,6,12,1,2412,-45,-92,47,40:e3:d6:da:ba:20,7868865,160,15852,7868705,7868865
955,6,6,1,2412,-45,-92,47,40:e3:d6:da:ba:21,7869066,368,-167,7868698,7869066
956,6,12,1,2412,-45,-92,47,40:e3:d6:da:ba:22,7869462,180,216,7869282,7869462
957,6,12,1,2412,-45,-92,47,40:e3:d6:da:ba:25,7870097,160,475,7869937,7870097
958,6,6,1,2412,-45,-92,47,40:e3:d6:da:ba:26,7870297,380,-180,7869917,7870297
959,6,6,1,2412,-88,-92,4,84:d4:7e:f2:42:26,7871146,380,469,7870766,7871146
960,6,12,1,2412,-88,-92,4,,7933605,32,62427,7933573,7933605
961,6,12,1,2412,-88,-92,4,,7933677,36,36,7933641,7933677
962,6,12,1,2412,-88,-92,4,,7937430,44,3709,7937386,7937430
963,4,1,1,2412,-80,-92,12,b8:3a:5a:88:e6:e0,7955269,2360,15479,7952909,7955269
964,6,6,1,2412,-44,-92,48,40:e3:d6:da:ba:21,7971451,368,15814,7971083,7971451
965,6,12,1,2412,-44,-92,48,40:e3:d6:da:ba:22,7971865,180,234,7971685,7971865
966,6,12,1,2412,-45,-92,47,40:e3:d6:da:ba:23,7972089,184,40,7971905,7972089
967,6,12,1,2412,-44,-92,48,40:e3:d6:da:ba:24,7972298,176,33,7972122,7972298
968,6,12,1,2412,-44,-92,48,40:e3:d6:da:ba:25,7972500,160,42,7972340,7972500
969,6,6,1,2412,-44,-92,48,40:e3:d6:da:ba:26,7972727,380,-153,7972347,7972727
970,6,6,1,2412,-89,-92,3,40:e3:d6:da:ca:c1,7986419,368,13324,7986051,7986419
971,6,12,1,2412,-87,-92,5,,8027896,36,41441,8027860,8027896
972,4,1,1,2412,-75,-92,17,54:e4:3a:ec:fb:64,8031673,2160,1617,8029513,8031673
973,4,1,1,2412,-79,-92,13,b8:3a:5a:88:e6:e0,8057652,2360,23619,8055292,8057652
974,4,1,1,2412,-79,-92,13,b8:3a:5a:88:e6:e1,8060031,2376,3,8057655,8060031
975,6,12,1,2412,-44,-92,48,40:e3:d6:da:ba:20,8073653,160,13462,8073493,8073653
976,6,6,1,2412,-45,-92,47,40:e3:d6:da:ba:21,8073863,368,-158,8073495,8073863
977,6,12,1,2412,-45,-92,47,40:e3:d6:da:ba:22,8074277,180,234,8074097,8074277
978,6,12,1,2412,-44,-92,48,40:e3:d6:da:ba:23,8074482,184,21,8074298,8074482
979,6,12,1,2412,-44,-92,48,40:e3:d6:da:ba:25,8074911,160,269,8074751,8074911
980,6,6,1,2412,-44,-92,48,40:e3:d6:da:ba:26,8075112,380,-179,8074732,8075112
981,6,12,1,2412,-88,-92,4,,8091939,32,16795,8091907,8091939
982,4,1,1,2412,-82,-92,10,,8111654,304,19411,8111350,8111654
983,4,1,1,2412,-80,-92,12,c0:c9:e3:4d:6e:bf,8155723,872,43197,8154851,8155723
984,4,1,1,2412,-77,-92,15,,8156612,304,585,8156308,8156612
985,4,1,1,2412,-61,-92,31,b8:3a:5a:88:e6:e0,8160073,2360,1101,8157713,8160073
986,4,1,1,2412,-79,-92,13,b8:3a:5a:88:e6:e1,8162462,2376,13,8160086,8162462
987,6,12,1,2412,-86,-92,6,40:e3:d6:da:bb:e4,8173796,172,11162,8173624,8173796
988,6,12,1,2412,-86,-92,6,40:e3:d6:da:bb:e5,8174012,156,60,8173856,8174012
989,6,6,1,2412,-88,-92,4,40:e3:d6:da:bb:e6,8174200,380,-192,8173820,8174200
990,6,12,1,2412,-44,-92,48,40:e3:d6:da:ba:20,8176052,160,1692,8175892,8176052
991,6,6,1,2412,-45,-92,47,40:e3:d6:da:ba:21,8176254,368,-166,8175886,8176254
992,6,12,1,2412,-44,-92,48,40:e3:d6:da:ba:22,8176649,180,215,8176469,8176649
993,6,12,1,2412,-44,-92,48,40:e3:d6:da:ba:25,8177319,160,510,8177159,8177319
994,6,12,1,2412,-87,-92,5,84:d4:7e:f2:42:24,8177943,176,448,8177767,8177943
995,6,12,1,2412,-85,-92,7,84:d4:7e:f2:42:25,8178163,160,60,8178003,8178163
996,6,12,1,2412,-86,-92,6,40:e3:d6:da:ca:c5,8192270,156,13951,8192114,8192270
997,6,6,1,2412,-86,-92,6,40:e3:d6:da:ca:c6,8192485,380,-165,8192105,8192485
998,6,12,1,2412,-87,-92,5,,8193575,32,1058,8193543,8193575
999,4,1,1,2412,-72,-92,20,c0:c9:e3:4d:6e:bf,8200366,872,5919,8199494,8200366
1000,4,1,1,2412,-78,-92,14,,8201254,304,584,8200950,8201254
1001,6,12,1,2412,-86,-92,6,,8217323,32,16037,8217291,8217323
1002,4,1,1,2412,-79,-92,13,a6:e5:7c:28:b1:d3,8227089,992,8774,8226097,8227089
1003,4,1,1,2412,-81,-92,11,,8229423,304,2030,8229119,8229423
1004,4,1,1,2412,-66,-92,26,54:e4:3a:ec:fb:64,8235312,2160,3729,8233152,8235312
1005,6,6,1,2412,-69,-92,23,e6:aa:ea:b7:4a:dd,8257698,408,21978,8257290,8257698
1006,6,6,1,2412,-69,-92,23,e6:aa:ea:b7:4a:dd,8269813,408,11707,8269405,8269813
1007,6,12,1,2412,-71,-92,21,84:d4:7e:d5:12:c0,8271580,960,807,8270620,8271580
1008,6,12,1,2412,-87,-92,5,40:e3:d6:da:bb:e4,8276431,172,4679,8276259,8276431
1009,6,12,1,2412,-86,-92,6,40:e3:d6:da:bb:e5,8277063,156,476,8276907,8277063
1010,6,12,1,2412,-45,-92,47,40:e3:d6:da:ba:20,8278453,160,1230,8278293,8278453
1011,6,12,1,2412,-44,-92,48,40:e3:d6:da:ba:22,8279068,180,435,8278888,8279068
1012,6,12,1,2412,-45,-92,47,40:e3:d6:da:ba:23,8279274,184,22,8279090,8279274
1013,6,12,1,2412,-44,-92,48,40:e3:d6:da:ba:24,8279492,176,42,8279316,8279492
1014,6,12,1,2412,-45,-92,47,40:e3:d6:da:ba:25,8279693,160,41,8279533,8279693
1015,6,6,1,2412,-44,-92,48,40:e3:d6:da:ba:26,8279885,380,-188,8279505,8279885
1016,6,12,1,2412,-86,-92,6,84:d4:7e:f2:42:24,8280318,176,257,8280142,8280318
1017,6,12,1,2412,-87,-92,5,84:d4:7e:f2:42:25,8280538,160,60,8280378,8280538
1018,6,6,1,2412,-85,-92,7,84:d4:7e:f2:42:26,8280757,380,-161,8280377,8280757
1019,6,6,1,2412,-70,-92,22,e6:aa:ea:b7:4a:dd,8281951,408,786,8281543,8281951
1020,6,6,1,2412,-70,-92,22,e6:aa:ea:b7:4a:dd,8294053,408,11694,8293645,8294053
1021,6,6,1,2412,-50,-92,42,e6:aa:ea:c9:ea:33,8311739,408,17278,8311331,8311739
1022,6,12,1,2412,-86,-92,6,,8316749,32,4978,8316717,8316749
1023,4,1,1,2412,-79,-92,13,a6:e5:7c:28:b1:d3,8327987,992,10246,8326995,8327987
1024,6,6,1,2412,-83,-92,9,e6:aa:ea:c9:ea:1b,8329745,408,1350,8329337,8329745
1025,6,6,1,2412,-51,-92,41,e6:aa:ea:c9:ea:33,8335991,408,5838,8335583,8335991
1026,4,1,1,2412,-66,-92,26,54:e4:3a:ec:fb:64,8337712,2160,-439,8335552,8337712
1027,6,6,1,2412,-51,-92,41,e6:aa:ea:c9:ea:33,8348103,408,9983,8347695,8348103
1028,6,6,1,2412,-51,-92,41,e6:aa:ea:c9:ea:33,8360225,408,11714,8359817,8360225
1029,4,1,1,2412,-81,-92,11,b8:3a:5a:88:e6:e0,8364853,2360,2268,8362493,8364853
1030,4,1,1,2412,-81,-92,11,b8:3a:5a:88:e6:e1,8367250,2376,21,8364874,8367250
1031,6,12,1,2412,-45,-92,47,40:e3:d6:da:ba:20,8380858,160,13448,8380698,8380858
1032,6,6,1,2412,-45,-92,47,40:e3:d6:da:ba:21,8381077,368,-149,8380709,8381077
1033,6,12,1,2412,-45,-92,47,40:e3:d6:da:ba:22,8381473,180,216,8381293,8381473
1034,6,12,1,2412,-45,-92,47,40:e3:d6:da:ba:24,8381915,176,266,8381739,8381915
1035,6,12,1,2412,-45,-92,47,40:e3:d6:da:ba:25,8382116,160,41,8381956,8382116
1036,6,6,1,2412,-45,-92,47,40:e3:d6:da:ba:26,8382317,380,-179,8381937,8382317
1037,6,12,1,2412,-87,-92,5,40:e3:d6:da:ca:c2,8396430,176,13937,8396254,8396430
1038,6,12,1,2412,-86,-92,6,40:e3:d6:da:ca:c3,8396632,180,22,8396452,8396632
1039,4,1,1,2412,-66,-92,26,54:e4:3a:ec:fb:64,8440082,2160,41290,8437922,8440082
1040,6,6,1,2412,-86,-92,6,40:e3:d6:da:bb:e1,8457748,348,17318,8457400,8457748
1041,6,12,1,2412,-83,-92,9,40:e3:d6:da:bb:e5,8458522,136,638,8458386,8458522
1042,4,1,1,2412,-82,-92,10,b8:3a:5a:88:e6:e0,8467252,2360,6370,8464892,8467252
1043,6,6,1,2412,-46,-92,46,40:e3:d6:da:ba:21,8483519,368,15899,8483151,8483519
1044,6,12,1,2412,-46,-92,46,40:e3:d6:da:ba:22,8484147,180,448,8483967,8484147
1045,6,12,1,2412,-46,-92,46,40:e3:d6:da:ba:23,8484353,184,22,8484169,8484353
1046,6,12,1,2412,-46,-92,46,40:e3:d6:da:ba:24,8484563,176,34,8484387,8484563
1047,6,12,1,2412,-45,-92,47,40:e3:d6:da:ba:25,8484791,160,68,8484631,8484791
1048,6,6,1,2412,-46,-92,46,40:e3:d6:da:ba:26,8485001,380,-170,8484621,8485001
1049,4,1,1,2412,-82,-92,10,,8493034,304,7729,8492730,8493034
1050,6,12,1,2412,-86,-92,6,40:e3:d6:da:ca:c0,8493483,136,313,8493347,8493483
1051,6,6,1,2412,-85,-92,7,40:e3:d6:da:ca:c1,8493780,348,-51,8493432,8493780
1052,6,12,1,2412,-85,-92,7,40:e3:d6:da:ca:c2,8494156,156,220,8494000,8494156
1053,6,12,1,2412,-86,-92,6,84:d4:7e:f2:42:20,8494894,140,598,8494754,8494894
1054,6,6,1,2412,-86,-92,6,40:e3:d6:da:ca:c1,8498448,368,3186,8498080,8498448
1055,4,1,1,2412,-79,-92,13,a6:e5:7c:28:b1:d3,8499912,944,520,8498968,8499912
1056,4,1,1,2412,-80,-92,12,,8518600,304,18384,8518296,8518600
1057,4,1,1,2412,-65,-92,27,54:e4:3a:ec:fb:64,8542473,2160,21713,8540313,8542473
1058,6,6,1,2412,-69,-92,23,78:8a:20:fa:27:f9,8555312,88,12751,8555224,8555312
1059,6,6,1,2412,-82,-92,10,,8555419,44,63,8555375,8555419
1060,6,6,1,2412,-69,-92,23,,8556093,44,630,8556049,8556093
1061,6,6,1,2412,-69,-92,23,,8556545,44,408,8556501,8556545
1062,6,12,1,2412,-69,-92,23,,8557199,32,622,8557167,8557199
1063,6,12,1,2412,-69,-92,23,,8557432,32,201,8557400,8557432
1064,4,1,1,2412,-79,-92,13,a6:e5:7c:28:b1:d3,8581400,944,23024,8580456,8581400
1065,4,1,1,2412,-80,-92,12,a6:e5:7c:28:b1:d3,8583592,944,1248,8582648,8583592
1066,4,1,1,2412,-78,-92,14,a6:e5:7c:28:b1:d3,8584688,944,152,8583744,8584688
1067,4,1,1,2412,-79,-92,13,a6:e5:7c:28:b1:d3,8585748,944,116,8584804,8585748
1068,6,12,1,2412,-47,-92,45,40:e3:d6:da:ba:22,8587682,180,1754,8587502,8587682
1069,6,12,1,2412,-47,-92,45,40:e3:d6:da:ba:23,8587906,184,40,8587722,8587906
1070,6,6,1,2412,-47,-92,45,40:e3:d6:da:ba:26,8588908,380,622,8588528,8588908
1071,4,1,1,2412,-80,-92,12,a6:e5:7c:28:b1:d3,8592448,944,2596,8591504,8592448
1072,6,12,1,2412,-86,-92,6,40:e3:d6:da:ca:c3,8601432,180,8804,8601252,8601432
1073,6,12,1,2412,-86,-92,6,40:e3:d6:da:ca:c4,8601655,172,51,8601483,8601655
1074,6,6,1,2412,-86,-92,6,40:e3:d6:da:ca:c6,8602050,380,15,8601670,8602050
1075,6,12,1,2412,-87,-92,5,,8604711,32,2629,8604679,8604711
1076,6,12,1,2412,-87,-92,5,,8604828,32,85,8604796,8604828
1077,6,12,1,2412,-85,-92,7,,8605191,32,331,8605159,8605191
1078,6,6,1,2412,-68,-92,24,78:8a:20:fa:27:f9,8605381,88,102,8605293,8605381
1079,6,6,1,2412,-78,-92,14,,8605487,44,62,8605443,8605487
1080,6,12,1,2412,-69,-92,23,,8605753,32,234,8605721,8605753
1081,6,12,1,2412,-69,-92,23,,8605977,32,192,8605945,8605977
1082,4,1,1,2412,-81,-92,11,a6:e5:7c:28:b1:d3,8606228,944,-693,8605284,8606228
1083,4,1,1,2412,-70,-92,22,,8607182,304,650,8606878,8607182
1084,6,6,1,2412,-69,-92,23,,8607726,44,500,8607682,8607726
1085,6,12,1,2412,-68,-92,24,,8607984,32,226,8607952,8607984
1086,6,12,1,2412,-69,-92,23,,8608228,32,212,8608196,8608228
1087,6,12,1,2412,-67,-92,25,,8608472,32,212,8608440,8608472
1088,6,12,1,2412,-69,-92,23,,8608704,32,200,8608672,8608704
1089,6,12,1,2412,-69,-92,23,,8608957,32,221,8608925,8608957
1090,6,12,1,2412,-69,-92,23,,8609189,32,200,8609157,8609189
1091,6,12,1,2412,-86,-92,6,,8628889,36,19664,8628853,8628889
1092,4,1,1,2412,-80,-92,12,c0:c9:e3:4d:6e:bf,8642729,872,12968,8641857,8642729
1093,4,1,1,2412,-79,-92,13,a6:e5:7c:28:b1:d3,8676200,944,32527,8675256,8676200
1094,4,1,1,2412,-79,-92,13,a6:e5:7c:28:b1:d3,8677392,944,248,8676448,8677392
1095,4,1,1,2412,-78,-92,14,a6:e5:7c:28:b1:d3,8680842,944,2506,8679898,8680842
1096,4,1,1,2412,-80,-92,12,a6:e5:7c:28:b1:d3,8684058,944,2272,8683114,8684058
1097,6,12,1,2412,-48,-92,44,40:e3:d6:da:ba:20,8689041,160,4823,8688881,8689041
1098,6,6,1,2412,-48,-92,44,40:e3:d6:da:ba:26,8690695,380,1274,8690315,8690695
1099,4,1,1,2412,-65,-92,27,a6:e5:7c:28:b1:d3,8691430,944,-209,8690486,8691430
1100,4,1,1,2412,-79,-92,13,a6:e5:7c:28:b1:d3,8693731,944,1357,8692787,8693731
1101,4,1,1,2412,-80,-92,12,a6:e5:7c:28:b1:d3,8696276,944,1601,8695332,8696276
1102,4,1,1,2412,-80,-92,12,a6:e5:7c:28:b1:d3,8697354,944,134,8696410,8697354
1103,4,1,1,2412,-75,-92,17,a6:e5:7c:28:b1:d3,8698414,944,116,8697470,8698414
1104,6,6,1,2412,-76,-92,16,e6:aa:ea:b7:4a:dd,8699268,408,446,8698860,8699268
1105,4,1,1,2412,-80,-92,12,a6:e5:7c:28:b1:d3,8700637,944,425,8699693,8700637
1106,6,6,1,2412,-76,-92,16,e6:aa:ea:b7:4a:dd,8711382,408,10337,8710974,8711382
1107,4,1,1,2412,-60,-92,32,a6:e5:7c:28:b1:d3,8767557,944,55231,8766613,8767557
1108,4,1,1,2412,-80,-92,12,a6:e5:7c:28:b1:d3,8768727,944,226,8767783,8768727
1109,4,1,1,2412,-79,-92,13,a6:e5:7c:28:b1:d3,8770883,944,1212,8769939,8770883
1110,4,1,1,2412,-79,-92,13,a6:e5:7c:28:b1:d3,8771970,944,143,8771026,8771970
1111,4,1,1,2412,-80,-92,12,a6:e5:7c:28:b1:d3,8773039,944,125,8772095,8773039
1112,4,1,1,2412,-80,-92,12,a6:e5:7c:28:b1:d3,8777417,944,3434,8776473,8777417
1113,4,1,1,2412,-78,-92,14,a6:e5:7c:28:b1:d3,8780749,944,2388,8779805,8780749
1114,4,1,1,2412,-80,-92,12,a6:e5:7c:28:b1:d3,8781800,944,107,8780856,8781800
1115,4,1,1,2412,-80,-92,12,a6:e5:7c:28:b1:d3,8783247,944,503,8782303,8783247
1116,4,1,1,2412,-79,-92,13,a6:e5:7c:28:b1:d3,8784307,944,116,8783363,8784307
1117,4,1,1,2412,-80,-92,12,a6:e5:7c:28:b1:d3,8785376,944,125,8784432,8785376
1118,4,1,1,2412,-79,-92,13,a6:e5:7c:28:b1:d3,8786445,944,125,8785501,8786445
1119,4,1,1,2412,-79,-92,13,a6:e5:7c:28:b1:d3,8788565,944,1176,8787621,8788565
1120,4,1,1,2412,-79,-92,13,a6:e5:7c:28:b1:d3,8789616,944,107,8788672,8789616
1121,6,6,1,2412,-48,-92,44,40:e3:d6:da:ba:21,8791403,368,1419,8791035,8791403
1122,6,12,1,2412,-48,-92,44,40:e3:d6:da:ba:22,8791808,180,225,8791628,8791808
1123,6,12,1,2412,-49,-92,43,40:e3:d6:da:ba:23,8792013,184,21,8791829,8792013
1124,6,12,1,2412,-48,-92,44,40:e3:d6:da:ba:24,8792241,176,52,8792065,8792241
1125,6,12,1,2412,-48,-92,44,40:e3:d6:da:ba:25,8792469,160,68,8792309,8792469
1126,6,6,1,2412,-48,-92,44,40:e3:d6:da:ba:26,8792661,380,-188,8792281,8792661
1127,6,6,1,2412,-87,-92,5,40:e3:d6:da:ca:c1,8805634,368,12605,8805266,8805634
1128,6,12,1,2412,-86,-92,6,40:e3:d6:da:ca:c2,8806030,176,220,8805854,8806030
1129,6,12,1,2412,-87,-92,5,40:e3:d6:da:ca:c4,8806473,172,271,8806301,8806473
1130,6,6,1,2412,-54,-92,38,e6:aa:ea:c9:ea:33,8831297,408,24416,8830889,8831297
1131,6,6,1,2412,-54,-92,38,e6:aa:ea:c9:ea:33,8843442,408,11737,8843034,8843442
1132,4,1,1,2412,-65,-92,27,54:e4:3a:ec:fb:64,8850020,2160,4418,8847860,8850020
1133,6,6,1,2412,-54,-92,38,e6:aa:ea:c9:ea:33,8855528,408,5100,8855120,8855528
1134,4,1,1,2412,-80,-92,12,a6:e5:7c:28:b1:d3,8858783,944,2311,8857839,8858783
1135,4,1,1,2412,-79,-92,13,a6:e5:7c:28:b1:d3,8859843,944,116,8858899,8859843
1136,4,1,1,2412,-80,-92,12,a6:e5:7c:28:b1:d3,8861045,944,258,8860101,8861045
1137,4,1,1,2412,-81,-92,11,a6:e5:7c:28:b1:d3,8862096,944,107,8861152,8862096
1138,4,1,1,2412,-81,-92,11,a6:e5:7c:28:b1:d3,8863147,944,107,8862203,8863147
1139,6,6,1,2412,-54,-92,38,e6:aa:ea:c9:ea:33,8867680,408,4125,8867272,8867680
1140,6,6,1,2412,-87,-92,5,40:e3:d6:da:bb:e1,8889752,368,21704,8889384,8889752
1141,6,12,1,2412,-88,-92,4,40:e3:d6:da:bb:e2,8890158,176,230,8889982,8890158
1142,6,12,1,2412,-47,-92,45,40:e3:d6:da:ba:20,8892874,160,2556,8892714,8892874
1143,6,6,1,2412,-47,-92,45,40:e3:d6:da:ba:21,8893093,368,-149,8892725,8893093
1144,6,12,1,2412,-47,-92,45,40:e3:d6:da:ba:23,8893713,184,436,8893529,8893713
1145,6,12,1,2412,-47,-92,45,40:e3:d6:da:ba:25,8894151,160,278,8893991,8894151
1146,6,6,1,2412,-47,-92,45,40:e3:d6:da:ba:26,8894361,380,-170,8893981,8894361
1147,6,12,1,2412,-84,-92,8,40:e3:d6:da:ca:c5,8910613,156,16096,8910457,8910613
1148,4,1,1,2412,-63,-92,29,54:e4:3a:ec:fb:64,8952057,2160,39284,8949897,8952057
1149,6,12,1,2412,-46,-92,46,40:e3:d6:da:ba:20,8995282,160,43065,8995122,8995282
1150,6,12,1,2412,-46,-92,46,40:e3:d6:da:ba:23,8996154,184,688,8995970,8996154
1151,6,12,1,2412,-46,-92,46,40:e3:d6:da:ba:25,8996592,160,278,8996432,8996592
1152,4,1,1,2412,-87,-92,5,,9045009,304,48113,9044705,9045009
1153,6,6,1,2412,-85,-92,7,e6:aa:ea:c9:ea:1b,9066977,408,21560,9066569,9066977
1154,6,6,1,2412,-83,-92,9,e6:aa:ea:c9:ea:1b,9079103,408,11718,9078695,9079103
1155,4,1,1,2412,-84,-92,8,b8:3a:5a:88:e6:e0,9081666,2360,203,9079306,9081666
1156,6,6,1,2412,-84,-92,8,e6:aa:ea:c9:ea:1b,9091312,408,9238,9090904,9091312
1157,6,6,1,2412,-75,-92,17,e6:aa:ea:b7:4a:dd,9092484,408,764,9092076,9092484
1158,6,12,1,2412,-88,-92,4,40:e3:d6:da:bb:e0,9094359,156,1719,9094203,9094359
1159,6,6,1,2412,-90,-92,2,40:e3:d6:da:bb:e1,9094547,368,-180,9094179,9094547
1160,6,12,1,2412,-87,-92,5,40:e3:d6:da:bb:e4,9095386,172,667,9095214,9095386
1161,6,6,1,2412,-90,-92,2,40:e3:d6:da:bb:e6,9095790,380,24,9095410,9095790
1162,6,12,1,2412,-48,-92,44,40:e3:d6:da:ba:20,9097655,160,1705,9097495,9097655
1163,6,6,1,2412,-47,-92,45,40:e3:d6:da:ba:21,9097874,368,-149,9097506,9097874
1164,6,12,1,2412,-48,-92,44,40:e3:d6:da:ba:22,9100404,180,2350,9100224,9100404
1165,6,12,1,2412,-47,-92,45,40:e3:d6:da:ba:23,9100618,184,30,9100434,9100618
1166,6,12,1,2412,-47,-92,45,40:e3:d6:da:ba:24,9100855,176,61,9100679,9100855
1167,6,12,1,2412,-47,-92,45,40:e3:d6:da:ba:25,9101083,160,68,9100923,9101083
1168,6,6,1,2412,-47,-92,45,40:e3:d6:da:ba:26,9101302,380,-161,9100922,9101302
1169,6,6,1,2412,-73,-92,19,e6:aa:ea:b7:4a:dd,9104598,408,2888,9104190,9104598
1170,4,1,1,2412,-80,-92,12,,9141425,304,36523,9141121,9141425
1171,4,5.5,1,2412,-89,-92,3,,9152133,213,10495,9151920,9152133
1172,4,1,1,2412,-85,-92,7,b8:3a:5a:88:e6:e0,9152379,2240,-1994,9150139,9152379
1173,4,1,1,2412,-84,-92,8,b8:3a:5a:88:e6:e1,9154674,2256,39,9152418,9154674
1174,4,1,1,2412,-67,-92,25,54:e4:3a:ec:fb:64,9157143,2160,309,9154983,9157143
1175,6,12,1,2412,-51,-92,41,40:e3:d6:da:ba:20,9200057,160,42754,9199897,9200057
1176,6,12,1,2412,-51,-92,41,40:e3:d6:da:ba:22,9200691,180,454,9200511,9200691
1177,6,12,1,2412,-51,-92,41,40:e3:d6:da:ba:24,9201133,176,266,9200957,9201133
1178,6,6,1,2412,-51,-92,41,40:e3:d6:da:ba:26,9201571,380,58,9201191,9201571
1179,6,6,1,2412,-86,-92,6,84:d4:7e:f2:42:26,9202399,380,448,9202019,9202399
1180,4,1,1,2412,-90,-92,2,,9205890,304,3187,9205586,9205890
1181,4,1,1,2412,-76,-92,16,a6:e5:7c:28:b1:d3,9245968,992,39086,9244976,9245968
1182,6,6,1,2412,-53,-92,39,e6:aa:ea:c9:ea:33,9249414,408,3038,9249006,9249414
1183,6,6,1,2412,-53,-92,39,e6:aa:ea:c9:ea:33,9264265,408,14443,9263857,9264265
1184,6,6,1,2412,-53,-92,39,e6:aa:ea:c9:ea:33,9273670,408,8997,9273262,9273670
1185,6,6,1,2412,-53,-92,39,e6:aa:ea:c9:ea:33,9285797,408,11719,9285389,9285797
1186,4,1,1,2412,-84,-92,8,b8:3a:5a:88:e6:e0,9286464,2360,-1693,9284104,9286464
1187,4,1,1,2412,-85,-92,7,b8:3a:5a:88:e6:e1,9288844,2376,4,9286468,9288844
1188,6,6,1,2412,-91,-92,1,40:e3:d6:da:bb:e1,9299349,368,10137,9298981,9299349
1189,6,12,1,2412,-89,-92,3,40:e3:d6:da:bb:e2,9299754,176,229,9299578,9299754
1190,6,12,1,2412,-88,-92,4,40:e3:d6:da:bb:e3,9299956,180,22,9299776,9299956
1191,6,12,1,2412,-89,-92,3,40:e3:d6:da:bb:e4,9300188,172,60,9300016,9300188
1192,6,12,1,2412,-90,-92,2,40:e3:d6:da:bb:e5,9300412,156,68,9300256,9300412
1193,6,6,1,2412,-89,-92,3,40:e3:d6:da:bb:e6,9300609,380,-183,9300229,9300609
1194,6,12,1,2412,-50,-92,42,40:e3:d6:da:ba:20,9302482,160,1713,9302322,9302482
1195,6,6,1,2412,-50,-92,42,40:e3:d6:da:ba:21,9302701,368,-149,9302333,9302701
1196,6,12,1,2412,-50,-92,42,40:e3:d6:da:ba:22,9303097,180,216,9302917,9303097
1197,6,12,1,2412,-50,-92,42,40:e3:d6:da:ba:23,9303311,184,30,9303127,9303311
1198,6,12,1,2412,-48,-92,44,40:e3:d6:da:ba:25,9303740,160,269,9303580,9303740
1199,6,6,1,2412,-50,-92,42,40:e3:d6:da:ba:26,9303950,380,-170,9303570,9303950
1200,6,12,1,2412,-85,-92,7,84:d4:7e:f2:42:24,9304364,176,238,9304188,9304364
1201,6,6,1,2412,-86,-92,6,e6:aa:ea:c9:ea:1b,9371582,408,66810,9371174,9371582
1202,4,1,1,2412,-81,-92,11,b8:3a:5a:88:e6:e0,9388873,2360,14931,9386513,9388873
1203,4,1,1,2412,-72,-92,20,b8:3a:5a:88:e6:e1,9391270,2376,21,9388894,9391270
1204,6,12,1,2412,-50,-92,42,40:e3:d6:da:ba:20,9404874,160,13444,9404714,9404874
1205,6,12,1,2412,-50,-92,42,40:e3:d6:da:ba:22,9405470,180,416,9405290,9405470
1206,6,12,1,2412,-50,-92,42,40:e3:d6:da:ba:23,9405676,184,22,9405492,9405676
1207,6,12,1,2412,-50,-92,42,40:e3:d6:da:ba:24,9405885,176,33,9405709,9405885
1208,6,6,1,2412,-50,-92,42,40:e3:d6:da:ba:26,9406287,380,22,9405907,9406287
1209,6,12,1,2412,-87,-92,5,84:d4:7e:f2:42:24,9406750,176,287,9406574,9406750
1210,6,6,1,2412,-86,-92,6,40:e3:d6:da:ca:c1,9420043,368,12925,9419675,9420043
1211,4,1,1,2412,-67,-92,25,54:e4:3a:ec:fb:64,9464147,2160,41944,9461987,9464147
1212,4,1,1,2412,-75,-92,17,b8:3a:5a:88:e6:e0,9491258,2360,24751,9488898,9491258
1213,6,12,1,2412,-49,-92,43,40:e3:d6:da:ba:23,9508122,184,16680,9507938,9508122
1214,6,12,1,2412,-49,-92,43,40:e3:d6:da:ba:24,9508332,176,34,9508156,9508332
1215,6,12,1,2412,-49,-92,43,40:e3:d6:da:ba:25,9508542,160,50,9508382,9508542
1216,6,6,1,2412,-49,-92,43,40:e3:d6:da:ba:26,9508761,380,-161,9508381,9508761
1217,6,12,1,2412,-87,-92,5,,9558060,32,49267,9558028,9558060
1218,6,12,1,2412,-87,-92,5,,9558733,32,641,9558701,9558733
1219,6,12,1,2412,-85,-92,7,,9558850,44,73,9558806,9558850
1220,6,12,1,2412,-87,-92,5,,9573101,36,14215,9573065,9573101
1221,6,12,1,2412,-88,-92,4,,9573316,36,179,9573280,9573316
1222,6,12,1,2412,-86,-92,6,,9573689,36,337,9573653,9573689
1223,6,12,1,2412,-87,-92,5,,9575498,44,1765,9575454,9575498
1224,4,1,1,2412,-79,-92,13,b8:3a:5a:88:e6:e0,9593687,2360,15829,9591327,9593687
1225,4,1,1,2412,-71,-92,21,b8:3a:5a:88:e6:e1,9596084,2376,21,9593708,9596084
1226,6,6,1,2412,-86,-92,6,84:d4:7e:f2:34:26,9599136,380,2672,9598756,9599136
1227,6,6,1,2412,-75,-92,17,e6:aa:ea:b7:4a:dd,9599642,408,98,9599234,9599642
1228,6,12,1,2412,-85,-92,7,40:e3:d6:da:bb:e0,9606371,156,6573,9606215,9606371
1229,6,6,1,2412,-87,-92,5,40:e3:d6:da:bb:e1,9606585,368,-154,9606217,9606585
1230,6,12,1,2412,-87,-92,5,40:e3:d6:da:bb:e2,9606990,176,229,9606814,9606990
1231,6,12,1,2412,-87,-92,5,40:e3:d6:da:bb:e3,9607192,180,22,9607012,9607192
1232,6,12,1,2412,-87,-92,5,40:e3:d6:da:bb:e4,9607415,172,51,9607243,9607415
1233,6,6,1,2412,-85,-92,7,40:e3:d6:da:bb:e6,9607810,380,15,9607430,9607810
1234,6,12,1,2412,-49,-92,43,40:e3:d6:da:ba:20,9609671,160,1701,9609511,9609671
1235,6,12,1,2412,-49,-92,43,40:e3:d6:da:ba:22,9610267,180,416,9610087,9610267
1236,6,12,1,2412,-49,-92,43,40:e3:d6:da:ba:23,9610500,184,49,9610316,9610500
1237,6,12,1,2412,-48,-92,44,40:e3:d6:da:ba:24,9610736,176,60,9610560,9610736
1238,6,12,1,2412,-48,-92,44,40:e3:d6:da:ba:25,9610947,160,51,9610787,9610947
1239,6,6,1,2412,-48,-92,44,40:e3:d6:da:ba:26,9611166,380,-161,9610786,9611166
1240,6,6,1,2412,-72,-92,20,e6:aa:ea:b7:4a:dd,9623877,408,12303,9623469,9623877
1241,6,12,1,2412,-87,-92,5,40:e3:d6:da:ca:c0,9624628,156,595,9624472,9624628
1242,4,1,1,2412,-77,-92,15,c0:c9:e3:4d:6e:bf,9631697,872,6197,9630825,9631697
1243,4,1,1,2412,-70,-92,22,,9632586,304,585,9632282,9632586
1244,6,6,1,2412,-72,-92,20,e6:aa:ea:b7:4a:dd,9635992,408,2998,9635584,9635992
1245,6,6,1,2412,-71,-92,21,e6:aa:ea:b7:4a:dd,9648114,408,11714,9647706,9648114
1246,6,6,1,2412,-53,-92,39,e6:aa:ea:c9:ea:33,9666660,408,18138,9666252,9666660
1247,6,12,1,2412,-88,-92,4,,9667499,32,807,9667467,9667499
1248,4,1,1,2412,-85,-92,7,,9678415,304,10612,9678111,9678415
1249,6,6,1,2412,-53,-92,39,e6:aa:ea:c9:ea:33,9678785,408,-38,9678377,9678785
1250,6,6,1,2412,-84,-92,8,e6:aa:ea:c9:ea:1b,9689044,408,9851,9688636,9689044
1251,6,6,1,2412,-53,-92,39,e6:aa:ea:c9:ea:33,9690918,408,1466,9690510,9690918
1252,4,1,1,2412,-64,-92,28,ba:55:cd:a8:ce:33,9695343,1128,3297,9694215,9695343
1253,6,12,1,2412,-65,-92,27,,9696603,32,1228,9696571,9696603
1254,6,6,1,2412,-53,-92,39,e6:aa:ea:c9:ea:33,9703201,408,6190,9702793,9703201
1255,6,6,1,2412,-88,-92,4,40:e3:d6:da:bb:e6,9710177,380,6596,9709797,9710177
1256,6,12,1,2412,-50,-92,42,40:e3:d6:da:ba:20,9712066,160,1729,9711906,9712066
1257,6,6,1,2412,-51,-92,41,40:e3:d6:da:ba:21,9712285,368,-149,9711917,9712285
1258,6,12,1,2412,-50,-92,42,40:e3:d6:da:ba:22,9712672,180,207,9712492,9712672
1259,6,12,1,2412,-50,-92,42,40:e3:d6:da:ba:23,9712905,184,49,9712721,9712905
1260,6,12,1,2412,-50,-92,42,40:e3:d6:da:ba:24,9713114,176,33,9712938,9713114
1261,6,12,1,2412,-50,-92,42,40:e3:d6:da:ba:25,9713325,160,51,9713165,9713325
1262,6,6,1,2412,-50,-92,42,40:e3:d6:da:ba:26,9713526,380,-179,9713146,9713526
1263,6,6,1,2412,-88,-92,4,84:d4:7e:f2:42:26,9714276,380,370,9713896,9714276
1264,6,6,1,2412,-53,-92,39,e6:aa:ea:c9:ea:33,9715141,408,457,9714733,9715141
1265,6,12,1,2412,-89,-92,3,40:e3:d6:da:ca:c2,9727654,176,12337,9727478,9727654
1266,6,12,1,2412,-89,-92,3,40:e3:d6:da:ca:c4,9728105,172,279,9727933,9728105
1267,4,5.5,1,2412,-87,-92,5,08:6a:c5:20:e6:d0,9752467,307,24055,9752160,9752467
1268,4,5.5,1,2412,-79,-92,13,,9752791,213,111,9752578,9752791
1269,6,12,1,2412,-86,-92,6,,9753019,32,196,9752987,9753019
1270,6,6,1,2412,-89,-92,3,40:e3:d6:da:c8:01,9753089,348,-278,9752741,9753089
1271,6,6,1,2412,-86,-92,6,,9753454,44,321,9753410,9753454
1272,6,6,1,2412,-88,-92,4,84:d4:7e:f2:34:21,9753542,348,-260,9753194,9753542
1273,6,6,1,2412,-86,-92,6,,9753906,44,320,9753862,9753906
1274,6,12,1,2412,-86,-92,6,,9754151,32,213,9754119,9754151
1275,6,12,1,2412,-86,-92,6,,9754395,32,212,9754363,9754395
1276,6,12,1,2412,-85,-92,7,,9754880,32,453,9754848,9754880
1277,6,12,1,2412,-90,-92,2,40:e3:d6:da:c8:05,9754953,140,-67,9754813,9754953
1278,6,12,1,2412,-85,-92,7,,9755109,32,124,9755077,9755109
1279,6,12,1,2412,-87,-92,5,,9755341,32,200,9755309,9755341
1280,6,12,1,2412,-89,-92,3,40:e3:d6:da:c8:04,9759244,176,3727,9759068,9759244
1281,6,12,1,2412,-89,-92,3,40:e3:d6:da:c8:05,9759464,160,60,9759304,9759464
1282,6,6,1,2412,-89,-92,3,40:e3:d6:da:c8:06,9759656,380,-188,9759276,9759656
1283,4,1,1,2412,-79,-92,13,b8:3a:5a:88:e6:e0,9798470,2360,36454,9796110,9798470
1284,4,1,1,2412,-78,-92,14,b8:3a:5a:88:e6:e1,9800859,2376,13,9798483,9800859
1285,6,6,1,2412,-87,-92,5,40:e3:d6:da:bb:e1,9811355,368,10128,9810987,9811355
1286,6,6,1,2412,-87,-92,5,40:e3:d6:da:bb:e6,9812597,380,862,9812217,9812597
1287,6,12,1,2412,-44,-92,48,40:e3:d6:da:ba:20,9814458,160,1701,9814298,9814458
1288,6,6,1,2412,-44,-92,48,40:e3:d6:da:ba:21,9814668,368,-158,9814300,9814668
1289,6,12,1,2412,-44,-92,48,40:e3:d6:da:ba:22,9815064,180,216,9814884,9815064
1290,6,12,1,2412,-44,-92,48,40:e3:d6:da:ba:23,9815297,184,49,9815113,9815297
1291,6,12,1,2412,-45,-92,47,40:e3:d6:da:ba:24,9815533,176,60,9815357,9815533
1292,6,12,1,2412,-44,-92,48,40:e3:d6:da:ba:25,9815753,160,60,9815593,9815753
1293,6,6,1,2412,-44,-92,48,40:e3:d6:da:ba:26,9815954,380,-179,9815574,9815954
1294,6,12,1,2412,-84,-92,8,84:d4:7e:f2:42:25,9816555,160,441,9816395,9816555
1295,6,6,1,2412,-85,-92,7,84:d4:7e:f2:42:26,9816756,380,-179,9816376,9816756
1296,6,12,1,2412,-87,-92,5,,9845170,32,28382,9845138,9845170
1297,4,1,1,2412,-67,-92,25,54:e4:3a:ec:fb:64,9873839,2160,26509,9871679,9873839
1298,6,12,1,2412,-87,-92,5,40:e3:d6:da:bb:e3,9914384,180,40365,9914204,9914384
1299,6,6,1,2412,-67,-92,25,e6:aa:ea:b7:4a:dd,9915395,408,603,9914987,9915395
1300,6,12,1,2412,-47,-92,45,40:e3:d6:da:ba:20,9916881,160,1326,9916721,9916881
1301,6,6,1,2412,-47,-92,45,40:e3:d6:da:ba:21,9917082,368,-167,9916714,9917082
1302,6,12,1,2412,-47,-92,45,40:e3:d6:da:ba:22,9917487,180,225,9917307,9917487
1303,6,12,1,2412,-47,-92,45,40:e3:d6:da:ba:23,9917692,184,21,9917508,9917692
1304,6,12,1,2412,-47,-92,45,40:e3:d6:da:ba:24,9917901,176,33,9917725,9917901
1305,6,12,1,2412,-47,-92,45,40:e3:d6:da:ba:25,9918112,160,51,9917952,9918112
1306,6,6,1,2412,-47,-92,45,40:e3:d6:da:ba:26,9918313,380,-179,9917933,9918313
1307,6,6,1,2412,-70,-92,22,e6:aa:ea:b7:4a:dd,9927520,408,8799,9927112,9927520
1308,6,6,1,2412,-87,-92,5,40:e3:d6:da:ca:c1,9932034,368,4146,9931666,9932034
1309,6,12,1,2412,-87,-92,5,40:e3:d6:da:ca:c3,9932641,180,427,9932461,9932641
1310,6,6,1,2412,-69,-92,23,e6:aa:ea:b7:4a:dd,9939631,408,6582,9939223,9939631
1311,6,6,1,2412,-68,-92,24,e6:aa:ea:b7:4a:dd,9951751,408,11712,9951343,9951751
1312,6,6,1,2412,-67,-92,25,e6:aa:ea:b7:4a:dd,9963866,408,11707,9963458,9963866
1313,4,1,1,2412,-66,-92,26,54:e4:3a:ec:fb:64,9976108,2160,10082,9973948,9976108
1314,6,6,1,2412,-55,-92,37,e6:aa:ea:c9:ea:33,9982844,408,6328,9982436,9982844
1315,6,6,1,2412,-56,-92,36,e6:aa:ea:c9:ea:33,9994834,408,11582,9994426,9994834
1316,6,12,1,2412,-87,-92,5,,10018496,32,23630,10018464,10018496
1317,6,6,1,2412,-91,-92,1,e6:aa:ea:c9:ea:1b,10018550,408,-354,10018142,10018550
1318,6,6,1,2412,-56,-92,36,e6:aa:ea:c9:ea:33,10019113,408,155,10018705,10019113
1319,6,12,1,2412,-54,-92,38,40:e3:d6:da:ba:20,10019541,160,268,10019381,10019541
1320,6,6,1,2412,-54,-92,38,40:e3:d6:da:ba:21,10019760,368,-149,10019392,10019760
1321,6,12,1,2412,-53,-92,39,40:e3:d6:da:ba:22,10020173,180,233,10019993,10020173
1322,6,12,1,2412,-53,-92,39,40:e3:d6:da:ba:23,10020388,184,31,10020204,10020388
1323,6,12,1,2412,-53,-92,39,40:e3:d6:da:ba:24,10020597,176,33,10020421,10020597
1324,6,12,1,2412,-53,-92,39,40:e3:d6:da:ba:25,10020808,160,51,10020648,10020808
1325,6,6,1,2412,-53,-92,39,40:e3:d6:da:ba:26,10021009,380,-179,10020629,10021009
1326,6,6,1,2412,-82,-92,10,84:d4:7e:f2:42:26,10021543,380,154,10021163,10021543
1327,6,6,1,2412,-86,-92,6,e6:aa:ea:c9:ea:1b,10030666,408,8715,10030258,10030666
1328,6,6,1,2412,-56,-92,36,e6:aa:ea:c9:ea:33,10031151,408,77,10030743,10031151
1329,6,6,1,2412,-85,-92,7,e6:aa:ea:c9:ea:1b,10042796,408,11237,10042388,10042796
1330,6,6,1,2412,-85,-92,7,e6:aa:ea:c9:ea:1b,10054905,408,11701,10054497,10054905
1331,4,1,1,2412,-82,-92,10,,10056411,304,1202,10056107,10056411
1332,4,1,1,2412,-79,-92,13,b8:3a:5a:88:e6:e0,10056748,2240,-1903,10054508,10056748
1333,4,1,1,2412,-63,-92,29,54:e4:3a:ec:fb:64,10081704,2160,22796,10079544,10081704
1334,4,1,1,2412,-81,-92,11,b8:3a:5a:88:e6:e0,10105681,2360,21617,10103321,10105681
1335,4,1,1,2412,-80,-92,12,b8:3a:5a:88:e6:e1,10108069,2376,12,10105693,10108069
1336,6,12,1,2412,-49,-92,43,40:e3:d6:da:ba:20,10121684,160,13455,10121524,10121684
1337,6,6,1,2412,-49,-92,43,40:e3:d6:da:ba:21,10122747,368,695,10122379,10122747
1338,6,12,1,2412,-49,-92,43,40:e3:d6:da:ba:22,10123134,180,207,10122954,10123134
1339,6,6,1,2412,-49,-92,43,40:e3:d6:da:ba:26,10124023,380,509,10123643,10124023
1340,4,1,1,2412,-81,-92,11,c0:c9:e3:4d:6e:bf,10126103,872,1208,10125231,10126103
1341,4,1,1,2412,-83,-92,9,,10126992,304,585,10126688,10126992
1342,4,1,1,2412,-77,-92,15,c0:c9:e3:4d:6e:bf,10172727,872,44863,10171855,10172727
1343,4,1,1,2412,-83,-92,9,,10173616,304,585,10173312,10173616
1344,4,1,1,2412,-67,-92,25,54:e4:3a:ec:fb:64,10180903,2160,5127,10178743,10180903
1345,4,1,1,2412,-80,-92,12,b8:3a:5a:88:e6:e0,10208056,2360,24793,10205696,10208056
1346,4,1,1,2412,-84,-92,8,b8:3a:5a:88:e6:e1,10210436,2376,4,10208060,10210436
1347,6,12,1,2412,-90,-92,2,40:e3:d6:da:bb:e0,10220750,156,10158,10220594,10220750
1348,6,12,1,2412,-50,-92,42,40:e3:d6:da:ba:20,10225365,160,4455,10225205,10225365
1349,6,12,1,2412,-50,-92,42,40:e3:d6:da:ba:22,10225952,180,407,10225772,10225952
1350,6,12,1,2412,-50,-92,42,40:e3:d6:da:ba:24,10226385,176,257,10226209,10226385
1351,6,12,1,2412,-50,-92,42,40:e3:d6:da:ba:25,10226605,160,60,10226445,10226605
1352,4,1,1,2412,-68,-92,24,54:e4:3a:ec:fb:64,10283283,2160,54518,10281123,10283283
1353,6,6,1,2412,-53,-92,39,e6:aa:ea:c9:ea:33,10298377,408,14686,10297969,10298377
1354,6,6,1,2412,-53,-92,39,e6:aa:ea:c9:ea:33,10322870,408,24085,10322462,10322870
1355,6,12,1,2412,-53,-92,39,40:e3:d6:da:ba:20,10326460,160,3430,10326300,10326460
1356,6,6,1,2412,-53,-92,39,40:e3:d6:da:ba:21,10326652,368,-176,10326284,10326652
1357,6,12,1,2412,-53,-92,39,40:e3:d6:da:ba:22,10327048,180,216,10326868,10327048
1358,6,12,1,2412,-53,-92,39,40:e3:d6:da:ba:23,10327272,184,40,10327088,10327272
1359,6,12,1,2412,-53,-92,39,40:e3:d6:da:ba:24,10327490,176,42,10327314,10327490
1360,6,12,1,2412,-53,-92,39,40:e3:d6:da:ba:25,10327710,160,60,10327550,10327710
1361,6,12,1,2412,-88,-92,4,84:d4:7e:f2:42:25,10328548,160,678,10328388,10328548
1362,6,6,1,2412,-88,-92,4,40:e3:d6:da:ca:c6,10342858,380,13930,10342478,10342858
1363,6,6,1,2412,-71,-92,21,e6:aa:ea:b7:4a:dd,10345147,408,1881,10344739,10345147
1364,6,6,1,2412,-53,-92,39,e6:aa:ea:c9:ea:33,10346844,408,1289,10346436,10346844
1365,6,6,1,2412,-70,-92,22,e6:aa:ea:b7:4a:dd,10357254,408,10002,10356846,10357254
1366,4,1,1,2412,-77,-92,15,b8:3a:5a:88:e6:e0,10412900,2360,53286,10410540,10412900
1367,4,1,1,2412,-77,-92,15,b8:3a:5a:88:e6:e1,10415307,2376,31,10412931,10415307
1368,6,6,1,2412,-89,-92,3,84:d4:7e:f2:34:21,10417583,368,1908,10417215,10417583
1369,6,12,1,2412,-89,-92,3,84:d4:7e:f2:34:22,10417997,180,234,10417817,10417997
1370,6,6,1,2412,-89,-92,3,40:e3:d6:da:bb:e6,10427961,380,9584,10427581,10427961
1371,6,12,1,2412,-50,-92,42,40:e3:d6:da:ba:20,10428865,160,744,10428705,10428865
1372,6,6,1,2412,-50,-92,42,40:e3:d6:da:ba:21,10429066,368,-167,10428698,10429066
1373,6,12,1,2412,-49,-92,43,40:e3:d6:da:ba:22,10429480,180,234,10429300,10429480
1374,6,12,1,2412,-50,-92,42,40:e3:d6:da:ba:23,10429712,184,48,10429528,10429712
1375,6,12,1,2412,-87,-92,5,40:e3:d6:da:ca:c0,10443835,156,13967,10443679,10443835
1376,6,6,1,2412,-87,-92,5,40:e3:d6:da:ca:c6,10445247,380,1032,10444867,10445247
1377,4,1,1,2412,-73,-92,19,a6:e5:7c:28:b1:d3,10474785,992,28546,10473793,10474785
1378,4,1,1,2412,-72,-92,20,54:e4:3a:ec:fb:64,10488111,2160,11166,10485951,10488111
1379,4,1,1,2412,-81,-92,11,b8:3a:5a:88:e6:e0,10516590,2360,26119,10514230,10516590
1380,6,12,1,2412,-88,-92,4,84:d4:7e:f2:34:20,10519323,160,2573,10519163,10519323
1381,6,6,1,2412,-88,-92,4,84:d4:7e:f2:34:21,10519524,368,-167,10519156,10519524
1382,6,12,1,2412,-88,-92,4,84:d4:7e:f2:34:22,10519911,180,207,10519731,10519911
1383,6,12,1,2412,-88,-92,4,84:d4:7e:f2:34:23,10520250,180,159,10520070,10520250
1384,6,12,1,2412,-52,-92,40,40:e3:d6:da:ba:20,10531266,160,10856,10531106,10531266
1385,6,6,1,2412,-51,-92,41,40:e3:d6:da:ba:21,10531485,368,-149,10531117,10531485
1386,6,12,1,2412,-52,-92,40,40:e3:d6:da:ba:22,10531881,180,216,10531701,10531881
1387,6,12,1,2412,-52,-92,40,40:e3:d6:da:ba:23,10532087,184,22,10531903,10532087
1388,6,12,1,2412,-51,-92,41,40:e3:d6:da:ba:24,10532323,176,60,10532147,10532323
1389,4,1,1,2412,-73,-92,19,a4:e5:7c:28:b1:d3,10536234,688,3223,10535546,10536234
1390,4,1,1,2412,-79,-92,13,,10536939,304,401,10536635,10536939
1391,4,1,1,2412,-74,-92,18,a6:e5:7c:28:b1:d3,10576925,992,38994,10575933,10576925
1392,4,1,1,2412,-68,-92,24,54:e4:3a:ec:fb:64,10590491,2160,11406,10588331,10590491
1393,4,1,1,2412,-53,-92,39,c0:c9:e3:4d:6e:bf,10617107,872,25744,10616235,10617107
1394,4,1,1,2412,-74,-92,18,,10617995,304,584,10617691,10617995
1395,4,1,1,2412,-78,-92,14,b8:3a:5a:88:e6:e0,10618527,2360,-1828,10616167,10618527
1396,6,6,1,2412,-59,-92,33,e6:aa:ea:c9:ea:33,10625507,408,6572,10625099,10625507
1397,6,12,1,2412,-53,-92,39,40:e3:d6:da:ba:20,10633674,160,8007,10633514,10633674
1398,6,6,1,2412,-53,-92,39,40:e3:d6:da:ba:21,10633893,368,-149,10633525,10633893
1399,6,12,1,2412,-53,-92,39,40:e3:d6:da:ba:22,10634298,180,225,10634118,10634298
1400,6,12,1,2412,-53,-92,39,40:e3:d6:da:ba:23,10634503,184,21,10634319,10634503
1401,6,12,1,2412,-53,-92,39,40:e3:d6:da:ba:24,10634721,176,42,10634545,10634721
1402,6,12,1,2412,-53,-92,39,40:e3:d6:da:ba:25,10634950,160,69,10634790,10634950
1403,6,6,1,2412,-53,-92,39,40:e3:d6:da:ba:26,10635160,380,-170,10634780,10635160
1404,6,6,1,2412,-88,-92,4,84:d4:7e:f2:42:26,10635995,380,455,10635615,10635995
1405,6,6,1,2412,-58,-92,34,e6:aa:ea:c9:ea:33,10637615,408,1212,10637207,10637615
1406,6,6,1,2412,-57,-92,35,e6:aa:ea:c9:ea:33,10649736,408,11713,10649328,10649736
1407,6,6,1,2412,-56,-92,36,e6:aa:ea:c9:ea:33,10661890,408,11746,10661482,10661890
1408,6,6,1,2412,-85,-92,7,e6:aa:ea:c9:ea:1b,10664211,408,1913,10663803,10664211
1409,6,6,1,2412,-85,-92,7,e6:aa:ea:c9:ea:1b,10676355,408,11736,10675947,10676355
1410,4,1,1,2412,-67,-92,25,54:e4:3a:ec:fb:64,10692847,2160,14332,10690687,10692847
1411,6,12,1,2412,-51,-92,41,40:e3:d6:da:ba:20,10736079,160,43072,10735919,10736079
1412,6,6,1,2412,-51,-92,41,40:e3:d6:da:ba:21,10736289,368,-158,10735921,10736289
1413,6,12,1,2412,-51,-92,41,40:e3:d6:da:ba:22,10736685,180,216,10736505,10736685
1414,6,12,1,2412,-51,-92,41,40:e3:d6:da:ba:23,10736908,184,39,10736724,10736908
1415,6,12,1,2412,-51,-92,41,40:e3:d6:da:ba:24,10737145,176,61,10736969,10737145
1416,6,12,1,2412,-51,-92,41,40:e3:d6:da:ba:25,10737374,160,69,10737214,10737374
1417,6,6,1,2412,-51,-92,41,40:e3:d6:da:ba:26,10737583,380,-171,10737203,10737583
1418,6,6,1,2412,-68,-92,24,e6:aa:ea:b7:4a:dd,10750052,408,12061,10749644,10750052
1419,6,6,1,2412,-66,-92,26,e6:aa:ea:b7:4a:dd,10774247,408,23787,10773839,10774247
1420,4,1,1,2412,-77,-92,15,b8:3a:5a:88:e6:e0,10822458,2360,45851,10820098,10822458
1421,6,12,1,2412,-85,-92,7,84:d4:7e:f2:34:20,10827430,160,4812,10827270,10827430
1422,6,12,1,2412,-88,-92,4,40:e3:d6:da:bb:e2,10835746,176,8140,10835570,10835746
1423,6,12,1,2412,-86,-92,6,40:e3:d6:da:bb:e3,10835974,180,48,10835794,10835974
1424,6,12,1,2412,-86,-92,6,40:e3:d6:da:bb:e4,10836206,172,60,10836034,10836206
1425,6,6,1,2412,-87,-92,5,40:e3:d6:da:bb:e6,10836628,380,42,10836248,10836628
1426,6,12,1,2412,-54,-92,38,40:e3:d6:da:ba:20,10838463,160,1675,10838303,10838463
1427,6,6,1,2412,-54,-92,38,40:e3:d6:da:ba:21,10838655,368,-176,10838287,10838655
1428,6,12,1,2412,-53,-92,39,40:e3:d6:da:ba:22,10839069,180,234,10838889,10839069
1429,6,12,1,2412,-54,-92,38,40:e3:d6:da:ba:23,10839274,184,21,10839090,10839274
1430,6,12,1,2412,-53,-92,39,40:e3:d6:da:ba:24,10839493,176,43,10839317,10839493
1431,6,12,1,2412,-53,-92,39,40:e3:d6:da:ba:25,10839721,160,68,10839561,10839721
1432,6,6,1,2412,-54,-92,38,40:e3:d6:da:ba:26,10839913,380,-188,10839533,10839913
1433,4,1,1,2412,-66,-92,26,a6:e5:7c:28:b1:d3,10884356,992,43451,10883364,10884356
1434,4,1,1,2412,-67,-92,25,54:e4:3a:ec:fb:64,10897692,2160,11176,10895532,10897692
1435,4,1,1,2412,-79,-92,13,b8:3a:5a:88:e6:e0,10924875,2360,24823,10922515,10924875
1436,6,12,1,2412,-51,-92,41,40:e3:d6:da:ba:20,10941246,160,16211,10941086,10941246
1437,6,6,1,2412,-51,-92,41,40:e3:d6:da:ba:21,10941464,368,-150,10941096,10941464
1438,6,12,1,2412,-51,-92,41,40:e3:d6:da:ba:22,10941879,180,235,10941699,10941879
1439,6,12,1,2412,-51,-92,41,40:e3:d6:da:ba:23,10942084,184,21,10941900,10942084
1440,6,12,1,2412,-51,-92,41,40:e3:d6:da:ba:25,10942522,160,278,10942362,10942522
1441,6,6,1,2412,-51,-92,41,40:e3:d6:da:ba:26,10942741,380,-161,10942361,10942741
1442,6,6,1,2412,-53,-92,39,e6:aa:ea:c9:ea:33,10954256,408,11107,10953848,10954256
1443,6,12,1,2412,-87,-92,5,40:e3:d6:da:ca:c2,10956414,176,1982,10956238,10956414
1444,4,1,1,2412,-75,-92,17,a6:e5:7c:28:b1:d3,10966423,944,9065,10965479,10966423
1445,4,1,1,2412,-75,-92,17,a6:e5:7c:28:b1:d3,10968647,944,1280,10967703,10968647
1446,4,1,1,2412,-76,-92,16,a6:e5:7c:28:b1:d3,10969698,944,107,10968754,10969698
1447,4,1,1,2412,-75,-92,17,a6:e5:7c:28:b1:d3,10970758,944,116,10969814,10970758
1448,4,1,1,2412,-74,-92,18,a6:e5:7c:28:b1:d3,10971809,944,107,10970865,10971809
1449,4,1,1,2412,-75,-92,17,a6:e5:7c:28:b1:d3,10972887,944,134,10971943,10972887
1450,4,1,1,2412,-76,-92,16,a6:e5:7c:28:b1:d3,10975227,944,1396,10974283,10975227
1451,4,1,1,2412,-74,-92,18,a6:e5:7c:28:b1:d3,10976323,944,152,10975379,10976323
1452,6,6,1,2412,-51,-92,41,e6:aa:ea:c9:ea:33,10977146,408,415,10976738,10977146
1453,4,1,1,2412,-75,-92,17,a6:e5:7c:28:b1:d3,10986484,992,8346,10985492,10986484
1454,6,6,1,2412,-89,-92,3,40:e3:d6:da:c8:01,10987565,368,713,10987197,10987565
1455,7,13,1,2412,-89,-92,3,74:da:38:6d:07:21,10989344,60,1719,10989284,10989344
1456,4,5.5,1,2412,-86,-92,6,74:da:38:6d:07:21,10990950,236,1370,10990714,10990950
1457,4,1,1,2412,-86,-92,6,74:da:38:6d:07:21,10996554,432,5172,10996122,10996554
1458,4,1,1,2412,-63,-92,29,54:e4:3a:ec:fb:64,11000071,2160,1357,10997911,11000071
1459,4,1,1,2412,-84,-92,8,74:da:38:6d:07:21,11009706,432,9203,11009274,11009706
1460,4,1,1,2412,-84,-92,8,74:da:38:6d:07:21,11011295,432,1157,11010863,11011295
1461,6,12,1,2412,-83,-92,9,84:d4:7e:f2:34:24,11034742,176,23271,11034566,11034742
1462,4,1,1,2412,-84,-92,8,74:da:38:6d:07:21,11037907,432,2733,11037475,11037907
1463,6,6,1,2412,-89,-92,3,40:e3:d6:da:bb:e1,11040209,368,1934,11039841,11040209
1464,6,12,1,2412,-88,-92,4,40:e3:d6:da:bb:e2,11040638,176,253,11040462,11040638
1465,6,12,1,2412,-86,-92,6,40:e3:d6:da:bb:e3,11040849,180,31,11040669,11040849
1466,6,12,1,2412,-87,-92,5,40:e3:d6:da:bb:e4,11041081,172,60,11040909,11041081
1467,4,1,1,2412,-83,-92,9,74:da:38:6d:07:21,11042138,432,625,11041706,11042138
1468,4,1,1,2412,-63,-92,29,74:da:38:6d:07:21,11042961,432,391,11042529,11042961
1469,6,12,1,2412,-54,-92,38,40:e3:d6:da:ba:20,11043646,160,525,11043486,11043646
1470,6,6,1,2412,-54,-92,38,40:e3:d6:da:ba:21,11043847,368,-167,11043479,11043847
1471,6,12,1,2412,-54,-92,38,40:e3:d6:da:ba:24,11044667,176,644,11044491,11044667
1472,6,12,1,2412,-53,-92,39,40:e3:d6:da:ba:25,11044868,160,41,11044708,11044868
1473,6,6,1,2412,-54,-92,38,40:e3:d6:da:ba:26,11045060,380,-188,11044680,11045060
1474,6,6,1,2412,-84,-92,8,84:d4:7e:f2:42:26,11045590,380,150,11045210,11045590
1475,4,1,1,2412,-82,-92,10,74:da:38:6d:07:21,11048529,432,2507,11048097,11048529
1476,4,1,1,2412,-82,-92,10,74:da:38:6d:07:21,11049645,432,684,11049213,11049645
1477,4,1,1,2412,-83,-92,9,74:da:38:6d:07:21,11050522,432,445,11050090,11050522
1478,4,1,1,2412,-84,-92,8,74:da:38:6d:07:21,11054838,432,3884,11054406,11054838
1479,4,1,1,2412,-76,-92,16,74:da:38:6d:07:21,11055949,432,679,11055517,11055949
1480,6,12,1,2412,-87,-92,5,40:e3:d6:da:ca:c0,11058223,156,2118,11058067,11058223
1481,6,12,1,2412,-88,-92,4,40:e3:d6:da:ca:c3,11059156,180,753,11058976,11059156
1482,6,12,1,2412,-88,-92,4,40:e3:d6:da:ca:c4,11059379,172,51,11059207,11059379
1483,6,12,1,2412,-87,-92,5,40:e3:d6:da:ca:c5,11059603,156,68,11059447,11059603
1484,4,1,1,2412,-83,-92,9,74:da:38:6d:07:21,11061509,432,1474,11061077,11061509
1485,4,1,1,2412,-83,-92,9,74:da:38:6d:07:21,11066116,432,4175,11065684,11066116
1486,4,1,1,2412,-82,-92,10,74:da:38:6d:07:21,11069678,432,3130,11069246,11069678
1487,6,6,1,2412,-72,-92,20,e6:aa:ea:b7:4a:dd,11077468,408,7382,11077060,11077468
1488,6,6,1,2412,-72,-92,20,e6:aa:ea:b7:4a:dd,11089576,408,11700,11089168,11089576
1489,6,6,1,2412,-72,-92,20,e6:aa:ea:b7:4a:dd,11101698,408,11714,11101290,11101698
1490,4,1,1,2412,-71,-92,21,54:e4:3a:ec:fb:64,11102497,2160,-1361,11100337,11102497
1491,4,1,1,2412,-78,-92,14,c0:c9:e3:4d:6e:bf,11105491,872,2122,11104619,11105491
1492,4,1,1,2412,-62,-92,30,,11106380,304,585,11106076,11106380
1493,6,6,1,2412,-72,-92,20,e6:aa:ea:b7:4a:dd,11113950,408,7162,11113542,11113950
1494,4,1,1,2412,-75,-92,17,b8:3a:5a:88:e6:e0,11129658,2360,13348,11127298,11129658
1495,4,1,1,2412,-76,-92,16,b8:3a:5a:88:e6:e1,11132046,2376,12,11129670,11132046
1496,6,12,1,2412,-86,-92,6,84:d4:7e:f2:34:22,11135251,180,3025,11135071,11135251
1497,6,12,1,2412,-80,-92,12,84:d4:7e:f2:34:23,11135483,180,52,11135303,11135483
1498,6,12,1,2412,-86,-92,6,84:d4:7e:f2:34:24,11135697,176,38,11135521,11135697
1499,6,12,1,2412,-86,-92,6,84:d4:7e:f2:34:25,11135908,160,51,11135748,11135908
1500,6,6,1,2412,-86,-92,6,84:d4:7e:f2:34:26,11136127,380,-161,11135747,11136127
1501,6,12,1,2412,-51,-92,41,40:e3:d6:da:ba:20,11145674,160,9387,11145514,11145674
1502,6,12,1,2412,-51,-92,41,40:e3:d6:da:ba:23,11146504,184,646,11146320,11146504
1503,6,12,1,2412,-51,-92,41,40:e3:d6:da:ba:24,11146722,176,42,11146546,11146722
1504,6,12,1,2412,-51,-92,41,40:e3:d6:da:ba:25,11146933,160,51,11146773,11146933
1505,4,1,1,2412,-83,-92,9,,11149900,304,2663,11149596,11149900
1506,6,6,1,2412,-86,-92,6,40:e3:d6:da:ca:c1,11160969,368,10701,11160601,11160969
1507,6,12,1,2412,-80,-92,12,40:e3:d6:da:ca:c5,11162649,156,1524,11162493,11162649
1508,4,1,1,2412,-84,-92,8,,11192759,304,29806,11192455,11192759
1509,6,12,1,2412,-87,-92,5,40:e3:d6:da:c8:00,11192932,160,13,11192772,11192932
1510,6,12,1,2412,-88,-92,4,40:e3:d6:da:c8:05,11194172,160,1080,11194012,11194172
1511,6,6,1,2412,-84,-92,8,e6:aa:ea:c9:ea:1b,11198192,408,3612,11197784,11198192
1512,4,1,1,2412,-72,-92,20,54:e4:3a:ec:fb:64,11205008,2160,4656,11202848,11205008
1513,6,6,1,2412,-85,-92,7,e6:aa:ea:c9:ea:1b,11210300,408,4884,11209892,11210300
1514,4,1,1,2412,-77,-92,15,b8:3a:5a:88:e6:e0,11232426,2360,19766,11230066,11232426
1515,4,1,1,2412,-80,-92,12,b8:3a:5a:88:e6:e1,11234824,2376,22,11232448,11234824
1516,6,12,1,2412,-86,-92,6,84:d4:7e:f2:34:20,11237415,160,2431,11237255,11237415
1517,6,6,1,2412,-86,-92,6,84:d4:7e:f2:34:21,11237651,368,-132,11237283,11237651
1518,6,12,1,2412,-85,-92,7,84:d4:7e:f2:34:22,11238037,180,206,11237857,11238037
1519,6,12,1,2412,-86,-92,6,84:d4:7e:f2:34:24,11238458,176,245,11238282,11238458
1520,6,12,1,2412,-85,-92,7,84:d4:7e:f2:34:25,11238668,160,50,11238508,11238668
1521,6,6,1,2412,-85,-92,7,84:d4:7e:f2:34:26,11238887,380,-161,11238507,11238887
1522,6,12,1,2412,-53,-92,39,40:e3:d6:da:ba:20,11248087,160,9040,11247927,11248087
1523,6,6,1,2412,-53,-92,39,40:e3:d6:da:ba:21,11248279,368,-176,11247911,11248279
1524,6,12,1,2412,-53,-92,39,40:e3:d6:da:ba:22,11248666,180,207,11248486,11248666
1525,6,12,1,2412,-53,-92,39,40:e3:d6:da:ba:23,11248880,184,30,11248696,11248880
1526,6,12,1,2412,-53,-92,39,40:e3:d6:da:ba:25,11249318,160,278,11249158,11249318
1527,6,6,1,2412,-53,-92,39,40:e3:d6:da:ba:26,11249537,380,-161,11249157,11249537
1528,6,12,1,2412,-86,-92,6,84:d4:7e:f2:42:24,11249943,176,230,11249767,11249943
1529,6,12,1,2412,-86,-92,6,84:d4:7e:f2:42:25,11250162,160,59,11250002,11250162
1530,6,6,1,2412,-86,-92,6,84:d4:7e:f2:42:26,11250354,380,-188,11249974,11250354
1531,6,12,1,2412,-85,-92,7,40:e3:d6:da:ca:c5,11264316,156,13806,11264160,11264316
1532,6,12,1,2412,-85,-92,7,40:e3:d6:da:c8:04,11295241,176,30749,11295065,11295241
1533,4,1,1,2412,-67,-92,25,54:e4:3a:ec:fb:64,11307394,2160,9993,11305234,11307394
1534,6,6,1,2412,-49,-92,43,e6:aa:ea:c9:ea:33,11346659,408,38857,11346251,11346659
1535,6,6,1,2412,-87,-92,5,40:e3:d6:da:bb:e1,11347383,368,356,11347015,11347383
1536,6,12,1,2412,-88,-92,4,40:e3:d6:da:bb:e3,11348008,180,445,11347828,11348008
1537,6,12,1,2412,-88,-92,4,40:e3:d6:da:bb:e4,11348240,172,60,11348068,11348240
1538,6,6,1,2412,-54,-92,38,40:e3:d6:da:ba:21,11350690,368,2082,11350322,11350690
1539,6,12,1,2412,-55,-92,37,40:e3:d6:da:ba:23,11351319,184,445,11351135,11351319
1540,6,12,1,2412,-54,-92,38,40:e3:d6:da:ba:24,11351555,176,60,11351379,11351555
1541,6,6,1,2412,-50,-92,42,e6:aa:ea:c9:ea:33,11358767,408,6804,11358359,11358767
1542,6,12,1,2412,-86,-92,6,40:e3:d6:da:ca:c0,11365435,156,6512,11365279,11365435
1543,6,6,1,2412,-84,-92,8,40:e3:d6:da:ca:c1,11365633,368,-170,11365265,11365633
1544,6,12,1,2412,-85,-92,7,40:e3:d6:da:ca:c2,11366028,176,219,11365852,11366028
1545,6,6,1,2412,-55,-92,37,e6:aa:ea:c9:ea:33,11370886,408,4450,11370478,11370886
1546,4,1,1,2412,-65,-92,27,54:e4:3a:ec:fb:64,11409635,2160,36589,11407475,11409635
1547,4,1,1,2412,-77,-92,15,b8:3a:5a:88:e6:e1,11439252,2376,27241,11436876,11439252
1548,6,12,1,2412,-52,-92,40,40:e3:d6:da:ba:20,11452884,160,13472,11452724,11452884
1549,6,6,1,2412,-52,-92,40,40:e3:d6:da:ba:21,11453076,368,-176,11452708,11453076
1550,6,12,1,2412,-52,-92,40,40:e3:d6:da:ba:22,11453463,180,207,11453283,11453463
1551,6,12,1,2412,-52,-92,40,40:e3:d6:da:ba:23,11453668,184,21,11453484,11453668
1552,6,12,1,2412,-52,-92,40,40:e3:d6:da:ba:24,11453896,176,52,11453720,11453896
1553,6,12,1,2412,-52,-92,40,40:e3:d6:da:ba:25,11454124,160,68,11453964,11454124
1554,6,6,1,2412,-52,-92,40,40:e3:d6:da:ba:26,11454343,380,-161,11453963,11454343
1555,6,12,1,2412,-83,-92,9,84:d4:7e:f2:42:24,11454747,176,228,11454571,11454747
1556,6,6,1,2412,-83,-92,9,84:d4:7e:f2:42:26,11455185,380,58,11454805,11455185
1557,6,12,1,2412,-86,-92,6,40:e3:d6:da:ca:c0,11467831,156,12490,11467675,11467831
1558,6,6,1,2412,-83,-92,9,40:e3:d6:da:ca:c1,11468019,368,-180,11467651,11468019
1559,6,12,1,2412,-85,-92,7,40:e3:d6:da:ca:c4,11468831,172,640,11468659,11468831
1560,6,12,1,2412,-84,-92,8,40:e3:d6:da:ca:c5,11469037,156,50,11468881,11469037
1561,6,6,1,2412,-83,-92,9,40:e3:d6:da:ca:c6,11469234,380,-183,11468854,11469234
1562,6,12,1,2412,-85,-92,7,40:e3:d6:da:c8:00,11498987,160,29593,11498827,11498987
1563,6,12,1,2412,-88,-92,4,40:e3:d6:da:c8:05,11500226,160,1079,11500066,11500226
1564,6,6,1,2412,-87,-92,5,40:e3:d6:da:c8:06,11500418,380,-188,11500038,11500418
1565,4,1,1,2412,-66,-92,26,54:e4:3a:ec:fb:64,11512089,2160,9511,11509929,11512089
1566,4,1,1,2412,-80,-92,12,b8:3a:5a:88:e6:e0,11539259,2360,24810,11536899,11539259
1567,6,12,1,2412,-86,-92,6,84:d4:7e:f2:34:22,11543937,180,4498,11543757,11543937
1568,6,12,1,2412,-87,-92,5,84:d4:7e:f2:34:24,11544418,176,305,11544242,11544418
1569,6,12,1,2412,-87,-92,5,84:d4:7e:f2:34:25,11544628,160,50,11544468,11544628
1570,6,6,1,2412,-86,-92,6,84:d4:7e:f2:34:26,11544848,380,-160,11544468,11544848
1571,6,12,1,2412,-85,-92,7,40:e3:d6:da:bb:e0,11551976,156,6972,11551820,11551976
1572,6,6,1,2412,-85,-92,7,40:e3:d6:da:bb:e1,11552190,368,-154,11551822,11552190
1573,6,12,1,2412,-86,-92,6,40:e3:d6:da:bb:e2,11552577,176,211,11552401,11552577
1574,6,12,1,2412,-86,-92,6,40:e3:d6:da:bb:e3,11552806,180,49,11552626,11552806
1575,6,12,1,2412,-52,-92,40,40:e3:d6:da:ba:20,11555266,160,2300,11555106,11555266
1576,6,6,1,2412,-52,-92,40,40:e3:d6:da:ba:21,11555476,368,-158,11555108,11555476
1577,6,12,1,2412,-52,-92,40,40:e3:d6:da:ba:22,11555872,180,216,11555692,11555872
1578,6,12,1,2412,-51,-92,41,40:e3:d6:da:ba:23,11556096,184,40,11555912,11556096
1579,6,12,1,2412,-52,-92,40,40:e3:d6:da:ba:24,11556305,176,33,11556129,11556305
1580,6,12,1,2412,-52,-92,40,40:e3:d6:da:ba:25,11556533,160,68,11556373,11556533
1581,6,12,1,2412,-84,-92,8,84:d4:7e:f2:42:24,11557152,176,443,11556976,11557152
1582,6,12,1,2412,-84,-92,8,84:d4:7e:f2:42:25,11557381,160,69,11557221,11557381
1583,6,12,1,2412,-84,-92,8,40:e3:d6:da:ca:c0,11570213,156,12676,11570057,11570213
1584,6,12,1,2412,-84,-92,8,40:e3:d6:da:ca:c2,11570806,176,417,11570630,11570806
1585,6,12,1,2412,-84,-92,8,40:e3:d6:da:ca:c3,11571016,180,30,11570836,11571016
1586,6,12,1,2412,-85,-92,7,40:e3:d6:da:ca:c4,11571241,172,53,11571069,11571241
1587,4,1,1,2412,-75,-92,17,c0:c9:e3:4d:6e:bf,11593540,872,21427,11592668,11593540
1588,4,1,1,2412,-87,-92,5,,11594429,304,585,11594125,11594429
1589,4,1,1,2412,-71,-92,21,54:e4:3a:ec:fb:64,11596330,2112,-211,11594218,11596330
1590,6,12,1,2412,-52,-92,40,40:e3:d6:da:ba:20,11598616,136,2150,11598480,11598616
1591,4,1,1,2412,-71,-92,21,54:e4:3a:ec:fb:64,11599218,2112,-1510,11597106,11599218
1592,6,6,1,2412,-52,-92,40,40:e3:d6:da:ba:21,11601528,348,1962,11601180,11601528
1593,6,12,1,2412,-52,-92,40,40:e3:d6:da:ba:22,11601913,156,229,11601757,11601913
1594,6,12,1,2412,-51,-92,41,40:e3:d6:da:ba:23,11602131,156,62,11601975,11602131
1595,6,12,1,2412,-52,-92,40,40:e3:d6:da:ba:25,11602330,136,63,11602194,11602330
1596,4,1,1,2412,-72,-92,20,54:e4:3a:ec:fb:64,11606113,2112,1671,11604001,11606113
1597,6,6,1,2412,-74,-92,18,e6:aa:ea:b7:4a:dd,11609254,408,2733,11608846,11609254
1598,6,12,1,2412,-87,-92,5,,11612814,32,3528,11612782,11612814
1599,6,12,1,2412,-87,-92,5,,11612965,32,119,11612933,11612965
1600,6,12,1,2412,-87,-92,5,,11613082,32,85,11613050,11613082
1601,6,6,1,2412,-74,-92,18,e6:aa:ea:b7:4a:dd,11621371,408,7881,11620963,11621371
1602,6,12,1,2412,-85,-92,7,,11637635,32,16232,11637603,11637635
1603,4,1,1,2412,-78,-92,14,c0:c9:e3:4d:6e:bf,11638103,872,-404,11637231,11638103
1604,4,1,1,2412,-75,-92,17,,11638991,304,584,11638687,11638991
1605,4,1,1,2412,-57,-92,35,b8:3a:5a:88:e6:e0,11641659,2360,308,11639299,11641659
1606,6,6,1,2412,-86,-92,6,84:d4:7e:f2:34:26,11647288,380,5249,11646908,11647288
1607,6,12,1,2412,-52,-92,40,40:e3:d6:da:ba:20,11657684,160,10236,11657524,11657684
1608,6,12,1,2412,-51,-92,41,40:e3:d6:da:ba:22,11658290,180,426,11658110,11658290
1609,6,12,1,2412,-51,-92,41,40:e3:d6:da:ba:23,11658514,184,40,11658330,11658514
1610,6,12,1,2412,-51,-92,41,40:e3:d6:da:ba:24,11658732,176,42,11658556,11658732
1611,6,12,1,2412,-51,-92,41,40:e3:d6:da:ba:25,11658943,160,51,11658783,11658943
1612,6,6,1,2412,-51,-92,41,40:e3:d6:da:ba:26,11659162,380,-161,11658782,11659162
1613,6,6,1,2412,-52,-92,40,e6:aa:ea:c9:ea:33,11662194,408,2624,11661786,11662194
1614,6,6,1,2412,-85,-92,7,66:d8:ff:ae:5d:41,11668092,64,5834,11668028,11668092
1615,6,6,1,2412,-86,-92,6,,11668174,44,38,11668130,11668174
1616,6,12,1,2412,-86,-92,6,,11668327,36,117,11668291,11668327
1617,6,12,1,2412,-86,-92,6,,11668381,32,22,11668349,11668381
1618,6,12,1,2412,-84,-92,8,,11668691,36,274,11668655,11668691
1619,6,12,1,2412,-85,-92,7,,11668744,32,21,11668712,11668744
1620,6,12,1,2412,-84,-92,8,,11668857,44,69,11668813,11668857
1621,6,6,1,2412,-86,-92,6,40:e3:d6:da:ca:c1,11672839,368,3614,11672471,11672839
1622,6,12,1,2412,-86,-92,6,40:e3:d6:da:ca:c2,11673244,176,229,11673068,11673244
1623,6,12,1,2412,-86,-92,6,40:e3:d6:da:ca:c3,11673463,180,39,11673283,11673463
1624,6,12,1,2412,-86,-92,6,40:e3:d6:da:ca:c4,11673678,172,43,11673506,11673678
1625,6,12,1,2412,-86,-92,6,40:e3:d6:da:ca:c5,11673875,156,41,11673719,11673875
1626,6,6,1,2412,-52,-92,40,e6:aa:ea:c9:ea:33,11674313,408,30,11673905,11674313
1627,6,6,1,2412,-88,-92,4,a8:5b:f7:55:1a:40,11677682,72,3297,11677610,11677682
1628,6,6,1,2412,-87,-92,5,a8:5b:f7:55:1a:40,11678552,72,798,11678480,11678552
1629,6,6,1,2412,-51,-92,41,e6:aa:ea:c9:ea:33,11686430,408,7470,11686022,11686430
1630,6,6,1,2412,-51,-92,41,e6:aa:ea:c9:ea:33,11698537,408,11699,11698129,11698537
1631,6,12,1,2412,-86,-92,6,40:e3:d6:da:c8:00,11703783,160,5086,11703623,11703783
1632,6,6,1,2412,-86,-92,6,40:e3:d6:da:c8:01,11703986,368,-165,11703618,11703986
1633,6,12,1,2412,-85,-92,7,40:e3:d6:da:c8:02,11704381,180,215,11704201,11704381
1634,6,12,1,2412,-86,-92,6,40:e3:d6:da:c8:03,11704614,184,49,11704430,11704614
1635,6,12,1,2412,-86,-92,6,40:e3:d6:da:c8:04,11704823,176,33,11704647,11704823
1636,6,12,1,2412,-85,-92,7,40:e3:d6:da:c8:05,11705024,160,41,11704864,11705024
1637,6,6,1,2412,-51,-92,41,e6:aa:ea:c9:ea:33,11710655,408,5223,11710247,11710655
1638,4,1,1,2412,-67,-92,25,54:e4:3a:ec:fb:64,11716897,2160,4082,11714737,11716897
1639,6,12,1,2412,-86,-92,6,84:d4:7e:f2:34:25,11750254,160,33197,11750094,11750254
1640,6,6,1,2412,-86,-92,6,84:d4:7e:f2:34:26,11750446,380,-188,11750066,11750446
1641,6,12,1,2412,-87,-92,5,40:e3:d6:da:bb:e0,11756783,156,6181,11756627,11756783
1642,6,12,1,2412,-85,-92,7,40:e3:d6:da:bb:e3,11757631,180,668,11757451,11757631
1643,6,12,1,2412,-83,-92,9,40:e3:d6:da:bb:e4,11757854,172,51,11757682,11757854
1644,6,12,1,2412,-82,-92,10,40:e3:d6:da:bb:e5,11758070,156,60,11757914,11758070
1645,6,6,1,2412,-87,-92,5,40:e3:d6:da:bb:e6,11758285,380,-165,11757905,11758285
1646,6,6,1,2412,-52,-92,40,40:e3:d6:da:ba:21,11760287,368,1634,11759919,11760287
1647,6,12,1,2412,-52,-92,40,40:e3:d6:da:ba:22,11760692,180,225,11760512,11760692
1648,6,12,1,2412,-52,-92,40,40:e3:d6:da:ba:23,11760898,184,22,11760714,11760898
1649,6,12,1,2412,-52,-92,40,40:e3:d6:da:ba:24,11761125,176,51,11760949,11761125
1650,6,12,1,2412,-52,-92,40,40:e3:d6:da:ba:25,11761353,160,68,11761193,11761353
1651,6,6,1,2412,-52,-92,40,40:e3:d6:da:ba:26,11761545,380,-188,11761165,11761545
1652,6,12,1,2412,-88,-92,4,84:d4:7e:f2:42:24,11761942,176,221,11761766,11761942
1653,6,12,1,2412,-88,-92,4,84:d4:7e:f2:42:25,11762143,160,41,11761983,11762143
1654,6,6,1,2412,-89,-92,3,84:d4:7e:f2:42:26,11762344,380,-179,11761964,11762344
1655,6,12,1,2412,-85,-92,7,40:e3:d6:da:ca:c4,11776042,172,13526,11775870,11776042
1656,6,12,1,2412,-83,-92,9,40:e3:d6:da:ca:c5,11776266,156,68,11776110,11776266
1657,6,12,1,2412,-80,-92,12,,11776922,32,624,11776890,11776922
1658,6,12,1,2412,-88,-92,4,40:e3:d6:da:c8:00,11806202,160,29120,11806042,11806202
1659,6,6,1,2412,-86,-92,6,40:e3:d6:da:c8:01,11806394,368,-176,11806026,11806394
1660,6,12,1,2412,-86,-92,6,40:e3:d6:da:c8:02,11806808,180,234,11806628,11806808
1661,6,12,1,2412,-86,-92,6,40:e3:d6:da:c8:03,11807013,184,21,11806829,11807013
1662,6,12,1,2412,-88,-92,4,40:e3:d6:da:c8:04,11807249,176,60,11807073,11807249
1663,6,6,1,2412,-87,-92,5,40:e3:d6:da:c8:06,11807661,380,32,11807281,11807661
1664,6,12,1,2412,-87,-92,5,,11817378,32,9685,11817346,11817378
1665,4,1,1,2412,-66,-92,26,54:e4:3a:ec:fb:64,11819312,2160,-226,11817152,11819312
1666,6,12,1,2412,-85,-92,7,,11824038,32,4694,11824006,11824038
1667,6,12,1,2412,-85,-92,7,,11824397,32,327,11824365,11824397
1668,6,12,1,2412,-85,-92,7,,11831442,32,7013,11831410,11831442
1669,4,1,1,2412,-78,-92,14,b8:3a:5a:88:e6:e0,11846459,2360,12657,11844099,11846459
1670,4,1,1,2412,-76,-92,16,b8:3a:5a:88:e6:e1,11848857,2376,22,11846481,11848857
1671,6,12,1,2412,-87,-92,5,84:d4:7e:f2:34:23,11851550,180,2513,11851370,11851550
1672,6,12,1,2412,-87,-92,5,84:d4:7e:f2:34:24,11851782,176,56,11851606,11851782
1673,6,12,1,2412,-85,-92,7,84:d4:7e:f2:34:25,11852010,160,68,11851850,11852010
1674,6,12,1,2412,-86,-92,6,,11854920,32,2878,11854888,11854920
1675,6,12,1,2412,-85,-92,7,84:d4:7e:f2:34:23,11856530,160,1450,11856370,11856530
1676,6,12,1,2412,-85,-92,7,84:d4:7e:f2:34:25,11856750,140,80,11856610,11856750
1677,6,6,1,2412,-53,-92,39,40:e3:d6:da:ba:21,11862688,368,5570,11862320,11862688
1678,6,12,1,2412,-53,-92,39,40:e3:d6:da:ba:24,11863544,176,680,11863368,11863544
1679,6,6,1,2412,-73,-92,19,e6:aa:ea:b7:4a:dd,11899614,408,35662,11899206,11899614
1680,6,24,1,2412,-87,-92,5,,11917241,28,17599,11917213,11917241
1681,6,12,1,2412,-85,-92,7,,11917286,32,13,11917254,11917286
1682,6,12,1,2412,-83,-92,9,,11917401,32,83,11917369,11917401
1683,6,6,1,2412,-73,-92,19,e6:aa:ea:b7:4a:dd,11935959,408,18150,11935551,11935959
1684,4,1,1,2412,-57,-92,35,b8:3a:5a:88:e6:e1,11951248,2376,12913,11948872,11951248
1685,6,12,1,2412,-84,-92,8,40:e3:d6:da:bb:e0,11961564,156,10160,11961408,11961564
1686,6,6,1,2412,-83,-92,9,40:e3:d6:da:bb:e1,11961761,368,-171,11961393,11961761
1687,6,12,1,2412,-84,-92,8,40:e3:d6:da:bb:e2,11962148,176,211,11961972,11962148
1688,6,12,1,2412,-55,-92,37,40:e3:d6:da:ba:20,11964890,160,2582,11964730,11964890
1689,6,6,1,2412,-56,-92,36,40:e3:d6:da:ba:21,11965091,368,-167,11964723,11965091
1690,6,12,1,2412,-55,-92,37,40:e3:d6:da:ba:22,11965505,180,234,11965325,11965505
1691,6,12,1,2412,-55,-92,37,40:e3:d6:da:ba:23,11965711,184,22,11965527,11965711
1692,6,12,1,2412,-55,-92,37,40:e3:d6:da:ba:24,11965947,176,60,11965771,11965947
1693,6,12,1,2412,-55,-92,37,40:e3:d6:da:ba:25,11966157,160,50,11965997,11966157
1694,6,6,1,2412,-55,-92,37,40:e3:d6:da:ba:26,11966376,380,-161,11965996,11966376
1695,6,12,1,2412,-85,-92,7,84:d4:7e:f2:42:24,11966777,176,225,11966601,11966777
1696,6,12,1,2412,-85,-92,7,84:d4:7e:f2:42:25,11966996,160,59,11966836,11966996
1697,6,12,1,2412,-86,-92,6,40:e3:d6:da:ca:c3,11980657,180,13481,11980477,11980657
1698,6,12,1,2412,-83,-92,9,,11999135,32,18446,11999103,11999135
1699,6,12,1,2412,-84,-92,8,,11999459,32,292,11999427,11999459
1700,6,6,1,2412,-85,-92,7,e6:aa:ea:c9:ea:1b,12003665,408,3798,12003257,12003665
1701,6,6,1,2412,-86,-92,6,e6:aa:ea:c9:ea:1b,12015782,408,11709,12015374,12015782
1702,6,6,1,2412,-85,-92,7,e6:aa:ea:c9:ea:1b,12027901,408,11711,12027493,12027901
1703,6,6,1,2412,-84,-92,8,e6:aa:ea:c9:ea:1b,12040031,408,11722,12039623,12040031
1704,6,6,1,2412,-85,-92,7,40:e3:d6:da:bb:e1,12064157,368,23758,12063789,12064157
1705,6,12,1,2412,-84,-92,8,40:e3:d6:da:bb:e2,12064553,176,220,12064377,12064553
1706,6,12,1,2412,-86,-92,6,40:e3:d6:da:bb:e3,12064772,180,39,12064592,12064772
1707,6,12,1,2412,-84,-92,8,40:e3:d6:da:bb:e4,12064987,172,43,12064815,12064987
1708,6,12,1,2412,-85,-92,7,40:e3:d6:da:bb:e5,12065202,156,59,12065046,12065202
1709,6,6,1,2412,-86,-92,6,40:e3:d6:da:bb:e6,12065390,380,-192,12065010,12065390
1710,6,12,1,2412,-55,-92,37,40:e3:d6:da:ba:20,12067268,160,1718,12067108,12067268
1711,6,6,1,2412,-55,-92,37,40:e3:d6:da:ba:21,12067460,368,-176,12067092,12067460
1712,6,12,1,2412,-55,-92,37,40:e3:d6:da:ba:22,12067856,180,216,12067676,12067856
1713,6,12,1,2412,-55,-92,37,40:e3:d6:da:ba:23,12068089,184,49,12067905,12068089
1714,6,12,1,2412,-55,-92,37,40:e3:d6:da:ba:24,12068325,176,60,12068149,12068325
1715,6,12,1,2412,-55,-92,37,40:e3:d6:da:ba:25,12068544,160,59,12068384,12068544
1716,6,6,1,2412,-55,-92,37,40:e3:d6:da:ba:26,12068736,380,-188,12068356,12068736
1717,6,6,1,2412,-53,-92,39,e6:aa:ea:c9:ea:33,12079511,408,10367,12079103,12079511
1718,4,1,1,2412,-80,-92,12,c0:c9:e3:4d:6e:bf,12089476,872,9093,12088604,12089476
1719,4,1,1,2412,-68,-92,24,,12090366,304,586,12090062,12090366
1720,6,6,1,2412,-54,-92,38,e6:aa:ea:c9:ea:33,12091631,408,857,12091223,12091631
1721,6,6,1,2412,-54,-92,38,e6:aa:ea:c9:ea:33,12103753,408,11714,12103345,12103753
1722,6,12,1,2412,-87,-92,5,40:e3:d6:da:c8:00,12113380,160,9467,12113220,12113380
1723,6,6,1,2412,-84,-92,8,40:e3:d6:da:c8:01,12113598,368,-150,12113230,12113598
1724,6,6,1,2412,-55,-92,37,e6:aa:ea:c9:ea:33,12118219,408,4213,12117811,12118219
1725,4,1,1,2412,-88,-92,4,a0:59:50:b4:3a:a2,12124338,1176,4943,12123162,12124338
1726,6,12,1,2412,-86,-92,6,,12130162,32,5792,12130130,12130162
1727,4,1,1,2412,-71,-92,21,,12135462,304,4996,12135158,12135462
1728,4,1,1,2412,-77,-92,15,b8:3a:5a:88:e6:e0,12153755,2360,15933,12151395,12153755
1729,4,1,1,2412,-72,-92,20,b8:3a:5a:88:e6:e1,12156199,2376,68,12153823,12156199
1730,6,12,1,2412,-85,-92,7,84:d4:7e:f2:34:20,12158750,160,2391,12158590,12158750
1731,6,6,1,2412,-84,-92,8,84:d4:7e:f2:34:21,12158959,368,-159,12158591,12158959
1732,6,12,1,2412,-84,-92,8,84:d4:7e:f2:34:23,12159579,180,440,12159399,12159579
1733,6,12,1,2412,-84,-92,8,84:d4:7e:f2:34:24,12159811,176,56,12159635,12159811
1734,6,12,1,2412,-84,-92,8,84:d4:7e:f2:34:25,12160058,160,87,12159898,12160058
1735,6,6,1,2412,-87,-92,5,40:e3:d6:da:bb:e1,12166572,368,6146,12166204,12166572
1736,6,12,1,2412,-87,-92,5,40:e3:d6:da:bb:e2,12166986,176,238,12166810,12166986
1737,6,12,1,2412,-88,-92,4,40:e3:d6:da:bb:e3,12167220,180,54,12167040,12167220
1738,6,12,1,2412,-85,-92,7,40:e3:d6:da:bb:e4,12167568,172,176,12167396,12167568
1739,6,12,1,2412,-86,-92,6,40:e3:d6:da:bb:e5,12167774,156,50,12167618,12167774
1740,6,6,1,2412,-86,-92,6,40:e3:d6:da:bb:e6,12167962,380,-192,12167582,12167962
1741,6,12,1,2412,-86,-92,6,,12168455,32,461,12168423,12168455
1742,6,12,1,2412,-52,-92,40,40:e3:d6:da:ba:20,12169694,160,1079,12169534,12169694
1743,6,6,1,2412,-52,-92,40,40:e3:d6:da:ba:21,12169913,368,-149,12169545,12169913
1744,6,12,1,2412,-51,-92,41,40:e3:d6:da:ba:22,12170300,180,207,12170120,12170300
1745,6,12,1,2412,-51,-92,41,40:e3:d6:da:ba:23,12170505,184,21,12170321,12170505
1746,6,12,1,2412,-51,-92,41,40:e3:d6:da:ba:24,12170742,176,61,12170566,12170742
1747,6,12,1,2412,-51,-92,41,40:e3:d6:da:ba:25,12170961,160,59,12170801,12170961
1748,6,6,1,2412,-51,-92,41,40:e3:d6:da:ba:26,12171171,380,-170,12170791,12171171
1749,6,12,1,2412,-85,-92,7,84:d4:7e:f2:42:24,12171557,176,210,12171381,12171557
1750,6,12,1,2412,-84,-92,8,84:d4:7e:f2:42:25,12171785,160,68,12171625,12171785
1751,6,6,1,2412,-86,-92,6,84:d4:7e:f2:42:26,12172004,380,-161,12171624,12172004
1752,6,6,1,2412,-84,-92,8,40:e3:d6:da:ca:c1,12184816,368,12444,12184448,12184816
1753,6,12,1,2412,-87,-92,5,40:e3:d6:da:ca:c4,12185637,172,649,12185465,12185637
1754,6,12,1,2412,-84,-92,8,40:e3:d6:da:ca:c5,12185861,156,68,12185705,12185861
1755,6,6,1,2412,-86,-92,6,40:e3:d6:da:ca:c6,12186059,380,-182,12185679,12186059
1756,6,6,1,2412,-80,-92,12,,12187167,44,1064,12187123,12187167
1757,6,12,1,2412,-84,-92,8,84:d4:7e:f2:34:20,12187300,140,-7,12187160,12187300
1758,6,12,1,2412,-82,-92,10,,12187456,32,124,12187424,12187456
1759,6,6,1,2412,-82,-92,10,84:d4:7e:f2:34:21,12187530,348,-274,12187182,12187530
1760,6,6,1,2412,-83,-92,9,,12187893,44,319,12187849,12187893
1761,6,12,1,2412,-81,-92,11,,12188169,32,244,12188137,12188169
1762,6,12,1,2412,-82,-92,10,,12188548,32,347,12188516,12188548
1763,6,12,1,2412,-85,-92,7,84:d4:7e:f2:34:25,12188625,140,-63,12188485,12188625
1764,6,12,1,2412,-83,-92,9,,12188780,32,123,12188748,12188780
1765,6,12,1,2412,-85,-92,7,,12189099,32,287,12189067,12189099
1766,6,12,1,2412,-82,-92,10,,12189368,32,237,12189336,12189368
1767,6,6,1,2412,-88,-92,4,40:e3:d6:da:c8:01,12215972,368,26236,12215604,12215972
1768,6,12,1,2412,-87,-92,5,40:e3:d6:da:c8:05,12217011,160,879,12216851,12217011
1769,4,1,1,2412,-67,-92,25,54:e4:3a:ec:fb:64,12229042,2160,9871,12226882,12229042
1770,6,12,1,2412,-84,-92,8,84:d4:7e:f2:34:20,12260148,160,30946,12259988,12260148
1771,6,6,1,2412,-84,-92,8,84:d4:7e:f2:34:21,12260349,368,-167,12259981,12260349
1772,6,12,1,2412,-85,-92,7,84:d4:7e:f2:34:22,12260753,180,224,12260573,12260753
1773,6,12,1,2412,-84,-92,8,84:d4:7e:f2:34:23,12260977,180,44,12260797,12260977
1774,6,12,1,2412,-86,-92,6,84:d4:7e:f2:34:24,12261183,176,30,12261007,12261183
1775,6,12,1,2412,-85,-92,7,84:d4:7e:f2:34:25,12261420,160,77,12261260,12261420
1776,6,12,1,2412,-86,-92,6,,12263481,32,2029,12263449,12263481
1777,6,12,1,2412,-85,-92,7,40:e3:d6:da:bb:e0,12268768,156,5131,12268612,12268768
1778,6,6,1,2412,-87,-92,5,40:e3:d6:da:bb:e1,12268956,368,-180,12268588,12268956
1779,6,12,1,2412,-87,-92,5,40:e3:d6:da:bb:e2,12269343,176,211,12269167,12269343
1780,6,12,1,2412,-54,-92,38,40:e3:d6:da:ba:20,12272069,160,2566,12271909,12272069
1781,6,6,1,2412,-54,-92,38,40:e3:d6:da:ba:21,12272288,368,-149,12271920,12272288
1782,6,12,1,2412,-54,-92,38,40:e3:d6:da:ba:22,12272692,180,224,12272512,12272692
1783,6,12,1,2412,-54,-92,38,40:e3:d6:da:ba:23,12272898,184,22,12272714,12272898
1784,6,12,1,2412,-54,-92,38,40:e3:d6:da:ba:24,12273107,176,33,12272931,12273107
1785,6,12,1,2412,-54,-92,38,40:e3:d6:da:ba:25,12273309,160,42,12273149,12273309
1786,6,6,1,2412,-54,-92,38,40:e3:d6:da:ba:26,12273528,380,-161,12273148,12273528
1787,6,6,1,2412,-88,-92,4,40:e3:d6:da:ca:c1,12287225,368,13329,12286857,12287225
1788,6,12,1,2412,-86,-92,6,,12290148,32,2891,12290116,12290148
1789,6,6,1,2412,-74,-92,18,e6:aa:ea:b7:4a:dd,12316687,408,26131,12316279,12316687
1790,6,6,1,2412,-75,-92,17,e6:aa:ea:b7:4a:dd,12328773,408,11678,12328365,12328773
1791,4,1,1,2412,-70,-92,22,54:e4:3a:ec:fb:64,12331291,2160,358,12329131,12331291
1792,6,6,1,2412,-75,-92,17,e6:aa:ea:b7:4a:dd,12340878,408,9179,12340470,12340878
1793,4,1,1,2412,-75,-92,17,b8:3a:5a:88:e6:e1,12360854,2376,17600,12358478,12360854
1794,6,6,1,2412,-75,-92,17,e6:aa:ea:b7:4a:dd,12365106,408,3844,12364698,12365106
1795,6,12,1,2412,-55,-92,37,40:e3:d6:da:ba:20,12374480,160,9214,12374320,12374480
1796,6,6,1,2412,-55,-92,37,40:e3:d6:da:ba:21,12374689,368,-159,12374321,12374689
1797,6,12,1,2412,-55,-92,37,40:e3:d6:da:ba:23,12375282,184,409,12375098,12375282
1798,6,12,1,2412,-55,-92,37,40:e3:d6:da:ba:24,12375500,176,42,12375324,12375500
1799,6,6,1,2412,-55,-92,37,40:e3:d6:da:ba:26,12375921,380,41,12375541,12375921
1800,6,6,1,2412,-88,-92,4,40:e3:d6:da:ca:c6,12390815,380,14514,12390435,12390815
1801,6,6,1,2412,-53,-92,39,e6:aa:ea:c9:ea:33,12394746,408,3523,12394338,12394746
1802,6,12,1,2412,-86,-92,6,,12401310,32,6532,12401278,12401310
1803,6,6,1,2412,-54,-92,38,e6:aa:ea:c9:ea:33,12406697,408,4979,12406289,12406697
1804,6,6,1,2412,-53,-92,39,e6:aa:ea:c9:ea:33,12430930,408,23825,12430522,12430930
1805,4,1,1,2412,-66,-92,26,54:e4:3a:ec:fb:64,12433755,2160,665,12431595,12433755
1806,6,6,1,2412,-52,-92,40,e6:aa:ea:c9:ea:33,12443050,408,8887,12442642,12443050
1807,4,1,1,2412,-70,-92,22,b8:3a:5a:88:e6:e0,12460863,2360,15453,12458503,12460863
1808,4,1,1,2412,-74,-92,18,b8:3a:5a:88:e6:e1,12463243,2376,4,12460867,12463243
1809,6,12,1,2412,-87,-92,5,,12469301,32,6026,12469269,12469301
1810,6,12,1,2412,-86,-92,6,40:e3:d6:da:bb:e2,12474162,176,4685,12473986,12474162
1811,6,12,1,2412,-87,-92,5,40:e3:d6:da:bb:e4,12474606,172,272,12474434,12474606
1812,6,12,1,2412,-86,-92,6,40:e3:d6:da:bb:e5,12474803,156,41,12474647,12474803
1813,6,12,1,2412,-54,-92,38,40:e3:d6:da:ba:22,12477503,180,2520,12477323,12477503
1814,6,12,1,2412,-53,-92,39,40:e3:d6:da:ba:24,12477944,176,265,12477768,12477944
1815,6,12,1,2412,-54,-92,38,40:e3:d6:da:ba:25,12478173,160,69,12478013,12478173
1816,6,6,1,2412,-54,-92,38,40:e3:d6:da:ba:26,12478392,380,-161,12478012,12478392
1817,6,12,1,2412,-84,-92,8,84:d4:7e:f2:42:25,12478945,160,393,12478785,12478945
1818,6,6,1,2412,-83,-92,9,84:d4:7e:f2:42:26,12479163,380,-162,12478783,12479163
1819,6,6,1,2412,-83,-92,9,a8:5b:f7:55:1a:40,12498606,72,19371,12498534,12498606
1820,6,6,1,2412,-89,-92,3,a8:5b:f7:55:1a:40,12498714,72,36,12498642,12498714
1821,6,6,1,2412,-88,-92,4,a8:5b:f7:55:1a:40,12498893,72,107,12498821,12498893
1822,6,6,1,2412,-81,-92,11,a8:5b:f7:55:1a:40,12500579,72,1614,12500507,12500579
1823,6,12,1,2412,-87,-92,5,,12517051,32,16440,12517019,12517051
1824,6,12,1,2412,-88,-92,4,,12539362,32,22279,12539330,12539362
1825,6,12,1,2412,-87,-92,5,40:e3:d6:da:bb:e0,12575980,156,36462,12575824,12575980
1826,6,6,1,2412,-88,-92,4,40:e3:d6:da:bb:e1,12576186,368,-162,12575818,12576186
1827,4,1,1,2412,-78,-92,14,c0:c9:e3:4d:6e:bf,12576728,872,-330,12575856,12576728
1828,4,1,1,2412,-82,-92,10,,12577617,304,585,12577313,12577617
1829,6,12,1,2412,-87,-92,5,40:e3:d6:da:bb:e3,12577870,180,73,12577690,12577870
1830,6,6,1,2412,-87,-92,5,40:e3:d6:da:bb:e6,12578514,380,264,12578134,12578514
1831,6,6,1,2412,-54,-92,38,40:e3:d6:da:ba:21,12579491,368,609,12579123,12579491
1832,6,12,1,2412,-54,-92,38,40:e3:d6:da:ba:23,12580129,184,454,12579945,12580129
1833,6,12,1,2412,-54,-92,38,40:e3:d6:da:ba:24,12580356,176,51,12580180,12580356
1834,6,12,1,2412,-54,-92,38,40:e3:d6:da:ba:25,12580575,160,59,12580415,12580575
1835,6,6,1,2412,-54,-92,38,40:e3:d6:da:ba:26,12580794,380,-161,12580414,12580794
1836,6,12,1,2412,-83,-92,9,84:d4:7e:f2:42:25,12581393,160,439,12581233,12581393
1837,6,6,1,2412,-84,-92,8,84:d4:7e:f2:42:26,12581585,380,-188,12581205,12581585
1838,6,12,1,2412,-85,-92,7,40:e3:d6:da:ca:c0,12594215,156,12474,12594059,12594215
1839,6,12,1,2412,-85,-92,7,40:e3:d6:da:ca:c2,12594817,176,426,12594641,12594817
1840,6,12,1,2412,-85,-92,7,40:e3:d6:da:ca:c3,12595018,180,21,12594838,12595018
1841,6,12,1,2412,-85,-92,7,40:e3:d6:da:ca:c4,12595224,172,34,12595052,12595224
1842,6,6,1,2412,-84,-92,8,40:e3:d6:da:ca:c6,12595618,380,14,12595238,12595618
1843,4,1,1,2412,-75,-92,17,c0:c9:e3:4d:6e:bf,12620717,872,24227,12619845,12620717
1844,6,12,1,2412,-87,-92,5,40:e3:d6:da:c8:02,12625983,180,5086,12625803,12625983
1845,6,12,1,2412,-86,-92,6,40:e3:d6:da:c8:03,12626206,184,39,12626022,12626206
1846,6,12,1,2412,-87,-92,5,40:e3:d6:da:c8:04,12626433,176,51,12626257,12626433
1847,6,12,1,2412,-86,-92,6,40:e3:d6:da:c8:05,12626634,160,41,12626474,12626634
1848,6,6,1,2412,-86,-92,6,40:e3:d6:da:c8:06,12626826,380,-188,12626446,12626826
1849,6,6,1,2412,-74,-92,18,e6:aa:ea:b7:4a:dd,12632194,408,4960,12631786,12632194
1850,4,1,1,2412,-67,-92,25,54:e4:3a:ec:fb:64,12638553,2160,4199,12636393,12638553
1851,6,6,1,2412,-74,-92,18,e6:aa:ea:b7:4a:dd,12644328,408,5367,12643920,12644328
1852,6,6,1,2412,-75,-92,17,e6:aa:ea:b7:4a:dd,12656444,408,11708,12656036,12656444
1853,6,12,1,2412,-87,-92,5,,12660687,32,4211,12660655,12660687
1854,6,12,1,2412,-88,-92,4,40:e3:d6:da:bb:e0,12678360,156,17517,12678204,12678360
1855,6,12,1,2412,-87,-92,5,40:e3:d6:da:bb:e2,12678961,176,425,12678785,12678961
1856,6,12,1,2412,-88,-92,4,40:e3:d6:da:bb:e3,12679172,180,31,12678992,12679172
1857,6,12,1,2412,-87,-92,5,40:e3:d6:da:bb:e4,12679395,172,51,12679223,12679395
1858,6,6,1,2412,-81,-92,11,40:e3:d6:da:bb:e6,12679827,380,52,12679447,12679827
1859,6,6,1,2412,-74,-92,18,e6:aa:ea:b7:4a:dd,12680678,408,443,12680270,12680678
1860,6,12,1,2412,-55,-92,37,40:e3:d6:da:ba:20,12681693,160,855,12681533,12681693
1861,6,6,1,2412,-55,-92,37,40:e3:d6:da:ba:21,12681903,368,-158,12681535,12681903
1862,6,12,1,2412,-55,-92,37,40:e3:d6:da:ba:22,12682290,180,207,12682110,12682290
1863,6,12,1,2412,-55,-92,37,40:e3:d6:da:ba:23,12682513,184,39,12682329,12682513
1864,6,12,1,2412,-54,-92,38,40:e3:d6:da:ba:24,12682723,176,34,12682547,12682723
1865,6,12,1,2412,-55,-92,37,40:e3:d6:da:ba:25,12682924,160,41,12682764,12682924
1866,6,6,1,2412,-54,-92,38,40:e3:d6:da:ba:26,12683116,380,-188,12682736,12683116
1867,6,12,1,2412,-86,-92,6,84:d4:7e:f2:42:25,12683774,160,498,12683614,12683774
1868,6,12,1,2412,-85,-92,7,40:e3:d6:da:ca:c2,12697252,176,13302,12697076,12697252
1869,6,12,1,2412,-84,-92,8,40:e3:d6:da:ca:c4,12697686,172,262,12697514,12697686
1870,6,12,1,2412,-85,-92,7,40:e3:d6:da:ca:c5,12697911,156,69,12697755,12697911
1871,6,6,1,2412,-85,-92,7,40:e3:d6:da:ca:c6,12698108,380,-183,12697728,12698108
1872,6,12,1,2412,-87,-92,5,,12699378,32,1238,12699346,12699378
1873,6,12,1,2412,-87,-92,5,,12719208,32,19798,12719176,12719208
1874,6,12,1,2412,-87,-92,5,,12719576,32,336,12719544,12719576
1875,6,12,1,2412,-86,-92,6,40:e3:d6:da:c8:00,12727861,160,8125,12727701,12727861
1876,4,1,1,2412,-72,-92,20,a6:e5:7c:28:b1:d3,12728231,992,-622,12727239,12728231
1877,6,12,1,2412,-87,-92,5,40:e3:d6:da:c8:02,12729495,180,1084,12729315,12729495
1878,6,12,1,2412,-86,-92,6,40:e3:d6:da:c8:04,12730042,176,371,12729866,12730042
1879,4,1,1,2412,-70,-92,22,54:e4:3a:ec:fb:64,12740931,2160,8729,12738771,12740931
1880,4,1,1,2412,-81,-92,11,b8:3a:5a:88:e6:e0,12768061,2360,24770,12765701,12768061
1881,4,1,1,2412,-79,-92,13,b8:3a:5a:88:e6:e1,12770449,2376,12,12768073,12770449
1882,6,6,1,2412,-87,-92,5,40:e3:d6:da:bb:e1,12780997,368,10180,12780629,12780997
1883,6,12,1,2412,-87,-92,5,40:e3:d6:da:bb:e2,12781384,176,211,12781208,12781384
1884,6,12,1,2412,-88,-92,4,40:e3:d6:da:bb:e5,12782033,156,493,12781877,12782033
1885,6,6,1,2412,-86,-92,6,40:e3:d6:da:bb:e6,12782248,380,-165,12781868,12782248
1886,6,12,1,2412,-55,-92,37,40:e3:d6:da:ba:20,12784089,160,1681,12783929,12784089
1887,6,6,1,2412,-55,-92,37,40:e3:d6:da:ba:21,12784308,368,-149,12783940,12784308
1888,6,12,1,2412,-55,-92,37,40:e3:d6:da:ba:22,12784704,180,216,12784524,12784704
1889,6,12,1,2412,-55,-92,37,40:e3:d6:da:ba:23,12784936,184,48,12784752,12784936
1890,6,12,1,2412,-55,-92,37,40:e3:d6:da:ba:24,12785164,176,52,12784988,12785164
1891,6,12,1,2412,-55,-92,37,40:e3:d6:da:ba:25,12785365,160,41,12785205,12785365
1892,6,6,1,2412,-84,-92,8,40:e3:d6:da:ca:c6,12800448,380,14703,12800068,12800448
1893,4,1,1,2412,-84,-92,8,,12809670,304,8918,12809366,12809670
1894,6,12,1,2412,-79,-92,13,40:e3:d6:da:ca:c5,12816889,136,7083,12816753,12816889
1895,6,6,1,2412,-49,-92,43,e6:aa:ea:c9:ea:33,12824837,408,7540,12824429,12824837
1896,4,1,1,2412,-73,-92,19,a4:e5:7c:28:b1:d3,12828574,688,3049,12827886,12828574
1897,4,1,1,2412,-84,-92,8,,12829280,304,402,12828976,12829280
1898,4,1,1,2412,-71,-92,21,a6:e5:7c:28:b1:d3,12830408,992,136,12829416,12830408
1899,6,6,1,2412,-49,-92,43,e6:aa:ea:c9:ea:33,12837067,408,6251,12836659,12837067
1900,4,1,1,2412,-84,-92,8,,12840095,304,2724,12839791,12840095
1901,6,12,1,2412,-87,-92,5,,12841740,32,1613,12841708,12841740
1902,6,12,1,2412,-85,-92,7,,12842646,44,862,12842602,12842646
1903,6,6,1,2412,-49,-92,43,e6:aa:ea:c9:ea:33,12849064,408,6010,12848656,12849064
1904,6,12,1,2412,-86,-92,6,,12860705,36,11605,12860669,12860705
1905,6,12,1,2412,-87,-92,5,,12860820,36,79,12860784,12860820
1906,6,6,1,2412,-85,-92,7,84:d4:7e:f2:34:21,12875770,368,14582,12875402,12875770
1907,6,6,1,2412,-88,-92,4,84:d4:7e:f2:34:26,12877012,380,862,12876632,12877012
1908,6,12,1,2412,-86,-92,6,,12877850,32,806,12877818,12877850
1909,6,12,1,2412,-83,-92,9,40:e3:d6:da:bb:e2,12883771,176,5745,12883595,12883771
1910,6,12,1,2412,-83,-92,9,40:e3:d6:da:bb:e3,12883972,180,21,12883792,12883972
1911,6,12,1,2412,-86,-92,6,40:e3:d6:da:bb:e4,12884196,172,52,12884024,12884196
1912,6,12,1,2412,-87,-92,5,40:e3:d6:da:bb:e5,12884420,156,68,12884264,12884420
1913,6,6,1,2412,-86,-92,6,40:e3:d6:da:bb:e6,12884617,380,-183,12884237,12884617
1914,6,12,1,2412,-55,-92,37,40:e3:d6:da:ba:20,12886491,160,1714,12886331,12886491
1915,6,6,1,2412,-55,-92,37,40:e3:d6:da:ba:21,12886692,368,-167,12886324,12886692
1916,6,12,1,2412,-55,-92,37,40:e3:d6:da:ba:25,12887731,160,879,12887571,12887731
1917,6,6,1,2412,-55,-92,37,40:e3:d6:da:ba:26,12887950,380,-161,12887570,12887950
1918,4,1,1,2412,-86,-92,6,,12890237,304,1983,12889933,12890237
1919,4,1,1,2412,-83,-92,9,,12892170,304,1629,12891866,12892170
1920,6,6,1,2412,-85,-92,7,e6:aa:ea:c9:ea:1b,12892629,408,51,12892221,12892629
1921,4,1,1,2412,-63,-92,29,54:e4:3a:ec:fb:64,12894729,2112,-12,12892617,12894729
1922,6,12,1,2412,-55,-92,37,40:e3:d6:da:ba:20,12897017,136,2152,12896881,12897017
1923,6,6,1,2412,-55,-92,37,40:e3:d6:da:ba:21,12897194,348,-171,12896846,12897194
1924,6,12,1,2412,-55,-92,37,40:e3:d6:da:ba:22,12897579,156,229,12897423,12897579
1925,6,12,1,2412,-55,-92,37,40:e3:d6:da:ba:23,12897797,156,62,12897641,12897797
1926,6,12,1,2412,-55,-92,37,40:e3:d6:da:ba:25,12897987,136,54,12897851,12897987
1927,6,12,1,2412,-85,-92,7,40:e3:d6:da:ca:c0,12901701,156,3558,12901545,12901701
1928,6,6,1,2412,-83,-92,9,40:e3:d6:da:ca:c1,12901898,368,-171,12901530,12901898
1929,6,12,1,2412,-84,-92,8,40:e3:d6:da:ca:c2,12902285,176,211,12902109,12902285
1930,6,12,1,2412,-83,-92,9,40:e3:d6:da:ca:c4,12902701,172,244,12902529,12902701
1931,4,1,1,2412,-84,-92,8,,12914677,304,11672,12914373,12914677
1932,4,1,1,2412,-83,-92,9,,12921507,304,6526,12921203,12921507
1933,4,1,1,2412,-70,-92,22,54:e4:3a:ec:fb:64,12945686,2160,22019,12943526,12945686
1934,4,1,1,2412,-77,-92,15,b8:3a:5a:88:e6:e1,12975278,2376,27216,12972902,12975278
1935,6,12,1,2412,-86,-92,6,84:d4:7e:f2:34:22,12978435,180,2977,12978255,12978435
1936,6,12,1,2412,-89,-92,3,84:d4:7e:f2:34:23,12978658,180,43,12978478,12978658
1937,6,12,1,2412,-87,-92,5,84:d4:7e:f2:34:24,12978882,176,48,12978706,12978882
1938,6,12,1,2412,-88,-92,4,84:d4:7e:f2:34:25,12979092,160,50,12978932,12979092
1939,6,6,1,2412,-87,-92,5,84:d4:7e:f2:34:26,12979311,380,-161,12978931,12979311
1940,6,12,1,2412,-86,-92,6,40:e3:d6:da:bb:e0,12985584,156,6117,12985428,12985584
1941,6,6,1,2412,-88,-92,4,40:e3:d6:da:bb:e1,12985772,368,-180,12985404,12985772
1942,6,12,1,2412,-87,-92,5,40:e3:d6:da:bb:e3,12986378,180,426,12986198,12986378
1943,6,12,1,2412,-86,-92,6,40:e3:d6:da:bb:e4,12986602,172,52,12986430,12986602
1944,6,12,1,2412,-86,-92,6,40:e3:d6:da:bb:e5,12986808,156,50,12986652,12986808
1945,6,6,1,2412,-88,-92,4,40:e3:d6:da:bb:e6,12987005,380,-183,12986625,12987005
1946,6,12,1,2412,-55,-92,37,40:e3:d6:da:ba:20,12988876,160,1711,12988716,12988876
1947,6,6,1,2412,-55,-92,37,40:e3:d6:da:ba:21,12989086,368,-158,12988718,12989086
1948,6,12,1,2412,-55,-92,37,40:e3:d6:da:ba:22,12989482,180,216,12989302,12989482
1949,6,12,1,2412,-55,-92,37,40:e3:d6:da:ba:23,12989714,184,48,12989530,12989714
1950,6,12,1,2412,-55,-92,37,40:e3:d6:da:ba:24,12989924,176,34,12989748,12989924
1951,6,12,1,2412,-55,-92,37,40:e3:d6:da:ba:25,12990143,160,59,12989983,12990143
1952,6,6,1,2412,-55,-92,37,40:e3:d6:da:ba:26,12990344,380,-179,12989964,12990344
1953,6,12,1,2412,-83,-92,9,84:d4:7e:f2:42:25,12990941,160,437,12990781,12990941
1954,6,12,1,2412,-87,-92,5,,12996256,32,5283,12996224,12996256
1955,6,12,1,2412,-85,-92,7,40:e3:d6:da:ca:c0,13003808,156,7396,13003652,13003808
1956,6,6,1,2412,-85,-92,7,40:e3:d6:da:ca:c1,13004022,368,-154,13003654,13004022
1957,6,12,1,2412,-85,-92,7,40:e3:d6:da:ca:c2,13004436,176,238,13004260,13004436
1958,6,12,1,2412,-85,-92,7,40:e3:d6:da:ca:c3,13004665,180,49,13004485,13004665
1959,6,12,1,2412,-82,-92,10,40:e3:d6:da:ca:c4,13004879,172,42,13004707,13004879
1960,6,6,1,2412,-85,-92,7,40:e3:d6:da:ca:c6,13005300,380,41,13004920,13005300
1961,6,12,1,2412,-86,-92,6,,13023929,32,18597,13023897,13023929
1962,6,12,1,2412,-85,-92,7,,13024323,32,362,13024291,13024323
1963,6,6,1,2412,-83,-92,9,40:e3:d6:da:c8:01,13035206,368,10515,13034838,13035206
1964,6,6,1,2412,-88,-92,4,40:e3:d6:da:c8:06,13036428,380,842,13036048,13036428
1965,6,6,1,2412,-73,-92,19,e6:aa:ea:b7:4a:dd,13050185,408,13349,13049777,13050185
1966,4,1,1,2412,-71,-92,21,,13064453,304,13964,13064149,13064453
1967,4,1,1,2412,-77,-92,15,b8:3a:5a:88:e6:e0,13075285,2360,8472,13072925,13075285
1968,6,6,1,2412,-87,-92,5,84:d4:7e:f2:34:21,13079898,368,4245,13079530,13079898
1969,6,12,1,2412,-87,-92,5,84:d4:7e:f2:34:22,13080303,180,225,13080123,13080303
1970,6,12,1,2412,-85,-92,7,84:d4:7e:f2:34:23,13080629,180,146,13080449,13080629
1971,6,12,1,2412,-87,-92,5,84:d4:7e:f2:34:24,13080843,176,38,13080667,13080843
1972,6,12,1,2412,-87,-92,5,84:d4:7e:f2:34:25,13081062,160,59,13080902,13081062
1973,6,6,1,2412,-73,-92,19,e6:aa:ea:b7:4a:dd,13086538,408,5068,13086130,13086538
1974,6,12,1,2412,-87,-92,5,40:e3:d6:da:bb:e0,13087962,156,1268,13087806,13087962
1975,6,12,1,2412,-87,-92,5,40:e3:d6:da:bb:e4,13088971,172,837,13088799,13088971
1976,6,6,1,2412,-86,-92,6,40:e3:d6:da:bb:e6,13089383,380,32,13089003,13089383
1977,6,12,1,2412,-54,-92,38,40:e3:d6:da:ba:20,13091287,160,1744,13091127,13091287
1978,6,6,1,2412,-54,-92,38,40:e3:d6:da:ba:21,13091506,368,-149,13091138,13091506
1979,6,12,1,2412,-54,-92,38,40:e3:d6:da:ba:22,13091920,180,234,13091740,13091920
1980,6,12,1,2412,-54,-92,38,40:e3:d6:da:ba:23,13092153,184,49,13091969,13092153
1981,6,12,1,2412,-54,-92,38,40:e3:d6:da:ba:24,13092371,176,42,13092195,13092371
1982,6,12,1,2412,-54,-92,38,40:e3:d6:da:ba:25,13092573,160,42,13092413,13092573
1983,6,6,1,2412,-54,-92,38,40:e3:d6:da:ba:26,13092774,380,-179,13092394,13092774
1984,6,12,1,2412,-86,-92,6,84:d4:7e:f2:42:24,13093149,176,199,13092973,13093149
1985,6,12,1,2412,-85,-92,7,84:d4:7e:f2:42:25,13093351,160,42,13093191,13093351
1986,6,6,1,2412,-74,-92,18,e6:aa:ea:b7:4a:dd,13098657,408,4898,13098249,13098657
1987,4,1,1,2412,-76,-92,16,c0:c9:e3:4d:6e:bf,13108851,872,9322,13107979,13108851
1988,4,1,1,2412,-71,-92,21,,13109740,304,585,13109436,13109740
1989,6,12,1,2412,-88,-92,4,,13125797,32,16025,13125765,13125797
1990,4,1,1,2412,-68,-92,24,54:e4:3a:ec:fb:64,13150701,2160,22744,13148541,13150701
1991,4,1,1,2412,-80,-92,12,b8:3a:5a:88:e6:e0,13177662,2360,24601,13175302,13177662
1992,6,12,1,2412,-53,-92,39,40:e3:d6:da:ba:22,13194370,180,16528,13194190,13194370
1993,6,12,1,2412,-53,-92,39,40:e3:d6:da:ba:23,13194585,184,31,13194401,13194585
1994,6,12,1,2412,-47,-92,45,40:e3:d6:da:ba:24,13194794,176,33,13194618,13194794
1995,6,12,1,2412,-53,-92,39,40:e3:d6:da:ba:25,13195014,160,60,13194854,13195014
1996,6,6,1,2412,-53,-92,39,40:e3:d6:da:ba:26,13195232,380,-162,13194852,13195232
1997,6,12,1,2412,-86,-92,6,84:d4:7e:f2:42:25,13195745,160,353,13195585,13195745
1998,6,6,1,2412,-85,-92,7,84:d4:7e:f2:42:26,13195964,380,-161,13195584,13195964
1999,6,6,1,2412,-86,-92,6,40:e3:d6:da:ca:c6,13210123,380,13779,13209743,13210123
2000,6,6,1,2412,-51,-92,41,e6:aa:ea:c9:ea:33,13229620,408,19089,13229212,13229620
2001,6,12,1,2412,-85,-92,7,,13230252,32,600,13230220,13230252
2002,6,12,1,2412,-86,-92,6,,13231646,32,1362,13231614,13231646
2003,6,6,1,2412,-51,-92,41,e6:aa:ea:c9:ea:33,13265973,408,33919,13265565,13265973
2004,6,6,1,2412,-51,-92,41,e6:aa:ea:c9:ea:33,13278422,408,12041,13278014,13278422
2005,6,6,1,2412,-84,-92,8,84:d4:7e:f2:34:26,13285563,380,6761,13285183,13285563
2006,4,1,1,2412,-71,-92,21,54:e4:3a:ec:fb:64,13292603,2112,4928,13290491,13292603
2007,4,1,1,2412,-71,-92,21,54:e4:3a:ec:fb:64,13294906,2112,191,13292794,13294906
2008,4,1,1,2412,-70,-92,22,54:e4:3a:ec:fb:64,13297101,2112,83,13294989,13297101
2009,6,12,1,2412,-53,-92,39,40:e3:d6:da:ba:20,13299395,160,2134,13299235,13299395
2010,6,6,1,2412,-53,-92,39,40:e3:d6:da:ba:21,13299614,368,-149,13299246,13299614
2011,6,12,1,2412,-53,-92,39,40:e3:d6:da:ba:22,13300010,180,216,13299830,13300010
2012,6,12,1,2412,-53,-92,39,40:e3:d6:da:ba:23,13300243,184,49,13300059,13300243
2013,6,12,1,2412,-52,-92,40,40:e3:d6:da:ba:24,13300470,176,51,13300294,13300470
2014,6,12,1,2412,-53,-92,39,40:e3:d6:da:ba:25,13300690,160,60,13300530,13300690
2015,6,6,1,2412,-52,-92,40,40:e3:d6:da:ba:26,13300909,380,-161,13300529,13300909
2016,6,12,1,2412,-52,-92,40,40:e3:d6:da:ba:20,13301317,136,272,13301181,13301317
2017,6,6,1,2412,-52,-92,40,40:e3:d6:da:ba:21,13301502,348,-163,13301154,13301502
2018,6,12,1,2412,-52,-92,40,40:e3:d6:da:ba:22,13301905,156,247,13301749,13301905
2019,6,12,1,2412,-52,-92,40,40:e3:d6:da:ba:23,13302096,156,35,13301940,13302096
2020,6,12,1,2412,-52,-92,40,40:e3:d6:da:ba:25,13302313,136,81,13302177,13302313
2021,4,1,1,2412,-69,-92,23,54:e4:3a:ec:fb:64,13303402,2112,-1023,13301290,13303402
2022,6,12,1,2412,-85,-92,7,40:e3:d6:da:ca:c2,13311622,176,8044,13311446,13311622
2023,6,12,1,2412,-86,-92,6,40:e3:d6:da:ca:c3,13311833,180,31,13311653,13311833
2024,6,12,1,2412,-86,-92,6,40:e3:d6:da:ca:c4,13312057,172,52,13311885,13312057
2025,6,12,1,2412,-86,-92,6,40:e3:d6:da:ca:c5,13312254,156,41,13312098,13312254
2026,6,6,1,2412,-86,-92,6,40:e3:d6:da:ca:c6,13312442,380,-192,13312062,13312442
2027,4,1,1,2412,-66,-92,26,54:e4:3a:ec:fb:64,13355217,2160,40615,13353057,13355217
2028,4,1,1,2412,-81,-92,11,b8:3a:5a:88:e6:e0,13382482,2360,24905,13380122,13382482
2029,4,1,1,2412,-81,-92,11,b8:3a:5a:88:e6:e1,13384879,2376,21,13382503,13384879
2030,6,12,1,2412,-85,-92,7,84:d4:7e:f2:34:20,13387430,160,2391,13387270,13387430
2031,6,6,1,2412,-84,-92,8,84:d4:7e:f2:34:21,13387649,368,-149,13387281,13387649
2032,6,12,1,2412,-84,-92,8,84:d4:7e:f2:34:22,13388036,180,207,13387856,13388036
2033,6,6,1,2412,-83,-92,9,84:d4:7e:f2:34:26,13388876,380,460,13388496,13388876
2034,6,12,1,2412,-87,-92,5,40:e3:d6:da:bb:e2,13395765,176,6713,13395589,13395765
2035,6,12,1,2412,-88,-92,4,40:e3:d6:da:bb:e4,13396601,172,664,13396429,13396601
2036,6,12,1,2412,-87,-92,5,40:e3:d6:da:bb:e5,13397260,156,503,13397104,13397260
2037,6,6,1,2412,-87,-92,5,40:e3:d6:da:bb:e6,13397457,380,-183,13397077,13397457
2038,6,12,1,2412,-52,-92,40,40:e3:d6:da:ba:20,13398489,160,872,13398329,13398489
2039,6,6,1,2412,-52,-92,40,40:e3:d6:da:ba:21,13398690,368,-167,13398322,13398690
2040,6,12,1,2412,-52,-92,40,40:e3:d6:da:ba:22,13399086,180,216,13398906,13399086
2041,6,12,1,2412,-52,-92,40,40:e3:d6:da:ba:23,13399292,184,22,13399108,13399292
2042,6,12,1,2412,-52,-92,40,40:e3:d6:da:ba:24,13399528,176,60,13399352,13399528
2043,6,12,1,2412,-52,-92,40,40:e3:d6:da:ba:25,13399757,160,69,13399597,13399757
2044,6,6,1,2412,-52,-92,40,40:e3:d6:da:ba:26,13399958,380,-179,13399578,13399958
2045,6,12,1,2412,-86,-92,6,84:d4:7e:f2:42:25,13400600,160,482,13400440,13400600
2046,6,6,1,2412,-86,-92,6,40:e3:d6:da:ca:c1,13413619,368,12651,13413251,13413619
2047,4,1,1,2412,-72,-92,20,54:e4:3a:ec:fb:64,13457660,2160,41881,13455500,13457660
2048,4,1,1,2412,-79,-92,13,b8:3a:5a:88:e6:e0,13484864,2360,24844,13482504,13484864
2049,4,1,1,2412,-78,-92,14,b8:3a:5a:88:e6:e1,13487271,2376,31,13484895,13487271
2050,6,12,1,2412,-83,-92,9,84:d4:7e:f2:34:20,13489821,160,2390,13489661,13489821
2051,6,6,1,2412,-85,-92,7,84:d4:7e:f2:34:21,13490029,368,-160,13489661,13490029
2052,6,12,1,2412,-85,-92,7,84:d4:7e:f2:34:22,13490416,180,207,13490236,13490416
2053,6,12,1,2412,-85,-92,7,84:d4:7e:f2:34:23,13490621,180,25,13490441,13490621
2054,6,12,1,2412,-86,-92,6,84:d4:7e:f2:34:24,13490845,176,48,13490669,13490845
2055,6,12,1,2412,-84,-92,8,84:d4:7e:f2:34:25,13491064,160,59,13490904,13491064
2056,6,6,1,2412,-85,-92,7,84:d4:7e:f2:34:26,13491256,380,-188,13490876,13491256
2057,6,12,1,2412,-52,-92,40,40:e3:d6:da:ba:20,13500900,160,9484,13500740,13500900
2058,6,6,1,2412,-52,-92,40,40:e3:d6:da:ba:21,13501119,368,-149,13500751,13501119
2059,6,12,1,2412,-52,-92,40,40:e3:d6:da:ba:22,13501515,180,216,13501335,13501515
2060,6,12,1,2412,-52,-92,40,40:e3:d6:da:ba:23,13501720,184,21,13501536,13501720
2061,6,12,1,2412,-52,-92,40,40:e3:d6:da:ba:24,13501930,176,34,13501754,13501930
2062,6,12,1,2412,-52,-92,40,40:e3:d6:da:ba:25,13502140,160,50,13501980,13502140
2063,6,6,1,2412,-52,-92,40,40:e3:d6:da:ba:26,13502350,380,-170,13501970,13502350
2064,6,12,1,2412,-84,-92,8,84:d4:7e:f2:42:24,13502737,176,211,13502561,13502737
2065,6,12,1,2412,-84,-92,8,84:d4:7e:f2:42:25,13502966,160,69,13502806,13502966
2066,6,12,1,2412,-87,-92,5,40:e3:d6:da:ca:c3,13516600,180,13454,13516420,13516600
2067,6,6,1,2412,-88,-92,4,40:e3:d6:da:ca:c6,13517218,380,238,13516838,13517218
2068,6,6,1,2412,-49,-92,43,e6:aa:ea:c9:ea:33,13545303,408,27677,13544895,13545303
2069,4,1,1,2412,-78,-92,14,c0:c9:e3:4d:6e:bf,13553746,872,7571,13552874,13553746
2070,4,1,1,2412,-74,-92,18,,13554635,304,585,13554331,13554635
2071,4,1,1,2412,-73,-92,19,54:e4:3a:ec:fb:64,13560105,2160,3310,13557945,13560105
2072,6,6,1,2412,-49,-92,43,e6:aa:ea:c9:ea:33,13569529,408,9016,13569121,13569529
2073,6,6,1,2412,-73,-92,19,e6:aa:ea:b7:4a:dd,13570082,408,145,13569674,13570082
2074,6,6,1,2412,-49,-92,43,e6:aa:ea:c9:ea:33,13581659,408,11169,13581251,13581659
2075,6,6,1,2412,-73,-92,19,e6:aa:ea:b7:4a:dd,13582465,408,398,13582057,13582465
2076,4,1,1,2412,-77,-92,15,b8:3a:5a:88:e6:e0,13587262,2360,2437,13584902,13587262
2077,6,12,1,2412,-85,-92,7,84:d4:7e:f2:34:20,13591319,160,3897,13591159,13591319
2078,6,6,1,2412,-86,-92,6,84:d4:7e:f2:34:21,13591520,368,-167,13591152,13591520
2079,6,12,1,2412,-85,-92,7,84:d4:7e:f2:34:22,13591925,180,225,13591745,13591925
2080,6,12,1,2412,-84,-92,8,84:d4:7e:f2:34:23,13592131,180,26,13591951,13592131
2081,6,12,1,2412,-86,-92,6,84:d4:7e:f2:34:24,13592363,176,56,13592187,13592363
2082,6,6,1,2412,-85,-92,7,84:d4:7e:f2:34:26,13592792,380,49,13592412,13592792
2083,6,6,1,2412,-49,-92,43,e6:aa:ea:c9:ea:33,13593775,408,575,13593367,13593775
2084,6,6,1,2412,-73,-92,19,e6:aa:ea:b7:4a:dd,13594337,408,154,13593929,13594337
2085,6,12,1,2412,-87,-92,5,40:e3:d6:da:bb:e0,13600087,156,5594,13599931,13600087
2086,6,6,1,2412,-87,-92,5,40:e3:d6:da:bb:e1,13600293,368,-162,13599925,13600293
2087,6,6,1,2412,-54,-92,38,40:e3:d6:da:ba:21,13604358,368,3697,13603990,13604358
2088,6,12,1,2412,-54,-92,38,40:e3:d6:da:ba:22,13604827,180,289,13604647,13604827
2089,6,12,1,2412,-54,-92,38,40:e3:d6:da:ba:25,13605488,160,501,13605328,13605488
2090,6,6,1,2412,-54,-92,38,40:e3:d6:da:ba:26,13605698,380,-170,13605318,13605698
2091,6,6,1,2412,-73,-92,19,e6:aa:ea:b7:4a:dd,13606475,408,369,13606067,13606475
2092,6,6,1,2412,-73,-92,19,e6:aa:ea:b7:4a:dd,13618553,408,11670,13618145,13618553
2093,6,12,1,2412,-87,-92,5,40:e3:d6:da:ca:c3,13619054,180,321,13618874,13619054
2094,6,12,1,2412,-88,-92,4,40:e3:d6:da:ca:c4,13619278,172,52,13619106,13619278
2095,6,12,1,2412,-87,-92,5,40:e3:d6:da:ca:c5,13619493,156,59,13619337,13619493
2096,4,1,1,2412,-75,-92,17,a6:e5:7c:28:b1:d3,13649005,992,28520,13648013,13649005
2097,4,1,1,2412,-70,-92,22,54:e4:3a:ec:fb:64,13662556,2160,11391,13660396,13662556
2098,6,6,1,2412,-85,-92,7,e6:aa:ea:c9:ea:1b,13683716,408,20752,13683308,13683716
2099,4,1,1,2412,-78,-92,14,b8:3a:5a:88:e6:e0,13689662,2360,3586,13687302,13689662
2100,6,6,1,2412,-87,-92,5,84:d4:7e:f2:34:26,13696358,380,6316,13695978,13696358
2101,6,12,1,2412,-87,-92,5,40:e3:d6:da:bb:e0,13702379,156,5865,13702223,13702379
2102,6,6,1,2412,-86,-92,6,40:e3:d6:da:bb:e1,13702567,368,-180,13702199,13702567
2103,6,12,1,2412,-56,-92,36,40:e3:d6:da:ba:20,13705680,160,2953,13705520,13705680
2104,6,6,1,2412,-56,-92,36,40:e3:d6:da:ba:21,13705872,368,-176,13705504,13705872
2105,6,12,1,2412,-56,-92,36,40:e3:d6:da:ba:22,13706267,180,215,13706087,13706267
2106,6,12,1,2412,-56,-92,36,40:e3:d6:da:ba:23,13706482,184,31,13706298,13706482
2107,6,12,1,2412,-56,-92,36,40:e3:d6:da:ba:24,13706718,176,60,13706542,13706718
2108,6,12,1,2412,-56,-92,36,40:e3:d6:da:ba:25,13706947,160,69,13706787,13706947
2109,6,6,1,2412,-56,-92,36,40:e3:d6:da:ba:26,13707166,380,-161,13706786,13707166
2110,6,12,1,2412,-86,-92,6,84:d4:7e:f2:42:24,13707545,176,203,13707369,13707545
2111,6,12,1,2412,-85,-92,7,84:d4:7e:f2:42:25,13707764,160,59,13707604,13707764
2112,6,6,1,2412,-86,-92,6,e6:aa:ea:c9:ea:1b,13707950,408,-222,13707542,13707950
2113,6,6,1,2412,-86,-92,6,e6:aa:ea:c9:ea:1b,13732164,408,23806,13731756,13732164
2114,4,1,1,2412,-74,-92,18,a6:e5:7c:28:b1:d3,13756422,992,23266,13755430,13756422
2115,4,1,1,2412,-70,-92,22,54:e4:3a:ec:fb:64,13764899,2160,6317,13762739,13764899
2116,6,12,1,2412,-55,-92,37,40:e3:d6:da:ba:20,13808079,160,43020,13807919,13808079
2117,6,6,1,2412,-55,-92,37,40:e3:d6:da:ba:21,13808298,368,-149,13807930,13808298
2118,6,12,1,2412,-50,-92,42,40:e3:d6:da:ba:22,13808728,180,250,13808548,13808728
2119,6,12,1,2412,-55,-92,37,40:e3:d6:da:ba:23,13808960,184,48,13808776,13808960
2120,6,12,1,2412,-55,-92,37,40:e3:d6:da:ba:24,13809170,176,34,13808994,13809170
2121,6,12,1,2412,-55,-92,37,40:e3:d6:da:ba:25,13809398,160,68,13809238,13809398
2122,6,6,1,2412,-55,-92,37,40:e3:d6:da:ba:26,13809608,380,-170,13809228,13809608
2123,6,12,1,2412,-85,-92,7,84:d4:7e:f2:42:25,13810167,160,399,13810007,13810167
2124,6,12,1,2412,-76,-92,16,40:e3:d6:da:ca:c0,13823159,156,12836,13823003,13823159
2125,6,12,1,2412,-85,-92,7,40:e3:d6:da:ca:c2,13823885,176,550,13823709,13823885
2126,6,12,1,2412,-86,-92,6,40:e3:d6:da:ca:c3,13824087,180,22,13823907,13824087
2127,4,1,1,2412,-77,-92,15,a6:e5:7c:28:b1:d3,13855197,992,30118,13854205,13855197
2128,6,12,1,2412,-87,-92,5,40:e3:d6:da:c8:04,13856285,176,912,13856109,13856285
2129,6,12,1,2412,-88,-92,4,40:e3:d6:da:c8:05,13856513,160,68,13856353,13856513
2130,4,1,1,2412,-68,-92,24,54:e4:3a:ec:fb:64,13867244,2160,8571,13865084,13867244
2131,6,6,1,2412,-70,-92,22,e6:aa:ea:b7:4a:dd,13884603,408,16951,13884195,13884603
2132,6,12,1,2412,-87,-92,5,84:d4:7e:f2:34:23,13899453,180,14670,13899273,13899453
2133,6,12,1,2412,-86,-92,6,84:d4:7e:f2:34:24,13899685,176,56,13899509,13899685
2134,6,12,1,2412,-88,-92,4,84:d4:7e:f2:34:25,13899913,160,68,13899753,13899913
2135,6,6,1,2412,-88,-92,4,84:d4:7e:f2:34:26,13900114,380,-179,13899734,13900114
2136,6,12,1,2412,-88,-92,4,40:e3:d6:da:bb:e2,13907790,176,7500,13907614,13907790
2137,6,6,1,2412,-70,-92,22,e6:aa:ea:b7:4a:dd,13908840,408,642,13908432,13908840
2138,6,12,1,2412,-54,-92,38,40:e3:d6:da:ba:20,13910476,160,1476,13910316,13910476
2139,6,12,1,2412,-54,-92,38,40:e3:d6:da:ba:22,13911091,180,435,13910911,13911091
2140,6,12,1,2412,-54,-92,38,40:e3:d6:da:ba:23,13911296,184,21,13911112,13911296
2141,6,12,1,2412,-54,-92,38,40:e3:d6:da:ba:25,13911743,160,287,13911583,13911743
2142,6,6,1,2412,-54,-92,38,40:e3:d6:da:ba:26,13911962,380,-161,13911582,13911962
2143,6,12,1,2412,-89,-92,3,40:e3:d6:da:ca:c2,13926004,176,13866,13925828,13926004
2144,6,6,1,2412,-70,-92,22,e6:aa:ea:b7:4a:dd,13933095,408,6683,13932687,13933095
2145,6,12,1,2412,-89,-92,3,40:e3:d6:da:c8:00,13956595,160,23340,13956435,13956595
2146,6,12,1,2412,-89,-92,3,40:e3:d6:da:c8:02,13957182,180,407,13957002,13957182
2147,6,12,1,2412,-88,-92,4,40:e3:d6:da:c8:03,13957415,184,49,13957231,13957415
2148,6,12,1,2412,-88,-92,4,40:e3:d6:da:c8:04,13957624,176,33,13957448,13957624
2149,6,12,1,2412,-87,-92,5,40:e3:d6:da:c8:05,13957834,160,50,13957674,13957834
2150,4,1,1,2412,-67,-92,25,54:e4:3a:ec:fb:64,13966797,2112,6851,13964685,13966797
2151,4,1,1,2412,-68,-92,24,54:e4:3a:ec:fb:64,13971194,2160,2237,13969034,13971194
2152,4,1,1,2412,-80,-92,12,b8:3a:5a:88:e6:e1,13999252,2376,25682,13996876,13999252
2153,6,12,1,2412,-87,-92,5,84:d4:7e:f2:34:20,14001794,160,2382,14001634,14001794
2154,6,12,1,2412,-86,-92,6,84:d4:7e:f2:34:22,14002400,180,426,14002220,14002400
2155,6,6,1,2412,-86,-92,6,84:d4:7e:f2:34:26,14003249,380,469,14002869,14003249
2156,6,12,1,2412,-88,-92,4,40:e3:d6:da:bb:e3,14010402,180,6973,14010222,14010402
2157,6,12,1,2412,-88,-92,4,40:e3:d6:da:bb:e4,14010625,172,51,14010453,14010625
2158,6,12,1,2412,-53,-92,39,40:e3:d6:da:ba:20,14012892,160,2107,14012732,14012892
2159,6,12,1,2412,-53,-92,39,40:e3:d6:da:ba:23,14013746,184,670,14013562,14013746
2160,6,12,1,2412,-53,-92,39,40:e3:d6:da:ba:24,14013989,176,67,14013813,14013989
2161,6,12,1,2412,-53,-92,39,40:e3:d6:da:ba:25,14014209,160,60,14014049,14014209
2162,6,6,1,2412,-53,-92,39,40:e3:d6:da:ba:26,14014410,380,-179,14014030,14014410
2163,6,6,1,2412,-87,-92,5,84:d4:7e:f2:42:26,14015185,380,395,14014805,14015185
2164,6,6,1,2412,-88,-92,4,40:e3:d6:da:ca:c6,14030974,380,15409,14030594,14030974
2165,4,1,1,2412,-81,-92,11,c0:c9:e3:4d:6e:bf,14044487,872,12641,14043615,14044487
2166,4,1,1,2412,-84,-92,8,,14045376,304,585,14045072,14045376
2167,6,6,1,2412,-90,-92,2,40:e3:d6:da:c8:01,14059227,368,13483,14058859,14059227
2168,6,12,1,2412,-90,-92,2,40:e3:d6:da:c8:02,14059631,180,224,14059451,14059631
2169,6,12,1,2412,-90,-92,2,40:e3:d6:da:c8:03,14059845,184,30,14059661,14059845
2170,6,12,1,2412,-89,-92,3,40:e3:d6:da:c8:04,14060064,176,43,14059888,14060064
2171,6,12,1,2412,-89,-92,3,40:e3:d6:da:c8:05,14060265,160,41,14060105,14060265
2172,6,6,1,2412,-88,-92,4,40:e3:d6:da:c8:06,14060475,380,-170,14060095,14060475
2173,4,1,1,2412,-67,-92,25,54:e4:3a:ec:fb:64,14072158,2160,9523,14069998,14072158
2174,6,6,1,2412,-53,-92,39,e6:aa:ea:c9:ea:33,14103140,408,30574,14102732,14103140
2175,6,12,1,2412,-78,-92,14,84:d4:7e:f2:34:25,14105461,160,2161,14105301,14105461
2176,6,6,1,2412,-85,-92,7,84:d4:7e:f2:34:26,14105736,380,-105,14105356,14105736
2177,6,6,1,2412,-54,-92,38,e6:aa:ea:c9:ea:33,14115265,408,9121,14114857,14115265
2178,6,12,1,2412,-51,-92,41,40:e3:d6:da:ba:20,14115693,160,268,14115533,14115693
2179,6,6,1,2412,-51,-92,41,40:e3:d6:da:ba:21,14115903,368,-158,14115535,14115903
2180,6,12,1,2412,-51,-92,41,40:e3:d6:da:ba:22,14116299,180,216,14116119,14116299
2181,6,12,1,2412,-51,-92,41,40:e3:d6:da:ba:23,14116513,184,30,14116329,14116513
2182,6,12,1,2412,-51,-92,41,40:e3:d6:da:ba:24,14116750,176,61,14116574,14116750
2183,6,12,1,2412,-51,-92,41,40:e3:d6:da:ba:25,14116951,160,41,14116791,14116951
2184,6,6,1,2412,-51,-92,41,40:e3:d6:da:ba:26,14117143,380,-188,14116763,14117143
2185,6,6,1,2412,-87,-92,5,84:d4:7e:f2:42:26,14117590,380,67,14117210,14117590
2186,6,6,1,2412,-85,-92,7,e6:aa:ea:c9:ea:1b,14140420,408,22422,14140012,14140420
2187,6,6,1,2412,-80,-92,12,,14142581,44,2117,14142537,14142581
2188,6,6,1,2412,-86,-92,6,e6:aa:ea:c9:ea:1b,14152550,408,9561,14152142,14152550
2189,6,6,1,2412,-89,-92,3,40:e3:d6:da:c8:01,14161622,368,8704,14161254,14161622
2190,6,12,1,2412,-89,-92,3,40:e3:d6:da:c8:03,14162260,184,454,14162076,14162260
2191,6,12,1,2412,-90,-92,2,40:e3:d6:da:c8:05,14162698,160,278,14162538,14162698
2192,6,6,1,2412,-89,-92,3,40:e3:d6:da:c8:06,14162899,380,-179,14162519,14162899
2193,4,1,1,2412,-67,-92,25,54:e4:3a:ec:fb:64,14174408,2160,9349,14172248,14174408
2194,6,12,1,2412,-87,-92,5,,14197320,32,22880,14197288,14197320
2195,6,12,1,2412,-87,-92,5,,14197535,32,183,14197503,14197535
2196,6,12,1,2412,-86,-92,6,,14198630,32,1063,14198598,14198630
2197,4,1,1,2412,-71,-92,21,b8:3a:5a:88:e6:e0,14201920,2360,930,14199560,14201920
2198,4,1,1,2412,-50,-92,42,,14206674,304,4450,14206370,14206674
2199,6,12,1,2412,-87,-92,5,84:d4:7e:f2:34:25,14208055,160,1221,14207895,14208055
2200,6,6,1,2412,-88,-92,4,84:d4:7e:f2:34:26,14208247,380,-188,14207867,14208247
2201,4,1,1,2412,-89,-92,3,66:d8:ff:ae:5d:41,14209097,416,434,14208681,14209097
2202,4,1,1,2412,-89,-92,3,,14209526,304,125,14209222,14209526
2203,6,12,1,2412,-88,-92,4,40:e3:d6:da:bb:e0,14214392,156,4710,14214236,14214392
2204,6,6,1,2412,-88,-92,4,40:e3:d6:da:bb:e1,14214598,368,-162,14214230,14214598
2205,6,12,1,2412,-88,-92,4,40:e3:d6:da:bb:e2,14214994,176,220,14214818,14214994
2206,6,12,1,2412,-87,-92,5,40:e3:d6:da:bb:e5,14215661,156,511,14215505,14215661
2207,6,6,1,2412,-88,-92,4,40:e3:d6:da:bb:e6,14215849,380,-192,14215469,14215849
2208,6,6,1,2412,-49,-92,43,40:e3:d6:da:ba:21,14217887,368,1670,14217519,14217887
2209,6,12,1,2412,-49,-92,43,40:e3:d6:da:ba:22,14218292,180,225,14218112,14218292
2210,6,12,1,2412,-49,-92,43,40:e3:d6:da:ba:23,14218515,184,39,14218331,14218515
2211,6,12,1,2412,-49,-92,43,40:e3:d6:da:ba:24,14218725,176,34,14218549,14218725
2212,6,6,1,2412,-49,-92,43,40:e3:d6:da:ba:26,14219118,380,13,14218738,14219118
2213,6,12,1,2412,-89,-92,3,84:d4:7e:f2:42:24,14219580,176,286,14219404,14219580
2214,6,12,1,2412,-87,-92,5,84:d4:7e:f2:42:25,14219800,160,60,14219640,14219800
2215,6,6,1,2412,-87,-92,5,84:d4:7e:f2:42:26,14220001,380,-179,14219621,14220001
2216,6,6,1,2412,-88,-92,4,40:e3:d6:da:ca:c6,14234062,380,13681,14233682,14234062
2217,4,1,1,2412,-88,-92,4,66:d8:ff:ae:5d:41,14244995,416,10517,14244579,14244995
2218,6,12,1,2412,-88,-92,4,,14254996,32,9969,14254964,14254996
2219,6,12,1,2412,-88,-92,4,40:e3:d6:da:c8:02,14264434,180,9258,14264254,14264434
2220,4,1,1,2412,-67,-92,25,54:e4:3a:ec:fb:64,14277162,2160,10568,14275002,14277162
2221,4,1,1,2412,-90,-92,2,66:d8:ff:ae:5d:41,14297609,416,20031,14297193,14297609
2222,4,1,1,2412,-89,-92,3,,14298038,304,125,14297734,14298038
2223,4,1,1,2412,-90,-92,2,,14299775,304,1433,14299471,14299775
2224,4,1,1,2412,-90,-92,2,66:d8:ff:ae:5d:41,14300100,416,-91,14299684,14300100
2225,4,1,1,2412,-83,-92,9,,14300530,304,126,14300226,14300530
2226,4,1,1,2412,-89,-92,3,,14301285,304,451,14300981,14301285
2227,4,1,1,2412,-68,-92,24,b8:3a:5a:88:e6:e0,14304145,2360,500,14301785,14304145
2228,6,12,1,2412,-85,-92,7,84:d4:7e:f2:34:22,14308936,180,4611,14308756,14308936
2229,6,12,1,2412,-88,-92,4,84:d4:7e:f2:34:23,14309142,180,26,14308962,14309142
2230,6,12,1,2412,-87,-92,5,84:d4:7e:f2:34:24,14309356,176,38,14309180,14309356
2231,6,6,1,2412,-88,-92,4,84:d4:7e:f2:34:26,14309785,380,49,14309405,14309785
2232,4,1,1,2412,-91,-92,1,66:d8:ff:ae:5d:41,14310458,416,257,14310042,14310458
2233,4,1,1,2412,-88,-92,4,66:d8:ff:ae:5d:41,14314122,416,3248,14313706,14314122
2234,4,1,1,2412,-89,-92,3,,14315405,304,979,14315101,14315405
2235,4,1,1,2412,-92,-92,0,66:d8:ff:ae:5d:41,14315731,416,-90,14315315,14315731
2236,4,1,1,2412,-88,-92,4,,14316160,304,125,14315856,14316160
2237,6,12,1,2412,-86,-92,6,40:e3:d6:da:bb:e0,14316813,156,497,14316657,14316813
2238,6,6,1,2412,-86,-92,6,40:e3:d6:da:bb:e1,14317019,368,-162,14316651,14317019
2239,6,12,1,2412,-86,-92,6,40:e3:d6:da:bb:e3,14317643,180,444,14317463,14317643
2240,6,12,1,2412,-86,-92,6,40:e3:d6:da:bb:e4,14317848,172,33,14317676,14317848
2241,6,12,1,2412,-84,-92,8,40:e3:d6:da:bb:e5,14318046,156,42,14317890,14318046
2242,6,6,1,2412,-88,-92,4,40:e3:d6:da:bb:e6,14318243,380,-183,14317863,14318243
2243,4,1,1,2412,-90,-92,2,66:d8:ff:ae:5d:41,14318813,416,154,14318397,14318813
2244,4,1,1,2412,-89,-92,3,,14319242,304,125,14318938,14319242
2245,4,1,1,2412,-90,-92,2,66:d8:ff:ae:5d:41,14319568,416,-90,14319152,14319568
2246,4,1,1,2412,-88,-92,4,,14319997,304,125,14319693,14319997
2247,6,12,1,2412,-49,-92,43,40:e3:d6:da:ba:20,14320190,160,33,14320030,14320190
2248,6,6,1,2412,-49,-92,43,40:e3:d6:da:ba:21,14320400,368,-158,14320032,14320400
2249,6,12,1,2412,-49,-92,43,40:e3:d6:da:ba:22,14320787,180,207,14320607,14320787
2250,6,12,1,2412,-48,-92,44,40:e3:d6:da:ba:24,14321202,176,239,14321026,14321202
2251,6,12,1,2412,-48,-92,44,40:e3:d6:da:ba:25,14321412,160,50,14321252,14321412
2252,6,6,1,2412,-48,-92,44,40:e3:d6:da:ba:26,14321604,380,-188,14321224,14321604
2253,4,1,1,2412,-92,-92,0,66:d8:ff:ae:5d:41,14328205,416,6185,14327789,14328205
2254,4,1,1,2412,-88,-92,4,,14328634,304,125,14328330,14328634
2255,4,1,1,2412,-88,-92,4,66:d8:ff:ae:5d:41,14328960,416,-90,14328544,14328960
2256,6,12,1,2412,-85,-92,7,40:e3:d6:da:ca:c5,14336261,156,7145,14336105,14336261
2257,4,1,1,2412,-71,-92,21,,14338736,304,2171,14338432,14338736
2258,6,12,1,2412,-89,-92,3,40:e3:d6:da:c8:05,14367465,160,28569,14367305,14367465
2259,4,1,1,2412,-67,-92,25,54:e4:3a:ec:fb:64,14379275,2160,9650,14377115,14379275
2260,4,1,1,2412,-90,-92,2,66:d8:ff:ae:5d:41,14389993,416,10302,14389577,14389993
2261,4,1,1,2412,-89,-92,3,,14390422,304,125,14390118,14390422
2262,6,6,1,2412,-87,-92,5,,14393491,44,3025,14393447,14393491
2263,4,1,1,2412,-76,-92,16,b8:3a:5a:88:e6:e0,14406582,2360,10731,14404222,14406582
2264,4,1,1,2412,-76,-92,16,b8:3a:5a:88:e6:e1,14408989,2376,31,14406613,14408989
2265,6,6,1,2412,-72,-92,20,e6:aa:ea:b7:4a:dd,14416824,408,7427,14416416,14416824
2266,6,6,1,2412,-85,-92,7,40:e3:d6:da:bb:e1,14419363,368,2171,14418995,14419363
2267,6,12,1,2412,-85,-92,7,40:e3:d6:da:bb:e3,14419960,180,417,14419780,14419960
2268,6,12,1,2412,-48,-92,44,40:e3:d6:da:ba:20,14422494,160,2374,14422334,14422494
2269,6,6,1,2412,-48,-92,44,40:e3:d6:da:ba:21,14422704,368,-158,14422336,14422704
2270,6,12,1,2412,-48,-92,44,40:e3:d6:da:ba:22,14423100,180,216,14422920,14423100
2271,6,12,1,2412,-48,-92,44,40:e3:d6:da:ba:24,14423575,176,299,14423399,14423575
2272,6,12,1,2412,-48,-92,44,40:e3:d6:da:ba:25,14423820,160,85,14423660,14423820
2273,6,6,1,2412,-73,-92,19,e6:aa:ea:b7:4a:dd,14428798,408,4570,14428390,14428798
2274,6,12,1,2412,-86,-92,6,40:e3:d6:da:ca:c0,14437428,156,8474,14437272,14437428
2275,6,6,1,2412,-84,-92,8,e6:aa:ea:c9:ea:1b,14444921,408,7085,14444513,14444921
2276,6,6,1,2412,-73,-92,19,e6:aa:ea:b7:4a:dd,14453042,408,7713,14452634,14453042
2277,6,6,1,2412,-89,-92,3,40:e3:d6:da:c8:06,14470130,380,16708,14469750,14470130
2278,4,1,1,2412,-55,-92,37,54:e4:3a:ec:fb:64,14481759,2160,9469,14479599,14481759
2279,6,12,1,2412,-87,-92,5,84:d4:7e:f2:34:23,14514651,180,32712,14514471,14514651
2280,6,12,1,2412,-88,-92,4,84:d4:7e:f2:34:25,14515058,160,247,14514898,14515058
2281,6,12,1,2412,-86,-92,6,40:e3:d6:da:bb:e0,14521611,156,6397,14521455,14521611
2282,6,12,1,2412,-87,-92,5,40:e3:d6:da:bb:e3,14522861,180,1070,14522681,14522861
2283,6,12,1,2412,-86,-92,6,40:e3:d6:da:bb:e4,14523076,172,43,14522904,14523076
2284,6,12,1,2412,-48,-92,44,40:e3:d6:da:ba:20,14524903,160,1667,14524743,14524903
2285,6,12,1,2412,-48,-92,44,40:e3:d6:da:ba:22,14525500,180,417,14525320,14525500
2286,6,12,1,2412,-48,-92,44,40:e3:d6:da:ba:23,14525723,184,39,14525539,14525723
2287,6,6,1,2412,-48,-92,44,40:e3:d6:da:ba:26,14526362,380,259,14525982,14526362
2288,6,12,1,2412,-87,-92,5,84:d4:7e:f2:42:24,14526757,176,219,14526581,14526757
2289,6,12,1,2412,-87,-92,5,84:d4:7e:f2:42:25,14526985,160,68,14526825,14526985
2290,6,6,1,2412,-86,-92,6,84:d4:7e:f2:42:26,14527177,380,-188,14526797,14527177
2291,4,1,1,2412,-81,-92,11,c0:c9:e3:4d:6e:bf,14538665,872,10616,14537793,14538665
2292,4,1,1,2412,-83,-92,9,,14539555,304,586,14539251,14539555
2293,6,6,1,2412,-87,-92,5,40:e3:d6:da:ca:c1,14540024,368,101,14539656,14540024
2294,6,6,1,2412,-88,-92,4,40:e3:d6:da:ca:c6,14541248,380,844,14540868,14541248
2295,6,6,1,2412,-89,-92,3,a8:5b:f7:55:1a:40,14543326,72,2006,14543254,14543326
2296,6,6,1,2412,-83,-92,9,a8:5b:f7:55:1a:40,14543927,72,529,14543855,14543927
2297,6,6,1,2412,-88,-92,4,a8:5b:f7:55:1a:40,14544035,72,36,14543963,14544035
2298,6,6,1,2412,-90,-92,2,a8:5b:f7:55:1a:40,14544142,72,35,14544070,14544142
2299,6,6,1,2412,-89,-92,3,a8:5b:f7:55:1a:40,14544456,72,242,14544384,14544456
2300,6,6,1,2412,-89,-92,3,a8:5b:f7:55:1a:40,14544859,72,331,14544787,14544859
2301,6,6,1,2412,-91,-92,1,a8:5b:f7:55:1a:40,14545290,72,359,14545218,14545290
2302,6,12,1,2412,-88,-92,4,40:e3:d6:da:c8:02,14571739,180,26269,14571559,14571739
2303,6,12,1,2412,-89,-92,3,40:e3:d6:da:c8:03,14571962,184,39,14571778,14571962
2304,6,12,1,2412,-88,-92,4,40:e3:d6:da:c8:05,14572400,160,278,14572240,14572400
2305,6,6,1,2412,-87,-92,5,40:e3:d6:da:c8:06,14572601,380,-179,14572221,14572601
2306,4,1,1,2412,-69,-92,23,54:e4:3a:ec:fb:64,14584134,2160,9373,14581974,14584134
2307,6,6,1,2412,-54,-92,38,e6:aa:ea:c9:ea:33,14588459,408,3917,14588051,14588459
2308,6,6,1,2412,-54,-92,38,e6:aa:ea:c9:ea:33,14600571,408,11704,14600163,14600571
2309,4,1,1,2412,-77,-92,15,b8:3a:5a:88:e6:e1,14614755,2376,11808,14612379,14614755
2310,6,12,1,2412,-89,-92,3,84:d4:7e:f2:34:20,14617315,160,2400,14617155,14617315
2311,6,12,1,2412,-88,-92,4,84:d4:7e:f2:34:22,14617939,180,444,14617759,14617939
2312,6,6,1,2412,-88,-92,4,84:d4:7e:f2:34:26,14618787,380,468,14618407,14618787
2313,6,12,1,2412,-49,-92,43,40:e3:d6:da:ba:20,14627283,160,8336,14627123,14627283
2314,6,6,1,2412,-49,-92,43,40:e3:d6:da:ba:21,14627475,368,-176,14627107,14627475
2315,6,12,1,2412,-48,-92,44,40:e3:d6:da:ba:22,14627862,180,207,14627682,14627862
2316,6,12,1,2412,-49,-92,43,40:e3:d6:da:ba:23,14628077,184,31,14627893,14628077
2317,6,12,1,2412,-48,-92,44,40:e3:d6:da:ba:24,14628313,176,60,14628137,14628313
2318,6,12,1,2412,-48,-92,44,40:e3:d6:da:ba:25,14628542,160,69,14628382,14628542
2319,6,6,1,2412,-48,-92,44,40:e3:d6:da:ba:26,14628751,380,-171,14628371,14628751
2320,6,6,1,2412,-54,-92,38,e6:aa:ea:c9:ea:33,14636924,408,7765,14636516,14636924
2321,6,12,1,2412,-87,-92,5,40:e3:d6:da:ca:c3,14643027,180,5923,14642847,14643027
2322,6,12,1,2412,-88,-92,4,40:e3:d6:da:ca:c5,14643457,156,274,14643301,14643457
2323,6,6,1,2412,-86,-92,6,40:e3:d6:da:ca:c6,14643646,380,-191,14643266,14643646
2324,6,12,1,2412,-90,-92,2,40:e3:d6:da:c8:02,14674036,180,30210,14673856,14674036
2325,6,12,1,2412,-90,-92,2,40:e3:d6:da:c8:05,14675532,160,1336,14675372,14675532
2326,6,6,1,2412,-89,-92,3,40:e3:d6:da:c8:06,14675751,380,-161,14675371,14675751
2327,4,1,1,2412,-70,-92,22,54:e4:3a:ec:fb:64,14686535,2160,8624,14684375,14686535
2328,4,1,1,2412,-77,-92,15,b8:3a:5a:88:e6:e0,14713829,2360,24934,14711469,14713829
2329,4,1,1,2412,-81,-92,11,1c:bf:ce:04:6b:0c,14717678,928,2921,14716750,14717678
2330,4,1,1,2412,-81,-92,11,,14718623,304,641,14718319,14718623
2331,6,12,1,2412,-82,-92,10,,14723217,32,4562,14723185,14723217
2332,6,12,1,2412,-82,-92,10,,14724847,32,1598,14724815,14724847
2333,6,12,1,2412,-82,-92,10,,14725276,32,397,14725244,14725276
2334,6,12,1,2412,-82,-92,10,,14725502,32,194,14725470,14725502
2335,6,6,1,2412,-82,-92,10,,14726202,44,656,14726158,14726202
2336,6,12,1,2412,-81,-92,11,,14726479,32,245,14726447,14726479
2337,6,6,1,2412,-87,-92,5,40:e3:d6:da:bb:e6,14727817,380,958,14727437,14727817
2338,6,12,1,2412,-50,-92,42,40:e3:d6:da:ba:20,14729694,160,1717,14729534,14729694
2339,6,6,1,2412,-50,-92,42,40:e3:d6:da:ba:21,14729895,368,-167,14729527,14729895
2340,6,12,1,2412,-50,-92,42,40:e3:d6:da:ba:22,14730282,180,207,14730102,14730282
2341,6,12,1,2412,-50,-92,42,40:e3:d6:da:ba:24,14730724,176,266,14730548,14730724
2342,6,12,1,2412,-50,-92,42,40:e3:d6:da:ba:25,14730926,160,42,14730766,14730926
2343,6,6,1,2412,-50,-92,42,40:e3:d6:da:ba:26,14731145,380,-161,14730765,14731145
2344,6,6,1,2412,-74,-92,18,e6:aa:ea:b7:4a:dd,14755664,408,24111,14755256,14755664
2345,6,6,1,2412,-75,-92,17,e6:aa:ea:b7:4a:dd,14767977,408,11905,14767569,14767977
2346,4,1,1,2412,-74,-92,18,54:e4:3a:ec:fb:64,14788984,2160,18847,14786824,14788984
2347,6,12,1,2412,-90,-92,2,84:d4:7e:f2:34:20,14820130,160,30986,14819970,14820130
2348,6,12,1,2412,-88,-92,4,84:d4:7e:f2:34:23,14821047,180,737,14820867,14821047
2349,6,12,1,2412,-86,-92,6,40:e3:d6:da:bb:e0,14828768,156,7565,14828612,14828768
2350,6,12,1,2412,-87,-92,5,40:e3:d6:da:bb:e3,14829598,180,650,14829418,14829598
2351,6,12,1,2412,-52,-92,40,40:e3:d6:da:ba:20,14832090,160,2332,14831930,14832090
2352,6,6,1,2412,-52,-92,40,40:e3:d6:da:ba:21,14832309,368,-149,14831941,14832309
2353,6,12,1,2412,-52,-92,40,40:e3:d6:da:ba:22,14832705,180,216,14832525,14832705
2354,6,6,1,2412,-52,-92,40,40:e3:d6:da:ba:26,14833540,380,455,14833160,14833540
2355,6,12,1,2412,-84,-92,8,84:d4:7e:f2:42:24,14833939,176,223,14833763,14833939
2356,6,12,1,2412,-84,-92,8,84:d4:7e:f2:42:25,14834168,160,69,14834008,14834168
2357,6,6,1,2412,-83,-92,9,84:d4:7e:f2:42:26,14834378,380,-170,14833998,14834378
2358,6,12,1,2412,-88,-92,4,40:e3:d6:da:ca:c0,14847011,156,12477,14846855,14847011
2359,6,12,1,2412,-87,-92,5,40:e3:d6:da:ca:c2,14847622,176,435,14847446,14847622
2360,6,12,1,2412,-86,-92,6,40:e3:d6:da:ca:c3,14847841,180,39,14847661,14847841
2361,6,12,1,2412,-87,-92,5,40:e3:d6:da:ca:c4,14848056,172,43,14847884,14848056
2362,6,12,1,2412,-88,-92,4,40:e3:d6:da:ca:c5,14848253,156,41,14848097,14848253
2363,6,6,1,2412,-86,-92,6,40:e3:d6:da:ca:c6,14848450,380,-183,14848070,14848450
2364,4,1,1,2412,-75,-92,17,54:e4:3a:ec:fb:64,14891360,2160,40750,14889200,14891360
2365,4,1,1,2412,-76,-92,16,b8:3a:5a:88:e6:e0,14918464,2360,24744,14916104,14918464
2366,6,12,1,2412,-54,-92,38,40:e3:d6:da:ba:20,14934499,160,15875,14934339,14934499
2367,6,6,1,2412,-54,-92,38,40:e3:d6:da:ba:21,14934691,368,-176,14934323,14934691
2368,6,12,1,2412,-54,-92,38,40:e3:d6:da:ba:22,14935104,180,233,14934924,14935104
2369,6,12,1,2412,-53,-92,39,40:e3:d6:da:ba:24,14935547,176,267,14935371,14935547
2370,6,12,1,2412,-53,-92,39,40:e3:d6:da:ba:25,14935757,160,50,14935597,14935757
2371,6,6,1,2412,-53,-92,39,40:e3:d6:da:ba:26,14935967,380,-170,14935587,14935967
2372,6,6,1,2412,-85,-92,7,e6:aa:ea:c9:ea:1b,14943161,408,6786,14942753,14943161
2373,6,12,1,2412,-88,-92,4,40:e3:d6:da:ca:c0,14949442,156,6125,14949286,14949442
2374,6,6,1,2412,-88,-92,4,40:e3:d6:da:ca:c1,14949657,368,-153,14949289,14949657
2375,6,12,1,2412,-87,-92,5,40:e3:d6:da:ca:c3,14950455,180,618,14950275,14950455
2376,6,12,1,2412,-89,-92,3,40:e3:d6:da:ca:c4,14950687,172,60,14950515,14950687
2377,6,12,1,2412,-88,-92,4,40:e3:d6:da:ca:c5,14950903,156,60,14950747,14950903
2378,6,6,1,2412,-88,-92,4,40:e3:d6:da:ca:c6,14951091,380,-192,14950711,14951091
2379,6,6,1,2412,-84,-92,8,e6:aa:ea:c9:ea:1b,14955170,408,3671,14954762,14955170
2380,6,6,1,2412,-86,-92,6,e6:aa:ea:c9:ea:1b,14991519,408,35941,14991111,14991519
2381,6,12,1,2412,-91,-92,1,84:d4:7e:f2:34:20,15028209,160,36530,15028049,15028209
2382,6,12,1,2412,-88,-92,4,84:d4:7e:f2:34:22,15028815,180,426,15028635,15028815
2383,6,12,1,2412,-89,-92,3,84:d4:7e:f2:34:25,15029480,160,505,15029320,15029480
2384,6,6,1,2412,-88,-92,4,84:d4:7e:f2:34:26,15029672,380,-188,15029292,15029672
2385,6,6,1,2412,-89,-92,3,40:e3:d6:da:bb:e6,15035042,380,4990,15034662,15035042
2386,4,1,1,2412,-77,-92,15,c0:c9:e3:4d:6e:bf,15036187,872,273,15035315,15036187
2387,4,1,1,2412,-77,-92,15,,15037076,304,585,15036772,15037076
2388,6,12,1,2412,-54,-92,38,40:e3:d6:da:ba:20,15037230,160,-6,15037070,15037230
2389,6,6,1,2412,-54,-92,38,40:e3:d6:da:ba:21,15037449,368,-149,15037081,15037449
2390,6,12,1,2412,-54,-92,38,40:e3:d6:da:ba:22,15037863,180,234,15037683,15037863
2391,6,12,1,2412,-54,-92,38,40:e3:d6:da:ba:23,15038096,184,49,15037912,15038096
2392,6,12,1,2412,-54,-92,38,40:e3:d6:da:ba:24,15038332,176,60,15038156,15038332
2393,6,12,1,2412,-54,-92,38,40:e3:d6:da:ba:25,15038561,160,69,15038401,15038561
2394,6,6,1,2412,-54,-92,38,40:e3:d6:da:ba:26,15038770,380,-171,15038390,15038770
2395,6,6,1,2412,-84,-92,8,84:d4:7e:f2:42:26,15039180,380,30,15038800,15039180
2396,6,6,1,2412,-87,-92,5,40:e3:d6:da:ca:c1,15055235,368,15687,15054867,15055235
2397,6,12,1,2412,-88,-92,4,40:e3:d6:da:ca:c2,15055621,176,210,15055445,15055621
2398,6,12,1,2412,-88,-92,4,40:e3:d6:da:ca:c3,15055823,180,22,15055643,15055823
2399,6,12,1,2412,-87,-92,5,40:e3:d6:da:ca:c4,15056038,172,43,15055866,15056038
2400,6,12,1,2412,-89,-92,3,40:e3:d6:da:ca:c5,15056244,156,50,15056088,15056244
2401,6,6,1,2412,-88,-92,4,40:e3:d6:da:ca:c6,15056441,380,-183,15056061,15056441
2402,4,1,1,2412,-80,-92,12,1c:bf:ce:04:6b:0c,15070968,928,13599,15070040,15070968
2403,4,1,1,2412,-80,-92,12,1c:bf:ce:04:6b:0c,15071936,928,40,15071008,15071936
2404,4,1,1,2412,-80,-92,12,1c:bf:ce:04:6b:0c,15072951,928,87,15072023,15072951
2405,4,1,1,2412,-77,-92,15,,15073896,304,641,15073592,15073896
2406,6,6,1,2412,-91,-92,1,40:e3:d6:da:c8:01,15079259,348,5015,15078911,15079259
2407,4,1,1,2412,-74,-92,18,c0:c9:e3:4d:6e:bf,15080431,872,300,15079559,15080431
2408,4,1,1,2412,-77,-92,15,,15081320,304,585,15081016,15081320
2409,4,1,1,2412,-79,-92,13,a6:e5:7c:28:b1:d3,15081667,944,-597,15080723,15081667
2410,4,1,1,2412,-79,-92,13,,15082630,304,659,15082326,15082630
2411,4,1,1,2412,-79,-92,13,a6:e5:7c:28:b1:d3,15083006,944,-568,15082062,15083006
2412,4,1,1,2412,-79,-92,13,,15083969,304,659,15083665,15083969
2413,4,1,1,2412,-79,-92,13,a6:e5:7c:28:b1:d3,15085132,944,219,15084188,15085132
2414,4,1,1,2412,-73,-92,19,54:e4:3a:ec:fb:64,15095999,2160,8707,15093839,15095999
2415,6,6,1,2412,-51,-92,41,e6:aa:ea:c9:ea:33,15109809,408,13402,15109401,15109809
2416,6,6,1,2412,-51,-92,41,e6:aa:ea:c9:ea:33,15121944,408,11727,15121536,15121944
2417,4,1,1,2412,-76,-92,16,b8:3a:5a:88:e6:e0,15123282,2360,-1022,15120922,15123282
2418,6,6,1,2412,-88,-92,4,84:d4:7e:f2:34:26,15129713,380,6051,15129333,15129713
2419,6,6,1,2412,-51,-92,41,e6:aa:ea:c9:ea:33,15134053,408,3932,15133645,15134053
2420,6,12,1,2412,-88,-92,4,40:e3:d6:da:bb:e3,15137435,180,3202,15137255,15137435
2421,6,12,1,2412,-88,-92,4,40:e3:d6:da:bb:e4,15137659,172,52,15137487,15137659
2422,6,12,1,2412,-89,-92,3,40:e3:d6:da:bb:e5,15137857,156,42,15137701,15137857
2423,6,6,1,2412,-87,-92,5,40:e3:d6:da:bb:e6,15138053,380,-184,15137673,15138053
2424,6,12,1,2412,-55,-92,37,40:e3:d6:da:ba:20,15139471,160,1258,15139311,15139471
2425,6,6,1,2412,-55,-92,37,40:e3:d6:da:ba:21,15139672,368,-167,15139304,15139672
2426,6,12,1,2412,-55,-92,37,40:e3:d6:da:ba:22,15140077,180,225,15139897,15140077
2427,6,12,1,2412,-54,-92,38,40:e3:d6:da:ba:23,15140309,184,48,15140125,15140309
2428,6,12,1,2412,-55,-92,37,40:e3:d6:da:ba:24,15140528,176,43,15140352,15140528
2429,6,12,1,2412,-55,-92,37,40:e3:d6:da:ba:25,15140738,160,50,15140578,15140738
2430,6,12,1,2412,-83,-92,9,84:d4:7e:f2:42:25,15141353,160,455,15141193,15141353
2431,6,6,1,2412,-83,-92,9,84:d4:7e:f2:42:26,15141572,380,-161,15141192,15141572
2432,6,6,1,2412,-51,-92,41,e6:aa:ea:c9:ea:33,15146163,408,4183,15145755,15146163
2433,6,6,1,2412,-51,-92,41,e6:aa:ea:c9:ea:33,15158283,408,11712,15157875,15158283
2434,6,6,1,2412,-91,-92,1,40:e3:d6:da:c8:01,15185746,368,27095,15185378,15185746
2435,4,1,1,2412,-79,-92,13,a6:e5:7c:28:b1:d3,15186315,992,-423,15185323,15186315
2436,4,1,1,2412,-73,-92,19,54:e4:3a:ec:fb:64,15198887,2160,10412,15196727,15198887
2437,4,1,1,2412,-78,-92,14,b8:3a:5a:88:e6:e0,15225681,2360,24434,15223321,15225681
2438,4,1,1,2412,-80,-92,12,b8:3a:5a:88:e6:e1,15228144,2376,87,15225768,15228144
2439,6,12,1,2412,-87,-92,5,84:d4:7e:f2:34:24,15231411,176,3091,15231235,15231411
2440,6,12,1,2412,-89,-92,3,84:d4:7e:f2:34:25,15231623,160,52,15231463,15231623
2441,6,12,1,2412,-87,-92,5,40:e3:d6:da:bb:e5,15239630,156,7851,15239474,15239630
2442,6,6,1,2412,-58,-92,34,40:e3:d6:da:ba:21,15241874,368,1876,15241506,15241874
2443,6,12,1,2412,-57,-92,35,40:e3:d6:da:ba:22,15242279,180,225,15242099,15242279
2444,6,12,1,2412,-55,-92,37,40:e3:d6:da:ba:24,15242703,176,248,15242527,15242703
2445,6,12,1,2412,-55,-92,37,40:e3:d6:da:ba:25,15242932,160,69,15242772,15242932
2446,6,6,1,2412,-55,-92,37,40:e3:d6:da:ba:26,15243142,380,-170,15242762,15243142
2447,6,12,1,2412,-84,-92,8,84:d4:7e:f2:42:24,15243523,176,205,15243347,15243523
2448,6,12,1,2412,-84,-92,8,84:d4:7e:f2:42:25,15243733,160,50,15243573,15243733
2449,6,12,1,2412,-87,-92,5,40:e3:d6:da:ca:c2,15257213,176,13304,15257037,15257213
2450,6,12,1,2412,-86,-92,6,40:e3:d6:da:ca:c4,15257638,172,253,15257466,15257638
2451,6,12,1,2412,-87,-92,5,40:e3:d6:da:ca:c5,15257854,156,60,15257698,15257854
2452,4,1,1,2412,-72,-92,20,54:e4:3a:ec:fb:64,15300962,2160,40948,15298802,15300962
2453,4,1,1,2412,-79,-92,13,b8:3a:5a:88:e6:e0,15328233,2360,24911,15325873,15328233
2454,6,12,1,2412,-88,-92,4,84:d4:7e:f2:34:20,15333209,160,4816,15333049,15333209
2455,6,6,1,2412,-88,-92,4,84:d4:7e:f2:34:21,15333428,368,-149,15333060,15333428
2456,6,12,1,2412,-87,-92,5,84:d4:7e:f2:34:24,15334271,176,667,15334095,15334271
2457,6,6,1,2412,-88,-92,4,84:d4:7e:f2:34:26,15335291,380,640,15334911,15335291
2458,4,1,1,2412,-68,-92,24,fa:eb:a9:1e:c0:3a,15336166,1128,-253,15335038,15336166
2459,4,1,1,2412,-67,-92,25,54:e4:3a:ec:fb:64,15337576,2112,-702,15335464,15337576
2460,6,12,1,2412,-88,-92,4,40:e3:d6:da:ca:c0,15339669,136,1957,15339533,15339669
2461,4,1,1,2412,-71,-92,21,54:e4:3a:ec:fb:64,15340065,2112,-1716,15337953,15340065
2462,6,12,1,2412,-54,-92,38,40:e3:d6:da:ba:20,15344097,160,3872,15343937,15344097
2463,6,12,1,2412,-55,-92,37,40:e3:d6:da:ba:22,15344703,180,426,15344523,15344703
2464,6,12,1,2412,-55,-92,37,40:e3:d6:da:ba:24,15345136,176,257,15344960,15345136
2465,6,12,1,2412,-54,-92,38,40:e3:d6:da:ba:25,15345337,160,41,15345177,15345337
2466,6,6,1,2412,-86,-92,6,e6:aa:ea:c9:ea:1b,15400010,408,54265,15399602,15400010
2467,4,1,1,2412,-70,-92,22,54:e4:3a:ec:fb:64,15403396,2160,1226,15401236,15403396
2468,6,6,1,2412,-51,-92,41,e6:aa:ea:c9:ea:33,15426176,408,22372,15425768,15426176
2469,6,6,1,2412,-85,-92,7,84:d4:7e:f2:34:21,15437381,368,10837,15437013,15437381
2470,6,12,1,2412,-86,-92,6,84:d4:7e:f2:34:22,15437768,180,207,15437588,15437768
2471,6,6,1,2412,-54,-92,38,e6:aa:ea:c9:ea:33,15438294,408,118,15437886,15438294
2472,6,12,1,2412,-87,-92,5,40:e3:d6:da:bb:e3,15444061,180,5587,15443881,15444061
2473,6,12,1,2412,-88,-92,4,40:e3:d6:da:bb:e5,15444516,156,299,15444360,15444516
2474,6,6,1,2412,-87,-92,5,40:e3:d6:da:bb:e6,15444704,380,-192,15444324,15444704
2475,6,12,1,2412,-52,-92,40,40:e3:d6:da:ba:20,15446487,160,1623,15446327,15446487
2476,6,6,1,2412,-51,-92,41,40:e3:d6:da:ba:21,15446697,368,-158,15446329,15446697
2477,6,12,1,2412,-51,-92,41,40:e3:d6:da:ba:24,15447535,176,662,15447359,15447535
2478,6,12,1,2412,-51,-92,41,40:e3:d6:da:ba:25,15447736,160,41,15447576,15447736
2479,6,6,1,2412,-51,-92,41,40:e3:d6:da:ba:26,15447946,380,-170,15447566,15447946
2480,6,12,1,2412,-87,-92,5,84:d4:7e:f2:42:24,15448343,176,221,15448167,15448343
2481,6,12,1,2412,-86,-92,6,84:d4:7e:f2:42:25,15448563,160,60,15448403,15448563
2482,6,6,1,2412,-86,-92,6,84:d4:7e:f2:42:26,15448781,380,-162,15448401,15448781
2483,6,6,1,2412,-55,-92,37,e6:aa:ea:c9:ea:33,15450405,408,1216,15449997,15450405
2484,6,6,1,2412,-55,-92,37,e6:aa:ea:c9:ea:33,15474777,408,23964,15474369,15474777
2485,4,1,1,2412,-76,-92,16,a6:e5:7c:28:b1:d3,15500453,992,24684,15499461,15500453
2486,6,12,1,2412,-84,-92,8,84:d4:7e:f2:34:23,15508943,160,8330,15508783,15508943
2487,6,12,1,2412,-86,-92,6,84:d4:7e:f2:34:20,15536930,160,27827,15536770,15536930
2488,6,12,1,2412,-85,-92,7,84:d4:7e:f2:34:22,15537527,180,417,15537347,15537527
2489,6,12,1,2412,-85,-92,7,84:d4:7e:f2:34:23,15537733,180,26,15537553,15537733
2490,6,12,1,2412,-86,-92,6,84:d4:7e:f2:34:24,15537965,176,56,15537789,15537965
2491,6,12,1,2412,-86,-92,6,84:d4:7e:f2:34:25,15538175,160,50,15538015,15538175
2492,6,6,1,2412,-85,-92,7,84:d4:7e:f2:34:26,15538376,380,-179,15537996,15538376
2493,6,12,1,2412,-51,-92,41,40:e3:d6:da:ba:20,15548899,160,10363,15548739,15548899
2494,6,6,1,2412,-51,-92,41,40:e3:d6:da:ba:21,15549100,368,-167,15548732,15549100
2495,6,12,1,2412,-51,-92,41,40:e3:d6:da:ba:22,15549521,180,241,15549341,15549521
2496,6,12,1,2412,-51,-92,41,40:e3:d6:da:ba:23,15549744,184,39,15549560,15549744
2497,6,12,1,2412,-51,-92,41,40:e3:d6:da:ba:24,15549981,176,61,15549805,15549981
2498,6,12,1,2412,-51,-92,41,40:e3:d6:da:ba:25,15550200,160,59,15550040,15550200
2499,6,6,1,2412,-51,-92,41,40:e3:d6:da:ba:26,15550410,380,-170,15550030,15550410
2500,6,6,1,2412,-88,-92,4,84:d4:7e:f2:42:26,15551147,380,357,15550767,15551147
2501,6,12,1,2412,-89,-92,3,40:e3:d6:da:ca:c5,15565110,156,13807,15564954,15565110
2502,6,6,1,2412,-88,-92,4,40:e3:d6:da:ca:c6,15565326,380,-164,15564946,15565326
2503,4,1,1,2412,-80,-92,12,,15571302,304,5672,15570998,15571302
2504,4,1,1,2412,-74,-92,18,a6:e5:7c:28:b1:d3,15594754,992,22460,15593762,15594754
2505,4,1,1,2412,-78,-92,14,b8:3a:5a:88:e6:e1,15637691,2376,40561,15635315,15637691
2506,6,6,1,2412,-52,-92,40,40:e3:d6:da:ba:21,15651516,368,13457,15651148,15651516
2507,6,12,1,2412,-51,-92,41,40:e3:d6:da:ba:23,15652145,184,445,15651961,15652145
2508,6,12,1,2412,-52,-92,40,40:e3:d6:da:ba:24,15652354,176,33,15652178,15652354
2509,6,12,1,2412,-51,-92,41,40:e3:d6:da:ba:25,15652555,160,41,15652395,15652555
2510,6,6,1,2412,-52,-92,40,40:e3:d6:da:ba:26,15652747,380,-188,15652367,15652747
2511,6,6,1,2412,-82,-92,10,84:1b:5e:df:1b:99,15655896,80,3069,15655816,15655896
2512,6,12,1,2412,-88,-92,4,40:e3:d6:da:ca:c0,15666201,156,10149,15666045,15666201
2513,6,12,1,2412,-86,-92,6,40:e3:d6:da:ca:c5,15667460,156,1103,15667304,15667460
2514,6,6,1,2412,-88,-92,4,40:e3:d6:da:ca:c6,15667647,380,-193,15667267,15667647
2515,6,6,1,2412,-89,-92,3,e6:aa:ea:c9:ea:1b,15692895,408,24840,15692487,15692895
2516,4,1,1,2412,-74,-92,18,a6:e5:7c:28:b1:d3,15696957,992,3070,15695965,15696957
2517,4,1,1,2412,-68,-92,24,54:e4:3a:ec:fb:64,15710570,2160,11453,15708410,15710570
2518,6,12,1,2412,-87,-92,5,84:d4:7e:f2:34:22,15720089,160,9359,15719929,15720089
2519,4,1,1,2412,-76,-92,16,b8:3a:5a:88:e6:e0,15737690,2360,15241,15735330,15737690
2520,6,12,1,2412,-87,-92,5,40:e3:d6:da:bb:e0,15750371,156,12525,15750215,15750371
2521,6,12,1,2412,-88,-92,4,40:e3:d6:da:bb:e4,15751605,172,1062,15751433,15751605
2522,6,12,1,2412,-84,-92,8,40:e3:d6:da:bb:e5,15752223,156,462,15752067,15752223
2523,6,6,1,2412,-81,-92,11,40:e3:d6:da:bb:e6,15752429,380,-174,15752049,15752429
2524,6,6,1,2412,-54,-92,38,e6:aa:ea:c9:ea:33,15753269,408,432,15752861,15753269
2525,6,12,1,2412,-52,-92,40,40:e3:d6:da:ba:20,15753715,160,286,15753555,15753715
2526,6,6,1,2412,-52,-92,40,40:e3:d6:da:ba:21,15753934,368,-149,15753566,15753934
2527,6,12,1,2412,-52,-92,40,40:e3:d6:da:ba:22,15754339,180,225,15754159,15754339
2528,6,12,1,2412,-51,-92,41,40:e3:d6:da:ba:23,15754553,184,30,15754369,15754553
2529,6,12,1,2412,-51,-92,41,40:e3:d6:da:ba:24,15754781,176,52,15754605,15754781
2530,6,12,1,2412,-52,-92,40,40:e3:d6:da:ba:25,15754982,160,41,15754822,15754982
2531,6,6,1,2412,-52,-92,40,40:e3:d6:da:ba:26,15755174,380,-188,15754794,15755174
2532,6,6,1,2412,-85,-92,7,84:d4:7e:f2:42:26,15755984,380,430,15755604,15755984
2533,6,6,1,2412,-54,-92,38,e6:aa:ea:c9:ea:33,15765379,408,8987,15764971,15765379
2534,6,12,1,2412,-88,-92,4,40:e3:d6:da:ca:c2,15769265,176,3710,15769089,15769265
2535,6,12,1,2412,-89,-92,3,40:e3:d6:da:ca:c3,15769476,180,31,15769296,15769476
2536,6,12,1,2412,-88,-92,4,40:e3:d6:da:ca:c4,15769691,172,43,15769519,15769691
2537,6,12,1,2412,-87,-92,5,40:e3:d6:da:ca:c5,15769897,156,50,15769741,15769897
2538,6,6,1,2412,-79,-92,13,e6:aa:ea:b7:4a:dd,15771342,408,1037,15770934,15771342
2539,6,6,1,2412,-54,-92,38,e6:aa:ea:c9:ea:33,15777511,408,5761,15777103,15777511
2540,4,1,1,2412,-85,-92,7,,15787223,304,9408,15786919,15787223
2541,6,6,1,2412,-54,-92,38,e6:aa:ea:c9:ea:33,15789633,408,2002,15789225,15789633
2542,6,6,1,2412,-74,-92,18,e6:aa:ea:b7:4a:dd,15795573,408,5532,15795165,15795573
2543,4,1,1,2412,-73,-92,19,a6:e5:7c:28:b1:d3,15800778,992,4213,15799786,15800778
2544,6,12,1,2412,-89,-92,3,40:e3:d6:da:c8:03,15801629,184,667,15801445,15801629
2545,6,12,1,2412,-89,-92,3,40:e3:d6:da:c8:04,15801857,176,52,15801681,15801857
2546,6,12,1,2412,-89,-92,3,40:e3:d6:da:c8:05,15802076,160,59,15801916,15802076
2547,6,6,1,2412,-88,-92,4,40:e3:d6:da:c8:06,15802295,380,-161,15801915,15802295
2548,4,1,1,2412,-84,-92,8,,15807488,304,4889,15807184,15807488
2549,4,1,1,2412,-70,-92,22,54:e4:3a:ec:fb:64,15812954,2160,3306,15810794,15812954
2550,6,12,1,2412,-87,-92,5,40:e3:d6:da:bb:e2,15853473,176,40343,15853297,15853473
2551,6,6,1,2412,-53,-92,39,40:e3:d6:da:ba:21,15856522,368,2681,15856154,15856522
2552,6,12,1,2412,-53,-92,39,40:e3:d6:da:ba:22,15859184,180,2482,15859004,15859184
2553,6,12,1,2412,-53,-92,39,40:e3:d6:da:ba:23,15859408,184,40,15859224,15859408
2554,6,12,1,2412,-53,-92,39,40:e3:d6:da:ba:24,15859626,176,42,15859450,15859626
2555,6,12,1,2412,-54,-92,38,40:e3:d6:da:ba:25,15859828,160,42,15859668,15859828
2556,6,6,1,2412,-53,-92,39,40:e3:d6:da:ba:26,15860564,380,356,15860184,15860564
2557,6,12,1,2412,-89,-92,3,40:e3:d6:da:ca:c0,15871020,156,10300,15870864,15871020
2558,6,6,1,2412,-88,-92,4,40:e3:d6:da:ca:c1,15871235,368,-153,15870867,15871235
2559,6,6,1,2412,-87,-92,5,40:e3:d6:da:c8:01,15902594,368,30991,15902226,15902594
2560,4,1,1,2412,-69,-92,23,54:e4:3a:ec:fb:64,15915367,2160,10613,15913207,15915367
2561,4,1,1,2412,-76,-92,16,b8:3a:5a:88:e6:e1,15945540,2376,27797,15943164,15945540
2562,6,12,1,2412,-87,-92,5,84:d4:7e:f2:34:20,15947794,160,2094,15947634,15947794
2563,6,6,1,2412,-85,-92,7,84:d4:7e:f2:34:21,15947985,368,-177,15947617,15947985
2564,6,12,1,2412,-86,-92,6,84:d4:7e:f2:34:22,15948399,180,234,15948219,15948399
2565,6,12,1,2412,-86,-92,6,40:e3:d6:da:bb:e0,15955182,156,6627,15955026,15955182
2566,6,6,1,2412,-86,-92,6,40:e3:d6:da:bb:e1,15955388,368,-162,15955020,15955388
2567,6,12,1,2412,-87,-92,5,40:e3:d6:da:bb:e2,15955794,176,230,15955618,15955794
2568,6,12,1,2412,-88,-92,4,40:e3:d6:da:bb:e3,15956022,180,48,15955842,15956022
2569,6,12,1,2412,-88,-92,4,40:e3:d6:da:bb:e4,15956245,172,51,15956073,15956245
2570,6,6,1,2412,-87,-92,5,40:e3:d6:da:bb:e6,15956649,380,24,15956269,15956649
2571,6,12,1,2412,-54,-92,38,40:e3:d6:da:ba:20,15958497,160,1688,15958337,15958497
2572,6,6,1,2412,-53,-92,39,40:e3:d6:da:ba:21,15958698,368,-167,15958330,15958698
2573,6,12,1,2412,-53,-92,39,40:e3:d6:da:ba:22,15959085,180,207,15958905,15959085
2574,6,12,1,2412,-54,-92,38,40:e3:d6:da:ba:23,15959290,184,21,15959106,15959290
2575,6,12,1,2412,-53,-92,39,40:e3:d6:da:ba:25,15959746,160,296,15959586,15959746
2576,6,6,1,2412,-53,-92,39,40:e3:d6:da:ba:26,15959965,380,-161,15959585,15959965
2577,6,12,1,2412,-84,-92,8,84:d4:7e:f2:42:24,15960403,176,262,15960227,15960403
2578,6,12,1,2412,-85,-92,7,84:d4:7e:f2:42:25,15960615,160,52,15960455,15960615
2579,6,12,1,2412,-88,-92,4,40:e3:d6:da:ca:c4,15974477,172,13690,15974305,15974477
2580,4,1,1,2412,-70,-92,22,54:e4:3a:ec:fb:64,16005702,2112,29113,16003590,16005702
2581,4,1,1,2412,-70,-92,22,54:e4:3a:ec:fb:64,16009038,2112,1224,16006926,16009038
2582,4,1,1,2412,-71,-92,21,54:e4:3a:ec:fb:64,16011824,2112,674,16009712,16011824
2583,4,1,1,2412,-62,-92,30,c0:c9:e3:4d:6e:bf,16016043,872,3347,16015171,16016043
2584,4,1,1,2412,-60,-92,32,,16016932,304,585,16016628,16016932
2585,4,1,1,2412,-63,-92,29,54:e4:3a:ec:fb:64,16017592,2160,-1500,16015432,16017592
2586,4,1,1,2412,-73,-92,19,b8:3a:5a:88:e6:e0,16044878,2360,24926,16042518,16044878
2587,4,1,1,2412,-72,-92,20,b8:3a:5a:88:e6:e1,16047276,2376,22,16044900,16047276
2588,4,1,1,2412,-77,-92,15,f8:89:d2:65:d2:3b,16052502,1048,4178,16051454,16052502
2589,6,12,1,2412,-53,-92,39,40:e3:d6:da:ba:20,16055955,136,3317,16055819,16055955
2590,6,6,1,2412,-53,-92,39,40:e3:d6:da:ba:21,16056132,348,-171,16055784,16056132
2591,6,12,1,2412,-53,-92,39,40:e3:d6:da:ba:23,16056752,156,464,16056596,16056752
2592,6,12,1,2412,-53,-92,39,40:e3:d6:da:ba:25,16056943,136,55,16056807,16056943
2593,6,6,1,2412,-54,-92,38,e6:aa:ea:c9:ea:33,16057156,408,-195,16056748,16057156
2594,4,1,1,2412,-64,-92,28,54:e4:3a:ec:fb:64,16058016,2112,-1252,16055904,16058016
2595,4,1,1,2412,-70,-92,22,54:e4:3a:ec:fb:64,16060724,2112,596,16058612,16060724
2596,4,1,1,2412,-74,-92,18,,16062954,304,1926,16062650,16062954
2597,6,12,1,2412,-53,-92,39,40:e3:d6:da:ba:20,16063118,160,4,16062958,16063118
2598,6,6,1,2412,-53,-92,39,40:e3:d6:da:ba:21,16063310,368,-176,16062942,16063310
2599,6,12,1,2412,-53,-92,39,40:e3:d6:da:ba:22,16063715,180,225,16063535,16063715
2600,6,12,1,2412,-53,-92,39,40:e3:d6:da:ba:23,16063938,184,39,16063754,16063938
2601,6,12,1,2412,-53,-92,39,40:e3:d6:da:ba:24,16064148,176,34,16063972,16064148
2602,6,12,1,2412,-53,-92,39,40:e3:d6:da:ba:25,16064349,160,41,16064189,16064349
2603,6,6,1,2412,-53,-92,39,40:e3:d6:da:ba:26,16064550,380,-179,16064170,16064550
2604,6,12,1,2412,-87,-92,5,40:e3:d6:da:ca:c0,16075801,156,11095,16075645,16075801
2605,6,6,1,2412,-86,-92,6,40:e3:d6:da:ca:c1,16075997,368,-172,16075629,16075997
2606,6,6,1,2412,-54,-92,38,e6:aa:ea:c9:ea:33,16080622,408,4217,16080214,16080622
2607,6,6,1,2412,-54,-92,38,e6:aa:ea:c9:ea:33,16092703,408,11673,16092295,16092703
2608,6,6,1,2412,-54,-92,38,e6:aa:ea:c9:ea:33,16104692,408,11581,16104284,16104692
2609,6,6,1,2412,-85,-92,7,40:e3:d6:da:c8:01,16107969,368,2909,16107601,16107969
2610,6,12,1,2412,-88,-92,4,40:e3:d6:da:c8:03,16108570,184,417,16108386,16108570
2611,4,1,1,2412,-65,-92,27,54:e4:3a:ec:fb:64,16120144,2160,9414,16117984,16120144
2612,6,6,1,2412,-90,-92,2,40:e3:d6:da:c8:01,16146303,348,25811,16145955,16146303
2613,4,1,1,2412,-76,-92,16,b8:3a:5a:88:e6:e0,16147277,2360,-1386,16144917,16147277
2614,4,1,1,2412,-74,-92,18,b8:3a:5a:88:e6:e1,16149656,2376,3,16147280,16149656
2615,6,12,1,2412,-89,-92,3,84:d4:7e:f2:34:24,16153580,176,3748,16153404,16153580
2616,6,12,1,2412,-89,-92,3,84:d4:7e:f2:34:25,16153799,160,59,16153639,16153799
2617,6,6,1,2412,-89,-92,3,84:d4:7e:f2:34:26,16154018,380,-161,16153638,16154018
2618,6,12,1,2412,-88,-92,4,40:e3:d6:da:bb:e2,16160589,176,6395,16160413,16160589
2619,6,12,1,2412,-88,-92,4,40:e3:d6:da:bb:e5,16161266,156,521,16161110,16161266
2620,6,6,1,2412,-87,-92,5,40:e3:d6:da:bb:e6,16161462,380,-184,16161082,16161462
2621,6,12,1,2412,-53,-92,39,40:e3:d6:da:ba:20,16163295,160,1673,16163135,16163295
2622,6,6,1,2412,-53,-92,39,40:e3:d6:da:ba:21,16163487,368,-176,16163119,16163487
2623,6,12,1,2412,-53,-92,39,40:e3:d6:da:ba:22,16163874,180,207,16163694,16163874
2624,6,12,1,2412,-53,-92,39,40:e3:d6:da:ba:23,16164106,184,48,16163922,16164106
2625,6,12,1,2412,-53,-92,39,40:e3:d6:da:ba:24,16164325,176,43,16164149,16164325
2626,6,12,1,2412,-53,-92,39,40:e3:d6:da:ba:25,16164553,160,68,16164393,16164553
2627,6,6,1,2412,-53,-92,39,40:e3:d6:da:ba:26,16164763,380,-170,16164383,16164763
2628,6,12,1,2412,-85,-92,7,84:d4:7e:f2:42:24,16165144,176,205,16164968,16165144
2629,6,12,1,2412,-84,-92,8,84:d4:7e:f2:42:25,16165346,160,42,16165186,16165346
2630,6,6,1,2412,-85,-92,7,84:d4:7e:f2:42:26,16165547,380,-179,16165167,16165547
2631,6,12,1,2412,-86,-92,6,40:e3:d6:da:ca:c0,16178217,156,12514,16178061,16178217
2632,6,12,1,2412,-84,-92,8,40:e3:d6:da:ca:c2,16178810,176,417,16178634,16178810
2633,6,12,1,2412,-88,-92,4,40:e3:d6:da:ca:c3,16179039,180,49,16178859,16179039
2634,6,12,1,2412,-88,-92,4,40:e3:d6:da:ca:c4,16179262,172,51,16179090,16179262
2635,6,6,1,2412,-86,-92,6,e6:aa:ea:c9:ea:1b,16203150,408,23480,16202742,16203150
2636,6,12,1,2412,-89,-92,3,40:e3:d6:da:c8:03,16210233,184,6899,16210049,16210233
2637,6,6,1,2412,-89,-92,3,40:e3:d6:da:c8:06,16210844,380,231,16210464,16210844
2638,6,6,1,2412,-86,-92,6,e6:aa:ea:c9:ea:1b,16215359,408,4107,16214951,16215359
2639,4,1,1,2412,-68,-92,24,54:e4:3a:ec:fb:64,16223050,2160,5531,16220890,16223050
2640,4,1,1,2412,-57,-92,35,b8:3a:5a:88:e6:e0,16249724,2360,24314,16247364,16249724
2641,4,1,1,2412,-77,-92,15,b8:3a:5a:88:e6:e1,16252104,2376,4,16249728,16252104
2642,6,12,1,2412,-89,-92,3,84:d4:7e:f2:34:20,16254654,160,2390,16254494,16254654
2643,6,6,1,2412,-88,-92,4,84:d4:7e:f2:34:21,16254847,368,-175,16254479,16254847
2644,6,12,1,2412,-88,-92,4,84:d4:7e:f2:34:22,16255234,180,207,16255054,16255234
2645,6,12,1,2412,-87,-92,5,84:d4:7e:f2:34:23,16255439,180,25,16255259,16255439
2646,6,6,1,2412,-88,-92,4,84:d4:7e:f2:34:26,16256056,380,237,16255676,16256056
2647,6,12,1,2412,-87,-92,5,40:e3:d6:da:bb:e0,16262398,156,6186,16262242,16262398
2648,6,12,1,2412,-87,-92,5,40:e3:d6:da:bb:e2,16263018,176,444,16262842,16263018
2649,6,12,1,2412,-87,-92,5,40:e3:d6:da:bb:e3,16263229,180,31,16263049,16263229
2650,6,12,1,2412,-87,-92,5,40:e3:d6:da:bb:e4,16263434,172,33,16263262,16263434
2651,6,12,1,2412,-83,-92,9,40:e3:d6:da:bb:e5,16263649,156,59,16263493,16263649
2652,6,6,1,2412,-88,-92,4,40:e3:d6:da:bb:e6,16263846,380,-183,16263466,16263846
2653,6,12,1,2412,-51,-92,41,40:e3:d6:da:ba:20,16265698,160,1692,16265538,16265698
2654,6,12,1,2412,-50,-92,42,40:e3:d6:da:ba:22,16266276,180,398,16266096,16266276
2655,6,12,1,2412,-50,-92,42,40:e3:d6:da:ba:23,16266491,184,31,16266307,16266491
2656,6,12,1,2412,-50,-92,42,40:e3:d6:da:ba:25,16266956,160,305,16266796,16266956
2657,6,6,1,2412,-50,-92,42,40:e3:d6:da:ba:26,16267148,380,-188,16266768,16267148
2658,6,12,1,2412,-84,-92,8,84:d4:7e:f2:42:24,16267535,176,211,16267359,16267535
2659,6,12,1,2412,-85,-92,7,84:d4:7e:f2:42:25,16267736,160,41,16267576,16267736
2660,6,6,1,2412,-74,-92,18,e6:aa:ea:b7:4a:dd,16278556,408,10412,16278148,16278556
2661,6,6,1,2412,-84,-92,8,40:e3:d6:da:ca:c1,16280823,368,1899,16280455,16280823
2662,6,12,1,2412,-85,-92,7,40:e3:d6:da:ca:c2,16281228,176,229,16281052,16281228
2663,6,12,1,2412,-85,-92,7,40:e3:d6:da:ca:c3,16281448,180,40,16281268,16281448
2664,6,12,1,2412,-85,-92,7,40:e3:d6:da:ca:c4,16281671,172,51,16281499,16281671
2665,6,12,1,2412,-85,-92,7,40:e3:d6:da:ca:c5,16281887,156,60,16281731,16281887
2666,6,6,1,2412,-86,-92,6,40:e3:d6:da:ca:c6,16282093,380,-174,16281713,16282093
2667,6,6,1,2412,-74,-92,18,e6:aa:ea:b7:4a:dd,16302797,408,20296,16302389,16302797
2668,6,12,1,2412,-89,-92,3,40:e3:d6:da:c8:05,16313127,160,10170,16312967,16313127
2669,6,6,1,2412,-73,-92,19,e6:aa:ea:b7:4a:dd,16314894,408,1359,16314486,16314894
2670,4,1,1,2412,-72,-92,20,54:e4:3a:ec:fb:64,16324926,2160,7872,16322766,16324926
2671,4,1,1,2412,-79,-92,13,b8:3a:5a:88:e6:e0,16352069,2360,24783,16349709,16352069
2672,4,1,1,2412,-79,-92,13,b8:3a:5a:88:e6:e1,16354458,2376,13,16352082,16354458
2673,6,12,1,2412,-86,-92,6,84:d4:7e:f2:34:20,16357035,160,2417,16356875,16357035
2674,6,6,1,2412,-89,-92,3,84:d4:7e:f2:34:21,16357226,368,-177,16356858,16357226
2675,6,12,1,2412,-87,-92,5,40:e3:d6:da:bb:e0,16364796,156,7414,16364640,16364796
2676,6,12,1,2412,-86,-92,6,40:e3:d6:da:bb:e2,16365407,176,435,16365231,16365407
2677,6,12,1,2412,-87,-92,5,40:e3:d6:da:bb:e3,16365618,180,31,16365438,16365618
2678,6,12,1,2412,-87,-92,5,40:e3:d6:da:bb:e4,16365842,172,52,16365670,16365842
2679,6,12,1,2412,-86,-92,6,40:e3:d6:da:bb:e5,16366057,156,59,16365901,16366057
2680,6,12,1,2412,-85,-92,7,40:e3:d6:da:ca:c3,16367358,156,1145,16367202,16367358
2681,6,6,1,2412,-52,-92,40,40:e3:d6:da:ba:21,16368277,368,551,16367909,16368277
2682,6,12,1,2412,-52,-92,40,40:e3:d6:da:ba:23,16368897,184,436,16368713,16368897
2683,6,12,1,2412,-52,-92,40,40:e3:d6:da:ba:24,16369124,176,51,16368948,16369124
2684,6,12,1,2412,-52,-92,40,40:e3:d6:da:ba:25,16369326,160,42,16369166,16369326
2685,6,6,1,2412,-52,-92,40,40:e3:d6:da:ba:26,16369527,380,-179,16369147,16369527
2686,6,12,1,2412,-86,-92,6,84:d4:7e:f2:42:24,16369939,176,236,16369763,16369939
2687,6,12,1,2412,-86,-92,6,40:e3:d6:da:ca:c3,16384236,180,14117,16384056,16384236
2688,6,12,1,2412,-87,-92,5,40:e3:d6:da:ca:c4,16384450,172,42,16384278,16384450
2689,6,12,1,2412,-86,-92,6,40:e3:d6:da:ca:c5,16384665,156,59,16384509,16384665
2690,4,1,1,2412,-89,-92,3,,16425318,304,40349,16425014,16425318
2691,4,1,1,2412,-71,-92,21,54:e4:3a:ec:fb:64,16427318,2160,-160,16425158,16427318
2692,6,12,1,2412,-87,-92,5,40:e3:d6:da:bb:e0,16467175,156,39701,16467019,16467175
2693,6,6,1,2412,-52,-92,40,40:e3:d6:da:ba:21,16470678,368,3135,16470310,16470678
2694,6,12,1,2412,-52,-92,40,40:e3:d6:da:ba:22,16471074,180,216,16470894,16471074
2695,6,12,1,2412,-52,-92,40,40:e3:d6:da:ba:23,16471279,184,21,16471095,16471279
2696,6,12,1,2412,-52,-92,40,40:e3:d6:da:ba:24,16471498,176,43,16471322,16471498
2697,6,12,1,2412,-52,-92,40,40:e3:d6:da:ba:25,16471726,160,68,16471566,16471726
2698,6,6,1,2412,-52,-92,40,40:e3:d6:da:ba:26,16471945,380,-161,16471565,16471945
2699,6,12,1,2412,-86,-92,6,84:d4:7e:f2:42:24,16472368,176,247,16472192,16472368
2700,6,12,1,2412,-87,-92,5,84:d4:7e:f2:42:25,16472579,160,51,16472419,16472579
2701,6,6,1,2412,-87,-92,5,84:d4:7e:f2:42:26,16472770,380,-189,16472390,16472770
2702,6,12,1,2412,-85,-92,7,40:e3:d6:da:ca:c0,16485410,156,12484,16485254,16485410
2703,6,6,1,2412,-86,-92,6,40:e3:d6:da:ca:c1,16485598,368,-180,16485230,16485598
2704,6,12,1,2412,-86,-92,6,40:e3:d6:da:ca:c2,16486012,176,238,16485836,16486012
2705,6,12,1,2412,-87,-92,5,40:e3:d6:da:ca:c3,16486231,180,39,16486051,16486231
2706,6,12,1,2412,-85,-92,7,40:e3:d6:da:ca:c4,16486455,172,52,16486283,16486455
2707,6,12,1,2412,-86,-92,6,40:e3:d6:da:ca:c5,16486680,156,69,16486524,16486680
2708,6,6,1,2412,-87,-92,5,40:e3:d6:da:ca:c6,16486876,380,-184,16486496,16486876
2709,4,1,1,2412,-73,-92,19,c0:c9:e3:4d:6e:bf,16513179,872,25431,16512307,16513179
2710,4,1,1,2412,-70,-92,22,54:e4:3a:ec:fb:64,16529715,2160,14376,16527555,16529715
2711,4,1,1,2412,-59,-92,33,,16567287,304,37268,16566983,16567287
2712,6,6,1,2412,-87,-92,5,40:e3:d6:da:bb:e1,16569790,368,2135,16569422,16569790
2713,6,12,1,2412,-84,-92,8,40:e3:d6:da:bb:e2,16570204,176,238,16570028,16570204
2714,6,12,1,2412,-86,-92,6,40:e3:d6:da:bb:e5,16570885,156,525,16570729,16570885
2715,6,6,1,2412,-85,-92,7,40:e3:d6:da:bb:e6,16571097,380,-168,16570717,16571097
2716,6,6,1,2412,-53,-92,39,40:e3:d6:da:ba:21,16573090,368,1625,16572722,16573090
2717,6,6,1,2412,-53,-92,39,40:e3:d6:da:ba:26,16576619,380,3149,16576239,16576619
2718,6,6,1,2412,-51,-92,41,e6:aa:ea:c9:ea:33,16587906,408,10879,16587498,16587906
2719,6,12,1,2412,-86,-92,6,40:e3:d6:da:ca:c2,16588408,176,326,16588232,16588408
2720,6,12,1,2412,-87,-92,5,40:e3:d6:da:ca:c3,16588637,180,49,16588457,16588637
2721,6,12,1,2412,-85,-92,7,40:e3:d6:da:ca:c4,16588860,172,51,16588688,16588860
2722,4,1,1,2412,-87,-92,5,,16592634,304,3470,16592330,16592634
2723,6,6,1,2412,-51,-92,41,e6:aa:ea:c9:ea:33,16612148,408,19106,16611740,16612148
2724,6,6,1,2412,-84,-92,8,e6:aa:ea:c9:ea:1b,16623803,408,11247,16623395,16623803
2725,6,6,1,2412,-51,-92,41,e6:aa:ea:c9:ea:33,16624264,408,53,16623856,16624264
2726,6,12,1,2412,-86,-92,6,,16631588,32,7292,16631556,16631588
2727,6,12,1,2412,-85,-92,7,,16631842,32,222,16631810,16631842
2728,4,1,1,2412,-70,-92,22,54:e4:3a:ec:fb:64,16632103,2160,-1899,16629943,16632103
2729,6,6,1,2412,-83,-92,9,e6:aa:ea:c9:ea:1b,16635919,408,3408,16635511,16635919
2730,6,12,1,2412,-84,-92,8,,16636752,32,801,16636720,16636752
2731,6,12,1,2412,-84,-92,8,,16637421,32,637,16637389,16637421
2732,6,12,1,2412,-84,-92,8,,16637534,44,69,16637490,16637534
2733,6,6,1,2412,-84,-92,8,e6:aa:ea:c9:ea:1b,16648028,408,10086,16647620,16648028
2734,6,12,1,2412,-84,-92,8,,16656633,44,8561,16656589,16656633
2735,6,12,1,2412,-86,-92,6,,16657331,32,666,16657299,16657331
2736,6,12,1,2412,-85,-92,7,,16657456,44,81,16657412,16657456
2737,4,1,1,2412,-74,-92,18,b8:3a:5a:88:e6:e0,16659275,2360,-541,16656915,16659275
2738,6,12,1,2412,-89,-92,3,84:d4:7e:f2:34:20,16664250,160,4815,16664090,16664250
2739,6,6,1,2412,-88,-92,4,84:d4:7e:f2:34:21,16664460,368,-158,16664092,16664460
2740,6,12,1,2412,-88,-92,4,84:d4:7e:f2:34:24,16665293,176,657,16665117,16665293
2741,6,12,1,2412,-84,-92,8,,16666702,32,1377,16666670,16666702
2742,6,12,1,2412,-85,-92,7,40:e3:d6:da:bb:e0,16671993,156,5135,16671837,16671993
2743,6,12,1,2412,-84,-92,8,40:e3:d6:da:bb:e3,16672805,180,632,16672625,16672805
2744,6,12,1,2412,-53,-92,39,40:e3:d6:da:ba:20,16675287,160,2322,16675127,16675287
2745,6,6,1,2412,-53,-92,39,40:e3:d6:da:ba:21,16675497,368,-158,16675129,16675497
2746,6,12,1,2412,-53,-92,39,40:e3:d6:da:ba:22,16675902,180,225,16675722,16675902
2747,6,12,1,2412,-53,-92,39,40:e3:d6:da:ba:23,16676125,184,39,16675941,16676125
2748,6,12,1,2412,-53,-92,39,40:e3:d6:da:ba:24,16676353,176,52,16676177,16676353
2749,6,12,1,2412,-53,-92,39,40:e3:d6:da:ba:25,16676572,160,59,16676412,16676572
2750,6,6,1,2412,-53,-92,39,40:e3:d6:da:ba:26,16676782,380,-170,16676402,16676782
2751,6,12,1,2412,-84,-92,8,84:d4:7e:f2:42:25,16677338,160,396,16677178,16677338
2752,6,12,1,2412,-87,-92,5,40:e3:d6:da:ca:c0,16690205,156,12711,16690049,16690205
2753,6,6,1,2412,-86,-92,6,40:e3:d6:da:ca:c1,16690421,368,-152,16690053,16690421
2754,6,12,1,2412,-87,-92,5,40:e3:d6:da:ca:c2,16690835,176,238,16690659,16690835
2755,6,12,1,2412,-88,-92,4,40:e3:d6:da:ca:c3,16691036,180,21,16690856,16691036
2756,6,12,1,2412,-87,-92,5,40:e3:d6:da:ca:c4,16691269,172,61,16691097,16691269
2757,6,6,1,2412,-87,-92,5,40:e3:d6:da:ca:c6,16691690,380,41,16691310,16691690
2758,6,12,1,2412,-84,-92,8,,16696963,32,5241,16696931,16696963
2759,7,21.6667,1,2412,0,-92,92,00:1f:26:41:f0:00,16697486,71,452,16697415,16697486
2760,7,21.6667,1,2412,-86,-92,6,00:1f:26:41:f0:00,16697486,544,-544,16696942,16697486
2761,6,12,1,2412,-84,-92,8,,16698316,36,794,16698280,16698316
2762,6,12,1,2412,-84,-92,8,,16699734,36,1382,16699698,16699734
2763,6,12,1,2412,-86,-92,6,,16699894,36,124,16699858,16699894
2764,7,21.6667,1,2412,-84,-92,8,00:1f:26:41:f0:00,16700004,137,-27,16699867,16700004
2765,6,12,1,2412,-86,-92,6,,16701238,32,1202,16701206,16701238
2766,6,12,1,2412,-84,-92,8,,16701359,44,77,16701315,16701359
2767,6,12,1,2412,-83,-92,9,,16707852,32,6461,16707820,16707852
2768,6,12,1,2412,-83,-92,9,,16707969,44,73,16707925,16707969
2769,6,6,1,2412,-80,-92,12,e6:aa:ea:b7:4a:dd,16708183,408,-194,16707775,16708183
2770,6,12,1,2412,-84,-92,8,,16716952,36,8733,16716916,16716952
2771,6,12,1,2412,-85,-92,7,,16719009,32,2025,16718977,16719009
2772,6,12,1,2412,-84,-92,8,,16719126,44,73,16719082,16719126
2773,6,6,1,2412,-80,-92,12,e6:aa:ea:b7:4a:dd,16720304,408,770,16719896,16720304
2774,6,12,1,2412,-85,-92,7,,16729966,36,9626,16729930,16729966
2775,7,21.6667,1,2412,-85,-92,7,00:1f:26:41:f0:00,16730075,79,30,16729996,16730075
2776,6,6,1,2412,-79,-92,13,e6:aa:ea:b7:4a:dd,16732524,408,2041,16732116,16732524
2777,6,12,1,2412,-84,-92,8,,16736778,36,4218,16736742,16736778
2778,7,21.6667,1,2412,-84,-92,8,00:1f:26:41:f0:00,16736888,97,13,16736791,16736888
2779,6,6,1,2412,-79,-92,13,e6:aa:ea:b7:4a:dd,16744535,408,7239,16744127,16744535
2780,6,12,1,2412,-84,-92,8,,16744974,36,403,16744938,16744974
2781,6,6,1,2412,-84,-92,8,,16745688,52,662,16745636,16745688
2782,6,6,1,2412,-85,-92,7,,16746651,52,911,16746599,16746651
2783,6,12,1,2412,-86,-92,6,,16749204,32,2521,16749172,16749204
2784,6,12,1,2412,-88,-92,4,84:d4:7e:f2:34:25,16767862,160,18498,16767702,16767862
2785,6,12,1,2412,-84,-92,8,40:e3:d6:da:bb:e2,16775029,176,6991,16774853,16775029
2786,6,12,1,2412,-84,-92,8,40:e3:d6:da:bb:e3,16775240,180,31,16775060,16775240
2787,6,12,1,2412,-84,-92,8,40:e3:d6:da:bb:e4,16775463,172,51,16775291,16775463
2788,6,12,1,2412,-85,-92,7,40:e3:d6:da:bb:e5,16775687,156,68,16775531,16775687
2789,6,6,1,2412,-84,-92,8,40:e3:d6:da:bb:e6,16775884,380,-183,16775504,16775884
2790,6,12,1,2412,-54,-92,38,40:e3:d6:da:ba:20,16777706,160,1662,16777546,16777706
2791,6,6,1,2412,-54,-92,38,40:e3:d6:da:ba:21,16777898,368,-176,16777530,16777898
2792,6,12,1,2412,-54,-92,38,40:e3:d6:da:ba:22,16778311,180,233,16778131,16778311
2793,6,12,1,2412,-54,-92,38,40:e3:d6:da:ba:23,16778517,184,22,16778333,16778517
2794,6,12,1,2412,-54,-92,38,40:e3:d6:da:ba:24,16778735,176,42,16778559,16778735
2795,6,12,1,2412,-52,-92,40,40:e3:d6:da:ba:25,16778937,160,42,16778777,16778937
2796,6,6,1,2412,-54,-92,38,40:e3:d6:da:ba:26,16779138,380,-179,16778758,16779138
2797,6,12,1,2412,-85,-92,7,84:d4:7e:f2:42:24,16779567,176,253,16779391,16779567
2798,6,12,1,2412,-85,-92,7,84:d4:7e:f2:42:25,16779786,160,59,16779626,16779786
2799,6,12,1,2412,-86,-92,6,40:e3:d6:da:ca:c2,16793703,176,13741,16793527,16793703
2800,6,12,1,2412,-87,-92,5,40:e3:d6:da:ca:c4,16794129,172,254,16793957,16794129
2801,4,1,1,2412,-70,-92,22,54:e4:3a:ec:fb:64,16836998,2160,40709,16834838,16836998
2802,6,12,1,2412,-86,-92,6,,16854875,32,17845,16854843,16854875
2803,6,12,1,2412,-86,-92,6,,16856208,32,1301,16856176,16856208
2804,6,12,1,2412,-85,-92,7,,16856333,44,81,16856289,16856333
2805,4,1,1,2412,-73,-92,19,b8:3a:5a:88:e6:e0,16864072,2360,5379,16861712,16864072
2806,6,12,1,2412,-88,-92,4,84:d4:7e:f2:34:23,16868975,180,4723,16868795,16868975
2807,6,12,1,2412,-86,-92,6,40:e3:d6:da:bb:e0,16876822,156,7691,16876666,16876822
2808,6,6,1,2412,-85,-92,7,40:e3:d6:da:bb:e1,16877037,368,-153,16876669,16877037
2809,6,12,1,2412,-85,-92,7,40:e3:d6:da:bb:e2,16877425,176,212,16877249,16877425
2810,6,12,1,2412,-85,-92,7,40:e3:d6:da:bb:e3,16877653,180,48,16877473,16877653
2811,6,12,1,2412,-85,-92,7,40:e3:d6:da:bb:e4,16877885,172,60,16877713,16877885
2812,6,12,1,2412,-85,-92,7,40:e3:d6:da:bb:e5,16878110,156,69,16877954,16878110
2813,6,6,1,2412,-85,-92,7,40:e3:d6:da:bb:e6,16878298,380,-192,16877918,16878298
2814,6,12,1,2412,-55,-92,37,40:e3:d6:da:ba:20,16880099,160,1641,16879939,16880099
2815,6,6,1,2412,-55,-92,37,40:e3:d6:da:ba:21,16880309,368,-158,16879941,16880309
2816,6,12,1,2412,-55,-92,37,40:e3:d6:da:ba:22,16880695,180,206,16880515,16880695
2817,6,12,1,2412,-55,-92,37,40:e3:d6:da:ba:23,16880928,184,49,16880744,16880928
2818,6,12,1,2412,-55,-92,37,40:e3:d6:da:ba:24,16881137,176,33,16880961,16881137
2819,6,12,1,2412,-55,-92,37,40:e3:d6:da:ba:25,16881339,160,42,16881179,16881339
2820,6,6,1,2412,-55,-92,37,40:e3:d6:da:ba:26,16881531,380,-188,16881151,16881531
2821,6,12,1,2412,-85,-92,7,84:d4:7e:f2:42:24,16881933,176,226,16881757,16881933
2822,6,12,1,2412,-86,-92,6,84:d4:7e:f2:42:25,16882161,160,68,16882001,16882161
2823,6,12,1,2412,-86,-92,6,,16887644,32,5451,16887612,16887644
2824,6,12,1,2412,-85,-92,7,,16887724,36,44,16887688,16887724
2825,7,28.8889,1,2412,-85,-92,7,00:1f:26:41:f0:00,16887834,72,38,16887762,16887834
2826,6,12,1,2412,-85,-92,7,,16888035,36,165,16887999,16888035
2827,7,28.8889,1,2412,-86,-92,6,00:1f:26:41:f0:00,16888145,72,38,16888073,16888145
2828,6,12,1,2412,-85,-92,7,,16888413,36,232,16888377,16888413
2829,6,6,1,2412,-47,-92,45,e6:aa:ea:c9:ea:33,16890624,408,1803,16890216,16890624
2830,6,12,1,2412,-85,-92,7,,16891737,32,1081,16891705,16891737
2831,6,12,1,2412,-85,-92,7,,16892353,32,584,16892321,16892353
2832,6,12,1,2412,-86,-92,6,,16892522,44,125,16892478,16892522
2833,6,6,1,2412,-89,-92,3,40:e3:d6:da:ca:c1,16895186,368,2296,16894818,16895186
2834,6,12,1,2412,-89,-92,3,40:e3:d6:da:ca:c3,16895810,180,444,16895630,16895810
2835,6,12,1,2412,-88,-92,4,40:e3:d6:da:ca:c5,16896223,156,257,16896067,16896223
2836,4,1,1,2412,-86,-92,6,,16897809,304,1282,16897505,16897809
2837,6,6,1,2412,-90,-92,2,a8:5b:f7:55:1a:40,16899992,72,2111,16899920,16899992
2838,6,6,1,2412,-88,-92,4,a8:5b:f7:55:1a:40,16903801,72,3737,16903729,16903801
2839,6,6,1,2412,-88,-92,4,a8:5b:f7:55:1a:40,16903909,72,36,16903837,16903909
2840,6,6,1,2412,-87,-92,5,a8:5b:f7:55:1a:40,16904133,72,152,16904061,16904133
2841,6,6,1,2412,-87,-92,5,a8:5b:f7:55:1a:40,16904241,72,36,16904169,16904241
2842,6,6,1,2412,-89,-92,3,a8:5b:f7:55:1a:40,16904483,72,170,16904411,16904483
2843,6,12,1,2412,-84,-92,8,,16906643,36,2124,16906607,16906643
2844,6,12,1,2412,-84,-92,8,,16907412,36,733,16907376,16907412
2845,6,12,1,2412,-85,-92,7,,16907639,36,191,16907603,16907639
2846,6,6,1,2412,-86,-92,6,,16907744,52,53,16907692,16907744
2847,6,6,1,2412,-85,-92,7,,16907859,52,63,16907807,16907859
2848,7,7.22222,1,2412,-85,-92,7,00:1f:26:41:f0:00,16907990,158,-27,16907832,16907990
2849,6,12,1,2412,-85,-92,7,,16913823,36,5797,16913787,16913823
2850,6,6,1,2412,-47,-92,45,e6:aa:ea:c9:ea:33,16914753,408,522,16914345,16914753
2851,6,12,1,2412,-86,-92,6,,16917459,32,2674,16917427,16917459
2852,6,6,1,2412,-47,-92,45,e6:aa:ea:c9:ea:33,16930485,408,12618,16930077,16930485
2853,6,6,1,2412,-47,-92,45,e6:aa:ea:c9:ea:33,16938972,408,8079,16938564,16938972
2854,4,1,1,2412,-69,-92,23,54:e4:3a:ec:fb:64,16940032,2160,-1100,16937872,16940032
2855,4,1,1,2412,-69,-92,23,,16959060,304,18724,16958756,16959060
2856,4,1,1,2412,-73,-92,19,b8:3a:5a:88:e6:e0,16966610,2360,5190,16964250,16966610
2857,4,1,1,2412,-72,-92,20,b8:3a:5a:88:e6:e1,16969007,2376,21,16966631,16969007
2858,6,6,1,2412,-55,-92,37,40:e3:d6:da:ba:21,16982698,368,13323,16982330,16982698
2859,6,12,1,2412,-54,-92,38,40:e3:d6:da:ba:22,16983119,180,241,16982939,16983119
2860,6,12,1,2412,-54,-92,38,40:e3:d6:da:ba:23,16983334,184,31,16983150,16983334
2861,6,12,1,2412,-54,-92,38,40:e3:d6:da:ba:24,16983552,176,42,16983376,16983552
2862,6,12,1,2412,-54,-92,38,40:e3:d6:da:ba:25,16983788,160,76,16983628,16983788
2863,6,6,1,2412,-54,-92,38,40:e3:d6:da:ba:26,16983989,380,-179,16983609,16983989
2864,6,12,1,2412,-84,-92,8,84:d4:7e:f2:42:25,16984566,160,417,16984406,16984566
2865,6,6,1,2412,-84,-92,8,84:d4:7e:f2:42:26,16984776,380,-170,16984396,16984776
2866,4,1,1,2412,-71,-92,21,c0:c9:e3:4d:6e:bf,17005387,872,19739,17004515,17005387
2867,6,6,1,2412,-85,-92,7,,17020640,44,15209,17020596,17020640
2868,6,12,1,2412,-89,-92,3,40:e3:d6:da:c8:03,17029465,184,8641,17029281,17029465
2869,6,12,1,2412,-89,-92,3,40:e3:d6:da:c8:05,17029894,160,269,17029734,17029894
2870,6,6,1,2412,-89,-92,3,40:e3:d6:da:c8:06,17030086,380,-188,17029706,17030086
2871,4,1,1,2412,-68,-92,24,54:e4:3a:ec:fb:64,17041788,2160,9542,17039628,17041788
2872,4,1,1,2412,-77,-92,15,c0:c9:e3:4d:6e:bf,17050802,872,8142,17049930,17050802
2873,4,1,1,2412,-85,-92,7,,17051692,304,586,17051388,17051692
2874,4,1,1,2412,-74,-92,18,b8:3a:5a:88:e6:e0,17068879,2360,14827,17066519,17068879
2875,4,1,1,2412,-75,-92,17,b8:3a:5a:88:e6:e1,17071286,2376,31,17068910,17071286
2876,6,12,1,2412,-85,-92,7,84:d4:7e:f2:34:24,17073973,176,2511,17073797,17073973
2877,6,12,1,2412,-86,-92,6,84:d4:7e:f2:34:25,17074175,160,42,17074015,17074175
2878,6,6,1,2412,-85,-92,7,84:d4:7e:f2:34:26,17074376,380,-179,17073996,17074376
2879,6,6,1,2412,-75,-92,17,78:8a:20:fa:27:f9,17080100,88,5636,17080012,17080100
2880,6,6,1,2412,-87,-92,5,,17080206,44,62,17080162,17080206
2881,4,1,1,2412,-74,-92,18,b8:3a:5a:88:e6:e0,17080608,2240,-1838,17078368,17080608
2882,4,1,1,2412,-76,-92,16,b8:3a:5a:88:e6:e1,17082933,2256,69,17080677,17082933
2883,6,12,1,2412,-53,-92,39,40:e3:d6:da:ba:20,17085040,160,1947,17084880,17085040
2884,6,6,1,2412,-52,-92,40,40:e3:d6:da:ba:21,17085280,368,-128,17084912,17085280
2885,6,12,1,2412,-53,-92,39,40:e3:d6:da:ba:23,17085900,184,436,17085716,17085900
2886,6,12,1,2412,-53,-92,39,40:e3:d6:da:ba:24,17086137,176,61,17085961,17086137
2887,6,12,1,2412,-53,-92,39,40:e3:d6:da:ba:25,17086347,160,50,17086187,17086347
2888,6,6,1,2412,-53,-92,39,40:e3:d6:da:ba:26,17086557,380,-170,17086177,17086557
2889,6,12,1,2412,-86,-92,6,,17088256,32,1667,17088224,17088256
2890,6,12,1,2412,-85,-92,7,84:d4:7e:f2:42:22,17089131,180,695,17088951,17089131
2891,6,12,1,2412,-85,-92,7,84:d4:7e:f2:42:23,17089337,180,26,17089157,17089337
2892,6,12,1,2412,-86,-92,6,40:e3:d6:da:ca:c0,17099798,156,10305,17099642,17099798
2893,6,6,1,2412,-86,-92,6,40:e3:d6:da:ca:c1,17100012,368,-154,17099644,17100012
2894,6,12,1,2412,-86,-92,6,40:e3:d6:da:ca:c2,17100400,176,212,17100224,17100400
2895,6,12,1,2412,-85,-92,7,40:e3:d6:da:ca:c3,17100610,180,30,17100430,17100610
2896,6,12,1,2412,-84,-92,8,,17105005,32,4363,17104973,17105005
2897,6,6,1,2412,-73,-92,19,78:8a:20:fa:27:f9,17130170,88,25077,17130082,17130170
2898,6,6,1,2412,-85,-92,7,,17130276,44,62,17130232,17130276
2899,6,12,1,2412,-86,-92,6,84:d4:7e:f2:42:23,17135137,160,4701,17134977,17135137
2900,6,12,1,2412,-85,-92,7,84:d4:7e:f2:42:25,17135332,140,55,17135192,17135332
2901,6,6,1,2412,-87,-92,5,40:e3:d6:da:bb:e1,17143147,348,7467,17142799,17143147
2902,6,12,1,2412,-87,-92,5,40:e3:d6:da:bb:e2,17143605,156,302,17143449,17143605
2903,4,1,1,2412,-66,-92,26,54:e4:3a:ec:fb:64,17144078,2160,-1687,17141918,17144078
2904,4,1,1,2412,-77,-92,15,b8:3a:5a:88:e6:e0,17171422,2360,24984,17169062,17171422
2905,4,1,1,2412,-77,-92,15,b8:3a:5a:88:e6:e1,17173802,2376,4,17171426,17173802
2906,6,12,1,2412,-89,-92,3,84:d4:7e:f2:34:23,17176866,180,2884,17176686,17176866
2907,6,12,1,2412,-89,-92,3,84:d4:7e:f2:34:24,17177090,176,48,17176914,17177090
2908,6,12,1,2412,-87,-92,5,84:d4:7e:f2:34:25,17177291,160,41,17177131,17177291
2909,6,6,1,2412,-88,-92,4,84:d4:7e:f2:34:26,17177510,380,-161,17177130,17177510
2910,6,12,1,2412,-88,-92,4,40:e3:d6:da:bb:e3,17185121,180,7431,17184941,17185121
2911,6,12,1,2412,-87,-92,5,40:e3:d6:da:bb:e4,17185345,172,52,17185173,17185345
2912,6,6,1,2412,-87,-92,5,40:e3:d6:da:bb:e6,17185757,380,32,17185377,17185757
2913,6,12,1,2412,-50,-92,42,40:e3:d6:da:ba:20,17187294,160,1377,17187134,17187294
2914,6,6,1,2412,-50,-92,42,40:e3:d6:da:ba:21,17187495,368,-167,17187127,17187495
2915,6,12,1,2412,-50,-92,42,40:e3:d6:da:ba:22,17187900,180,225,17187720,17187900
2916,6,12,1,2412,-50,-92,42,40:e3:d6:da:ba:23,17188132,184,48,17187948,17188132
2917,6,12,1,2412,-50,-92,42,40:e3:d6:da:ba:25,17188552,160,260,17188392,17188552
2918,6,6,1,2412,-50,-92,42,40:e3:d6:da:ba:26,17188753,380,-179,17188373,17188753
2919,6,12,1,2412,-85,-92,7,84:d4:7e:f2:42:24,17189163,176,234,17188987,17189163
2920,6,12,1,2412,-86,-92,6,84:d4:7e:f2:42:25,17189364,160,41,17189204,17189364
2921,6,6,1,2412,-86,-92,6,84:d4:7e:f2:42:26,17189583,380,-161,17189203,17189583
2922,6,12,1,2412,-87,-92,5,40:e3:d6:da:bb:e3,17192137,156,2398,17191981,17192137
2923,6,12,1,2412,-87,-92,5,40:e3:d6:da:bb:e5,17192343,136,70,17192207,17192343
2924,6,12,1,2412,-86,-92,6,40:e3:d6:f7:15:a0,17197788,960,4485,17196828,17197788
2925,6,6,1,2412,-83,-92,9,40:e3:d6:da:ca:c1,17202426,368,4270,17202058,17202426
2926,6,12,1,2412,-84,-92,8,40:e3:d6:da:ca:c2,17202813,176,211,17202637,17202813
2927,6,12,1,2412,-84,-92,8,40:e3:d6:da:ca:c3,17203023,180,30,17202843,17203023
2928,6,12,1,2412,-83,-92,9,40:e3:d6:da:ca:c4,17203229,172,34,17203057,17203229
2929,6,12,1,2412,-83,-92,9,40:e3:d6:da:ca:c5,17203444,156,59,17203288,17203444
2930,6,6,1,2412,-88,-92,4,40:e3:d6:da:bb:e1,17209209,348,5417,17208861,17209209
2931,6,12,1,2412,-89,-92,3,40:e3:d6:da:bb:e3,17213055,156,3690,17212899,17213055
2932,6,12,1,2412,-88,-92,4,40:e3:d6:da:bb:e2,17214022,156,811,17213866,17214022
2933,6,12,1,2412,-87,-92,5,40:e3:d6:da:bb:e3,17214231,156,53,17214075,17214231
2934,6,12,1,2412,-88,-92,4,40:e3:d6:da:bb:e5,17214439,136,72,17214303,17214439
2935,6,6,1,2412,-75,-92,17,e6:aa:ea:b7:4a:dd,17217491,408,2644,17217083,17217491
2936,6,6,1,2412,-75,-92,17,e6:aa:ea:b7:4a:dd,17230412,408,12513,17230004,17230412
2937,4,1,1,2412,-79,-92,13,22:a3:7f:87:e5:4e,17231242,1480,-650,17229762,17231242
2938,6,12,1,2412,-57,-92,35,40:e3:d6:da:ba:23,17232734,156,1336,17232578,17232734
2939,6,12,1,2412,-84,-92,8,40:e3:d6:da:ca:c0,17241353,136,8483,17241217,17241353
2940,6,6,1,2412,-74,-92,18,e6:aa:ea:b7:4a:dd,17241533,408,-228,17241125,17241533
2941,6,12,1,2412,-85,-92,7,40:e3:d6:da:ca:c2,17241933,156,244,17241777,17241933
2942,6,12,1,2412,-85,-92,7,40:e3:d6:da:ca:c5,17242323,136,254,17242187,17242323
2943,6,12,1,2412,-88,-92,4,,17270472,32,28117,17270440,17270472
2944,6,12,1,2412,-89,-92,3,,17271099,32,595,17271067,17271099
2945,4,1,1,2412,-79,-92,13,b8:3a:5a:88:e6:e1,17276061,2376,2586,17273685,17276061
2946,6,12,1,2412,-88,-92,4,84:d4:7e:f2:34:22,17278501,180,2260,17278321,17278501
2947,6,12,1,2412,-88,-92,4,84:d4:7e:f2:34:24,17278931,176,254,17278755,17278931
2948,6,12,1,2412,-88,-92,4,84:d4:7e:f2:34:25,17279131,160,40,17278971,17279131
2949,6,12,1,2412,-52,-92,40,40:e3:d6:da:ba:20,17289689,160,10398,17289529,17289689
2950,6,6,1,2412,-52,-92,40,40:e3:d6:da:ba:21,17289890,368,-167,17289522,17289890
2951,6,12,1,2412,-52,-92,40,40:e3:d6:da:ba:22,17290304,180,234,17290124,17290304
2952,6,12,1,2412,-52,-92,40,40:e3:d6:da:ba:23,17290519,184,31,17290335,17290519
2953,6,12,1,2412,-52,-92,40,40:e3:d6:da:ba:24,17290746,176,51,17290570,17290746
2954,6,12,1,2412,-51,-92,41,40:e3:d6:da:ba:25,17290948,160,42,17290788,17290948
2955,6,6,1,2412,-52,-92,40,40:e3:d6:da:ba:26,17291183,380,-145,17290803,17291183
2956,6,12,1,2412,-83,-92,9,84:d4:7e:f2:42:24,17291599,176,240,17291423,17291599
2957,6,12,1,2412,-85,-92,7,84:d4:7e:f2:42:25,17291809,160,50,17291649,17291809
2958,6,6,1,2412,-86,-92,6,84:d4:7e:f2:42:26,17292001,380,-188,17291621,17292001
2959,6,12,1,2412,-84,-92,8,40:e3:d6:da:ca:c0,17304622,156,12465,17304466,17304622
2960,6,6,1,2412,-84,-92,8,40:e3:d6:da:ca:c1,17304836,368,-154,17304468,17304836
2961,6,12,1,2412,-85,-92,7,40:e3:d6:da:ca:c2,17305233,176,221,17305057,17305233
2962,6,12,1,2412,-84,-92,8,40:e3:d6:da:ca:c5,17305881,156,492,17305725,17305881
2963,6,6,1,2412,-84,-92,8,40:e3:d6:da:ca:c6,17306088,380,-173,17305708,17306088
2964,6,12,1,2412,-88,-92,4,40:e3:d6:da:bb:e0,17306483,136,259,17306347,17306483
2965,6,6,1,2412,-87,-92,5,40:e3:d6:da:bb:e1,17306669,348,-162,17306321,17306669
2966,6,6,1,2412,-52,-92,40,e6:aa:ea:c9:ea:33,17308526,408,1449,17308118,17308526
2967,6,6,1,2412,-88,-92,4,40:e3:d6:da:bb:e1,17310645,348,1771,17310297,17310645
2968,6,12,1,2412,-88,-92,4,40:e3:d6:da:bb:e3,17311239,156,438,17311083,17311239
2969,6,12,1,2412,-88,-92,4,40:e3:d6:da:bb:e2,17312276,156,881,17312120,17312276
2970,6,12,1,2412,-88,-92,4,40:e3:d6:da:bb:e3,17312475,156,43,17312319,17312475
2971,6,12,1,2412,-87,-92,5,40:e3:d6:da:bb:e5,17312684,136,73,17312548,17312684
2972,6,6,1,2412,-53,-92,39,e6:aa:ea:c9:ea:33,17320864,408,7772,17320456,17320864
2973,6,6,1,2412,-87,-92,5,66:d8:ff:ae:5d:41,17321626,64,698,17321562,17321626
2974,6,6,1,2412,-89,-92,3,,17321707,44,37,17321663,17321707
2975,6,24,1,2412,-87,-92,5,66:d8:ff:ae:5d:41,17321860,32,121,17321828,17321860
2976,6,12,1,2412,-87,-92,5,,17321909,32,17,17321877,17321909
2977,6,24,1,2412,-86,-92,6,66:d8:ff:ae:5d:41,17323763,32,1822,17323731,17323763
2978,6,12,1,2412,-87,-92,5,,17323812,32,17,17323780,17323812
2979,6,12,1,2412,-87,-92,5,,17324403,36,555,17324367,17324403
2980,6,12,1,2412,-88,-92,4,,17324878,32,443,17324846,17324878
2981,6,12,1,2412,-87,-92,5,,17326398,36,1484,17326362,17326398
2982,6,6,1,2412,-87,-92,5,,17326610,68,144,17326542,17326610
2983,6,12,1,2412,-87,-92,5,,17326746,32,104,17326714,17326746
2984,6,6,1,2412,-52,-92,40,e6:aa:ea:c9:ea:33,17332759,408,5605,17332351,17332759
2985,6,12,1,2412,-88,-92,4,,17334148,44,1345,17334104,17334148
2986,6,6,1,2412,-87,-92,5,40:e3:d6:da:c8:01,17336023,368,1507,17335655,17336023
2987,4,1,1,2412,-76,-92,16,a6:e5:7c:28:b1:d3,17336645,992,-370,17335653,17336645
2988,6,12,1,2412,-85,-92,7,,17338055,32,1378,17338023,17338055
2989,6,12,1,2412,-88,-92,4,,17343919,36,5828,17343883,17343919
2990,6,12,1,2412,-88,-92,4,,17344043,36,88,17344007,17344043
2991,6,12,1,2412,-88,-92,4,,17344123,32,48,17344091,17344123
2992,6,12,1,2412,-88,-92,4,,17344292,36,133,17344256,17344292
2993,6,12,1,2412,-87,-92,5,,17344391,36,63,17344355,17344391
2994,6,12,1,2412,-87,-92,5,,17344490,36,63,17344454,17344490
2995,6,12,1,2412,-86,-92,6,,17344588,36,62,17344552,17344588
2996,6,12,1,2412,-88,-92,4,,17344770,32,150,17344738,17344770
2997,6,6,1,2412,-52,-92,40,e6:aa:ea:c9:ea:33,17344870,408,-308,17344462,17344870
2998,6,12,1,2412,-87,-92,5,,17355246,32,10344,17355214,17355246
2999,6,6,1,2412,-51,-92,41,e6:aa:ea:c9:ea:33,17357121,408,1467,17356713,17357121
3000,6,12,1,2412,-86,-92,6,,17366713,32,9560,17366681,17366713
3001,6,12,1,2412,-87,-92,5,,17370185,36,3436,17370149,17370185
3002,6,12,1,2412,-86,-92,6,,17370238,32,21,17370206,17370238
3003,6,12,1,2412,-87,-92,5,,17370352,44,70,17370308,17370352
3004,4,5.5,1,2412,-75,-92,17,,17372627,213,2062,17372414,17372627
3005,4,1,1,2412,-75,-92,17,a6:e5:7c:28:b1:d3,17373420,944,-151,17372476,17373420
3006,4,1,1,2412,-68,-92,24,,17374377,304,653,17374073,17374377
3007,6,12,1,2412,-87,-92,5,84:d4:7e:f2:34:22,17381613,180,7056,17381433,17381613
3008,6,12,1,2412,-85,-92,7,84:d4:7e:f2:34:23,17381818,180,25,17381638,17381818
3009,6,12,1,2412,-82,-92,10,,17384149,36,2295,17384113,17384149
3010,6,12,1,2412,-83,-92,9,,17384202,32,21,17384170,17384202
3011,6,12,1,2412,-84,-92,8,,17384322,44,76,17384278,17384322
3012,6,12,1,2412,-86,-92,6,40:e3:d6:da:bb:e5,17390060,156,5582,17389904,17390060
3013,6,6,1,2412,-86,-92,6,40:e3:d6:da:bb:e6,17390276,380,-164,17389896,17390276
3014,6,12,1,2412,-87,-92,5,,17390901,36,589,17390865,17390901
3015,6,12,1,2412,-55,-92,37,40:e3:d6:da:ba:20,17392094,160,1033,17391934,17392094
3016,6,6,1,2412,-55,-92,37,40:e3:d6:da:ba:21,17392313,368,-149,17391945,17392313
3017,6,12,1,2412,-55,-92,37,40:e3:d6:da:ba:22,17392709,180,216,17392529,17392709
3018,6,12,1,2412,-55,-92,37,40:e3:d6:da:ba:23,17392990,184,97,17392806,17392990
3019,6,6,1,2412,-85,-92,7,,17394786,44,1752,17394742,17394786
3020,6,12,1,2412,-85,-92,7,,17396642,36,1820,17396606,17396642
3021,6,12,1,2412,-86,-92,6,,17396695,32,21,17396663,17396695
3022,6,6,1,2412,-86,-92,6,,17396987,68,224,17396919,17396987
3023,6,12,1,2412,-87,-92,5,,17397119,36,96,17397083,17397119
3024,6,6,1,2412,-87,-92,5,,17397178,44,15,17397134,17397178
3025,6,12,1,2412,-83,-92,9,,17397586,32,376,17397554,17397586
3026,6,6,1,2412,-87,-92,5,,17398144,68,490,17398076,17398144
3027,6,12,1,2412,-86,-92,6,,17398505,36,325,17398469,17398505
3028,6,6,1,2412,-86,-92,6,,17398565,44,16,17398521,17398565
3029,6,12,1,2412,-86,-92,6,,17399067,36,466,17399031,17399067
3030,6,12,1,2412,-86,-92,6,,17399119,32,20,17399087,17399119
3031,6,6,1,2412,-85,-92,7,,17399638,68,451,17399570,17399638
3032,6,12,1,2412,-86,-92,6,,17399834,36,160,17399798,17399834
3033,6,6,1,2412,-86,-92,6,,17399893,44,15,17399849,17399893
3034,6,6,1,2412,-87,-92,5,,17400205,68,244,17400137,17400205
3035,6,12,1,2412,-87,-92,5,,17400320,36,79,17400284,17400320
3036,6,6,1,2412,-87,-92,5,,17400379,44,15,17400335,17400379
3037,6,6,1,2412,-85,-92,7,,17401243,68,796,17401175,17401243
3038,6,12,1,2412,-86,-92,6,,17401433,32,158,17401401,17401433
3039,6,12,1,2412,-85,-92,7,40:e3:d6:da:ca:c0,17407014,156,5425,17406858,17407014
3040,6,6,1,2412,-84,-92,8,40:e3:d6:da:ca:c1,17407211,368,-171,17406843,17407211
3041,6,12,1,2412,-84,-92,8,40:e3:d6:da:ca:c3,17407808,180,417,17407628,17407808
3042,6,12,1,2412,-84,-92,8,40:e3:d6:da:ca:c4,17408032,172,52,17407860,17408032
3043,4,1,1,2412,-84,-92,8,,17435395,304,27059,17435091,17435395
3044,4,1,1,2412,-86,-92,6,,17436910,304,1211,17436606,17436910
3045,6,12,1,2412,-86,-92,6,,17437295,36,349,17437259,17437295
3046,4,1,1,2412,-86,-92,6,,17437944,304,345,17437640,17437944
3047,4,1,1,2412,-86,-92,6,66:d8:ff:ae:5d:41,17439790,416,1430,17439374,17439790
3048,4,1,1,2412,-85,-92,7,,17440220,304,126,17439916,17440220
3049,4,1,1,2412,-76,-92,16,a6:e5:7c:28:b1:d3,17441175,992,-37,17440183,17441175
3050,6,12,1,2412,-87,-92,5,40:e3:d6:da:c8:03,17442857,184,1498,17442673,17442857
3051,6,12,1,2412,-88,-92,4,40:e3:d6:da:c8:04,17443065,176,32,17442889,17443065
3052,6,12,1,2412,-88,-92,4,40:e3:d6:da:c8:05,17443294,160,69,17443134,17443294
3053,6,6,1,2412,-88,-92,4,40:e3:d6:da:c8:06,17443513,380,-161,17443133,17443513
3054,6,12,1,2412,-85,-92,7,,17444021,36,472,17443985,17444021
3055,6,12,1,2412,-86,-92,6,,17444119,36,62,17444083,17444119
3056,6,12,1,2412,-87,-92,5,,17444334,36,179,17444298,17444334
3057,6,12,1,2412,-85,-92,7,,17444816,36,446,17444780,17444816
3058,6,12,1,2412,-85,-92,7,,17445273,36,421,17445237,17445273
3059,6,12,1,2412,-86,-92,6,,17445804,36,495,17445768,17445804
3060,6,12,1,2412,-85,-92,7,,17446342,36,502,17446306,17446342
3061,6,12,1,2412,-86,-92,6,,17446727,36,349,17446691,17446727
3062,6,12,1,2412,-85,-92,7,,17447642,36,879,17447606,17447642
3063,6,12,1,2412,-85,-92,7,,17447865,36,187,17447829,17447865
3064,6,12,1,2412,-85,-92,7,,17448278,36,377,17448242,17448278
3065,6,6,1,2412,-87,-92,5,84:d4:7e:f2:34:23,17448596,64,254,17448532,17448596
3066,6,6,1,2412,-82,-92,10,84:d4:7e:f2:34:23,17449477,64,817,17449413,17449477
3067,6,6,1,2412,-85,-92,7,84:d4:7e:f2:34:23,17450105,64,564,17450041,17450105
3068,6,6,1,2412,-84,-92,8,84:d4:7e:f2:34:23,17450231,64,62,17450167,17450231
3069,6,6,1,2412,-85,-92,7,84:d4:7e:f2:34:23,17450357,64,62,17450293,17450357
3070,6,6,1,2412,-85,-92,7,84:d4:7e:f2:34:23,17453361,64,2940,17453297,17453361
3071,6,6,1,2412,-86,-92,6,84:d4:7e:f2:34:23,17453487,64,62,17453423,17453487
3072,6,6,1,2412,-85,-92,7,84:d4:7e:f2:34:23,17453864,64,313,17453800,17453864
3073,6,6,1,2412,-85,-92,7,84:d4:7e:f2:34:23,17453990,64,62,17453926,17453990
3074,6,6,1,2412,-84,-92,8,84:d4:7e:f2:34:23,17462566,64,8512,17462502,17462566
3075,6,6,1,2412,-85,-92,7,84:d4:7e:f2:34:23,17463160,64,530,17463096,17463160
3076,6,6,1,2412,-86,-92,6,84:d4:7e:f2:34:23,17463286,64,62,17463222,17463286
3077,6,6,1,2412,-82,-92,10,84:d4:7e:f2:34:23,17463538,64,188,17463474,17463538
3078,6,6,1,2412,-85,-92,7,84:d4:7e:f2:34:23,17463663,64,61,17463599,17463663
3079,6,6,1,2412,-85,-92,7,84:d4:7e:f2:34:23,17463789,64,62,17463725,17463789
3080,6,6,1,2412,-82,-92,10,84:d4:7e:f2:34:23,17463915,64,62,17463851,17463915
3081,6,6,1,2412,-86,-92,6,84:d4:7e:f2:34:23,17464041,64,62,17463977,17464041
3082,6,6,1,2412,-86,-92,6,84:d4:7e:f2:34:23,17464166,64,61,17464102,17464166
3083,4,1,1,2412,-85,-92,7,,17469663,304,5193,17469359,17469663
3084,6,12,1,2412,-85,-92,7,,17470349,36,650,17470313,17470349
3085,6,12,1,2412,-85,-92,7,,17471221,36,836,17471185,17471221
3086,6,12,1,2412,-85,-92,7,,17471426,36,169,17471390,17471426
3087,6,12,1,2412,-85,-92,7,,17471596,36,134,17471560,17471596
3088,6,12,1,2412,-85,-92,7,,17471846,36,214,17471810,17471846
3089,6,12,1,2412,-85,-92,7,,17472321,36,439,17472285,17472321
3090,6,12,1,2412,-86,-92,6,,17473994,36,1637,17473958,17473994
3091,6,12,1,2412,-85,-92,7,,17474235,36,205,17474199,17474235
3092,6,12,1,2412,-85,-92,7,,17474648,36,377,17474612,17474648
3093,6,12,1,2412,-86,-92,6,,17474894,36,210,17474858,17474894
3094,6,12,1,2412,-86,-92,6,,17475000,36,70,17474964,17475000
3095,6,12,1,2412,-85,-92,7,,17475484,36,448,17475448,17475484
3096,6,12,1,2412,-86,-92,6,,17475627,36,107,17475591,17475627
3097,6,6,1,2412,-86,-92,6,84:d4:7e:f2:34:23,17475912,64,221,17475848,17475912
3098,6,6,1,2412,-85,-92,7,84:d4:7e:f2:34:23,17476038,64,62,17475974,17476038
3099,6,6,1,2412,-85,-92,7,84:d4:7e:f2:34:23,17476243,64,141,17476179,17476243
3100,6,6,1,2412,-84,-92,8,84:d4:7e:f2:34:23,17476595,64,288,17476531,17476595
3101,6,6,1,2412,-87,-92,5,84:d4:7e:f2:34:23,17476720,64,61,17476656,17476720
3102,6,6,1,2412,-85,-92,7,84:d4:7e:f2:34:23,17476971,64,187,17476907,17476971
3103,6,6,1,2412,-86,-92,6,84:d4:7e:f2:34:23,17477097,64,62,17477033,17477097
3104,6,6,1,2412,-86,-92,6,84:d4:7e:f2:34:23,17477223,64,62,17477159,17477223
3105,6,6,1,2412,-85,-92,7,84:d4:7e:f2:34:23,17477349,64,62,17477285,17477349
3106,6,6,1,2412,-86,-92,6,84:d4:7e:f2:34:23,17477474,64,61,17477410,17477474
3107,6,6,1,2412,-86,-92,6,84:d4:7e:f2:34:23,17477601,64,63,17477537,17477601
3108,6,6,1,2412,-85,-92,7,84:d4:7e:f2:34:23,17477727,64,62,17477663,17477727
3109,6,6,1,2412,-85,-92,7,84:d4:7e:f2:34:23,17477852,64,61,17477788,17477852
3110,4,1,1,2412,-79,-92,13,b8:3a:5a:88:e6:e1,17480857,2376,629,17478481,17480857
3111,6,6,1,2412,-84,-92,8,84:d4:7e:f2:34:23,17484615,64,3694,17484551,17484615
3112,6,6,1,2412,-85,-92,7,84:d4:7e:f2:34:23,17484740,64,61,17484676,17484740
3113,6,6,1,2412,-85,-92,7,84:d4:7e:f2:34:23,17484866,64,62,17484802,17484866
3114,6,6,1,2412,-85,-92,7,84:d4:7e:f2:34:23,17490092,64,5162,17490028,17490092
3115,6,6,1,2412,-85,-92,7,84:d4:7e:f2:34:23,17490629,64,473,17490565,17490629
3116,6,6,1,2412,-84,-92,8,84:d4:7e:f2:34:23,17490755,64,62,17490691,17490755
3117,6,6,1,2412,-86,-92,6,84:d4:7e:f2:34:23,17490881,64,62,17490817,17490881
3118,6,6,1,2412,-58,-92,34,40:e3:d6:da:ba:21,17494706,368,3457,17494338,17494706
3119,6,12,1,2412,-58,-92,34,40:e3:d6:da:ba:24,17495628,176,746,17495452,17495628
3120,6,6,1,2412,-59,-92,33,40:e3:d6:da:ba:26,17496039,380,31,17495659,17496039
3121,4,1,1,2412,-74,-92,18,,17497010,304,667,17496706,17497010
3122,6,6,1,2412,-85,-92,7,84:d4:7e:f2:34:23,17497350,64,276,17497286,17497350
3123,6,6,1,2412,-86,-92,6,84:d4:7e:f2:34:23,17497475,64,61,17497411,17497475
3124,6,6,1,2412,-86,-92,6,84:d4:7e:f2:34:23,17497601,64,62,17497537,17497601
3125,4,1,1,2412,-85,-92,7,,17498200,304,295,17497896,17498200
3126,6,12,1,2412,-82,-92,10,,17498832,36,596,17498796,17498832
3127,6,6,1,2412,-82,-92,10,84:d4:7e:f2:34:23,17498936,64,40,17498872,17498936
3128,6,6,1,2412,-85,-92,7,84:d4:7e:f2:34:23,17499062,64,62,17498998,17499062
3129,6,12,1,2412,-86,-92,6,,17499885,36,787,17499849,17499885
3130,6,12,1,2412,-83,-92,9,,17500477,36,556,17500441,17500477
3131,6,12,1,2412,-85,-92,7,,17500989,36,476,17500953,17500989
3132,6,12,1,2412,-84,-92,8,,17501600,36,575,17501564,17501600
3133,6,12,1,2412,-85,-92,7,,17501868,36,232,17501832,17501868
3134,6,12,1,2412,-85,-92,7,,17502576,36,672,17502540,17502576
3135,6,12,1,2412,-86,-92,6,,17503105,36,493,17503069,17503105
3136,6,12,1,2412,-86,-92,6,,17503382,36,241,17503346,17503382
3137,6,12,1,2412,-85,-92,7,,17504138,36,720,17504102,17504138
3138,6,12,1,2412,-85,-92,7,,17504701,36,527,17504665,17504701
3139,6,12,1,2412,-86,-92,6,,17504988,36,251,17504952,17504988
3140,6,12,1,2412,-86,-92,6,,17505087,36,63,17505051,17505087
3141,6,12,1,2412,-85,-92,7,,17505411,36,288,17505375,17505411
3142,4,1,1,2412,-86,-92,6,,17506853,304,1138,17506549,17506853
3143,6,6,1,2412,-85,-92,7,84:d4:7e:f2:34:23,17507523,64,606,17507459,17507523
3144,6,6,1,2412,-86,-92,6,84:d4:7e:f2:34:23,17507649,64,62,17507585,17507649
3145,6,6,1,2412,-85,-92,7,84:d4:7e:f2:34:23,17508286,64,573,17508222,17508286
3146,6,6,1,2412,-85,-92,7,84:d4:7e:f2:34:23,17508412,64,62,17508348,17508412
3147,6,6,1,2412,-85,-92,7,84:d4:7e:f2:34:23,17509160,64,684,17509096,17509160
3148,6,6,1,2412,-85,-92,7,84:d4:7e:f2:34:23,17509286,64,62,17509222,17509286
3149,6,12,1,2412,-84,-92,8,40:e3:d6:da:ca:c0,17509396,156,-46,17509240,17509396
3150,6,6,1,2412,-86,-92,6,40:e3:d6:da:ca:c1,17509611,368,-153,17509243,17509611
3151,6,12,1,2412,-86,-92,6,40:e3:d6:da:ca:c3,17510217,180,426,17510037,17510217
3152,6,12,1,2412,-84,-92,8,40:e3:d6:da:ca:c4,17510433,172,44,17510261,17510433
3153,6,6,1,2412,-85,-92,7,40:e3:d6:da:ca:c6,17510872,380,59,17510492,17510872
3154,6,6,1,2412,-85,-92,7,84:d4:7e:f2:34:23,17511480,64,544,17511416,17511480
3155,6,12,1,2412,-86,-92,6,,17514872,36,3356,17514836,17514872
3156,6,12,1,2412,-84,-92,8,,17515844,36,936,17515808,17515844
3157,6,12,1,2412,-85,-92,7,,17516364,36,484,17516328,17516364
3158,6,12,1,2412,-85,-92,7,,17516948,36,548,17516912,17516948
3159,6,12,1,2412,-86,-92,6,,17517962,36,978,17517926,17517962
3160,6,12,1,2412,-85,-92,7,,17518060,36,62,17518024,17518060
3161,6,12,1,2412,-85,-92,7,,17518160,36,64,17518124,17518160
3162,6,12,1,2412,-84,-92,8,,17518293,40,93,17518253,17518293
3163,6,12,1,2412,-85,-92,7,,17518395,40,62,17518355,17518395
3164,6,12,1,2412,-85,-92,7,,17518497,40,62,17518457,17518497
3165,6,12,1,2412,-85,-92,7,,17519072,40,535,17519032,17519072
3166,6,12,1,2412,-86,-92,6,,17519174,40,62,17519134,17519174
3167,6,12,1,2412,-85,-92,7,,17519275,40,61,17519235,17519275
3168,6,12,1,2412,-83,-92,9,,17519600,40,285,17519560,17519600
3169,6,12,1,2412,-81,-92,11,,17519702,40,62,17519662,17519702
3170,6,6,1,2412,-85,-92,7,,17519765,68,-5,17519697,17519765
3171,6,6,1,2412,-85,-92,7,66:d8:ff:ae:5d:41,17519972,64,143,17519908,17519972
3172,6,6,1,2412,-86,-92,6,,17520054,44,38,17520010,17520054
3173,6,12,1,2412,-82,-92,10,,17520189,36,99,17520153,17520189
3174,6,12,1,2412,-82,-92,10,,17520242,32,21,17520210,17520242
3175,6,12,1,2412,-85,-92,7,,17520589,36,311,17520553,17520589
3176,6,6,1,2412,-85,-92,7,,17520648,44,15,17520604,17520648
3177,6,6,1,2412,-87,-92,5,,17521018,68,302,17520950,17521018
3178,6,12,1,2412,-85,-92,7,,17521196,36,142,17521160,17521196
3179,6,6,1,2412,-87,-92,5,,17521611,44,371,17521567,17521611
3180,6,6,1,2412,-76,-92,16,e6:aa:ea:b7:4a:dd,17533091,408,11072,17532683,17533091
3181,4,1,1,2412,-77,-92,15,,17540948,304,7553,17540644,17540948
3182,4,1,1,2412,-77,-92,15,a6:e5:7c:28:b1:d3,17541286,992,-654,17540294,17541286
3183,6,12,1,2412,-88,-92,4,40:e3:d6:da:c8:05,17543260,160,1814,17543100,17543260
3184,6,6,1,2412,-75,-92,17,e6:aa:ea:b7:4a:dd,17545000,408,1332,17544592,17545000
3185,6,12,1,2412,-86,-92,6,,17549378,44,4334,17549334,17549378
3186,4,1,1,2412,-83,-92,9,,17551509,304,1827,17551205,17551509
3187,4,1,1,2412,-70,-92,22,54:e4:3a:ec:fb:64,17553794,2160,125,17551634,17553794
3188,6,12,1,2412,-86,-92,6,,17555958,36,2128,17555922,17555958
3189,6,12,1,2412,-85,-92,7,,17556011,32,21,17555979,17556011
3190,6,12,1,2412,-85,-92,7,,17556132,44,77,17556088,17556132
3191,6,6,1,2412,-76,-92,16,e6:aa:ea:b7:4a:dd,17557117,408,577,17556709,17557117
3192,6,12,1,2412,-85,-92,7,,17560080,36,2927,17560044,17560080
3193,6,12,1,2412,-84,-92,8,,17560133,32,21,17560101,17560133
3194,6,12,1,2412,-85,-92,7,,17560283,44,106,17560239,17560283
3195,6,6,1,2412,-85,-92,7,66:d8:ff:ae:5d:41,17564310,64,3963,17564246,17564310
3196,6,6,1,2412,-84,-92,8,,17564391,44,37,17564347,17564391
3197,6,6,1,2412,-76,-92,16,e6:aa:ea:b7:4a:dd,17569245,408,4446,17568837,17569245
3198,6,12,1,2412,-87,-92,5,,17585864,36,16583,17585828,17585864
3199,4,1,1,2412,-72,-92,20,,17586984,304,816,17586680,17586984
3200,6,12,1,2412,-85,-92,7,84:d4:7e:f2:34:20,17587140,160,-4,17586980,17587140
3201,6,6,1,2412,-85,-92,7,84:d4:7e:f2:34:21,17587332,368,-176,17586964,17587332
3202,6,12,1,2412,-86,-92,6,84:d4:7e:f2:34:22,17587753,180,241,17587573,17587753
3203,6,12,1,2412,-85,-92,7,84:d4:7e:f2:34:23,17587993,180,60,17587813,17587993
3204,6,12,1,2412,-85,-92,7,84:d4:7e:f2:34:24,17588198,176,29,17588022,17588198
3205,6,12,1,2412,-85,-92,7,84:d4:7e:f2:34:25,17588400,160,42,17588240,17588400
3206,6,12,1,2412,-85,-92,7,,17589540,36,1104,17589504,17589540
3207,6,12,1,2412,-84,-92,8,,17589639,36,63,17589603,17589639
3208,6,12,1,2412,-86,-92,6,,17589738,36,63,17589702,17589738
3209,6,12,1,2412,-85,-92,7,,17589837,36,63,17589801,17589837
3210,6,12,1,2412,-86,-92,6,,17590057,36,184,17590021,17590057
3211,6,12,1,2412,-88,-92,4,,17590458,36,365,17590422,17590458
3212,6,12,1,2412,-85,-92,7,,17590638,36,144,17590602,17590638
3213,6,12,1,2412,-85,-92,7,,17591039,36,365,17591003,17591039
3214,6,12,1,2412,-84,-92,8,,17591138,36,63,17591102,17591138
3215,6,12,1,2412,-86,-92,6,,17591413,36,239,17591377,17591413
3216,6,12,1,2412,-82,-92,10,,17591871,36,422,17591835,17591871
3217,6,6,1,2412,-85,-92,7,84:d4:7e:f2:34:23,17592233,64,298,17592169,17592233
3218,6,6,1,2412,-87,-92,5,84:d4:7e:f2:34:23,17593120,64,823,17593056,17593120
3219,6,12,1,2412,-87,-92,5,40:e3:d6:da:bb:e5,17594830,156,1554,17594674,17594830
3220,6,6,1,2412,-86,-92,6,40:e3:d6:da:bb:e6,17595045,380,-165,17594665,17595045
3221,6,6,1,2412,-87,-92,5,84:d4:7e:f2:34:23,17596101,64,992,17596037,17596101
3222,6,6,1,2412,-85,-92,7,84:d4:7e:f2:34:23,17596401,64,236,17596337,17596401
3223,6,6,1,2412,-84,-92,8,84:d4:7e:f2:34:23,17596527,64,62,17596463,17596527
3224,6,6,1,2412,-80,-92,12,84:d4:7e:f2:42:26,17599123,380,2216,17598743,17599123
3225,6,6,1,2412,-83,-92,9,84:d4:7e:f2:34:23,17606205,64,7018,17606141,17606205
3226,6,6,1,2412,-84,-92,8,84:d4:7e:f2:34:23,17606331,64,62,17606267,17606331
3227,6,6,1,2412,-86,-92,6,84:d4:7e:f2:34:23,17606457,64,62,17606393,17606457
3228,6,6,1,2412,-86,-92,6,84:d4:7e:f2:34:23,17606583,64,62,17606519,17606583
3229,6,6,1,2412,-86,-92,6,84:d4:7e:f2:34:23,17606708,64,61,17606644,17606708
3230,6,6,1,2412,-84,-92,8,84:d4:7e:f2:34:23,17606835,64,63,17606771,17606835
3231,6,6,1,2412,-87,-92,5,84:d4:7e:f2:34:23,17607206,64,307,17607142,17607206
3232,6,6,1,2412,-86,-92,6,84:d4:7e:f2:34:23,17608013,64,743,17607949,17608013
3233,6,12,1,2412,-87,-92,5,40:e3:d6:da:ca:c3,17612612,180,4419,17612432,17612612
3234,6,12,1,2412,-86,-92,6,40:e3:d6:da:ca:c4,17612826,172,42,17612654,17612826
3235,6,12,1,2412,-86,-92,6,40:e3:d6:da:ca:c5,17613032,156,50,17612876,17613032
3236,6,6,1,2412,-86,-92,6,84:d4:7e:f2:34:23,17616101,64,3005,17616037,17616101
3237,6,6,1,2412,-86,-92,6,84:d4:7e:f2:34:23,17616227,64,62,17616163,17616227
3238,6,6,1,2412,-85,-92,7,84:d4:7e:f2:34:23,17616832,64,541,17616768,17616832
3239,6,6,1,2412,-86,-92,6,84:d4:7e:f2:34:23,17617420,64,524,17617356,17617420
3240,6,6,1,2412,-87,-92,5,84:d4:7e:f2:34:23,17617546,64,62,17617482,17617546
3241,6,6,1,2412,-84,-92,8,84:d4:7e:f2:34:23,17617671,64,61,17617607,17617671
3242,6,6,1,2412,-84,-92,8,84:d4:7e:f2:34:23,17617798,64,63,17617734,17617798
3243,6,6,1,2412,-86,-92,6,84:d4:7e:f2:34:23,17618050,64,188,17617986,17618050
3244,6,6,1,2412,-56,-92,36,e6:aa:ea:c9:ea:33,17622759,408,4301,17622351,17622759
3245,6,6,1,2412,-87,-92,5,84:d4:7e:f2:34:23,17626104,64,3281,17626040,17626104
3246,6,6,1,2412,-87,-92,5,84:d4:7e:f2:34:23,17626590,64,422,17626526,17626590
3247,6,6,1,2412,-85,-92,7,84:d4:7e:f2:34:23,17626784,64,130,17626720,17626784
3248,6,6,1,2412,-85,-92,7,84:d4:7e:f2:34:23,17626910,64,62,17626846,17626910
3249,6,6,1,2412,-87,-92,5,84:d4:7e:f2:34:23,17627287,64,313,17627223,17627287
3250,6,6,1,2412,-86,-92,6,84:d4:7e:f2:34:23,17627413,64,62,17627349,17627413
3251,6,6,1,2412,-87,-92,5,84:d4:7e:f2:34:23,17627538,64,61,17627474,17627538
3252,6,6,1,2412,-86,-92,6,84:d4:7e:f2:34:23,17627664,64,62,17627600,17627664
3253,6,6,1,2412,-86,-92,6,84:d4:7e:f2:34:23,17627790,64,62,17627726,17627790
3254,6,6,1,2412,-86,-92,6,84:d4:7e:f2:34:23,17628042,64,188,17627978,17628042
3255,6,6,1,2412,-56,-92,36,e6:aa:ea:c9:ea:33,17634869,408,6419,17634461,17634869
3256,6,6,1,2412,-86,-92,6,84:d4:7e:f2:34:23,17636091,64,1158,17636027,17636091
3257,6,6,1,2412,-86,-92,6,84:d4:7e:f2:34:23,17636225,64,70,17636161,17636225
3258,6,6,1,2412,-85,-92,7,84:d4:7e:f2:34:23,17636482,64,193,17636418,17636482
3259,6,6,1,2412,-86,-92,6,84:d4:7e:f2:34:23,17636607,64,61,17636543,17636607
3260,6,6,1,2412,-86,-92,6,84:d4:7e:f2:34:23,17636734,64,63,17636670,17636734
3261,6,6,1,2412,-85,-92,7,84:d4:7e:f2:34:23,17636859,64,61,17636795,17636859
3262,6,6,1,2412,-86,-92,6,84:d4:7e:f2:34:23,17637144,64,221,17637080,17637144
3263,6,6,1,2412,-86,-92,6,84:d4:7e:f2:34:23,17637270,64,62,17637206,17637270
3264,6,6,1,2412,-85,-92,7,84:d4:7e:f2:34:23,17637395,64,61,17637331,17637395
3265,6,6,1,2412,-87,-92,5,84:d4:7e:f2:34:23,17637521,64,62,17637457,17637521
3266,6,6,1,2412,-86,-92,6,84:d4:7e:f2:34:23,17637647,64,62,17637583,17637647
3267,6,6,1,2412,-85,-92,7,84:d4:7e:f2:34:23,17637773,64,62,17637709,17637773
3268,6,6,1,2412,-86,-92,6,84:d4:7e:f2:34:23,17637899,64,62,17637835,17637899
3269,6,6,1,2412,-86,-92,6,84:d4:7e:f2:34:23,17638125,64,162,17638061,17638125
3270,6,6,1,2412,-85,-92,7,40:e3:d6:da:c8:06,17645189,380,6684,17644809,17645189
3271,6,6,1,2412,-85,-92,7,84:d4:7e:f2:34:23,17646350,64,1097,17646286,17646350
3272,6,6,1,2412,-86,-92,6,84:d4:7e:f2:34:23,17646476,64,62,17646412,17646476
3273,6,6,1,2412,-87,-92,5,84:d4:7e:f2:34:23,17646602,64,62,17646538,17646602
3274,6,6,1,2412,-87,-92,5,84:d4:7e:f2:34:23,17646728,64,62,17646664,17646728
3275,6,6,1,2412,-86,-92,6,84:d4:7e:f2:34:23,17646853,64,61,17646789,17646853
3276,6,6,1,2412,-57,-92,35,e6:aa:ea:c9:ea:33,17646994,408,-267,17646586,17646994
3277,6,6,1,2412,-86,-92,6,84:d4:7e:f2:34:23,17647482,64,424,17647418,17647482
3278,6,6,1,2412,-85,-92,7,84:d4:7e:f2:34:23,17647733,64,187,17647669,17647733
3279,6,6,1,2412,-86,-92,6,84:d4:7e:f2:34:23,17647859,64,62,17647795,17647859
3280,4,1,1,2412,-70,-92,22,54:e4:3a:ec:fb:64,17656170,2160,6151,17654010,17656170
3281,6,6,1,2412,-57,-92,35,e6:aa:ea:c9:ea:33,17659108,408,2530,17658700,17659108
3282,6,6,1,2412,-86,-92,6,66:d8:ff:ae:5d:41,17665207,64,6035,17665143,17665207
3283,6,6,1,2412,-87,-92,5,,17665289,44,38,17665245,17665289
3284,6,6,1,2412,-76,-92,16,,17665474,44,141,17665430,17665474
3285,6,12,1,2412,-87,-92,5,,17665648,36,138,17665612,17665648
3286,6,6,1,2412,-79,-92,13,,17665707,44,15,17665663,17665707
3287,6,6,1,2412,-87,-92,5,,17665839,68,64,17665771,17665839
3288,6,12,1,2412,-88,-92,4,,17666008,36,133,17665972,17666008
3289,6,6,1,2412,-87,-92,5,,17666067,44,15,17666023,17666067
3290,6,12,1,2412,-87,-92,5,,17666596,36,493,17666560,17666596
3291,6,6,1,2412,-87,-92,5,,17666656,44,16,17666612,17666656
3292,6,6,1,2412,-85,-92,7,,17667065,68,341,17666997,17667065
3293,6,12,1,2412,-87,-92,5,,17667260,36,159,17667224,17667260
3294,6,12,1,2412,-87,-92,5,,17667313,32,21,17667281,17667313
3295,6,12,1,2412,-86,-92,6,,17667595,36,246,17667559,17667595
3296,6,12,1,2412,-87,-92,5,,17667648,32,21,17667616,17667648
3297,6,12,1,2412,-87,-92,5,,17667806,44,114,17667762,17667806
3298,6,12,1,2412,-87,-92,5,,17668080,36,238,17668044,17668080
3299,6,6,1,2412,-86,-92,6,,17668139,44,15,17668095,17668139
3300,6,6,1,2412,-84,-92,8,,17668336,68,129,17668268,17668336
3301,6,6,1,2412,-85,-92,7,,17668528,44,148,17668484,17668528
3302,6,6,1,2412,-57,-92,35,e6:aa:ea:c9:ea:33,17671238,408,2302,17670830,17671238
3303,6,12,1,2412,-87,-92,5,,17672091,36,817,17672055,17672091
3304,6,6,1,2412,-86,-92,6,,17672149,44,14,17672105,17672149
3305,6,6,1,2412,-87,-92,5,,17675544,68,3327,17675476,17675544
3306,6,12,1,2412,-86,-92,6,,17675721,36,141,17675685,17675721
3307,6,12,1,2412,-88,-92,4,,17675774,32,21,17675742,17675774
3308,6,12,1,2412,-87,-92,5,,17675944,44,126,17675900,17675944
3309,6,12,1,2412,-88,-92,4,,17676264,36,284,17676228,17676264
3310,6,6,1,2412,-87,-92,5,,17676323,44,15,17676279,17676323
3311,6,6,1,2412,-87,-92,5,,17676459,68,68,17676391,17676459
3312,6,12,1,2412,-87,-92,5,,17676600,36,105,17676564,17676600
3313,6,12,1,2412,-88,-92,4,,17676653,32,21,17676621,17676653
3314,6,12,1,2412,-89,-92,3,,17676783,44,86,17676739,17676783
3315,6,12,1,2412,-87,-92,5,,17677519,36,700,17677483,17677519
3316,6,6,1,2412,-87,-92,5,,17677579,44,16,17677535,17677579
3317,6,12,1,2412,-87,-92,5,,17677960,44,337,17677916,17677960
3318,6,12,1,2412,-86,-92,6,,17681964,36,3968,17681928,17681964
3319,6,12,1,2412,-87,-92,5,,17682017,32,21,17681985,17682017
3320,4,1,1,2412,-36,-92,56,b8:3a:5a:88:e6:e0,17683295,2360,-1082,17680935,17683295
3321,4,1,1,2412,-73,-92,19,b8:3a:5a:88:e6:e1,17685761,2376,90,17683385,17685761
3322,6,12,1,2412,-89,-92,3,84:d4:7e:f2:34:20,17688330,160,2409,17688170,17688330
3323,6,12,1,2412,-88,-92,4,,17690224,36,1858,17690188,17690224
3324,6,6,1,2412,-88,-92,4,,17690282,44,14,17690238,17690282
3325,6,6,1,2412,-88,-92,4,40:e3:d6:da:bb:e1,17696201,368,5551,17695833,17696201
3326,6,6,1,2412,-85,-92,7,,17696941,68,672,17696873,17696941
3327,6,12,1,2412,-86,-92,6,,17697909,44,924,17697865,17697909
3328,6,12,1,2412,-89,-92,3,,17698198,36,253,17698162,17698198
3329,6,6,1,2412,-87,-92,5,,17698257,44,15,17698213,17698257
3330,6,6,1,2412,-87,-92,5,,17698645,68,320,17698577,17698645
3331,6,12,1,2412,-88,-92,4,,17698825,36,144,17698789,17698825
3332,6,6,1,2412,-87,-92,5,,17698885,44,16,17698841,17698885
3333,6,12,1,2412,-57,-92,35,40:e3:d6:da:ba:20,17699309,160,264,17699149,17699309
3334,6,6,1,2412,-57,-92,35,40:e3:d6:da:ba:21,17699510,368,-167,17699142,17699510
3335,6,12,1,2412,-57,-92,35,40:e3:d6:da:ba:22,17699906,180,216,17699726,17699906
3336,6,12,1,2412,-57,-92,35,40:e3:d6:da:ba:24,17700375,176,293,17700199,17700375
3337,6,12,1,2412,-57,-92,35,40:e3:d6:da:ba:25,17700604,160,69,17700444,17700604
3338,6,6,1,2412,-57,-92,35,40:e3:d6:da:ba:26,17700796,380,-188,17700416,17700796
3339,6,12,1,2412,-78,-92,14,84:d4:7e:f2:42:24,17701200,176,228,17701024,17701200
3340,6,12,1,2412,-87,-92,5,,17702399,36,1163,17702363,17702399
3341,6,6,1,2412,-85,-92,7,,17702459,44,16,17702415,17702459
3342,6,6,1,2412,-88,-92,4,,17702847,68,320,17702779,17702847
3343,6,6,1,2412,-86,-92,6,,17705348,44,2457,17705304,17705348
3344,6,6,1,2412,-86,-92,6,,17705736,68,320,17705668,17705736
3345,6,6,1,2412,-87,-92,5,,17706368,68,564,17706300,17706368
3346,6,12,1,2412,-89,-92,3,,17709308,32,2908,17709276,17709308
3347,6,12,1,2412,-85,-92,7,,17709561,36,217,17709525,17709561
3348,6,6,1,2412,-85,-92,7,,17709621,44,16,17709577,17709621
3349,6,12,1,2412,-89,-92,3,,17711028,36,1371,17710992,17711028
3350,6,12,1,2412,-87,-92,5,,17711224,36,160,17711188,17711224
3351,6,6,1,2412,-88,-92,4,66:d8:ff:ae:5d:41,17711409,64,121,17711345,17711409
3352,6,6,1,2412,-89,-92,3,,17711490,44,37,17711446,17711490
3353,6,12,1,2412,-86,-92,6,40:e3:d6:da:ca:c5,17715431,156,3785,17715275,17715431
3354,6,6,1,2412,-87,-92,5,40:e3:d6:da:ca:c6,17715646,380,-165,17715266,17715646
3355,6,12,1,2412,-85,-92,7,40:e3:d6:da:c8:00,17745424,160,29618,17745264,17745424
3356,6,6,1,2412,-82,-92,10,40:e3:d6:da:c8:01,17745634,368,-158,17745266,17745634
3357,6,12,1,2412,-84,-92,8,40:e3:d6:da:c8:02,17746039,180,225,17745859,17746039
3358,6,12,1,2412,-81,-92,11,40:e3:d6:da:c8:04,17746462,176,247,17746286,17746462
3359,4,1,1,2412,-70,-92,22,54:e4:3a:ec:fb:64,17758568,2160,9946,17756408,17758568
3360,4,1,1,2412,-74,-92,18,b8:3a:5a:88:e6:e1,17788068,2376,27124,17785692,17788068
3361,6,12,1,2412,-90,-92,2,84:d4:7e:f2:34:20,17790619,160,2391,17790459,17790619
3362,6,6,1,2412,-91,-92,1,84:d4:7e:f2:34:21,17790829,368,-158,17790461,17790829
3363,6,12,1,2412,-80,-92,12,fc:f8:ae:51:0a:f9,17791609,48,732,17791561,17791609
3364,6,12,1,2412,-89,-92,3,,17791675,32,34,17791643,17791675
3365,6,12,1,2412,-56,-92,36,40:e3:d6:da:ba:20,17801711,160,9876,17801551,17801711
3366,6,6,1,2412,-56,-92,36,40:e3:d6:da:ba:21,17801912,368,-167,17801544,17801912
3367,6,12,1,2412,-56,-92,36,40:e3:d6:da:ba:22,17802326,180,234,17802146,17802326
3368,6,12,1,2412,-56,-92,36,40:e3:d6:da:ba:23,17802558,184,48,17802374,17802558
3369,6,12,1,2412,-56,-92,36,40:e3:d6:da:ba:24,17802794,176,60,17802618,17802794
3370,6,12,1,2412,-56,-92,36,40:e3:d6:da:ba:25,17803005,160,51,17802845,17803005
3371,6,6,1,2412,-56,-92,36,40:e3:d6:da:ba:26,17803206,380,-179,17802826,17803206
3372,6,12,1,2412,-79,-92,13,84:d4:7e:f2:42:24,17803597,176,215,17803421,17803597
3373,6,12,1,2412,-80,-92,12,84:d4:7e:f2:42:25,17803816,160,59,17803656,17803816
3374,6,12,1,2412,-90,-92,2,,17814142,36,10290,17814106,17814142
3375,6,12,1,2412,-86,-92,6,,17814195,32,21,17814163,17814195
3376,6,6,1,2412,-85,-92,7,66:d8:ff:ae:5d:41,17814671,64,412,17814607,17814671
3377,6,6,1,2412,-87,-92,5,66:d8:ff:ae:5d:41,17814842,64,107,17814778,17814842
3378,6,6,1,2412,-90,-92,2,,17814924,44,38,17814880,17814924
3379,6,12,1,2412,-89,-92,3,,17815220,36,260,17815184,17815220
3380,6,12,1,2412,-85,-92,7,,17815273,32,21,17815241,17815273
3381,6,12,1,2412,-87,-92,5,,17816469,44,1152,17816425,17816469
3382,6,12,1,2412,-84,-92,8,40:e3:d6:da:ca:c0,17816596,156,-29,17816440,17816596
3383,6,6,1,2412,-85,-92,7,40:e3:d6:da:ca:c1,17816794,368,-170,17816426,17816794
3384,6,12,1,2412,-85,-92,7,,17817197,44,359,17817153,17817197
3385,6,12,1,2412,-86,-92,6,40:e3:d6:da:ca:c2,17817302,176,-71,17817126,17817302
3386,6,6,1,2412,-86,-92,6,40:e3:d6:da:ca:c6,17818148,380,466,17817768,17818148
3387,6,12,1,2412,-87,-92,5,,17820896,44,2704,17820852,17820896
3388,6,12,1,2412,-85,-92,7,,17821163,32,235,17821131,17821163
3389,6,12,1,2412,-87,-92,5,,17821645,36,446,17821609,17821645
3390,6,12,1,2412,-90,-92,2,,17821698,32,21,17821666,17821698
3391,6,12,1,2412,-86,-92,6,,17822060,32,330,17822028,17822060
3392,6,12,1,2412,-86,-92,6,,17822284,44,180,17822240,17822284
3393,6,12,1,2412,-86,-92,6,,17824943,36,2623,17824907,17824943
3394,6,12,1,2412,-86,-92,6,,17836707,36,11728,17836671,17836707
3395,6,12,1,2412,-90,-92,2,,17836760,32,21,17836728,17836760
3396,6,12,1,2412,-85,-92,7,,17846639,36,9843,17846603,17846639
3397,6,12,1,2412,-87,-92,5,,17846692,32,21,17846660,17846692
3398,6,12,1,2412,-86,-92,6,40:e3:d6:da:c8:00,17847825,160,973,17847665,17847825
3399,6,6,1,2412,-85,-92,7,40:e3:d6:da:c8:01,17848017,368,-176,17847649,17848017
3400,6,12,1,2412,-85,-92,7,40:e3:d6:da:c8:02,17848413,180,216,17848233,17848413
3401,6,12,1,2412,-85,-92,7,40:e3:d6:da:c8:03,17848618,184,21,17848434,17848618
3402,6,12,1,2412,-85,-92,7,40:e3:d6:da:c8:05,17849081,160,303,17848921,17849081
3403,6,6,1,2412,-84,-92,8,40:e3:d6:da:c8:06,17849300,380,-161,17848920,17849300
3404,6,24,1,2412,-87,-92,5,66:d8:ff:ae:5d:41,17857422,32,8090,17857390,17857422
3405,4,1,1,2412,-69,-92,23,54:e4:3a:ec:fb:64,17861002,2160,1420,17858842,17861002
3406,4,1,1,2412,-74,-92,18,b8:3a:5a:88:e6:e0,17888070,2360,24708,17885710,17888070
3407,6,12,1,2412,-75,-92,17,84:d4:7e:d5:12:c0,17896918,960,7888,17895958,17896918
3408,6,12,1,2412,-56,-92,36,40:e3:d6:da:ba:20,17904101,160,7023,17903941,17904101
3409,6,6,1,2412,-56,-92,36,40:e3:d6:da:ba:21,17904302,368,-167,17903934,17904302
3410,6,12,1,2412,-56,-92,36,40:e3:d6:da:ba:22,17904707,180,225,17904527,17904707
3411,6,12,1,2412,-56,-92,36,40:e3:d6:da:ba:25,17905368,160,501,17905208,17905368
3412,6,6,1,2412,-56,-92,36,40:e3:d6:da:ba:26,17905570,380,-178,17905190,17905570
3413,6,12,1,2412,-81,-92,11,84:d4:7e:f2:42:24,17906221,176,475,17906045,17906221
3414,6,12,1,2412,-82,-92,10,84:d4:7e:f2:42:25,17906431,160,50,17906271,17906431
3415,6,6,1,2412,-81,-92,11,84:d4:7e:f2:42:26,17906623,380,-188,17906243,17906623
3416,6,6,1,2412,-88,-92,4,e6:aa:ea:c9:ea:1b,17909027,408,1996,17908619,17909027
3417,6,6,1,2412,-55,-92,37,e6:aa:ea:c9:ea:33,17938195,408,28760,17937787,17938195
3418,6,6,1,2412,-55,-92,37,e6:aa:ea:c9:ea:33,17950314,408,11711,17949906,17950314
3419,6,6,1,2412,-55,-92,37,e6:aa:ea:c9:ea:33,17962586,408,11864,17962178,17962586
3420,4,1,1,2412,-70,-92,22,54:e4:3a:ec:fb:64,17963390,2160,-1356,17961230,17963390
3421,4,1,1,2412,-90,-92,2,,17969452,304,5758,17969148,17969452
3422,6,12,1,2412,-89,-92,3,,17969666,36,178,17969630,17969666
3423,6,12,1,2412,-86,-92,6,,17970446,32,748,17970414,17970446
3424,6,12,1,2412,-87,-92,5,,17970606,44,116,17970562,17970606
3425,6,12,1,2412,-86,-92,6,,17970775,36,133,17970739,17970775
3426,6,12,1,2412,-89,-92,3,,17970828,32,21,17970796,17970828
3427,6,6,1,2412,-55,-92,37,e6:aa:ea:c9:ea:33,17974543,408,3307,17974135,17974543
3428,6,6,1,2412,-55,-92,37,e6:aa:ea:c9:ea:33,17986664,408,11713,17986256,17986664
3429,4,1,1,2412,-75,-92,17,b8:3a:5a:88:e6:e0,17990502,2360,1478,17988142,17990502
3430,4,1,1,2412,-74,-92,18,b8:3a:5a:88:e6:e1,17992882,2376,4,17990506,17992882
3431,6,12,1,2412,-89,-92,3,40:e3:d6:da:bb:e0,18003182,156,10144,18003026,18003182
3432,6,12,1,2412,-57,-92,35,40:e3:d6:da:ba:20,18006515,160,3173,18006355,18006515
3433,6,6,1,2412,-56,-92,36,40:e3:d6:da:ba:21,18006716,368,-167,18006348,18006716
3434,6,12,1,2412,-57,-92,35,40:e3:d6:da:ba:22,18007103,180,207,18006923,18007103
3435,6,12,1,2412,-57,-92,35,40:e3:d6:da:ba:23,18007309,184,22,18007125,18007309
3436,6,12,1,2412,-57,-92,35,40:e3:d6:da:ba:24,18007545,176,60,18007369,18007545
3437,6,12,1,2412,-57,-92,35,40:e3:d6:da:ba:25,18007765,160,60,18007605,18007765
3438,6,6,1,2412,-57,-92,35,40:e3:d6:da:ba:26,18007975,380,-170,18007595,18007975
3439,6,6,1,2412,-83,-92,9,84:d4:7e:f2:42:26,18008780,380,425,18008400,18008780
3440,4,1,1,2412,-73,-92,19,b8:3a:5a:88:e6:e0,18009611,2240,-1409,18007371,18009611
3441,6,6,1,2412,-85,-92,7,40:e3:d6:da:ca:c1,18021610,368,11631,18021242,18021610
3442,6,12,1,2412,-83,-92,9,40:e3:d6:da:ca:c2,18021996,176,210,18021820,18021996
3443,6,12,1,2412,-84,-92,8,40:e3:d6:da:ca:c3,18022208,180,32,18022028,18022208
3444,6,12,1,2412,-88,-92,4,40:e3:d6:da:ca:c4,18022440,172,60,18022268,18022440
3445,6,12,1,2412,-85,-92,7,40:e3:d6:da:ca:c5,18022664,156,68,18022508,18022664
3446,6,6,1,2412,-86,-92,6,40:e3:d6:da:ca:c6,18022879,380,-165,18022499,18022879
3447,4,1,1,2412,-80,-92,12,c0:c9:e3:4d:6e:bf,18034042,872,10291,18033170,18034042
3448,4,1,1,2412,-82,-92,10,,18034931,304,585,18034627,18034931
3449,6,6,1,2412,-77,-92,15,e6:aa:ea:b7:4a:dd,18065327,408,29988,18064919,18065327
3450,4,1,1,2412,-69,-92,23,54:e4:3a:ec:fb:64,18066274,2160,-1213,18064114,18066274
3451,6,6,1,2412,-67,-92,25,e6:aa:ea:b7:4a:dd,18077440,408,10758,18077032,18077440
3452,6,6,1,2412,-78,-92,14,e6:aa:ea:b7:4a:dd,18089562,408,11714,18089154,18089562
3453,4,1,1,2412,-73,-92,19,b8:3a:5a:88:e6:e0,18092870,2360,948,18090510,18092870
3454,4,1,1,2412,-73,-92,19,b8:3a:5a:88:e6:e1,18095259,2376,13,18092883,18095259
3455,6,6,1,2412,-79,-92,13,e6:aa:ea:b7:4a:dd,18101676,408,6009,18101268,18101676
3456,6,12,1,2412,-88,-92,4,40:e3:d6:da:bb:e0,18105597,156,3765,18105441,18105597
3457,6,6,1,2412,-89,-92,3,40:e3:d6:da:bb:e1,18105784,368,-181,18105416,18105784
3458,6,12,1,2412,-89,-92,3,40:e3:d6:da:bb:e2,18106613,176,653,18106437,18106613
3459,6,24,1,2412,-81,-92,11,,18106936,28,295,18106908,18106936
3460,6,24,1,2412,-82,-92,10,,18107050,28,86,18107022,18107050
3461,6,24,1,2412,-81,-92,11,,18107162,28,84,18107134,18107162
3462,6,12,1,2412,-88,-92,4,,18108728,32,1534,18108696,18108728
3463,6,6,1,2412,-57,-92,35,40:e3:d6:da:ba:21,18109104,368,8,18108736,18109104
3464,6,12,1,2412,-57,-92,35,40:e3:d6:da:ba:22,18109500,180,216,18109320,18109500
3465,6,12,1,2412,-58,-92,34,40:e3:d6:da:ba:23,18109715,184,31,18109531,18109715
3466,6,12,1,2412,-57,-92,35,40:e3:d6:da:ba:25,18110144,160,269,18109984,18110144
3467,6,6,1,2412,-57,-92,35,40:e3:d6:da:ba:26,18110345,380,-179,18109965,18110345
3468,6,12,1,2412,-84,-92,8,84:d4:7e:f2:42:24,18110723,176,202,18110547,18110723
3469,6,12,1,2412,-83,-92,9,84:d4:7e:f2:42:25,18110933,160,50,18110773,18110933
3470,6,6,1,2412,-85,-92,7,40:e3:d6:da:ca:c1,18124026,368,12725,18123658,18124026
3471,6,12,1,2412,-86,-92,6,40:e3:d6:da:ca:c2,18124440,176,238,18124264,18124440
3472,6,6,1,2412,-80,-92,12,40:e3:d6:da:ca:c6,18125296,380,476,18124916,18125296
3473,6,12,1,2412,-88,-92,4,,18141790,32,16462,18141758,18141790
3474,6,12,1,2412,-88,-92,4,,18141914,44,80,18141870,18141914
3475,6,12,1,2412,-89,-92,3,,18143565,32,1619,18143533,18143565
3476,6,12,1,2412,-83,-92,9,,18151159,36,7558,18151123,18151159
3477,6,12,1,2412,-82,-92,10,,18151212,32,21,18151180,18151212
3478,6,12,1,2412,-86,-92,6,,18151587,44,331,18151543,18151587
3479,6,12,1,2412,-87,-92,5,,18151857,36,234,18151821,18151857
3480,6,12,1,2412,-87,-92,5,,18151910,32,21,18151878,18151910
3481,6,12,1,2412,-88,-92,4,,18154117,36,2171,18154081,18154117
3482,6,12,1,2412,-87,-92,5,,18154170,32,21,18154138,18154170
3483,6,12,1,2412,-86,-92,6,,18154546,44,332,18154502,18154546
3484,6,12,1,2412,-85,-92,7,40:e3:d6:da:c8:05,18156352,160,1646,18156192,18156352
3485,6,6,1,2412,-86,-92,6,40:e3:d6:da:c8:06,18156587,380,-145,18156207,18156587
3486,6,12,1,2412,-89,-92,3,,18157139,36,516,18157103,18157139
3487,6,12,1,2412,-85,-92,7,,18157192,32,21,18157160,18157192
3488,6,12,1,2412,-88,-92,4,,18157568,36,340,18157532,18157568
3489,6,12,1,2412,-85,-92,7,,18157620,32,20,18157588,18157620
3490,6,6,1,2412,-82,-92,10,66:d8:ff:ae:5d:41,18158004,64,320,18157940,18158004
3491,6,12,1,2412,-86,-92,6,,18158256,36,216,18158220,18158256
3492,6,12,1,2412,-84,-92,8,,18158309,32,21,18158277,18158309
3493,6,12,1,2412,-88,-92,4,,18158439,44,86,18158395,18158439
3494,4,1,1,2412,-70,-92,22,54:e4:3a:ec:fb:64,18168210,2160,7611,18166050,18168210
3495,4,1,1,2412,-74,-92,18,b8:3a:5a:88:e6:e0,18195288,2360,24718,18192928,18195288
3496,4,1,1,2412,-75,-92,17,b8:3a:5a:88:e6:e1,18197676,2376,12,18195300,18197676
3497,6,6,1,2412,-87,-92,5,84:d4:7e:f2:34:21,18200455,368,2411,18200087,18200455
3498,6,12,1,2412,-87,-92,5,84:d4:7e:f2:34:22,18200842,180,207,18200662,18200842
3499,6,12,1,2412,-86,-92,6,84:d4:7e:f2:34:23,18201048,180,26,18200868,18201048
3500,6,6,1,2412,-86,-92,6,84:d4:7e:f2:34:26,18201673,380,245,18201293,18201673
3501,6,12,1,2412,-89,-92,3,,18206681,32,4976,18206649,18206681
3502,6,6,1,2412,-85,-92,7,66:d8:ff:ae:5d:41,18208192,64,1447,18208128,18208192
3503,6,12,1,2412,-83,-92,9,,18208765,44,529,18208721,18208765
3504,6,12,1,2412,-81,-92,11,,18209343,36,542,18209307,18209343
3505,6,12,1,2412,-86,-92,6,,18209522,44,135,18209478,18209522
3506,6,12,1,2412,-57,-92,35,40:e3:d6:da:ba:20,18211293,160,1611,18211133,18211293
3507,6,6,1,2412,-57,-92,35,40:e3:d6:da:ba:21,18211512,368,-149,18211144,18211512
3508,6,12,1,2412,-57,-92,35,40:e3:d6:da:ba:22,18211908,180,216,18211728,18211908
3509,6,12,1,2412,-57,-92,35,40:e3:d6:da:ba:23,18212123,184,31,18211939,18212123
3510,6,12,1,2412,-57,-92,35,40:e3:d6:da:ba:24,18212341,176,42,18212165,18212341
3511,6,12,1,2412,-57,-92,35,40:e3:d6:da:ba:25,18212570,160,69,18212410,18212570
3512,6,6,1,2412,-57,-92,35,40:e3:d6:da:ba:26,18212771,380,-179,18212391,18212771
3513,6,6,1,2412,-86,-92,6,e6:aa:ea:c9:ea:1b,18239919,408,26740,18239511,18239919
3514,6,6,1,2412,-54,-92,38,e6:aa:ea:c9:ea:33,18256133,408,15806,18255725,18256133
3515,6,12,1,2412,-88,-92,4,40:e3:d6:da:c8:00,18257447,160,1154,18257287,18257447
3516,6,6,1,2412,-87,-92,5,40:e3:d6:da:c8:01,18257639,368,-176,18257271,18257639
3517,4,1,1,2412,-81,-92,11,,18267086,304,9143,18266782,18267086
3518,6,12,1,2412,-87,-92,5,84:d4:7e:f2:34:25,18269010,140,1784,18268870,18269010
3519,4,1,1,2412,-71,-92,21,54:e4:3a:ec:fb:64,18270596,2160,-574,18268436,18270596
3520,6,6,1,2412,-54,-92,38,e6:aa:ea:c9:ea:33,18280368,408,9364,18279960,18280368
3521,4,1,1,2412,-83,-92,9,,18287569,304,6897,18287265,18287569
3522,6,12,1,2412,-87,-92,5,,18287822,32,221,18287790,18287822
3523,6,6,1,2412,-54,-92,38,e6:aa:ea:c9:ea:33,18292484,408,4254,18292076,18292484
3524,6,12,1,2412,-88,-92,4,84:d4:7e:f2:34:23,18302575,180,9911,18302395,18302575
3525,6,6,1,2412,-86,-92,6,84:d4:7e:f2:34:26,18303210,380,255,18302830,18303210
3526,6,6,1,2412,-54,-92,38,e6:aa:ea:c9:ea:33,18304608,408,990,18304200,18304608
3527,6,12,1,2412,-87,-92,5,,18306998,36,2354,18306962,18306998
3528,6,12,1,2412,-57,-92,35,40:e3:d6:da:ba:20,18313693,160,6535,18313533,18313693
3529,6,6,1,2412,-57,-92,35,40:e3:d6:da:ba:21,18313885,368,-176,18313517,18313885
3530,6,12,1,2412,-56,-92,36,40:e3:d6:da:ba:22,18314298,180,233,18314118,18314298
3531,6,12,1,2412,-57,-92,35,40:e3:d6:da:ba:23,18314513,184,31,18314329,18314513
3532,6,12,1,2412,-57,-92,35,40:e3:d6:da:ba:24,18314723,176,34,18314547,18314723
3533,6,6,1,2412,-57,-92,35,40:e3:d6:da:ba:26,18315134,380,31,18314754,18315134
3534,6,6,1,2412,-86,-92,6,,18329597,44,14419,18329553,18329597
3535,6,12,1,2412,-82,-92,10,,18330188,32,559,18330156,18330188
3536,6,12,1,2412,-81,-92,11,,18330348,44,116,18330304,18330348
3537,6,6,1,2412,-89,-92,3,a8:5b:f7:55:1a:40,18336938,72,6518,18336866,18336938
3538,6,6,1,2412,-90,-92,2,a8:5b:f7:55:1a:40,18337091,72,81,18337019,18337091
3539,6,6,1,2412,-89,-92,3,a8:5b:f7:55:1a:40,18337261,72,98,18337189,18337261
3540,6,6,1,2412,-89,-92,3,a8:5b:f7:55:1a:40,18337404,72,71,18337332,18337404
3541,6,6,1,2412,-90,-92,2,a8:5b:f7:55:1a:40,18337728,72,252,18337656,18337728
3542,4,1,1,2412,-84,-92,8,,18338911,304,879,18338607,18338911
3543,6,12,1,2412,-82,-92,10,,18349141,36,10194,18349105,18349141
3544,6,12,1,2412,-86,-92,6,,18349194,32,21,18349162,18349194
3545,6,6,1,2412,-89,-92,3,40:e3:d6:da:c8:06,18361279,380,11705,18360899,18361279
3546,6,12,1,2412,-80,-92,12,,18363455,36,2140,18363419,18363455
3547,6,12,1,2412,-81,-92,11,,18363508,32,21,18363476,18363508
3548,6,6,1,2412,-71,-92,21,e6:aa:ea:b7:4a:dd,18368079,408,4163,18367671,18368079
3549,4,1,1,2412,-69,-92,23,54:e4:3a:ec:fb:64,18373076,2160,2837,18370916,18373076
3550,6,12,1,2412,-88,-92,4,,18378607,36,5495,18378571,18378607
3551,6,12,1,2412,-82,-92,10,,18378660,32,21,18378628,18378660
3552,6,12,1,2412,-81,-92,11,,18378985,44,281,18378941,18378985
3553,6,6,1,2412,-72,-92,20,e6:aa:ea:b7:4a:dd,18380194,408,801,18379786,18380194
3554,6,6,1,2412,-71,-92,21,e6:aa:ea:b7:4a:dd,18392504,408,11902,18392096,18392504
3555,6,12,1,2412,-80,-92,12,,18394788,36,2248,18394752,18394788
3556,6,12,1,2412,-88,-92,4,,18394841,32,21,18394809,18394841
3557,6,12,1,2412,-79,-92,13,,18395116,36,239,18395080,18395116
3558,6,12,1,2412,-88,-92,4,,18395170,32,22,18395138,18395170
3559,6,12,1,2412,-82,-92,10,,18395282,44,68,18395238,18395282
3560,4,1,1,2412,-77,-92,15,b8:3a:5a:88:e6:e0,18400092,2360,2450,18397732,18400092
3561,4,1,1,2412,-76,-92,16,b8:3a:5a:88:e6:e1,18403234,2376,766,18400858,18403234
3562,6,12,1,2412,-86,-92,6,84:d4:7e:f2:34:24,18406838,176,3428,18406662,18406838
3563,6,12,1,2412,-86,-92,6,84:d4:7e:f2:34:25,18407048,160,50,18406888,18407048
3564,6,6,1,2412,-88,-92,4,84:d4:7e:f2:34:26,18407267,380,-161,18406887,18407267
3565,6,12,1,2412,-88,-92,4,,18407900,32,601,18407868,18407900
3566,6,12,1,2412,-87,-92,5,40:e3:d6:da:bb:e2,18413384,176,5308,18413208,18413384
3567,6,12,1,2412,-87,-92,5,40:e3:d6:da:bb:e4,18414126,172,570,18413954,18414126
3568,6,6,1,2412,-88,-92,4,40:e3:d6:da:bb:e6,18414961,380,455,18414581,18414961
3569,6,12,1,2412,-54,-92,38,40:e3:d6:da:ba:20,18416106,160,985,18415946,18416106
3570,6,6,1,2412,-54,-92,38,40:e3:d6:da:ba:21,18416341,368,-133,18415973,18416341
3571,6,12,1,2412,-55,-92,37,40:e3:d6:da:ba:22,18416728,180,207,18416548,18416728
3572,6,12,1,2412,-55,-92,37,40:e3:d6:da:ba:23,18417230,184,318,18417046,18417230
3573,6,12,1,2412,-55,-92,37,40:e3:d6:da:ba:24,18417440,176,34,18417264,18417440
3574,6,12,1,2412,-55,-92,37,40:e3:d6:da:ba:25,18417641,160,41,18417481,18417641
3575,6,6,1,2412,-55,-92,37,40:e3:d6:da:ba:26,18417860,380,-161,18417480,18417860
3576,6,12,1,2412,-87,-92,5,,18437404,32,19512,18437372,18437404
3577,6,12,1,2412,-85,-92,7,,18437725,32,289,18437693,18437725
3578,6,12,1,2412,-87,-92,5,,18437850,44,81,18437806,18437850
3579,6,12,1,2412,-87,-92,5,,18449075,32,11193,18449043,18449075
3580,6,12,1,2412,-86,-92,6,,18449501,32,394,18449469,18449501
3581,4,1,1,2412,-63,-92,29,a6:e5:7c:28:b1:d3,18462237,992,11744,18461245,18462237
3582,6,12,1,2412,-85,-92,7,,18468950,32,6681,18468918,18468950
3583,6,12,1,2412,-76,-92,16,,18469140,36,154,18469104,18469140
3584,6,12,1,2412,-87,-92,5,,18473943,32,4771,18473911,18473943
3585,4,1,1,2412,-71,-92,21,54:e4:3a:ec:fb:64,18475395,2160,-708,18473235,18475395
3586,4,1,1,2412,-75,-92,17,c0:c9:e3:4d:6e:bf,18487065,872,10798,18486193,18487065
3587,4,1,1,2412,-60,-92,32,,18487954,304,585,18487650,18487954
3588,4,1,1,2412,-84,-92,8,,18493334,304,5076,18493030,18493334
3589,4,1,1,2412,-76,-92,16,b8:3a:5a:88:e6:e1,18505573,2376,9863,18503197,18505573
3590,6,12,1,2412,-88,-92,4,84:d4:7e:f2:34:20,18508133,160,2400,18507973,18508133
3591,6,12,1,2412,-87,-92,5,40:e3:d6:da:bb:e0,18515205,156,6916,18515049,18515205
3592,6,6,1,2412,-87,-92,5,40:e3:d6:da:bb:e1,18515393,368,-180,18515025,18515393
3593,6,12,1,2412,-87,-92,5,40:e3:d6:da:bb:e5,18516429,156,880,18516273,18516429
3594,6,6,1,2412,-87,-92,5,40:e3:d6:da:bb:e6,18516626,380,-183,18516246,18516626
3595,6,6,1,2412,-54,-92,38,40:e3:d6:da:ba:26,18519983,380,2977,18519603,18519983
3596,6,12,1,2412,-88,-92,4,,18526328,32,6313,18526296,18526328
3597,6,12,1,2412,-89,-92,3,,18531733,32,5373,18531701,18531733
3598,4,1,1,2412,-72,-92,20,c0:c9:e3:4d:6e:bf,18532438,872,-167,18531566,18532438
3599,4,1,1,2412,-84,-92,8,,18533327,304,585,18533023,18533327
3600,6,6,1,2412,-87,-92,5,40:e3:d6:da:ca:c6,18535088,380,1381,18534708,18535088
3601,6,12,1,2412,-86,-92,6,,18560331,32,25211,18560299,18560331
3602,6,12,1,2412,-84,-92,8,,18569886,32,9523,18569854,18569886
3603,6,6,1,2412,-52,-92,40,e6:aa:ea:c9:ea:33,18583743,408,13449,18583335,18583743
3604,6,12,1,2412,-88,-92,4,40:e3:d6:da:bb:e2,18589831,156,5932,18589675,18589831
3605,6,12,1,2412,-87,-92,5,,18594500,32,4637,18594468,18594500
3606,6,6,1,2412,-52,-92,40,e6:aa:ea:c9:ea:33,18595965,408,1057,18595557,18595965
3607,6,6,1,2412,-81,-92,11,66:d8:ff:ae:5d:41,18602554,64,6525,18602490,18602554
3608,6,6,1,2412,-87,-92,5,,18602635,44,37,18602591,18602635
3609,6,6,1,2412,-86,-92,6,84:d4:7e:f2:34:26,18611102,380,8087,18610722,18611102
3610,6,6,1,2412,-52,-92,40,e6:aa:ea:c9:ea:33,18620674,408,9164,18620266,18620674
3611,6,6,1,2412,-53,-92,39,40:e3:d6:da:ba:21,18621331,368,289,18620963,18621331
3612,6,12,1,2412,-53,-92,39,40:e3:d6:da:ba:22,18621718,180,207,18621538,18621718
3613,6,12,1,2412,-53,-92,39,40:e3:d6:da:ba:23,18621932,184,30,18621748,18621932
3614,6,12,1,2412,-53,-92,39,40:e3:d6:da:ba:24,18622160,176,52,18621984,18622160
3615,6,12,1,2412,-53,-92,39,40:e3:d6:da:ba:25,18622388,160,68,18622228,18622388
3616,6,6,1,2412,-53,-92,39,40:e3:d6:da:ba:26,18622598,380,-170,18622218,18622598
3617,6,6,1,2412,-84,-92,8,84:d4:7e:f2:42:26,18623181,380,203,18622801,18623181
3618,6,6,1,2412,-87,-92,5,40:e3:d6:da:ca:c1,18636005,368,12456,18635637,18636005
3619,6,6,1,2412,-83,-92,9,66:d8:ff:ae:5d:41,18655371,64,19302,18655307,18655371
3620,6,12,1,2412,-83,-92,9,,18655561,36,154,18655525,18655561
3621,6,12,1,2412,-82,-92,10,,18669480,44,13875,18669436,18669480
3622,6,12,1,2412,-83,-92,9,,18675398,36,5882,18675362,18675398
3623,6,12,1,2412,-88,-92,4,,18675451,32,21,18675419,18675451
3624,6,12,1,2412,-87,-92,5,,18675597,44,102,18675553,18675597
3625,4,1,1,2412,-69,-92,23,54:e4:3a:ec:fb:64,18680169,2160,2412,18678009,18680169
3626,6,12,1,2412,-87,-92,5,,18705736,36,25531,18705700,18705736
3627,6,12,1,2412,-83,-92,9,,18705788,32,20,18705756,18705788
3628,6,12,1,2412,-83,-92,9,,18706164,44,332,18706120,18706164
3629,6,12,1,2412,-87,-92,5,,18706292,36,92,18706256,18706292
3630,6,12,1,2412,-83,-92,9,,18706345,32,21,18706313,18706345
3631,6,12,1,2412,-88,-92,4,,18706916,36,535,18706880,18706916
3632,4,1,1,2412,-74,-92,18,b8:3a:5a:88:e6:e0,18707286,2360,-1990,18704926,18707286
3633,6,12,1,2412,-87,-92,5,84:d4:7e:f2:34:25,18713080,160,5634,18712920,18713080
3634,6,6,1,2412,-89,-92,3,84:d4:7e:f2:34:26,18713290,380,-170,18712910,18713290
3635,6,12,1,2412,-86,-92,6,,18714145,32,823,18714113,18714145
3636,6,6,1,2412,-88,-92,4,40:e3:d6:da:bb:e1,18720175,368,5662,18719807,18720175
3637,6,12,1,2412,-88,-92,4,40:e3:d6:da:bb:e2,18720588,176,237,18720412,18720588
3638,6,12,1,2412,-87,-92,5,40:e3:d6:da:bb:e5,18721638,156,894,18721482,18721638
3639,6,12,1,2412,-52,-92,40,40:e3:d6:da:ba:20,18723319,160,1521,18723159,18723319
3640,6,6,1,2412,-53,-92,39,40:e3:d6:da:ba:21,18723529,368,-158,18723161,18723529
3641,6,12,1,2412,-52,-92,40,40:e3:d6:da:ba:22,18723925,180,216,18723745,18723925
3642,6,12,1,2412,-52,-92,40,40:e3:d6:da:ba:23,18724130,184,21,18723946,18724130
3643,6,12,1,2412,-52,-92,40,40:e3:d6:da:ba:24,18724340,176,34,18724164,18724340
3644,6,12,1,2412,-52,-92,40,40:e3:d6:da:ba:25,18724541,160,41,18724381,18724541
3645,6,6,1,2412,-52,-92,40,40:e3:d6:da:ba:26,18724760,380,-161,18724380,18724760
3646,6,12,1,2412,-83,-92,9,,18734614,36,9818,18734578,18734614
3647,6,12,1,2412,-88,-92,4,,18734668,32,22,18734636,18734668
3648,6,12,1,2412,-87,-92,5,,18734785,44,73,18734741,18734785
3649,6,6,1,2412,-87,-92,5,e6:aa:ea:c9:ea:1b,18737455,408,2262,18737047,18737455
3650,6,12,1,2412,-88,-92,4,,18740069,32,2582,18740037,18740069
3651,6,12,1,2412,-88,-92,4,,18746330,36,6225,18746294,18746330
3652,6,12,1,2412,-83,-92,9,,18746382,32,20,18746350,18746382
3653,6,12,1,2412,-83,-92,9,,18751055,36,4637,18751019,18751055
3654,6,12,1,2412,-88,-92,4,,18751107,32,20,18751075,18751107
3655,6,12,1,2412,-88,-92,4,,18752433,36,1290,18752397,18752433
3656,6,12,1,2412,-82,-92,10,,18752486,32,21,18752454,18752486
3657,6,12,1,2412,-83,-92,9,,18752616,44,86,18752572,18752616
3658,4,1,1,2412,-85,-92,7,,18768328,304,15408,18768024,18768328
3659,6,6,1,2412,-88,-92,4,40:e3:d6:da:c8:01,18769664,368,968,18769296,18769664
3660,6,12,1,2412,-82,-92,10,,18770685,44,977,18770641,18770685
3661,6,6,1,2412,-87,-92,5,e6:aa:ea:c9:ea:1b,18773792,408,2699,18773384,18773792
3662,6,6,1,2412,-73,-92,19,e6:aa:ea:b7:4a:dd,18785629,408,11429,18785221,18785629
3663,6,12,1,2412,-84,-92,8,,18801530,36,15865,18801494,18801530
3664,6,12,1,2412,-87,-92,5,,18801584,32,22,18801552,18801584
3665,6,12,1,2412,-87,-92,5,,18801698,44,70,18801654,18801698
3666,6,12,1,2412,-89,-92,3,,18807575,32,5845,18807543,18807575
3667,4,1,1,2412,-74,-92,18,b8:3a:5a:88:e6:e0,18809692,2360,-243,18807332,18809692
3668,4,1,1,2412,-74,-92,18,b8:3a:5a:88:e6:e1,18812080,2376,12,18809704,18812080
3669,6,6,1,2412,-88,-92,4,84:d4:7e:f2:34:21,18814352,368,1904,18813984,18814352
3670,6,12,1,2412,-89,-92,3,84:d4:7e:f2:34:24,18815221,176,693,18815045,18815221
3671,6,6,1,2412,-88,-92,4,84:d4:7e:f2:34:26,18815651,380,50,18815271,18815651
3672,6,6,1,2412,-73,-92,19,e6:aa:ea:b7:4a:dd,18821986,408,5927,18821578,18821986
3673,6,12,1,2412,-52,-92,40,40:e3:d6:da:ba:20,18827912,160,5766,18827752,18827912
3674,6,6,1,2412,-52,-92,40,40:e3:d6:da:ba:21,18828113,368,-167,18827745,18828113
3675,6,12,1,2412,-52,-92,40,40:e3:d6:da:ba:22,18828546,180,253,18828366,18828546
3676,6,12,1,2412,-52,-92,40,40:e3:d6:da:ba:24,18829006,176,284,18828830,18829006
3677,6,12,1,2412,-52,-92,40,40:e3:d6:da:ba:25,18829235,160,69,18829075,18829235
3678,6,6,1,2412,-52,-92,40,40:e3:d6:da:ba:26,18829436,380,-179,18829056,18829436
3679,6,12,1,2412,-88,-92,4,40:e3:d6:da:ca:c0,18840602,156,11010,18840446,18840602
3680,6,6,1,2412,-87,-92,5,40:e3:d6:da:ca:c1,18840790,368,-180,18840422,18840790
3681,6,12,1,2412,-88,-92,4,40:e3:d6:da:ca:c2,18841185,176,219,18841009,18841185
3682,6,12,1,2412,-86,-92,6,40:e3:d6:da:ca:c3,18841387,180,22,18841207,18841387
3683,4,1,1,2412,-75,-92,17,a6:e5:7c:28:b1:d3,18871566,992,29187,18870574,18871566
3684,6,12,1,2412,-87,-92,5,40:e3:d6:da:c8:00,18872417,160,691,18872257,18872417
3685,6,6,1,2412,-88,-92,4,40:e3:d6:da:c8:01,18872618,368,-167,18872250,18872618
3686,6,12,1,2412,-88,-92,4,,18877555,36,4901,18877519,18877555
3687,6,12,1,2412,-88,-92,4,,18877955,36,364,18877919,18877955
3688,6,12,1,2412,-84,-92,8,,18881731,36,3740,18881695,18881731
3689,6,12,1,2412,-89,-92,3,,18884068,32,2305,18884036,18884068
3690,6,12,1,2412,-84,-92,8,,18884506,32,406,18884474,18884506
3691,4,1,1,2412,-67,-92,25,54:e4:3a:ec:fb:64,18884798,2160,-1868,18882638,18884798
3692,6,12,1,2412,-84,-92,8,,18888198,36,3364,18888162,18888198
3693,6,12,1,2412,-87,-92,5,,18888252,32,22,18888220,18888252
3694,6,12,1,2412,-83,-92,9,,18888598,36,310,18888562,18888598
3695,6,12,1,2412,-88,-92,4,,18888652,32,22,18888620,18888652
3696,6,12,1,2412,-89,-92,3,,18888769,44,73,18888725,18888769
3697,6,12,1,2412,-88,-92,4,,18896443,32,7642,18896411,18896443
3698,6,6,1,2412,-51,-92,41,e6:aa:ea:c9:ea:33,18898332,408,1481,18897924,18898332
3699,6,6,1,2412,-51,-92,41,e6:aa:ea:c9:ea:33,18910454,408,11714,18910046,18910454
3700,4,1,1,2412,-75,-92,17,b8:3a:5a:88:e6:e0,18912554,2360,-260,18910194,18912554
3701,6,6,1,2412,-52,-92,40,e6:aa:ea:c9:ea:33,18922574,408,9612,18922166,18922574
3702,6,12,1,2412,-86,-92,6,40:e3:d6:da:bb:e0,18924808,156,2078,18924652,18924808
3703,6,6,1,2412,-87,-92,5,40:e3:d6:da:bb:e1,18925014,368,-162,18924646,18925014
3704,6,12,1,2412,-87,-92,5,40:e3:d6:da:bb:e2,18925402,176,212,18925226,18925402
3705,6,12,1,2412,-86,-92,6,40:e3:d6:da:bb:e3,18925621,180,39,18925441,18925621
3706,6,12,1,2412,-87,-92,5,40:e3:d6:da:bb:e4,18925854,172,61,18925682,18925854
3707,6,12,1,2412,-88,-92,4,40:e3:d6:da:bb:e5,18926051,156,41,18925895,18926051
3708,6,6,1,2412,-89,-92,3,40:e3:d6:da:bb:e6,18926257,380,-174,18925877,18926257
3709,6,12,1,2412,-51,-92,41,40:e3:d6:da:ba:20,18928168,160,1751,18928008,18928168
3710,6,6,1,2412,-51,-92,41,40:e3:d6:da:ba:21,18928360,368,-176,18927992,18928360
3711,6,12,1,2412,-52,-92,40,40:e3:d6:da:ba:22,18928774,180,234,18928594,18928774
3712,6,12,1,2412,-52,-92,40,40:e3:d6:da:ba:23,18929007,184,49,18928823,18929007
3713,6,12,1,2412,-52,-92,40,40:e3:d6:da:ba:24,18929225,176,42,18929049,18929225
3714,6,12,1,2412,-51,-92,41,40:e3:d6:da:ba:25,18929427,160,42,18929267,18929427
3715,6,6,1,2412,-51,-92,41,40:e3:d6:da:ba:26,18929646,380,-161,18929266,18929646
3716,6,12,1,2412,-84,-92,8,84:d4:7e:f2:42:25,18930162,160,356,18930002,18930162
3717,6,6,1,2412,-84,-92,8,84:d4:7e:f2:42:26,18930353,380,-189,18929973,18930353
3718,6,6,1,2412,-52,-92,40,e6:aa:ea:c9:ea:33,18934688,408,3927,18934280,18934688
3719,6,6,1,2412,-86,-92,6,40:e3:d6:da:ca:c6,18944451,380,9383,18944071,18944451
3720,6,24,1,2412,-85,-92,7,66:d8:ff:ae:5d:41,18948624,32,4141,18948592,18948624
3721,6,12,1,2412,-89,-92,3,,18948673,32,17,18948641,18948673
3722,4,1,1,2412,-79,-92,13,c0:c9:e3:4d:6e:bf,18979403,872,29858,18978531,18979403
3723,4,1,1,2412,-85,-92,7,,18980291,304,584,18979987,18980291
3724,6,6,1,2412,-78,-92,14,40:e3:d6:da:c8:01,18980480,368,-179,18980112,18980480
3725,6,12,1,2412,-86,-92,6,40:e3:d6:da:c8:05,18981511,160,871,18981351,18981511
3726,4,1,1,2412,-67,-92,25,54:e4:3a:ec:fb:64,18987370,2160,3699,18985210,18987370
3727,4,1,1,2412,-84,-92,8,,18996698,304,9024,18996394,18996698
3728,6,12,1,2412,-87,-92,5,40:e3:d6:da:bb:e0,19027191,156,30337,19027035,19027191
3729,6,6,1,2412,-87,-92,5,40:e3:d6:da:bb:e1,19027397,368,-162,19027029,19027397
3730,6,6,1,2412,-88,-92,4,40:e3:d6:da:bb:e6,19028648,380,871,19028268,19028648
3731,6,12,1,2412,-52,-92,40,40:e3:d6:da:ba:20,19030496,160,1688,19030336,19030496
3732,6,6,1,2412,-52,-92,40,40:e3:d6:da:ba:21,19030715,368,-149,19030347,19030715
3733,6,12,1,2412,-52,-92,40,40:e3:d6:da:ba:22,19031111,180,216,19030931,19031111
3734,6,12,1,2412,-52,-92,40,40:e3:d6:da:ba:24,19031544,176,257,19031368,19031544
3735,6,6,1,2412,-52,-92,40,40:e3:d6:da:ba:26,19031965,380,41,19031585,19031965
3736,6,6,1,2412,-86,-92,6,e6:aa:ea:c9:ea:1b,19043072,408,10699,19042664,19043072
3737,6,12,1,2412,-88,-92,4,40:e3:d6:da:ca:c0,19045398,156,2170,19045242,19045398
3738,6,6,1,2412,-87,-92,5,40:e3:d6:da:ca:c1,19045604,368,-162,19045236,19045604
3739,6,12,1,2412,-88,-92,4,40:e3:d6:da:ca:c3,19046210,180,426,19046030,19046210
3740,6,12,1,2412,-87,-92,5,40:e3:d6:da:c8:00,19076635,160,30265,19076475,19076635
3741,6,12,1,2412,-87,-92,5,40:e3:d6:da:c8:03,19077464,184,645,19077280,19077464
3742,4,1,1,2412,-73,-92,19,,19079583,304,1815,19079279,19079583
3743,4,1,1,2412,-68,-92,24,54:e4:3a:ec:fb:64,19080261,2112,-1434,19078149,19080261
3744,4,1,1,2412,-65,-92,27,54:e4:3a:ec:fb:64,19084090,2112,1717,19081978,19084090
3745,4,1,1,2412,-66,-92,26,54:e4:3a:ec:fb:64,19087614,2112,1412,19085502,19087614
3746,4,1,1,2412,-67,-92,25,54:e4:3a:ec:fb:64,19089798,2160,24,19087638,19089798
3747,4,1,1,2412,-82,-92,10,,19091966,304,1864,19091662,19091966
3748,6,12,1,2412,-86,-92,6,40:e3:d6:da:c8:00,19092129,140,23,19091989,19092129
3749,6,12,1,2412,-87,-92,5,,19092280,32,119,19092248,19092280
3750,6,12,1,2412,-87,-92,5,40:e3:d6:da:c8:02,19092786,160,346,19092626,19092786
3751,6,12,1,2412,-86,-92,6,40:e3:d6:da:c8:05,19093220,140,294,19093080,19093220
3752,4,1,1,2412,-66,-92,26,54:e4:3a:ec:fb:64,19094643,2112,-689,19092531,19094643
3753,6,6,1,2412,-72,-92,20,e6:aa:ea:b7:4a:dd,19100192,408,5141,19099784,19100192
3754,4,1,1,2412,-66,-92,26,54:e4:3a:ec:fb:64,19103347,2112,1043,19101235,19103347
3755,4,1,1,2412,-67,-92,25,54:e4:3a:ec:fb:64,19110229,2112,4770,19108117,19110229
3756,6,6,1,2412,-72,-92,20,e6:aa:ea:b7:4a:dd,19112314,408,1677,19111906,19112314
3757,4,1,1,2412,-65,-92,27,54:e4:3a:ec:fb:64,19113417,2112,-1009,19111305,19113417
3758,4,1,1,2412,-67,-92,25,54:e4:3a:ec:fb:64,19116548,2112,1019,19114436,19116548
3759,4,1,1,2412,-76,-92,16,b8:3a:5a:88:e6:e1,19120539,2376,1615,19118163,19120539
3760,4,1,1,2412,-85,-92,7,,19123644,304,2801,19123340,19123644
3761,6,12,1,2412,-88,-92,4,40:e3:d6:da:c8:00,19123816,140,32,19123676,19123816
3762,6,12,1,2412,-88,-92,4,40:e3:d6:da:bb:e5,19130857,156,6885,19130701,19130857
3763,6,12,1,2412,-53,-92,39,40:e3:d6:da:ba:20,19132922,160,1905,19132762,19132922
3764,6,12,1,2412,-52,-92,40,40:e3:d6:da:ba:24,19133960,176,862,19133784,19133960
3765,6,12,1,2412,-52,-92,40,40:e3:d6:da:ba:25,19134171,160,51,19134011,19134171
3766,6,6,1,2412,-52,-92,40,40:e3:d6:da:ba:26,19134363,380,-188,19133983,19134363
3767,6,6,1,2412,-84,-92,8,84:d4:7e:f2:42:26,19135319,380,576,19134939,19135319
3768,6,6,1,2412,-72,-92,20,e6:aa:ea:b7:4a:dd,19136542,408,815,19136134,19136542
3769,4,1,1,2412,-86,-92,6,,19137881,304,1035,19137577,19137881
3770,6,12,1,2412,-87,-92,5,40:e3:d6:da:ca:c0,19138144,136,127,19138008,19138144
3771,6,6,1,2412,-87,-92,5,40:e3:d6:da:ca:c1,19138330,348,-162,19137982,19138330
3772,6,12,1,2412,-88,-92,4,40:e3:d6:da:ca:c2,19138733,156,247,19138577,19138733
3773,6,12,1,2412,-88,-92,4,40:e3:d6:da:ca:c3,19138924,156,35,19138768,19138924
3774,4,1,1,2412,-78,-92,14,b8:3a:5a:88:e6:e1,19142974,2256,1794,19140718,19142974
3775,6,12,1,2412,-88,-92,4,40:e3:d6:da:ca:c0,19147818,156,4688,19147662,19147818
3776,6,12,1,2412,-87,-92,5,40:e3:d6:da:ca:c2,19148420,176,426,19148244,19148420
3777,6,6,1,2412,-72,-92,20,e6:aa:ea:b7:4a:dd,19148660,408,-168,19148252,19148660
3778,4,1,1,2412,-85,-92,7,,19158253,304,9289,19157949,19158253
3779,6,12,1,2412,-82,-92,10,40:e3:d6:da:ca:c5,19164192,136,5803,19164056,19164192
3780,6,12,1,2412,-88,-92,4,,19166115,32,1891,19166083,19166115
3781,6,12,1,2412,-88,-92,4,,19166248,44,89,19166204,19166248
3782,6,6,1,2412,-87,-92,5,40:e3:d6:da:c8:01,19179246,368,12630,19178878,19179246
3783,6,12,1,2412,-87,-92,5,40:e3:d6:da:c8:02,19179650,180,224,19179470,19179650
3784,6,12,1,2412,-89,-92,3,,19183695,36,4009,19183659,19183695
3785,4,1,1,2412,-72,-92,20,b8:3a:5a:88:e6:e0,19219295,2360,33240,19216935,19219295
3786,6,12,1,2412,-88,-92,4,40:e3:d6:da:bb:e0,19232253,156,12802,19232097,19232253
3787,6,6,1,2412,-88,-92,4,40:e3:d6:da:bb:e1,19232618,368,-3,19232250,19232618
3788,6,12,1,2412,-87,-92,5,40:e3:d6:da:bb:e5,19233637,156,863,19233481,19233637
3789,6,6,1,2412,-84,-92,8,40:e3:d6:da:bb:e6,19233852,380,-165,19233472,19233852
3790,6,12,1,2412,-53,-92,39,40:e3:d6:da:ba:20,19235308,160,1296,19235148,19235308
3791,6,6,1,2412,-53,-92,39,40:e3:d6:da:ba:21,19235509,368,-167,19235141,19235509
3792,6,12,1,2412,-53,-92,39,40:e3:d6:da:ba:22,19235923,180,234,19235743,19235923
3793,6,12,1,2412,-53,-92,39,40:e3:d6:da:ba:24,19236365,176,266,19236189,19236365
3794,6,12,1,2412,-53,-92,39,40:e3:d6:da:ba:25,19236576,160,51,19236416,19236576
3795,6,6,1,2412,-53,-92,39,40:e3:d6:da:ba:26,19236777,380,-179,19236397,19236777
3796,6,6,1,2412,-85,-92,7,84:d4:7e:f2:42:26,19237528,380,371,19237148,19237528
3797,6,12,1,2412,-86,-92,6,40:e3:d6:da:ca:c2,19259265,156,21581,19259109,19259265
3798,6,12,1,2412,-88,-92,4,,19274609,32,15312,19274577,19274609
3799,4,1,1,2412,-84,-92,8,,19277116,304,2203,19276812,19277116
3800,6,12,1,2412,-83,-92,9,40:e3:d6:da:ca:c2,19277280,156,8,19277124,19277280
3801,6,12,1,2412,-88,-92,4,40:e3:d6:da:c8:04,19282502,176,5046,19282326,19282502
3802,6,12,1,2412,-73,-92,19,84:d4:7e:f2:33:00,19289517,960,6055,19288557,19289517
3803,4,1,1,2412,-67,-92,25,54:e4:3a:ec:fb:64,19294576,2160,2899,19292416,19294576
3804,6,6,1,2412,-51,-92,41,e6:aa:ea:c9:ea:33,19303216,408,8232,19302808,19303216
3805,6,6,1,2412,-51,-92,41,e6:aa:ea:c9:ea:33,19315333,408,11709,19314925,19315333
3806,4,1,1,2412,-90,-92,2,,19316328,304,691,19316024,19316328
3807,6,12,1,2412,-87,-92,5,,19317222,36,858,19317186,19317222
3808,6,12,1,2412,-87,-92,5,,19317593,36,335,19317557,19317593
3809,6,12,1,2412,-87,-92,5,,19317735,36,106,19317699,19317735
3810,6,12,1,2412,-90,-92,2,,19317834,36,63,19317798,19317834
3811,6,12,1,2412,-86,-92,6,,19317933,36,63,19317897,19317933
3812,6,12,1,2412,-89,-92,3,,19318084,36,115,19318048,19318084
3813,6,12,1,2412,-87,-92,5,40:e3:d6:da:bb:e3,19318864,44,736,19318820,19318864
3814,6,12,1,2412,-88,-92,4,40:e3:d6:da:bb:e3,19318970,44,62,19318926,19318970
3815,6,12,1,2412,-91,-92,1,40:e3:d6:da:bb:e3,19319075,44,61,19319031,19319075
3816,6,12,1,2412,-91,-92,1,,19321012,36,1901,19320976,19321012
3817,6,12,1,2412,-88,-92,4,,19321111,36,63,19321075,19321111
3818,6,12,1,2412,-88,-92,4,,19321226,36,79,19321190,19321226
3819,6,12,1,2412,-89,-92,3,,19321405,36,143,19321369,19321405
3820,4,1,1,2412,-79,-92,13,b8:3a:5a:88:e6:e0,19321672,2360,-2093,19319312,19321672
3821,6,12,1,2412,-88,-92,4,,19328052,36,6344,19328016,19328052
3822,6,12,1,2412,-87,-92,5,,19329171,36,1083,19329135,19329171
3823,6,12,1,2412,-88,-92,4,40:e3:d6:da:bb:e3,19335198,180,5847,19335018,19335198
3824,6,12,1,2412,-88,-92,4,40:e3:d6:da:bb:e4,19335422,172,52,19335250,19335422
3825,6,12,1,2412,-88,-92,4,40:e3:d6:da:bb:e5,19335638,156,60,19335482,19335638
3826,6,6,1,2412,-88,-92,4,40:e3:d6:da:bb:e6,19335834,380,-184,19335454,19335834
3827,6,12,1,2412,-53,-92,39,40:e3:d6:da:ba:20,19337749,160,1755,19337589,19337749
3828,6,6,1,2412,-52,-92,40,40:e3:d6:da:ba:21,19337950,368,-167,19337582,19337950
3829,6,12,1,2412,-52,-92,40,40:e3:d6:da:ba:22,19338364,180,234,19338184,19338364
3830,6,12,1,2412,-52,-92,40,40:e3:d6:da:ba:23,19338578,184,30,19338394,19338578
3831,6,12,1,2412,-52,-92,40,40:e3:d6:da:ba:24,19338806,176,52,19338630,19338806
3832,6,12,1,2412,-53,-92,39,40:e3:d6:da:ba:25,19339025,160,59,19338865,19339025
3833,6,6,1,2412,-54,-92,38,e6:aa:ea:c9:ea:33,19339675,408,242,19339267,19339675
3834,6,6,1,2412,-51,-92,41,e6:aa:ea:c9:ea:33,19351674,408,11591,19351266,19351674
3835,6,6,1,2412,-88,-92,4,40:e3:d6:da:ca:c1,19352830,368,788,19352462,19352830
3836,6,6,1,2412,-84,-92,8,40:e3:d6:da:ca:c6,19354117,380,907,19353737,19354117
3837,6,12,1,2412,-87,-92,5,40:e3:d6:da:c8:02,19384426,180,30129,19384246,19384426
3838,4,1,1,2412,-69,-92,23,54:e4:3a:ec:fb:64,19397003,2160,10417,19394843,19397003
3839,4,1,1,2412,-79,-92,13,b8:3a:5a:88:e6:e0,19424081,2360,24718,19421721,19424081
3840,4,1,1,2412,-81,-92,11,b8:3a:5a:88:e6:e1,19426461,2376,4,19424085,19426461
3841,6,12,1,2412,-86,-92,6,40:e3:d6:da:bb:e3,19437604,180,10963,19437424,19437604
3842,6,12,1,2412,-86,-92,6,40:e3:d6:da:bb:e4,19437826,172,50,19437654,19437826
3843,6,6,1,2412,-87,-92,5,40:e3:d6:da:bb:e6,19438230,380,24,19437850,19438230
3844,6,12,1,2412,-53,-92,39,40:e3:d6:da:ba:20,19440118,160,1728,19439958,19440118
3845,6,6,1,2412,-53,-92,39,40:e3:d6:da:ba:21,19440319,368,-167,19439951,19440319
3846,6,12,1,2412,-50,-92,42,40:e3:d6:da:ba:22,19440732,180,233,19440552,19440732
3847,6,12,1,2412,-53,-92,39,40:e3:d6:da:ba:23,19440956,184,40,19440772,19440956
3848,6,12,1,2412,-52,-92,40,40:e3:d6:da:ba:24,19441165,176,33,19440989,19441165
3849,6,6,1,2412,-83,-92,9,84:d4:7e:f2:42:26,19442397,380,852,19442017,19442397
3850,6,12,1,2412,-87,-92,5,,19457555,32,15126,19457523,19457555
3851,4,1,1,2412,-80,-92,12,,19473953,304,16094,19473649,19473953
3852,6,6,1,2412,-89,-92,3,40:e3:d6:da:c8:01,19486438,368,12117,19486070,19486438
3853,6,12,1,2412,-88,-92,4,40:e3:d6:da:c8:04,19487249,176,635,19487073,19487249
3854,6,12,1,2412,-86,-92,6,40:e3:d6:da:c8:05,19487451,160,42,19487291,19487451
3855,6,6,1,2412,-89,-92,3,40:e3:d6:da:c8:06,19487651,380,-180,19487271,19487651
3856,4,1,1,2412,-68,-92,24,54:e4:3a:ec:fb:64,19499158,2160,9347,19496998,19499158
3857,4,1,1,2412,-73,-92,19,c0:c9:e3:4d:6e:bf,19516578,872,16548,19515706,19516578
3858,4,1,1,2412,-80,-92,12,,19517467,304,585,19517163,19517467
3859,6,12,1,2412,-86,-92,6,,19524638,32,7139,19524606,19524638
3860,6,12,1,2412,-86,-92,6,,19524751,44,69,19524707,19524751
3861,6,12,1,2412,-85,-92,7,84:d4:7e:f2:34:23,19532277,180,7346,19532097,19532277
3862,6,12,1,2412,-87,-92,5,84:d4:7e:f2:34:25,19532721,160,284,19532561,19532721
3863,6,6,1,2412,-87,-92,5,84:d4:7e:f2:34:26,19532939,380,-162,19532559,19532939
3864,6,12,1,2412,-87,-92,5,,19533940,32,969,19533908,19533940
3865,6,12,1,2412,-52,-92,40,40:e3:d6:da:ba:20,19542501,160,8401,19542341,19542501
3866,6,6,1,2412,-52,-92,40,40:e3:d6:da:ba:21,19542711,368,-158,19542343,19542711
3867,6,12,1,2412,-52,-92,40,40:e3:d6:da:ba:23,19543349,184,454,19543165,19543349
3868,6,12,1,2412,-52,-92,40,40:e3:d6:da:ba:24,19543567,176,42,19543391,19543567
3869,6,12,1,2412,-52,-92,40,40:e3:d6:da:ba:25,19543787,160,60,19543627,19543787
3870,6,6,1,2412,-52,-92,40,40:e3:d6:da:ba:26,19543997,380,-170,19543617,19543997
3871,6,12,1,2412,-85,-92,7,84:d4:7e:f2:42:25,19544592,160,435,19544432,19544592
3872,6,12,1,2412,-82,-92,10,40:e3:d6:da:ca:c0,19557405,156,12657,19557249,19557405
3873,4,1,1,2412,-79,-92,13,,19563286,304,5577,19562982,19563286
3874,6,6,1,2412,-88,-92,4,e6:aa:ea:c9:ea:1b,19565294,408,1600,19564886,19565294
3875,4,1,1,2412,-72,-92,20,54:e4:3a:ec:fb:64,19601762,2160,34308,19599602,19601762
3876,6,12,1,2412,-85,-92,7,,19617495,32,15701,19617463,19617495
3877,6,6,1,2412,-78,-92,14,e6:aa:ea:b7:4a:dd,19620043,408,2140,19619635,19620043
3878,4,1,1,2412,-80,-92,12,b8:3a:5a:88:e6:e0,19628873,2360,6470,19626513,19628873
3879,4,1,1,2412,-83,-92,9,b8:3a:5a:88:e6:e1,19631253,2376,4,19628877,19631253
3880,6,6,1,2412,-85,-92,7,84:d4:7e:f2:34:21,19633810,368,2189,19633442,19633810
3881,4,1,1,2412,-73,-92,19,,19634498,304,384,19634194,19634498
3882,6,12,1,2412,-86,-92,6,40:e3:d6:da:bb:e2,19642180,176,7506,19642004,19642180
3883,6,12,1,2412,-86,-92,6,40:e3:d6:da:bb:e4,19642632,172,280,19642460,19642632
3884,6,12,1,2412,-85,-92,7,40:e3:d6:da:bb:e5,19642847,156,59,19642691,19642847
3885,6,6,1,2412,-87,-92,5,40:e3:d6:da:bb:e6,19643044,380,-183,19642664,19643044
3886,6,12,1,2412,-53,-92,39,40:e3:d6:da:ba:20,19644908,160,1704,19644748,19644908
3887,6,6,1,2412,-52,-92,40,40:e3:d6:da:ba:21,19645118,368,-158,19644750,19645118
3888,6,12,1,2412,-52,-92,40,40:e3:d6:da:ba:23,19645854,184,552,19645670,19645854
3889,6,12,1,2412,-52,-92,40,40:e3:d6:da:ba:24,19646072,176,42,19645896,19646072
3890,6,12,1,2412,-52,-92,40,40:e3:d6:da:ba:25,19646274,160,42,19646114,19646274
3891,6,6,1,2412,-52,-92,40,40:e3:d6:da:ba:26,19646493,380,-161,19646113,19646493
3892,6,12,1,2412,-83,-92,9,84:d4:7e:f2:42:23,19654873,160,8220,19654713,19654873
3893,6,6,1,2412,-77,-92,15,e6:aa:ea:b7:4a:dd,19656405,408,1124,19655997,19656405
3894,6,12,1,2412,-88,-92,4,40:e3:d6:da:ca:c0,19659807,156,3246,19659651,19659807
3895,6,6,1,2412,-87,-92,5,40:e3:d6:da:ca:c1,19659995,368,-180,19659627,19659995
3896,6,12,1,2412,-87,-92,5,40:e3:d6:da:ca:c2,19660409,176,238,19660233,19660409
3897,6,6,1,2412,-87,-92,5,a8:5b:f7:55:1a:40,19664464,72,3983,19664392,19664464
3898,6,6,1,2412,-85,-92,7,a8:5b:f7:55:1a:40,19664572,72,36,19664500,19664572
3899,6,6,1,2412,-86,-92,6,a8:5b:f7:55:1a:40,19665299,72,655,19665227,19665299
3900,6,6,1,2412,-78,-92,14,e6:aa:ea:b7:4a:dd,19668518,408,2811,19668110,19668518
3901,4,1,1,2412,-74,-92,18,a6:e5:7c:28:b1:d3,19691152,992,21642,19690160,19691152
3902,6,12,1,2412,-89,-92,3,40:e3:d6:da:c8:03,19692851,184,1515,19692667,19692851
3903,6,6,1,2412,-89,-92,3,40:e3:d6:da:c8:06,19693499,380,268,19693119,19693499
3904,4,1,1,2412,-72,-92,20,54:e4:3a:ec:fb:64,19704155,2160,8496,19701995,19704155
3905,6,6,1,2412,-49,-92,43,e6:aa:ea:c9:ea:33,19721622,408,17059,19721214,19721622
3906,6,12,1,2412,-86,-92,6,40:e3:d6:da:bb:e0,19744238,156,22460,19744082,19744238
3907,6,12,1,2412,-87,-92,5,40:e3:d6:da:bb:e3,19745060,180,642,19744880,19745060
3908,6,12,1,2412,-86,-92,6,40:e3:d6:da:bb:e4,19745274,172,42,19745102,19745274
3909,6,6,1,2412,-49,-92,43,e6:aa:ea:c9:ea:33,19745675,408,-7,19745267,19745675
3910,6,12,1,2412,-52,-92,40,40:e3:d6:da:ba:20,19747300,160,1465,19747140,19747300
3911,6,6,1,2412,-51,-92,41,40:e3:d6:da:ba:21,19747501,368,-167,19747133,19747501
3912,6,12,1,2412,-52,-92,40,40:e3:d6:da:ba:22,19747888,180,207,19747708,19747888
3913,6,12,1,2412,-52,-92,40,40:e3:d6:da:ba:23,19748102,184,30,19747918,19748102
3914,6,12,1,2412,-52,-92,40,40:e3:d6:da:ba:24,19748330,176,52,19748154,19748330
3915,6,12,1,2412,-52,-92,40,40:e3:d6:da:ba:25,19748559,160,69,19748399,19748559
3916,6,6,1,2412,-52,-92,40,40:e3:d6:da:ba:26,19748777,380,-162,19748397,19748777
3917,6,6,1,2412,-84,-92,8,84:d4:7e:f2:42:21,19749405,368,260,19749037,19749405
3918,6,6,1,2412,-49,-92,43,e6:aa:ea:c9:ea:33,19757794,408,7981,19757386,19757794
3919,6,12,1,2412,-88,-92,4,40:e3:d6:da:ca:c4,19763228,172,5262,19763056,19763228
3920,4,1,1,2412,-74,-92,18,a4:e5:7c:28:b1:d3,19764227,688,311,19763539,19764227
3921,6,6,1,2412,-49,-92,43,e6:aa:ea:c9:ea:33,19769918,408,5283,19769510,19769918
3922,6,12,1,2412,-88,-92,4,40:e3:d6:da:c8:03,19794275,184,24173,19794091,19794275
3923,6,12,1,2412,-87,-92,5,40:e3:d6:da:bb:e3,19797580,156,3149,19797424,19797580
3924,4,1,1,2412,-55,-92,37,a6:e5:7c:28:b1:d3,19799037,992,465,19798045,19799037
3925,4,1,1,2412,-70,-92,22,54:e4:3a:ec:fb:64,19806631,2160,5434,19804471,19806631
3926,4,1,1,2412,-78,-92,14,b8:3a:5a:88:e6:e0,19833674,2360,24683,19831314,19833674
3927,6,12,1,2412,-51,-92,41,40:e3:d6:da:ba:20,19849721,160,15887,19849561,19849721
3928,6,6,1,2412,-51,-92,41,40:e3:d6:da:ba:21,19849939,368,-150,19849571,19849939
3929,6,12,1,2412,-51,-92,41,40:e3:d6:da:ba:22,19850326,180,207,19850146,19850326
3930,6,12,1,2412,-51,-92,41,40:e3:d6:da:ba:23,19850541,184,31,19850357,19850541
3931,6,12,1,2412,-51,-92,41,40:e3:d6:da:ba:24,19850777,176,60,19850601,19850777
3932,6,12,1,2412,-51,-92,41,40:e3:d6:da:ba:25,19850988,160,51,19850828,19850988
3933,6,6,1,2412,-51,-92,41,40:e3:d6:da:ba:26,19851180,380,-188,19850800,19851180
3934,6,12,1,2412,-85,-92,7,84:d4:7e:f2:42:25,19851737,160,397,19851577,19851737
3935,4,1,1,2412,-74,-92,18,a4:e5:7c:28:b1:d3,19858411,688,5986,19857723,19858411
3936,4,1,1,2412,-83,-92,9,,19859116,304,401,19858812,19859116
3937,6,12,1,2412,-88,-92,4,40:e3:d6:da:ca:c2,19865414,176,6122,19865238,19865414
3938,6,12,1,2412,-87,-92,5,40:e3:d6:da:ca:c3,19865625,180,31,19865445,19865625
3939,6,12,1,2412,-87,-92,5,40:e3:d6:da:ca:c4,19865848,172,51,19865676,19865848
3940,4,1,1,2412,-69,-92,23,54:e4:3a:ec:fb:64,19909033,2160,41025,19906873,19909033
3941,4,1,1,2412,-72,-92,20,b8:3a:5a:88:e6:e0,19936075,2360,24682,19933715,19936075
3942,4,1,1,2412,-77,-92,15,b8:3a:5a:88:e6:e1,19938463,2376,12,19936087,19938463
3943,6,12,1,2412,-83,-92,9,40:e3:d6:da:bb:e0,19948810,156,10191,19948654,19948810
3944,6,6,1,2412,-87,-92,5,40:e3:d6:da:bb:e1,19949025,368,-153,19948657,19949025
3945,6,12,1,2412,-86,-92,6,40:e3:d6:da:bb:e2,19949421,176,220,19949245,19949421
3946,6,12,1,2412,-86,-92,6,40:e3:d6:da:bb:e3,19949622,180,21,19949442,19949622
3947,6,12,1,2412,-52,-92,40,40:e3:d6:da:ba:20,19952115,160,2333,19951955,19952115
3948,6,6,1,2412,-51,-92,41,40:e3:d6:da:ba:21,19952334,368,-149,19951966,19952334
3949,6,12,1,2412,-52,-92,40,40:e3:d6:da:ba:22,19952730,180,216,19952550,19952730
3950,6,12,1,2412,-52,-92,40,40:e3:d6:da:ba:24,19953154,176,248,19952978,19953154
3951,6,12,1,2412,-51,-92,41,40:e3:d6:da:ba:25,19953373,160,59,19953213,19953373
3952,6,6,1,2412,-51,-92,41,40:e3:d6:da:ba:26,19953592,380,-161,19953212,19953592
3953,6,12,1,2412,-86,-92,6,84:d4:7e:f2:42:25,19954138,160,386,19953978,19954138
3954,6,6,1,2412,-87,-92,5,40:e3:d6:da:ca:c6,19968495,380,13977,19968115,19968495
3955,6,6,1,2412,-89,-92,3,40:e3:d6:da:c8:06,19999705,380,30830,19999325,19999705
3956,4,1,1,2412,-76,-92,16,b8:3a:5a:88:e6:e1,20040920,2376,38839,20038544,20040920
3957,6,12,1,2412,-80,-92,12,84:d4:7e:f2:34:20,20043471,160,2391,20043311,20043471
3958,6,6,1,2412,-83,-92,9,84:d4:7e:f2:34:21,20043663,368,-176,20043295,20043663
3959,6,12,1,2412,-85,-92,7,84:d4:7e:f2:34:22,20044068,180,225,20043888,20044068
3960,6,12,1,2412,-85,-92,7,84:d4:7e:f2:34:23,20044273,180,25,20044093,20044273
3961,6,12,1,2412,-86,-92,6,84:d4:7e:f2:34:24,20044506,176,57,20044330,20044506
3962,6,6,1,2412,-49,-92,43,e6:aa:ea:c9:ea:33,20050505,408,5591,20050097,20050505
3963,6,12,1,2412,-86,-92,6,40:e3:d6:da:bb:e0,20051203,156,542,20051047,20051203
3964,6,6,1,2412,-85,-92,7,40:e3:d6:da:bb:e1,20051417,368,-154,20051049,20051417
3965,6,12,1,2412,-53,-92,39,40:e3:d6:da:ba:20,20054501,160,2924,20054341,20054501
3966,6,6,1,2412,-53,-92,39,40:e3:d6:da:ba:21,20054693,368,-176,20054325,20054693
3967,6,12,1,2412,-53,-92,39,40:e3:d6:da:ba:22,20055107,180,234,20054927,20055107
3968,6,12,1,2412,-53,-92,39,40:e3:d6:da:ba:23,20055321,184,30,20055137,20055321
3969,6,12,1,2412,-53,-92,39,40:e3:d6:da:ba:24,20055540,176,43,20055364,20055540
3970,6,12,1,2412,-53,-92,39,40:e3:d6:da:ba:25,20055768,160,68,20055608,20055768
3971,6,6,1,2412,-53,-92,39,40:e3:d6:da:ba:26,20055960,380,-188,20055580,20055960
3972,6,12,1,2412,-83,-92,9,84:d4:7e:f2:42:24,20056387,176,251,20056211,20056387
3973,6,12,1,2412,-89,-92,3,40:e3:d6:da:ca:c0,20069412,156,12869,20069256,20069412
3974,6,6,1,2412,-49,-92,43,e6:aa:ea:c9:ea:33,20074743,408,4923,20074335,20074743
3975,6,6,1,2412,-50,-92,42,e6:aa:ea:c9:ea:33,20087849,408,12698,20087441,20087849
3976,6,6,1,2412,-89,-92,3,40:e3:d6:da:c8:01,20100834,368,12617,20100466,20100834
3977,4,1,1,2412,-54,-92,38,54:e4:3a:ec:fb:64,20113843,2160,10849,20111683,20113843
3978,6,6,1,2412,-69,-92,23,e6:aa:ea:b7:4a:dd,20140651,408,26400,20140243,20140651
3979,4,1,1,2412,-80,-92,12,b8:3a:5a:88:e6:e1,20143443,2376,416,20141067,20143443
3980,6,12,1,2412,-86,-92,6,84:d4:7e:f2:34:22,20145709,180,2086,20145529,20145709
3981,6,12,1,2412,-55,-92,37,40:e3:d6:da:ba:20,20156924,160,11055,20156764,20156924
3982,6,6,1,2412,-54,-92,38,40:e3:d6:da:ba:21,20157134,368,-158,20156766,20157134
3983,6,12,1,2412,-55,-92,37,40:e3:d6:da:ba:22,20157529,180,215,20157349,20157529
3984,6,12,1,2412,-54,-92,38,40:e3:d6:da:ba:23,20157743,184,30,20157559,20157743
3985,6,12,1,2412,-54,-92,38,40:e3:d6:da:ba:25,20158173,160,270,20158013,20158173
3986,6,12,1,2412,-82,-92,10,84:d4:7e:f2:42:24,20158804,176,455,20158628,20158804
3987,6,12,1,2412,-79,-92,13,84:d4:7e:f2:42:25,20159005,160,41,20158845,20159005
3988,6,6,1,2412,-84,-92,8,84:d4:7e:f2:42:26,20159197,380,-188,20158817,20159197
3989,6,6,1,2412,-70,-92,22,e6:aa:ea:b7:4a:dd,20164878,408,5273,20164470,20164878
3990,6,6,1,2412,-70,-92,22,e6:aa:ea:b7:4a:dd,20189109,408,23823,20188701,20189109
3991,4,1,1,2412,-78,-92,14,a6:e5:7c:28:b1:d3,20202512,992,12411,20201520,20202512
3992,6,12,1,2412,-88,-92,4,40:e3:d6:da:c8:00,20203382,160,710,20203222,20203382
3993,6,6,1,2412,-88,-92,4,40:e3:d6:da:c8:01,20203583,368,-167,20203215,20203583
3994,6,12,1,2412,-90,-92,2,40:e3:d6:da:c8:03,20204202,184,435,20204018,20204202
3995,6,6,1,2412,-90,-92,2,40:e3:d6:da:c8:06,20204841,380,259,20204461,20204841
3996,4,1,1,2412,-72,-92,20,54:e4:3a:ec:fb:64,20216210,2160,9209,20214050,20216210
3997,4,1,1,2412,-78,-92,14,b8:3a:5a:88:e6:e0,20243432,2360,24862,20241072,20243432
3998,6,12,1,2412,-86,-92,6,40:e3:d6:da:bb:e4,20257060,172,13456,20256888,20257060
3999,6,12,1,2412,-86,-92,6,40:e3:d6:da:bb:e5,20257284,156,68,20257128,20257284
4000,7,21.6667,1,2412,-87,-92,5,00:1f:26:41:f0:00,20258507,126,1097,20258381,20258507
4001,6,12,1,2412,-54,-92,38,40:e3:d6:da:ba:20,20259313,160,646,20259153,20259313
4002,6,6,1,2412,-54,-92,38,40:e3:d6:da:ba:21,20259514,368,-167,20259146,20259514
4003,6,12,1,2412,-54,-92,38,40:e3:d6:da:ba:22,20259919,180,225,20259739,20259919
4004,6,12,1,2412,-54,-92,38,40:e3:d6:da:ba:23,20260125,184,22,20259941,20260125
4005,6,12,1,2412,-54,-92,38,40:e3:d6:da:ba:24,20260343,176,42,20260167,20260343
4006,6,12,1,2412,-54,-92,38,40:e3:d6:da:ba:25,20260572,160,69,20260412,20260572
4007,6,6,1,2412,-54,-92,38,40:e3:d6:da:ba:26,20260791,380,-161,20260411,20260791
4008,6,12,1,2412,-85,-92,7,84:d4:7e:f2:42:24,20261197,176,230,20261021,20261197
4009,6,6,1,2412,-85,-92,7,84:d4:7e:f2:42:26,20261635,380,58,20261255,20261635
4010,6,12,1,2412,-85,-92,7,,20263629,32,1962,20263597,20263629
4011,6,12,1,2412,-87,-92,5,40:e3:d6:da:ca:c2,20274803,176,10998,20274627,20274803
4012,4,1,1,2412,-77,-92,15,a6:e5:7c:28:b1:d3,20305823,992,30028,20304831,20305823
4013,4,1,1,2412,-67,-92,25,54:e4:3a:ec:fb:64,20318614,2160,10631,20316454,20318614
4014,4,1,1,2412,-74,-92,18,b8:3a:5a:88:e6:e0,20345694,2360,24720,20343334,20345694
4015,6,6,1,2412,-89,-92,3,84:d4:7e:f2:34:21,20350536,368,4474,20350168,20350536
4016,6,12,1,2412,-86,-92,6,40:e3:d6:da:bb:e0,20358409,156,7717,20358253,20358409
4017,6,12,1,2412,-55,-92,37,40:e3:d6:da:ba:20,20361712,160,3143,20361552,20361712
4018,6,12,1,2412,-54,-92,38,40:e3:d6:da:ba:22,20362318,180,426,20362138,20362318
4019,6,12,1,2412,-55,-92,37,40:e3:d6:da:ba:23,20362551,184,49,20362367,20362551
4020,6,12,1,2412,-54,-92,38,40:e3:d6:da:ba:24,20362787,176,60,20362611,20362787
4021,6,12,1,2412,-55,-92,37,40:e3:d6:da:ba:25,20363016,160,69,20362856,20363016
4022,6,6,1,2412,-54,-92,38,40:e3:d6:da:ba:26,20363208,380,-188,20362828,20363208
4023,4,1,1,2412,-85,-92,7,aa:cd:0e:77:bf:b5,20368096,1128,3760,20366968,20368096
4024,6,12,1,2412,-55,-92,37,40:e3:d6:da:ba:20,20369294,136,1062,20369158,20369294
4025,6,6,1,2412,-55,-92,37,40:e3:d6:da:ba:21,20369480,348,-162,20369132,20369480
4026,6,12,1,2412,-55,-92,37,40:e3:d6:da:ba:22,20369856,156,220,20369700,20369856
4027,6,12,1,2412,-55,-92,37,40:e3:d6:da:ba:23,20370065,156,53,20369909,20370065
4028,6,12,1,2412,-55,-92,37,40:e3:d6:da:ba:25,20370255,136,54,20370119,20370255
4029,6,12,1,2412,-86,-92,6,,20370887,32,600,20370855,20370887
4030,6,12,1,2412,-88,-92,4,40:e3:d6:da:ca:c0,20376615,156,5572,20376459,20376615
4031,6,6,1,2412,-88,-92,4,40:e3:d6:da:ca:c1,20376812,368,-171,20376444,20376812
4032,6,12,1,2412,-87,-92,5,40:e3:d6:da:ca:c2,20377208,176,220,20377032,20377208
4033,6,12,1,2412,-87,-92,5,40:e3:d6:da:ca:c3,20377409,180,21,20377229,20377409
4034,6,12,1,2412,-86,-92,6,40:e3:d6:da:ca:c4,20377633,172,52,20377461,20377633
4035,6,12,1,2412,-88,-92,4,40:e3:d6:da:ca:c5,20377830,156,41,20377674,20377830
4036,6,6,1,2412,-87,-92,5,40:e3:d6:da:ca:c6,20378028,380,-182,20377648,20378028
4037,4,1,1,2412,-85,-92,7,aa:cd:0e:77:bf:b5,20389292,1128,10136,20388164,20389292
4038,6,12,1,2412,-88,-92,4,,20390753,32,1429,20390721,20390753
4039,6,12,1,2412,-85,-92,7,40:e3:d6:da:bb:e5,20391798,136,909,20391662,20391798
4040,6,6,1,2412,-89,-92,3,e6:aa:ea:c9:ea:1b,20407120,408,14914,20406712,20407120
4041,4,1,1,2412,-67,-92,25,54:e4:3a:ec:fb:64,20420809,2160,11529,20418649,20420809
4042,4,1,1,2412,-79,-92,13,b8:3a:5a:88:e6:e0,20448088,2360,24919,20445728,20448088
4043,4,1,1,2412,-79,-92,13,b8:3a:5a:88:e6:e1,20450468,2376,4,20448092,20450468
4044,6,12,1,2412,-84,-92,8,84:d4:7e:f2:34:20,20452704,160,2076,20452544,20452704
4045,6,6,1,2412,-87,-92,5,84:d4:7e:f2:34:21,20452896,368,-176,20452528,20452896
4046,6,6,1,2412,-69,-92,23,e6:aa:ea:b7:4a:dd,20455639,408,2335,20455231,20455639
4047,6,12,1,2412,-87,-92,5,84:d4:7e:f2:34:25,20457651,160,1852,20457491,20457651
4048,6,6,1,2412,-85,-92,7,84:d4:7e:f2:34:26,20457842,380,-189,20457462,20457842
4049,4,1,1,2412,-79,-92,13,c0:c9:e3:4d:6e:bf,20463331,872,4617,20462459,20463331
4050,4,1,1,2412,-73,-92,19,,20464220,304,585,20463916,20464220
4051,6,12,1,2412,-55,-92,37,40:e3:d6:da:ba:20,20464375,160,-5,20464215,20464375
4052,6,6,1,2412,-55,-92,37,40:e3:d6:da:ba:21,20464575,368,-168,20464207,20464575
4053,6,12,1,2412,-55,-92,37,40:e3:d6:da:ba:22,20464962,180,207,20464782,20464962
4054,6,12,1,2412,-54,-92,38,40:e3:d6:da:ba:23,20465185,184,39,20465001,20465185
4055,6,12,1,2412,-55,-92,37,40:e3:d6:da:ba:24,20465413,176,52,20465237,20465413
4056,6,12,1,2412,-54,-92,38,40:e3:d6:da:ba:25,20465615,160,42,20465455,20465615
4057,6,6,1,2412,-55,-92,37,40:e3:d6:da:ba:26,20465825,380,-170,20465445,20465825
4058,6,6,1,2412,-86,-92,6,84:d4:7e:f2:42:26,20466385,380,180,20466005,20466385
4059,6,6,1,2412,-73,-92,19,e6:aa:ea:b7:4a:dd,20467768,408,975,20467360,20467768
4060,6,12,1,2412,-86,-92,6,40:e3:d6:da:ca:c0,20478998,156,11074,20478842,20478998
4061,6,6,1,2412,-84,-92,8,40:e3:d6:da:ca:c1,20479212,368,-154,20478844,20479212
4062,6,12,1,2412,-87,-92,5,40:e3:d6:da:ca:c2,20479617,176,229,20479441,20479617
4063,6,6,1,2412,-73,-92,19,e6:aa:ea:b7:4a:dd,20479891,408,-134,20479483,20479891
4064,6,6,1,2412,-85,-92,7,40:e3:d6:da:ca:c6,20480472,380,201,20480092,20480472
4065,6,6,1,2412,-72,-92,20,e6:aa:ea:b7:4a:dd,20492004,408,11124,20491596,20492004
4066,6,6,1,2412,-72,-92,20,e6:aa:ea:b7:4a:dd,20504116,408,11704,20503708,20504116
4067,4,1,1,2412,-59,-92,33,,20509665,304,5245,20509361,20509665
4068,4,1,1,2412,-78,-92,14,a6:e5:7c:28:b1:d3,20510003,992,-654,20509011,20510003
4069,6,6,1,2412,-85,-92,7,40:e3:d6:da:c8:01,20511146,368,775,20510778,20511146
4070,4,1,1,2412,-75,-92,17,b8:3a:5a:88:e6:e0,20550474,2360,36968,20548114,20550474
4071,4,1,1,2412,-73,-92,19,b8:3a:5a:88:e6:e1,20552863,2376,13,20550487,20552863
4072,6,12,1,2412,-86,-92,6,84:d4:7e:f2:34:24,20556446,176,3407,20556270,20556446
4073,6,12,1,2412,-85,-92,7,84:d4:7e:f2:34:25,20556665,160,59,20556505,20556665
4074,6,6,1,2412,-87,-92,5,84:d4:7e:f2:34:26,20556875,380,-170,20556495,20556875
4075,6,6,1,2412,-53,-92,39,e6:aa:ea:c9:ea:33,20558964,408,1681,20558556,20558964
4076,6,12,1,2412,-79,-92,13,40:e3:d6:da:bb:e4,20564278,172,5142,20564106,20564278
4077,6,12,1,2412,-53,-92,39,40:e3:d6:da:ba:20,20566503,160,2065,20566343,20566503
4078,6,6,1,2412,-53,-92,39,40:e3:d6:da:ba:21,20566722,368,-149,20566354,20566722
4079,6,12,1,2412,-53,-92,39,40:e3:d6:da:ba:22,20567118,180,216,20566938,20567118
4080,6,12,1,2412,-53,-92,39,40:e3:d6:da:ba:23,20567351,184,49,20567167,20567351
4081,6,12,1,2412,-53,-92,39,40:e3:d6:da:ba:25,20567806,160,295,20567646,20567806
4082,6,6,1,2412,-53,-92,39,40:e3:d6:da:ba:26,20568007,380,-179,20567627,20568007
4083,6,6,1,2412,-53,-92,39,e6:aa:ea:c9:ea:33,20571072,408,2657,20570664,20571072
4084,6,12,1,2412,-85,-92,7,40:e3:d6:da:ca:c4,20582432,172,11188,20582260,20582432
4085,6,12,1,2412,-84,-92,8,40:e3:d6:da:ca:c5,20582639,156,51,20582483,20582639
4086,6,6,1,2412,-53,-92,39,e6:aa:ea:c9:ea:33,20583178,408,131,20582770,20583178
4087,6,6,1,2412,-53,-92,39,e6:aa:ea:c9:ea:33,20595292,408,11706,20594884,20595292
4088,6,12,1,2412,-85,-92,7,40:e3:d6:da:bb:e2,20596032,156,584,20595876,20596032
4089,6,12,1,2412,-85,-92,7,40:e3:d6:da:bb:e3,20596257,156,69,20596101,20596257
4090,6,12,1,2412,-86,-92,6,40:e3:d6:da:bb:e5,20596457,136,64,20596321,20596457
4091,6,6,1,2412,-88,-92,4,40:e3:d6:da:c8:01,20612856,368,16031,20612488,20612856
4092,6,12,1,2412,-85,-92,7,40:e3:d6:da:bb:e5,20616855,136,3863,20616719,20616855
4093,4,1,1,2412,-66,-92,26,54:e4:3a:ec:fb:64,20625804,2160,6789,20623644,20625804
4094,6,12,1,2412,-83,-92,9,,20631545,32,5709,20631513,20631545
4095,6,12,1,2412,-83,-92,9,,20631620,36,39,20631584,20631620
4096,6,12,1,2412,-84,-92,8,,20634917,32,3265,20634885,20634917
4097,6,12,1,2412,-84,-92,8,,20635034,44,73,20634990,20635034
4098,6,12,1,2412,-85,-92,7,,20640521,32,5455,20640489,20640521
4099,6,12,1,2412,-86,-92,6,,20640643,44,78,20640599,20640643
4100,4,1,1,2412,-76,-92,16,b8:3a:5a:88:e6:e0,20655529,2360,12526,20653169,20655529
4101,4,1,1,2412,-76,-92,16,b8:3a:5a:88:e6:e1,20657909,2376,4,20655533,20657909
4102,6,12,1,2412,-86,-92,6,40:e3:d6:da:bb:e3,20666399,180,8310,20666219,20666399
4103,6,12,1,2412,-85,-92,7,40:e3:d6:da:bb:e4,20666622,172,51,20666450,20666622
4104,6,12,1,2412,-86,-92,6,40:e3:d6:da:bb:e5,20666829,156,51,20666673,20666829
4105,6,12,1,2412,-52,-92,40,40:e3:d6:da:ba:20,20668904,160,1915,20668744,20668904
4106,6,6,1,2412,-52,-92,40,40:e3:d6:da:ba:21,20669095,368,-177,20668727,20669095
4107,6,12,1,2412,-52,-92,40,40:e3:d6:da:ba:22,20669501,180,226,20669321,20669501
4108,6,12,1,2412,-52,-92,40,40:e3:d6:da:ba:23,20669706,184,21,20669522,20669706
4109,6,12,1,2412,-52,-92,40,40:e3:d6:da:ba:24,20669934,176,52,20669758,20669934
4110,6,12,1,2412,-52,-92,40,40:e3:d6:da:ba:25,20670153,160,59,20669993,20670153
4111,6,6,1,2412,-52,-92,40,40:e3:d6:da:ba:26,20670372,380,-161,20669992,20670372
4112,6,12,1,2412,-88,-92,4,84:d4:7e:f2:42:25,20670956,160,424,20670796,20670956
4113,6,6,1,2412,-87,-92,5,84:d4:7e:f2:42:26,20671148,380,-188,20670768,20671148
4114,6,12,1,2412,-84,-92,8,40:e3:d6:da:ca:c2,20684383,176,13059,20684207,20684383
4115,6,12,1,2412,-85,-92,7,40:e3:d6:da:ca:c4,20684807,172,252,20684635,20684807
4116,6,12,1,2412,-85,-92,7,40:e3:d6:da:ca:c5,20685023,156,60,20684867,20685023
4117,6,12,1,2412,-84,-92,8,,20686702,32,1647,20686670,20686702
4118,6,12,1,2412,-87,-92,5,40:e3:d6:da:c8:02,20715654,180,28772,20715474,20715654
4119,4,1,1,2412,-68,-92,24,54:e4:3a:ec:fb:64,20727969,2160,10155,20725809,20727969
4120,4,1,1,2412,-75,-92,17,b8:3a:5a:88:e6:e0,20755540,2360,25211,20753180,20755540
4121,6,12,1,2412,-85,-92,7,84:d4:7e:f2:34:20,20759362,160,3662,20759202,20759362
4122,6,12,1,2412,-85,-92,7,84:d4:7e:f2:34:22,20759968,180,426,20759788,20759968
4123,6,12,1,2412,-81,-92,11,84:d4:7e:f2:34:23,20760201,180,53,20760021,20760201
4124,6,12,1,2412,-81,-92,11,84:d4:7e:f2:34:24,20760424,176,47,20760248,20760424
4125,6,6,1,2412,-85,-92,7,84:d4:7e:f2:34:26,20760835,380,31,20760455,20760835
4126,6,12,1,2412,-87,-92,5,,20762710,32,1843,20762678,20762710
4127,6,6,1,2412,-87,-92,5,e6:aa:ea:c9:ea:1b,20763193,408,75,20762785,20763193
4128,6,12,1,2412,-54,-92,38,40:e3:d6:da:ba:20,20771304,160,7951,20771144,20771304
4129,6,6,1,2412,-54,-92,38,40:e3:d6:da:ba:21,20771523,368,-149,20771155,20771523
4130,6,12,1,2412,-54,-92,38,40:e3:d6:da:ba:22,20771910,180,207,20771730,20771910
4131,6,12,1,2412,-54,-92,38,40:e3:d6:da:ba:23,20772116,184,22,20771932,20772116
4132,6,12,1,2412,-54,-92,38,40:e3:d6:da:ba:24,20772334,176,42,20772158,20772334
4133,6,12,1,2412,-54,-92,38,40:e3:d6:da:ba:25,20772562,160,68,20772402,20772562
4134,6,6,1,2412,-54,-92,38,40:e3:d6:da:ba:26,20772754,380,-188,20772374,20772754
4135,6,12,1,2412,-83,-92,9,84:d4:7e:f2:42:24,20783136,176,10206,20782960,20783136
4136,6,12,1,2412,-82,-92,10,84:d4:7e:f2:42:25,20783364,160,68,20783204,20783364
4137,6,6,1,2412,-84,-92,8,40:e3:d6:da:ca:c1,20786390,368,2658,20786022,20786390
4138,6,12,1,2412,-83,-92,9,40:e3:d6:da:ca:c2,20786795,176,229,20786619,20786795
4139,6,12,1,2412,-84,-92,8,40:e3:d6:da:ca:c3,20786996,180,21,20786816,20786996
4140,6,12,1,2412,-83,-92,9,40:e3:d6:da:ca:c4,20787202,172,34,20787030,20787202
4141,6,12,1,2412,-84,-92,8,40:e3:d6:da:ca:c5,20787426,156,68,20787270,20787426
4142,6,12,1,2412,-86,-92,6,,20789259,32,1801,20789227,20789259
4143,6,12,1,2412,-88,-92,4,,20794627,32,5336,20794595,20794627
4144,6,12,1,2412,-86,-92,6,,20794739,44,68,20794695,20794739
4145,6,12,1,2412,-87,-92,5,,20795607,32,836,20795575,20795607
4146,6,12,1,2412,-87,-92,5,,20795720,44,69,20795676,20795720
4147,6,12,1,2412,-86,-92,6,,20816789,36,21033,20816753,20816789
4148,6,12,1,2412,-89,-92,3,40:e3:d6:da:c8:02,20818080,180,1111,20817900,20818080
4149,4,1,1,2412,-67,-92,25,54:e4:3a:ec:fb:64,20835447,2160,15207,20833287,20835447
4150,4,1,1,2412,-75,-92,17,b8:3a:5a:88:e6:e1,20860084,2376,22261,20857708,20860084
4151,6,12,1,2412,-86,-92,6,40:e3:d6:da:bb:e0,20870402,156,10162,20870246,20870402
4152,6,6,1,2412,-87,-92,5,40:e3:d6:da:bb:e1,20870590,368,-180,20870222,20870590
4153,6,12,1,2412,-88,-92,4,40:e3:d6:da:bb:e4,20871447,172,685,20871275,20871447
4154,6,6,1,2412,-57,-92,35,40:e3:d6:da:ba:21,20873939,368,2124,20873571,20873939
4155,6,12,1,2412,-57,-92,35,40:e3:d6:da:ba:23,20874559,184,436,20874375,20874559
4156,6,12,1,2412,-57,-92,35,40:e3:d6:da:ba:24,20874795,176,60,20874619,20874795
4157,6,12,1,2412,-57,-92,35,40:e3:d6:da:ba:25,20875024,160,69,20874864,20875024
4158,6,6,1,2412,-80,-92,12,84:d4:7e:f2:42:26,20875977,380,573,20875597,20875977
4159,6,6,1,2412,-75,-92,17,e6:aa:ea:b7:4a:dd,20885369,408,8984,20884961,20885369
4160,6,12,1,2412,-85,-92,7,40:e3:d6:da:ca:c0,20888588,156,3063,20888432,20888588
4161,6,6,1,2412,-84,-92,8,40:e3:d6:da:ca:c1,20888785,368,-171,20888417,20888785
4162,6,12,1,2412,-84,-92,8,40:e3:d6:da:ca:c2,20889190,176,229,20889014,20889190
4163,6,12,1,2412,-84,-92,8,40:e3:d6:da:ca:c3,20889418,180,48,20889238,20889418
4164,6,12,1,2412,-85,-92,7,40:e3:d6:da:ca:c4,20889623,172,33,20889451,20889623
4165,6,12,1,2412,-84,-92,8,40:e3:d6:da:ca:c5,20889821,156,42,20889665,20889821
4166,6,6,1,2412,-84,-92,8,40:e3:d6:da:ca:c6,20890018,380,-183,20889638,20890018
4167,6,6,1,2412,-75,-92,17,e6:aa:ea:b7:4a:dd,20909712,408,19286,20909304,20909712
4168,6,6,1,2412,-76,-92,16,e6:aa:ea:b7:4a:dd,20921720,408,11600,20921312,20921720
4169,4,1,1,2412,-65,-92,27,54:e4:3a:ec:fb:64,20933024,2160,9144,20930864,20933024
4170,4,1,1,2412,-79,-92,13,c0:c9:e3:4d:6e:bf,20953893,872,19997,20953021,20953893
4171,4,1,1,2412,-82,-92,10,,20954782,304,585,20954478,20954782
4172,6,12,1,2412,-85,-92,7,84:d4:7e:f2:34:23,20965262,180,10300,20965082,20965262
4173,6,6,1,2412,-87,-92,5,84:d4:7e:f2:34:26,20965915,380,273,20965535,20965915
4174,6,12,1,2412,-86,-92,6,40:e3:d6:da:bb:e0,20972796,156,6725,20972640,20972796
4175,6,6,1,2412,-55,-92,37,40:e3:d6:da:ba:21,20976332,368,3168,20975964,20976332
4176,6,12,1,2412,-55,-92,37,40:e3:d6:da:ba:22,20976737,180,225,20976557,20976737
4177,6,12,1,2412,-55,-92,37,40:e3:d6:da:ba:23,20976942,184,21,20976758,20976942
4178,6,12,1,2412,-55,-92,37,40:e3:d6:da:ba:24,20977179,176,61,20977003,20977179
4179,6,12,1,2412,-55,-92,37,40:e3:d6:da:ba:25,20977389,160,50,20977229,20977389
4180,6,6,1,2412,-54,-92,38,40:e3:d6:da:ba:26,20977608,380,-161,20977228,20977608
4181,6,12,1,2412,-82,-92,10,84:d4:7e:f2:42:25,20978147,160,379,20977987,20978147
4182,6,6,1,2412,-81,-92,11,84:d4:7e:f2:42:26,20978366,380,-161,20977986,20978366
4183,6,12,1,2412,-83,-92,9,40:e3:d6:da:ca:c0,20991002,156,12480,20990846,20991002
4184,6,12,1,2412,-86,-92,6,40:e3:d6:da:ca:c2,20991604,176,426,20991428,20991604
4185,6,12,1,2412,-85,-92,7,40:e3:d6:da:ca:c3,20991824,180,40,20991644,20991824
4186,6,12,1,2412,-87,-92,5,40:e3:d6:da:ca:c4,20992048,172,52,20991876,20992048
4187,4,1,1,2412,-82,-92,10,,21002334,304,9982,21002030,21002334
4188,4,1,1,2412,-65,-92,27,54:e4:3a:ec:fb:64,21035501,2160,31007,21033341,21035501
4189,6,12,1,2412,-86,-92,6,,21048923,32,13390,21048891,21048923
4190,6,12,1,2412,-87,-92,5,,21049010,36,51,21048974,21049010
4191,6,12,1,2412,-86,-92,6,,21051631,32,2589,21051599,21051631
4192,6,12,1,2412,-87,-92,5,,21051744,44,69,21051700,21051744
4193,6,12,1,2412,-87,-92,5,,21057474,32,5698,21057442,21057474
4194,4,1,1,2412,-77,-92,15,b8:3a:5a:88:e6:e0,21062623,2360,2789,21060263,21062623
4195,4,1,1,2412,-77,-92,15,b8:3a:5a:88:e6:e1,21065408,2376,409,21063032,21065408
4196,6,12,1,2412,-86,-92,6,84:d4:7e:f2:34:20,21068073,160,2505,21067913,21068073
4197,6,12,1,2412,-87,-92,5,84:d4:7e:f2:34:22,21068696,180,443,21068516,21068696
4198,6,12,1,2412,-87,-92,5,84:d4:7e:f2:34:23,21068920,180,44,21068740,21068920
4199,6,12,1,2412,-88,-92,4,84:d4:7e:f2:34:25,21069353,160,273,21069193,21069353
4200,6,6,1,2412,-82,-92,10,40:e3:d6:da:bb:e1,21075427,368,5706,21075059,21075427
4201,6,12,1,2412,-87,-92,5,40:e3:d6:da:bb:e2,21075824,176,221,21075648,21075824
4202,6,12,1,2412,-85,-92,7,40:e3:d6:da:bb:e3,21076052,180,48,21075872,21076052
4203,6,12,1,2412,-88,-92,4,40:e3:d6:da:bb:e4,21076651,172,427,21076479,21076651
4204,6,12,1,2412,-53,-92,39,40:e3:d6:da:ba:20,21078504,160,1693,21078344,21078504
4205,6,6,1,2412,-53,-92,39,40:e3:d6:da:ba:21,21078723,368,-149,21078355,21078723
4206,6,12,1,2412,-53,-92,39,40:e3:d6:da:ba:22,21079137,180,234,21078957,21079137
4207,6,12,1,2412,-53,-92,39,40:e3:d6:da:ba:23,21079343,184,22,21079159,21079343
4208,6,12,1,2412,-53,-92,39,40:e3:d6:da:ba:24,21079552,176,33,21079376,21079552
4209,6,12,1,2412,-53,-92,39,40:e3:d6:da:ba:25,21079982,160,270,21079822,21079982
4210,6,6,1,2412,-85,-92,7,84:d4:7e:f2:42:26,21080786,380,424,21080406,21080786
4211,6,12,1,2412,-87,-92,5,,21084279,32,3461,21084247,21084279
4212,6,12,1,2412,-87,-92,5,,21084815,36,500,21084779,21084815
4213,6,12,1,2412,-86,-92,6,,21085237,36,386,21085201,21085237
4214,6,6,1,2412,-60,-92,32,e6:aa:ea:c9:ea:33,21091424,408,5779,21091016,21091424
4215,6,12,1,2412,-84,-92,8,40:e3:d6:da:ca:c0,21093397,156,1817,21093241,21093397
4216,6,12,1,2412,-84,-92,8,40:e3:d6:da:ca:c5,21095139,156,1586,21094983,21095139
4217,6,6,1,2412,-59,-92,33,e6:aa:ea:c9:ea:33,21115662,408,20115,21115254,21115662
4218,6,6,1,2412,-85,-92,7,,21116094,44,388,21116050,21116094
4219,6,6,1,2412,-86,-92,6,,21120914,44,4776,21120870,21120914
4220,6,12,1,2412,-88,-92,4,40:e3:d6:da:c8:02,21121000,160,-74,21120840,21121000
4221,6,12,1,2412,-88,-92,4,40:e3:d6:da:c8:05,21121590,140,450,21121450,21121590
4222,6,12,1,2412,-85,-92,7,,21121748,32,126,21121716,21121748
4223,6,12,1,2412,-86,-92,6,84:d4:7e:f2:34:22,21121804,160,-104,21121644,21121804
4224,6,12,1,2412,-86,-92,6,84:d4:7e:f2:34:23,21122065,160,101,21121905,21122065
4225,6,12,1,2412,-84,-92,8,,21122243,32,146,21122211,21122243
4226,6,12,1,2412,-87,-92,5,84:d4:7e:f2:34:25,21122317,140,-66,21122177,21122317
4227,6,12,1,2412,-86,-92,6,,21122476,32,127,21122444,21122476
4228,6,12,1,2412,-88,-92,4,40:e3:d6:da:c8:00,21125146,160,2510,21124986,21125146
4229,6,6,1,2412,-66,-92,26,e6:aa:ea:c9:ea:33,21127795,408,2241,21127387,21127795
4230,6,12,1,2412,-88,-92,4,,21132677,32,4850,21132645,21132677
4231,4,1,1,2412,-67,-92,25,54:e4:3a:ec:fb:64,21137775,2160,2938,21135615,21137775
4232,6,6,1,2412,-87,-92,5,e6:aa:ea:c9:ea:1b,21145578,408,7395,21145170,21145578
4233,6,12,1,2412,-88,-92,4,,21147471,32,1861,21147439,21147471
4234,4,1,1,2412,-75,-92,17,b8:3a:5a:88:e6:e0,21166766,2360,16935,21164406,21166766
4235,4,1,1,2412,-74,-92,18,b8:3a:5a:88:e6:e1,21169155,2376,13,21166779,21169155
4236,6,12,1,2412,-87,-92,5,40:e3:d6:da:bb:e0,21177615,156,8304,21177459,21177615
4237,6,6,1,2412,-86,-92,6,40:e3:d6:da:bb:e1,21177821,368,-162,21177453,21177821
4238,6,12,1,2412,-52,-92,40,40:e3:d6:da:ba:20,21180929,160,2948,21180769,21180929
4239,6,6,1,2412,-52,-92,40,40:e3:d6:da:ba:21,21181139,368,-158,21180771,21181139
4240,6,12,1,2412,-52,-92,40,40:e3:d6:da:ba:22,21181526,180,207,21181346,21181526
4241,6,12,1,2412,-52,-92,40,40:e3:d6:da:ba:23,21181749,184,39,21181565,21181749
4242,6,12,1,2412,-52,-92,40,40:e3:d6:da:ba:24,21181968,176,43,21181792,21181968
4243,6,12,1,2412,-52,-92,40,40:e3:d6:da:ba:25,21182178,160,50,21182018,21182178
4244,6,6,1,2412,-52,-92,40,40:e3:d6:da:ba:26,21182370,380,-188,21181990,21182370
4245,6,6,1,2412,-85,-92,7,84:d4:7e:f2:42:26,21183160,380,410,21182780,21183160
4246,4,1,1,2412,-82,-92,10,,21184825,304,1361,21184521,21184825
4247,6,12,1,2412,-86,-92,6,84:d4:7e:f2:34:20,21184989,140,24,21184849,21184989
4248,6,6,1,2412,-87,-92,5,84:d4:7e:f2:34:21,21185169,348,-168,21184821,21185169
4249,6,12,1,2412,-86,-92,6,84:d4:7e:f2:34:22,21185555,160,226,21185395,21185555
4250,4,1,1,2412,-81,-92,11,a6:e5:7c:28:b1:d3,21187495,944,996,21186551,21187495
4251,6,12,1,2412,-84,-92,8,40:e3:d6:da:ca:c3,21196609,180,8934,21196429,21196609
4252,6,6,1,2412,-83,-92,9,40:e3:d6:da:ca:c6,21197244,380,255,21196864,21197244
4253,6,12,1,2412,-88,-92,4,40:e3:d6:da:c8:02,21205769,160,8365,21205609,21205769
4254,6,12,1,2412,-89,-92,3,40:e3:d6:da:c8:05,21206202,140,293,21206062,21206202
4255,6,12,1,2412,-89,-92,3,40:e3:d6:da:c8:00,21227077,160,20715,21226917,21227077
4256,6,6,1,2412,-87,-92,5,40:e3:d6:da:c8:01,21227287,368,-158,21226919,21227287
4257,6,12,1,2412,-84,-92,8,84:d4:7e:f2:34:25,21272584,160,45137,21272424,21272584
4258,6,6,1,2412,-85,-92,7,84:d4:7e:f2:34:26,21272776,380,-188,21272396,21272776
4259,6,12,1,2412,-87,-92,5,40:e3:d6:da:bb:e0,21280521,156,7589,21280365,21280521
4260,6,6,1,2412,-86,-92,6,40:e3:d6:da:bb:e1,21280718,368,-171,21280350,21280718
4261,4,1,1,2412,-86,-92,6,,21281283,304,261,21280979,21281283
4262,6,12,1,2412,-86,-92,6,40:e3:d6:da:bb:e3,21281577,180,114,21281397,21281577
4263,6,12,1,2412,-87,-92,5,40:e3:d6:da:bb:e4,21281792,172,43,21281620,21281792
4264,6,12,1,2412,-87,-92,5,40:e3:d6:da:bb:e5,21281989,156,41,21281833,21281989
4265,6,12,1,2412,-86,-92,6,,21283180,32,1159,21283148,21283180
4266,6,12,1,2412,-86,-92,6,,21283256,36,40,21283220,21283256
4267,6,12,1,2412,-53,-92,39,40:e3:d6:da:ba:20,21283315,160,-101,21283155,21283315
4268,6,6,1,2412,-53,-92,39,40:e3:d6:da:ba:21,21283525,368,-158,21283157,21283525
4269,6,12,1,2412,-53,-92,39,40:e3:d6:da:ba:22,21283930,180,225,21283750,21283930
4270,6,12,1,2412,-53,-92,39,40:e3:d6:da:ba:23,21284157,184,43,21283973,21284157
4271,6,12,1,2412,-53,-92,39,40:e3:d6:da:ba:24,21284400,176,67,21284224,21284400
4272,6,12,1,2412,-53,-92,39,40:e3:d6:da:ba:25,21284620,160,60,21284460,21284620
4273,6,6,1,2412,-52,-92,40,40:e3:d6:da:ba:26,21284830,380,-170,21284450,21284830
4274,6,12,1,2412,-86,-92,6,84:d4:7e:f2:42:25,21285378,160,388,21285218,21285378
4275,6,12,1,2412,-85,-92,7,40:e3:d6:da:ca:c4,21299247,172,13697,21299075,21299247
4276,6,12,1,2412,-86,-92,6,40:e3:d6:da:ca:c5,21299462,156,59,21299306,21299462
4277,6,6,1,2412,-85,-92,7,40:e3:d6:da:ca:c6,21299677,380,-165,21299297,21299677
4278,4,1,1,2412,-85,-92,7,,21301569,304,1588,21301265,21301569
4279,6,12,1,2412,-85,-92,7,,21310125,32,8524,21310093,21310125
4280,6,12,1,2412,-86,-92,6,,21311355,32,1198,21311323,21311355
4281,6,12,1,2412,-89,-92,3,40:e3:d6:da:c8:00,21329459,160,17944,21329299,21329459
4282,6,6,1,2412,-89,-92,3,40:e3:d6:da:c8:01,21329651,368,-176,21329283,21329651
4283,6,12,1,2412,-89,-92,3,40:e3:d6:da:c8:02,21330066,180,235,21329886,21330066
4284,6,6,1,2412,-89,-92,3,40:e3:d6:da:c8:06,21330963,380,517,21330583,21330963
4285,4,1,1,2412,-68,-92,24,54:e4:3a:ec:fb:64,21342586,2160,9463,21340426,21342586
4286,4,1,1,2412,-90,-92,2,,21373649,304,30759,21373345,21373649
4287,6,12,1,2412,-84,-92,8,84:d4:7e:f2:34:20,21373822,160,13,21373662,21373822
4288,6,6,1,2412,-84,-92,8,84:d4:7e:f2:34:21,21374023,368,-167,21373655,21374023
4289,6,12,1,2412,-84,-92,8,84:d4:7e:f2:34:25,21375040,160,857,21374880,21375040
4290,6,6,1,2412,-84,-92,8,84:d4:7e:f2:34:26,21375250,380,-170,21374870,21375250
4291,6,6,1,2412,-84,-92,8,40:e3:d6:da:bb:e1,21382622,368,7004,21382254,21382622
4292,6,12,1,2412,-85,-92,7,40:e3:d6:da:bb:e2,21383018,176,220,21382842,21383018
4293,6,12,1,2412,-86,-92,6,40:e3:d6:da:bb:e3,21383247,180,49,21383067,21383247
4294,6,12,1,2412,-86,-92,6,40:e3:d6:da:bb:e4,21383452,172,33,21383280,21383452
4295,6,6,1,2412,-85,-92,7,40:e3:d6:da:bb:e6,21383855,380,23,21383475,21383855
4296,6,12,1,2412,-54,-92,38,40:e3:d6:da:ba:20,21385720,160,1705,21385560,21385720
4297,6,6,1,2412,-54,-92,38,40:e3:d6:da:ba:21,21385930,368,-158,21385562,21385930
4298,6,12,1,2412,-54,-92,38,40:e3:d6:da:ba:22,21386335,180,225,21386155,21386335
4299,6,12,1,2412,-54,-92,38,40:e3:d6:da:ba:23,21386549,184,30,21386365,21386549
4300,6,12,1,2412,-54,-92,38,40:e3:d6:da:ba:24,21386776,176,51,21386600,21386776
4301,6,12,1,2412,-54,-92,38,40:e3:d6:da:ba:25,21387005,160,69,21386845,21387005
4302,6,6,1,2412,-54,-92,38,40:e3:d6:da:ba:26,21387206,380,-179,21386826,21387206
4303,6,12,1,2412,-86,-92,6,84:d4:7e:f2:42:25,21387813,160,447,21387653,21387813
4304,6,6,1,2412,-87,-92,5,84:d4:7e:f2:42:26,21388004,380,-189,21387624,21388004
4305,6,6,1,2412,-73,-92,19,e6:aa:ea:b7:4a:dd,21392569,408,4157,21392161,21392569
4306,6,12,1,2412,-87,-92,5,,21393156,32,555,21393124,21393156
4307,4,1,1,2412,-74,-92,18,,21393917,304,457,21393613,21393917
4308,6,6,1,2412,-53,-92,39,e6:aa:ea:c9:ea:33,21394602,408,277,21394194,21394602
4309,6,6,1,2412,-84,-92,8,40:e3:d6:da:ca:c1,21400807,368,5837,21400439,21400807
4310,6,12,1,2412,-85,-92,7,40:e3:d6:da:ca:c2,21401221,176,238,21401045,21401221
4311,6,12,1,2412,-84,-92,8,40:e3:d6:da:ca:c3,21401441,180,40,21401261,21401441
4312,6,12,1,2412,-86,-92,6,40:e3:d6:da:ca:c4,21401673,172,60,21401501,21401673
4313,6,12,1,2412,-85,-92,7,40:e3:d6:da:ca:c5,21401888,156,59,21401732,21401888
4314,6,6,1,2412,-81,-92,11,40:e3:d6:da:ca:c6,21402094,380,-174,21401714,21402094
4315,6,6,1,2412,-74,-92,18,e6:aa:ea:b7:4a:dd,21404693,408,2191,21404285,21404693
4316,6,6,1,2412,-52,-92,40,e6:aa:ea:c9:ea:33,21406574,408,1473,21406166,21406574
4317,6,6,1,2412,-74,-92,18,e6:aa:ea:b7:4a:dd,21416815,408,9833,21416407,21416815
4318,6,6,1,2412,-52,-92,40,e6:aa:ea:c9:ea:33,21418666,408,1443,21418258,21418666
4319,6,6,1,2412,-52,-92,40,e6:aa:ea:c9:ea:33,21430812,408,11738,21430404,21430812
4320,6,12,1,2412,-72,-92,20,84:d4:7e:f2:33:00,21439803,960,8031,21438843,21439803
4321,6,6,1,2412,-52,-92,40,e6:aa:ea:c9:ea:33,21442905,408,2694,21442497,21442905
4322,4,1,1,2412,-68,-92,24,54:e4:3a:ec:fb:64,21445031,2160,-34,21442871,21445031
4323,6,6,1,2412,-86,-92,6,e6:aa:ea:c9:ea:1b,21463913,408,18474,21463505,21463913
4324,4,1,1,2412,-78,-92,14,b8:3a:5a:88:e6:e1,21474477,2376,8188,21472101,21474477
4325,6,12,1,2412,-83,-92,9,84:d4:7e:f2:34:20,21476704,160,2067,21476544,21476704
4326,6,12,1,2412,-83,-92,9,84:d4:7e:f2:34:24,21477939,176,1059,21477763,21477939
4327,6,12,1,2412,-83,-92,9,84:d4:7e:f2:34:25,21478158,160,59,21477998,21478158
4328,6,12,1,2412,-87,-92,5,40:e3:d6:da:bb:e0,21485009,156,6695,21484853,21485009
4329,6,6,1,2412,-85,-92,7,40:e3:d6:da:bb:e1,21485206,368,-171,21484838,21485206
4330,6,12,1,2412,-86,-92,6,40:e3:d6:da:bb:e2,21485620,176,238,21485444,21485620
4331,6,12,1,2412,-85,-92,7,40:e3:d6:da:bb:e3,21485831,180,31,21485651,21485831
4332,6,12,1,2412,-86,-92,6,40:e3:d6:da:bb:e4,21486064,172,61,21485892,21486064
4333,6,12,1,2412,-87,-92,5,40:e3:d6:da:bb:e5,21486270,156,50,21486114,21486270
4334,6,6,1,2412,-86,-92,6,40:e3:d6:da:bb:e6,21486476,380,-174,21486096,21486476
4335,6,12,1,2412,-56,-92,36,40:e3:d6:da:ba:25,21489422,160,2786,21489262,21489422
4336,6,6,1,2412,-56,-92,36,40:e3:d6:da:ba:26,21489623,380,-179,21489243,21489623
4337,4,1,1,2412,-78,-92,14,c0:c9:e3:4d:6e:bf,21491282,872,787,21490410,21491282
4338,4,1,1,2412,-84,-92,8,,21492171,304,585,21491867,21492171
4339,4,1,1,2412,-86,-92,6,,21493300,304,825,21492996,21493300
4340,6,6,1,2412,-84,-92,8,84:1b:5e:df:1b:99,21495870,80,2490,21495790,21495870
4341,6,12,1,2412,-86,-92,6,40:e3:d6:da:ca:c0,21504820,156,8794,21504664,21504820
4342,6,6,1,2412,-85,-92,7,40:e3:d6:da:ca:c1,21505026,368,-162,21504658,21505026
4343,6,12,1,2412,-85,-92,7,40:e3:d6:da:ca:c2,21505413,176,211,21505237,21505413
4344,6,12,1,2412,-85,-92,7,40:e3:d6:da:ca:c3,21505642,180,49,21505462,21505642
4345,6,12,1,2412,-86,-92,6,40:e3:d6:da:ca:c4,21505856,172,42,21505684,21505856
4346,6,12,1,2412,-86,-92,6,40:e3:d6:da:ca:c5,21506063,156,51,21505907,21506063
4347,6,6,1,2412,-85,-92,7,40:e3:d6:da:ca:c6,21506260,380,-183,21505880,21506260
4348,6,6,1,2412,-87,-92,5,e6:aa:ea:c9:ea:1b,21512373,408,5705,21511965,21512373
4349,4,1,1,2412,-87,-92,5,,21513963,304,1286,21513659,21513963
4350,6,12,1,2412,-88,-92,4,40:e3:d6:da:c8:05,21536414,160,22291,21536254,21536414
4351,4,1,1,2412,-65,-92,27,54:e4:3a:ec:fb:64,21547203,2160,8629,21545043,21547203
4352,4,1,1,2412,-77,-92,15,b8:3a:5a:88:e6:e0,21574751,2360,25188,21572391,21574751
4353,6,12,1,2412,-83,-92,9,84:d4:7e:f2:34:22,21579802,180,4871,21579622,21579802
4354,6,12,1,2412,-83,-92,9,84:d4:7e:f2:34:23,21580026,180,44,21579846,21580026
4355,6,12,1,2412,-82,-92,10,84:d4:7e:f2:34:24,21580231,176,29,21580055,21580231
4356,6,12,1,2412,-83,-92,9,84:d4:7e:f2:34:25,21580474,160,83,21580314,21580474
4357,6,6,1,2412,-82,-92,10,84:d4:7e:f2:34:26,21580693,380,-161,21580313,21580693
4358,6,12,1,2412,-89,-92,3,40:e3:d6:da:bb:e0,21587218,156,6369,21587062,21587218
4359,6,12,1,2412,-57,-92,35,40:e3:d6:da:ba:25,21591786,160,4408,21591626,21591786
4360,6,6,1,2412,-57,-92,35,40:e3:d6:da:ba:26,21591986,380,-180,21591606,21591986
4361,6,6,1,2412,-84,-92,8,84:d4:7e:f2:42:26,21592734,380,368,21592354,21592734
4362,6,6,1,2412,-85,-92,7,40:e3:d6:da:ca:c1,21605605,368,12503,21605237,21605605
4363,6,12,1,2412,-88,-92,4,40:e3:d6:da:ca:c2,21605991,176,210,21605815,21605991
4364,6,12,1,2412,-87,-92,5,40:e3:d6:da:ca:c3,21606202,180,31,21606022,21606202
4365,6,12,1,2412,-88,-92,4,40:e3:d6:da:ca:c4,21606416,172,42,21606244,21606416
4366,6,12,1,2412,-87,-92,5,40:e3:d6:da:ca:c5,21606614,156,42,21606458,21606614
4367,6,6,1,2412,-86,-92,6,40:e3:d6:da:ca:c6,21606829,380,-165,21606449,21606829
4368,6,12,1,2412,-87,-92,5,40:e3:d6:da:c8:00,21636676,160,29687,21636516,21636676
4369,6,12,1,2412,-86,-92,6,40:e3:d6:da:c8:05,21637952,160,1116,21637792,21637952
4370,6,6,1,2412,-88,-92,4,40:e3:d6:da:c8:06,21638144,380,-188,21637764,21638144
4371,4,1,1,2412,-67,-92,25,54:e4:3a:ec:fb:64,21649832,2160,9528,21647672,21649832
4372,4,1,1,2412,-62,-92,30,de:ca:7b:84:e9:08,21665595,1360,14403,21664235,21665595
4373,4,1,1,2412,-62,-92,30,6a:08:d1:79:e4:01,21667144,1128,421,21666016,21667144
4374,6,12,1,2412,-55,-92,37,40:e3:d6:da:ba:20,21668257,136,977,21668121,21668257
4375,6,6,1,2412,-55,-92,37,40:e3:d6:da:ba:21,21668461,348,-144,21668113,21668461
4376,6,12,1,2412,-55,-92,37,40:e3:d6:da:ba:22,21668846,156,229,21668690,21668846
4377,6,12,1,2412,-55,-92,37,40:e3:d6:da:ba:23,21669037,156,35,21668881,21669037
4378,6,12,1,2412,-55,-92,37,40:e3:d6:da:ba:25,21669254,136,81,21669118,21669254
4379,4,1,1,2412,-77,-92,15,b8:3a:5a:88:e6:e0,21676878,2360,5264,21674518,21676878
4380,4,1,1,2412,-78,-92,14,b8:3a:5a:88:e6:e1,21679266,2376,12,21676890,21679266
4381,6,12,1,2412,-55,-92,37,40:e3:d6:da:ba:20,21690710,136,11308,21690574,21690710
4382,6,6,1,2412,-55,-92,37,40:e3:d6:da:ba:21,21690905,348,-153,21690557,21690905
4383,6,12,1,2412,-55,-92,37,40:e3:d6:da:ba:22,21691281,156,220,21691125,21691281
4384,6,12,1,2412,-54,-92,38,40:e3:d6:da:ba:23,21691489,156,52,21691333,21691489
4385,6,12,1,2412,-54,-92,38,40:e3:d6:da:ba:25,21691707,136,82,21691571,21691707
4386,6,12,1,2412,-55,-92,37,40:e3:d6:da:ba:20,21692921,160,1054,21692761,21692921
4387,6,6,1,2412,-55,-92,37,40:e3:d6:da:ba:21,21693113,368,-176,21692745,21693113
4388,6,12,1,2412,-55,-92,37,40:e3:d6:da:ba:22,21693518,180,225,21693338,21693518
4389,6,12,1,2412,-55,-92,37,40:e3:d6:da:ba:23,21693733,184,31,21693549,21693733
4390,6,12,1,2412,-55,-92,37,40:e3:d6:da:ba:24,21693960,176,51,21693784,21693960
4391,6,12,1,2412,-55,-92,37,40:e3:d6:da:ba:25,21694171,160,51,21694011,21694171
4392,6,6,1,2412,-55,-92,37,40:e3:d6:da:ba:26,21694363,380,-188,21693983,21694363
4393,6,12,1,2412,-85,-92,7,84:d4:7e:f2:42:24,21694749,176,210,21694573,21694749
4394,6,12,1,2412,-85,-92,7,84:d4:7e:f2:42:25,21694950,160,41,21694790,21694950
4395,6,6,1,2412,-85,-92,7,84:d4:7e:f2:42:26,21695160,380,-170,21694780,21695160
4396,6,12,1,2412,-88,-92,4,40:e3:d6:da:ca:c0,21707792,156,12476,21707636,21707792
4397,6,6,1,2412,-89,-92,3,40:e3:d6:da:ca:c1,21708007,368,-153,21707639,21708007
4398,6,12,1,2412,-88,-92,4,40:e3:d6:da:ca:c2,21708412,176,229,21708236,21708412
4399,6,12,1,2412,-88,-92,4,40:e3:d6:da:ca:c3,21708640,180,48,21708460,21708640
4400,6,12,1,2412,-87,-92,5,40:e3:d6:da:ca:c4,21708846,172,34,21708674,21708846
4401,6,12,1,2412,-87,-92,5,40:e3:d6:da:c8:00,21739056,160,30050,21738896,21739056
4402,6,6,1,2412,-88,-92,4,40:e3:d6:da:c8:01,21739275,368,-149,21738907,21739275
4403,6,12,1,2412,-87,-92,5,40:e3:d6:da:c8:02,21739679,180,224,21739499,21739679
4404,4,1,1,2412,-57,-92,35,54:e4:3a:ec:fb:64,21752226,2160,10387,21750066,21752226
4405,6,12,1,2412,-87,-92,5,,21773233,32,20975,21773201,21773233
4406,4,1,1,2412,-79,-92,13,b8:3a:5a:88:e6:e1,21782381,2376,6772,21780005,21782381
4407,6,6,1,2412,-85,-92,7,40:e3:d6:da:bb:e1,21792218,368,9469,21791850,21792218
4408,6,12,1,2412,-54,-92,38,40:e3:d6:da:ba:20,21795330,160,2952,21795170,21795330
4409,6,6,1,2412,-54,-92,38,40:e3:d6:da:ba:21,21795540,368,-158,21795172,21795540
4410,6,12,1,2412,-54,-92,38,40:e3:d6:da:ba:22,21795927,180,207,21795747,21795927
4411,6,12,1,2412,-54,-92,38,40:e3:d6:da:ba:23,21796133,184,22,21795949,21796133
4412,6,12,1,2412,-54,-92,38,40:e3:d6:da:ba:24,21796369,176,60,21796193,21796369
4413,6,12,1,2412,-54,-92,38,40:e3:d6:da:ba:25,21796598,160,69,21796438,21796598
4414,6,6,1,2412,-54,-92,38,40:e3:d6:da:ba:26,21796790,380,-188,21796410,21796790
4415,6,12,1,2412,-87,-92,5,84:d4:7e:f2:42:25,21797405,160,455,21797245,21797405
4416,6,6,1,2412,-88,-92,4,e6:aa:ea:c9:ea:1b,21805318,408,7505,21804910,21805318
4417,4,1,1,2412,-61,-92,31,da:0d:f1:2f:24:83,21808619,1360,1941,21807259,21808619
4418,4,1,1,2412,-60,-92,32,5e:db:37:89:17:02,21810195,1128,448,21809067,21810195
4419,6,12,1,2412,-53,-92,39,40:e3:d6:da:ba:20,21811305,136,974,21811169,21811305
4420,6,12,1,2412,-59,-92,33,,21811458,32,121,21811426,21811458
4421,6,6,1,2412,-53,-92,39,40:e3:d6:da:ba:21,21811558,348,-248,21811210,21811558
4422,6,12,1,2412,-53,-92,39,40:e3:d6:da:ba:22,21811953,156,239,21811797,21811953
4423,6,12,1,2412,-52,-92,40,40:e3:d6:da:ba:23,21812177,156,68,21812021,21812177
4424,6,12,1,2412,-53,-92,39,40:e3:d6:da:ba:25,21812394,136,81,21812258,21812394
4425,6,12,1,2412,-59,-92,33,,21812547,32,121,21812515,21812547
4426,6,12,1,2412,-52,-92,40,40:e3:d6:da:ba:20,21832040,136,19357,21831904,21832040
4427,6,6,1,2412,-52,-92,40,40:e3:d6:da:ba:21,21832235,348,-153,21831887,21832235
4428,6,12,1,2412,-52,-92,40,40:e3:d6:da:ba:22,21832739,156,348,21832583,21832739
4429,6,12,1,2412,-52,-92,40,40:e3:d6:da:ba:25,21833218,136,343,21833082,21833218
4430,6,6,1,2412,-60,-92,32,,21833376,44,114,21833332,21833376
4431,6,6,1,2412,-75,-92,17,e6:aa:ea:b7:4a:dd,21835060,408,1276,21834652,21835060
4432,6,12,1,2412,-89,-92,3,40:e3:d6:da:c8:00,21841458,160,6238,21841298,21841458
4433,4,1,1,2412,-70,-92,22,54:e4:3a:ec:fb:64,21854624,2160,11006,21852464,21854624
4434,4,1,1,2412,-59,-92,33,,21859049,304,4121,21858745,21859049
4435,6,6,1,2412,-74,-92,18,e6:aa:ea:b7:4a:dd,21859311,408,-146,21858903,21859311
4436,6,12,1,2412,-88,-92,4,40:e3:d6:da:c8:03,21860000,160,529,21859840,21860000
4437,4,1,1,2412,-85,-92,7,,21879802,304,19498,21879498,21879802
4438,4,1,1,2412,-77,-92,15,b8:3a:5a:88:e6:e1,21884635,2376,2457,21882259,21884635
4439,6,6,1,2412,-89,-92,3,84:d4:7e:f2:34:21,21887369,368,2366,21887001,21887369
4440,6,12,1,2412,-88,-92,4,84:d4:7e:f2:34:22,21887764,180,215,21887584,21887764
4441,6,12,1,2412,-88,-92,4,84:d4:7e:f2:34:23,21887988,180,44,21887808,21887988
4442,6,6,1,2412,-87,-92,5,84:d4:7e:f2:34:26,21888657,380,289,21888277,21888657
4443,6,12,1,2412,-86,-92,6,40:e3:d6:da:bb:e0,21894990,156,6177,21894834,21894990
4444,6,6,1,2412,-84,-92,8,40:e3:d6:da:bb:e1,21895178,368,-180,21894810,21895178
4445,6,12,1,2412,-86,-92,6,40:e3:d6:da:bb:e2,21895583,176,229,21895407,21895583
4446,6,12,1,2412,-85,-92,7,40:e3:d6:da:bb:e3,21895809,180,46,21895629,21895809
4447,6,12,1,2412,-85,-92,7,40:e3:d6:da:bb:e4,21896030,172,49,21895858,21896030
4448,6,6,1,2412,-86,-92,6,40:e3:d6:da:bb:e6,21896442,380,32,21896062,21896442
4449,6,12,1,2412,-52,-92,40,40:e3:d6:da:ba:20,21897731,160,1129,21897571,21897731
4450,6,6,1,2412,-52,-92,40,40:e3:d6:da:ba:21,21897932,368,-167,21897564,21897932
4451,6,12,1,2412,-52,-92,40,40:e3:d6:da:ba:22,21898328,180,216,21898148,21898328
4452,6,12,1,2412,-52,-92,40,40:e3:d6:da:ba:23,21898561,184,49,21898377,21898561
4453,6,12,1,2412,-52,-92,40,40:e3:d6:da:ba:24,21898770,176,33,21898594,21898770
4454,6,12,1,2412,-52,-92,40,40:e3:d6:da:ba:25,21898972,160,42,21898812,21898972
4455,6,6,1,2412,-52,-92,40,40:e3:d6:da:ba:26,21899172,380,-180,21898792,21899172
4456,6,6,1,2412,-87,-92,5,84:d4:7e:f2:42:21,21900909,368,1369,21900541,21900909
4457,6,12,1,2412,-86,-92,6,84:d4:7e:f2:42:22,21901314,180,225,21901134,21901314
4458,6,12,1,2412,-85,-92,7,84:d4:7e:f2:42:23,21901538,180,44,21901358,21901538
4459,6,12,1,2412,-87,-92,5,84:d4:7e:f2:42:25,21901963,160,265,21901803,21901963
4460,6,6,1,2412,-87,-92,5,84:d4:7e:f2:42:26,21902173,380,-170,21901793,21902173
4461,6,12,1,2412,-88,-92,4,40:e3:d6:da:ca:c2,21913190,176,10841,21913014,21913190
4462,6,12,1,2412,-87,-92,5,40:e3:d6:da:ca:c3,21913410,180,40,21913230,21913410
4463,6,12,1,2412,-89,-92,3,40:e3:d6:da:ca:c4,21913615,172,33,21913443,21913615
4464,6,12,1,2412,-88,-92,4,40:e3:d6:da:ca:c5,21913822,156,51,21913666,21913822
4465,6,6,1,2412,-86,-92,6,40:e3:d6:da:ca:c6,21914019,380,-183,21913639,21914019
4466,6,6,1,2412,-54,-92,38,e6:aa:ea:c9:ea:33,21914538,408,111,21914130,21914538
4467,6,6,1,2412,-90,-92,2,a8:5b:f7:55:1a:40,21917161,72,2551,21917089,21917161
4468,6,6,1,2412,-54,-92,38,e6:aa:ea:c9:ea:33,21926653,408,9084,21926245,21926653
4469,4,1,1,2412,-84,-92,8,,21936400,304,9443,21936096,21936400
4470,6,6,1,2412,-54,-92,38,e6:aa:ea:c9:ea:33,21938758,408,1950,21938350,21938758
4471,4,1,1,2412,-73,-92,19,a6:e5:7c:28:b1:d3,21943390,992,3640,21942398,21943390
4472,6,6,1,2412,-89,-92,3,40:e3:d6:da:c8:06,21945817,380,2047,21945437,21945817
4473,6,6,1,2412,-53,-92,39,e6:aa:ea:c9:ea:33,21950888,408,4663,21950480,21950888
4474,4,1,1,2412,-68,-92,24,54:e4:3a:ec:fb:64,21957054,2160,4006,21954894,21957054
4475,6,6,1,2412,-53,-92,39,e6:aa:ea:c9:ea:33,21963006,408,5544,21962598,21963006
4476,4,1,1,2412,-75,-92,17,,21982673,304,19363,21982369,21982673
4477,4,1,1,2412,-77,-92,15,b8:3a:5a:88:e6:e1,21986483,2376,1434,21984107,21986483
4478,6,6,1,2412,-88,-92,4,84:d4:7e:f2:34:21,21989253,368,2402,21988885,21989253
4479,6,12,1,2412,-86,-92,6,84:d4:7e:f2:34:22,21989667,180,234,21989487,21989667
4480,6,12,1,2412,-89,-92,3,84:d4:7e:f2:34:23,21989872,180,25,21989692,21989872
4481,6,12,1,2412,-87,-92,5,84:d4:7e:f2:34:24,21990204,176,156,21990028,21990204
4482,6,12,1,2412,-87,-92,5,84:d4:7e:f2:34:25,21990415,160,51,21990255,21990415
4483,6,6,1,2412,-88,-92,4,40:e3:d6:da:bb:e1,21997000,368,6217,21996632,21997000
4484,6,12,1,2412,-54,-92,38,40:e3:d6:da:ba:20,22000115,160,2955,21999955,22000115
4485,6,6,1,2412,-55,-92,37,40:e3:d6:da:ba:21,22000316,368,-167,21999948,22000316
4486,6,12,1,2412,-54,-92,38,40:e3:d6:da:ba:22,22000721,180,225,22000541,22000721
4487,6,12,1,2412,-54,-92,38,40:e3:d6:da:ba:23,22000953,184,48,22000769,22000953
4488,6,12,1,2412,-54,-92,38,40:e3:d6:da:ba:24,22001181,176,52,22001005,22001181
4489,6,12,1,2412,-54,-92,38,40:e3:d6:da:ba:25,22001409,160,68,22001249,22001409
4490,6,6,1,2412,-55,-92,37,40:e3:d6:da:ba:26,22001601,380,-188,22001221,22001601
4491,6,12,1,2412,-87,-92,5,40:e3:d6:da:ca:c2,22015597,176,13820,22015421,22015597
4492,6,12,1,2412,-86,-92,6,40:e3:d6:da:ca:c3,22015798,180,21,22015618,22015798
4493,6,12,1,2412,-85,-92,7,40:e3:d6:da:ca:c4,22016031,172,61,22015859,22016031
4494,6,12,1,2412,-86,-92,6,40:e3:d6:da:ca:c5,22016238,156,51,22016082,22016238
4495,6,6,1,2412,-88,-92,4,40:e3:d6:da:ca:c6,22016443,380,-175,22016063,22016443
4496,6,12,1,2412,-88,-92,4,40:e3:d6:da:c8:00,22046267,160,29664,22046107,22046267
4497,4,1,1,2412,-75,-92,17,a6:e5:7c:28:b1:d3,22046618,992,-641,22045626,22046618
4498,6,12,1,2412,-87,-92,5,40:e3:d6:da:c8:02,22047882,180,1084,22047702,22047882
4499,6,12,1,2412,-87,-92,5,40:e3:d6:da:c8:03,22048114,184,48,22047930,22048114
4500,6,12,1,2412,-87,-92,5,40:e3:d6:da:c8:05,22048543,160,269,22048383,22048543
4501,4,1,1,2412,-70,-92,22,54:e4:3a:ec:fb:64,22059470,2160,8767,22057310,22059470
4502,4,1,1,2412,-74,-92,18,,22074557,304,14783,22074253,22074557
4503,4,1,1,2412,-81,-92,11,b8:3a:5a:88:e6:e0,22086982,2360,10065,22084622,22086982
4504,6,6,1,2412,-90,-92,2,40:e3:d6:da:bb:e1,22099392,368,12042,22099024,22099392
4505,6,12,1,2412,-54,-92,38,40:e3:d6:da:ba:22,22103122,180,3550,22102942,22103122
4506,6,12,1,2412,-54,-92,38,40:e3:d6:da:ba:23,22103355,184,49,22103171,22103355
4507,6,12,1,2412,-54,-92,38,40:e3:d6:da:ba:24,22103582,176,51,22103406,22103582
4508,6,12,1,2412,-54,-92,38,40:e3:d6:da:ba:25,22103784,160,42,22103624,22103784
4509,6,12,1,2412,-87,-92,5,40:e3:d6:da:ca:c0,22117385,156,13445,22117229,22117385
4510,6,6,1,2412,-87,-92,5,40:e3:d6:da:ca:c1,22117600,368,-153,22117232,22117600
4511,6,12,1,2412,-86,-92,6,40:e3:d6:da:ca:c2,22117996,176,220,22117820,22117996
4512,6,12,1,2412,-87,-92,5,40:e3:d6:da:ca:c4,22118402,172,234,22118230,22118402
4513,6,6,1,2412,-86,-92,6,40:e3:d6:da:ca:c6,22118806,380,24,22118426,22118806
4514,4,1,1,2412,-73,-92,19,a6:e5:7c:28:b1:d3,22148804,992,29006,22147812,22148804
4515,4,1,1,2412,-71,-92,21,54:e4:3a:ec:fb:64,22161801,2160,10837,22159641,22161801
4516,4,1,1,2412,-83,-92,9,,22165978,304,3873,22165674,22165978
4517,6,12,1,2412,-86,-92,6,40:e3:d6:da:ca:c2,22188787,156,22653,22188631,22188787
4518,4,1,1,2412,-78,-92,14,b8:3a:5a:88:e6:e1,22191606,2376,443,22189230,22191606
4519,6,12,1,2412,-87,-92,5,40:e3:d6:da:bb:e0,22201628,156,9866,22201472,22201628
4520,6,6,1,2412,-87,-92,5,40:e3:d6:da:bb:e1,22201815,368,-181,22201447,22201815
4521,6,12,1,2412,-89,-92,3,40:e3:d6:da:bb:e3,22202460,180,465,22202280,22202460
4522,6,12,1,2412,-89,-92,3,40:e3:d6:da:bb:e4,22202683,172,51,22202511,22202683
4523,6,12,1,2412,-56,-92,36,40:e3:d6:da:ba:20,22204917,160,2074,22204757,22204917
4524,6,12,1,2412,-55,-92,37,40:e3:d6:da:ba:22,22205523,180,426,22205343,22205523
4525,6,12,1,2412,-55,-92,37,40:e3:d6:da:ba:23,22205728,184,21,22205544,22205728
4526,6,12,1,2412,-55,-92,37,40:e3:d6:da:ba:25,22206175,160,287,22206015,22206175
4527,6,6,1,2412,-55,-92,37,40:e3:d6:da:ba:26,22206376,380,-179,22205996,22206376
4528,6,12,1,2412,-84,-92,8,84:d4:7e:f2:42:24,22206761,176,209,22206585,22206761
4529,6,12,1,2412,-85,-92,7,84:d4:7e:f2:42:25,22206990,160,69,22206830,22206990
4530,6,6,1,2412,-81,-92,11,84:d4:7e:f2:42:26,22207192,380,-178,22206812,22207192
4531,6,12,1,2412,-85,-92,7,40:e3:d6:da:ca:c3,22220607,180,13235,22220427,22220607
4532,6,6,1,2412,-86,-92,6,40:e3:d6:da:ca:c6,22221234,380,247,22220854,22221234
4533,6,12,1,2412,-88,-92,4,84:d4:7e:f2:34:23,22223131,160,1737,22222971,22223131
4534,6,6,1,2412,-74,-92,18,e6:aa:ea:b7:4a:dd,22228180,408,4641,22227772,22228180
4535,6,6,1,2412,-74,-92,18,e6:aa:ea:b7:4a:dd,22252416,408,23828,22252008,22252416
4536,4,1,1,2412,-71,-92,21,54:e4:3a:ec:fb:64,22264202,2160,9626,22262042,22264202
4537,6,12,1,2412,-88,-92,4,84:d4:7e:f2:34:25,22296740,160,32378,22296580,22296740
4538,6,6,1,2412,-89,-92,3,84:d4:7e:f2:34:26,22296941,380,-179,22296561,22296941
4539,6,12,1,2412,-89,-92,3,40:e3:d6:da:bb:e0,22304005,156,6908,22303849,22304005
4540,6,6,1,2412,-89,-92,3,40:e3:d6:da:bb:e1,22304202,368,-171,22303834,22304202
4541,6,12,1,2412,-89,-92,3,40:e3:d6:da:bb:e3,22304827,180,445,22304647,22304827
4542,6,6,1,2412,-87,-92,5,40:e3:d6:da:bb:e6,22305481,380,274,22305101,22305481
4543,6,12,1,2412,-56,-92,36,40:e3:d6:da:ba:20,22307310,160,1669,22307150,22307310
4544,6,6,1,2412,-56,-92,36,40:e3:d6:da:ba:21,22307520,368,-158,22307152,22307520
4545,6,12,1,2412,-55,-92,37,40:e3:d6:da:ba:22,22307907,180,207,22307727,22307907
4546,6,12,1,2412,-56,-92,36,40:e3:d6:da:ba:24,22308349,176,266,22308173,22308349
4547,6,12,1,2412,-55,-92,37,40:e3:d6:da:ba:25,22308568,160,59,22308408,22308568
4548,6,6,1,2412,-87,-92,5,40:e3:d6:da:ca:c1,22322401,368,13465,22322033,22322401
4549,6,12,1,2412,-85,-92,7,40:e3:d6:da:ca:c3,22322998,180,417,22322818,22322998
4550,6,12,1,2412,-75,-92,17,40:e3:d6:da:ca:c5,22323438,156,284,22323282,22323438
4551,4,1,1,2412,-70,-92,22,54:e4:3a:ec:fb:64,22366601,2160,41003,22364441,22366601
4552,6,12,1,2412,-89,-92,3,84:d4:7e:f2:34:22,22398566,180,31785,22398386,22398566
4553,6,12,1,2412,-88,-92,4,84:d4:7e:f2:34:23,22398789,180,43,22398609,22398789
4554,6,12,1,2412,-88,-92,4,84:d4:7e:f2:34:24,22398994,176,29,22398818,22398994
4555,6,12,1,2412,-88,-92,4,40:e3:d6:da:bb:e0,22406421,156,7271,22406265,22406421
4556,6,12,1,2412,-88,-92,4,40:e3:d6:da:bb:e4,22407448,172,855,22407276,22407448
4557,6,12,1,2412,-86,-92,6,40:e3:d6:da:bb:e5,22407663,156,59,22407507,22407663
4558,6,6,1,2412,-86,-92,6,40:e3:d6:da:bb:e6,22407851,380,-192,22407471,22407851
4559,6,12,1,2412,-54,-92,38,40:e3:d6:da:ba:20,22409711,160,1700,22409551,22409711
4560,6,6,1,2412,-54,-92,38,40:e3:d6:da:ba:21,22409912,368,-167,22409544,22409912
4561,6,12,1,2412,-54,-92,38,40:e3:d6:da:ba:22,22410308,180,216,22410128,22410308
4562,6,12,1,2412,-54,-92,38,40:e3:d6:da:ba:23,22410513,184,21,22410329,22410513
4563,6,12,1,2412,-54,-92,38,40:e3:d6:da:ba:24,22410750,176,61,22410574,22410750
4564,6,12,1,2412,-54,-92,38,40:e3:d6:da:ba:25,22410978,160,68,22410818,22410978
4565,6,6,1,2412,-54,-92,38,40:e3:d6:da:ba:26,22411170,380,-188,22410790,22411170
4566,6,12,1,2412,-85,-92,7,84:d4:7e:f2:42:24,22411631,176,285,22411455,22411631
4567,4,1,1,2412,-73,-92,19,c0:c9:e3:4d:6e:bf,22432121,872,19618,22431249,22432121
4568,4,1,1,2412,-73,-92,19,,22433009,304,584,22432705,22433009
4569,6,6,1,2412,-89,-92,3,e6:aa:ea:c9:ea:1b,22439087,408,5670,22438679,22439087
4570,6,6,1,2412,-55,-92,37,e6:aa:ea:c9:ea:33,22446969,408,7474,22446561,22446969
4571,6,6,1,2412,-55,-92,37,e6:aa:ea:c9:ea:33,22459089,408,11712,22458681,22459089
4572,4,1,1,2412,-71,-92,21,54:e4:3a:ec:fb:64,22468997,2160,7748,22466837,22468997
4573,6,6,1,2412,-55,-92,37,e6:aa:ea:c9:ea:33,22471573,408,2168,22471165,22471573
4574,6,6,1,2412,-55,-92,37,e6:aa:ea:c9:ea:33,22483335,408,11354,22482927,22483335
4575,6,12,1,2412,-87,-92,5,84:d4:7e:f2:34:22,22501650,180,18135,22501470,22501650
4576,6,6,1,2412,-89,-92,3,84:d4:7e:f2:34:26,22502616,380,586,22502236,22502616
4577,6,12,1,2412,-85,-92,7,40:e3:d6:da:bb:e0,22508808,156,6036,22508652,22508808
4578,6,12,1,2412,-86,-92,6,40:e3:d6:da:bb:e5,22510060,156,1096,22509904,22510060
4579,6,6,1,2412,-87,-92,5,40:e3:d6:da:bb:e6,22510275,380,-165,22509895,22510275
4580,4,1,1,2412,-83,-92,9,,22510900,304,321,22510596,22510900
4581,6,12,1,2412,-53,-92,39,40:e3:d6:da:ba:20,22512126,160,1066,22511966,22512126
4582,6,6,1,2412,-52,-92,40,40:e3:d6:da:ba:21,22512345,368,-149,22511977,22512345
4583,6,12,1,2412,-52,-92,40,40:e3:d6:da:ba:23,22512989,184,460,22512805,22512989
4584,6,12,1,2412,-52,-92,40,40:e3:d6:da:ba:24,22513198,176,33,22513022,22513198
4585,6,6,1,2412,-53,-92,39,40:e3:d6:da:ba:26,22513610,380,32,22513230,22513610
4586,6,12,1,2412,-83,-92,9,84:d4:7e:f2:42:25,22514195,160,425,22514035,22514195
4587,6,6,1,2412,-84,-92,8,84:d4:7e:f2:42:26,22514387,380,-188,22514007,22514387
4588,6,12,1,2412,-88,-92,4,40:e3:d6:da:ca:c0,22526985,156,12442,22526829,22526985
4589,6,12,1,2412,-87,-92,5,40:e3:d6:da:ca:c3,22527806,180,641,22527626,22527806
4590,6,12,1,2412,-86,-92,6,40:e3:d6:da:ca:c4,22528038,172,60,22527866,22528038
4591,6,12,1,2412,-88,-92,4,40:e3:d6:da:ca:c5,22528236,156,42,22528080,22528236
4592,4,1,1,2412,-83,-92,9,,22537898,304,9358,22537594,22537898
4593,6,6,1,2412,-77,-92,15,e6:aa:ea:b7:4a:dd,22544096,408,5790,22543688,22544096
4594,6,6,1,2412,-78,-92,14,e6:aa:ea:b7:4a:dd,22556209,408,11705,22555801,22556209
4595,6,12,1,2412,-89,-92,3,40:e3:d6:da:c8:02,22558853,180,2464,22558673,22558853
4596,6,12,1,2412,-87,-92,5,40:e3:d6:da:c8:03,22559068,184,31,22558884,22559068
4597,6,12,1,2412,-89,-92,3,40:e3:d6:da:c8:04,22559286,176,42,22559110,22559286
4598,6,12,1,2412,-89,-92,3,40:e3:d6:da:c8:05,22559505,160,59,22559345,22559505
4599,6,6,1,2412,-89,-92,3,40:e3:d6:da:c8:06,22559697,380,-188,22559317,22559697
4600,4,1,1,2412,-70,-92,22,54:e4:3a:ec:fb:64,22571395,2160,9538,22569235,22571395
4601,6,6,1,2412,-79,-92,13,e6:aa:ea:b7:4a:dd,22580446,408,8643,22580038,22580446
4602,4,1,1,2412,-83,-92,9,,22584380,304,3630,22584076,22584380
4603,4,1,1,2412,-77,-92,15,b8:3a:5a:88:e6:e0,22598478,2360,11738,22596118,22598478
4604,4,1,1,2412,-78,-92,14,b8:3a:5a:88:e6:e1,22601380,2376,526,22599004,22601380
4605,6,6,1,2412,-88,-92,4,84:d4:7e:f2:34:26,22604327,380,2567,22603947,22604327
4606,6,6,1,2412,-53,-92,39,40:e3:d6:da:ba:21,22614740,368,10045,22614372,22614740
4607,6,12,1,2412,-53,-92,39,40:e3:d6:da:ba:22,22615154,180,234,22614974,22615154
4608,6,12,1,2412,-53,-92,39,40:e3:d6:da:ba:23,22615360,184,22,22615176,22615360
4609,6,12,1,2412,-53,-92,39,40:e3:d6:da:ba:24,22615587,176,51,22615411,22615587
4610,6,12,1,2412,-53,-92,39,40:e3:d6:da:ba:25,22615798,160,51,22615638,22615798
4611,6,6,1,2412,-53,-92,39,40:e3:d6:da:ba:26,22616016,380,-162,22615636,22616016
4612,6,12,1,2412,-83,-92,9,84:d4:7e:f2:42:25,22616600,160,424,22616440,22616600
4613,6,12,1,2412,-88,-92,4,40:e3:d6:da:ca:c0,22629407,156,12651,22629251,22629407
4614,6,6,1,2412,-87,-92,5,40:e3:d6:da:ca:c1,22629595,368,-180,22629227,22629595
4615,6,12,1,2412,-86,-92,6,40:e3:d6:da:ca:c4,22630425,172,658,22630253,22630425
4616,6,12,1,2412,-88,-92,4,40:e3:d6:da:ca:c5,22630640,156,59,22630484,22630640
4617,6,24,1,2412,-82,-92,10,,22651203,28,20535,22651175,22651203
4618,6,12,1,2412,-86,-92,6,,22651249,32,14,22651217,22651249
4619,6,12,1,2412,-85,-92,7,,22651363,32,82,22651331,22651363
4620,4,1,1,2412,-71,-92,21,54:e4:3a:ec:fb:64,22673834,2160,20311,22671674,22673834
4621,4,1,1,2412,-78,-92,14,b8:3a:5a:88:e6:e0,22700898,2360,24704,22698538,22700898
4622,6,6,1,2412,-89,-92,3,84:d4:7e:f2:34:26,22706492,380,5214,22706112,22706492
4623,6,12,1,2412,-85,-92,7,40:e3:d6:da:bb:e0,22713598,156,6950,22713442,22713598
4624,6,6,1,2412,-85,-92,7,40:e3:d6:da:bb:e1,22713786,368,-180,22713418,22713786
4625,6,12,1,2412,-84,-92,8,40:e3:d6:da:bb:e2,22714182,176,220,22714006,22714182
4626,6,12,1,2412,-85,-92,7,40:e3:d6:da:bb:e3,22714401,180,39,22714221,22714401
4627,6,12,1,2412,-85,-92,7,40:e3:d6:da:bb:e4,22714625,172,52,22714453,22714625
4628,6,12,1,2412,-86,-92,6,40:e3:d6:da:bb:e5,22714822,156,41,22714666,22714822
4629,6,6,1,2412,-83,-92,9,40:e3:d6:da:bb:e6,22715020,380,-182,22714640,22715020
4630,6,12,1,2412,-54,-92,38,40:e3:d6:da:ba:20,22716919,160,1739,22716759,22716919
4631,6,6,1,2412,-54,-92,38,40:e3:d6:da:ba:21,22717120,368,-167,22716752,22717120
4632,6,12,1,2412,-54,-92,38,40:e3:d6:da:ba:22,22717534,180,234,22717354,22717534
4633,6,12,1,2412,-54,-92,38,40:e3:d6:da:ba:23,22717758,184,40,22717574,22717758
4634,6,12,1,2412,-54,-92,38,40:e3:d6:da:ba:24,22717976,176,42,22717800,22717976
4635,6,12,1,2412,-54,-92,38,40:e3:d6:da:ba:25,22718178,160,42,22718018,22718178
4636,6,6,1,2412,-54,-92,38,40:e3:d6:da:ba:26,22718378,380,-180,22717998,22718378
4637,6,12,1,2412,-85,-92,7,84:d4:7e:f2:42:24,22718768,176,214,22718592,22718768
4638,6,12,1,2412,-85,-92,7,84:d4:7e:f2:42:25,22718978,160,50,22718818,22718978
4639,6,12,1,2412,-87,-92,5,40:e3:d6:da:ca:c0,22732266,156,13132,22732110,22732266
4640,6,12,1,2412,-87,-92,5,40:e3:d6:da:ca:c2,22732886,176,444,22732710,22732886
4641,6,6,1,2412,-86,-92,6,40:e3:d6:da:c8:06,22764549,380,31283,22764169,22764549
4642,4,1,1,2412,-79,-92,13,b8:3a:5a:88:e6:e1,22805685,2376,38760,22803309,22805685
4643,6,6,1,2412,-84,-92,8,40:e3:d6:da:bb:e1,22816204,368,10151,22815836,22816204
4644,6,12,1,2412,-87,-92,5,40:e3:d6:da:bb:e4,22817061,172,685,22816889,22817061
4645,6,12,1,2412,-88,-92,4,40:e3:d6:da:bb:e5,22817286,156,69,22817130,22817286
4646,6,12,1,2412,-52,-92,40,40:e3:d6:da:ba:20,22819333,160,1887,22819173,22819333
4647,6,6,1,2412,-52,-92,40,40:e3:d6:da:ba:21,22819543,368,-158,22819175,22819543
4648,6,12,1,2412,-53,-92,39,40:e3:d6:da:ba:22,22819930,180,207,22819750,22819930
4649,6,12,1,2412,-53,-92,39,40:e3:d6:da:ba:23,22820145,184,31,22819961,22820145
4650,6,12,1,2412,-53,-92,39,40:e3:d6:da:ba:24,22820354,176,33,22820178,22820354
4651,6,12,1,2412,-53,-92,39,40:e3:d6:da:ba:25,22820555,160,41,22820395,22820555
4652,6,6,1,2412,-53,-92,39,40:e3:d6:da:ba:26,22820765,380,-170,22820385,22820765
4653,6,12,1,2412,-88,-92,4,84:d4:7e:f2:42:25,22821391,160,466,22821231,22821391
4654,6,6,1,2412,-87,-92,5,40:e3:d6:da:ca:c1,22834397,368,12638,22834029,22834397
4655,6,12,1,2412,-87,-92,5,40:e3:d6:da:ca:c2,22834811,176,238,22834635,22834811
4656,6,6,1,2412,-86,-92,6,40:e3:d6:da:c8:01,22865678,368,30499,22865310,22865678
4657,6,12,1,2412,-80,-92,12,40:e3:d6:da:c8:02,22866083,180,225,22865903,22866083
4658,6,12,1,2412,-85,-92,7,40:e3:d6:da:c8:05,22866726,160,483,22866566,22866726
4659,6,6,1,2412,-86,-92,6,40:e3:d6:da:c8:06,22866945,380,-161,22866565,22866945
4660,4,1,1,2412,-71,-92,21,54:e4:3a:ec:fb:64,22878336,2160,9231,22876176,22878336
4661,4,1,1,2412,-75,-92,17,b8:3a:5a:88:e6:e1,22908059,2376,27347,22905683,22908059
4662,6,12,1,2412,-52,-92,40,40:e3:d6:da:ba:22,22924509,180,16270,22924329,22924509
4663,6,12,1,2412,-52,-92,40,40:e3:d6:da:ba:23,22924732,184,39,22924548,22924732
4664,6,12,1,2412,-52,-92,40,40:e3:d6:da:ba:24,22925014,176,106,22924838,22925014
4665,6,12,1,2412,-52,-92,40,40:e3:d6:da:ba:25,22925242,160,68,22925082,22925242
4666,6,6,1,2412,-52,-92,40,40:e3:d6:da:ba:26,22925461,380,-161,22925081,22925461
4667,6,12,1,2412,-88,-92,4,40:e3:d6:da:ca:c0,22936583,156,10966,22936427,22936583
4668,6,12,1,2412,-88,-92,4,40:e3:d6:da:ca:c2,22937185,176,426,22937009,22937185
4669,6,12,1,2412,-88,-92,4,40:e3:d6:da:ca:c3,22937404,180,39,22937224,22937404
4670,6,6,1,2412,-87,-92,5,40:e3:d6:da:c8:01,22941033,348,3281,22940685,22941033
4671,6,12,1,2412,-86,-92,6,40:e3:d6:da:c8:02,22941418,160,225,22941258,22941418
4672,6,12,1,2412,-87,-92,5,40:e3:d6:da:c8:03,22941631,160,53,22941471,22941631
4673,6,6,1,2412,-89,-92,3,84:d4:7e:f2:34:21,22941836,348,-143,22941488,22941836
4674,6,12,1,2412,-87,-92,5,40:e3:d6:da:c8:05,22942212,140,236,22942072,22942212
4675,6,6,1,2412,-54,-92,38,e6:aa:ea:c9:ea:33,22954635,408,12015,22954227,22954635
4676,4,1,1,2412,-88,-92,4,d6:73:9f:4c:25:bd,22960800,1128,5037,22959672,22960800
4677,4,1,1,2412,-83,-92,9,,22961945,304,841,22961641,22961945
4678,6,6,1,2412,-76,-92,16,e6:aa:ea:b7:4a:dd,22963203,408,850,22962795,22963203
4679,6,6,1,2412,-54,-92,38,e6:aa:ea:c9:ea:33,22966934,408,3323,22966526,22966934
4680,4,1,1,2412,-75,-92,17,a6:e5:7c:28:b1:d3,22968271,992,345,22967279,22968271
4681,6,6,1,2412,-76,-92,16,e6:aa:ea:b7:4a:dd,22975318,408,6639,22974910,22975318
4682,6,6,1,2412,-54,-92,38,e6:aa:ea:c9:ea:33,22978955,408,3229,22978547,22978955
4683,4,1,1,2412,-65,-92,27,54:e4:3a:ec:fb:64,22981026,2160,-89,22978866,22981026
4684,6,6,1,2412,-76,-92,16,e6:aa:ea:b7:4a:dd,22987435,408,6001,22987027,22987435
4685,6,6,1,2412,-53,-92,39,e6:aa:ea:c9:ea:33,22990979,408,3136,22990571,22990979
4686,6,6,1,2412,-76,-92,16,e6:aa:ea:b7:4a:dd,22999744,408,8357,22999336,22999744
4687,6,6,1,2412,-53,-92,39,e6:aa:ea:c9:ea:33,23003094,408,2942,23002686,23003094
4688,4,1,1,2412,-57,-92,35,b8:3a:5a:88:e6:e0,23008078,2360,2624,23005718,23008078
4689,4,1,1,2412,-76,-92,16,b8:3a:5a:88:e6:e1,23010485,2376,31,23008109,23010485
4690,6,6,1,2412,-87,-92,5,84:d4:7e:f2:34:21,23013551,368,2698,23013183,23013551
4691,6,6,1,2412,-77,-92,15,f0:b6:1e:30:eb:66,23017148,204,3393,23016944,23017148
4692,4,1,1,2412,-76,-92,16,b8:3a:5a:88:e6:e0,23017781,2240,-1607,23015541,23017781
4693,4,1,1,2412,-77,-92,15,b8:3a:5a:88:e6:e1,23020049,2256,12,23017793,23020049
4694,6,12,1,2412,-86,-92,6,40:e3:d6:da:bb:e0,23022498,156,2293,23022342,23022498
4695,6,12,1,2412,-83,-92,9,40:e3:d6:da:bb:e2,23023127,176,453,23022951,23023127
4696,6,12,1,2412,-83,-92,9,40:e3:d6:da:bb:e5,23023758,156,475,23023602,23023758
4697,6,6,1,2412,-85,-92,7,40:e3:d6:da:bb:e6,23023965,380,-173,23023585,23023965
4698,6,12,1,2412,-55,-92,37,40:e3:d6:da:ba:20,23024860,160,735,23024700,23024860
4699,6,6,1,2412,-55,-92,37,40:e3:d6:da:ba:21,23025060,368,-168,23024692,23025060
4700,6,12,1,2412,-55,-92,37,40:e3:d6:da:ba:22,23025465,180,225,23025285,23025465
4701,6,12,1,2412,-55,-92,37,40:e3:d6:da:ba:23,23025671,184,22,23025487,23025671
4702,6,12,1,2412,-55,-92,37,40:e3:d6:da:ba:24,23025880,176,33,23025704,23025880
4703,6,12,1,2412,-55,-92,37,40:e3:d6:da:ba:25,23026100,160,60,23025940,23026100
4704,6,6,1,2412,-55,-92,37,40:e3:d6:da:ba:26,23026301,380,-179,23025921,23026301
4705,4,5.5,1,2412,-75,-92,17,f0:b6:1e:30:eb:66,23028875,389,2185,23028486,23028875
4706,4,5.5,1,2412,-77,-92,15,,23029281,213,193,23029068,23029281
4707,6,12,1,2412,-55,-92,37,40:e3:d6:da:ba:20,23029347,136,-70,23029211,23029347
4708,6,6,1,2412,-55,-92,37,40:e3:d6:da:ba:21,23029542,348,-153,23029194,23029542
4709,6,12,1,2412,-55,-92,37,40:e3:d6:da:ba:23,23030135,156,437,23029979,23030135
4710,6,12,1,2412,-55,-92,37,40:e3:d6:da:ba:25,23030335,136,64,23030199,23030335
4711,4,1,1,2412,-76,-92,16,b8:3a:5a:88:e6:e0,23030976,2240,-1599,23028736,23030976
4712,6,12,1,2412,-85,-92,7,40:e3:d6:da:c8:00,23070281,160,39145,23070121,23070281
4713,4,1,1,2412,-77,-92,15,a6:e5:7c:28:b1:d3,23070642,992,-631,23069650,23070642
4714,6,12,1,2412,-86,-92,6,40:e3:d6:da:c8:05,23072223,160,1421,23072063,23072223
4715,4,1,1,2412,-72,-92,20,54:e4:3a:ec:fb:64,23083435,2160,9052,23081275,23083435
4716,4,1,1,2412,-59,-92,33,b8:3a:5a:88:e6:e0,23110480,2360,24685,23108120,23110480
4717,4,1,1,2412,-78,-92,14,b8:3a:5a:88:e6:e1,23112887,2376,31,23110511,23112887
4718,6,12,1,2412,-86,-92,6,40:e3:d6:da:bb:e3,23125126,180,12059,23124946,23125126
4719,6,12,1,2412,-86,-92,6,40:e3:d6:da:bb:e4,23125350,172,52,23125178,23125350
4720,6,12,1,2412,-86,-92,6,40:e3:d6:da:bb:e5,23125614,156,108,23125458,23125614
4721,6,12,1,2412,-52,-92,40,40:e3:d6:da:ba:20,23126536,160,762,23126376,23126536
4722,6,6,1,2412,-52,-92,40,40:e3:d6:da:ba:21,23126727,368,-177,23126359,23126727
4723,6,12,1,2412,-52,-92,40,40:e3:d6:da:ba:23,23127365,184,454,23127181,23127365
4724,6,12,1,2412,-52,-92,40,40:e3:d6:da:ba:24,23127574,176,33,23127398,23127574
4725,6,6,1,2412,-85,-92,7,84:d4:7e:f2:42:26,23128814,380,860,23128434,23128814
4726,6,6,1,2412,-88,-92,4,40:e3:d6:da:c8:06,23174196,380,45002,23173816,23174196
4727,4,1,1,2412,-70,-92,22,54:e4:3a:ec:fb:64,23185698,2160,9342,23183538,23185698
4728,4,1,1,2412,-78,-92,14,,23217452,304,31450,23217148,23217452
4729,6,6,1,2412,-86,-92,6,84:d4:7e:f2:34:26,23218885,380,1053,23218505,23218885
4730,6,12,1,2412,-85,-92,7,40:e3:d6:da:bb:e0,23225615,156,6574,23225459,23225615
4731,6,6,1,2412,-86,-92,6,40:e3:d6:da:bb:e1,23225802,368,-181,23225434,23225802
4732,6,12,1,2412,-85,-92,7,40:e3:d6:da:bb:e2,23226207,176,229,23226031,23226207
4733,6,12,1,2412,-87,-92,5,40:e3:d6:da:bb:e3,23226409,180,22,23226229,23226409
4734,6,12,1,2412,-86,-92,6,40:e3:d6:da:bb:e4,23226633,172,52,23226461,23226633
4735,6,12,1,2412,-87,-92,5,40:e3:d6:da:bb:e5,23226839,156,50,23226683,23226839
4736,6,12,1,2412,-54,-92,38,40:e3:d6:da:ba:20,23228934,160,1935,23228774,23228934
4737,6,6,1,2412,-54,-92,38,40:e3:d6:da:ba:21,23229144,368,-158,23228776,23229144
4738,6,12,1,2412,-54,-92,38,40:e3:d6:da:ba:22,23229540,180,216,23229360,23229540
4739,6,12,1,2412,-54,-92,38,40:e3:d6:da:ba:23,23229745,184,21,23229561,23229745
4740,6,12,1,2412,-54,-92,38,40:e3:d6:da:ba:24,23229973,176,52,23229797,23229973
4741,6,12,1,2412,-54,-92,38,40:e3:d6:da:ba:25,23230183,160,50,23230023,23230183
4742,6,6,1,2412,-54,-92,38,40:e3:d6:da:ba:26,23230384,380,-179,23230004,23230384
4743,6,12,1,2412,-84,-92,8,84:d4:7e:f2:42:25,23230956,160,412,23230796,23230956
4744,6,6,1,2412,-86,-92,6,84:d4:7e:f2:42:26,23231147,380,-189,23230767,23231147
4745,4,1,1,2412,-82,-92,10,,23236619,304,5168,23236315,23236619
4746,6,6,1,2412,-86,-92,6,40:e3:d6:da:ca:c1,23244305,368,7318,23243937,23244305
4747,6,12,1,2412,-88,-92,4,40:e3:d6:da:ca:c5,23245396,156,935,23245240,23245396
4748,6,6,1,2412,-59,-92,33,e6:aa:ea:c9:ea:33,23270005,408,24201,23269597,23270005
4749,6,12,1,2412,-87,-92,5,40:e3:d6:da:c8:03,23275913,184,5724,23275729,23275913
4750,6,12,1,2412,-87,-92,5,40:e3:d6:da:c8:04,23276140,176,51,23275964,23276140
4751,6,12,1,2412,-89,-92,3,40:e3:d6:da:c8:05,23276360,160,60,23276200,23276360
4752,6,6,1,2412,-59,-92,33,e6:aa:ea:c9:ea:33,23282116,408,5348,23281708,23282116
4753,4,1,1,2412,-72,-92,20,54:e4:3a:ec:fb:64,23288440,2160,4164,23286280,23288440
4754,4,1,1,2412,-79,-92,13,b8:3a:5a:88:e6:e0,23315385,2360,24585,23313025,23315385
4755,6,12,1,2412,-86,-92,6,84:d4:7e:f2:34:25,23320666,160,5121,23320506,23320666
4756,6,12,1,2412,-84,-92,8,40:e3:d6:da:bb:e3,23328851,180,8005,23328671,23328851
4757,6,12,1,2412,-54,-92,38,40:e3:d6:da:ba:20,23331315,160,2304,23331155,23331315
4758,6,6,1,2412,-54,-92,38,40:e3:d6:da:ba:21,23331507,368,-176,23331139,23331507
4759,6,12,1,2412,-54,-92,38,40:e3:d6:da:ba:22,23331903,180,216,23331723,23331903
4760,6,12,1,2412,-54,-92,38,40:e3:d6:da:ba:23,23332126,184,39,23331942,23332126
4761,6,12,1,2412,-54,-92,38,40:e3:d6:da:ba:24,23332336,176,34,23332160,23332336
4762,6,12,1,2412,-54,-92,38,40:e3:d6:da:ba:25,23332546,160,50,23332386,23332546
4763,6,6,1,2412,-54,-92,38,40:e3:d6:da:ba:26,23332738,380,-188,23332358,23332738
4764,6,12,1,2412,-88,-92,4,84:d4:7e:f2:42:25,23333386,160,488,23333226,23333386
4765,6,12,1,2412,-85,-92,7,40:e3:d6:da:ca:c3,23347018,180,13452,23346838,23347018
4766,6,12,1,2412,-85,-92,7,40:e3:d6:da:ca:c4,23347251,172,61,23347079,23347251
4767,6,6,1,2412,-87,-92,5,40:e3:d6:da:ca:c6,23347672,380,41,23347292,23347672
4768,6,6,1,2412,-88,-92,4,e6:aa:ea:c9:ea:1b,23368815,408,20735,23368407,23368815
4769,6,6,1,2412,-87,-92,5,e6:aa:ea:c9:ea:1b,23380824,408,11601,23380416,23380824
4770,4,1,1,2412,-77,-92,15,b8:3a:5a:88:e6:e0,23417680,2360,34496,23415320,23417680
4771,6,12,1,2412,-83,-92,9,84:d4:7e:f2:34:23,23423149,180,5289,23422969,23423149
4772,6,6,1,2412,-88,-92,4,40:e3:d6:da:bb:e1,23430631,368,7114,23430263,23430631
4773,6,12,1,2412,-89,-92,3,40:e3:d6:da:bb:e2,23431018,176,211,23430842,23431018
4774,6,12,1,2412,-55,-92,37,40:e3:d6:da:ba:20,23433728,160,2550,23433568,23433728
4775,6,12,1,2412,-55,-92,37,40:e3:d6:da:ba:22,23434343,180,435,23434163,23434343
4776,6,12,1,2412,-54,-92,38,40:e3:d6:da:ba:23,23434557,184,30,23434373,23434557
4777,6,12,1,2412,-55,-92,37,40:e3:d6:da:ba:24,23434767,176,34,23434591,23434767
4778,6,12,1,2412,-54,-92,38,40:e3:d6:da:ba:25,23434995,160,68,23434835,23434995
4779,6,6,1,2412,-54,-92,38,40:e3:d6:da:ba:26,23435196,380,-179,23434816,23435196
4780,6,12,1,2412,-88,-92,4,84:d4:7e:f2:42:24,23435602,176,230,23435426,23435602
4781,6,12,1,2412,-89,-92,3,84:d4:7e:f2:42:25,23435831,160,69,23435671,23435831
4782,6,6,1,2412,-87,-92,5,84:d4:7e:f2:42:26,23436022,380,-189,23435642,23436022
4783,4,1,1,2412,-62,-92,30,b8:3a:5a:88:e6:e0,23445849,2240,7587,23443609,23445849
4784,4,1,1,2412,-71,-92,21,a6:e5:7c:28:b1:d3,23453000,944,6207,23452056,23453000
4785,4,1,1,2412,-73,-92,19,a6:e5:7c:28:b1:d3,23454087,944,143,23453143,23454087
4786,4,1,1,2412,-75,-92,17,a6:e5:7c:28:b1:d3,23455116,944,85,23454172,23455116
4787,4,1,1,2412,-73,-92,19,a6:e5:7c:28:b1:d3,23456194,944,134,23455250,23456194
4788,4,1,1,2412,-71,-92,21,a6:e5:7c:28:b1:d3,23457254,944,116,23456310,23457254
4789,4,1,1,2412,-73,-92,19,a6:e5:7c:28:b1:d3,23458341,944,143,23457397,23458341
4790,4,1,1,2412,-73,-92,19,a6:e5:7c:28:b1:d3,23461793,944,2508,23460849,23461793
4791,4,1,1,2412,-74,-92,18,a6:e5:7c:28:b1:d3,23462889,944,152,23461945,23462889
4792,4,1,1,2412,-77,-92,15,b8:3a:5a:88:e6:e0,23466783,2240,1654,23464543,23466783
4793,4,1,1,2412,-73,-92,19,a6:e5:7c:28:b1:d3,23479976,992,12201,23478984,23479976
4794,4,1,1,2412,-67,-92,25,54:e4:3a:ec:fb:64,23493080,2160,10944,23490920,23493080
4795,6,6,1,2412,-74,-92,18,e6:aa:ea:b7:4a:dd,23496618,408,3130,23496210,23496618
4796,4,1,1,2412,-78,-92,14,b8:3a:5a:88:e6:e1,23523580,2376,24586,23521204,23523580
4797,6,12,1,2412,-83,-92,9,,23531228,44,7604,23531184,23531228
4798,6,12,1,2412,-84,-92,8,,23531346,32,86,23531314,23531346
4799,6,12,1,2412,-87,-92,5,40:e3:d6:da:ca:c5,23531966,136,484,23531830,23531966
4800,6,6,1,2412,-74,-92,18,e6:aa:ea:b7:4a:dd,23532974,408,600,23532566,23532974
4801,6,12,1,2412,-86,-92,6,40:e3:d6:da:bb:e4,23533828,172,682,23533656,23533828
4802,6,12,1,2412,-53,-92,39,40:e3:d6:da:ba:20,23536142,160,2154,23535982,23536142
4803,6,6,1,2412,-53,-92,39,40:e3:d6:da:ba:21,23536361,368,-149,23535993,23536361
4804,6,12,1,2412,-53,-92,39,40:e3:d6:da:ba:22,23536748,180,207,23536568,23536748
4805,6,12,1,2412,-53,-92,39,40:e3:d6:da:ba:23,23536962,184,30,23536778,23536962
4806,6,12,1,2412,-53,-92,39,40:e3:d6:da:ba:24,23537172,176,34,23536996,23537172
4807,6,12,1,2412,-54,-92,38,40:e3:d6:da:ba:25,23537373,160,41,23537213,23537373
4808,6,12,1,2412,-86,-92,6,84:d4:7e:f2:42:24,23537962,176,413,23537786,23537962
4809,6,12,1,2412,-80,-92,12,,23543513,32,5519,23543481,23543513
4810,6,6,1,2412,-83,-92,9,,23546154,44,2597,23546110,23546154
4811,6,12,1,2412,-85,-92,7,,23546266,32,80,23546234,23546266
4812,6,12,1,2412,-88,-92,4,40:e3:d6:da:ca:c0,23550982,156,4560,23550826,23550982
4813,6,6,1,2412,-86,-92,6,40:e3:d6:da:ca:c1,23551170,368,-180,23550802,23551170
4814,6,12,1,2412,-87,-92,5,40:e3:d6:da:ca:c3,23551785,180,435,23551605,23551785
4815,6,6,1,2412,-88,-92,4,40:e3:d6:da:ca:c6,23552421,380,256,23552041,23552421
4816,6,12,1,2412,-84,-92,8,,23552986,32,533,23552954,23552986
4817,6,12,1,2412,-84,-92,8,,23556891,32,3873,23556859,23556891
4818,6,12,1,2412,-82,-92,10,,23561875,32,4952,23561843,23561875
4819,6,12,1,2412,-84,-92,8,,23561981,32,74,23561949,23561981
4820,6,12,1,2412,-84,-92,8,,23564098,32,2085,23564066,23564098
4821,6,6,1,2412,-87,-92,5,40:e3:d6:da:c8:01,23582488,368,18022,23582120,23582488
4822,6,12,1,2412,-84,-92,8,40:e3:d6:da:c8:02,23582875,180,207,23582695,23582875
4823,4,1,1,2412,-80,-92,12,b8:3a:5a:88:e6:e0,23622480,2360,37245,23620120,23622480
4824,6,12,1,2412,-84,-92,8,84:d4:7e:f2:34:22,23627144,180,4484,23626964,23627144
4825,6,12,1,2412,-85,-92,7,84:d4:7e:f2:34:23,23627440,180,116,23627260,23627440
4826,6,12,1,2412,-84,-92,8,84:d4:7e:f2:34:24,23627655,176,39,23627479,23627655
4827,6,12,1,2412,-85,-92,7,84:d4:7e:f2:34:25,23627865,160,50,23627705,23627865
4828,6,6,1,2412,-85,-92,7,84:d4:7e:f2:34:26,23628084,380,-161,23627704,23628084
4829,6,6,1,2412,-88,-92,4,40:e3:d6:da:bb:e1,23635673,368,7221,23635305,23635673
4830,6,12,1,2412,-87,-92,5,40:e3:d6:da:bb:e2,23636069,176,220,23635893,23636069
4831,6,12,1,2412,-88,-92,4,40:e3:d6:da:bb:e4,23636494,172,253,23636322,23636494
4832,6,12,1,2412,-56,-92,36,40:e3:d6:da:ba:20,23639153,160,2499,23638993,23639153
4833,6,6,1,2412,-56,-92,36,40:e3:d6:da:ba:21,23639362,368,-159,23638994,23639362
4834,6,12,1,2412,-56,-92,36,40:e3:d6:da:ba:23,23640005,184,459,23639821,23640005
4835,6,12,1,2412,-56,-92,36,40:e3:d6:da:ba:24,23640223,176,42,23640047,23640223
4836,6,12,1,2412,-56,-92,36,40:e3:d6:da:ba:25,23640452,160,69,23640292,23640452
4837,6,6,1,2412,-56,-92,36,40:e3:d6:da:ba:26,23640652,380,-180,23640272,23640652
4838,6,12,1,2412,-87,-92,5,40:e3:d6:da:ca:c0,23653395,156,12587,23653239,23653395
4839,6,6,1,2412,-87,-92,5,40:e3:d6:da:ca:c1,23653583,368,-180,23653215,23653583
4840,6,12,1,2412,-86,-92,6,40:e3:d6:da:ca:c2,23653988,176,229,23653812,23653988
4841,6,12,1,2412,-87,-92,5,40:e3:d6:da:ca:c3,23654190,180,22,23654010,23654190
4842,6,12,1,2412,-88,-92,4,40:e3:d6:da:ca:c4,23654394,172,32,23654222,23654394
4843,6,12,1,2412,-85,-92,7,40:e3:d6:da:ca:c5,23654619,156,69,23654463,23654619
4844,6,12,1,2412,-86,-92,6,,23658684,32,4033,23658652,23658684
4845,6,12,1,2412,-87,-92,5,,23660430,32,1714,23660398,23660430
4846,6,12,1,2412,-86,-92,6,,23661627,32,1165,23661595,23661627
4847,6,12,1,2412,-87,-92,5,,23672706,32,11047,23672674,23672706
4848,6,12,1,2412,-83,-92,9,40:e3:d6:da:c8:02,23685341,180,12455,23685161,23685341
4849,6,12,1,2412,-86,-92,6,40:e3:d6:da:c8:05,23686004,160,503,23685844,23686004
4850,6,6,1,2412,-86,-92,6,40:e3:d6:da:c8:06,23686214,380,-170,23685834,23686214
4851,6,6,1,2412,-49,-92,43,e6:aa:ea:c9:ea:33,23687262,408,640,23686854,23687262
4852,6,6,1,2412,-86,-92,6,66:d8:ff:ae:5d:41,23689888,64,2562,23689824,23689888
4853,6,6,1,2412,-86,-92,6,66:d8:ff:ae:5d:41,23690032,64,80,23689968,23690032
4854,6,6,1,2412,-86,-92,6,,23690113,44,37,23690069,23690113
4855,6,6,1,2412,-49,-92,43,e6:aa:ea:c9:ea:33,23711368,408,20847,23710960,23711368
4856,6,6,1,2412,-49,-92,43,e6:aa:ea:c9:ea:33,23723461,408,11685,23723053,23723461
4857,4,1,1,2412,-80,-92,12,b8:3a:5a:88:e6:e1,23727297,2376,1460,23724921,23727297
4858,6,12,1,2412,-88,-92,4,84:d4:7e:f2:34:20,23729956,160,2499,23729796,23729956
4859,6,6,1,2412,-87,-92,5,84:d4:7e:f2:34:21,23730148,368,-176,23729780,23730148
4860,6,12,1,2412,-89,-92,3,84:d4:7e:f2:34:22,23730561,180,233,23730381,23730561
4861,6,12,1,2412,-88,-92,4,84:d4:7e:f2:34:23,23730767,180,26,23730587,23730767
4862,6,12,1,2412,-87,-92,5,84:d4:7e:f2:34:24,23730972,176,29,23730796,23730972
4863,6,12,1,2412,-88,-92,4,84:d4:7e:f2:34:25,23731183,160,51,23731023,23731183
4864,6,6,1,2412,-88,-92,4,84:d4:7e:f2:34:26,23731553,380,-10,23731173,23731553
4865,6,12,1,2412,-87,-92,5,,23734575,32,2990,23734543,23734575
4866,6,6,1,2412,-49,-92,43,e6:aa:ea:c9:ea:33,23735558,408,575,23735150,23735558
4867,6,6,1,2412,-88,-92,4,40:e3:d6:da:bb:e1,23737833,368,1907,23737465,23737833
4868,6,12,1,2412,-57,-92,35,40:e3:d6:da:ba:20,23740972,160,2979,23740812,23740972
4869,6,6,1,2412,-57,-92,35,40:e3:d6:da:ba:21,23741164,368,-176,23740796,23741164
4870,6,12,1,2412,-56,-92,36,40:e3:d6:da:ba:22,23741569,180,225,23741389,23741569
4871,6,12,1,2412,-56,-92,36,40:e3:d6:da:ba:23,23741802,184,49,23741618,23741802
4872,6,12,1,2412,-57,-92,35,40:e3:d6:da:ba:24,23742011,176,33,23741835,23742011
4873,6,12,1,2412,-57,-92,35,40:e3:d6:da:ba:25,23742230,160,59,23742070,23742230
4874,6,6,1,2412,-56,-92,36,40:e3:d6:da:ba:26,23742431,380,-179,23742051,23742431
4875,6,12,1,2412,-86,-92,6,84:d4:7e:f2:42:25,23742949,160,358,23742789,23742949
4876,6,6,1,2412,-87,-92,5,84:d4:7e:f2:42:26,23743140,380,-189,23742760,23743140
4877,6,12,1,2412,-86,-92,6,40:e3:d6:da:ca:c0,23755800,156,12504,23755644,23755800
4878,6,6,1,2412,-87,-92,5,40:e3:d6:da:ca:c1,23756006,368,-162,23755638,23756006
4879,6,12,1,2412,-86,-92,6,40:e3:d6:da:ca:c2,23756402,176,220,23756226,23756402
4880,6,6,1,2412,-84,-92,8,a8:5b:f7:55:1a:40,23759896,72,3422,23759824,23759896
4881,6,6,1,2412,-87,-92,5,a8:5b:f7:55:1a:40,23760496,72,528,23760424,23760496
4882,6,6,1,2412,-87,-92,5,a8:5b:f7:55:1a:40,23761259,72,691,23761187,23761259
4883,6,12,1,2412,-86,-92,6,40:e3:d6:da:ca:c2,23792952,156,31537,23792796,23792952
4884,6,12,1,2412,-87,-92,5,40:e3:d6:da:ca:c3,23793151,156,43,23792995,23793151
4885,6,12,1,2412,-87,-92,5,40:e3:d6:da:ca:c5,23793369,136,82,23793233,23793369
4886,4,1,1,2412,-72,-92,20,54:e4:3a:ec:fb:64,23799918,2160,4389,23797758,23799918
4887,4,1,1,2412,-84,-92,8,,23812670,304,12448,23812366,23812670
4888,6,12,1,2412,-87,-92,5,40:e3:d6:da:ca:c2,23814421,156,1595,23814265,23814421
4889,6,6,1,2412,-87,-92,5,e6:aa:ea:c9:ea:1b,23825077,408,10248,23824669,23825077
4890,4,1,1,2412,-79,-92,13,b8:3a:5a:88:e6:e0,23827598,2360,161,23825238,23827598
4891,6,12,1,2412,-90,-92,2,84:d4:7e:f2:34:20,23831351,160,3593,23831191,23831351
4892,6,6,1,2412,-89,-92,3,84:d4:7e:f2:34:21,23831560,368,-159,23831192,23831560
4893,6,12,1,2412,-89,-92,3,84:d4:7e:f2:34:23,23832162,180,422,23831982,23832162
4894,6,6,1,2412,-82,-92,10,,23835354,44,3148,23835310,23835354
4895,6,12,1,2412,-56,-92,36,40:e3:d6:da:ba:20,23843327,160,7813,23843167,23843327
4896,6,6,1,2412,-56,-92,36,40:e3:d6:da:ba:21,23843537,368,-158,23843169,23843537
4897,6,12,1,2412,-56,-92,36,40:e3:d6:da:ba:22,23843924,180,207,23843744,23843924
4898,6,12,1,2412,-56,-92,36,40:e3:d6:da:ba:23,23844138,184,30,23843954,23844138
4899,6,12,1,2412,-56,-92,36,40:e3:d6:da:ba:24,23844442,176,128,23844266,23844442
4900,6,12,1,2412,-56,-92,36,40:e3:d6:da:ba:25,23844652,160,50,23844492,23844652
4901,6,6,1,2412,-56,-92,36,40:e3:d6:da:ba:26,23844871,380,-161,23844491,23844871
4902,6,6,1,2412,-82,-92,10,,23847024,44,2109,23846980,23847024
4903,6,6,1,2412,-85,-92,7,40:e3:d6:da:ca:c1,23858413,368,11021,23858045,23858413
4904,6,12,1,2412,-84,-92,8,40:e3:d6:da:ca:c4,23859225,172,640,23859053,23859225
4905,6,6,1,2412,-81,-92,11,,23881047,44,21778,23881003,23881047
4906,6,6,1,2412,-80,-92,12,,23881764,44,673,23881720,23881764
4907,6,12,1,2412,-86,-92,6,40:e3:d6:da:c8:03,23897672,184,15724,23897488,23897672
4908,6,12,1,2412,-87,-92,5,40:e3:d6:da:c8:05,23898118,160,286,23897958,23898118
4909,6,6,1,2412,-87,-92,5,40:e3:d6:da:c8:06,23898319,380,-179,23897939,23898319
4910,4,1,1,2412,-71,-92,21,54:e4:3a:ec:fb:64,23902658,2160,2179,23900498,23902658
4911,4,1,1,2412,-78,-92,14,c0:c9:e3:4d:6e:bf,23912031,872,8501,23911159,23912031
4912,4,1,1,2412,-84,-92,8,,23912921,304,586,23912617,23912921
4913,4,1,1,2412,-65,-92,27,b8:3a:5a:88:e6:e0,23929705,2360,14424,23927345,23929705
4914,4,1,1,2412,-80,-92,12,b8:3a:5a:88:e6:e1,23933237,2376,1156,23930861,23933237
4915,6,12,1,2412,-88,-92,4,40:e3:d6:da:bb:e0,23942403,156,9010,23942247,23942403
4916,6,6,1,2412,-87,-92,5,40:e3:d6:da:bb:e1,23942591,368,-180,23942223,23942591
4917,6,12,1,2412,-87,-92,5,40:e3:d6:da:bb:e2,23942996,176,229,23942820,23942996
4918,6,12,1,2412,-88,-92,4,40:e3:d6:da:bb:e4,23943439,172,271,23943267,23943439
4919,6,12,1,2412,-89,-92,3,40:e3:d6:da:bb:e5,23943655,156,60,23943499,23943655
4920,6,6,1,2412,-87,-92,5,40:e3:d6:da:bb:e6,23943852,380,-183,23943472,23943852
4921,6,12,1,2412,-55,-92,37,40:e3:d6:da:ba:20,23945724,160,1712,23945564,23945724
4922,6,6,1,2412,-55,-92,37,40:e3:d6:da:ba:21,23945934,368,-158,23945566,23945934
4923,6,12,1,2412,-55,-92,37,40:e3:d6:da:ba:22,23946339,180,225,23946159,23946339
4924,6,12,1,2412,-55,-92,37,40:e3:d6:da:ba:23,23946572,184,49,23946388,23946572
4925,6,12,1,2412,-55,-92,37,40:e3:d6:da:ba:24,23946781,176,33,23946605,23946781
4926,6,12,1,2412,-55,-92,37,40:e3:d6:da:ba:25,23947009,160,68,23946849,23947009
4927,6,6,1,2412,-55,-92,37,40:e3:d6:da:ba:26,23947219,380,-170,23946839,23947219
4928,6,12,1,2412,-85,-92,7,84:d4:7e:f2:42:25,23947766,160,387,23947606,23947766
4929,6,6,1,2412,-88,-92,4,84:d4:7e:f2:42:26,23947985,380,-161,23947605,23947985
4930,6,6,1,2412,-88,-92,4,,23959189,44,11160,23959145,23959189
4931,6,6,1,2412,-87,-92,5,,23959808,44,575,23959764,23959808
4932,6,12,1,2412,-86,-92,6,40:e3:d6:da:ca:c2,23961208,176,1224,23961032,23961208
4933,6,12,1,2412,-88,-92,4,40:e3:d6:da:ca:c3,23961436,180,48,23961256,23961436
4934,4,1,1,2412,-73,-92,19,54:e4:3a:ec:fb:64,23979735,2112,16187,23977623,23979735
4935,4,1,1,2412,-87,-92,5,,23981860,304,1821,23981556,23981860
4936,6,12,1,2412,-82,-92,10,,23982975,32,1083,23982943,23982975
4937,6,12,1,2412,-82,-92,10,,23983245,32,238,23983213,23983245
4938,6,6,1,2412,-50,-92,42,e6:aa:ea:c9:ea:33,24003103,408,19450,24002695,24003103
4939,6,6,1,2412,-51,-92,41,e6:aa:ea:c9:ea:33,24015221,408,11710,24014813,24015221
4940,6,6,1,2412,-78,-92,14,e6:aa:ea:b7:4a:dd,24016898,408,1269,24016490,24016898
4941,6,6,1,2412,-79,-92,13,e6:aa:ea:b7:4a:dd,24029393,408,12087,24028985,24029393
4942,4,1,1,2412,-80,-92,12,b8:3a:5a:88:e6:e1,24034477,2376,2708,24032101,24034477
4943,6,6,1,2412,-89,-92,3,84:d4:7e:f2:34:21,24036734,368,1889,24036366,24036734
4944,6,6,1,2412,-51,-92,41,e6:aa:ea:c9:ea:33,24039447,408,2305,24039039,24039447
4945,6,6,1,2412,-79,-92,13,e6:aa:ea:b7:4a:dd,24041133,408,1278,24040725,24041133
4946,6,6,1,2412,-89,-92,3,40:e3:d6:da:bb:e1,24045007,368,3506,24044639,24045007
4947,6,12,1,2412,-55,-92,37,40:e3:d6:da:ba:20,24048117,160,2950,24047957,24048117
4948,6,6,1,2412,-55,-92,37,40:e3:d6:da:ba:21,24048318,368,-167,24047950,24048318
4949,6,12,1,2412,-55,-92,37,40:e3:d6:da:ba:22,24048705,180,207,24048525,24048705
4950,6,12,1,2412,-55,-92,37,40:e3:d6:da:ba:23,24048910,184,21,24048726,24048910
4951,6,12,1,2412,-54,-92,38,40:e3:d6:da:ba:24,24049119,176,33,24048943,24049119
4952,6,12,1,2412,-55,-92,37,40:e3:d6:da:ba:25,24049321,160,42,24049161,24049321
4953,6,6,1,2412,-54,-92,38,40:e3:d6:da:ba:26,24049513,380,-188,24049133,24049513
4954,6,12,1,2412,-87,-92,5,84:d4:7e:f2:42:24,24049991,176,302,24049815,24049991
4955,6,12,1,2412,-88,-92,4,84:d4:7e:f2:42:25,24050211,160,60,24050051,24050211
4956,6,6,1,2412,-85,-92,7,84:d4:7e:f2:42:26,24050412,380,-179,24050032,24050412
4957,6,6,1,2412,-51,-92,41,e6:aa:ea:c9:ea:33,24051561,408,741,24051153,24051561
4958,6,12,1,2412,-87,-92,5,40:e3:d6:da:ca:c0,24062995,156,11278,24062839,24062995
4959,6,6,1,2412,-87,-92,5,40:e3:d6:da:ca:c1,24063210,368,-153,24062842,24063210
4960,6,12,1,2412,-82,-92,10,40:e3:d6:da:ca:c2,24063624,176,238,24063448,24063624
4961,6,6,1,2412,-86,-92,6,40:e3:d6:da:ca:c6,24064434,380,430,24064054,24064434
4962,6,6,1,2412,-87,-92,5,e6:aa:ea:c9:ea:1b,24093852,408,29010,24093444,24093852
4963,6,12,1,2412,-85,-92,7,40:e3:d6:da:c8:00,24094289,160,277,24094129,24094289
4964,6,6,1,2412,-87,-92,5,40:e3:d6:da:c8:01,24094499,368,-158,24094131,24094499
4965,6,12,1,2412,-85,-92,7,40:e3:d6:da:c8:02,24094953,180,274,24094773,24094953
4966,6,6,1,2412,-87,-92,5,e6:aa:ea:c9:ea:1b,24105986,408,10625,24105578,24105986
4967,4,1,1,2412,-72,-92,20,54:e4:3a:ec:fb:64,24107195,2160,-951,24105035,24107195
4968,6,6,1,2412,-81,-92,11,e6:aa:ea:c9:ea:1b,24130193,408,22590,24129785,24130193
4969,4,1,1,2412,-79,-92,13,b8:3a:5a:88:e6:e0,24134491,2360,1938,24132131,24134491
4970,6,6,1,2412,-86,-92,6,e6:aa:ea:c9:ea:1b,24142321,408,7422,24141913,24142321
4971,6,12,1,2412,-55,-92,37,40:e3:d6:da:ba:20,24150522,160,8041,24150362,24150522
4972,6,6,1,2412,-55,-92,37,40:e3:d6:da:ba:21,24150741,368,-149,24150373,24150741
4973,6,12,1,2412,-55,-92,37,40:e3:d6:da:ba:22,24151137,180,216,24150957,24151137
4974,6,12,1,2412,-55,-92,37,40:e3:d6:da:ba:23,24151369,184,48,24151185,24151369
4975,6,12,1,2412,-55,-92,37,40:e3:d6:da:ba:24,24151606,176,61,24151430,24151606
4976,6,12,1,2412,-55,-92,37,40:e3:d6:da:ba:25,24151903,160,137,24151743,24151903
4977,6,6,1,2412,-55,-92,37,40:e3:d6:da:ba:26,24152104,380,-179,24151724,24152104
4978,6,12,1,2412,-86,-92,6,84:d4:7e:f2:42:25,24152601,160,337,24152441,24152601
4979,6,12,1,2412,-86,-92,6,40:e3:d6:da:ca:c0,24165397,156,12640,24165241,24165397
4980,4,1,1,2412,-71,-92,21,54:e4:3a:ec:fb:64,24209782,2160,42225,24207622,24209782
4981,4,1,1,2412,-77,-92,15,b8:3a:5a:88:e6:e0,24236882,2360,24740,24234522,24236882
4982,6,12,1,2412,-85,-92,7,84:d4:7e:f2:34:25,24243082,160,6040,24242922,24243082
4983,6,12,1,2412,-87,-92,5,40:e3:d6:da:bb:e0,24249624,156,6386,24249468,24249624
4984,6,6,1,2412,-88,-92,4,40:e3:d6:da:bb:e1,24249822,368,-170,24249454,24249822
4985,6,12,1,2412,-54,-92,38,40:e3:d6:da:ba:20,24252940,160,2958,24252780,24252940
4986,6,6,1,2412,-54,-92,38,40:e3:d6:da:ba:21,24253159,368,-149,24252791,24253159
4987,6,12,1,2412,-54,-92,38,40:e3:d6:da:ba:22,24253546,180,207,24253366,24253546
4988,6,12,1,2412,-54,-92,38,40:e3:d6:da:ba:23,24253770,184,40,24253586,24253770
4989,6,12,1,2412,-54,-92,38,40:e3:d6:da:ba:25,24254208,160,278,24254048,24254208
4990,6,6,1,2412,-54,-92,38,40:e3:d6:da:ba:26,24254400,380,-188,24254020,24254400
4991,6,6,1,2412,-88,-92,4,40:e3:d6:da:ca:c1,24268002,368,13234,24267634,24268002
4992,6,12,1,2412,-87,-92,5,40:e3:d6:da:ca:c2,24268417,176,239,24268241,24268417
4993,6,12,1,2412,-86,-92,6,40:e3:d6:da:ca:c3,24268636,180,39,24268456,24268636
4994,6,12,1,2412,-87,-92,5,40:e3:d6:da:ca:c5,24269047,156,255,24268891,24269047
4995,6,6,1,2412,-85,-92,7,40:e3:d6:da:ca:c6,24269236,380,-191,24268856,24269236
4996,6,12,1,2412,-87,-92,5,40:e3:d6:da:c8:00,24299076,160,29680,24298916,24299076
4997,6,12,1,2412,-89,-92,3,40:e3:d6:da:c8:03,24299956,184,696,24299772,24299956
4998,6,12,1,2412,-87,-92,5,40:e3:d6:da:c8:04,24300175,176,43,24299999,24300175
4999,6,12,1,2412,-88,-92,4,40:e3:d6:da:c8:05,24300404,160,69,24300244,24300404
5000,4,1,1,2412,-73,-92,19,a6:e5:7c:28:b1:d3,24302005,992,609,24301013,24302005
5001,4,1,1,2412,-68,-92,24,54:e4:3a:ec:fb:64,24312266,2160,8101,24310106,24312266
5002,6,6,1,2412,-76,-92,16,e6:aa:ea:b7:4a:dd,24319221,408,6547,24318813,24319221
5003,6,6,1,2412,-75,-92,17,e6:aa:ea:b7:4a:dd,24331333,408,11704,24330925,24331333
5004,4,1,1,2412,-78,-92,14,b8:3a:5a:88:e6:e0,24339309,2360,5616,24336949,24339309
5005,4,1,1,2412,-77,-92,15,b8:3a:5a:88:e6:e1,24341715,2376,30,24339339,24341715
5006,6,12,1,2412,-86,-92,6,84:d4:7e:f2:34:20,24344266,160,2391,24344106,24344266
5007,6,12,1,2412,-87,-92,5,84:d4:7e:f2:34:22,24344863,180,417,24344683,24344863
5008,6,12,1,2412,-85,-92,7,84:d4:7e:f2:34:23,24345068,180,25,24344888,24345068
5009,6,12,1,2412,-86,-92,6,84:d4:7e:f2:34:24,24345274,176,30,24345098,24345274
5010,6,12,1,2412,-89,-92,3,40:e3:d6:da:bb:e2,24352605,176,7155,24352429,24352605
5011,6,6,1,2412,-54,-92,38,40:e3:d6:da:ba:21,24355563,368,2590,24355195,24355563
5012,6,12,1,2412,-54,-92,38,40:e3:d6:da:ba:22,24355950,180,207,24355770,24355950
5013,6,12,1,2412,-54,-92,38,40:e3:d6:da:ba:23,24356156,184,22,24355972,24356156
5014,6,12,1,2412,-54,-92,38,40:e3:d6:da:ba:24,24356383,176,51,24356207,24356383
5015,6,12,1,2412,-54,-92,38,40:e3:d6:da:ba:25,24357027,160,484,24356867,24357027
5016,4,1,1,2412,-74,-92,18,a4:e5:7c:28:b1:d3,24366991,688,9276,24366303,24366991
5017,6,6,1,2412,-74,-92,18,e6:aa:ea:b7:4a:dd,24367703,408,304,24367295,24367703
5018,6,12,1,2412,-86,-92,6,40:e3:d6:da:ca:c0,24370179,156,2320,24370023,24370179
5019,6,6,1,2412,-86,-92,6,40:e3:d6:da:ca:c1,24370386,368,-161,24370018,24370386
5020,6,12,1,2412,-87,-92,5,40:e3:d6:da:ca:c2,24370799,176,237,24370623,24370799
5021,6,12,1,2412,-88,-92,4,40:e3:d6:da:ca:c3,24371019,180,40,24370839,24371019
5022,6,12,1,2412,-85,-92,7,40:e3:d6:da:ca:c4,24371233,172,42,24371061,24371233
5023,6,12,1,2412,-88,-92,4,40:e3:d6:da:ca:c5,24371458,156,69,24371302,24371458
5024,6,6,1,2412,-87,-92,5,40:e3:d6:da:ca:c6,24371655,380,-183,24371275,24371655
5025,4,1,1,2412,-74,-92,18,a6:e5:7c:28:b1:d3,24401208,992,28561,24400216,24401208
5026,4,1,1,2412,-76,-92,16,c0:c9:e3:4d:6e:bf,24402855,872,775,24401983,24402855
5027,4,1,1,2412,-75,-92,17,,24403744,304,585,24403440,24403744
5028,6,12,1,2412,-89,-92,3,40:e3:d6:da:c8:03,24403933,184,5,24403749,24403933
5029,6,12,1,2412,-81,-92,11,40:e3:d6:da:c8:04,24404151,176,42,24403975,24404151
5030,6,6,1,2412,-84,-92,8,84:1b:5e:df:1b:99,24416723,80,12492,24416643,24416723
5031,6,6,1,2412,-83,-92,9,,24416823,44,56,24416779,24416823
5032,4,1,1,2412,-79,-92,13,b8:3a:5a:88:e6:e0,24441694,2360,22511,24439334,24441694
5033,6,12,1,2412,-87,-92,5,84:d4:7e:f2:34:20,24447607,160,5753,24447447,24447607
5034,6,6,1,2412,-88,-92,4,84:d4:7e:f2:34:21,24447808,368,-167,24447440,24447808
5035,6,12,1,2412,-88,-92,4,84:d4:7e:f2:34:22,24448204,180,216,24448024,24448204
5036,6,12,1,2412,-87,-92,5,84:d4:7e:f2:34:24,24448633,176,253,24448457,24448633
5037,6,6,1,2412,-87,-92,5,84:d4:7e:f2:34:26,24449071,380,58,24448691,24449071
5038,4,1,1,2412,-75,-92,17,,24450536,304,1161,24450232,24450536
5039,6,12,1,2412,-87,-92,5,40:e3:d6:da:bb:e3,24455182,180,4466,24455002,24455182
5040,6,12,1,2412,-88,-92,4,40:e3:d6:da:bb:e4,24455387,172,33,24455215,24455387
5041,6,12,1,2412,-85,-92,7,40:e3:d6:da:bb:e5,24455585,156,42,24455429,24455585
5042,6,12,1,2412,-55,-92,37,40:e3:d6:da:ba:20,24457732,160,1987,24457572,24457732
5043,6,6,1,2412,-55,-92,37,40:e3:d6:da:ba:21,24457951,368,-149,24457583,24457951
5044,6,12,1,2412,-55,-92,37,40:e3:d6:da:ba:22,24458337,180,206,24458157,24458337
5045,6,12,1,2412,-54,-92,38,40:e3:d6:da:ba:23,24458552,184,31,24458368,24458552
5046,6,12,1,2412,-55,-92,37,40:e3:d6:da:ba:24,24458770,176,42,24458594,24458770
5047,6,12,1,2412,-54,-92,38,40:e3:d6:da:ba:25,24458999,160,69,24458839,24458999
5048,6,6,1,2412,-55,-92,37,40:e3:d6:da:ba:26,24459218,380,-161,24458838,24459218
5049,6,12,1,2412,-84,-92,8,84:d4:7e:f2:42:20,24460767,160,1389,24460607,24460767
5050,6,6,1,2412,-85,-92,7,84:d4:7e:f2:42:21,24460969,368,-166,24460601,24460969
5051,6,12,1,2412,-82,-92,10,84:d4:7e:f2:42:24,24461766,176,621,24461590,24461766
5052,6,12,1,2412,-81,-92,11,40:e3:d6:da:ca:c0,24472582,156,10660,24472426,24472582
5053,6,12,1,2412,-85,-92,7,40:e3:d6:da:ca:c4,24474345,172,1591,24474173,24474345
5054,6,12,1,2412,-85,-92,7,40:e3:d6:da:ca:c5,24474560,156,59,24474404,24474560
5055,4,1,1,2412,-73,-92,19,,24491764,304,16900,24491460,24491764
5056,6,12,1,2412,-88,-92,4,40:e3:d6:da:c8:04,24504923,176,12983,24504747,24504923
5057,6,6,1,2412,-88,-92,4,40:e3:d6:da:c8:06,24505370,380,67,24504990,24505370
5058,4,1,1,2412,-72,-92,20,54:e4:3a:ec:fb:64,24517083,2160,9553,24514923,24517083
5059,6,6,1,2412,-51,-92,41,e6:aa:ea:c9:ea:33,24523991,408,6500,24523583,24523991
5060,6,6,1,2412,-51,-92,41,e6:aa:ea:c9:ea:33,24536120,408,11721,24535712,24536120
5061,6,6,1,2412,-83,-92,9,e6:aa:ea:c9:ea:1b,24549805,408,13277,24549397,24549805
5062,6,12,1,2412,-87,-92,5,40:e3:d6:da:bb:e2,24557885,176,7904,24557709,24557885
5063,6,12,1,2412,-88,-92,4,40:e3:d6:da:bb:e3,24558096,180,31,24557916,24558096
5064,6,6,1,2412,-55,-92,37,40:e3:d6:da:ba:21,24560329,368,1865,24559961,24560329
5065,6,12,1,2412,-53,-92,39,40:e3:d6:da:ba:23,24561202,184,689,24561018,24561202
5066,6,12,1,2412,-52,-92,40,40:e3:d6:da:ba:24,24561430,176,52,24561254,24561430
5067,6,12,1,2412,-54,-92,38,40:e3:d6:da:ba:25,24561649,160,59,24561489,24561649
5068,6,6,1,2412,-54,-92,38,40:e3:d6:da:ba:26,24561884,380,-145,24561504,24561884
5069,6,12,1,2412,-88,-92,4,40:e3:d6:da:bb:e2,24562899,156,859,24562743,24562899
5070,6,12,1,2412,-88,-92,4,40:e3:d6:da:bb:e3,24563116,156,61,24562960,24563116
5071,6,12,1,2412,-85,-92,7,40:e3:d6:da:bb:e5,24563334,136,82,24563198,24563334
5072,6,6,1,2412,-52,-92,40,e6:aa:ea:c9:ea:33,24572444,408,8702,24572036,24572444
5073,6,12,1,2412,-87,-92,5,40:e3:d6:da:ca:c0,24574980,156,2380,24574824,24574980
5074,6,12,1,2412,-86,-92,6,40:e3:d6:da:ca:c2,24575581,176,425,24575405,24575581
5075,6,12,1,2412,-87,-92,5,40:e3:d6:da:ca:c3,24575801,180,40,24575621,24575801
5076,6,12,1,2412,-87,-92,5,40:e3:d6:da:ca:c4,24576015,172,42,24575843,24576015
5077,6,12,1,2412,-87,-92,5,40:e3:d6:da:ca:c5,24576240,156,69,24576084,24576240
5078,6,6,1,2412,-86,-92,6,40:e3:d6:da:ca:c6,24576455,380,-165,24576075,24576455
5079,6,12,1,2412,-88,-92,4,40:e3:d6:da:bb:e0,24578470,136,1879,24578334,24578470
5080,6,6,1,2412,-88,-92,4,40:e3:d6:da:bb:e1,24578673,348,-145,24578325,24578673
5081,6,12,1,2412,-87,-92,5,40:e3:d6:da:bb:e2,24579214,156,385,24579058,24579214
5082,6,12,1,2412,-85,-92,7,40:e3:d6:da:bb:e3,24579842,156,472,24579686,24579842
5083,6,12,1,2412,-87,-92,5,40:e3:d6:da:bb:e5,24580192,136,214,24580056,24580192
5084,6,6,1,2412,-87,-92,5,40:e3:d6:da:c8:01,24606505,368,25945,24606137,24606505
5085,6,12,1,2412,-88,-92,4,40:e3:d6:da:c8:02,24606901,180,216,24606721,24606901
5086,6,12,1,2412,-88,-92,4,40:e3:d6:da:c8:04,24607437,176,360,24607261,24607437
5087,6,6,1,2412,-73,-92,19,e6:aa:ea:b7:4a:dd,24634979,408,27134,24634571,24634979
5088,6,6,1,2412,-88,-92,4,84:d4:7e:f2:34:26,24653084,380,17725,24652704,24653084
5089,6,6,1,2412,-73,-92,19,e6:aa:ea:b7:4a:dd,24659226,408,5734,24658818,24659226
5090,6,12,1,2412,-86,-92,6,40:e3:d6:da:bb:e5,24660475,156,1093,24660319,24660475
5091,6,6,1,2412,-86,-92,6,40:e3:d6:da:bb:e6,24660681,380,-174,24660301,24660681
5092,6,12,1,2412,-53,-92,39,40:e3:d6:da:ba:20,24662566,160,1725,24662406,24662566
5093,6,6,1,2412,-53,-92,39,40:e3:d6:da:ba:21,24662785,368,-149,24662417,24662785
5094,6,12,1,2412,-53,-92,39,40:e3:d6:da:ba:22,24663181,180,216,24663001,24663181
5095,6,12,1,2412,-53,-92,39,40:e3:d6:da:ba:23,24663396,184,31,24663212,24663396
5096,6,12,1,2412,-53,-92,39,40:e3:d6:da:ba:24,24663623,176,51,24663447,24663623
5097,6,12,1,2412,-53,-92,39,40:e3:d6:da:ba:25,24663825,160,42,24663665,24663825
5098,6,6,1,2412,-53,-92,39,40:e3:d6:da:ba:26,24664025,380,-180,24663645,24664025
5099,6,12,1,2412,-85,-92,7,84:d4:7e:f2:42:25,24664607,160,422,24664447,24664607
5100,6,12,1,2412,-86,-92,6,40:e3:d6:da:ca:c0,24677392,156,12629,24677236,24677392
5101,6,6,1,2412,-86,-92,6,40:e3:d6:da:ca:c1,24677597,368,-163,24677229,24677597
5102,6,6,1,2412,-73,-92,19,e6:aa:ea:b7:4a:dd,24683454,408,5449,24683046,24683454
5103,4,1,1,2412,-73,-92,19,a6:e5:7c:28:b1:d3,24708503,992,24057,24707511,24708503
5104,6,12,1,2412,-88,-92,4,40:e3:d6:da:c8:00,24709373,160,710,24709213,24709373
5105,6,6,1,2412,-88,-92,4,40:e3:d6:da:c8:06,24710869,380,1116,24710489,24710869
5106,6,6,1,2412,-89,-92,3,84:d4:7e:f2:34:21,24753584,368,42347,24753216,24753584
5107,6,12,1,2412,-86,-92,6,84:d4:7e:f2:34:25,24754673,160,929,24754513,24754673
5108,6,6,1,2412,-87,-92,5,84:d4:7e:f2:34:26,24754957,380,-96,24754577,24754957
5109,6,12,1,2412,-88,-92,4,40:e3:d6:da:bb:e0,24761608,156,6495,24761452,24761608
5110,6,6,1,2412,-87,-92,5,40:e3:d6:da:bb:e1,24761795,368,-181,24761427,24761795
5111,6,12,1,2412,-53,-92,39,40:e3:d6:da:ba:20,24764936,160,2981,24764776,24764936
5112,6,6,1,2412,-52,-92,40,40:e3:d6:da:ba:21,24765155,368,-149,24764787,24765155
5113,6,12,1,2412,-52,-92,40,40:e3:d6:da:ba:22,24765551,180,216,24765371,24765551
5114,6,12,1,2412,-53,-92,39,40:e3:d6:da:ba:23,24765766,184,31,24765582,24765766
5115,6,12,1,2412,-52,-92,40,40:e3:d6:da:ba:24,24765984,176,42,24765808,24765984
5116,6,12,1,2412,-53,-92,39,40:e3:d6:da:ba:25,24766186,160,42,24766026,24766186
5117,6,6,1,2412,-52,-92,40,40:e3:d6:da:ba:26,24766404,380,-162,24766024,24766404
5118,6,6,1,2412,-83,-92,9,84:d4:7e:f2:42:26,24767187,380,403,24766807,24767187
5119,6,6,1,2412,-87,-92,5,a8:5b:f7:55:1a:40,24784104,72,16845,24784032,24784104
5120,6,6,1,2412,-88,-92,4,a8:5b:f7:55:1a:40,24784400,72,224,24784328,24784400
5121,6,6,1,2412,-87,-92,5,a8:5b:f7:55:1a:40,24784508,72,36,24784436,24784508
5122,6,6,1,2412,-87,-92,5,a8:5b:f7:55:1a:40,24784651,72,71,24784579,24784651
5123,6,6,1,2412,-88,-92,4,a8:5b:f7:55:1a:40,24785198,72,475,24785126,24785198
5124,6,6,1,2412,-88,-92,4,a8:5b:f7:55:1a:40,24785332,72,62,24785260,24785332
5125,6,6,1,2412,-90,-92,2,a8:5b:f7:55:1a:40,24785530,72,126,24785458,24785530
5126,6,6,1,2412,-89,-92,3,a8:5b:f7:55:1a:40,24788590,72,2988,24788518,24788590
5127,6,6,1,2412,-88,-92,4,a8:5b:f7:55:1a:40,24788697,72,35,24788625,24788697
5128,6,6,1,2412,-88,-92,4,a8:5b:f7:55:1a:40,24788867,72,98,24788795,24788867
5129,6,6,1,2412,-88,-92,4,a8:5b:f7:55:1a:40,24788992,72,53,24788920,24788992
5130,6,6,1,2412,-87,-92,5,a8:5b:f7:55:1a:40,24789127,72,63,24789055,24789127
5131,6,6,1,2412,-88,-92,4,a8:5b:f7:55:1a:40,24790222,72,1023,24790150,24790222
5132,6,6,1,2412,-89,-92,3,a8:5b:f7:55:1a:40,24790329,72,35,24790257,24790329
5133,6,6,1,2412,-87,-92,5,a8:5b:f7:55:1a:40,24790490,72,89,24790418,24790490
5134,6,6,1,2412,-88,-92,4,a8:5b:f7:55:1a:40,24790778,72,216,24790706,24790778
5135,4,1,1,2412,-74,-92,18,a6:e5:7c:28:b1:d3,24810671,992,18901,24809679,24810671
5136,6,12,1,2412,-89,-92,3,40:e3:d6:da:c8:04,24812580,176,1733,24812404,24812580
5137,4,1,1,2412,-72,-92,20,54:e4:3a:ec:fb:64,24824265,2160,9525,24822105,24824265
5138,6,12,1,2412,-52,-92,40,40:e3:d6:da:ba:20,24867321,160,42896,24867161,24867321
5139,6,6,1,2412,-52,-92,40,40:e3:d6:da:ba:21,24867513,368,-176,24867145,24867513
5140,6,12,1,2412,-52,-92,40,40:e3:d6:da:ba:22,24867918,180,225,24867738,24867918
5141,6,12,1,2412,-52,-92,40,40:e3:d6:da:ba:23,24868150,184,48,24867966,24868150
5142,6,12,1,2412,-52,-92,40,40:e3:d6:da:ba:24,24868360,176,34,24868184,24868360
5143,6,12,1,2412,-52,-92,40,40:e3:d6:da:ba:25,24868588,160,68,24868428,24868588
5144,6,6,1,2412,-52,-92,40,40:e3:d6:da:ba:26,24868807,380,-161,24868427,24868807
5145,4,1,1,2412,-76,-92,16,,24897158,304,28047,24896854,24897158
5146,6,12,1,2412,-88,-92,4,40:e3:d6:da:c8:03,24914333,184,16991,24914149,24914333
5147,4,1,1,2412,-76,-92,16,a6:e5:7c:28:b1:d3,24914724,992,-601,24913732,24914724
5148,6,6,1,2412,-89,-92,3,40:e3:d6:da:c8:06,24916014,380,910,24915634,24916014
5149,4,1,1,2412,-71,-92,21,54:e4:3a:ec:fb:64,24926641,2160,8467,24924481,24926641
5150,4,1,1,2412,-77,-92,15,c0:c9:e3:4d:6e:bf,24942375,872,14862,24941503,24942375
5151,4,1,1,2412,-83,-92,9,,24943264,304,585,24942960,24943264
5152,6,6,1,2412,-55,-92,37,e6:aa:ea:c9:ea:33,24953325,408,9653,24952917,24953325
5153,4,1,1,2412,-77,-92,15,b8:3a:5a:88:e6:e1,24956110,2376,409,24953734,24956110
5154,6,12,1,2412,-90,-92,2,84:d4:7e:f2:34:20,24958652,160,2382,24958492,24958652
5155,6,12,1,2412,-89,-92,3,84:d4:7e:f2:34:24,24959929,176,1101,24959753,24959929
5156,6,6,1,2412,-56,-92,36,e6:aa:ea:c9:ea:33,24965455,408,5118,24965047,24965455
5157,6,6,1,2412,-88,-92,4,40:e3:d6:da:bb:e1,24966595,368,772,24966227,24966595
5158,6,12,1,2412,-85,-92,7,40:e3:d6:da:bb:e4,24967406,172,639,24967234,24967406
5159,6,12,1,2412,-88,-92,4,40:e3:d6:da:bb:e5,24967622,156,60,24967466,24967622
5160,6,6,1,2412,-88,-92,4,40:e3:d6:da:bb:e6,24967828,380,-174,24967448,24967828
5161,6,12,1,2412,-53,-92,39,40:e3:d6:da:ba:20,24969744,160,1756,24969584,24969744
5162,6,12,1,2412,-52,-92,40,40:e3:d6:da:ba:22,24970349,180,425,24970169,24970349
5163,6,12,1,2412,-53,-92,39,40:e3:d6:da:ba:23,24970555,184,22,24970371,24970555
5164,6,12,1,2412,-53,-92,39,40:e3:d6:da:ba:24,24970773,176,42,24970597,24970773
5165,6,12,1,2412,-52,-92,40,40:e3:d6:da:ba:25,24970975,160,42,24970815,24970975
5166,6,6,1,2412,-52,-92,40,40:e3:d6:da:ba:26,24971166,380,-189,24970786,24971166
5167,6,12,1,2412,-84,-92,8,84:d4:7e:f2:42:24,24971576,176,234,24971400,24971576
5168,6,12,1,2412,-84,-92,8,84:d4:7e:f2:42:25,24971795,160,59,24971635,24971795
5169,6,6,1,2412,-84,-92,8,84:d4:7e:f2:42:26,24971996,380,-179,24971616,24971996
5170,6,6,1,2412,-56,-92,36,e6:aa:ea:c9:ea:33,24977550,408,5146,24977142,24977550
5171,6,12,1,2412,-87,-92,5,40:e3:d6:da:ca:c5,24985856,156,8150,24985700,24985856
5172,6,6,1,2412,-56,-92,36,e6:aa:ea:c9:ea:33,24989651,408,3387,24989243,24989651
5173,6,12,1,2412,-88,-92,4,40:e3:d6:da:c8:00,25015906,160,26095,25015746,25015906
5174,6,6,1,2412,-90,-92,2,40:e3:d6:da:c8:01,25016125,368,-149,25015757,25016125
5175,6,12,1,2412,-89,-92,3,40:e3:d6:da:c8:02,25016530,180,225,25016350,25016530
5176,6,6,1,2412,-87,-92,5,40:e3:d6:da:c8:06,25017383,380,473,25017003,25017383
5177,4,1,1,2412,-72,-92,20,54:e4:3a:ec:fb:64,25029074,2160,9531,25026914,25029074
5178,4,1,1,2412,-77,-92,15,b8:3a:5a:88:e6:e0,25056103,2360,24669,25053743,25056103
5179,6,6,1,2412,-88,-92,4,84:d4:7e:f2:34:21,25061262,368,4791,25060894,25061262
5180,6,12,1,2412,-89,-92,3,84:d4:7e:f2:34:22,25061667,180,225,25061487,25061667
5181,6,12,1,2412,-89,-92,3,84:d4:7e:f2:34:23,25061891,180,44,25061711,25061891
5182,6,12,1,2412,-88,-92,4,84:d4:7e:f2:34:24,25062105,176,38,25061929,25062105
5183,6,12,1,2412,-87,-92,5,40:e3:d6:da:bb:e0,25068825,156,6564,25068669,25068825
5184,6,6,1,2412,-88,-92,4,40:e3:d6:da:bb:e1,25069040,368,-153,25068672,25069040
5185,6,12,1,2412,-88,-92,4,40:e3:d6:da:bb:e3,25069646,180,426,25069466,25069646
5186,6,12,1,2412,-52,-92,40,40:e3:d6:da:ba:20,25072121,160,2315,25071961,25072121
5187,6,12,1,2412,-52,-92,40,40:e3:d6:da:ba:22,25072736,180,435,25072556,25072736
5188,6,12,1,2412,-52,-92,40,40:e3:d6:da:ba:25,25075758,160,2862,25075598,25075758
5189,6,6,1,2412,-52,-92,40,40:e3:d6:da:ba:26,25075959,380,-179,25075579,25075959
5190,6,12,1,2412,-88,-92,4,40:e3:d6:da:ca:c0,25086977,156,10862,25086821,25086977
5191,6,6,1,2412,-85,-92,7,40:e3:d6:da:ca:c1,25087183,368,-162,25086815,25087183
5192,6,12,1,2412,-87,-92,5,40:e3:d6:da:ca:c2,25087598,176,239,25087422,25087598
5193,6,12,1,2412,-87,-92,5,40:e3:d6:da:ca:c4,25088050,172,280,25087878,25088050
5194,6,6,1,2412,-88,-92,4,40:e3:d6:da:c8:01,25118473,368,30055,25118105,25118473
5195,4,1,1,2412,-73,-92,19,54:e4:3a:ec:fb:64,25131568,2160,10935,25129408,25131568
5196,6,12,1,2412,-68,-92,24,40:e3:d6:da:bb:60,25135667,960,3139,25134707,25135667
5197,6,6,1,2412,-75,-92,17,e6:aa:ea:b7:4a:dd,25155597,408,19522,25155189,25155597
5198,4,1,1,2412,-74,-92,18,b8:3a:5a:88:e6:e0,25158510,2360,553,25156150,25158510
5199,4,1,1,2412,-75,-92,17,b8:3a:5a:88:e6:e1,25160952,2376,66,25158576,25160952
5200,6,12,1,2412,-89,-92,3,40:e3:d6:da:bb:e0,25171223,156,10115,25171067,25171223
5201,6,6,1,2412,-88,-92,4,40:e3:d6:da:bb:e1,25171411,368,-180,25171043,25171411
5202,6,12,1,2412,-88,-92,4,40:e3:d6:da:bb:e2,25171840,176,253,25171664,25171840
5203,6,12,1,2412,-85,-92,7,40:e3:d6:da:bb:e3,25172076,180,56,25171896,25172076
5204,6,6,1,2412,-87,-92,5,40:e3:d6:da:bb:e6,25172703,380,247,25172323,25172703
5205,6,12,1,2412,-52,-92,40,40:e3:d6:da:ba:20,25174522,160,1659,25174362,25174522
5206,6,6,1,2412,-52,-92,40,40:e3:d6:da:ba:21,25174732,368,-158,25174364,25174732
5207,6,12,1,2412,-52,-92,40,40:e3:d6:da:ba:22,25175119,180,207,25174939,25175119
5208,6,12,1,2412,-52,-92,40,40:e3:d6:da:ba:23,25175343,184,40,25175159,25175343
5209,6,12,1,2412,-52,-92,40,40:e3:d6:da:ba:25,25175781,160,278,25175621,25175781
5210,6,6,1,2412,-52,-92,40,40:e3:d6:da:ba:26,25175981,380,-180,25175601,25175981
5211,6,12,1,2412,-86,-92,6,40:e3:d6:da:ca:c3,25190163,180,14002,25189983,25190163
5212,6,6,1,2412,-74,-92,18,e6:aa:ea:b7:4a:dd,25191953,408,1382,25191545,25191953
5213,6,12,1,2412,-89,-92,3,40:e3:d6:da:c8:00,25220682,160,28569,25220522,25220682
5214,6,6,1,2412,-88,-92,4,40:e3:d6:da:c8:01,25220874,368,-176,25220506,25220874
5215,6,12,1,2412,-89,-92,3,40:e3:d6:da:c8:02,25221279,180,225,25221099,25221279
5216,6,12,1,2412,-89,-92,3,40:e3:d6:da:c8:03,25221484,184,21,25221300,25221484
5217,4,1,1,2412,-72,-92,20,54:e4:3a:ec:fb:64,25233843,2160,10199,25231683,25233843
5218,6,6,1,2412,-57,-92,35,e6:aa:ea:c9:ea:33,25257000,408,22749,25256592,25257000
5219,4,1,1,2412,-76,-92,16,b8:3a:5a:88:e6:e0,25260883,2360,1523,25258523,25260883
5220,4,1,1,2412,-76,-92,16,b8:3a:5a:88:e6:e1,25263299,2376,40,25260923,25263299
5221,6,12,1,2412,-90,-92,2,84:d4:7e:f2:34:20,25265841,160,2382,25265681,25265841
5222,6,6,1,2412,-89,-92,3,84:d4:7e:f2:34:21,25266041,368,-168,25265673,25266041
5223,6,12,1,2412,-89,-92,3,84:d4:7e:f2:34:25,25267154,160,953,25266994,25267154
5224,6,6,1,2412,-58,-92,34,e6:aa:ea:c9:ea:33,25269129,408,1567,25268721,25269129
5225,6,12,1,2412,-87,-92,5,40:e3:d6:da:bb:e4,25274631,172,5330,25274459,25274631
5226,6,6,1,2412,-88,-92,4,40:e3:d6:da:bb:e6,25275070,380,59,25274690,25275070
5227,6,12,1,2412,-53,-92,39,40:e3:d6:da:ba:20,25276938,160,1708,25276778,25276938
5228,6,6,1,2412,-53,-92,39,40:e3:d6:da:ba:21,25277139,368,-167,25276771,25277139
5229,6,12,1,2412,-53,-92,39,40:e3:d6:da:ba:22,25277544,180,225,25277364,25277544
5230,6,12,1,2412,-53,-92,39,40:e3:d6:da:ba:23,25277768,184,40,25277584,25277768
5231,6,12,1,2412,-53,-92,39,40:e3:d6:da:ba:24,25278004,176,60,25277828,25278004
5232,6,12,1,2412,-53,-92,39,40:e3:d6:da:ba:25,25278224,160,60,25278064,25278224
5233,6,6,1,2412,-53,-92,39,40:e3:d6:da:ba:26,25278425,380,-179,25278045,25278425
5234,6,12,1,2412,-84,-92,8,84:d4:7e:f2:42:25,25278969,160,384,25278809,25278969
5235,6,6,1,2412,-84,-92,8,84:d4:7e:f2:42:26,25279161,380,-188,25278781,25279161
5236,6,12,1,2412,-78,-92,14,40:e3:d6:da:ca:c0,25291793,156,12476,25291637,25291793
5237,6,12,1,2412,-87,-92,5,40:e3:d6:da:ca:c4,25292829,172,864,25292657,25292829
5238,6,6,1,2412,-58,-92,34,e6:aa:ea:c9:ea:33,25293346,408,109,25292938,25293346
5239,6,6,1,2412,-55,-92,37,e6:aa:ea:c9:ea:33,25305470,408,11716,25305062,25305470
5240,6,12,1,2412,-86,-92,6,40:e3:d6:da:ca:c3,25314448,156,8822,25314292,25314448
5241,6,12,1,2412,-89,-92,3,40:e3:d6:da:c8:00,25323083,160,8475,25322923,25323083
5242,6,6,1,2412,-90,-92,2,40:e3:d6:da:c8:01,25323275,368,-176,25322907,25323275
5243,6,12,1,2412,-89,-92,3,40:e3:d6:da:c8:05,25324368,160,933,25324208,25324368
5244,4,1,1,2412,-72,-92,20,54:e4:3a:ec:fb:64,25335904,2160,9376,25333744,25335904
5245,4,1,1,2412,-65,-92,27,b8:3a:5a:88:e6:e0,25363301,2360,25037,25360941,25363301
5246,6,12,1,2412,-89,-92,3,84:d4:7e:f2:34:22,25368003,180,4522,25367823,25368003
5247,6,12,1,2412,-90,-92,2,84:d4:7e:f2:34:23,25368235,180,52,25368055,25368235
5248,6,12,1,2412,-89,-92,3,84:d4:7e:f2:34:24,25368459,176,48,25368283,25368459
5249,6,6,1,2412,-89,-92,3,84:d4:7e:f2:34:26,25368879,380,40,25368499,25368879
5250,6,12,1,2412,-87,-92,5,40:e3:d6:da:bb:e3,25376815,180,7756,25376635,25376815
5251,6,12,1,2412,-88,-92,4,40:e3:d6:da:bb:e4,25377039,172,52,25376867,25377039
5252,6,12,1,2412,-88,-92,4,40:e3:d6:da:bb:e5,25377263,156,68,25377107,25377263
5253,6,6,1,2412,-88,-92,4,40:e3:d6:da:bb:e6,25377478,380,-165,25377098,25377478
5254,6,12,1,2412,-54,-92,38,40:e3:d6:da:ba:20,25379338,160,1700,25379178,25379338
5255,6,6,1,2412,-54,-92,38,40:e3:d6:da:ba:21,25379557,368,-149,25379189,25379557
5256,6,12,1,2412,-54,-92,38,40:e3:d6:da:ba:22,25379971,180,234,25379791,25379971
5257,6,12,1,2412,-54,-92,38,40:e3:d6:da:ba:23,25380176,184,21,25379992,25380176
5258,6,12,1,2412,-53,-92,39,40:e3:d6:da:ba:24,25380404,176,52,25380228,25380404
5259,6,12,1,2412,-54,-92,38,40:e3:d6:da:ba:25,25380632,160,68,25380472,25380632
5260,4,1,1,2412,-82,-92,10,c0:c9:e3:4d:6e:bf,25388711,872,7207,25387839,25388711
5261,4,1,1,2412,-75,-92,17,,25389600,304,585,25389296,25389600
5262,6,12,1,2412,-87,-92,5,40:e3:d6:da:ca:c3,25395256,180,5476,25395076,25395256
5263,6,12,1,2412,-86,-92,6,40:e3:d6:da:ca:c4,25395480,172,52,25395308,25395480
5264,6,12,1,2412,-86,-92,6,40:e3:d6:da:ca:c5,25395695,156,59,25395539,25395695
5265,6,6,1,2412,-86,-92,6,40:e3:d6:da:ca:c6,25395892,380,-183,25395512,25395892
5266,6,12,1,2412,-89,-92,3,40:e3:d6:da:c8:00,25425494,160,29442,25425334,25425494
5267,6,6,1,2412,-88,-92,4,40:e3:d6:da:c8:06,25427148,380,1274,25426768,25427148
5268,4,1,1,2412,-65,-92,27,c0:c9:e3:4d:6e:bf,25434488,872,6468,25433616,25434488
5269,4,1,1,2412,-84,-92,8,,25435377,304,585,25435073,25435377
5270,4,1,1,2412,-71,-92,21,54:e4:3a:ec:fb:64,25438303,2160,766,25436143,25438303
5271,6,6,1,2412,-84,-92,8,e6:aa:ea:c9:ea:1b,25455059,408,16348,25454651,25455059
5272,6,12,1,2412,-90,-92,2,84:d4:7e:f2:34:22,25470951,180,15712,25470771,25470951
5273,6,12,1,2412,-89,-92,3,84:d4:7e:f2:34:23,25471174,180,43,25470994,25471174
5274,6,6,1,2412,-89,-92,3,84:d4:7e:f2:34:26,25471942,380,388,25471562,25471942
5275,6,12,1,2412,-87,-92,5,40:e3:d6:da:bb:e3,25480189,180,8067,25480009,25480189
5276,6,12,1,2412,-54,-92,38,40:e3:d6:da:ba:20,25481741,160,1392,25481581,25481741
5277,6,6,1,2412,-54,-92,38,40:e3:d6:da:ba:21,25481933,368,-176,25481565,25481933
5278,6,12,1,2412,-54,-92,38,40:e3:d6:da:ba:24,25482744,176,635,25482568,25482744
5279,6,12,1,2412,-54,-92,38,40:e3:d6:da:ba:25,25482973,160,69,25482813,25482973
5280,6,6,1,2412,-54,-92,38,40:e3:d6:da:ba:26,25483164,380,-189,25482784,25483164
5281,6,12,1,2412,-85,-92,7,84:d4:7e:f2:42:24,25483563,176,223,25483387,25483563
5282,6,6,1,2412,-84,-92,8,e6:aa:ea:c9:ea:1b,25491406,408,7435,25490998,25491406
5283,6,12,1,2412,-86,-92,6,40:e3:d6:da:ca:c0,25496597,156,5035,25496441,25496597
5284,6,6,1,2412,-85,-92,7,40:e3:d6:da:ca:c1,25496803,368,-162,25496435,25496803
5285,6,12,1,2412,-87,-92,5,40:e3:d6:da:ca:c3,25497436,180,453,25497256,25497436
5286,6,6,1,2412,-84,-92,8,e6:aa:ea:c9:ea:1b,25503555,408,5711,25503147,25503555
5287,6,6,1,2412,-89,-92,3,40:e3:d6:da:c8:01,25528217,368,24294,25527849,25528217
5288,6,12,1,2412,-90,-92,2,40:e3:d6:da:c8:04,25529028,176,635,25528852,25529028
5289,6,12,1,2412,-89,-92,3,40:e3:d6:da:c8:05,25529247,160,59,25529087,25529247
5290,6,6,1,2412,-89,-92,3,40:e3:d6:da:c8:06,25529467,380,-160,25529087,25529467
5291,4,1,1,2412,-71,-92,21,54:e4:3a:ec:fb:64,25540718,2160,9091,25538558,25540718
5292,4,1,1,2412,-78,-92,14,b8:3a:5a:88:e6:e0,25568102,2360,25024,25565742,25568102
5293,6,12,1,2412,-87,-92,5,40:e3:d6:da:bb:e0,25580823,156,12565,25580667,25580823
5294,6,6,1,2412,-87,-92,5,40:e3:d6:da:bb:e1,25581020,368,-171,25580652,25581020
5295,6,12,1,2412,-87,-92,5,40:e3:d6:da:bb:e3,25581609,180,409,25581429,25581609
5296,6,6,1,2412,-58,-92,34,e6:aa:ea:c9:ea:33,25583922,408,1905,25583514,25583922
5297,6,12,1,2412,-54,-92,38,40:e3:d6:da:ba:20,25584359,160,277,25584199,25584359
5298,6,6,1,2412,-54,-92,38,40:e3:d6:da:ba:21,25584560,368,-167,25584192,25584560
5299,6,12,1,2412,-54,-92,38,40:e3:d6:da:ba:22,25584965,180,225,25584785,25584965
5300,6,12,1,2412,-54,-92,38,40:e3:d6:da:ba:23,25585179,184,30,25584995,25585179
5301,6,6,1,2412,-74,-92,18,e6:aa:ea:b7:4a:dd,25585371,408,-216,25584963,25585371
5302,6,12,1,2412,-54,-92,38,40:e3:d6:da:ba:24,25585794,176,247,25585618,25585794
5303,6,12,1,2412,-54,-92,38,40:e3:d6:da:ba:25,25586022,160,68,25585862,25586022
5304,6,6,1,2412,-54,-92,38,40:e3:d6:da:ba:26,25586223,380,-179,25585843,25586223
5305,6,6,1,2412,-58,-92,34,e6:aa:ea:c9:ea:33,25596043,408,9412,25595635,25596043
5306,6,6,1,2412,-75,-92,17,e6:aa:ea:b7:4a:dd,25597303,408,852,25596895,25597303
5307,6,12,1,2412,-86,-92,6,40:e3:d6:da:ca:c0,25599003,156,1544,25598847,25599003
5308,6,6,1,2412,-86,-92,6,40:e3:d6:da:ca:c1,25599208,368,-163,25598840,25599208
5309,6,12,1,2412,-83,-92,9,40:e3:d6:da:ca:c2,25599604,176,220,25599428,25599604
5310,6,12,1,2412,-80,-92,12,40:e3:d6:da:ca:c3,25599825,180,41,25599645,25599825
5311,6,12,1,2412,-84,-92,8,40:e3:d6:da:ca:c4,25600048,172,51,25599876,25600048
5312,6,12,1,2412,-86,-92,6,40:e3:d6:da:ca:c5,25600245,156,41,25600089,25600245
5313,6,6,1,2412,-86,-92,6,40:e3:d6:da:ca:c6,25600460,380,-165,25600080,25600460
5314,6,6,1,2412,-69,-92,23,78:8a:20:fa:27:f9,25607608,88,7060,25607520,25607608
5315,6,6,1,2412,-83,-92,9,,25607714,44,62,25607670,25607714
5316,6,6,1,2412,-75,-92,17,e6:aa:ea:b7:4a:dd,25621498,408,13376,25621090,25621498
5317,6,6,1,2412,-69,-92,23,78:8a:20:fa:27:f9,25657681,88,36095,25657593,25657681
5318,6,6,1,2412,-82,-92,10,,25657787,44,62,25657743,25657787
5319,6,12,1,2412,-68,-92,24,,25658066,32,247,25658034,25658066
5320,6,12,1,2412,-68,-92,24,,25658290,32,192,25658258,25658290
5321,6,12,1,2412,-83,-92,9,84:d4:7e:f2:42:22,25658560,160,110,25658400,25658560
5322,6,6,1,2412,-69,-92,23,,25658728,44,124,25658684,25658728
5323,6,12,1,2412,-83,-92,9,84:d4:7e:f2:42:23,25659008,160,120,25658848,25659008
5324,6,12,1,2412,-69,-92,23,,25659371,32,331,25659339,25659371
5325,6,12,1,2412,-69,-92,23,,25659827,32,424,25659795,25659827
5326,6,12,1,2412,-68,-92,24,,25660061,32,202,25660029,25660061
5327,6,12,1,2412,-69,-92,23,,25660304,32,211,25660272,25660304
5328,4,1,1,2412,-77,-92,15,b8:3a:5a:88:e6:e0,25670504,2360,7840,25668144,25670504
5329,4,1,1,2412,-78,-92,14,b8:3a:5a:88:e6:e1,25672902,2376,22,25670526,25672902
5330,6,12,1,2412,-88,-92,4,84:d4:7e:f2:34:22,25675186,180,2104,25675006,25675186
5331,6,12,1,2412,-88,-92,4,84:d4:7e:f2:34:23,25675401,180,35,25675221,25675401
5332,6,12,1,2412,-89,-92,3,84:d4:7e:f2:34:24,25675605,176,28,25675429,25675605
5333,6,12,1,2412,-89,-92,3,84:d4:7e:f2:34:25,25675825,160,60,25675665,25675825
5334,6,12,1,2412,-84,-92,8,40:e3:d6:da:bb:e0,25683228,156,7247,25683072,25683228
5335,6,6,1,2412,-86,-92,6,40:e3:d6:da:bb:e1,25683444,368,-152,25683076,25683444
5336,6,12,1,2412,-86,-92,6,40:e3:d6:da:bb:e2,25683830,176,210,25683654,25683830
5337,6,12,1,2412,-88,-92,4,40:e3:d6:da:bb:e3,25684041,180,31,25683861,25684041
5338,6,12,1,2412,-86,-92,6,40:e3:d6:da:bb:e4,25684246,172,33,25684074,25684246
5339,6,6,1,2412,-88,-92,4,40:e3:d6:da:bb:e6,25684677,380,51,25684297,25684677
5340,6,6,1,2412,-55,-92,37,40:e3:d6:da:ba:21,25686754,368,1709,25686386,25686754
5341,6,12,1,2412,-54,-92,38,40:e3:d6:da:ba:22,25687150,180,216,25686970,25687150
5342,6,12,1,2412,-54,-92,38,40:e3:d6:da:ba:24,25687583,176,257,25687407,25687583
5343,6,12,1,2412,-54,-92,38,40:e3:d6:da:ba:25,25687811,160,68,25687651,25687811
5344,6,6,1,2412,-54,-92,38,40:e3:d6:da:ba:26,25688021,380,-170,25687641,25688021
5345,6,12,1,2412,-84,-92,8,84:d4:7e:f2:42:25,25688591,160,410,25688431,25688591
5346,6,6,1,2412,-85,-92,7,84:d4:7e:f2:42:26,25688811,380,-160,25688431,25688811
5347,6,12,1,2412,-82,-92,10,40:e3:d6:da:ca:c0,25701375,156,12408,25701219,25701375
5348,6,6,1,2412,-82,-92,10,40:e3:d6:da:ca:c1,25701573,368,-170,25701205,25701573
5349,6,12,1,2412,-86,-92,6,40:e3:d6:da:ca:c3,25702197,180,444,25702017,25702197
5350,6,12,1,2412,-85,-92,7,40:e3:d6:da:ca:c4,25702403,172,34,25702231,25702403
5351,6,12,1,2412,-86,-92,6,40:e3:d6:da:ca:c5,25702609,156,50,25702453,25702609
5352,6,6,1,2412,-85,-92,7,40:e3:d6:da:ca:c6,25702824,380,-165,25702444,25702824
5353,6,6,1,2412,-88,-92,4,a8:5b:f7:55:1a:40,25705156,72,2260,25705084,25705156
5354,6,6,1,2412,-89,-92,3,a8:5b:f7:55:1a:40,25705299,72,71,25705227,25705299
5355,6,6,1,2412,-87,-92,5,a8:5b:f7:55:1a:40,25705407,72,36,25705335,25705407
5356,6,6,1,2412,-88,-92,4,a8:5b:f7:55:1a:40,25705523,72,44,25705451,25705523
5357,6,6,1,2412,-88,-92,4,a8:5b:f7:55:1a:40,25705758,72,163,25705686,25705758
5358,6,6,1,2412,-89,-92,3,a8:5b:f7:55:1a:40,25705864,72,34,25705792,25705864
5359,6,6,1,2412,-86,-92,6,a8:5b:f7:55:1a:40,25706089,72,153,25706017,25706089
5360,6,6,1,2412,-89,-92,3,a8:5b:f7:55:1a:40,25706197,72,36,25706125,25706197
5361,6,6,1,2412,-89,-92,3,a8:5b:f7:55:1a:40,25706403,72,134,25706331,25706403
5362,6,6,1,2412,-89,-92,3,a8:5b:f7:55:1a:40,25706510,72,35,25706438,25706510
5363,6,6,1,2412,-88,-92,4,a8:5b:f7:55:1a:40,25706699,72,117,25706627,25706699
5364,6,6,1,2412,-87,-92,5,a8:5b:f7:55:1a:40,25706843,72,72,25706771,25706843
5365,6,6,1,2412,-88,-92,4,a8:5b:f7:55:1a:40,25707184,72,269,25707112,25707184
5366,6,6,1,2412,-88,-92,4,a8:5b:f7:55:1a:40,25707291,72,35,25707219,25707291
5367,6,6,1,2412,-88,-92,4,a8:5b:f7:55:1a:40,25707489,72,126,25707417,25707489
5368,6,6,1,2412,-88,-92,4,a8:5b:f7:55:1a:40,25708598,72,1037,25708526,25708598
5369,6,6,1,2412,-89,-92,3,a8:5b:f7:55:1a:40,25708705,72,35,25708633,25708705
5370,6,6,1,2412,-87,-92,5,a8:5b:f7:55:1a:40,25708921,72,144,25708849,25708921
5371,6,6,1,2412,-88,-92,4,a8:5b:f7:55:1a:40,25709028,72,35,25708956,25709028
5372,6,6,1,2412,-88,-92,4,a8:5b:f7:55:1a:40,25709198,72,98,25709126,25709198
5373,6,6,1,2412,-90,-92,2,a8:5b:f7:55:1a:40,25709306,72,36,25709234,25709306
5374,6,6,1,2412,-88,-92,4,a8:5b:f7:55:1a:40,25709531,72,153,25709459,25709531
5375,6,6,1,2412,-88,-92,4,a8:5b:f7:55:1a:40,25709638,72,35,25709566,25709638
5376,6,6,1,2412,-89,-92,3,a8:5b:f7:55:1a:40,25709871,72,161,25709799,25709871
5377,6,6,1,2412,-87,-92,5,a8:5b:f7:55:1a:40,25709979,72,36,25709907,25709979
5378,6,6,1,2412,-88,-92,4,a8:5b:f7:55:1a:40,25710122,72,71,25710050,25710122
5379,6,6,1,2412,-89,-92,3,a8:5b:f7:55:1a:40,25710266,72,72,25710194,25710266
5380,6,6,1,2412,-88,-92,4,a8:5b:f7:55:1a:40,25710410,72,72,25710338,25710410
5381,6,6,1,2412,-88,-92,4,a8:5b:f7:55:1a:40,25710616,72,134,25710544,25710616
5382,6,6,1,2412,-89,-92,3,a8:5b:f7:55:1a:40,25710742,72,54,25710670,25710742
5383,6,6,1,2412,-87,-92,5,a8:5b:f7:55:1a:40,25710957,72,143,25710885,25710957
5384,6,6,1,2412,-88,-92,4,40:e3:d6:da:c8:01,25732879,368,21554,25732511,25732879
5385,6,12,1,2412,-91,-92,1,40:e3:d6:da:c8:02,25733274,180,215,25733094,25733274
5386,6,12,1,2412,-90,-92,2,40:e3:d6:da:c8:03,25733488,184,30,25733304,25733488
5387,6,6,1,2412,-87,-92,5,84:d4:7e:f2:34:26,25780669,380,46801,25780289,25780669
5388,6,12,1,2412,-87,-92,5,40:e3:d6:da:bb:e0,25785630,156,4805,25785474,25785630
5389,6,12,1,2412,-86,-92,6,40:e3:d6:da:bb:e5,25786837,156,1051,25786681,25786837
5390,6,6,1,2412,-87,-92,5,40:e3:d6:da:bb:e6,25787042,380,-175,25786662,25787042
5391,6,12,1,2412,-55,-92,37,40:e3:d6:da:ba:20,25788950,160,1748,25788790,25788950
5392,6,6,1,2412,-55,-92,37,40:e3:d6:da:ba:21,25789169,368,-149,25788801,25789169
5393,6,12,1,2412,-55,-92,37,40:e3:d6:da:ba:22,25789583,180,234,25789403,25789583
5394,6,12,1,2412,-55,-92,37,40:e3:d6:da:ba:23,25789806,184,39,25789622,25789806
5395,6,12,1,2412,-55,-92,37,40:e3:d6:da:ba:24,25790025,176,43,25789849,25790025
5396,6,12,1,2412,-55,-92,37,40:e3:d6:da:ba:25,25790253,160,68,25790093,25790253
5397,6,6,1,2412,-55,-92,37,40:e3:d6:da:ba:26,25790454,380,-179,25790074,25790454
5398,6,12,1,2412,-54,-92,38,40:e3:d6:da:ba:20,25799708,960,8294,25798748,25799708
5399,6,12,1,2412,-86,-92,6,40:e3:d6:da:ca:c0,25803794,156,3930,25803638,25803794
5400,6,12,1,2412,-86,-92,6,40:e3:d6:da:ca:c2,25804387,176,417,25804211,25804387
5401,6,12,1,2412,-84,-92,8,40:e3:d6:da:ca:c3,25804606,180,39,25804426,25804606
5402,6,12,1,2412,-82,-92,10,40:e3:d6:da:ca:c4,25804811,172,33,25804639,25804811
5403,6,12,1,2412,-82,-92,10,40:e3:d6:da:ca:c5,25805077,156,110,25804921,25805077
5404,6,6,1,2412,-85,-92,7,40:e3:d6:da:ca:c6,25805274,380,-183,25804894,25805274
5405,6,6,1,2412,-86,-92,6,e6:aa:ea:c9:ea:1b,25809014,408,3332,25808606,25809014
5406,6,6,1,2412,-87,-92,5,e6:aa:ea:c9:ea:1b,25821097,408,11675,25820689,25821097
5407,6,12,1,2412,-89,-92,3,40:e3:d6:da:c8:05,25836363,160,15106,25836203,25836363
5408,6,6,1,2412,-89,-92,3,40:e3:d6:da:c8:06,25836581,380,-162,25836201,25836581
5409,4,1,1,2412,-72,-92,20,54:e4:3a:ec:fb:64,25847997,2160,9256,25845837,25847997
5410,4,1,1,2412,-78,-92,14,b8:3a:5a:88:e6:e0,25875284,2360,24927,25872924,25875284
5411,4,1,1,2412,-76,-92,16,b8:3a:5a:88:e6:e1,25877673,2376,13,25875297,25877673
5412,6,6,1,2412,-88,-92,4,,25881567,44,3850,25881523,25881567
5413,6,12,1,2412,-89,-92,3,,25881667,36,64,25881631,25881667
5414,6,12,1,2412,-86,-92,6,,25881719,32,20,25881687,25881719
5415,6,12,1,2412,-80,-92,12,,25882097,36,342,25882061,25882097
5416,6,12,1,2412,-82,-92,10,,25882150,32,21,25882118,25882150
5417,4,1,1,2412,-82,-92,10,c0:c9:e3:4d:6e:bf,25885450,872,2428,25884578,25885450
5418,4,1,1,2412,-84,-92,8,,25886338,304,584,25886034,25886338
5419,6,12,1,2412,-89,-92,3,,25886538,36,164,25886502,25886538
5420,6,12,1,2412,-85,-92,7,,25886590,32,20,25886558,25886590
5421,6,12,1,2412,-86,-92,6,,25886725,44,91,25886681,25886725
5422,6,12,1,2412,-87,-92,5,40:e3:d6:da:bb:e3,25888826,180,1921,25888646,25888826
5423,6,12,1,2412,-88,-92,4,40:e3:d6:da:bb:e4,25889059,172,61,25888887,25889059
5424,6,12,1,2412,-86,-92,6,40:e3:d6:da:bb:e5,25889274,156,59,25889118,25889274
5425,6,12,1,2412,-56,-92,36,40:e3:d6:da:ba:20,25891344,160,1910,25891184,25891344
5426,6,6,1,2412,-56,-92,36,40:e3:d6:da:ba:21,25891536,368,-176,25891168,25891536
5427,6,12,1,2412,-56,-92,36,40:e3:d6:da:ba:22,25891950,180,234,25891770,25891950
5428,6,12,1,2412,-56,-92,36,40:e3:d6:da:ba:23,25892165,184,31,25891981,25892165
5429,6,12,1,2412,-56,-92,36,40:e3:d6:da:ba:24,25892374,176,33,25892198,25892374
5430,6,12,1,2412,-56,-92,36,40:e3:d6:da:ba:25,25892593,160,59,25892433,25892593
5431,6,6,1,2412,-56,-92,36,40:e3:d6:da:ba:26,25892794,380,-179,25892414,25892794
5432,6,12,1,2412,-86,-92,6,40:e3:d6:da:ca:c0,25906197,156,13247,25906041,25906197
5433,6,6,1,2412,-87,-92,5,40:e3:d6:da:ca:c1,25906404,368,-161,25906036,25906404
5434,6,12,1,2412,-87,-92,5,40:e3:d6:da:ca:c2,25906800,176,220,25906624,25906800
5435,6,12,1,2412,-85,-92,7,40:e3:d6:da:ca:c4,25907335,172,363,25907163,25907335
5436,6,12,1,2412,-87,-92,5,40:e3:d6:da:ca:c5,25907541,156,50,25907385,25907541
5437,6,6,1,2412,-87,-92,5,40:e3:d6:da:ca:c6,25907756,380,-165,25907376,25907756
5438,4,1,1,2412,-70,-92,22,c0:c9:e3:4d:6e:bf,25930461,872,21833,25929589,25930461
5439,4,1,1,2412,-83,-92,9,,25931350,304,585,25931046,25931350
5440,4,1,1,2412,-73,-92,19,54:e4:3a:ec:fb:64,25951001,2160,17491,25948841,25951001
5441,6,12,1,2412,-87,-92,5,84:d4:7e:f2:34:22,25982376,180,31195,25982196,25982376
5442,6,12,1,2412,-88,-92,4,84:d4:7e:f2:34:24,25982938,176,386,25982762,25982938
5443,6,12,1,2412,-89,-92,3,84:d4:7e:f2:34:25,25983150,160,52,25982990,25983150
5444,6,6,1,2412,-88,-92,4,84:d4:7e:f2:34:26,25983368,380,-162,25982988,25983368
5445,6,12,1,2412,-89,-92,3,,25986781,32,3381,25986749,25986781
5446,6,12,1,2412,-83,-92,9,,25988148,32,1335,25988116,25988148
5447,6,12,1,2412,-88,-92,4,,25989006,32,826,25988974,25989006
5448,6,24,1,2412,-86,-92,6,66:d8:ff:ae:5d:41,25989383,32,345,25989351,25989383
5449,6,12,1,2412,-88,-92,4,,25989432,32,17,25989400,25989432
5450,6,12,1,2412,-89,-92,3,,25989682,32,218,25989650,25989682
5451,6,6,1,2412,-87,-92,5,40:e3:d6:da:bb:e1,25990619,368,569,25990251,25990619
5452,6,12,1,2412,-86,-92,6,40:e3:d6:da:bb:e2,25991033,176,238,25990857,25991033
5453,6,6,1,2412,-74,-92,18,e6:aa:ea:b7:4a:dd,25991308,408,-133,25990900,25991308
5454,6,6,1,2412,-86,-92,6,40:e3:d6:da:bb:e6,25991906,380,218,25991526,25991906
5455,6,12,1,2412,-57,-92,35,40:e3:d6:da:ba:20,25993747,160,1681,25993587,25993747
5456,6,6,1,2412,-56,-92,36,40:e3:d6:da:ba:21,25993939,368,-176,25993571,25993939
5457,6,12,1,2412,-56,-92,36,40:e3:d6:da:ba:22,25994335,180,216,25994155,25994335
5458,6,12,1,2412,-56,-92,36,40:e3:d6:da:ba:24,25994758,176,247,25994582,25994758
5459,6,12,1,2412,-56,-92,36,40:e3:d6:da:ba:25,25994960,160,42,25994800,25994960
5460,6,12,1,2412,-84,-92,8,84:d4:7e:f2:42:25,25995787,160,667,25995627,25995787
5461,6,6,1,2412,-85,-92,7,84:d4:7e:f2:42:26,25995988,380,-179,25995608,25995988
5462,6,6,1,2412,-75,-92,17,e6:aa:ea:b7:4a:dd,26003416,408,7020,26003008,26003416
5463,6,12,1,2412,-86,-92,6,40:e3:d6:da:ca:c2,26009160,176,5568,26008984,26009160
5464,6,12,1,2412,-87,-92,5,40:e3:d6:da:ca:c3,26009388,180,48,26009208,26009388
5465,6,12,1,2412,-86,-92,6,40:e3:d6:da:ca:c4,26009594,172,34,26009422,26009594
5466,6,12,1,2412,-86,-92,6,40:e3:d6:da:ca:c5,26009801,156,51,26009645,26009801
5467,6,6,1,2412,-87,-92,5,40:e3:d6:da:ca:c6,26010016,380,-165,26009636,26010016
5468,6,6,1,2412,-75,-92,17,e6:aa:ea:b7:4a:dd,26015541,408,5117,26015133,26015541
5469,6,12,1,2412,-89,-92,3,,26016921,32,1348,26016889,26016921
5470,6,12,1,2412,-88,-92,4,,26019173,32,2220,26019141,26019173
5471,6,12,1,2412,-90,-92,2,,26019990,32,785,26019958,26019990
5472,6,6,1,2412,-83,-92,9,66:d8:ff:ae:5d:41,26020273,64,219,26020209,26020273
5473,6,24,1,2412,-85,-92,7,66:d8:ff:ae:5d:41,26025394,32,5089,26025362,26025394
5474,6,12,1,2412,-88,-92,4,,26025444,32,18,26025412,26025444
5475,6,24,1,2412,-86,-92,6,66:d8:ff:ae:5d:41,26026518,32,1042,26026486,26026518
5476,6,12,1,2412,-88,-92,4,,26026567,32,17,26026535,26026567
5477,6,6,1,2412,-75,-92,17,e6:aa:ea:b7:4a:dd,26027864,408,889,26027456,26027864
5478,6,12,1,2412,-90,-92,2,,26039481,32,11585,26039449,26039481
5479,6,6,1,2412,-75,-92,17,e6:aa:ea:b7:4a:dd,26039821,408,-68,26039413,26039821
5480,6,12,1,2412,-89,-92,3,40:e3:d6:da:c8:03,26040710,184,705,26040526,26040710
5481,6,12,1,2412,-89,-92,3,40:e3:d6:da:c8:05,26041215,160,345,26041055,26041215
5482,6,6,1,2412,-88,-92,4,40:e3:d6:da:c8:06,26041425,380,-170,26041045,26041425
5483,6,12,1,2412,-89,-92,3,,26046259,32,4802,26046227,26046259
5484,6,12,1,2412,-90,-92,2,,26051612,32,5321,26051580,26051612
5485,4,1,1,2412,-73,-92,19,54:e4:3a:ec:fb:64,26053046,2160,-726,26050886,26053046
5486,4,1,1,2412,-77,-92,15,b8:3a:5a:88:e6:e0,26080106,2360,24700,26077746,26080106
5487,4,1,1,2412,-73,-92,19,b8:3a:5a:88:e6:e1,26082885,2376,403,26080509,26082885
5488,6,12,1,2412,-89,-92,3,,26085289,32,2372,26085257,26085289
5489,6,12,1,2412,-89,-92,3,84:d4:7e:f2:34:20,26085347,160,-102,26085187,26085347
5490,6,24,1,2412,-85,-92,7,66:d8:ff:ae:5d:41,26085531,32,152,26085499,26085531
5491,6,12,1,2412,-89,-92,3,,26085581,32,18,26085549,26085581
5492,6,6,1,2412,-89,-92,3,84:d4:7e:f2:34:21,26085662,368,-287,26085294,26085662
5493,6,12,1,2412,-90,-92,2,84:d4:7e:f2:34:22,26086076,180,234,26085896,26086076
5494,6,12,1,2412,-88,-92,4,84:d4:7e:f2:34:23,26086300,180,44,26086120,26086300
5495,6,12,1,2412,-89,-92,3,84:d4:7e:f2:34:24,26086505,176,29,26086329,26086505
5496,6,6,1,2412,-91,-92,1,84:d4:7e:f2:34:26,26086907,380,22,26086527,26086907
5497,6,6,1,2412,-57,-92,35,e6:aa:ea:c9:ea:33,26091480,408,4165,26091072,26091480
5498,6,24,1,2412,-85,-92,7,66:d8:ff:ae:5d:41,26091944,32,432,26091912,26091944
5499,6,12,1,2412,-89,-92,3,,26091994,32,18,26091962,26091994
5500,6,12,1,2412,-57,-92,35,40:e3:d6:da:ba:20,26096152,160,3998,26095992,26096152
5501,6,6,1,2412,-57,-92,35,40:e3:d6:da:ba:21,26096344,368,-176,26095976,26096344
5502,6,12,1,2412,-57,-92,35,40:e3:d6:da:ba:23,26098744,184,2216,26098560,26098744
5503,6,12,1,2412,-57,-92,35,40:e3:d6:da:ba:24,26098954,176,34,26098778,26098954
5504,6,12,1,2412,-57,-92,35,40:e3:d6:da:ba:25,26099173,160,59,26099013,26099173
5505,6,6,1,2412,-56,-92,36,40:e3:d6:da:ba:26,26099383,380,-170,26099003,26099383
5506,6,6,1,2412,-57,-92,35,e6:aa:ea:c9:ea:33,26103604,408,3813,26103196,26103604
5507,6,12,1,2412,-85,-92,7,40:e3:d6:da:ca:c0,26110997,156,7237,26110841,26110997
5508,6,6,1,2412,-86,-92,6,40:e3:d6:da:ca:c1,26111204,368,-161,26110836,26111204
5509,6,12,1,2412,-87,-92,5,40:e3:d6:da:ca:c2,26111599,176,219,26111423,26111599
5510,6,12,1,2412,-88,-92,4,40:e3:d6:da:ca:c3,26111810,180,31,26111630,26111810
5511,6,12,1,2412,-87,-92,5,40:e3:d6:da:ca:c5,26112249,156,283,26112093,26112249
5512,6,6,1,2412,-87,-92,5,40:e3:d6:da:ca:c6,26112437,380,-192,26112057,26112437
5513,6,6,1,2412,-57,-92,35,e6:aa:ea:c9:ea:33,26127838,408,14993,26127430,26127838
5514,6,6,1,2412,-56,-92,36,e6:aa:ea:c9:ea:33,26139955,408,11709,26139547,26139955
5515,6,12,1,2412,-89,-92,3,40:e3:d6:da:c8:04,26143512,176,3381,26143336,26143512
5516,6,12,1,2412,-89,-92,3,40:e3:d6:da:c8:05,26143732,160,60,26143572,26143732
5517,4,1,1,2412,-79,-92,13,b8:3a:5a:88:e6:e1,26184885,2376,38777,26182509,26184885
5518,6,12,1,2412,-88,-92,4,84:d4:7e:f2:34:20,26187459,160,2414,26187299,26187459
5519,6,6,1,2412,-90,-92,2,84:d4:7e:f2:34:26,26188923,380,1084,26188543,26188923
5520,6,12,1,2412,-86,-92,6,40:e3:d6:da:bb:e0,26195212,156,6133,26195056,26195212
5521,6,12,1,2412,-86,-92,6,40:e3:d6:da:bb:e2,26195823,176,435,26195647,26195823
5522,6,12,1,2412,-86,-92,6,40:e3:d6:da:bb:e3,26196051,180,48,26195871,26196051
5523,6,12,1,2412,-85,-92,7,40:e3:d6:da:bb:e4,26196257,172,34,26196085,26196257
5524,6,6,1,2412,-80,-92,12,40:e3:d6:da:bb:e6,26196651,380,14,26196271,26196651
5525,6,12,1,2412,-57,-92,35,40:e3:d6:da:ba:20,26198553,160,1742,26198393,26198553
5526,6,12,1,2412,-57,-92,35,40:e3:d6:da:ba:22,26199159,180,426,26198979,26199159
5527,6,12,1,2412,-57,-92,35,40:e3:d6:da:ba:23,26199373,184,30,26199189,26199373
5528,6,12,1,2412,-58,-92,34,40:e3:d6:da:ba:24,26199601,176,52,26199425,26199601
5529,6,12,1,2412,-57,-92,35,40:e3:d6:da:ba:25,26199830,160,69,26199670,26199830
5530,6,6,1,2412,-57,-92,35,40:e3:d6:da:ba:26,26200030,380,-180,26199650,26200030
5531,6,12,1,2412,-87,-92,5,84:d4:7e:f2:42:25,26200606,160,416,26200446,26200606
5532,6,6,1,2412,-87,-92,5,84:d4:7e:f2:42:26,26200807,380,-179,26200427,26200807
5533,6,12,1,2412,-87,-92,5,40:e3:d6:da:ca:c0,26213375,156,12412,26213219,26213375
5534,6,12,1,2412,-86,-92,6,40:e3:d6:da:ca:c2,26213977,176,426,26213801,26213977
5535,6,12,1,2412,-87,-92,5,40:e3:d6:da:ca:c5,26214608,156,475,26214452,26214608
5536,6,6,1,2412,-87,-92,5,40:e3:d6:da:ca:c6,26214805,380,-183,26214425,26214805
5537,6,12,1,2412,-90,-92,2,40:e3:d6:da:c8:00,26244691,160,29726,26244531,26244691
5538,6,6,1,2412,-89,-92,3,40:e3:d6:da:c8:01,26244891,368,-168,26244523,26244891
5539,6,12,1,2412,-89,-92,3,40:e3:d6:da:c8:04,26245757,176,690,26245581,26245757
5540,6,12,1,2412,-88,-92,4,40:e3:d6:da:c8:05,26245976,160,59,26245816,26245976
5541,6,6,1,2412,-90,-92,2,40:e3:d6:da:c8:06,26246168,380,-188,26245788,26246168
5542,4,1,1,2412,-72,-92,20,54:e4:3a:ec:fb:64,26257894,2160,9566,26255734,26257894
5543,4,1,1,2412,-79,-92,13,b8:3a:5a:88:e6:e0,26285003,2360,24749,26282643,26285003
5544,4,1,1,2412,-75,-92,17,b8:3a:5a:88:e6:e1,26287391,2376,12,26285015,26287391
5545,6,6,1,2412,-88,-92,4,84:d4:7e:f2:34:21,26289795,368,2036,26289427,26289795
5546,6,12,1,2412,-87,-92,5,84:d4:7e:f2:34:22,26290234,180,259,26290054,26290234
5547,6,12,1,2412,-87,-92,5,84:d4:7e:f2:34:23,26290439,180,25,26290259,26290439
5548,6,12,1,2412,-87,-92,5,84:d4:7e:f2:34:24,26290654,176,39,26290478,26290654
5549,6,12,1,2412,-89,-92,3,84:d4:7e:f2:34:25,26290959,160,145,26290799,26290959
5550,6,6,1,2412,-88,-92,4,84:d4:7e:f2:34:26,26291178,380,-161,26290798,26291178
5551,6,6,1,2412,-86,-92,6,40:e3:d6:da:bb:e1,26297827,368,6281,26297459,26297827
5552,6,12,1,2412,-87,-92,5,40:e3:d6:da:bb:e2,26298223,176,220,26298047,26298223
5553,6,12,1,2412,-85,-92,7,40:e3:d6:da:bb:e3,26298442,180,39,26298262,26298442
5554,6,12,1,2412,-86,-92,6,40:e3:d6:da:bb:e4,26298657,172,43,26298485,26298657
5555,6,12,1,2412,-86,-92,6,40:e3:d6:da:bb:e5,26298873,156,60,26298717,26298873
5556,6,6,1,2412,-87,-92,5,40:e3:d6:da:bb:e6,26299079,380,-174,26298699,26299079
5557,6,12,1,2412,-58,-92,34,40:e3:d6:da:ba:20,26300938,160,1699,26300778,26300938
5558,6,12,1,2412,-57,-92,35,40:e3:d6:da:ba:22,26301562,180,444,26301382,26301562
5559,6,12,1,2412,-58,-92,34,40:e3:d6:da:ba:23,26301786,184,40,26301602,26301786
5560,6,12,1,2412,-58,-92,34,40:e3:d6:da:ba:24,26302022,176,60,26301846,26302022
5561,6,12,1,2412,-57,-92,35,40:e3:d6:da:ba:25,26302242,160,60,26302082,26302242
5562,6,6,1,2412,-57,-92,35,40:e3:d6:da:ba:26,26302433,380,-189,26302053,26302433
5563,6,12,1,2412,-85,-92,7,84:d4:7e:f2:42:25,26302973,160,380,26302813,26302973
5564,6,6,1,2412,-86,-92,6,84:d4:7e:f2:42:26,26303174,380,-179,26302794,26303174
5565,6,12,1,2412,-86,-92,6,40:e3:d6:da:ca:c0,26315793,156,12463,26315637,26315793
5566,6,12,1,2412,-87,-92,5,40:e3:d6:da:ca:c2,26316386,176,417,26316210,26316386
5567,6,12,1,2412,-87,-92,5,40:e3:d6:da:ca:c3,26316596,180,30,26316416,26316596
5568,6,12,1,2412,-87,-92,5,40:e3:d6:da:ca:c4,26316802,172,34,26316630,26316802
5569,6,12,1,2412,-85,-92,7,40:e3:d6:da:ca:c5,26317000,156,42,26316844,26317000
5570,4,1,1,2412,-78,-92,14,b8:3a:5a:88:e6:e0,26347251,2240,28011,26345011,26347251
5571,4,1,1,2412,-78,-92,14,b8:3a:5a:88:e6:e1,26349529,2256,22,26347273,26349529
5572,6,6,1,2412,-90,-92,2,40:e3:d6:da:c8:06,26352161,380,2252,26351781,26352161
5573,4,1,1,2412,-81,-92,11,c0:c9:e3:4d:6e:bf,26381921,872,28888,26381049,26381921
5574,4,1,1,2412,-82,-92,10,,26382810,304,585,26382506,26382810
5575,4,1,1,2412,-78,-92,14,b8:3a:5a:88:e6:e0,26387290,2360,2120,26384930,26387290
5576,4,1,1,2412,-77,-92,15,b8:3a:5a:88:e6:e1,26389749,2376,83,26387373,26389749
5577,6,12,1,2412,-87,-92,5,84:d4:7e:f2:34:25,26393627,160,3718,26393467,26393627
5578,6,6,1,2412,-88,-92,4,84:d4:7e:f2:34:26,26393837,380,-170,26393457,26393837
5579,6,12,1,2412,-88,-92,4,40:e3:d6:da:bb:e0,26400012,156,6019,26399856,26400012
5580,6,12,1,2412,-56,-92,36,40:e3:d6:da:ba:22,26403933,180,3741,26403753,26403933
5581,6,6,1,2412,-56,-92,36,40:e3:d6:da:ba:26,26404814,380,501,26404434,26404814
5582,6,12,1,2412,-85,-92,7,84:d4:7e:f2:42:24,26405196,176,206,26405020,26405196
5583,6,12,1,2412,-84,-92,8,84:d4:7e:f2:42:25,26405407,160,51,26405247,26405407
5584,6,6,1,2412,-87,-92,5,84:d4:7e:f2:42:26,26405617,380,-170,26405237,26405617
5585,6,6,1,2412,-88,-92,4,e6:aa:ea:c9:ea:1b,26408007,408,1982,26407599,26408007
5586,6,6,1,2412,-75,-92,17,e6:aa:ea:b7:4a:dd,26410561,408,2146,26410153,26410561
5587,6,6,1,2412,-75,-92,17,e6:aa:ea:b7:4a:dd,26434928,408,23959,26434520,26434928
5588,6,6,1,2412,-75,-92,17,e6:aa:ea:b7:4a:dd,26446916,408,11580,26446508,26446916
5589,6,6,1,2412,-88,-92,4,e6:aa:ea:c9:ea:1b,26456479,408,9155,26456071,26456479
5590,6,6,1,2412,-75,-92,17,e6:aa:ea:b7:4a:dd,26459042,408,2155,26458634,26459042
5591,4,1,1,2412,-72,-92,20,54:e4:3a:ec:fb:64,26462665,2160,1463,26460505,26462665
5592,4,1,1,2412,-77,-92,15,b8:3a:5a:88:e6:e1,26492069,2376,27028,26489693,26492069
5593,6,12,1,2412,-88,-92,4,84:d4:7e:f2:34:23,26494945,180,2696,26494765,26494945
5594,6,12,1,2412,-89,-92,3,84:d4:7e:f2:34:24,26495150,176,29,26494974,26495150
5595,6,12,1,2412,-89,-92,3,84:d4:7e:f2:34:25,26495369,160,59,26495209,26495369
5596,6,6,1,2412,-88,-92,4,84:d4:7e:f2:34:26,26495570,380,-179,26495190,26495570
5597,6,6,1,2412,-88,-92,4,40:e3:d6:da:bb:e6,26503867,380,7917,26503487,26503867
5598,6,12,1,2412,-54,-92,38,40:e3:d6:da:ba:20,26505749,160,1722,26505589,26505749
5599,6,6,1,2412,-55,-92,37,40:e3:d6:da:ba:21,26505941,368,-176,26505573,26505941
5600,6,12,1,2412,-55,-92,37,40:e3:d6:da:ba:22,26506346,180,225,26506166,26506346
5601,6,12,1,2412,-54,-92,38,40:e3:d6:da:ba:23,26506551,184,21,26506367,26506551
5602,6,12,1,2412,-54,-92,38,40:e3:d6:da:ba:24,26506778,176,51,26506602,26506778
5603,6,12,1,2412,-54,-92,38,40:e3:d6:da:ba:25,26506989,160,51,26506829,26506989
5604,6,6,1,2412,-54,-92,38,40:e3:d6:da:ba:26,26507208,380,-161,26506828,26507208
5605,6,12,1,2412,-83,-92,9,84:d4:7e:f2:42:25,26507774,160,406,26507614,26507774
5606,6,6,1,2412,-84,-92,8,84:d4:7e:f2:42:26,26507983,380,-171,26507603,26507983
5607,6,12,1,2412,-86,-92,6,40:e3:d6:da:ca:c0,26520590,156,12451,26520434,26520590
5608,6,6,1,2412,-87,-92,5,40:e3:d6:da:ca:c1,26520787,368,-171,26520419,26520787
5609,6,12,1,2412,-87,-92,5,40:e3:d6:da:ca:c2,26521192,176,229,26521016,26521192
5610,4,1,1,2412,-74,-92,18,a6:e5:7c:28:b1:d3,26552262,992,30078,26551270,26552262
5611,4,1,1,2412,-77,-92,15,b8:3a:5a:88:e6:e0,26555412,2240,910,26553172,26555412
5612,4,1,1,2412,-78,-92,14,b8:3a:5a:88:e6:e1,26557681,2256,13,26555425,26557681
5613,4,1,1,2412,-68,-92,24,54:e4:3a:ec:fb:64,26564693,2160,4852,26562533,26564693
5614,4,1,1,2412,-78,-92,14,b8:3a:5a:88:e6:e0,26592254,2360,25201,26589894,26592254
5615,4,1,1,2412,-79,-92,13,b8:3a:5a:88:e6:e1,26594643,2376,13,26592267,26594643
5616,6,12,1,2412,-89,-92,3,84:d4:7e:f2:34:20,26597194,160,2391,26597034,26597194
5617,6,12,1,2412,-88,-92,4,40:e3:d6:da:bb:e0,26604832,156,7482,26604676,26604832
5618,6,6,1,2412,-87,-92,5,40:e3:d6:da:bb:e1,26605020,368,-180,26604652,26605020
5619,6,12,1,2412,-87,-92,5,40:e3:d6:da:bb:e2,26605407,176,211,26605231,26605407
5620,6,12,1,2412,-88,-92,4,40:e3:d6:da:bb:e5,26606039,156,476,26605883,26606039
5621,6,6,1,2412,-88,-92,4,40:e3:d6:da:bb:e6,26606236,380,-183,26605856,26606236
5622,6,12,1,2412,-52,-92,40,40:e3:d6:da:ba:20,26608129,160,1733,26607969,26608129
5623,6,6,1,2412,-52,-92,40,40:e3:d6:da:ba:21,26608321,368,-176,26607953,26608321
5624,6,12,1,2412,-52,-92,40,40:e3:d6:da:ba:22,26608726,180,225,26608546,26608726
5625,6,12,1,2412,-52,-92,40,40:e3:d6:da:ba:23,26608931,184,21,26608747,26608931
5626,6,12,1,2412,-52,-92,40,40:e3:d6:da:ba:24,26609158,176,51,26608982,26609158
5627,6,12,1,2412,-52,-92,40,40:e3:d6:da:ba:25,26609360,160,42,26609200,26609360
5628,6,6,1,2412,-52,-92,40,40:e3:d6:da:ba:26,26609561,380,-179,26609181,26609561
5629,6,12,1,2412,-84,-92,8,84:d4:7e:f2:42:24,26609939,176,202,26609763,26609939
5630,6,12,1,2412,-84,-92,8,84:d4:7e:f2:42:25,26610149,160,50,26609989,26610149
5631,6,6,1,2412,-84,-92,8,84:d4:7e:f2:42:26,26610341,380,-188,26609961,26610341
5632,6,6,1,2412,-55,-92,37,e6:aa:ea:c9:ea:33,26611662,408,913,26611254,26611662
5633,6,6,1,2412,-56,-92,36,e6:aa:ea:c9:ea:33,26623784,408,11714,26623376,26623784
5634,6,12,1,2412,-85,-92,7,40:e3:d6:da:ca:c4,26624277,172,321,26624105,26624277
5635,6,12,1,2412,-86,-92,6,40:e3:d6:da:ca:c5,26624491,156,58,26624335,26624491
5636,6,6,1,2412,-55,-92,37,e6:aa:ea:c9:ea:33,26635904,408,11005,26635496,26635904
5637,6,6,1,2412,-55,-92,37,e6:aa:ea:c9:ea:33,26648019,408,11707,26647611,26648019
5638,4,1,1,2412,-64,-92,28,24:f6:77:10:02:c8,26655622,1064,6539,26654558,26655622
5639,6,6,1,2412,-56,-92,36,e6:aa:ea:c9:ea:33,26660225,408,4195,26659817,26660225
5640,4,1,1,2412,-67,-92,25,54:e4:3a:ec:fb:64,26667646,2160,5261,26665486,26667646
5641,4,1,1,2412,-65,-92,27,24:f6:77:10:02:c8,26669858,1064,1148,26668794,26669858
5642,4,1,1,2412,-62,-92,30,a4:e5:7c:28:b1:d3,26671979,688,1433,26671291,26671979
5643,4,1,1,2412,-80,-92,12,b8:3a:5a:88:e6:e0,26694494,2360,20155,26692134,26694494
5644,6,12,1,2412,-89,-92,3,84:d4:7e:f2:34:23,26699430,180,4756,26699250,26699430
5645,6,6,1,2412,-90,-92,2,84:d4:7e:f2:34:26,26700103,380,293,26699723,26700103
5646,6,12,1,2412,-89,-92,3,40:e3:d6:da:bb:e2,26707857,176,7578,26707681,26707857
5647,6,12,1,2412,-88,-92,4,40:e3:d6:da:bb:e3,26708077,180,40,26707897,26708077
5648,6,12,1,2412,-87,-92,5,40:e3:d6:da:bb:e5,26708525,156,292,26708369,26708525
5649,6,6,1,2412,-89,-92,3,40:e3:d6:da:bb:e6,26708739,380,-166,26708359,26708739
5650,6,12,1,2412,-51,-92,41,40:e3:d6:da:ba:20,26710528,160,1629,26710368,26710528
5651,6,6,1,2412,-51,-92,41,40:e3:d6:da:ba:21,26710720,368,-176,26710352,26710720
5652,6,12,1,2412,-51,-92,41,40:e3:d6:da:ba:22,26711107,180,207,26710927,26711107
5653,6,12,1,2412,-51,-92,41,40:e3:d6:da:ba:23,26711340,184,49,26711156,26711340
5654,6,12,1,2412,-51,-92,41,40:e3:d6:da:ba:24,26711576,176,60,26711400,26711576
5655,6,12,1,2412,-51,-92,41,40:e3:d6:da:ba:25,26711795,160,59,26711635,26711795
5656,6,6,1,2412,-51,-92,41,40:e3:d6:da:ba:26,26712005,380,-170,26711625,26712005
5657,6,12,1,2412,-87,-92,5,40:e3:d6:da:ca:c0,26725381,156,13220,26725225,26725381
5658,6,12,1,2412,-87,-92,5,40:e3:d6:da:ca:c3,26726194,180,633,26726014,26726194
5659,6,12,1,2412,-86,-92,6,40:e3:d6:da:ca:c4,26726426,172,60,26726254,26726426
5660,6,12,1,2412,-86,-92,6,40:e3:d6:da:ca:c5,26726623,156,41,26726467,26726623
5661,6,6,1,2412,-87,-92,5,40:e3:d6:da:ca:c6,26726839,380,-164,26726459,26726839
5662,6,6,1,2412,-74,-92,18,e6:aa:ea:b7:4a:dd,26737911,408,10664,26737503,26737911
5663,4,1,1,2412,-63,-92,29,24:f6:77:10:02:c8,26740393,1064,1418,26739329,26740393
5664,6,6,1,2412,-74,-92,18,e6:aa:ea:b7:4a:dd,26750025,408,9224,26749617,26750025
5665,4,1,1,2412,-75,-92,17,a6:e5:7c:28:b1:d3,26758092,992,7075,26757100,26758092
5666,6,6,1,2412,-75,-92,17,e6:aa:ea:b7:4a:dd,26762146,408,3646,26761738,26762146
5667,4,1,1,2412,-86,-92,6,,26764093,304,1643,26763789,26764093
5668,4,1,1,2412,-69,-92,23,54:e4:3a:ec:fb:64,26769881,2160,3628,26767721,26769881
5669,6,6,1,2412,-72,-92,20,e6:aa:ea:b7:4a:dd,26774266,408,3977,26773858,26774266
5670,6,12,1,2412,-86,-92,6,,26790849,44,16539,26790805,26790849
5671,4,1,1,2412,-83,-92,9,b8:3a:5a:88:e6:e0,26796978,2360,3769,26794618,26796978
5672,4,1,1,2412,-83,-92,9,b8:3a:5a:88:e6:e1,26799376,2376,22,26797000,26799376
5673,6,12,1,2412,-87,-92,5,40:e3:d6:da:ca:c3,26808364,156,8832,26808208,26808364
5674,6,12,1,2412,-87,-92,5,40:e3:d6:da:ca:c0,26808581,136,81,26808445,26808581
5675,6,6,1,2412,-86,-92,6,40:e3:d6:da:ca:c1,26808785,348,-144,26808437,26808785
5676,6,6,1,2412,-87,-92,5,40:e3:d6:da:bb:e1,26809810,368,657,26809442,26809810
5677,6,12,1,2412,-87,-92,5,40:e3:d6:da:bb:e2,26810197,176,211,26810021,26810197
5678,6,12,1,2412,-87,-92,5,40:e3:d6:da:bb:e3,26810398,180,21,26810218,26810398
5679,6,12,1,2412,-87,-92,5,40:e3:d6:da:bb:e4,26810604,172,34,26810432,26810604
5680,6,12,1,2412,-88,-92,4,40:e3:d6:da:bb:e5,26810801,156,41,26810645,26810801
5681,6,6,1,2412,-88,-92,4,40:e3:d6:da:bb:e6,26811016,380,-165,26810636,26811016
5682,6,12,1,2412,-52,-92,40,40:e3:d6:da:ba:20,26812941,160,1765,26812781,26812941
5683,6,6,1,2412,-52,-92,40,40:e3:d6:da:ba:21,26813133,368,-176,26812765,26813133
5684,6,12,1,2412,-52,-92,40,40:e3:d6:da:ba:22,26813529,180,216,26813349,26813529
5685,6,12,1,2412,-52,-92,40,40:e3:d6:da:ba:23,26813761,184,48,26813577,26813761
5686,6,12,1,2412,-52,-92,40,40:e3:d6:da:ba:24,26813998,176,61,26813822,26813998
5687,6,12,1,2412,-52,-92,40,40:e3:d6:da:ba:25,26814226,160,68,26814066,26814226
5688,6,12,1,2412,-84,-92,8,84:d4:7e:f2:42:25,26814966,160,580,26814806,26814966
5689,6,6,1,2412,-84,-92,8,84:d4:7e:f2:42:26,26815176,380,-170,26814796,26815176
5690,6,6,1,2412,-86,-92,6,e6:aa:ea:c9:ea:1b,26827554,408,11970,26827146,26827554
5691,6,12,1,2412,-89,-92,3,40:e3:d6:da:ca:c0,26828250,156,540,26828094,26828250
5692,6,6,1,2412,-87,-92,5,40:e3:d6:da:ca:c1,26828466,368,-152,26828098,26828466
5693,6,6,1,2412,-88,-92,4,a8:5b:f7:55:1a:40,26831743,72,3205,26831671,26831743
5694,6,6,1,2412,-87,-92,5,a8:5b:f7:55:1a:40,26832559,72,744,26832487,26832559
5695,6,6,1,2412,-89,-92,3,a8:5b:f7:55:1a:40,26832766,72,135,26832694,26832766
5696,6,6,1,2412,-87,-92,5,a8:5b:f7:55:1a:40,26832873,72,35,26832801,26832873
5697,6,6,1,2412,-88,-92,4,a8:5b:f7:55:1a:40,26833053,72,108,26832981,26833053
5698,6,6,1,2412,-89,-92,3,a8:5b:f7:55:1a:40,26833206,72,81,26833134,26833206
5699,6,6,1,2412,-88,-92,4,a8:5b:f7:55:1a:40,26833429,72,151,26833357,26833429
5700,6,12,1,2412,-85,-92,7,,26834059,32,598,26834027,26834059
5701,6,6,1,2412,-86,-92,6,e6:aa:ea:c9:ea:1b,26839676,408,5209,26839268,26839676
5702,6,6,1,2412,-87,-92,5,40:e3:d6:da:bb:e1,26850780,348,10756,26850432,26850780
5703,4,1,1,2412,-68,-92,24,54:e4:3a:ec:fb:64,26871890,2160,18950,26869730,26871890
5704,6,6,1,2412,-86,-92,6,e6:aa:ea:c9:ea:1b,26876023,408,3725,26875615,26876023
5705,4,1,1,2412,-82,-92,10,b8:3a:5a:88:e6:e0,26899300,2360,20917,26896940,26899300
5706,4,1,1,2412,-66,-92,26,b8:3a:5a:88:e6:e1,26901680,2376,4,26899304,26901680
5707,6,12,1,2412,-87,-92,5,84:d4:7e:f2:34:22,26904303,180,2443,26904123,26904303
5708,4,1,1,2412,-91,-92,1,,26905508,304,901,26905204,26905508
5709,6,12,1,2412,-88,-92,4,84:d4:7e:f2:34:25,26905972,160,304,26905812,26905972
5710,6,6,1,2412,-86,-92,6,84:d4:7e:f2:34:26,26906163,380,-189,26905783,26906163
5711,6,12,1,2412,-86,-92,6,,26906907,32,712,26906875,26906907
5712,6,12,1,2412,-87,-92,5,40:e3:d6:da:bb:e0,26912336,156,5273,26912180,26912336
5713,6,12,1,2412,-55,-92,37,40:e3:d6:da:ba:22,26915979,180,3463,26915799,26915979
5714,6,12,1,2412,-55,-92,37,40:e3:d6:da:ba:23,26916212,184,49,26916028,26916212
5715,6,12,1,2412,-55,-92,37,40:e3:d6:da:ba:24,26916430,176,42,26916254,26916430
5716,6,12,1,2412,-55,-92,37,40:e3:d6:da:ba:25,26916631,160,41,26916471,26916631
5717,6,6,1,2412,-55,-92,37,40:e3:d6:da:ba:26,26916850,380,-161,26916470,26916850
5718,4,1,1,2412,-75,-92,17,,26917616,304,462,26917312,26917616
5719,4,1,1,2412,-68,-92,24,54:e4:3a:ec:fb:64,26974658,2160,54882,26972498,26974658
5720,4,1,1,2412,-80,-92,12,b8:3a:5a:88:e6:e0,27001713,2360,24695,26999353,27001713
5721,6,12,1,2412,-86,-92,6,84:d4:7e:f2:34:24,27007860,176,5971,27007684,27007860
5722,6,6,1,2412,-87,-92,5,,27008163,44,259,27008119,27008163
5723,6,12,1,2412,-86,-92,6,84:d4:7e:f2:34:25,27008253,160,-70,27008093,27008253
5724,6,6,1,2412,-85,-92,7,84:d4:7e:f2:34:26,27008463,380,-170,27008083,27008463
5725,6,12,1,2412,-85,-92,7,,27008871,36,372,27008835,27008871
5726,6,12,1,2412,-87,-92,5,,27008924,32,21,27008892,27008924
5727,6,12,1,2412,-88,-92,4,,27009058,44,90,27009014,27009058
5728,6,6,1,2412,-88,-92,4,40:e3:d6:da:bb:e1,27014623,368,5197,27014255,27014623
5729,6,12,1,2412,-88,-92,4,40:e3:d6:da:bb:e2,27015027,176,228,27014851,27015027
5730,6,12,1,2412,-86,-92,6,40:e3:d6:da:bb:e3,27015247,180,40,27015067,27015247
5731,6,12,1,2412,-56,-92,36,40:e3:d6:da:ba:20,27017736,160,2329,27017576,27017736
5732,6,6,1,2412,-56,-92,36,40:e3:d6:da:ba:21,27017955,368,-149,27017587,27017955
5733,6,12,1,2412,-56,-92,36,40:e3:d6:da:ba:22,27018350,180,215,27018170,27018350
5734,6,12,1,2412,-57,-92,35,40:e3:d6:da:ba:23,27018565,184,31,27018381,27018565
5735,6,12,1,2412,-56,-92,36,40:e3:d6:da:ba:24,27018801,176,60,27018625,27018801
5736,6,12,1,2412,-56,-92,36,40:e3:d6:da:ba:25,27019012,160,51,27018852,27019012
5737,6,6,1,2412,-47,-92,45,40:e3:d6:da:ba:26,27019222,380,-170,27018842,27019222
5738,6,6,1,2412,-85,-92,7,84:d4:7e:f2:42:26,27019994,380,392,27019614,27019994
5739,6,12,1,2412,-87,-92,5,40:e3:d6:da:ca:c3,27033374,180,13200,27033194,27033374
5740,6,12,1,2412,-86,-92,6,40:e3:d6:da:ca:c4,27033597,172,51,27033425,27033597
5741,6,12,1,2412,-87,-92,5,,27035774,32,2145,27035742,27035774
5742,6,12,1,2412,-89,-92,3,40:e3:d6:da:c8:02,27064494,180,28540,27064314,27064494
5743,6,12,1,2412,-90,-92,2,40:e3:d6:da:c8:04,27064944,176,274,27064768,27064944
5744,4,1,1,2412,-61,-92,31,22:53:47:b4:a6:07,27077196,1152,11100,27076044,27077196
5745,6,12,1,2412,-56,-92,36,40:e3:d6:da:ba:20,27080172,136,2840,27080036,27080172
5746,6,6,1,2412,-56,-92,36,40:e3:d6:da:ba:21,27080376,348,-144,27080028,27080376
5747,6,12,1,2412,-56,-92,36,40:e3:d6:da:ba:22,27080770,156,238,27080614,27080770
5748,6,12,1,2412,-56,-92,36,40:e3:d6:da:ba:23,27080969,156,43,27080813,27080969
5749,6,12,1,2412,-63,-92,29,,27081142,32,141,27081110,27081142
5750,4,1,1,2412,-76,-92,16,b8:3a:5a:88:e6:e0,27104092,2360,20590,27101732,27104092
5751,6,12,1,2412,-85,-92,7,84:d4:7e:f2:34:20,27108161,160,3909,27108001,27108161
5752,6,6,1,2412,-85,-92,7,84:d4:7e:f2:34:21,27108380,368,-149,27108012,27108380
5753,6,12,1,2412,-84,-92,8,84:d4:7e:f2:34:22,27108786,180,226,27108606,27108786
5754,6,12,1,2412,-83,-92,9,84:d4:7e:f2:34:23,27109018,180,52,27108838,27109018
5755,6,12,1,2412,-85,-92,7,84:d4:7e:f2:34:24,27109250,176,56,27109074,27109250
5756,6,12,1,2412,-84,-92,8,84:d4:7e:f2:34:25,27109452,160,42,27109292,27109452
5757,6,6,1,2412,-85,-92,7,84:d4:7e:f2:34:26,27109661,380,-171,27109281,27109661
5758,6,12,1,2412,-86,-92,6,,27111555,32,1862,27111523,27111555
5759,6,6,1,2412,-87,-92,5,40:e3:d6:da:bb:e6,27118368,380,6433,27117988,27118368
5760,6,12,1,2412,-56,-92,36,40:e3:d6:da:ba:20,27120130,160,1602,27119970,27120130
5761,6,6,1,2412,-56,-92,36,40:e3:d6:da:ba:21,27120322,368,-176,27119954,27120322
5762,6,12,1,2412,-56,-92,36,40:e3:d6:da:ba:22,27120709,180,207,27120529,27120709
5763,6,12,1,2412,-56,-92,36,40:e3:d6:da:ba:23,27120923,184,30,27120739,27120923
5764,6,12,1,2412,-56,-92,36,40:e3:d6:da:ba:24,27121142,176,43,27120966,27121142
5765,6,12,1,2412,-56,-92,36,40:e3:d6:da:ba:25,27121370,160,68,27121210,27121370
5766,6,6,1,2412,-56,-92,36,40:e3:d6:da:ba:26,27121571,380,-179,27121191,27121571
5767,6,12,1,2412,-85,-92,7,84:d4:7e:f2:42:23,27124255,180,2504,27124075,27124255
5768,6,6,1,2412,-50,-92,42,e6:aa:ea:c9:ea:33,27131195,408,6532,27130787,27131195
5769,6,12,1,2412,-86,-92,6,40:e3:d6:da:ca:c0,27134973,156,3622,27134817,27134973
5770,6,6,1,2412,-50,-92,42,e6:aa:ea:c9:ea:33,27143326,408,7945,27142918,27143326
5771,6,12,1,2412,-85,-92,7,,27149434,32,6076,27149402,27149434
5772,6,6,1,2412,-49,-92,43,e6:aa:ea:c9:ea:33,27155438,408,5596,27155030,27155438
5773,6,12,1,2412,-89,-92,3,40:e3:d6:da:c8:02,27166895,180,11277,27166715,27166895
5774,6,6,1,2412,-49,-92,43,e6:aa:ea:c9:ea:33,27167562,408,259,27167154,27167562
5775,6,12,1,2412,-87,-92,5,,27174069,32,6475,27174037,27174069
5776,6,12,1,2412,-87,-92,5,,27174704,32,603,27174672,27174704
5777,6,12,1,2412,-87,-92,5,,27175712,32,976,27175680,27175712
5778,6,12,1,2412,-85,-92,7,84:d4:7e:f2:34:20,27211466,160,35594,27211306,27211466
5779,6,12,1,2412,-84,-92,8,84:d4:7e:f2:34:22,27212081,180,435,27211901,27212081
5780,6,12,1,2412,-84,-92,8,84:d4:7e:f2:34:23,27212296,180,35,27212116,27212296
5781,6,12,1,2412,-85,-92,7,84:d4:7e:f2:34:25,27212738,160,282,27212578,27212738
5782,6,6,1,2412,-85,-92,7,84:d4:7e:f2:34:26,27212948,380,-170,27212568,27212948
5783,6,6,1,2412,-86,-92,6,66:d8:ff:ae:5d:41,27213648,64,636,27213584,27213648
5784,6,6,1,2412,-85,-92,7,,27213729,44,37,27213685,27213729
5785,6,12,1,2412,-88,-92,4,,27213940,32,179,27213908,27213940
5786,6,12,1,2412,-87,-92,5,40:e3:d6:da:bb:e0,27219216,156,5120,27219060,27219216
5787,6,12,1,2412,-87,-92,5,40:e3:d6:da:bb:e2,27219827,176,435,27219651,27219827
5788,6,12,1,2412,-88,-92,4,40:e3:d6:da:bb:e3,27220056,180,49,27219876,27220056
5789,6,12,1,2412,-87,-92,5,40:e3:d6:da:bb:e4,27220262,172,34,27220090,27220262
5790,6,12,1,2412,-87,-92,5,40:e3:d6:da:bb:e5,27220468,156,50,27220312,27220468
5791,6,6,1,2412,-87,-92,5,40:e3:d6:da:bb:e6,27220656,380,-192,27220276,27220656
5792,6,12,1,2412,-57,-92,35,40:e3:d6:da:ba:20,27222535,160,1719,27222375,27222535
5793,6,12,1,2412,-57,-92,35,40:e3:d6:da:ba:22,27223132,180,417,27222952,27223132
5794,6,12,1,2412,-56,-92,36,40:e3:d6:da:ba:24,27223555,176,247,27223379,27223555
5795,6,6,1,2412,-57,-92,35,40:e3:d6:da:ba:26,27224003,380,68,27223623,27224003
5796,6,6,1,2412,-84,-92,8,84:d4:7e:f2:42:26,27224803,380,420,27224423,27224803
5797,6,6,1,2412,-71,-92,21,e6:aa:ea:b7:4a:dd,27245329,408,20118,27244921,27245329
5798,6,12,1,2412,-87,-92,5,,27251266,32,5905,27251234,27251266
5799,6,12,1,2412,-88,-92,4,40:e3:d6:da:c8:00,27268698,160,17272,27268538,27268698
5800,6,6,1,2412,-87,-92,5,40:e3:d6:da:c8:01,27268909,368,-157,27268541,27268909
5801,6,12,1,2412,-88,-92,4,40:e3:d6:da:c8:02,27269323,180,234,27269143,27269323
5802,6,6,1,2412,-71,-92,21,e6:aa:ea:b7:4a:dd,27269566,408,-165,27269158,27269566
5803,6,12,1,2412,-89,-92,3,40:e3:d6:da:c8:05,27269974,160,248,27269814,27269974
5804,6,6,1,2412,-88,-92,4,40:e3:d6:da:c8:06,27270167,380,-187,27269787,27270167
5805,4,1,1,2412,-68,-92,24,54:e4:3a:ec:fb:64,27281624,2160,9297,27279464,27281624
5806,6,6,1,2412,-88,-92,4,e6:aa:ea:c9:ea:1b,27295780,408,13748,27295372,27295780
5807,4,1,1,2412,-86,-92,6,,27297229,304,1145,27296925,27297229
5808,4,1,1,2412,-75,-92,17,b8:3a:5a:88:e6:e0,27308887,2360,9298,27306527,27308887
5809,4,1,1,2412,-74,-92,18,b8:3a:5a:88:e6:e1,27311294,2376,31,27308918,27311294
5810,6,12,1,2412,-87,-92,5,84:d4:7e:f2:34:20,27313854,160,2400,27313694,27313854
5811,6,6,1,2412,-86,-92,6,84:d4:7e:f2:34:21,27314055,368,-167,27313687,27314055
5812,6,12,1,2412,-84,-92,8,84:d4:7e:f2:34:22,27314450,180,215,27314270,27314450
5813,6,12,1,2412,-87,-92,5,84:d4:7e:f2:34:23,27314683,180,53,27314503,27314683
5814,6,12,1,2412,-86,-92,6,84:d4:7e:f2:34:24,27314994,176,135,27314818,27314994
5815,6,12,1,2412,-86,-92,6,84:d4:7e:f2:34:25,27315222,160,68,27315062,27315222
5816,4,1,1,2412,-73,-92,19,a6:e5:7c:28:b1:d3,27320764,944,4598,27319820,27320764
5817,4,1,1,2412,-80,-92,12,,27321718,304,650,27321414,27321718
5818,6,12,1,2412,-80,-92,12,,27323286,32,1536,27323254,27323286
5819,6,12,1,2412,-54,-92,38,40:e3:d6:da:ba:20,27324944,160,1498,27324784,27324944
5820,6,6,1,2412,-54,-92,38,40:e3:d6:da:ba:21,27325145,368,-167,27324777,27325145
5821,6,12,1,2412,-54,-92,38,40:e3:d6:da:ba:22,27325550,180,225,27325370,27325550
5822,6,12,1,2412,-54,-92,38,40:e3:d6:da:ba:24,27325992,176,266,27325816,27325992
5823,6,12,1,2412,-54,-92,38,40:e3:d6:da:ba:25,27326211,160,59,27326051,27326211
5824,6,6,1,2412,-54,-92,38,40:e3:d6:da:ba:26,27326430,380,-161,27326050,27326430
5825,6,6,1,2412,-86,-92,6,84:d4:7e:f2:42:26,27327177,380,367,27326797,27327177
5826,6,12,1,2412,-84,-92,8,,27340216,32,13007,27340184,27340216
5827,6,12,1,2412,-89,-92,3,40:e3:d6:da:ca:c0,27341769,156,1397,27341613,27341769
5828,6,6,1,2412,-84,-92,8,40:e3:d6:da:ca:c1,27341984,368,-153,27341616,27341984
5829,6,12,1,2412,-87,-92,5,40:e3:d6:da:ca:c2,27342371,176,211,27342195,27342371
5830,6,12,1,2412,-84,-92,8,,27357488,36,15081,27357452,27357488
5831,4,1,1,2412,-79,-92,13,c0:c9:e3:4d:6e:bf,27366820,872,8460,27365948,27366820
5832,6,12,1,2412,-85,-92,7,40:e3:d6:da:c8:00,27371102,160,4122,27370942,27371102
5833,6,6,1,2412,-78,-92,14,a0:59:50:b4:3a:a2,27381404,188,10114,27381216,27381404
5834,6,6,1,2412,-84,-92,8,,27381611,44,163,27381567,27381611
5835,6,6,1,2412,-79,-92,13,,27382568,44,913,27382524,27382568
5836,6,6,1,2412,-78,-92,14,,27383011,44,399,27382967,27383011
5837,6,12,1,2412,-78,-92,14,,27383261,32,218,27383229,27383261
5838,6,12,1,2412,-79,-92,13,,27383484,32,191,27383452,27383484
5839,4,1,1,2412,-71,-92,21,54:e4:3a:ec:fb:64,27383885,2160,-1759,27381725,27383885
5840,4,1,1,2412,-76,-92,16,,27422735,304,38546,27422431,27422735
5841,6,6,1,2412,-84,-92,8,40:e3:d6:da:bb:e1,27424232,368,1129,27423864,27424232
5842,6,12,1,2412,-85,-92,7,40:e3:d6:da:bb:e2,27424636,176,228,27424460,27424636
5843,6,12,1,2412,-87,-92,5,40:e3:d6:da:bb:e3,27424865,180,49,27424685,27424865
5844,6,12,1,2412,-85,-92,7,40:e3:d6:da:bb:e4,27425079,172,42,27424907,27425079
5845,6,12,1,2412,-85,-92,7,40:e3:d6:da:bb:e5,27425276,156,41,27425120,27425276
5846,6,6,1,2412,-86,-92,6,40:e3:d6:da:bb:e6,27425502,380,-154,27425122,27425502
5847,6,12,1,2412,-53,-92,39,40:e3:d6:da:ba:20,27427332,160,1670,27427172,27427332
5848,6,6,1,2412,-53,-92,39,40:e3:d6:da:ba:21,27427524,368,-176,27427156,27427524
5849,6,12,1,2412,-53,-92,39,40:e3:d6:da:ba:22,27427920,180,216,27427740,27427920
5850,6,12,1,2412,-53,-92,39,40:e3:d6:da:ba:23,27428125,184,21,27427941,27428125
5851,6,12,1,2412,-53,-92,39,40:e3:d6:da:ba:24,27428335,176,34,27428159,27428335
5852,6,12,1,2412,-53,-92,39,40:e3:d6:da:ba:25,27428563,160,68,27428403,27428563
5853,6,12,1,2412,-87,-92,5,84:d4:7e:f2:42:24,27429201,176,462,27429025,27429201
5854,6,6,1,2412,-88,-92,4,84:d4:7e:f2:42:26,27429630,380,49,27429250,27429630
5855,6,12,1,2412,-87,-92,5,40:e3:d6:da:ca:c4,27443895,172,14093,27443723,27443895
5856,6,6,1,2412,-88,-92,4,40:e3:d6:da:ca:c6,27444335,380,60,27443955,27444335
5857,4,1,1,2412,-80,-92,12,a6:e5:7c:28:b1:d3,27494518,944,49239,27493574,27494518
5858,4,1,1,2412,-69,-92,23,a6:e5:7c:28:b1:d3,27495614,944,152,27494670,27495614
5859,4,1,1,2412,-77,-92,15,a6:e5:7c:28:b1:d3,27496674,944,116,27495730,27496674
5860,4,1,1,2412,-79,-92,13,a6:e5:7c:28:b1:d3,27497725,944,107,27496781,27497725
5861,4,1,1,2412,-81,-92,11,a6:e5:7c:28:b1:d3,27498776,944,107,27497832,27498776
5862,4,1,1,2412,-79,-92,13,a6:e5:7c:28:b1:d3,27502046,944,2326,27501102,27502046
5863,4,1,1,2412,-80,-92,12,a6:e5:7c:28:b1:d3,27503160,944,170,27502216,27503160
5864,4,1,1,2412,-79,-92,13,a6:e5:7c:28:b1:d3,27505307,944,1203,27504363,27505307
5865,4,1,1,2412,-75,-92,17,b8:3a:5a:88:e6:e1,27516153,2376,8470,27513777,27516153
5866,6,12,1,2412,-85,-92,7,84:d4:7e:f2:34:20,27518713,160,2400,27518553,27518713
5867,6,12,1,2412,-87,-92,5,84:d4:7e:f2:34:22,27519447,180,554,27519267,27519447
5868,6,12,1,2412,-88,-92,4,84:d4:7e:f2:34:24,27519984,176,361,27519808,27519984
5869,6,12,1,2412,-87,-92,5,84:d4:7e:f2:34:25,27520203,160,59,27520043,27520203
5870,6,6,1,2412,-88,-92,4,84:d4:7e:f2:34:26,27520395,380,-188,27520015,27520395
5871,6,12,1,2412,-84,-92,8,40:e3:d6:da:bb:e0,27526438,156,5887,27526282,27526438
5872,6,12,1,2412,-85,-92,7,40:e3:d6:da:bb:e3,27527269,180,651,27527089,27527269
5873,6,12,1,2412,-87,-92,5,40:e3:d6:da:bb:e4,27527501,172,60,27527329,27527501
5874,6,12,1,2412,-88,-92,4,40:e3:d6:da:bb:e5,27527717,156,60,27527561,27527717
5875,6,6,1,2412,-86,-92,6,40:e3:d6:da:bb:e6,27527904,380,-193,27527524,27527904
5876,6,12,1,2412,-54,-92,38,40:e3:d6:da:ba:20,27529739,160,1675,27529579,27529739
5877,6,6,1,2412,-54,-92,38,40:e3:d6:da:ba:21,27529949,368,-158,27529581,27529949
5878,6,12,1,2412,-54,-92,38,40:e3:d6:da:ba:22,27530345,180,216,27530165,27530345
5879,6,12,1,2412,-54,-92,38,40:e3:d6:da:ba:24,27530805,176,284,27530629,27530805
5880,6,6,1,2412,-54,-92,38,40:e3:d6:da:ba:26,27531234,380,49,27530854,27531234
5881,6,12,1,2412,-87,-92,5,40:e3:d6:da:ca:c4,27545630,172,14224,27545458,27545630
5882,6,6,1,2412,-54,-92,38,e6:aa:ea:c9:ea:33,27564014,408,17976,27563606,27564014
5883,6,6,1,2412,-54,-92,38,e6:aa:ea:c9:ea:33,27572811,408,8389,27572403,27572811
5884,6,12,1,2412,-90,-92,2,40:e3:d6:da:c8:03,27576724,184,3729,27576540,27576724
5885,6,12,1,2412,-90,-92,2,40:e3:d6:da:c8:04,27576934,176,34,27576758,27576934
5886,6,6,1,2412,-77,-92,15,e6:aa:ea:b7:4a:dd,27584574,408,7232,27584166,27584574
5887,6,6,1,2412,-53,-92,39,e6:aa:ea:c9:ea:33,27585017,408,35,27584609,27585017
5888,4,1,1,2412,-70,-92,22,54:e4:3a:ec:fb:64,27589062,2160,1885,27586902,27589062
5889,6,6,1,2412,-52,-92,40,e6:aa:ea:c9:ea:33,27597495,408,8025,27597087,27597495
5890,6,6,1,2412,-79,-92,13,e6:aa:ea:b7:4a:dd,27608825,408,10922,27608417,27608825
5891,4,1,1,2412,-81,-92,11,b8:3a:5a:88:e6:e1,27618467,2376,7266,27616091,27618467
5892,6,12,1,2412,-86,-92,6,40:e3:d6:da:bb:e5,27630088,156,11465,27629932,27630088
5893,6,6,1,2412,-87,-92,5,40:e3:d6:da:bb:e6,27630285,380,-183,27629905,27630285
5894,6,12,1,2412,-59,-92,33,40:e3:d6:da:ba:20,27632140,160,1695,27631980,27632140
5895,6,6,1,2412,-60,-92,32,40:e3:d6:da:ba:21,27632332,368,-176,27631964,27632332
5896,6,12,1,2412,-60,-92,32,40:e3:d6:da:ba:22,27632746,180,234,27632566,27632746
5897,6,12,1,2412,-59,-92,33,40:e3:d6:da:ba:23,27632969,184,39,27632785,27632969
5898,6,12,1,2412,-59,-92,33,40:e3:d6:da:ba:24,27633206,176,61,27633030,27633206
5899,6,12,1,2412,-59,-92,33,40:e3:d6:da:ba:25,27633407,160,41,27633247,27633407
5900,6,6,1,2412,-59,-92,33,40:e3:d6:da:ba:26,27633626,380,-161,27633246,27633626
5901,6,12,1,2412,-85,-92,7,84:d4:7e:f2:42:25,27634215,160,429,27634055,27634215
5902,6,6,1,2412,-84,-92,8,84:d4:7e:f2:42:26,27634425,380,-170,27634045,27634425
5903,6,12,1,2412,-88,-92,4,40:e3:d6:da:c8:00,27678308,160,43723,27678148,27678308
5904,6,6,1,2412,-90,-92,2,40:e3:d6:da:c8:01,27678509,368,-167,27678141,27678509
5905,6,12,1,2412,-89,-92,3,40:e3:d6:da:c8:03,27679110,184,417,27678926,27679110
5906,6,12,1,2412,-89,-92,3,40:e3:d6:da:c8:05,27679566,160,296,27679406,27679566
5907,6,6,1,2412,-89,-92,3,40:e3:d6:da:c8:06,27679776,380,-170,27679396,27679776
5908,6,12,1,2412,-86,-92,6,40:e3:d6:da:bb:e0,27686562,136,6650,27686426,27686562
5909,6,12,1,2412,-87,-92,5,40:e3:d6:da:bb:e5,27687558,136,860,27687422,27687558
5910,4,1,1,2412,-73,-92,19,54:e4:3a:ec:fb:64,27693366,2160,3648,27691206,27693366
5911,4,1,1,2412,-79,-92,13,b8:3a:5a:88:e6:e0,27718515,2360,22789,27716155,27718515
5912,6,12,1,2412,-85,-92,7,40:e3:d6:da:bb:e0,27731240,156,12569,27731084,27731240
5913,6,6,1,2412,-85,-92,7,40:e3:d6:da:bb:e1,27731446,368,-162,27731078,27731446
5914,6,12,1,2412,-86,-92,6,40:e3:d6:da:bb:e3,27732088,180,462,27731908,27732088
5915,6,6,1,2412,-85,-92,7,40:e3:d6:da:bb:e6,27732733,380,265,27732353,27732733
5916,6,6,1,2412,-55,-92,37,40:e3:d6:da:ba:21,27734756,368,1655,27734388,27734756
5917,6,12,1,2412,-55,-92,37,40:e3:d6:da:ba:22,27735170,180,234,27734990,27735170
5918,6,12,1,2412,-55,-92,37,40:e3:d6:da:ba:23,27735403,184,49,27735219,27735403
5919,6,12,1,2412,-55,-92,37,40:e3:d6:da:ba:24,27735612,176,33,27735436,27735612
5920,6,12,1,2412,-55,-92,37,40:e3:d6:da:ba:25,27735840,160,68,27735680,27735840
5921,6,6,1,2412,-55,-92,37,40:e3:d6:da:ba:26,27736032,380,-188,27735652,27736032
5922,6,12,1,2412,-86,-92,6,84:d4:7e:f2:42:25,27736621,160,429,27736461,27736621
5923,6,6,1,2412,-85,-92,7,84:d4:7e:f2:42:26,27736822,380,-179,27736442,27736822
5924,6,12,1,2412,-86,-92,6,40:e3:d6:da:ca:c0,27749443,156,12465,27749287,27749443
5925,6,6,1,2412,-86,-92,6,40:e3:d6:da:ca:c1,27749631,368,-180,27749263,27749631
5926,6,12,1,2412,-84,-92,8,40:e3:d6:da:ca:c2,27750050,176,243,27749874,27750050
5927,6,12,1,2412,-87,-92,5,40:e3:d6:da:ca:c3,27750260,180,30,27750080,27750260
5928,6,12,1,2412,-87,-92,5,40:e3:d6:da:c8:03,27781550,184,31106,27781366,27781550
5929,4,1,1,2412,-73,-92,19,54:e4:3a:ec:fb:64,27793482,2160,9772,27791322,27793482
5930,6,12,1,2412,-85,-92,7,40:e3:d6:da:bb:e2,27795807,156,2169,27795651,27795807
5931,6,12,1,2412,-84,-92,8,40:e3:d6:da:bb:e3,27795998,156,35,27795842,27795998
5932,6,12,1,2412,-86,-92,6,40:e3:d6:da:bb:e5,27796207,136,73,27796071,27796207
5933,4,1,1,2412,-78,-92,14,b8:3a:5a:88:e6:e1,27823296,2376,24713,27820920,27823296
5934,6,12,1,2412,-85,-92,7,84:d4:7e:f2:34:20,27825838,160,2382,27825678,27825838
5935,6,6,1,2412,-86,-92,6,84:d4:7e:f2:34:21,27826039,368,-167,27825671,27826039
5936,6,12,1,2412,-85,-92,7,84:d4:7e:f2:34:22,27826444,180,225,27826264,27826444
5937,6,12,1,2412,-85,-92,7,84:d4:7e:f2:34:23,27826676,180,52,27826496,27826676
5938,6,12,1,2412,-84,-92,8,84:d4:7e:f2:34:24,27826909,176,57,27826733,27826909
5939,6,12,1,2412,-85,-92,7,84:d4:7e:f2:34:25,27827119,160,50,27826959,27827119
5940,6,6,1,2412,-87,-92,5,84:d4:7e:f2:34:26,27827338,380,-161,27826958,27827338
5941,6,6,1,2412,-87,-92,5,40:e3:d6:da:bb:e1,27833843,368,6137,27833475,27833843
5942,6,12,1,2412,-86,-92,6,40:e3:d6:da:bb:e2,27834248,176,229,27834072,27834248
5943,6,12,1,2412,-87,-92,5,40:e3:d6:da:bb:e5,27834888,156,484,27834732,27834888
5944,6,12,1,2412,-55,-92,37,40:e3:d6:da:ba:24,27837983,176,2919,27837807,27837983
5945,6,12,1,2412,-55,-92,37,40:e3:d6:da:ba:25,27838202,160,59,27838042,27838202
5946,6,6,1,2412,-55,-92,37,40:e3:d6:da:ba:26,27838421,380,-161,27838041,27838421
5947,6,12,1,2412,-85,-92,7,40:e3:d6:da:ca:c0,27851780,156,13203,27851624,27851780
5948,6,6,1,2412,-86,-92,6,40:e3:d6:da:ca:c1,27851976,368,-172,27851608,27851976
5949,6,12,1,2412,-87,-92,5,40:e3:d6:da:ca:c2,27852381,176,229,27852205,27852381
5950,6,12,1,2412,-88,-92,4,40:e3:d6:da:c8:00,27883103,160,30562,27882943,27883103
5951,6,12,1,2412,-85,-92,7,40:e3:d6:da:c8:05,27884380,160,1117,27884220,27884380
5952,6,6,1,2412,-87,-92,5,40:e3:d6:da:c8:06,27884581,380,-179,27884201,27884581
5953,4,1,1,2412,-73,-92,19,54:e4:3a:ec:fb:64,27895925,2160,9184,27893765,27895925
5954,4,1,1,2412,-77,-92,15,c0:c9:e3:4d:6e:bf,27901887,872,5090,27901015,27901887
5955,4,1,1,2412,-84,-92,8,,27902777,304,586,27902473,27902777
5956,4,1,1,2412,-78,-92,14,b8:3a:5a:88:e6:e0,27923298,2360,18161,27920938,27923298
5957,4,1,1,2412,-79,-92,13,b8:3a:5a:88:e6:e1,27925678,2376,4,27923302,27925678
5958,6,12,1,2412,-81,-92,11,84:d4:7e:f2:34:20,27928066,160,2228,27927906,27928066
5959,6,6,1,2412,-81,-92,11,84:d4:7e:f2:34:21,27928285,368,-149,27927917,27928285
5960,6,12,1,2412,-81,-92,11,84:d4:7e:f2:34:22,27928690,180,225,27928510,27928690
5961,6,6,1,2412,-81,-92,11,84:d4:7e:f2:34:26,27929566,380,496,27929186,27929566
5962,6,6,1,2412,-84,-92,8,66:d8:ff:ae:5d:41,27929954,64,324,27929890,27929954
5963,6,6,1,2412,-81,-92,11,,27930035,44,37,27929991,27930035
5964,6,12,1,2412,-81,-92,11,,27930125,36,54,27930089,27930125
5965,6,12,1,2412,-84,-92,8,,27930178,32,21,27930146,27930178
5966,6,12,1,2412,-84,-92,8,,27930313,44,91,27930269,27930313
5967,6,12,1,2412,-87,-92,5,40:e3:d6:da:bb:e2,27936631,176,6142,27936455,27936631
5968,6,12,1,2412,-89,-92,3,40:e3:d6:da:bb:e3,27936842,180,31,27936662,27936842
5969,6,12,1,2412,-88,-92,4,40:e3:d6:da:bb:e4,27937056,172,42,27936884,27937056
5970,6,12,1,2412,-86,-92,6,40:e3:d6:da:bb:e5,27937253,156,41,27937097,27937253
5971,6,6,1,2412,-87,-92,5,40:e3:d6:da:bb:e6,27937441,380,-192,27937061,27937441
5972,6,6,1,2412,-56,-92,36,40:e3:d6:da:ba:21,27939564,368,1755,27939196,27939564
5973,6,12,1,2412,-56,-92,36,40:e3:d6:da:ba:23,27940192,184,444,27940008,27940192
5974,6,12,1,2412,-56,-92,36,40:e3:d6:da:ba:24,27940420,176,52,27940244,27940420
5975,6,12,1,2412,-55,-92,37,40:e3:d6:da:ba:25,27940621,160,41,27940461,27940621
5976,6,6,1,2412,-55,-92,37,40:e3:d6:da:ba:26,27940831,380,-170,27940451,27940831
5977,6,12,1,2412,-85,-92,7,84:d4:7e:f2:42:25,27941391,160,400,27941231,27941391
5978,6,6,1,2412,-84,-92,8,84:d4:7e:f2:42:26,27941582,380,-189,27941202,27941582
5979,6,12,1,2412,-86,-92,6,40:e3:d6:da:ca:c4,27955224,172,13470,27955052,27955224
5980,6,6,1,2412,-49,-92,43,e6:aa:ea:c9:ea:33,27977589,408,21957,27977181,27977589
5981,6,6,1,2412,-79,-92,13,,27982842,44,5209,27982798,27982842
5982,6,12,1,2412,-89,-92,3,40:e3:d6:da:c8:05,27986794,160,3792,27986634,27986794
5983,6,6,1,2412,-49,-92,43,e6:aa:ea:c9:ea:33,27990072,408,2870,27989664,27990072
5984,4,1,1,2412,-82,-92,10,,27991720,304,1344,27991416,27991720
5985,6,6,1,2412,-88,-92,4,e6:aa:ea:c9:ea:1b,27995942,408,3814,27995534,27995942
5986,4,1,1,2412,-70,-92,22,54:e4:3a:ec:fb:64,27998279,2160,177,27996119,27998279
5987,6,6,1,2412,-49,-92,43,e6:aa:ea:c9:ea:33,28001819,408,3132,28001411,28001819
5988,6,6,1,2412,-89,-92,3,e6:aa:ea:c9:ea:1b,28008069,408,5842,28007661,28008069
5989,4,1,1,2412,-79,-92,13,b8:3a:5a:88:e6:e0,28027091,2360,16662,28024731,28027091
5990,4,1,1,2412,-66,-92,26,b8:3a:5a:88:e6:e1,28029471,2376,4,28027095,28029471
5991,6,12,1,2412,-81,-92,11,84:d4:7e:f2:34:20,28031816,160,2185,28031656,28031816
5992,6,12,1,2412,-82,-92,10,84:d4:7e:f2:34:23,28032741,180,745,28032561,28032741
5993,6,12,1,2412,-82,-92,10,84:d4:7e:f2:34:24,28032973,176,56,28032797,28032973
5994,6,12,1,2412,-82,-92,10,84:d4:7e:f2:34:25,28033183,160,50,28033023,28033183
5995,6,12,1,2412,-50,-92,42,40:e3:d6:da:ba:20,28041760,160,8417,28041600,28041760
5996,6,6,1,2412,-55,-92,37,40:e3:d6:da:ba:21,28041952,368,-176,28041584,28041952
5997,6,12,1,2412,-55,-92,37,40:e3:d6:da:ba:22,28042357,180,225,28042177,28042357
5998,6,12,1,2412,-55,-92,37,40:e3:d6:da:ba:23,28042590,184,49,28042406,28042590
5999,6,12,1,2412,-55,-92,37,40:e3:d6:da:ba:24,28042826,176,60,28042650,28042826
6000,6,12,1,2412,-55,-92,37,40:e3:d6:da:ba:25,28043027,160,41,28042867,28043027
6001,6,6,1,2412,-55,-92,37,40:e3:d6:da:ba:26,28043228,380,-179,28042848,28043228
6002,6,12,1,2412,-83,-92,9,84:d4:7e:f2:42:25,28043795,160,407,28043635,28043795
6003,6,6,1,2412,-82,-92,10,84:d4:7e:f2:42:26,28043996,380,-179,28043616,28043996
6004,6,24,1,2412,-84,-92,8,66:d8:ff:ae:5d:41,28070084,32,26056,28070052,28070084
6005,6,12,1,2412,-82,-92,10,,28070133,32,17,28070101,28070133
6006,4,1,1,2412,-78,-92,14,a6:e5:7c:28:b1:d3,28076786,944,5709,28075842,28076786
6007,4,1,1,2412,-77,-92,15,a6:e5:7c:28:b1:d3,28088898,944,11168,28087954,28088898
6008,4,1,1,2412,-77,-92,15,a6:e5:7c:28:b1:d3,28089967,944,125,28089023,28089967
6009,4,1,1,2412,-57,-92,35,a6:e5:7c:28:b1:d3,28091018,944,107,28090074,28091018
6010,4,1,1,2412,-77,-92,15,a6:e5:7c:28:b1:d3,28093156,944,1194,28092212,28093156
6011,4,1,1,2412,-77,-92,15,a6:e5:7c:28:b1:d3,28094207,944,107,28093263,28094207
6012,4,1,1,2412,-78,-92,14,a6:e5:7c:28:b1:d3,28097396,944,2245,28096452,28097396
6013,4,1,1,2412,-77,-92,15,a6:e5:7c:28:b1:d3,28098564,992,176,28097572,28098564
6014,6,24,1,2412,-83,-92,9,66:d8:ff:ae:5d:41,28099405,32,809,28099373,28099405
6015,6,12,1,2412,-82,-92,10,,28099455,32,18,28099423,28099455
6016,4,1,1,2412,-70,-92,22,54:e4:3a:ec:fb:64,28100679,2160,-936,28098519,28100679
6017,6,6,1,2412,-73,-92,19,e6:aa:ea:b7:4a:dd,28104394,408,3307,28103986,28104394
6018,4,1,1,2412,-81,-92,11,b8:3a:5a:88:e6:e0,28128112,2360,21358,28125752,28128112
6019,6,12,1,2412,-83,-92,9,84:d4:7e:f2:34:24,28133302,176,5014,28133126,28133302
6020,6,6,1,2412,-82,-92,10,66:d8:ff:ae:5d:41,28135023,64,1657,28134959,28135023
6021,6,6,1,2412,-81,-92,11,,28135104,44,37,28135060,28135104
6022,6,6,1,2412,-86,-92,6,40:e3:d6:da:bb:e1,28141015,368,5543,28140647,28141015
6023,6,12,1,2412,-86,-92,6,40:e3:d6:da:bb:e2,28141411,176,220,28141235,28141411
6024,6,12,1,2412,-54,-92,38,40:e3:d6:da:ba:20,28144232,160,2661,28144072,28144232
6025,6,6,1,2412,-54,-92,38,40:e3:d6:da:ba:21,28144432,368,-168,28144064,28144432
6026,6,12,1,2412,-54,-92,38,40:e3:d6:da:ba:22,28144987,180,375,28144807,28144987
6027,6,12,1,2412,-53,-92,39,40:e3:d6:da:ba:23,28145202,184,31,28145018,28145202
6028,6,12,1,2412,-54,-92,38,40:e3:d6:da:ba:24,28145411,176,33,28145235,28145411
6029,6,12,1,2412,-54,-92,38,40:e3:d6:da:ba:25,28145613,160,42,28145453,28145613
6030,6,6,1,2412,-54,-92,38,40:e3:d6:da:ba:26,28145814,380,-179,28145434,28145814
6031,6,12,1,2412,-84,-92,8,84:d4:7e:f2:42:25,28146206,160,232,28146046,28146206
6032,6,6,1,2412,-83,-92,9,84:d4:7e:f2:42:26,28146398,380,-188,28146018,28146398
6033,6,12,1,2412,-90,-92,2,40:e3:d6:da:ca:c3,28159830,180,13252,28159650,28159830
6034,6,12,1,2412,-83,-92,9,84:d4:7e:f2:34:23,28188941,160,28951,28188781,28188941
6035,6,12,1,2412,-84,-92,8,84:d4:7e:f2:34:25,28189625,140,544,28189485,28189625
6036,4,1,1,2412,-70,-92,22,54:e4:3a:ec:fb:64,28203078,2160,11293,28200918,28203078
6037,6,6,1,2412,-87,-92,5,40:e3:d6:da:bb:e1,28205442,348,2016,28205094,28205442
6038,6,12,1,2412,-86,-92,6,84:d4:7e:f2:34:24,28236430,176,30812,28236254,28236430
6039,6,12,1,2412,-86,-92,6,84:d4:7e:f2:34:25,28236640,160,50,28236480,28236640
6040,6,6,1,2412,-88,-92,4,84:d4:7e:f2:34:26,28236841,380,-179,28236461,28236841
6041,6,12,1,2412,-87,-92,5,40:e3:d6:da:bb:e0,28243229,156,6232,28243073,28243229
6042,6,6,1,2412,-87,-92,5,40:e3:d6:da:bb:e1,28243435,368,-162,28243067,28243435
6043,6,12,1,2412,-87,-92,5,40:e3:d6:da:bb:e2,28243822,176,211,28243646,28243822
6044,6,12,1,2412,-86,-92,6,40:e3:d6:da:bb:e3,28244024,180,22,28243844,28244024
6045,6,12,1,2412,-87,-92,5,40:e3:d6:da:bb:e4,28244238,172,42,28244066,28244238
6046,6,12,1,2412,-86,-92,6,40:e3:d6:da:bb:e5,28244453,156,59,28244297,28244453
6047,6,6,1,2412,-55,-92,37,40:e3:d6:da:ba:21,28246737,368,1916,28246369,28246737
6048,6,12,1,2412,-54,-92,38,40:e3:d6:da:ba:22,28247133,180,216,28246953,28247133
6049,6,12,1,2412,-55,-92,37,40:e3:d6:da:ba:23,28247338,184,21,28247154,28247338
6050,6,12,1,2412,-55,-92,37,40:e3:d6:da:ba:24,28247557,176,43,28247381,28247557
6051,6,12,1,2412,-55,-92,37,40:e3:d6:da:ba:25,28247776,160,59,28247616,28247776
6052,6,6,1,2412,-55,-92,37,40:e3:d6:da:ba:26,28248011,380,-145,28247631,28248011
6053,6,6,1,2412,-88,-92,4,40:e3:d6:da:ca:c6,28262862,380,14471,28262482,28262862
6054,6,6,1,2412,-56,-92,36,e6:aa:ea:c9:ea:33,28281755,408,18485,28281347,28281755
6055,6,6,1,2412,-86,-92,6,40:e3:d6:da:c8:01,28292961,368,10838,28292593,28292961
6056,6,6,1,2412,-56,-92,36,e6:aa:ea:c9:ea:33,28293880,408,511,28293472,28293880
6057,6,6,1,2412,-87,-92,5,e6:aa:ea:c9:ea:1b,28314006,408,19718,28313598,28314006
6058,6,6,1,2412,-56,-92,36,e6:aa:ea:c9:ea:33,28318115,408,3701,28317707,28318115
6059,6,6,1,2412,-56,-92,36,e6:aa:ea:c9:ea:33,28330211,408,11688,28329803,28330211
6060,4,1,1,2412,-76,-92,16,b8:3a:5a:88:e6:e0,28332897,2360,326,28330537,28332897
6061,4,1,1,2412,-76,-92,16,b8:3a:5a:88:e6:e1,28335277,2376,4,28332901,28335277
6062,6,12,1,2412,-88,-92,4,84:d4:7e:f2:34:25,28341610,160,6173,28341450,28341610
6063,6,6,1,2412,-89,-92,3,84:d4:7e:f2:34:26,28341803,380,-187,28341423,28341803
6064,6,12,1,2412,-87,-92,5,40:e3:d6:da:bb:e2,28346213,176,4234,28346037,28346213
6065,6,12,1,2412,-88,-92,4,40:e3:d6:da:bb:e3,28346414,180,21,28346234,28346414
6066,6,12,1,2412,-55,-92,37,40:e3:d6:da:ba:20,28349115,160,2541,28348955,28349115
6067,6,6,1,2412,-56,-92,36,40:e3:d6:da:ba:21,28349334,368,-149,28348966,28349334
6068,6,12,1,2412,-55,-92,37,40:e3:d6:da:ba:23,28349998,184,480,28349814,28349998
6069,6,12,1,2412,-55,-92,37,40:e3:d6:da:ba:24,28350225,176,51,28350049,28350225
6070,6,12,1,2412,-55,-92,37,40:e3:d6:da:ba:25,28350427,160,42,28350267,28350427
6071,6,6,1,2412,-55,-92,37,40:e3:d6:da:ba:26,28350618,380,-189,28350238,28350618
6072,6,6,1,2412,-86,-92,6,84:d4:7e:f2:42:26,28351251,380,253,28350871,28351251
6073,6,12,1,2412,-88,-92,4,40:e3:d6:da:ca:c3,28364622,180,13191,28364442,28364622
6074,6,6,1,2412,-78,-92,14,e6:aa:ea:b7:4a:dd,28407452,408,42422,28407044,28407452
6075,4,1,1,2412,-72,-92,20,54:e4:3a:ec:fb:64,28408667,2160,-945,28406507,28408667
6076,6,6,1,2412,-79,-92,13,e6:aa:ea:b7:4a:dd,28419573,408,10498,28419165,28419573
6077,4,1,1,2412,-68,-92,24,b8:3a:5a:88:e6:e0,28435305,2360,13372,28432945,28435305
6078,4,1,1,2412,-75,-92,17,b8:3a:5a:88:e6:e1,28437703,2376,22,28435327,28437703
6079,6,12,1,2412,-88,-92,4,84:d4:7e:f2:34:22,28440031,180,2148,28439851,28440031
6080,6,12,1,2412,-89,-92,3,84:d4:7e:f2:34:23,28440255,180,44,28440075,28440255
6081,6,12,1,2412,-87,-92,5,40:e3:d6:da:bb:e0,28448024,156,7613,28447868,28448024
6082,6,6,1,2412,-85,-92,7,40:e3:d6:da:bb:e1,28448229,368,-163,28447861,28448229
6083,6,12,1,2412,-86,-92,6,40:e3:d6:da:bb:e3,28448872,180,463,28448692,28448872
6084,6,12,1,2412,-86,-92,6,40:e3:d6:da:bb:e4,28449087,172,43,28448915,28449087
6085,6,12,1,2412,-54,-92,38,40:e3:d6:da:ba:20,28451343,160,2096,28451183,28451343
6086,6,6,1,2412,-54,-92,38,40:e3:d6:da:ba:21,28451562,368,-149,28451194,28451562
6087,6,12,1,2412,-54,-92,38,40:e3:d6:da:ba:22,28454275,180,2533,28454095,28454275
6088,6,12,1,2412,-54,-92,38,40:e3:d6:da:ba:23,28454498,184,39,28454314,28454498
6089,6,12,1,2412,-54,-92,38,40:e3:d6:da:ba:24,28454717,176,43,28454541,28454717
6090,6,12,1,2412,-54,-92,38,40:e3:d6:da:ba:25,28454945,160,68,28454785,28454945
6091,6,6,1,2412,-54,-92,38,40:e3:d6:da:ba:26,28455137,380,-188,28454757,28455137
6092,6,12,1,2412,-88,-92,4,40:e3:d6:da:ca:c2,28466807,176,11494,28466631,28466807
6093,6,12,1,2412,-88,-92,4,40:e3:d6:da:ca:c3,28467009,180,22,28466829,28467009
6094,6,12,1,2412,-87,-92,5,40:e3:d6:da:ca:c4,28467214,172,33,28467042,28467214
6095,6,12,1,2412,-86,-92,6,40:e3:d6:da:ca:c5,28467411,156,41,28467255,28467411
6096,6,6,1,2412,-87,-92,5,40:e3:d6:da:ca:c6,28467626,380,-165,28467246,28467626
6097,6,12,1,2412,-86,-92,6,40:e3:d6:da:c8:05,28498757,160,30971,28498597,28498757
6098,6,6,1,2412,-86,-92,6,40:e3:d6:da:c8:06,28498967,380,-170,28498587,28498967
6099,4,1,1,2412,-78,-92,14,b8:3a:5a:88:e6:e0,28537696,2360,36369,28535336,28537696
6100,6,12,1,2412,-84,-92,8,40:e3:d6:da:bb:e0,28550421,156,12569,28550265,28550421
6101,6,6,1,2412,-83,-92,9,40:e3:d6:da:bb:e1,28550609,368,-180,28550241,28550609
6102,6,12,1,2412,-85,-92,7,40:e3:d6:da:bb:e2,28551023,176,238,28550847,28551023
6103,6,12,1,2412,-85,-92,7,40:e3:d6:da:bb:e3,28551243,180,40,28551063,28551243
6104,6,12,1,2412,-84,-92,8,40:e3:d6:da:bb:e4,28551448,172,33,28551276,28551448
6105,6,12,1,2412,-84,-92,8,40:e3:d6:da:bb:e5,28551655,156,51,28551499,28551655
6106,6,12,1,2412,-52,-92,40,40:e3:d6:da:ba:20,28553745,160,1930,28553585,28553745
6107,6,6,1,2412,-52,-92,40,40:e3:d6:da:ba:21,28553946,368,-167,28553578,28553946
6108,6,12,1,2412,-52,-92,40,40:e3:d6:da:ba:22,28554360,180,234,28554180,28554360
6109,6,12,1,2412,-52,-92,40,40:e3:d6:da:ba:24,28554801,176,265,28554625,28554801
6110,6,12,1,2412,-52,-92,40,40:e3:d6:da:ba:25,28555003,160,42,28554843,28555003
6111,6,6,1,2412,-52,-92,40,40:e3:d6:da:ba:26,28555195,380,-188,28554815,28555195
6112,6,12,1,2412,-85,-92,7,40:e3:d6:da:ca:c0,28568585,156,13234,28568429,28568585
6113,6,6,1,2412,-85,-92,7,40:e3:d6:da:ca:c1,28568772,368,-181,28568404,28568772
6114,6,12,1,2412,-84,-92,8,40:e3:d6:da:ca:c5,28569818,156,890,28569662,28569818
6115,6,6,1,2412,-84,-92,8,40:e3:d6:da:ca:c6,28570015,380,-183,28569635,28570015
6116,4,1,1,2412,-67,-92,25,,28574246,304,3927,28573942,28574246
6117,6,6,1,2412,-51,-92,41,e6:aa:ea:c9:ea:33,28596767,408,22113,28596359,28596767
6118,6,12,1,2412,-87,-92,5,40:e3:d6:da:c8:00,28599919,160,2992,28599759,28599919
6119,6,12,1,2412,-87,-92,5,40:e3:d6:da:c8:02,28600525,180,426,28600345,28600525
6120,6,12,1,2412,-87,-92,5,40:e3:d6:da:c8:03,28600757,184,48,28600573,28600757
6121,6,12,1,2412,-88,-92,4,40:e3:d6:da:c8:04,28600993,176,60,28600817,28600993
6122,6,12,1,2412,-87,-92,5,40:e3:d6:da:c8:05,28601213,160,60,28601053,28601213
6123,6,6,1,2412,-88,-92,4,40:e3:d6:da:c8:06,28601432,380,-161,28601052,28601432
6124,6,6,1,2412,-51,-92,41,e6:aa:ea:c9:ea:33,28621011,408,19171,28620603,28621011
6125,6,6,1,2412,-51,-92,41,e6:aa:ea:c9:ea:33,28633145,408,11726,28632737,28633145
6126,6,6,1,2412,-51,-92,41,e6:aa:ea:c9:ea:33,28645266,408,11713,28644858,28645266
6127,6,12,1,2412,-85,-92,7,84:d4:7e:f2:34:22,28645926,180,480,28645746,28645926
6128,6,12,1,2412,-86,-92,6,84:d4:7e:f2:34:23,28646155,180,49,28645975,28646155
6129,6,12,1,2412,-86,-92,6,40:e3:d6:da:bb:e3,28653636,180,7301,28653456,28653636
6130,6,12,1,2412,-84,-92,8,40:e3:d6:da:bb:e4,28653859,172,51,28653687,28653859
6131,6,12,1,2412,-55,-92,37,40:e3:d6:da:ba:20,28656147,160,2128,28655987,28656147
6132,6,6,1,2412,-55,-92,37,40:e3:d6:da:ba:21,28656366,368,-149,28655998,28656366
6133,6,12,1,2412,-54,-92,38,40:e3:d6:da:ba:22,28656771,180,225,28656591,28656771
6134,6,12,1,2412,-55,-92,37,40:e3:d6:da:ba:23,28656977,184,22,28656793,28656977
6135,6,12,1,2412,-55,-92,37,40:e3:d6:da:ba:24,28657186,176,33,28657010,28657186
6136,6,12,1,2412,-55,-92,37,40:e3:d6:da:ba:25,28657406,160,60,28657246,28657406
6137,6,6,1,2412,-55,-92,37,40:e3:d6:da:ba:26,28657606,380,-180,28657226,28657606
6138,6,12,1,2412,-85,-92,7,84:d4:7e:f2:42:24,28657989,176,207,28657813,28657989
6139,6,12,1,2412,-85,-92,7,84:d4:7e:f2:42:25,28658190,160,41,28658030,28658190
6140,6,6,1,2412,-84,-92,8,84:d4:7e:f2:42:26,28658392,380,-178,28658012,28658392
6141,6,6,1,2412,-85,-92,7,40:e3:d6:da:ca:c1,28671171,368,12411,28670803,28671171
6142,6,12,1,2412,-87,-92,5,40:e3:d6:da:ca:c2,28671576,176,229,28671400,28671576
6143,6,12,1,2412,-87,-92,5,40:e3:d6:da:ca:c3,28671796,180,40,28671616,28671796
6144,6,12,1,2412,-86,-92,6,40:e3:d6:da:ca:c4,28672010,172,42,28671838,28672010
6145,6,12,1,2412,-86,-92,6,40:e3:d6:da:ca:c5,28672235,156,69,28672079,28672235
6146,6,6,1,2412,-87,-92,5,40:e3:d6:da:ca:c6,28672441,380,-174,28672061,28672441
6147,6,12,1,2412,-86,-92,6,40:e3:d6:da:c8:04,28703365,176,30748,28703189,28703365
6148,6,6,1,2412,-76,-92,16,e6:aa:ea:b7:4a:dd,28710431,408,6658,28710023,28710431
6149,4,1,1,2412,-69,-92,23,54:e4:3a:ec:fb:64,28715230,2160,2639,28713070,28715230
6150,6,6,1,2412,-77,-92,15,e6:aa:ea:b7:4a:dd,28734682,408,19044,28734274,28734682
6151,4,1,1,2412,-76,-92,16,b8:3a:5a:88:e6:e0,28743245,2360,6203,28740885,28743245
6152,4,1,1,2412,-77,-92,15,b8:3a:5a:88:e6:e1,28745643,2376,22,28743267,28745643
6153,6,12,1,2412,-86,-92,6,84:d4:7e:f2:34:25,28748122,160,2319,28747962,28748122
6154,6,6,1,2412,-85,-92,7,84:d4:7e:f2:34:26,28748314,380,-188,28747934,28748314
6155,6,6,1,2412,-86,-92,6,40:e3:d6:da:bb:e1,28755440,368,6758,28755072,28755440
6156,6,12,1,2412,-85,-92,7,40:e3:d6:da:bb:e2,28755845,176,229,28755669,28755845
6157,6,12,1,2412,-85,-92,7,40:e3:d6:da:bb:e3,28756064,180,39,28755884,28756064
6158,6,12,1,2412,-87,-92,5,40:e3:d6:da:bb:e4,28756279,172,43,28756107,28756279
6159,6,12,1,2412,-86,-92,6,40:e3:d6:da:bb:e5,28756485,156,50,28756329,28756485
6160,6,6,1,2412,-85,-92,7,40:e3:d6:da:bb:e6,28756700,380,-165,28756320,28756700
6161,6,12,1,2412,-54,-92,38,40:e3:d6:da:ba:20,28758559,160,1699,28758399,28758559
6162,6,6,1,2412,-55,-92,37,40:e3:d6:da:ba:21,28758769,368,-158,28758401,28758769
6163,6,12,1,2412,-55,-92,37,40:e3:d6:da:ba:22,28759183,180,234,28759003,28759183
6164,6,12,1,2412,-55,-92,37,40:e3:d6:da:ba:23,28759398,184,31,28759214,28759398
6165,6,12,1,2412,-55,-92,37,40:e3:d6:da:ba:24,28759634,176,60,28759458,28759634
6166,6,12,1,2412,-55,-92,37,40:e3:d6:da:ba:25,28760252,160,458,28760092,28760252
6167,6,6,1,2412,-55,-92,37,40:e3:d6:da:ba:26,28760462,380,-170,28760082,28760462
6168,6,6,1,2412,-86,-92,6,40:e3:d6:da:ca:c1,28773574,368,12744,28773206,28773574
6169,6,12,1,2412,-84,-92,8,40:e3:d6:da:ca:c2,28773970,176,220,28773794,28773970
6170,6,12,1,2412,-86,-92,6,40:e3:d6:da:ca:c5,28774583,156,457,28774427,28774583
6171,4,1,1,2412,-69,-92,23,54:e4:3a:ec:fb:64,28817996,2160,41253,28815836,28817996
6172,4,1,1,2412,-81,-92,11,b8:3a:5a:88:e6:e1,28847624,2376,27252,28845248,28847624
6173,6,12,1,2412,-90,-92,2,84:d4:7e:f2:34:20,28849899,160,2115,28849739,28849899
6174,6,6,1,2412,-88,-92,4,84:d4:7e:f2:34:21,28850199,368,-68,28849831,28850199
6175,6,12,1,2412,-90,-92,2,84:d4:7e:f2:34:22,28850613,180,234,28850433,28850613
6176,6,12,1,2412,-89,-92,3,84:d4:7e:f2:34:23,28850846,180,53,28850666,28850846
6177,6,12,1,2412,-89,-92,3,84:d4:7e:f2:34:24,28851167,176,145,28850991,28851167
6178,6,12,1,2412,-89,-92,3,84:d4:7e:f2:34:25,28851387,160,60,28851227,28851387
6179,6,6,1,2412,-89,-92,3,84:d4:7e:f2:34:26,28851596,380,-171,28851216,28851596
6180,6,12,1,2412,-55,-92,37,40:e3:d6:da:ba:20,28860938,160,9182,28860778,28860938
6181,6,6,1,2412,-55,-92,37,40:e3:d6:da:ba:21,28861157,368,-149,28860789,28861157
6182,6,12,1,2412,-54,-92,38,40:e3:d6:da:ba:23,28861785,184,444,28861601,28861785
6183,6,12,1,2412,-54,-92,38,40:e3:d6:da:ba:24,28862004,176,43,28861828,28862004
6184,6,12,1,2412,-54,-92,38,40:e3:d6:da:ba:25,28862205,160,41,28862045,28862205
6185,6,6,1,2412,-54,-92,38,40:e3:d6:da:ba:26,28862406,380,-179,28862026,28862406
6186,6,6,1,2412,-83,-92,9,84:d4:7e:f2:42:26,28863225,380,439,28862845,28863225
6187,6,6,1,2412,-85,-92,7,e6:aa:ea:c9:ea:1b,28872715,408,9082,28872307,28872715
6188,6,12,1,2412,-85,-92,7,40:e3:d6:da:ca:c0,28875773,156,2902,28875617,28875773
6189,6,6,1,2412,-86,-92,6,40:e3:d6:da:ca:c6,28877239,380,1086,28876859,28877239
6190,4,1,1,2412,-67,-92,25,,28884916,304,7373,28884612,28884916
6191,4,1,1,2412,-72,-92,20,a6:e5:7c:28:b1:d3,28906901,992,20993,28905909,28906901
6192,6,12,1,2412,-90,-92,2,40:e3:d6:da:c8:02,28908377,180,1296,28908197,28908377
6193,6,12,1,2412,-89,-92,3,40:e3:d6:da:c8:03,28908610,184,49,28908426,28908610
6194,4,1,1,2412,-69,-92,23,54:e4:3a:ec:fb:64,28919870,2160,9100,28917710,28919870
6195,4,1,1,2412,-77,-92,15,b8:3a:5a:88:e6:e0,28947315,2360,25085,28944955,28947315
6196,4,1,1,2412,-76,-92,16,b8:3a:5a:88:e6:e1,28949694,2376,3,28947318,28949694
6197,6,6,1,2412,-87,-92,5,84:d4:7e:f2:34:26,28952828,380,2754,28952448,28952828
6198,6,12,1,2412,-85,-92,7,40:e3:d6:da:bb:e0,28960023,156,7039,28959867,28960023
6199,6,6,1,2412,-85,-92,7,40:e3:d6:da:bb:e1,28960238,368,-153,28959870,28960238
6200,6,12,1,2412,-86,-92,6,40:e3:d6:da:bb:e2,28960634,176,220,28960458,28960634
6201,6,12,1,2412,-85,-92,7,40:e3:d6:da:bb:e3,28960863,180,49,28960683,28960863
6202,6,12,1,2412,-85,-92,7,40:e3:d6:da:bb:e4,28961077,172,42,28960905,28961077
6203,6,12,1,2412,-84,-92,8,40:e3:d6:da:bb:e5,28961274,156,41,28961118,28961274
6204,6,6,1,2412,-86,-92,6,40:e3:d6:da:bb:e6,28961471,380,-183,28961091,28961471
6205,6,6,1,2412,-54,-92,38,40:e3:d6:da:ba:21,28963548,368,1709,28963180,28963548
6206,6,12,1,2412,-55,-92,37,40:e3:d6:da:ba:22,28963962,180,234,28963782,28963962
6207,6,12,1,2412,-54,-92,38,40:e3:d6:da:ba:23,28964194,184,48,28964010,28964194
6208,6,12,1,2412,-54,-92,38,40:e3:d6:da:ba:24,28964431,176,61,28964255,28964431
6209,6,12,1,2412,-55,-92,37,40:e3:d6:da:ba:25,28964641,160,50,28964481,28964641
6210,6,12,1,2412,-86,-92,6,84:d4:7e:f2:42:25,28965389,160,588,28965229,28965389
6211,6,6,1,2412,-87,-92,5,84:d4:7e:f2:42:26,28965580,380,-189,28965200,28965580
6212,4,1,1,2412,-72,-92,20,a4:e5:7c:28:b1:d3,28989094,688,22826,28988406,28989094
6213,4,1,1,2412,-80,-92,12,,28992492,304,3094,28992188,28992492
6214,6,12,1,2412,-86,-92,6,40:e3:d6:da:bb:e0,28996588,136,3960,28996452,28996588
6215,6,12,1,2412,-85,-92,7,40:e3:d6:da:bb:e2,28997186,156,442,28997030,28997186
6216,6,12,1,2412,-86,-92,6,40:e3:d6:da:bb:e3,28997376,156,34,28997220,28997376
6217,6,12,1,2412,-82,-92,10,40:e3:d6:da:bb:e5,28997593,136,81,28997457,28997593
6218,4,1,1,2412,-72,-92,20,a6:e5:7c:28:b1:d3,29009064,992,10479,29008072,29009064
6219,6,12,1,2412,-87,-92,5,40:e3:d6:da:c8:04,29011008,176,1768,29010832,29011008
6220,6,6,1,2412,-58,-92,34,e6:aa:ea:c9:ea:33,29014919,408,3503,29014511,29014919
6221,4,1,1,2412,-66,-92,26,54:e4:3a:ec:fb:64,29023110,2160,6031,29020950,29023110
6222,6,6,1,2412,-57,-92,35,e6:aa:ea:c9:ea:33,29027322,408,3804,29026914,29027322
6223,6,6,1,2412,-56,-92,36,e6:aa:ea:c9:ea:33,29039164,408,11434,29038756,29039164
6224,6,12,1,2412,-86,-92,6,84:d4:7e:f2:34:22,29054645,180,15301,29054465,29054645
6225,6,12,1,2412,-85,-92,7,84:d4:7e:f2:34:23,29054851,180,26,29054671,29054851
6226,6,6,1,2412,-84,-92,8,40:e3:d6:da:bb:e1,29062708,368,7489,29062340,29062708
6227,6,12,1,2412,-86,-92,6,40:e3:d6:da:bb:e2,29063122,176,238,29062946,29063122
6228,6,6,1,2412,-55,-92,37,e6:aa:ea:c9:ea:33,29063401,408,-129,29062993,29063401
6229,6,6,1,2412,-86,-92,6,40:e3:d6:da:bb:e6,29064248,380,467,29063868,29064248
6230,6,12,1,2412,-55,-92,37,40:e3:d6:da:ba:20,29065746,160,1338,29065586,29065746
6231,6,6,1,2412,-55,-92,37,40:e3:d6:da:ba:21,29065937,368,-177,29065569,29065937
6232,6,12,1,2412,-54,-92,38,40:e3:d6:da:ba:22,29066342,180,225,29066162,29066342
6233,6,12,1,2412,-55,-92,37,40:e3:d6:da:ba:25,29066986,160,484,29066826,29066986
6234,6,6,1,2412,-55,-92,37,40:e3:d6:da:ba:26,29067205,380,-161,29066825,29067205
6235,4,1,1,2412,-84,-92,8,,29081358,304,13849,29081054,29081358
6236,6,6,1,2412,-86,-92,6,40:e3:d6:da:ca:c6,29082111,380,373,29081731,29082111
6237,6,12,1,2412,-86,-92,6,40:e3:d6:da:bb:e5,29102884,136,20637,29102748,29102884
6238,6,12,1,2412,-89,-92,3,40:e3:d6:da:c8:00,29111919,160,8875,29111759,29111919
6239,6,12,1,2412,-88,-92,4,40:e3:d6:da:c8:02,29112516,180,417,29112336,29112516
6240,6,12,1,2412,-89,-92,3,40:e3:d6:da:c8:03,29112721,184,21,29112537,29112721
6241,6,12,1,2412,-88,-92,4,40:e3:d6:da:c8:05,29113141,160,260,29112981,29113141
6242,6,6,1,2412,-88,-92,4,40:e3:d6:da:c8:06,29113342,380,-179,29112962,29113342
6243,4,1,1,2412,-68,-92,24,54:e4:3a:ec:fb:64,29124697,2160,9195,29122537,29124697
6244,4,1,1,2412,-71,-92,21,b8:3a:5a:88:e6:e0,29152090,2360,25033,29149730,29152090
6245,4,1,1,2412,-72,-92,20,b8:3a:5a:88:e6:e1,29154478,2376,12,29152102,29154478
6246,6,12,1,2412,-85,-92,7,84:d4:7e:f2:34:20,29157020,160,2382,29156860,29157020
6247,6,6,1,2412,-85,-92,7,84:d4:7e:f2:34:21,29157230,368,-158,29156862,29157230
6248,6,12,1,2412,-87,-92,5,40:e3:d6:da:bb:e0,29164843,156,7457,29164687,29164843
6249,6,6,1,2412,-87,-92,5,40:e3:d6:da:bb:e6,29166255,380,1032,29165875,29166255
6250,6,12,1,2412,-54,-92,38,40:e3:d6:da:ba:20,29168147,160,1732,29167987,29168147
6251,6,6,1,2412,-54,-92,38,40:e3:d6:da:ba:21,29168348,368,-167,29167980,29168348
6252,6,12,1,2412,-53,-92,39,40:e3:d6:da:ba:22,29168744,180,216,29168564,29168744
6253,6,12,1,2412,-53,-92,39,40:e3:d6:da:ba:23,29168967,184,39,29168783,29168967
6254,6,12,1,2412,-53,-92,39,40:e3:d6:da:ba:24,29169203,176,60,29169027,29169203
6255,6,12,1,2412,-53,-92,39,40:e3:d6:da:ba:25,29169423,160,60,29169263,29169423
6256,6,6,1,2412,-53,-92,39,40:e3:d6:da:ba:26,29169624,380,-179,29169244,29169624
6257,6,12,1,2412,-86,-92,6,84:d4:7e:f2:42:24,29170007,176,207,29169831,29170007
6258,6,12,1,2412,-85,-92,7,84:d4:7e:f2:42:25,29170217,160,50,29170057,29170217
6259,6,6,1,2412,-88,-92,4,40:e3:d6:da:c8:01,29214571,368,43986,29214203,29214571
6260,6,12,1,2412,-89,-92,3,40:e3:d6:da:c8:02,29214967,180,216,29214787,29214967
6261,6,6,1,2412,-90,-92,2,40:e3:d6:da:c8:06,29215820,380,473,29215440,29215820
6262,4,1,1,2412,-67,-92,25,54:e4:3a:ec:fb:64,29227072,2160,9092,29224912,29227072
6263,6,6,1,2412,-72,-92,20,e6:aa:ea:b7:4a:dd,29231183,408,3703,29230775,29231183
6264,6,6,1,2412,-72,-92,20,e6:aa:ea:b7:4a:dd,29243317,408,11726,29242909,29243317
6265,4,1,1,2412,-78,-92,14,b8:3a:5a:88:e6:e0,29254495,2360,8818,29252135,29254495
6266,4,1,1,2412,-77,-92,15,b8:3a:5a:88:e6:e1,29256875,2376,4,29254499,29256875
6267,6,12,1,2412,-85,-92,7,84:d4:7e:f2:34:22,29259382,180,2327,29259202,29259382
6268,6,12,1,2412,-85,-92,7,84:d4:7e:f2:34:23,29259615,180,53,29259435,29259615
6269,6,12,1,2412,-86,-92,6,84:d4:7e:f2:34:24,29259820,176,29,29259644,29259820
6270,6,6,1,2412,-85,-92,7,84:d4:7e:f2:34:26,29260231,380,31,29259851,29260231
6271,6,6,1,2412,-52,-92,40,40:e3:d6:da:ba:21,29270763,368,10164,29270395,29270763
6272,6,12,1,2412,-52,-92,40,40:e3:d6:da:ba:22,29271168,180,225,29270988,29271168
6273,6,12,1,2412,-52,-92,40,40:e3:d6:da:ba:23,29271391,184,39,29271207,29271391
6274,6,12,1,2412,-52,-92,40,40:e3:d6:da:ba:24,29271628,176,61,29271452,29271628
6275,6,12,1,2412,-52,-92,40,40:e3:d6:da:ba:25,29271847,160,59,29271687,29271847
6276,6,6,1,2412,-52,-92,40,40:e3:d6:da:ba:26,29272066,380,-161,29271686,29272066
6277,6,12,1,2412,-86,-92,6,84:d4:7e:f2:42:25,29272575,160,349,29272415,29272575
6278,6,6,1,2412,-87,-92,5,e6:aa:ea:c9:ea:1b,29292559,408,19576,29292151,29292559
6279,6,12,1,2412,-90,-92,2,40:e3:d6:da:c8:02,29317361,180,24622,29317181,29317361
6280,6,12,1,2412,-88,-92,4,40:e3:d6:da:c8:03,29317566,184,21,29317382,29317566
6281,6,12,1,2412,-88,-92,4,40:e3:d6:da:c8:05,29317986,160,260,29317826,29317986
6282,4,1,1,2412,-76,-92,16,c0:c9:e3:4d:6e:bf,29328953,872,10095,29328081,29328953
6283,6,6,1,2412,-57,-92,35,e6:aa:ea:c9:ea:33,29330362,408,1001,29329954,29330362
6284,6,6,1,2412,-58,-92,34,e6:aa:ea:c9:ea:33,29342477,408,11707,29342069,29342477
6285,6,6,1,2412,-57,-92,35,e6:aa:ea:c9:ea:33,29354710,408,11825,29354302,29354710
6286,4,1,1,2412,-78,-92,14,b8:3a:5a:88:e6:e0,29356904,2360,-166,29354544,29356904
6287,6,12,1,2412,-85,-92,7,84:d4:7e:f2:34:22,29361709,180,4625,29361529,29361709
6288,6,12,1,2412,-85,-92,7,84:d4:7e:f2:34:25,29362384,160,515,29362224,29362384
6289,6,6,1,2412,-85,-92,7,84:d4:7e:f2:34:26,29362603,380,-161,29362223,29362603
6290,6,6,1,2412,-57,-92,35,e6:aa:ea:c9:ea:33,29366708,408,3697,29366300,29366708
6291,6,12,1,2412,-54,-92,38,40:e3:d6:da:ba:24,29373994,176,7110,29373818,29373994
6292,6,12,1,2412,-54,-92,38,40:e3:d6:da:ba:25,29374214,160,60,29374054,29374214
6293,6,6,1,2412,-54,-92,38,40:e3:d6:da:ba:26,29374406,380,-188,29374026,29374406
6294,6,12,1,2412,-84,-92,8,84:d4:7e:f2:42:25,29375013,160,447,29374853,29375013
6295,6,6,1,2412,-84,-92,8,84:d4:7e:f2:42:26,29375223,380,-170,29374843,29375223
6296,6,6,1,2412,-57,-92,35,e6:aa:ea:c9:ea:33,29378822,408,3191,29378414,29378822
6297,6,12,1,2412,-89,-92,3,40:e3:d6:da:ca:c3,29391263,180,12261,29391083,29391263
6298,6,12,1,2412,-90,-92,2,40:e3:d6:da:ca:c4,29391486,172,51,29391314,29391486
6299,4,1,1,2412,-84,-92,8,,29416729,304,24939,29416425,29416729
6300,4,1,1,2412,-69,-92,23,54:e4:3a:ec:fb:64,29431875,2160,12986,29429715,29431875
6301,6,12,1,2412,-86,-92,6,84:d4:7e:f2:34:23,29464241,180,32186,29464061,29464241
6302,6,6,1,2412,-87,-92,5,40:e3:d6:da:bb:e1,29472247,368,7638,29471879,29472247
6303,6,12,1,2412,-87,-92,5,40:e3:d6:da:bb:e2,29472634,176,211,29472458,29472634
6304,6,12,1,2412,-88,-92,4,40:e3:d6:da:bb:e3,29472853,180,39,29472673,29472853
6305,6,12,1,2412,-85,-92,7,40:e3:d6:da:bb:e4,29473068,172,43,29472896,29473068
6306,6,12,1,2412,-87,-92,5,40:e3:d6:da:bb:e5,29473275,156,51,29473119,29473275
6307,6,6,1,2412,-87,-92,5,40:e3:d6:da:bb:e6,29473481,380,-174,29473101,29473481
6308,6,6,1,2412,-55,-92,37,40:e3:d6:da:ba:21,29475578,368,1729,29475210,29475578
6309,6,12,1,2412,-55,-92,37,40:e3:d6:da:ba:23,29476207,184,445,29476023,29476207
6310,6,12,1,2412,-55,-92,37,40:e3:d6:da:ba:24,29476416,176,33,29476240,29476416
6311,6,6,1,2412,-55,-92,37,40:e3:d6:da:ba:26,29476845,380,49,29476465,29476845
6312,6,12,1,2412,-88,-92,4,40:e3:d6:da:c8:00,29521517,160,44512,29521357,29521517
6313,6,12,1,2412,-89,-92,3,40:e3:d6:da:c8:02,29522122,180,425,29521942,29522122
6314,6,12,1,2412,-88,-92,4,40:e3:d6:da:c8:04,29522591,176,293,29522415,29522591
6315,6,12,1,2412,-88,-92,4,40:e3:d6:da:c8:05,29522792,160,41,29522632,29522792
6316,6,6,1,2412,-89,-92,3,40:e3:d6:da:c8:06,29523002,380,-170,29522622,29523002
6317,4,1,1,2412,-67,-92,25,54:e4:3a:ec:fb:64,29534303,2160,9141,29532143,29534303
6318,6,6,1,2412,-85,-92,7,84:d4:7e:f2:34:21,29566844,368,32173,29566476,29566844
6319,6,12,1,2412,-86,-92,6,84:d4:7e:f2:34:22,29567257,180,233,29567077,29567257
6320,6,12,1,2412,-85,-92,7,84:d4:7e:f2:34:23,29567490,180,53,29567310,29567490
6321,6,12,1,2412,-83,-92,9,84:d4:7e:f2:34:24,29567696,176,30,29567520,29567696
6322,6,12,1,2412,-86,-92,6,84:d4:7e:f2:34:25,29567924,160,68,29567764,29567924
6323,6,6,1,2412,-85,-92,7,e6:aa:ea:c9:ea:1b,29573079,408,4747,29572671,29573079
6324,6,6,1,2412,-87,-92,5,40:e3:d6:da:bb:e1,29574651,368,1204,29574283,29574651
6325,6,12,1,2412,-86,-92,6,40:e3:d6:da:bb:e2,29575056,176,229,29574880,29575056
6326,6,12,1,2412,-86,-92,6,40:e3:d6:da:bb:e3,29575257,180,21,29575077,29575257
6327,6,12,1,2412,-87,-92,5,40:e3:d6:da:bb:e4,29575472,172,43,29575300,29575472
6328,6,12,1,2412,-56,-92,36,40:e3:d6:da:ba:20,29577747,160,2115,29577587,29577747
6329,6,6,1,2412,-56,-92,36,40:e3:d6:da:ba:21,29577948,368,-167,29577580,29577948
6330,6,12,1,2412,-56,-92,36,40:e3:d6:da:ba:22,29578344,180,216,29578164,29578344
6331,6,12,1,2412,-56,-92,36,40:e3:d6:da:ba:23,29578549,184,21,29578365,29578549
6332,6,12,1,2412,-56,-92,36,40:e3:d6:da:ba:24,29578759,176,34,29578583,29578759
6333,6,12,1,2412,-56,-92,36,40:e3:d6:da:ba:25,29578987,160,68,29578827,29578987
6334,6,6,1,2412,-87,-92,5,84:d4:7e:f2:42:26,29580032,380,665,29579652,29580032
6335,4,1,1,2412,-77,-92,15,a6:e5:7c:28:b1:d3,29627864,992,46840,29626872,29627864
6336,4,1,1,2412,-68,-92,24,54:e4:3a:ec:fb:64,29636715,2160,6691,29634555,29636715
6337,6,6,1,2412,-74,-92,18,e6:aa:ea:b7:4a:dd,29649038,408,11915,29648630,29649038
6338,6,6,1,2412,-74,-92,18,e6:aa:ea:b7:4a:dd,29661162,408,11716,29660754,29661162
6339,6,6,1,2412,-85,-92,7,84:d4:7e:f2:34:21,29669299,368,7769,29668931,29669299
6340,6,12,1,2412,-83,-92,9,84:d4:7e:f2:34:22,29669686,180,207,29669506,29669686
6341,6,12,1,2412,-85,-92,7,84:d4:7e:f2:34:23,29669918,180,52,29669738,29669918
6342,6,12,1,2412,-85,-92,7,84:d4:7e:f2:34:24,29670142,176,48,29669966,29670142
6343,6,6,1,2412,-85,-92,7,84:d4:7e:f2:34:26,29670544,380,22,29670164,29670544
6344,6,12,1,2412,-86,-92,6,40:e3:d6:da:bb:e2,29677446,176,6726,29677270,29677446
6345,6,12,1,2412,-85,-92,7,40:e3:d6:da:bb:e3,29677675,180,49,29677495,29677675
6346,6,12,1,2412,-83,-92,9,40:e3:d6:da:bb:e4,29677908,172,61,29677736,29677908
6347,6,6,1,2412,-56,-92,36,40:e3:d6:da:ba:26,29681607,380,3319,29681227,29681607
6348,6,12,1,2412,-88,-92,4,40:e3:d6:da:ca:c0,29694985,156,13222,29694829,29694985
6349,6,12,1,2412,-86,-92,6,40:e3:d6:da:ca:c2,29695596,176,435,29695420,29695596
6350,6,12,1,2412,-88,-92,4,40:e3:d6:da:ca:c3,29695806,180,30,29695626,29695806
6351,6,12,1,2412,-87,-92,5,40:e3:d6:da:ca:c4,29696012,172,34,29695840,29696012
6352,6,12,1,2412,-88,-92,4,40:e3:d6:da:ca:c5,29696236,156,68,29696080,29696236
6353,6,12,1,2412,-87,-92,5,40:e3:d6:da:bb:e3,29718776,156,22384,29718620,29718776
6354,6,6,1,2412,-88,-92,4,40:e3:d6:da:c8:01,29726519,368,7375,29726151,29726519
6355,6,12,1,2412,-88,-92,4,40:e3:d6:da:c8:02,29726933,180,234,29726753,29726933
6356,6,12,1,2412,-87,-92,5,40:e3:d6:da:c8:03,29727148,184,31,29726964,29727148
6357,4,1,1,2412,-78,-92,14,a6:e5:7c:28:b1:d3,29727530,992,-610,29726538,29727530
6358,6,12,1,2412,-87,-92,5,40:e3:d6:da:c8:05,29728619,160,929,29728459,29728619
6359,6,6,1,2412,-88,-92,4,40:e3:d6:da:c8:06,29728837,380,-162,29728457,29728837
6360,4,1,1,2412,-69,-92,23,54:e4:3a:ec:fb:64,29739114,2160,8117,29736954,29739114
6361,6,6,1,2412,-55,-92,37,e6:aa:ea:c9:ea:33,29748038,408,8516,29747630,29748038
6362,4,1,1,2412,-75,-92,17,b8:3a:5a:88:e6:e0,29767020,2360,16622,29764660,29767020
6363,4,1,1,2412,-74,-92,18,b8:3a:5a:88:e6:e1,29769409,2376,13,29767033,29769409
6364,6,12,1,2412,-85,-92,7,84:d4:7e:f2:34:24,29771762,176,2177,29771586,29771762
6365,6,12,1,2412,-84,-92,8,84:d4:7e:f2:34:25,29771972,160,50,29771812,29771972
6366,6,6,1,2412,-56,-92,36,e6:aa:ea:c9:ea:33,29772270,408,-110,29771862,29772270
6367,6,6,1,2412,-85,-92,7,66:d8:ff:ae:5d:41,29776779,64,4445,29776715,29776779
6368,6,6,1,2412,-80,-92,12,,29776860,44,37,29776816,29776860
6369,6,12,1,2412,-83,-92,9,,29776932,36,36,29776896,29776932
6370,6,12,1,2412,-84,-92,8,,29776985,32,21,29776953,29776985
6371,6,6,1,2412,-88,-92,4,,29777111,68,58,29777043,29777111
6372,6,12,1,2412,-82,-92,10,,29778440,36,1293,29778404,29778440
6373,6,6,1,2412,-85,-92,7,,29778645,68,137,29778577,29778645
6374,6,12,1,2412,-83,-92,9,,29778791,32,114,29778759,29778791
6375,6,12,1,2412,-87,-92,5,40:e3:d6:da:bb:e0,29779245,156,298,29779089,29779245
6376,6,6,1,2412,-88,-92,4,40:e3:d6:da:bb:e1,29779451,368,-162,29779083,29779451
6377,6,12,1,2412,-85,-92,7,40:e3:d6:da:bb:e2,29779865,176,238,29779689,29779865
6378,6,12,1,2412,-87,-92,5,40:e3:d6:da:bb:e3,29780085,180,40,29779905,29780085
6379,6,12,1,2412,-87,-92,5,40:e3:d6:da:bb:e4,29780299,172,42,29780127,29780299
6380,6,12,1,2412,-86,-92,6,40:e3:d6:da:bb:e5,29780497,156,42,29780341,29780497
6381,6,12,1,2412,-56,-92,36,40:e3:d6:da:ba:20,29782562,160,1905,29782402,29782562
6382,6,6,1,2412,-55,-92,37,40:e3:d6:da:ba:21,29782753,368,-177,29782385,29782753
6383,6,12,1,2412,-55,-92,37,40:e3:d6:da:ba:22,29783158,180,225,29782978,29783158
6384,6,12,1,2412,-56,-92,36,40:e3:d6:da:ba:23,29783364,184,22,29783180,29783364
6385,6,12,1,2412,-55,-92,37,40:e3:d6:da:ba:24,29783591,176,51,29783415,29783591
6386,6,12,1,2412,-55,-92,37,40:e3:d6:da:ba:25,29783793,160,42,29783633,29783793
6387,6,6,1,2412,-55,-92,37,40:e3:d6:da:ba:26,29784012,380,-161,29783632,29784012
6388,6,6,1,2412,-86,-92,6,84:d4:7e:f2:42:26,29784846,380,454,29784466,29784846
6389,6,12,1,2412,-83,-92,9,,29786875,32,1997,29786843,29786875
6390,6,12,1,2412,-84,-92,8,,29790707,32,3800,29790675,29790707
6391,6,6,1,2412,-55,-92,37,e6:aa:ea:c9:ea:33,29796510,408,5395,29796102,29796510
6392,6,6,1,2412,-88,-92,4,40:e3:d6:da:ca:c1,29797658,368,780,29797290,29797658
6393,6,12,1,2412,-89,-92,3,40:e3:d6:da:ca:c2,29798054,176,220,29797878,29798054
6394,6,12,1,2412,-84,-92,8,,29801625,32,3539,29801593,29801625
6395,6,12,1,2412,-84,-92,8,,29801791,36,130,29801755,29801791
6396,6,24,1,2412,-88,-92,4,66:d8:ff:ae:5d:41,29809609,32,7786,29809577,29809609
6397,6,12,1,2412,-85,-92,7,,29809658,32,17,29809626,29809658
6398,6,24,1,2412,-88,-92,4,66:d8:ff:ae:5d:41,29811837,32,2147,29811805,29811837
6399,6,12,1,2412,-85,-92,7,,29811886,32,17,29811854,29811886
6400,6,24,1,2412,-87,-92,5,66:d8:ff:ae:5d:41,29814323,32,2405,29814291,29814323
6401,6,6,1,2412,-87,-92,5,66:d8:ff:ae:5d:41,29814937,64,550,29814873,29814937
6402,6,6,1,2412,-86,-92,6,66:d8:ff:ae:5d:41,29815575,64,574,29815511,29815575
6403,6,6,1,2412,-85,-92,7,,29815657,44,38,29815613,29815657
6404,6,6,1,2412,-88,-92,4,66:d8:ff:ae:5d:41,29819404,64,3683,29819340,29819404
6405,6,6,1,2412,-87,-92,5,66:d8:ff:ae:5d:41,29819547,64,79,29819483,29819547
6406,4,1,1,2412,-90,-92,2,66:d8:ff:ae:5d:41,29819856,416,-107,29819440,29819856
6407,4,1,1,2412,-89,-92,3,66:d8:ff:ae:5d:41,29820614,416,342,29820198,29820614
6408,4,1,1,2412,-71,-92,21,66:d8:ff:ae:5d:41,29821372,416,342,29820956,29821372
6409,4,1,1,2412,-50,-92,42,c0:c9:e3:4d:6e:bf,29823209,872,965,29822337,29823209
6410,4,1,1,2412,-49,-92,43,,29824097,304,584,29823793,29824097
6411,4,1,1,2412,-88,-92,4,66:d8:ff:ae:5d:41,29826363,416,1850,29825947,29826363
6412,4,1,1,2412,-86,-92,6,,29826792,304,125,29826488,29826792
6413,4,1,1,2412,-89,-92,3,66:d8:ff:ae:5d:41,29827118,416,-90,29826702,29827118
6414,4,1,1,2412,-84,-92,8,,29827547,304,125,29827243,29827547
6415,4,1,1,2412,-73,-92,19,66:d8:ff:ae:5d:41,29830054,416,2091,29829638,29830054
6416,4,1,1,2412,-85,-92,7,,29830483,304,125,29830179,29830483
6417,6,12,1,2412,-88,-92,4,40:e3:d6:da:c8:00,29831701,160,1058,29831541,29831701
6418,6,6,1,2412,-88,-92,4,40:e3:d6:da:c8:01,29831902,368,-167,29831534,29831902
6419,6,12,1,2412,-88,-92,4,40:e3:d6:da:c8:02,29832298,180,216,29832118,29832298
6420,6,12,1,2412,-87,-92,5,,29836514,32,4184,29836482,29836514
6421,6,12,1,2412,-87,-92,5,,29836631,44,73,29836587,29836631
6422,4,1,1,2412,-89,-92,3,66:d8:ff:ae:5d:41,29837959,416,912,29837543,29837959
6423,4,1,1,2412,-88,-92,4,,29838389,304,126,29838085,29838389
6424,4,1,1,2412,-89,-92,3,66:d8:ff:ae:5d:41,29838714,416,-91,29838298,29838714
6425,4,1,1,2412,-67,-92,25,54:e4:3a:ec:fb:64,29841488,2160,614,29839328,29841488
6426,6,12,1,2412,-85,-92,7,,29845174,44,3642,29845130,29845174
6427,6,12,1,2412,-85,-92,7,,29847132,36,1922,29847096,29847132
6428,6,12,1,2412,-88,-92,4,,29847185,32,21,29847153,29847185
6429,6,6,1,2412,-85,-92,7,,29847344,68,91,29847276,29847344
6430,6,12,1,2412,-85,-92,7,,29847480,32,104,29847448,29847480
6431,6,12,1,2412,-84,-92,8,,29851744,32,4232,29851712,29851744
6432,6,12,1,2412,-85,-92,7,,29853018,32,1242,29852986,29853018
6433,6,12,1,2412,-86,-92,6,,29853111,36,57,29853075,29853111
6434,6,12,1,2412,-87,-92,5,,29853163,32,20,29853131,29853163
6435,6,6,1,2412,-87,-92,5,66:d8:ff:ae:5d:41,29853339,64,112,29853275,29853339
6436,6,6,1,2412,-86,-92,6,,29853420,44,37,29853376,29853420
6437,6,12,1,2412,-86,-92,6,,29856469,36,3013,29856433,29856469
6438,6,12,1,2412,-85,-92,7,,29856522,32,21,29856490,29856522
6439,6,12,1,2412,-87,-92,5,,29856635,44,69,29856591,29856635
6440,6,12,1,2412,-86,-92,6,,29857472,32,805,29857440,29857472
6441,6,12,1,2412,-84,-92,8,,29857713,32,209,29857681,29857713
6442,6,12,1,2412,-84,-92,8,,29861135,36,3386,29861099,29861135
6443,6,6,1,2412,-86,-92,6,,29861193,44,14,29861149,29861193
6444,6,6,1,2412,-87,-92,5,66:d8:ff:ae:5d:41,29861376,64,119,29861312,29861376
6445,6,6,1,2412,-86,-92,6,,29861457,44,37,29861413,29861457
6446,6,6,1,2412,-88,-92,4,66:d8:ff:ae:5d:41,29865694,64,4173,29865630,29865694
6447,6,6,1,2412,-86,-92,6,,29865776,44,38,29865732,29865776
6448,6,12,1,2412,-86,-92,6,,29865888,32,80,29865856,29865888
6449,4,1,1,2412,-82,-92,10,,29867406,304,1214,29867102,29867406
6450,4,1,1,2412,-75,-92,17,b8:3a:5a:88:e6:e0,29868905,2360,-861,29866545,29868905
6451,6,12,1,2412,-86,-92,6,84:d4:7e:f2:34:20,29872994,160,3929,29872834,29872994
6452,6,6,1,2412,-85,-92,7,84:d4:7e:f2:34:21,29873196,368,-166,29872828,29873196
6453,6,12,1,2412,-85,-92,7,84:d4:7e:f2:34:23,29873921,180,545,29873741,29873921
6454,6,6,1,2412,-83,-92,9,84:d4:7e:f2:34:26,29874598,380,297,29874218,29874598
6455,6,12,1,2412,-54,-92,38,40:e3:d6:da:ba:22,29885563,180,10785,29885383,29885563
6456,6,12,1,2412,-54,-92,38,40:e3:d6:da:ba:23,29885787,184,40,29885603,29885787
6457,6,12,1,2412,-54,-92,38,40:e3:d6:da:ba:24,29886023,176,60,29885847,29886023
6458,6,12,1,2412,-55,-92,37,40:e3:d6:da:ba:25,29886242,160,59,29886082,29886242
6459,6,12,1,2412,-87,-92,5,84:d4:7e:f2:42:25,29886953,160,551,29886793,29886953
6460,6,12,1,2412,-87,-92,5,,29896560,32,9575,29896528,29896560
6461,6,12,1,2412,-89,-92,3,40:e3:d6:da:ca:c4,29900783,172,4051,29900611,29900783
6462,6,12,1,2412,-88,-92,4,40:e3:d6:da:ca:c5,29900990,156,51,29900834,29900990
6463,6,6,1,2412,-87,-92,5,40:e3:d6:da:ca:c6,29901196,380,-174,29900816,29901196
6464,6,24,1,2412,-86,-92,6,66:d8:ff:ae:5d:41,29901632,32,404,29901600,29901632
6465,6,12,1,2412,-85,-92,7,,29901682,32,18,29901650,29901682
6466,6,12,1,2412,-85,-92,7,,29901905,32,191,29901873,29901905
6467,6,12,1,2412,-84,-92,8,,29909414,32,7477,29909382,29909414
6468,6,12,1,2412,-83,-92,9,,29911001,32,1555,29910969,29911001
6469,6,12,1,2412,-84,-92,8,,29911224,32,191,29911192,29911224
6470,6,6,1,2412,-85,-92,7,66:d8:ff:ae:5d:41,29912343,64,1055,29912279,29912343
6471,6,6,1,2412,-87,-92,5,66:d8:ff:ae:5d:41,29912488,64,81,29912424,29912488
6472,6,6,1,2412,-85,-92,7,,29912569,44,37,29912525,29912569
6473,6,12,1,2412,-85,-92,7,,29915617,32,3016,29915585,29915617
6474,6,24,1,2412,-86,-92,6,66:d8:ff:ae:5d:41,29915800,32,151,29915768,29915800
6475,6,12,1,2412,-85,-92,7,,29915849,32,17,29915817,29915849
6476,6,24,1,2412,-87,-92,5,66:d8:ff:ae:5d:41,29917013,32,1132,29916981,29917013
6477,6,12,1,2412,-86,-92,6,,29917062,32,17,29917030,29917062
6478,6,24,1,2412,-86,-92,6,66:d8:ff:ae:5d:41,29917317,32,223,29917285,29917317
6479,6,12,1,2412,-85,-92,7,,29917367,32,18,29917335,29917367
6480,6,24,1,2412,-87,-92,5,66:d8:ff:ae:5d:41,29918570,32,1171,29918538,29918570
6481,6,12,1,2412,-86,-92,6,,29918619,32,17,29918587,29918619
6482,6,24,1,2412,-87,-92,5,66:d8:ff:ae:5d:41,29918802,32,151,29918770,29918802
6483,6,12,1,2412,-85,-92,7,,29918851,32,17,29918819,29918851
6484,6,12,1,2412,-88,-92,4,,29918951,32,68,29918919,29918951
6485,6,12,1,2412,-89,-92,3,,29919587,32,604,29919555,29919587
6486,4,1,1,2412,-69,-92,23,7e:da:03:af:ee:ca,29919809,992,-770,29918817,29919809
6487,4,1,1,2412,-72,-92,20,54:e4:3a:ec:fb:64,29920917,2112,-1004,29918805,29920917
6488,4,1,1,2412,-66,-92,26,,29923045,304,1824,29922741,29923045
6489,6,12,1,2412,-54,-92,38,40:e3:d6:da:ba:20,29923209,136,28,29923073,29923209
6490,6,6,1,2412,-54,-92,38,40:e3:d6:da:ba:21,29923386,348,-171,29923038,29923386
6491,6,6,1,2412,-70,-92,22,,29923752,44,322,29923708,29923752
6492,6,12,1,2412,-54,-92,38,40:e3:d6:da:ba:22,29923829,156,-79,29923673,29923829
6493,6,12,1,2412,-54,-92,38,40:e3:d6:da:ba:23,29924074,156,89,29923918,29924074
6494,6,12,1,2412,-69,-92,23,,29924247,32,141,29924215,29924247
6495,6,12,1,2412,-54,-92,38,40:e3:d6:da:ba:25,29924337,136,-46,29924201,29924337
6496,6,12,1,2412,-70,-92,22,,29924491,32,122,29924459,29924491
6497,6,12,1,2412,-85,-92,7,,29926788,32,2265,29926756,29926788
6498,6,24,1,2412,-87,-92,5,66:d8:ff:ae:5d:41,29930044,32,3224,29930012,29930044
6499,6,12,1,2412,-86,-92,6,,29930094,32,18,29930062,29930094
6500,6,6,1,2412,-88,-92,4,40:e3:d6:da:c8:01,29931353,368,891,29930985,29931353
6501,6,12,1,2412,-90,-92,2,40:e3:d6:da:c8:02,29931750,180,217,29931570,29931750
6502,6,12,1,2412,-87,-92,5,40:e3:d6:da:c8:03,29931955,184,21,29931771,29931955
6503,6,12,1,2412,-85,-92,7,,29956328,32,24341,29956296,29956328
6504,6,12,1,2412,-85,-92,7,,29960221,32,3861,29960189,29960221
6505,6,12,1,2412,-85,-92,7,84:d4:7e:f2:34:20,29975385,160,15004,29975225,29975385
6506,4,1,1,2412,-73,-92,19,b8:3a:5a:88:e6:e0,29975745,2360,-2000,29973385,29975745
6507,4,1,1,2412,-74,-92,18,b8:3a:5a:88:e6:e1,29978125,2376,4,29975749,29978125
6508,6,6,1,2412,-89,-92,3,40:e3:d6:da:bb:e1,29984244,368,5751,29983876,29984244
6509,6,24,1,2412,-86,-92,6,66:d8:ff:ae:5d:41,29984623,32,347,29984591,29984623
6510,6,12,1,2412,-87,-92,5,40:e3:d6:da:bb:e5,29985280,156,501,29985124,29985280
6511,6,6,1,2412,-88,-92,4,40:e3:d6:da:bb:e6,29985468,380,-192,29985088,29985468
6512,6,12,1,2412,-84,-92,8,,29987074,32,1574,29987042,29987074
6513,6,12,1,2412,-54,-92,38,40:e3:d6:da:ba:20,29987342,160,108,29987182,29987342
6514,6,12,1,2412,-54,-92,38,40:e3:d6:da:ba:23,29988162,184,636,29987978,29988162
6515,6,12,1,2412,-55,-92,37,40:e3:d6:da:ba:24,29988381,176,43,29988205,29988381
6516,6,12,1,2412,-54,-92,38,40:e3:d6:da:ba:25,29988591,160,50,29988431,29988591
6517,6,6,1,2412,-54,-92,38,40:e3:d6:da:ba:26,29988810,380,-161,29988430,29988810
6518,6,12,1,2412,-87,-92,5,84:d4:7e:f2:42:24,29989207,176,221,29989031,29989207
6519,6,6,1,2412,-86,-92,6,84:d4:7e:f2:42:26,29989645,380,58,29989265,29989645
6520,6,12,1,2412,-86,-92,6,,29990144,32,467,29990112,29990144
6521,6,24,1,2412,-86,-92,6,66:d8:ff:ae:5d:41,30000769,32,10593,30000737,30000769
6522,6,12,1,2412,-85,-92,7,,30000818,32,17,30000786,30000818
6523,6,24,1,2412,-87,-92,5,66:d8:ff:ae:5d:41,30001028,32,178,30000996,30001028
6524,6,12,1,2412,-85,-92,7,,30001078,32,18,30001046,30001078
6525,6,12,1,2412,-88,-92,4,40:e3:d6:da:ca:c0,30002165,156,931,30002009,30002165
6526,6,6,1,2412,-88,-92,4,40:e3:d6:da:ca:c1,30002372,368,-161,30002004,30002372
6527,6,12,1,2412,-88,-92,4,40:e3:d6:da:ca:c2,30002759,176,211,30002583,30002759
6528,6,6,1,2412,-89,-92,3,40:e3:d6:da:ca:c6,30003596,380,457,30003216,30003596
6529,6,12,1,2412,-90,-92,2,40:e3:d6:da:c8:00,30033540,160,29784,30033380,30033540
6530,6,6,1,2412,-89,-92,3,40:e3:d6:da:c8:01,30033741,368,-167,30033373,30033741
6531,6,12,1,2412,-88,-92,4,40:e3:d6:da:c8:02,30034128,180,207,30033948,30034128
6532,6,12,1,2412,-88,-92,4,40:e3:d6:da:c8:03,30034342,184,30,30034158,30034342
6533,6,12,1,2412,-88,-92,4,40:e3:d6:da:c8:04,30034552,176,34,30034376,30034552
6534,6,24,1,2412,-86,-92,6,66:d8:ff:ae:5d:41,30035674,32,1090,30035642,30035674
6535,6,12,1,2412,-87,-92,5,,30035723,32,17,30035691,30035723
6536,4,1,1,2412,-85,-92,7,,30037462,304,1435,30037158,30037462
6537,4,1,1,2412,-76,-92,16,b8:3a:5a:88:e6:e0,30037798,2240,-1904,30035558,30037798
6538,6,6,1,2412,-85,-92,7,40:e3:d6:da:ca:c1,30039907,348,1761,30039559,30039907
6539,6,24,1,2412,-86,-92,6,66:d8:ff:ae:5d:41,30044347,32,4408,30044315,30044347
6540,6,12,1,2412,-85,-92,7,,30044397,32,18,30044365,30044397
6541,6,24,1,2412,-87,-92,5,66:d8:ff:ae:5d:41,30044570,32,141,30044538,30044570
6542,4,1,1,2412,-73,-92,19,54:e4:3a:ec:fb:64,30046308,2160,-422,30044148,30046308
6543,6,24,1,2412,-86,-92,6,66:d8:ff:ae:5d:41,30048977,32,2637,30048945,30048977
6544,6,12,1,2412,-85,-92,7,,30049026,32,17,30048994,30049026
6545,6,24,1,2412,-86,-92,6,66:d8:ff:ae:5d:41,30050801,32,1743,30050769,30050801
6546,6,12,1,2412,-87,-92,5,,30050850,32,17,30050818,30050850
6547,4,1,1,2412,-83,-92,9,,30057754,304,6600,30057450,30057754
6548,4,1,1,2412,-83,-92,9,,30058171,304,113,30057867,30058171
6549,4,1,1,2412,-85,-92,7,,30058926,304,451,30058622,30058926
6550,4,1,1,2412,-75,-92,17,b8:3a:5a:88:e6:e0,30059297,2240,-1869,30057057,30059297
6551,4,1,1,2412,-75,-92,17,b8:3a:5a:88:e6:e1,30061682,2256,129,30059426,30061682
6552,4,1,1,2412,-76,-92,16,b8:3a:5a:88:e6:e0,30073706,2360,9664,30071346,30073706
6553,6,12,1,2412,-85,-92,7,84:d4:7e:f2:34:20,30077772,160,3906,30077612,30077772
6554,6,6,1,2412,-86,-92,6,84:d4:7e:f2:34:21,30077973,368,-167,30077605,30077973
6555,6,12,1,2412,-85,-92,7,84:d4:7e:f2:34:22,30078386,180,233,30078206,30078386
6556,6,12,1,2412,-85,-92,7,84:d4:7e:f2:34:23,30078619,180,53,30078439,30078619
6557,6,6,1,2412,-73,-92,19,e6:aa:ea:b7:4a:dd,30078957,408,-70,30078549,30078957
6558,4,1,1,2412,-78,-92,14,b8:3a:5a:88:e6:e1,30079984,2376,-1349,30077608,30079984
6559,6,6,1,2412,-88,-92,4,40:e3:d6:da:ca:c1,30085910,348,5578,30085562,30085910
6560,6,12,1,2412,-89,-92,3,40:e3:d6:da:ca:c2,30086295,156,229,30086139,30086295
6561,6,12,1,2412,-90,-92,2,40:e3:d6:da:bb:e5,30088442,156,1991,30088286,30088442
6562,6,12,1,2412,-56,-92,36,40:e3:d6:da:ba:20,30089744,160,1142,30089584,30089744
6563,6,12,1,2412,-56,-92,36,40:e3:d6:da:ba:22,30090368,180,444,30090188,30090368
6564,6,12,1,2412,-56,-92,36,40:e3:d6:da:ba:23,30090600,184,48,30090416,30090600
6565,6,12,1,2412,-57,-92,35,40:e3:d6:da:ba:24,30090819,176,43,30090643,30090819
6566,6,12,1,2412,-56,-92,36,40:e3:d6:da:ba:25,30091029,160,50,30090869,30091029
6567,6,6,1,2412,-56,-92,36,40:e3:d6:da:ba:26,30091230,380,-179,30090850,30091230
6568,6,6,1,2412,-85,-92,7,84:d4:7e:f2:42:26,30092022,380,412,30091642,30092022
6569,6,6,1,2412,-75,-92,17,e6:aa:ea:b7:4a:dd,30103188,408,10758,30102780,30103188
6570,6,12,1,2412,-88,-92,4,40:e3:d6:da:ca:c5,30105913,156,2569,30105757,30105913
6571,6,6,1,2412,-89,-92,3,40:e3:d6:da:ca:c6,30106102,380,-191,30105722,30106102
6572,6,6,1,2412,-75,-92,17,e6:aa:ea:b7:4a:dd,30115297,408,8787,30114889,30115297
6573,6,12,1,2412,-88,-92,4,,30116041,36,708,30116005,30116041
6574,6,12,1,2412,-86,-92,6,,30116219,36,142,30116183,30116219
6575,6,12,1,2412,-87,-92,5,,30119196,32,2945,30119164,30119196
6576,6,12,1,2412,-88,-92,4,,30132313,32,13085,30132281,30132313
6577,4,1,1,2412,-72,-92,20,54:e4:3a:ec:fb:64,30148713,2160,14240,30146553,30148713
6578,4,1,1,2412,-78,-92,14,b8:3a:5a:88:e6:e0,30176125,2360,25052,30173765,30176125
6579,4,1,1,2412,-78,-92,14,b8:3a:5a:88:e6:e1,30178587,2376,86,30176211,30178587
6580,6,12,1,2412,-89,-92,3,40:e3:d6:da:bb:e0,30189237,156,10494,30189081,30189237
6581,6,12,1,2412,-89,-92,3,40:e3:d6:da:bb:e3,30190094,180,677,30189914,30190094
6582,6,12,1,2412,-89,-92,3,40:e3:d6:da:bb:e4,30190299,172,33,30190127,30190299
6583,6,12,1,2412,-88,-92,4,40:e3:d6:da:bb:e5,30190523,156,68,30190367,30190523
6584,6,12,1,2412,-57,-92,35,40:e3:d6:da:ba:20,30192154,160,1471,30191994,30192154
6585,6,6,1,2412,-57,-92,35,40:e3:d6:da:ba:21,30192364,368,-158,30191996,30192364
6586,6,12,1,2412,-57,-92,35,40:e3:d6:da:ba:22,30192751,180,207,30192571,30192751
6587,6,12,1,2412,-57,-92,35,40:e3:d6:da:ba:24,30193175,176,248,30192999,30193175
6588,6,12,1,2412,-57,-92,35,40:e3:d6:da:ba:25,30193377,160,42,30193217,30193377
6589,6,6,1,2412,-56,-92,36,40:e3:d6:da:ba:26,30193595,380,-162,30193215,30193595
6590,6,12,1,2412,-89,-92,3,40:e3:d6:da:c8:00,30238337,160,44582,30238177,30238337
6591,6,6,1,2412,-89,-92,3,40:e3:d6:da:c8:01,30238556,368,-149,30238188,30238556
6592,6,12,1,2412,-89,-92,3,40:e3:d6:da:c8:02,30238970,180,234,30238790,30238970
6593,6,6,1,2412,-89,-92,3,40:e3:d6:da:c8:06,30239805,380,455,30239425,30239805
6594,4,1,1,2412,-70,-92,22,54:e4:3a:ec:fb:64,30251110,2160,9145,30248950,30251110
6595,6,6,1,2412,-81,-92,11,84:1b:5e:df:1b:99,30255858,80,4668,30255778,30255858
6596,6,6,1,2412,-58,-92,34,e6:aa:ea:c9:ea:33,30271139,408,14873,30270731,30271139
6597,4,1,1,2412,-76,-92,16,b8:3a:5a:88:e6:e1,30280904,2376,7389,30278528,30280904
6598,6,6,1,2412,-58,-92,34,e6:aa:ea:c9:ea:33,30283245,408,1933,30282837,30283245
6599,6,12,1,2412,-88,-92,4,84:d4:7e:f2:34:22,30284021,180,596,30283841,30284021
6600,6,12,1,2412,-88,-92,4,84:d4:7e:f2:34:23,30284236,180,35,30284056,30284236
6601,6,6,1,2412,-89,-92,3,40:e3:d6:da:bb:e1,30291443,368,6839,30291075,30291443
6602,6,12,1,2412,-87,-92,5,40:e3:d6:da:bb:e2,30291830,176,211,30291654,30291830
6603,6,12,1,2412,-88,-92,4,40:e3:d6:da:bb:e3,30292049,180,39,30291869,30292049
6604,6,6,1,2412,-87,-92,5,40:e3:d6:da:bb:e6,30292676,380,247,30292296,30292676
6605,6,6,1,2412,-56,-92,36,40:e3:d6:da:ba:21,30294760,368,1716,30294392,30294760
6606,6,12,1,2412,-56,-92,36,40:e3:d6:da:ba:22,30295174,180,234,30294994,30295174
6607,6,12,1,2412,-56,-92,36,40:e3:d6:da:ba:23,30295379,184,21,30295195,30295379
6608,6,12,1,2412,-56,-92,36,40:e3:d6:da:ba:24,30295606,176,51,30295430,30295606
6609,6,6,1,2412,-58,-92,34,e6:aa:ea:c9:ea:33,30295823,408,-191,30295415,30295823
6610,6,12,1,2412,-57,-92,35,40:e3:d6:da:ba:25,30296288,160,305,30296128,30296288
6611,6,6,1,2412,-56,-92,36,40:e3:d6:da:ba:26,30296498,380,-170,30296118,30296498
6612,6,6,1,2412,-57,-92,35,e6:aa:ea:c9:ea:33,30307538,408,10632,30307130,30307538
6613,4,1,1,2412,-73,-92,19,c0:c9:e3:4d:6e:bf,30312325,872,3915,30311453,30312325
6614,4,1,1,2412,-86,-92,6,,30313214,304,585,30312910,30313214
6615,6,6,1,2412,-90,-92,2,a8:5b:f7:55:1a:40,30313485,72,199,30313413,30313485
6616,6,6,1,2412,-90,-92,2,a8:5b:f7:55:1a:40,30313592,72,35,30313520,30313592
6617,6,6,1,2412,-90,-92,2,a8:5b:f7:55:1a:40,30313709,72,45,30313637,30313709
6618,6,6,1,2412,-89,-92,3,a8:5b:f7:55:1a:40,30313861,72,80,30313789,30313861
6619,6,6,1,2412,-89,-92,3,a8:5b:f7:55:1a:40,30313969,72,36,30313897,30313969
6620,6,6,1,2412,-90,-92,2,a8:5b:f7:55:1a:40,30314184,72,143,30314112,30314184
6621,6,6,1,2412,-90,-92,2,a8:5b:f7:55:1a:40,30314292,72,36,30314220,30314292
6622,6,6,1,2412,-90,-92,2,a8:5b:f7:55:1a:40,30314499,72,135,30314427,30314499
6623,6,6,1,2412,-91,-92,1,a8:5b:f7:55:1a:40,30314606,72,35,30314534,30314606
6624,6,6,1,2412,-91,-92,1,a8:5b:f7:55:1a:40,30314785,72,107,30314713,30314785
6625,6,6,1,2412,-91,-92,1,a8:5b:f7:55:1a:40,30314938,72,81,30314866,30314938
6626,6,6,1,2412,-92,-92,0,a8:5b:f7:55:1a:40,30315046,72,36,30314974,30315046
6627,6,6,1,2412,-90,-92,2,a8:5b:f7:55:1a:40,30315216,72,98,30315144,30315216
6628,6,6,1,2412,-90,-92,2,a8:5b:f7:55:1a:40,30315324,72,36,30315252,30315324
6629,6,6,1,2412,-87,-92,5,a8:5b:f7:55:1a:40,30316681,72,1285,30316609,30316681
6630,6,6,1,2412,-87,-92,5,a8:5b:f7:55:1a:40,30316788,72,35,30316716,30316788
6631,6,6,1,2412,-87,-92,5,a8:5b:f7:55:1a:40,30316994,72,134,30316922,30316994
6632,6,6,1,2412,-87,-92,5,a8:5b:f7:55:1a:40,30317102,72,36,30317030,30317102
6633,6,6,1,2412,-86,-92,6,a8:5b:f7:55:1a:40,30317443,72,269,30317371,30317443
6634,6,6,1,2412,-87,-92,5,a8:5b:f7:55:1a:40,30317641,72,126,30317569,30317641
6635,6,6,1,2412,-87,-92,5,a8:5b:f7:55:1a:40,30317748,72,35,30317676,30317748
6636,6,6,1,2412,-88,-92,4,a8:5b:f7:55:1a:40,30317991,72,171,30317919,30317991
6637,6,6,1,2412,-87,-92,5,a8:5b:f7:55:1a:40,30318098,72,35,30318026,30318098
6638,6,6,1,2412,-87,-92,5,a8:5b:f7:55:1a:40,30318367,72,197,30318295,30318367
6639,6,6,1,2412,-85,-92,7,a8:5b:f7:55:1a:40,30318547,72,108,30318475,30318547
6640,6,6,1,2412,-86,-92,6,a8:5b:f7:55:1a:40,30318654,72,35,30318582,30318654
6641,6,6,1,2412,-87,-92,5,a8:5b:f7:55:1a:40,30318878,72,152,30318806,30318878
6642,6,6,1,2412,-87,-92,5,a8:5b:f7:55:1a:40,30318985,72,35,30318913,30318985
6643,6,6,1,2412,-88,-92,4,e6:aa:ea:c9:ea:1b,30335246,408,15853,30334838,30335246
6644,4,1,1,2412,-69,-92,23,54:e4:3a:ec:fb:64,30353500,2160,16094,30351340,30353500
6645,4,1,1,2412,-74,-92,18,b8:3a:5a:88:e6:e0,30380913,2360,25053,30378553,30380913
6646,4,1,1,2412,-74,-92,18,b8:3a:5a:88:e6:e1,30383302,2376,13,30380926,30383302
6647,6,12,1,2412,-84,-92,8,84:d4:7e:f2:34:20,30385843,160,2381,30385683,30385843
6648,6,6,1,2412,-86,-92,6,84:d4:7e:f2:34:21,30386045,368,-166,30385677,30386045
6649,6,12,1,2412,-88,-92,4,84:d4:7e:f2:34:22,30386431,180,206,30386251,30386431
6650,6,12,1,2412,-88,-92,4,84:d4:7e:f2:34:23,30386637,180,26,30386457,30386637
6651,6,6,1,2412,-85,-92,7,40:e3:d6:da:bb:e1,30393842,368,6837,30393474,30393842
6652,6,12,1,2412,-88,-92,4,40:e3:d6:da:bb:e2,30394248,176,230,30394072,30394248
6653,6,12,1,2412,-88,-92,4,40:e3:d6:da:bb:e3,30394450,180,22,30394270,30394450
6654,6,12,1,2412,-88,-92,4,40:e3:d6:da:bb:e5,30394870,156,264,30394714,30394870
6655,6,6,1,2412,-87,-92,5,40:e3:d6:da:bb:e6,30395067,380,-183,30394687,30395067
6656,6,12,1,2412,-56,-92,36,40:e3:d6:da:ba:20,30396943,160,1716,30396783,30396943
6657,6,6,1,2412,-56,-92,36,40:e3:d6:da:ba:21,30397135,368,-176,30396767,30397135
6658,6,12,1,2412,-56,-92,36,40:e3:d6:da:ba:22,30397531,180,216,30397351,30397531
6659,6,12,1,2412,-56,-92,36,40:e3:d6:da:ba:23,30397737,184,22,30397553,30397737
6660,6,12,1,2412,-56,-92,36,40:e3:d6:da:ba:24,30397973,176,60,30397797,30397973
6661,6,12,1,2412,-56,-92,36,40:e3:d6:da:ba:25,30398193,160,60,30398033,30398193
6662,6,12,1,2412,-87,-92,5,40:e3:d6:da:ca:c0,30411764,156,13415,30411608,30411764
6663,6,6,1,2412,-87,-92,5,40:e3:d6:da:ca:c1,30411980,368,-152,30411612,30411980
6664,6,12,1,2412,-85,-92,7,40:e3:d6:da:ca:c3,30412604,180,444,30412424,30412604
6665,6,12,1,2412,-88,-92,4,40:e3:d6:da:ca:c4,30412827,172,51,30412655,30412827
6666,6,6,1,2412,-88,-92,4,40:e3:d6:da:ca:c6,30413258,380,51,30412878,30413258
6667,4,1,1,2412,-68,-92,24,7e:da:03:af:ee:ca,30423386,992,9136,30422394,30423386
6668,4,1,1,2412,-68,-92,24,,30426628,304,2938,30426324,30426628
6669,6,12,1,2412,-56,-92,36,40:e3:d6:da:ba:20,30426792,136,28,30426656,30426792
6670,6,6,1,2412,-57,-92,35,40:e3:d6:da:ba:21,30426969,348,-171,30426621,30426969
6671,6,12,1,2412,-56,-92,36,40:e3:d6:da:ba:22,30427363,156,238,30427207,30427363
6672,6,12,1,2412,-56,-92,36,40:e3:d6:da:ba:23,30427580,156,61,30427424,30427580
6673,6,12,1,2412,-56,-92,36,40:e3:d6:da:ba:25,30427797,136,81,30427661,30427797
6674,4,1,1,2412,-67,-92,25,54:e4:3a:ec:fb:64,30455929,2160,25972,30453769,30455929
6675,4,1,1,2412,-68,-92,24,7e:da:03:af:ee:ca,30469674,992,12753,30468682,30469674
6676,6,12,1,2412,-57,-92,35,40:e3:d6:da:ba:20,30470641,136,831,30470505,30470641
6677,6,6,1,2412,-57,-92,35,40:e3:d6:da:ba:21,30470854,348,-135,30470506,30470854
6678,6,12,1,2412,-56,-92,36,40:e3:d6:da:ba:22,30471239,156,229,30471083,30471239
6679,6,12,1,2412,-56,-92,36,40:e3:d6:da:ba:23,30471438,156,43,30471282,30471438
6680,6,12,1,2412,-56,-92,36,40:e3:d6:da:ba:25,30471647,136,73,30471511,30471647
6681,4,1,1,2412,-55,-92,37,b8:3a:5a:88:e6:e0,30483316,2360,9309,30480956,30483316
6682,4,1,1,2412,-73,-92,19,b8:3a:5a:88:e6:e1,30485723,2376,31,30483347,30485723
6683,6,12,1,2412,-87,-92,5,84:d4:7e:f2:34:22,30488026,180,2123,30487846,30488026
6684,6,12,1,2412,-86,-92,6,84:d4:7e:f2:34:25,30488666,160,480,30488506,30488666
6685,6,6,1,2412,-87,-92,5,84:d4:7e:f2:34:26,30488875,380,-171,30488495,30488875
6686,6,12,1,2412,-87,-92,5,40:e3:d6:da:bb:e2,30496727,176,7676,30496551,30496727
6687,6,12,1,2412,-87,-92,5,40:e3:d6:da:bb:e3,30497364,180,457,30497184,30497364
6688,6,12,1,2412,-86,-92,6,40:e3:d6:da:bb:e4,30497587,172,51,30497415,30497587
6689,6,12,1,2412,-57,-92,35,40:e3:d6:da:ba:20,30499349,160,1602,30499189,30499349
6690,6,6,1,2412,-56,-92,36,40:e3:d6:da:ba:21,30499559,368,-158,30499191,30499559
6691,6,12,1,2412,-56,-92,36,40:e3:d6:da:ba:22,30499955,180,216,30499775,30499955
6692,6,12,1,2412,-56,-92,36,40:e3:d6:da:ba:23,30500187,184,48,30500003,30500187
6693,6,12,1,2412,-56,-92,36,40:e3:d6:da:ba:25,30500616,160,269,30500456,30500616
6694,6,12,1,2412,-87,-92,5,84:d4:7e:f2:42:25,30501390,160,614,30501230,30501390
6695,6,6,1,2412,-86,-92,6,84:d4:7e:f2:42:26,30501600,380,-170,30501220,30501600
6696,6,6,1,2412,-87,-92,5,40:e3:d6:da:ca:c1,30514370,368,12402,30514002,30514370
6697,6,12,1,2412,-87,-92,5,40:e3:d6:da:ca:c2,30514756,176,210,30514580,30514756
6698,6,12,1,2412,-86,-92,6,40:e3:d6:da:ca:c3,30514966,180,30,30514786,30514966
6699,6,12,1,2412,-83,-92,9,40:e3:d6:da:c8:02,30546109,180,30963,30545929,30546109
6700,6,12,1,2412,-85,-92,7,40:e3:d6:da:c8:03,30546332,184,39,30546148,30546332
6701,6,12,1,2412,-86,-92,6,40:e3:d6:da:c8:04,30546550,176,42,30546374,30546550
6702,6,12,1,2412,-85,-92,7,40:e3:d6:da:c8:05,30546752,160,42,30546592,30546752
6703,6,6,1,2412,-85,-92,7,40:e3:d6:da:c8:06,30546962,380,-170,30546582,30546962
6704,4,1,1,2412,-68,-92,24,54:e4:3a:ec:fb:64,30558386,2160,9264,30556226,30558386
6705,4,1,1,2412,-73,-92,19,b8:3a:5a:88:e6:e0,30585692,2360,24946,30583332,30585692
6706,6,6,1,2412,-71,-92,21,e6:aa:ea:b7:4a:dd,30598615,408,12515,30598207,30598615
6707,6,12,1,2412,-57,-92,35,40:e3:d6:da:ba:20,30601757,160,2982,30601597,30601757
6708,6,6,1,2412,-57,-92,35,40:e3:d6:da:ba:21,30601958,368,-167,30601590,30601958
6709,6,12,1,2412,-57,-92,35,40:e3:d6:da:ba:22,30602363,180,225,30602183,30602363
6710,6,12,1,2412,-57,-92,35,40:e3:d6:da:ba:23,30602577,184,30,30602393,30602577
6711,6,12,1,2412,-57,-92,35,40:e3:d6:da:ba:24,30602796,176,43,30602620,30602796
6712,6,12,1,2412,-57,-92,35,40:e3:d6:da:ba:25,30603006,160,50,30602846,30603006
6713,6,6,1,2412,-57,-92,35,40:e3:d6:da:ba:26,30603207,380,-179,30602827,30603207
6714,6,12,1,2412,-86,-92,6,84:d4:7e:f2:42:24,30603588,176,205,30603412,30603588
6715,6,12,1,2412,-82,-92,10,84:d4:7e:f2:42:25,30603816,160,68,30603656,30603816
6716,6,6,1,2412,-80,-92,12,84:d4:7e:f2:42:26,30604008,380,-188,30603628,30604008
6717,6,6,1,2412,-88,-92,4,40:e3:d6:da:bb:e6,30605635,380,1247,30605255,30605635
6718,6,6,1,2412,-71,-92,21,e6:aa:ea:b7:4a:dd,30610850,408,4807,30610442,30610850
6719,6,6,1,2412,-87,-92,5,e6:aa:ea:c9:ea:1b,30615569,408,4311,30615161,30615569
6720,6,12,1,2412,-87,-92,5,40:e3:d6:da:ca:c2,30617200,176,1455,30617024,30617200
6721,6,12,1,2412,-85,-92,7,40:e3:d6:da:ca:c5,30617868,156,512,30617712,30617868
6722,6,6,1,2412,-85,-92,7,e6:aa:ea:c9:ea:1b,30651903,408,33627,30651495,30651903
6723,4,1,1,2412,-67,-92,25,54:e4:3a:ec:fb:64,30660726,2160,6663,30658566,30660726
6724,6,6,1,2412,-86,-92,6,e6:aa:ea:c9:ea:1b,30664033,408,2899,30663625,30664033
6725,4,1,1,2412,-73,-92,19,b8:3a:5a:88:e6:e1,30690499,2376,24090,30688123,30690499
6726,6,12,1,2412,-82,-92,10,84:d4:7e:f2:34:22,30693655,180,2976,30693475,30693655
6727,6,12,1,2412,-86,-92,6,84:d4:7e:f2:34:23,30693870,180,35,30693690,30693870
6728,6,12,1,2412,-88,-92,4,84:d4:7e:f2:34:24,30694102,176,56,30693926,30694102
6729,6,12,1,2412,-86,-92,6,84:d4:7e:f2:34:25,30694313,160,51,30694153,30694313
6730,6,6,1,2412,-88,-92,4,84:d4:7e:f2:34:26,30694514,380,-179,30694134,30694514
6731,6,6,1,2412,-54,-92,38,e6:aa:ea:c9:ea:33,30700860,408,5938,30700452,30700860
6732,6,12,1,2412,-88,-92,4,40:e3:d6:da:bb:e2,30701440,176,404,30701264,30701440
6733,6,12,1,2412,-87,-92,5,40:e3:d6:da:bb:e3,30701650,180,30,30701470,30701650
6734,6,12,1,2412,-88,-92,4,40:e3:d6:da:bb:e5,30702090,156,284,30701934,30702090
6735,6,6,1,2412,-88,-92,4,40:e3:d6:da:bb:e6,30702277,380,-193,30701897,30702277
6736,6,12,1,2412,-57,-92,35,40:e3:d6:da:ba:20,30704168,160,1731,30704008,30704168
6737,6,6,1,2412,-57,-92,35,40:e3:d6:da:ba:21,30704368,368,-168,30704000,30704368
6738,6,12,1,2412,-57,-92,35,40:e3:d6:da:ba:22,30704773,180,225,30704593,30704773
6739,6,12,1,2412,-57,-92,35,40:e3:d6:da:ba:23,30704997,184,40,30704813,30704997
6740,6,12,1,2412,-57,-92,35,40:e3:d6:da:ba:25,30705435,160,278,30705275,30705435
6741,6,6,1,2412,-57,-92,35,40:e3:d6:da:ba:26,30705636,380,-179,30705256,30705636
6742,6,12,1,2412,-86,-92,6,84:d4:7e:f2:42:25,30706229,160,433,30706069,30706229
6743,6,6,1,2412,-54,-92,38,e6:aa:ea:c9:ea:33,30712964,408,6327,30712556,30712964
6744,6,12,1,2412,-88,-92,4,40:e3:d6:da:ca:c0,30719162,156,6042,30719006,30719162
6745,6,6,1,2412,-87,-92,5,40:e3:d6:da:ca:c1,30719376,368,-154,30719008,30719376
6746,6,12,1,2412,-88,-92,4,40:e3:d6:da:ca:c2,30719764,176,212,30719588,30719764
6747,6,12,1,2412,-88,-92,4,40:e3:d6:da:ca:c3,30719992,180,48,30719812,30719992
6748,6,12,1,2412,-88,-92,4,40:e3:d6:da:ca:c4,30720197,172,33,30720025,30720197
6749,6,6,1,2412,-87,-92,5,40:e3:d6:da:ca:c6,30720610,380,33,30720230,30720610
6750,6,6,1,2412,-54,-92,38,e6:aa:ea:c9:ea:33,30725245,408,4227,30724837,30725245
6751,6,12,1,2412,-85,-92,7,40:e3:d6:da:c8:00,30750326,160,24921,30750166,30750326
6752,6,6,1,2412,-86,-92,6,40:e3:d6:da:c8:01,30750536,368,-158,30750168,30750536
6753,6,12,1,2412,-86,-92,6,40:e3:d6:da:c8:02,30750949,180,233,30750769,30750949
6754,6,12,1,2412,-84,-92,8,40:e3:d6:da:c8:05,30751707,160,598,30751547,30751707
6755,6,6,1,2412,-86,-92,6,40:e3:d6:da:c8:06,30751916,380,-171,30751536,30751916
6756,4,1,1,2412,-68,-92,24,54:e4:3a:ec:fb:64,30768796,2160,14720,30766636,30768796
6757,4,1,1,2412,-72,-92,20,b8:3a:5a:88:e6:e0,30790506,2360,19350,30788146,30790506
6758,4,1,1,2412,-72,-92,20,b8:3a:5a:88:e6:e1,30792886,2376,4,30790510,30792886
6759,6,12,1,2412,-87,-92,5,84:d4:7e:f2:34:20,30795497,160,2451,30795337,30795497
6760,6,12,1,2412,-87,-92,5,84:d4:7e:f2:34:24,30796486,176,813,30796310,30796486
6761,6,12,1,2412,-87,-92,5,84:d4:7e:f2:34:25,30796715,160,69,30796555,30796715
6762,6,6,1,2412,-87,-92,5,84:d4:7e:f2:34:26,30796934,380,-161,30796554,30796934
6763,6,12,1,2412,-57,-92,35,40:e3:d6:da:ba:20,30806554,160,9460,30806394,30806554
6764,6,12,1,2412,-57,-92,35,40:e3:d6:da:ba:25,30808326,160,1612,30808166,30808326
6765,6,6,1,2412,-57,-92,35,40:e3:d6:da:ba:26,30808518,380,-188,30808138,30808518
6766,4,1,1,2412,-82,-92,10,,30848919,304,40097,30848615,30848919
6767,6,12,1,2412,-87,-92,5,40:e3:d6:da:c8:05,30853959,160,4880,30853799,30853959
6768,6,6,1,2412,-87,-92,5,40:e3:d6:da:c8:06,30854177,380,-162,30853797,30854177
6769,6,12,1,2412,-86,-92,6,84:d4:7e:f2:34:20,30898233,160,43896,30898073,30898233
6770,6,6,1,2412,-87,-92,5,84:d4:7e:f2:34:21,30898443,368,-158,30898075,30898443
6771,6,12,1,2412,-87,-92,5,84:d4:7e:f2:34:22,30898839,180,216,30898659,30898839
6772,6,12,1,2412,-87,-92,5,84:d4:7e:f2:34:23,30899054,180,35,30898874,30899054
6773,6,12,1,2412,-87,-92,5,84:d4:7e:f2:34:24,30899268,176,38,30899092,30899268
6774,6,12,1,2412,-87,-92,5,84:d4:7e:f2:34:25,30899478,160,50,30899318,30899478
6775,6,6,1,2412,-87,-92,5,84:d4:7e:f2:34:26,30899697,380,-161,30899317,30899697
6776,6,6,1,2412,-71,-92,21,e6:aa:ea:b7:4a:dd,30901740,408,1635,30901332,30901740
6777,6,12,1,2412,-87,-92,5,40:e3:d6:da:bb:e0,30905629,156,3733,30905473,30905629
6778,6,6,1,2412,-87,-92,5,40:e3:d6:da:bb:e1,30905844,368,-153,30905476,30905844
6779,6,12,1,2412,-87,-92,5,40:e3:d6:da:bb:e2,30906241,176,221,30906065,30906241
6780,6,12,1,2412,-87,-92,5,40:e3:d6:da:bb:e4,30906684,172,271,30906512,30906684
6781,6,12,1,2412,-86,-92,6,40:e3:d6:da:bb:e5,30906908,156,68,30906752,30906908
6782,6,6,1,2412,-86,-92,6,40:e3:d6:da:bb:e6,30907105,380,-183,30906725,30907105
6783,6,12,1,2412,-57,-92,35,40:e3:d6:da:ba:20,30908966,160,1701,30908806,30908966
6784,6,6,1,2412,-57,-92,35,40:e3:d6:da:ba:21,30909167,368,-167,30908799,30909167
6785,6,12,1,2412,-57,-92,35,40:e3:d6:da:ba:22,30909572,180,225,30909392,30909572
6786,4,1,1,2412,-66,-92,26,54:e4:3a:ec:fb:64,30909958,2160,-1774,30907798,30909958
6787,6,12,1,2412,-57,-92,35,40:e3:d6:da:ba:23,30912014,184,1872,30911830,30912014
6788,6,12,1,2412,-55,-92,37,40:e3:d6:da:ba:24,30912232,176,42,30912056,30912232
6789,6,12,1,2412,-57,-92,35,40:e3:d6:da:ba:25,30912452,160,60,30912292,30912452
6790,6,6,1,2412,-57,-92,35,40:e3:d6:da:ba:26,30912644,380,-188,30912264,30912644
6791,6,6,1,2412,-71,-92,21,e6:aa:ea:b7:4a:dd,30913936,408,884,30913528,30913936
6792,6,12,1,2412,-86,-92,6,40:e3:d6:da:ca:c5,30925417,156,11325,30925261,30925417
6793,6,6,1,2412,-71,-92,21,e6:aa:ea:b7:4a:dd,30938103,408,12278,30937695,30938103
6794,6,12,1,2412,-87,-92,5,40:e3:d6:da:c8:00,30955149,160,16886,30954989,30955149
6795,4,1,1,2412,-73,-92,19,b8:3a:5a:88:e6:e1,30997689,2376,40164,30995313,30997689
6796,6,12,1,2412,-87,-92,5,84:d4:7e:f2:34:20,31000240,160,2391,31000080,31000240
6797,6,6,1,2412,-87,-92,5,84:d4:7e:f2:34:21,31000440,368,-168,31000072,31000440
6798,6,12,1,2412,-86,-92,6,84:d4:7e:f2:34:25,31001503,160,903,31001343,31001503
6799,6,6,1,2412,-87,-92,5,84:d4:7e:f2:34:26,31001722,380,-161,31001342,31001722
6800,6,12,1,2412,-87,-92,5,40:e3:d6:da:bb:e2,31008633,176,6735,31008457,31008633
6801,6,12,1,2412,-86,-92,6,40:e3:d6:da:bb:e3,31008852,180,39,31008672,31008852
6802,6,12,1,2412,-87,-92,5,40:e3:d6:da:bb:e4,31009067,172,43,31008895,31009067
6803,6,12,1,2412,-87,-92,5,40:e3:d6:da:bb:e5,31009274,156,51,31009118,31009274
6804,6,6,1,2412,-87,-92,5,40:e3:d6:da:bb:e6,31009480,380,-174,31009100,31009480
6805,6,12,1,2412,-57,-92,35,40:e3:d6:da:ba:22,31011989,180,2329,31011809,31011989
6806,6,12,1,2412,-57,-92,35,40:e3:d6:da:ba:23,31012213,184,40,31012029,31012213
6807,6,12,1,2412,-57,-92,35,40:e3:d6:da:ba:24,31012431,176,42,31012255,31012431
6808,6,12,1,2412,-57,-92,35,40:e3:d6:da:ba:25,31012642,160,51,31012482,31012642
6809,6,6,1,2412,-57,-92,35,40:e3:d6:da:ba:26,31012851,380,-171,31012471,31012851
6810,4,1,1,2412,-68,-91,23,54:e4:3a:ec:fb:64,31070257,2160,55246,31068097,31070257
6811,4,1,1,2412,-71,-91,20,b8:3a:5a:88:e6:e0,31097697,2360,25080,31095337,31097697
6812,6,12,1,2412,-84,-91,7,84:d4:7e:f2:34:20,31102637,160,4780,31102477,31102637
6813,6,12,1,2412,-86,-91,5,84:d4:7e:f2:34:22,31103260,180,443,31103080,31103260
6814,6,12,1,2412,-86,-91,5,84:d4:7e:f2:34:25,31103908,160,488,31103748,31103908
6815,6,12,1,2412,-57,-91,34,40:e3:d6:da:ba:20,31113748,160,9680,31113588,31113748
6816,6,6,1,2412,-57,-91,34,40:e3:d6:da:ba:21,31113939,368,-177,31113571,31113939
6817,6,12,1,2412,-57,-91,34,40:e3:d6:da:ba:22,31114326,180,207,31114146,31114326
6818,6,12,1,2412,-57,-91,34,40:e3:d6:da:ba:23,31114532,184,22,31114348,31114532
6819,6,12,1,2412,-57,-91,34,40:e3:d6:da:ba:24,31114768,176,60,31114592,31114768
6820,6,12,1,2412,-57,-91,34,40:e3:d6:da:ba:25,31114997,160,69,31114837,31114997
6821,6,6,1,2412,-57,-91,34,40:e3:d6:da:ba:26,31115189,380,-188,31114809,31115189
6822,4,1,1,2412,-68,-91,23,54:e4:3a:ec:fb:64,31172750,2160,55401,31170590,31172750
6823,4,1,1,2412,-74,-91,17,b8:3a:5a:88:e6:e1,31202497,2376,27371,31200121,31202497
6824,6,6,1,2412,-54,-91,37,e6:aa:ea:c9:ea:33,31208733,408,5828,31208325,31208733
6825,6,12,1,2412,-57,-91,34,40:e3:d6:da:ba:20,31216147,160,7254,31215987,31216147
6826,6,6,1,2412,-57,-91,34,40:e3:d6:da:ba:21,31216339,368,-176,31215971,31216339
6827,6,12,1,2412,-57,-91,34,40:e3:d6:da:ba:22,31216753,180,234,31216573,31216753
6828,6,12,1,2412,-57,-91,34,40:e3:d6:da:ba:23,31216976,184,39,31216792,31216976
6829,6,12,1,2412,-57,-91,34,40:e3:d6:da:ba:24,31217213,176,61,31217037,31217213
6830,6,12,1,2412,-57,-91,34,40:e3:d6:da:ba:25,31217414,160,41,31217254,31217414
6831,6,6,1,2412,-57,-91,34,40:e3:d6:da:ba:26,31217624,380,-170,31217244,31217624
6832,6,6,1,2412,-53,-91,38,e6:aa:ea:c9:ea:33,31220740,408,2708,31220332,31220740
6833,6,6,1,2412,-53,-91,38,e6:aa:ea:c9:ea:33,31232848,408,11700,31232440,31232848
6834,6,6,1,2412,-53,-91,38,e6:aa:ea:c9:ea:33,31244965,408,11709,31244557,31244965
6835,6,6,1,2412,-53,-91,38,e6:aa:ea:c9:ea:33,31257092,408,11719,31256684,31257092
6836,4,1,1,2412,-68,-91,23,54:e4:3a:ec:fb:64,31275110,2160,15858,31272950,31275110
6837,6,12,1,2412,-87,-91,4,84:d4:7e:f2:34:20,31307884,160,32614,31307724,31307884
6838,6,6,1,2412,-86,-91,5,84:d4:7e:f2:34:21,31308085,368,-167,31307717,31308085
6839,6,12,1,2412,-86,-91,5,84:d4:7e:f2:34:22,31308471,180,206,31308291,31308471
6840,6,12,1,2412,-86,-91,5,84:d4:7e:f2:34:24,31308909,176,262,31308733,31308909
6841,6,12,1,2412,-85,-91,6,84:d4:7e:f2:34:25,31309111,160,42,31308951,31309111
6842,6,12,1,2412,-57,-91,34,40:e3:d6:da:ba:24,31319741,176,10454,31319565,31319741
6843,6,12,1,2412,-57,-91,34,40:e3:d6:da:ba:25,31319952,160,51,31319792,31319952
6844,6,6,1,2412,-56,-91,35,40:e3:d6:da:ba:26,31320143,380,-189,31319763,31320143
6845,4,1,1,2412,-76,-91,15,,31343511,304,23064,31343207,31343511
6846,4,1,1,2412,-68,-91,23,54:e4:3a:ec:fb:64,31377448,2160,31777,31375288,31377448
6847,4,1,1,2412,-71,-91,20,b8:3a:5a:88:e6:e0,31404894,2360,25086,31402534,31404894
6848,4,1,1,2412,-70,-91,21,b8:3a:5a:88:e6:e1,31407274,2376,4,31404898,31407274
6849,6,6,1,2412,-86,-91,5,84:d4:7e:f2:34:26,31411015,380,3361,31410635,31411015
6850,6,12,1,2412,-57,-91,34,40:e3:d6:da:ba:20,31420963,160,9788,31420803,31420963
6851,6,6,1,2412,-57,-91,34,40:e3:d6:da:ba:21,31421182,368,-149,31420814,31421182
6852,6,12,1,2412,-57,-91,34,40:e3:d6:da:ba:22,31421578,180,216,31421398,31421578
6853,6,12,1,2412,-57,-91,34,40:e3:d6:da:ba:23,31422085,184,323,31421901,31422085
6854,6,12,1,2412,-57,-91,34,40:e3:d6:da:ba:24,31422295,176,34,31422119,31422295
6855,6,12,1,2412,-57,-91,34,40:e3:d6:da:ba:25,31422496,160,41,31422336,31422496
6856,6,6,1,2412,-57,-91,34,40:e3:d6:da:ba:26,31422706,380,-170,31422326,31422706
6857,6,6,1,2412,-75,-91,16,e6:aa:ea:b7:4a:dd,31445849,408,22735,31445441,31445849
6858,6,6,1,2412,-74,-91,17,e6:aa:ea:b7:4a:dd,31457969,408,11712,31457561,31457969
6859,4,1,1,2412,-75,-91,16,a6:e5:7c:28:b1:d3,31467513,992,8552,31466521,31467513
6860,6,6,1,2412,-82,-91,9,,31469583,44,2026,31469539,31469583
6861,6,6,1,2412,-81,-91,10,,31469906,44,279,31469862,31469906
6862,4,1,1,2412,-70,-91,21,54:e4:3a:ec:fb:64,31479904,2160,7838,31477744,31479904
6863,6,6,1,2412,-82,-91,9,,31484465,44,4517,31484421,31484465
6864,6,6,1,2412,-82,-91,9,,31489913,44,5404,31489869,31489913
6865,4,1,1,2412,-62,-91,29,b8:3a:5a:88:e6:e0,31507528,2360,15255,31505168,31507528
6866,4,1,1,2412,-71,-91,20,b8:3a:5a:88:e6:e1,31509996,2376,92,31507620,31509996
6867,6,6,1,2412,-83,-91,8,,31514639,44,4599,31514595,31514639
6868,6,6,1,2412,-82,-91,9,,31515006,44,323,31514962,31515006
6869,6,6,1,2412,-82,-91,9,,31515633,44,583,31515589,31515633
6870,6,6,1,2412,-82,-91,9,,31515865,44,188,31515821,31515865
6871,6,12,1,2412,-56,-91,35,40:e3:d6:da:ba:20,31523349,160,7324,31523189,31523349
6872,6,12,1,2412,-56,-91,35,40:e3:d6:da:ba:22,31523946,180,417,31523766,31523946
6873,6,12,1,2412,-56,-91,35,40:e3:d6:da:ba:23,31524169,184,39,31523985,31524169
6874,6,12,1,2412,-56,-91,35,40:e3:d6:da:ba:24,31524379,176,34,31524203,31524379
6875,6,6,1,2412,-56,-91,35,40:e3:d6:da:ba:26,31524817,380,58,31524437,31524817
6876,6,6,1,2412,-55,-91,36,e6:aa:ea:c9:ea:33,31525259,408,34,31524851,31525259
6877,6,6,1,2412,-55,-91,36,e6:aa:ea:c9:ea:33,31537215,408,11548,31536807,31537215
6878,6,6,1,2412,-54,-91,37,e6:aa:ea:c9:ea:33,31549289,408,11666,31548881,31549289
6879,6,6,1,2412,-54,-91,37,e6:aa:ea:c9:ea:33,31561404,408,11707,31560996,31561404
6880,4,1,1,2412,-75,-91,16,a6:e5:7c:28:b1:d3,31569684,992,7288,31568692,31569684
6881,6,6,1,2412,-54,-91,37,e6:aa:ea:c9:ea:33,31573531,408,3439,31573123,31573531
6882,4,1,1,2412,-70,-91,21,54:e4:3a:ec:fb:64,31582341,2160,6650,31580181,31582341
6883,4,1,1,2412,-73,-91,18,b8:3a:5a:88:e6:e0,31609710,2360,25009,31607350,31609710
6884,6,12,1,2412,-55,-91,36,40:e3:d6:da:ba:20,31636350,160,26480,31636190,31636350
6885,6,6,1,2412,-55,-91,36,40:e3:d6:da:ba:21,31636569,368,-149,31636201,31636569
6886,6,12,1,2412,-55,-91,36,40:e3:d6:da:ba:22,31636974,180,225,31636794,31636974
6887,6,12,1,2412,-54,-91,37,40:e3:d6:da:ba:24,31637388,176,238,31637212,31637388
6888,6,12,1,2412,-54,-91,37,40:e3:d6:da:ba:25,31637599,160,51,31637439,31637599
6889,6,6,1,2412,-54,-91,37,40:e3:d6:da:ba:26,31637818,380,-161,31637438,31637818
6890,6,12,1,2412,-86,-91,5,40:e3:d6:da:c8:04,31673396,176,35402,31673220,31673396
6891,4,1,1,2412,-69,-91,22,54:e4:3a:ec:fb:64,31684700,2160,9144,31682540,31684700
6892,6,6,1,2412,-85,-91,6,40:e3:d6:da:c8:01,31698321,348,13273,31697973,31698321
6893,6,6,1,2412,-84,-91,7,,31699767,44,1402,31699723,31699767
6894,6,12,1,2412,-56,-91,35,40:e3:d6:da:ba:20,31728157,160,28230,31727997,31728157
6895,6,6,1,2412,-55,-91,36,40:e3:d6:da:ba:21,31728349,368,-176,31727981,31728349
6896,6,12,1,2412,-55,-91,36,40:e3:d6:da:ba:22,31728745,180,216,31728565,31728745
6897,6,12,1,2412,-55,-91,36,40:e3:d6:da:ba:23,31728959,184,30,31728775,31728959
6898,6,12,1,2412,-55,-91,36,40:e3:d6:da:ba:24,31729186,176,51,31729010,31729186
6899,6,12,1,2412,-55,-91,36,40:e3:d6:da:ba:25,31729406,160,60,31729246,31729406
6900,6,6,1,2412,-55,-91,36,40:e3:d6:da:ba:26,31729598,380,-188,31729218,31729598
6901,6,12,1,2412,-83,-91,8,84:d4:7e:f2:42:24,31730004,176,230,31729828,31730004
6902,6,12,1,2412,-83,-91,8,84:d4:7e:f2:42:25,31730215,160,51,31730055,31730215
6903,6,6,1,2412,-83,-91,8,84:d4:7e:f2:42:26,31730425,380,-170,31730045,31730425
6904,6,12,1,2412,-85,-91,6,,31732503,32,2046,31732471,31732503
6905,6,6,1,2412,-84,-91,7,,31736000,44,3453,31735956,31736000
6906,6,12,1,2412,-87,-91,4,,31769795,32,33763,31769763,31769795
6907,6,6,1,2412,-87,-91,4,40:e3:d6:da:c8:01,31774526,368,4363,31774158,31774526
6908,6,12,1,2412,-87,-91,4,40:e3:d6:da:c8:05,31775619,160,933,31775459,31775619
6909,4,1,1,2412,-72,-91,19,66:d8:ff:ae:5d:41,31785556,416,9521,31785140,31785556
6910,4,1,1,2412,-66,-91,25,54:e4:3a:ec:fb:64,31787095,2160,-621,31784935,31787095
6911,4,1,1,2412,-69,-91,22,66:d8:ff:ae:5d:41,31794859,416,7348,31794443,31794859
6912,4,1,1,2412,-62,-91,29,,31795288,304,125,31794984,31795288
6913,4,1,1,2412,-69,-91,22,66:d8:ff:ae:5d:41,31795614,416,-90,31795198,31795614
6914,4,1,1,2412,-74,-91,17,66:d8:ff:ae:5d:41,31797422,416,1392,31797006,31797422
6915,4,1,1,2412,-87,-91,4,,31797851,304,125,31797547,31797851
6916,4,1,1,2412,-89,-91,2,66:d8:ff:ae:5d:41,31798177,416,-90,31797761,31798177
6917,4,1,1,2412,-87,-91,4,,31798607,304,126,31798303,31798607
6918,4,1,1,2412,-89,-91,2,66:d8:ff:ae:5d:41,31800454,416,1431,31800038,31800454
6919,4,1,1,2412,-90,-91,1,66:d8:ff:ae:5d:41,31801209,416,339,31800793,31801209
6920,4,1,1,2412,-87,-91,4,,31801639,304,126,31801335,31801639
6921,4,1,1,2412,-90,-91,1,,31811432,304,9489,31811128,31811432
6922,4,1,1,2412,-73,-91,18,b8:3a:5a:88:e6:e0,31814495,2360,703,31812135,31814495
6923,4,1,1,2412,-73,-91,18,b8:3a:5a:88:e6:e1,31816874,2376,3,31814498,31816874
6924,6,6,1,2412,-84,-91,7,84:d4:7e:f2:34:21,31819259,368,2017,31818891,31819259
6925,6,12,1,2412,-86,-91,5,84:d4:7e:f2:34:22,31819646,180,207,31819466,31819646
6926,4,1,1,2412,-88,-91,3,,31820667,304,717,31820363,31820667
6927,4,1,1,2412,-90,-91,1,66:d8:ff:ae:5d:41,31820993,416,-90,31820577,31820993
6928,4,1,1,2412,-88,-91,3,,31821422,304,125,31821118,31821422
6929,6,12,1,2412,-84,-91,7,84:d4:7e:f2:34:24,31821574,176,-24,31821398,31821574
6930,6,12,1,2412,-84,-91,7,84:d4:7e:f2:34:25,31821793,160,59,31821633,31821793
6931,4,1,1,2412,-88,-91,3,,31823770,304,1673,31823466,31823770
6932,4,1,1,2412,-87,-91,4,,31824525,304,451,31824221,31824525
6933,4,1,1,2412,-86,-91,5,,31830521,304,5692,31830217,31830521
6934,6,12,1,2412,-56,-91,35,40:e3:d6:da:ba:20,31830985,160,304,31830825,31830985
6935,6,6,1,2412,-56,-91,35,40:e3:d6:da:ba:26,31833001,380,1636,31832621,31833001
6936,4,1,1,2412,-90,-91,1,66:d8:ff:ae:5d:41,31835115,416,1698,31834699,31835115
6937,4,1,1,2412,-87,-91,4,,31835545,304,126,31835241,31835545
6938,4,1,1,2412,-92,-91,-1,66:d8:ff:ae:5d:41,31835870,416,-91,31835454,31835870
6939,4,1,1,2412,-88,-91,3,,31836300,304,126,31835996,31836300
6940,4,1,1,2412,-83,-91,8,c0:c9:e3:4d:6e:bf,31836650,872,-522,31835778,31836650
6941,4,1,1,2412,-76,-91,15,,31837539,304,585,31837235,31837539
6942,4,1,1,2412,-89,-91,2,,31839456,304,1613,31839152,31839456
6943,4,1,1,2412,-90,-91,1,66:d8:ff:ae:5d:41,31839781,416,-91,31839365,31839781
6944,4,1,1,2412,-90,-91,1,,31840211,304,126,31839907,31840211
6945,6,12,1,2412,-85,-91,6,84:d4:7e:f2:42:20,31841632,960,461,31840672,31841632
6946,4,1,1,2412,-89,-91,2,66:d8:ff:ae:5d:41,31844164,416,2116,31843748,31844164
6947,4,1,1,2412,-85,-91,6,,31844594,304,126,31844290,31844594
6948,4,1,1,2412,-89,-91,2,66:d8:ff:ae:5d:41,31850032,416,5022,31849616,31850032
6949,4,1,1,2412,-89,-91,2,,31850462,304,126,31850158,31850462
6950,4,1,1,2412,-90,-91,1,,31853038,304,2272,31852734,31853038
6951,4,1,1,2412,-88,-91,3,66:d8:ff:ae:5d:41,31853364,416,-90,31852948,31853364
6952,4,1,1,2412,-88,-91,3,,31853793,304,125,31853489,31853793
6953,4,1,1,2412,-90,-91,1,66:d8:ff:ae:5d:41,31856621,416,2412,31856205,31856621
6954,4,1,1,2412,-89,-91,2,,31857051,304,126,31856747,31857051
6955,4,1,1,2412,-90,-91,1,66:d8:ff:ae:5d:41,31858135,416,668,31857719,31858135
6956,4,1,1,2412,-87,-91,4,66:d8:ff:ae:5d:41,31859286,416,735,31858870,31859286
6957,4,1,1,2412,-88,-91,3,,31859715,304,125,31859411,31859715
6958,6,12,1,2412,-86,-91,5,,31859967,32,220,31859935,31859967
6959,6,12,1,2412,-86,-91,5,,31860085,44,74,31860041,31860085
6960,6,6,1,2412,-85,-91,6,,31860892,44,763,31860848,31860892
6961,6,6,1,2412,-77,-91,14,e6:aa:ea:b7:4a:dd,31862812,408,1512,31862404,31862812
6962,6,12,1,2412,-85,-91,6,,31881322,36,18474,31881286,31881322
6963,6,12,1,2412,-86,-91,5,,31886748,32,5394,31886716,31886748
6964,6,6,1,2412,-77,-91,14,e6:aa:ea:b7:4a:dd,31887047,408,-109,31886639,31887047
6965,6,12,1,2412,-86,-91,5,,31888914,32,1835,31888882,31888914
6966,4,1,1,2412,-69,-91,22,54:e4:3a:ec:fb:64,31889483,2160,-1591,31887323,31889483
6967,6,12,1,2412,-85,-91,6,,31897206,32,7691,31897174,31897206
6968,6,12,1,2412,-86,-91,5,,31901287,32,4049,31901255,31901287
6969,6,12,1,2412,-86,-91,5,,31901519,32,200,31901487,31901519
6970,6,6,1,2412,-86,-91,5,,31909711,44,8148,31909667,31909711
6971,6,24,1,2412,-87,-91,4,66:d8:ff:ae:5d:41,31910106,32,363,31910074,31910106
6972,6,12,1,2412,-86,-91,5,,31910156,32,18,31910124,31910156
6973,6,12,1,2412,-87,-91,4,84:d4:7e:f2:34:22,31921583,180,11247,31921403,31921583
6974,6,12,1,2412,-86,-91,5,,31921837,32,222,31921805,31921837
6975,6,12,1,2412,-86,-91,5,84:d4:7e:f2:34:24,31922251,176,238,31922075,31922251
6976,6,12,1,2412,-56,-91,35,40:e3:d6:da:ba:20,31932969,160,10558,31932809,31932969
6977,6,6,1,2412,-56,-91,35,40:e3:d6:da:ba:21,31933179,368,-158,31932811,31933179
6978,6,12,1,2412,-56,-91,35,40:e3:d6:da:ba:22,31933566,180,207,31933386,31933566
6979,6,12,1,2412,-56,-91,35,40:e3:d6:da:ba:23,31933790,184,40,31933606,31933790
6980,6,12,1,2412,-55,-91,36,40:e3:d6:da:ba:24,31933999,176,33,31933823,31933999
6981,6,12,1,2412,-55,-91,36,40:e3:d6:da:ba:25,31934219,160,60,31934059,31934219
6982,6,6,1,2412,-55,-91,36,40:e3:d6:da:ba:26,31934420,380,-179,31934040,31934420
6983,6,12,1,2412,-84,-91,7,84:d4:7e:f2:42:25,31934996,160,416,31934836,31934996
6984,6,6,1,2412,-55,-91,36,e6:aa:ea:c9:ea:33,31942325,408,6921,31941917,31942325
6985,6,6,1,2412,-54,-91,37,e6:aa:ea:c9:ea:33,31954268,408,11535,31953860,31954268
6986,6,12,1,2412,-85,-91,6,,31960431,32,6131,31960399,31960431
6987,6,24,1,2412,-86,-91,5,66:d8:ff:ae:5d:41,31962528,32,2065,31962496,31962528
6988,6,12,1,2412,-87,-91,4,,31962577,32,17,31962545,31962577
6989,6,12,1,2412,-86,-91,5,,31965666,32,3057,31965634,31965666
6990,6,6,1,2412,-54,-91,37,e6:aa:ea:c9:ea:33,31966363,408,289,31965955,31966363
6991,6,12,1,2412,-86,-91,5,,31970910,32,4515,31970878,31970910
6992,6,12,1,2412,-86,-91,5,,31976423,32,5481,31976391,31976423
6993,6,12,1,2412,-86,-91,5,,31976656,32,201,31976624,31976656
6994,6,12,1,2412,-87,-91,4,,31978070,32,1382,31978038,31978070
6995,6,12,1,2412,-87,-91,4,,31978285,32,183,31978253,31978285
6996,6,6,1,2412,-54,-91,37,e6:aa:ea:c9:ea:33,31978486,408,-207,31978078,31978486
6997,6,12,1,2412,-86,-91,5,,31978902,32,384,31978870,31978902
6998,6,12,1,2412,-87,-91,4,,31979206,32,272,31979174,31979206
6999,6,12,1,2412,-86,-91,5,,31981488,32,2250,31981456,31981488
7000,6,12,1,2412,-86,-91,5,,31981649,32,129,31981617,31981649
7001,6,12,1,2412,-87,-91,4,,31990112,32,8431,31990080,31990112
7002,6,12,1,2412,-87,-91,4,,31990344,32,200,31990312,31990344
7003,6,6,1,2412,-54,-91,37,e6:aa:ea:c9:ea:33,31990728,408,-24,31990320,31990728
7004,4,1,1,2412,-68,-91,23,54:e4:3a:ec:fb:64,31991842,2160,-1046,31989682,31991842
7005,6,6,1,2412,-86,-91,5,,31997471,44,5585,31997427,31997471
7006,6,12,1,2412,-86,-91,5,,31999608,32,2105,31999576,31999608
7007,4,1,1,2412,-85,-91,6,,32004625,304,4713,32004321,32004625
7008,6,6,1,2412,-87,-91,4,e6:aa:ea:c9:ea:1b,32004950,408,-83,32004542,32004950
7009,4,1,1,2412,-85,-91,6,,32009599,304,4345,32009295,32009599
7010,6,6,1,2412,-87,-91,4,e6:aa:ea:c9:ea:1b,32017046,408,7039,32016638,32017046
7011,4,1,1,2412,-73,-91,18,b8:3a:5a:88:e6:e1,32021700,2376,2278,32019324,32021700
7012,6,12,1,2412,-87,-91,4,84:d4:7e:f2:34:22,32024249,180,2369,32024069,32024249
7013,6,12,1,2412,-86,-91,5,84:d4:7e:f2:34:23,32024596,180,167,32024416,32024596
7014,6,12,1,2412,-87,-91,4,84:d4:7e:f2:34:24,32024819,176,47,32024643,32024819
7015,6,12,1,2412,-85,-91,6,84:d4:7e:f2:34:25,32025029,160,50,32024869,32025029
7016,6,6,1,2412,-86,-91,5,84:d4:7e:f2:34:26,32025248,380,-161,32024868,32025248
7017,6,12,1,2412,-55,-91,36,40:e3:d6:da:ba:20,32035355,160,9947,32035195,32035355
7018,6,6,1,2412,-55,-91,36,40:e3:d6:da:ba:21,32035556,368,-167,32035188,32035556
7019,6,12,1,2412,-55,-91,36,40:e3:d6:da:ba:22,32035952,180,216,32035772,32035952
7020,6,12,1,2412,-54,-91,37,40:e3:d6:da:ba:23,32036175,184,39,32035991,32036175
7021,6,12,1,2412,-55,-91,36,40:e3:d6:da:ba:24,32036393,176,42,32036217,32036393
7022,6,12,1,2412,-55,-91,36,40:e3:d6:da:ba:25,32036613,160,60,32036453,32036613
7023,6,6,1,2412,-55,-91,36,40:e3:d6:da:ba:26,32036823,380,-170,32036443,32036823
7024,4,1,1,2412,-88,-91,3,,32045222,304,8095,32044918,32045222
7025,4,1,1,2412,-88,-91,3,66:d8:ff:ae:5d:41,32045620,416,-18,32045204,32045620
7026,4,1,1,2412,-88,-91,3,,32046049,304,125,32045745,32046049
7027,4,1,1,2412,-90,-91,1,66:d8:ff:ae:5d:41,32046420,416,-45,32046004,32046420
7028,4,1,1,2412,-87,-91,4,66:d8:ff:ae:5d:41,32049179,416,2343,32048763,32049179
7029,4,1,1,2412,-61,-91,30,66:d8:ff:ae:5d:41,32050996,416,1401,32050580,32050996
7030,4,1,1,2412,-87,-91,4,66:d8:ff:ae:5d:41,32053295,416,1883,32052879,32053295
7031,4,1,1,2412,-88,-91,3,,32053724,304,125,32053420,32053724
7032,4,1,1,2412,-65,-91,26,66:d8:ff:ae:5d:41,32055201,416,1061,32054785,32055201
7033,4,1,1,2412,-85,-91,6,66:d8:ff:ae:5d:41,32061117,416,5500,32060701,32061117
7034,4,1,1,2412,-87,-91,4,66:d8:ff:ae:5d:41,32061872,416,339,32061456,32061872
7035,4,1,1,2412,-86,-91,5,,32062302,304,126,32061998,32062302
7036,4,1,1,2412,-88,-91,3,66:d8:ff:ae:5d:41,32067989,416,5271,32067573,32067989
7037,4,1,1,2412,-87,-91,4,66:d8:ff:ae:5d:41,32069823,416,1418,32069407,32069823
7038,4,1,1,2412,-87,-91,4,,32070253,304,126,32069949,32070253
7039,4,1,1,2412,-90,-91,1,66:d8:ff:ae:5d:41,32070578,416,-91,32070162,32070578
7040,4,1,1,2412,-87,-91,4,,32071008,304,126,32070704,32071008
7041,4,1,1,2412,-60,-91,31,,32073860,304,2548,32073556,32073860
7042,4,1,1,2412,-88,-91,3,66:d8:ff:ae:5d:41,32074185,416,-91,32073769,32074185
7043,4,1,1,2412,-88,-91,3,66:d8:ff:ae:5d:41,32076155,416,1554,32075739,32076155
7044,4,1,1,2412,-85,-91,6,,32076585,304,126,32076281,32076585
7045,4,1,1,2412,-91,-91,0,66:d8:ff:ae:5d:41,32076910,416,-91,32076494,32076910
7046,4,1,1,2412,-86,-91,5,,32077340,304,126,32077036,32077340
7047,4,1,1,2412,-86,-91,5,,32080337,304,2693,32080033,32080337
7048,4,1,1,2412,-87,-91,4,,32083187,304,2546,32082883,32083187
7049,6,6,1,2412,-86,-91,5,,32087529,44,4298,32087485,32087529
7050,4,1,1,2412,-73,-91,18,1c:c1:0c:c4:25:70,32098850,2344,8977,32096506,32098850
7051,6,12,1,2412,-55,-91,36,40:e3:d6:da:ba:22,32101755,156,2749,32101599,32101755
7052,6,12,1,2412,-55,-91,36,40:e3:d6:da:ba:23,32102092,156,181,32101936,32102092
7053,6,12,1,2412,-55,-91,36,40:e3:d6:da:ba:25,32102292,136,64,32102156,32102292
7054,6,12,1,2412,-74,-91,17,,32102629,32,305,32102597,32102629
7055,6,12,1,2412,-71,-91,20,,32103326,32,665,32103294,32103326
7056,6,12,1,2412,-73,-91,18,,32103559,32,201,32103527,32103559
7057,4,1,1,2412,-76,-91,15,b8:3a:5a:88:e6:e0,32121699,2360,15780,32119339,32121699
7058,4,1,1,2412,-76,-91,15,b8:3a:5a:88:e6:e1,32124079,2376,4,32121703,32124079
7059,6,12,1,2412,-85,-91,6,84:d4:7e:f2:34:22,32127375,180,3116,32127195,32127375
7060,6,12,1,2412,-57,-91,34,40:e3:d6:da:ba:20,32137762,160,10227,32137602,32137762
7061,6,6,1,2412,-57,-91,34,40:e3:d6:da:ba:21,32137981,368,-149,32137613,32137981
7062,6,12,1,2412,-57,-91,34,40:e3:d6:da:ba:22,32138368,180,207,32138188,32138368
7063,6,12,1,2412,-57,-91,34,40:e3:d6:da:ba:23,32138583,184,31,32138399,32138583
7064,6,12,1,2412,-57,-91,34,40:e3:d6:da:ba:24,32138792,176,33,32138616,32138792
7065,6,12,1,2412,-57,-91,34,40:e3:d6:da:ba:25,32139011,160,59,32138851,32139011
7066,6,6,1,2412,-57,-91,34,40:e3:d6:da:ba:26,32139230,380,-161,32138850,32139230
7067,6,24,1,2412,-84,-91,7,,32140507,28,1249,32140479,32140507
7068,6,6,1,2412,-77,-91,14,e6:aa:ea:b7:4a:dd,32154686,408,13771,32154278,32154686
7069,6,6,1,2412,-82,-91,9,,32156419,44,1689,32156375,32156419
7070,4,1,1,2412,-78,-91,13,b8:3a:5a:88:e6:e0,32158056,2240,-603,32155816,32158056
7071,4,1,1,2412,-78,-91,13,b8:3a:5a:88:e6:e1,32160343,2256,31,32158087,32160343
7072,4,1,1,2412,-78,-91,13,b8:3a:5a:88:e6:e1,32177280,2256,14681,32175024,32177280
7073,4,1,1,2412,-83,-91,8,,32190244,304,12660,32189940,32190244
7074,4,1,1,2412,-78,-91,13,b8:3a:5a:88:e6:e0,32190581,2240,-1903,32188341,32190581
7075,4,1,1,2412,-79,-91,12,b8:3a:5a:88:e6:e1,32192858,2256,21,32190602,32192858
7076,4,1,1,2412,-70,-91,21,54:e4:3a:ec:fb:64,32197118,2160,2100,32194958,32197118
7077,6,6,1,2412,-76,-91,15,e6:aa:ea:b7:4a:dd,32203161,408,5635,32202753,32203161
7078,4,1,1,2412,-79,-91,12,b8:3a:5a:88:e6:e1,32226852,2376,21315,32224476,32226852
7079,6,12,1,2412,-86,-91,5,84:d4:7e:f2:34:23,32230342,180,3310,32230162,32230342
7080,6,12,1,2412,-86,-91,5,84:d4:7e:f2:34:25,32230785,160,283,32230625,32230785
7081,6,6,1,2412,-85,-91,6,84:d4:7e:f2:34:26,32230995,380,-170,32230615,32230995
7082,6,6,1,2412,-86,-91,5,84:d4:7e:f2:34:21,32234232,348,2889,32233884,32234232
7083,6,12,1,2412,-59,-91,32,40:e3:d6:da:ba:20,32240176,160,5784,32240016,32240176
7084,6,6,1,2412,-59,-91,32,40:e3:d6:da:ba:21,32240377,368,-167,32240009,32240377
7085,6,12,1,2412,-59,-91,32,40:e3:d6:da:ba:23,32240997,184,436,32240813,32240997
7086,6,12,1,2412,-59,-91,32,40:e3:d6:da:ba:24,32241224,176,51,32241048,32241224
7087,6,12,1,2412,-59,-91,32,40:e3:d6:da:ba:25,32241426,160,42,32241266,32241426
7088,6,6,1,2412,-59,-91,32,40:e3:d6:da:ba:26,32241635,380,-171,32241255,32241635
7089,4,1,1,2412,-75,-91,16,c0:c9:e3:4d:6e:bf,32276516,872,34009,32275644,32276516
7090,4,1,1,2412,-83,-91,8,,32277405,304,585,32277101,32277405
7091,4,1,1,2412,-71,-91,20,54:e4:3a:ec:fb:64,32299111,2160,19546,32296951,32299111
7092,4,1,1,2412,-75,-91,16,c0:c9:e3:4d:6e:bf,32321112,872,21129,32320240,32321112
7093,4,1,1,2412,-77,-91,14,,32322001,304,585,32321697,32322001
7094,6,6,1,2412,-56,-91,35,40:e3:d6:da:ba:21,32342796,368,20427,32342428,32342796
7095,6,12,1,2412,-56,-91,35,40:e3:d6:da:ba:22,32343183,180,207,32343003,32343183
7096,6,12,1,2412,-56,-91,35,40:e3:d6:da:ba:23,32343415,184,48,32343231,32343415
7097,6,12,1,2412,-56,-91,35,40:e3:d6:da:ba:24,32343633,176,42,32343457,32343633
7098,6,12,1,2412,-56,-91,35,40:e3:d6:da:ba:25,32343844,160,51,32343684,32343844
7099,6,6,1,2412,-56,-91,35,40:e3:d6:da:ba:26,32344063,380,-161,32343683,32344063
7100,6,6,1,2412,-53,-91,38,e6:aa:ea:c9:ea:33,32359161,408,14690,32358753,32359161
7101,6,6,1,2412,-53,-91,38,e6:aa:ea:c9:ea:33,32371281,408,11712,32370873,32371281
7102,6,6,1,2412,-53,-91,38,e6:aa:ea:c9:ea:33,32383396,408,11707,32382988,32383396
7103,4,1,1,2412,-70,-91,21,54:e4:3a:ec:fb:64,32401515,2160,15959,32399355,32401515
7104,6,6,1,2412,-53,-91,38,e6:aa:ea:c9:ea:33,32407704,408,5781,32407296,32407704
7105,4,1,1,2412,-73,-91,18,b8:3a:5a:88:e6:e0,32428918,2360,18854,32426558,32428918
7106,4,1,1,2412,-75,-91,16,b8:3a:5a:88:e6:e1,32431325,2376,31,32428949,32431325
7107,6,12,1,2412,-57,-91,34,40:e3:d6:da:ba:20,32444955,160,13470,32444795,32444955
7108,6,6,1,2412,-57,-91,34,40:e3:d6:da:ba:21,32445147,368,-176,32444779,32445147
7109,6,12,1,2412,-57,-91,34,40:e3:d6:da:ba:22,32445534,180,207,32445354,32445534
7110,6,12,1,2412,-57,-91,34,40:e3:d6:da:ba:23,32445739,184,21,32445555,32445739
7111,6,12,1,2412,-57,-91,34,40:e3:d6:da:ba:24,32445958,176,43,32445782,32445958
7112,6,12,1,2412,-57,-91,34,40:e3:d6:da:ba:25,32446186,160,68,32446026,32446186
7113,6,6,1,2412,-57,-91,34,40:e3:d6:da:ba:26,32446378,380,-188,32445998,32446378
7114,6,6,1,2412,-84,-91,7,84:d4:7e:f2:42:26,32447254,380,496,32446874,32447254
7115,6,6,1,2412,-79,-91,12,e6:aa:ea:b7:4a:dd,32482452,408,34790,32482044,32482452
7116,6,6,1,2412,-77,-91,14,e6:aa:ea:b7:4a:dd,32494566,408,11706,32494158,32494566
7117,4,1,1,2412,-59,-91,32,54:e4:3a:ec:fb:64,32503899,2160,7173,32501739,32503899
7118,6,6,1,2412,-75,-91,16,e6:aa:ea:b7:4a:dd,32518810,408,14503,32518402,32518810
7119,4,1,1,2412,-78,-91,13,b8:3a:5a:88:e6:e0,32531884,2360,10714,32529524,32531884
7120,4,1,1,2412,-78,-91,13,b8:3a:5a:88:e6:e1,32534291,2376,31,32531915,32534291
7121,6,12,1,2412,-57,-91,34,40:e3:d6:da:ba:20,32547353,160,12902,32547193,32547353
7122,6,6,1,2412,-57,-91,34,40:e3:d6:da:ba:21,32547554,368,-167,32547186,32547554
7123,6,12,1,2412,-57,-91,34,40:e3:d6:da:ba:22,32547941,180,207,32547761,32547941
7124,6,12,1,2412,-57,-91,34,40:e3:d6:da:ba:23,32548164,184,39,32547980,32548164
7125,6,12,1,2412,-57,-91,34,40:e3:d6:da:ba:24,32548374,176,34,32548198,32548374
7126,6,12,1,2412,-57,-91,34,40:e3:d6:da:ba:25,32548584,160,50,32548424,32548584
7127,6,6,1,2412,-57,-91,34,40:e3:d6:da:ba:26,32548776,380,-188,32548396,32548776
7128,4,1,1,2412,-79,-91,12,b8:3a:5a:88:e6:e1,32587307,2256,36275,32585051,32587307
7129,4,1,1,2412,-71,-91,20,54:e4:3a:ec:fb:64,32606327,2160,16860,32604167,32606327
7130,6,6,1,2412,-53,-91,38,40:e3:d6:da:ba:21,32649980,368,43285,32649612,32649980
7131,6,12,1,2412,-53,-91,38,40:e3:d6:da:ba:22,32650367,180,207,32650187,32650367
7132,6,12,1,2412,-53,-91,38,40:e3:d6:da:ba:23,32650600,184,49,32650416,32650600
7133,6,12,1,2412,-53,-91,38,40:e3:d6:da:ba:24,32650809,176,33,32650633,32650809
7134,6,12,1,2412,-53,-91,38,40:e3:d6:da:ba:25,32651011,160,42,32650851,32651011
7135,6,6,1,2412,-53,-91,38,40:e3:d6:da:ba:26,32651229,380,-162,32650849,32651229
7136,4,1,1,2412,-75,-91,16,a6:e5:7c:28:b1:d3,32695665,944,43492,32694721,32695665
7137,4,1,1,2412,-75,-91,16,a6:e5:7c:28:b1:d3,32696761,944,152,32695817,32696761
7138,4,1,1,2412,-75,-91,16,a6:e5:7c:28:b1:d3,32698953,944,1248,32698009,32698953
7139,4,1,1,2412,-75,-91,16,a6:e5:7c:28:b1:d3,32700058,944,161,32699114,32700058
7140,4,1,1,2412,-75,-91,16,a6:e5:7c:28:b1:d3,32701154,944,152,32700210,32701154
7141,4,1,1,2412,-75,-91,16,a6:e5:7c:28:b1:d3,32702259,944,161,32701315,32702259
7142,4,1,1,2412,-63,-91,28,a6:e5:7c:28:b1:d3,32703319,944,116,32702375,32703319
7143,4,1,1,2412,-75,-91,16,a6:e5:7c:28:b1:d3,32704397,944,134,32703453,32704397
7144,4,1,1,2412,-75,-91,16,a6:e5:7c:28:b1:d3,32705448,944,107,32704504,32705448
7145,4,1,1,2412,-75,-91,16,a6:e5:7c:28:b1:d3,32706535,944,143,32705591,32706535
7146,4,1,1,2412,-73,-91,18,b8:3a:5a:88:e6:e0,32736097,2360,27202,32733737,32736097
7147,6,12,1,2412,-59,-91,32,40:e3:d6:da:ba:20,32752164,160,15907,32752004,32752164
7148,6,6,1,2412,-59,-91,32,40:e3:d6:da:ba:21,32752356,368,-176,32751988,32752356
7149,6,12,1,2412,-59,-91,32,40:e3:d6:da:ba:22,32752752,180,216,32752572,32752752
7150,6,12,1,2412,-59,-91,32,40:e3:d6:da:ba:23,32752958,184,22,32752774,32752958
7151,6,12,1,2412,-59,-91,32,40:e3:d6:da:ba:24,32753176,176,42,32753000,32753176
7152,6,12,1,2412,-59,-91,32,40:e3:d6:da:ba:25,32753378,160,42,32753218,32753378
7153,6,6,1,2412,-58,-91,33,40:e3:d6:da:ba:26,32753596,380,-162,32753216,32753596
7154,6,12,1,2412,-85,-91,6,84:d4:7e:f2:42:25,32754226,160,470,32754066,32754226
7155,4,1,1,2412,-81,-91,10,c0:c9:e3:4d:6e:bf,32773126,872,18028,32772254,32773126
7156,4,1,1,2412,-80,-91,11,,32774014,304,584,32773710,32774014
7157,6,6,1,2412,-51,-91,40,e6:aa:ea:c9:ea:33,32776683,408,2261,32776275,32776683
7158,6,6,1,2412,-49,-91,42,e6:aa:ea:c9:ea:33,32800916,408,23825,32800508,32800916
7159,4,1,1,2412,-79,-91,12,c0:c9:e3:4d:6e:bf,32816657,872,14869,32815785,32816657
7160,4,1,1,2412,-68,-91,23,c6:fb:aa:f7:fb:15,32818591,1128,806,32817463,32818591
7161,4,1,1,2412,-73,-91,18,54:e4:3a:ec:fb:64,32819839,2112,-864,32817727,32819839
7162,4,1,1,2412,-74,-91,17,54:e4:3a:ec:fb:64,32822069,2112,118,32819957,32822069
7163,4,1,1,2412,-74,-91,17,54:e4:3a:ec:fb:64,32826603,2112,2422,32824491,32826603
7164,6,12,1,2412,-58,-91,33,40:e3:d6:da:ba:20,32828889,136,2150,32828753,32828889
7165,6,6,1,2412,-58,-91,33,40:e3:d6:da:ba:21,32829066,348,-171,32828718,32829066
7166,6,12,1,2412,-58,-91,33,40:e3:d6:da:ba:22,32829442,156,220,32829286,32829442
7167,6,12,1,2412,-74,-91,17,,32829614,32,140,32829582,32829614
7168,6,12,1,2412,-58,-91,33,40:e3:d6:da:ba:23,32829693,156,-77,32829537,32829693
7169,6,12,1,2412,-74,-91,17,,32829865,32,140,32829833,32829865
7170,6,12,1,2412,-58,-91,33,40:e3:d6:da:ba:25,32829927,136,-74,32829791,32829927
7171,6,12,1,2412,-74,-91,17,,32830079,32,120,32830047,32830079
7172,4,1,1,2412,-74,-91,17,b8:3a:5a:88:e6:e0,32838498,2360,6059,32836138,32838498
7173,4,1,1,2412,-74,-91,17,b8:3a:5a:88:e6:e1,32840878,2376,4,32838502,32840878
7174,6,6,1,2412,-86,-91,5,40:e3:d6:da:bb:e1,32851495,368,10249,32851127,32851495
7175,6,12,1,2412,-86,-91,5,40:e3:d6:da:bb:e3,32852128,180,453,32851948,32852128
7176,6,12,1,2412,-88,-91,3,40:e3:d6:da:bb:e4,32852351,172,51,32852179,32852351
7177,6,12,1,2412,-87,-91,4,40:e3:d6:da:bb:e5,32852549,156,42,32852393,32852549
7178,6,12,1,2412,-57,-91,34,40:e3:d6:da:ba:20,32854571,160,1862,32854411,32854571
7179,6,6,1,2412,-57,-91,34,40:e3:d6:da:ba:21,32854763,368,-176,32854395,32854763
7180,6,12,1,2412,-58,-91,33,40:e3:d6:da:ba:24,32855583,176,644,32855407,32855583
7181,6,12,1,2412,-57,-91,34,40:e3:d6:da:ba:25,32855784,160,41,32855624,32855784
7182,6,6,1,2412,-57,-91,34,40:e3:d6:da:ba:26,32856003,380,-161,32855623,32856003
7183,6,6,1,2412,-75,-91,16,e6:aa:ea:b7:4a:dd,32887799,408,31388,32887391,32887799
7184,6,6,1,2412,-76,-91,15,e6:aa:ea:b7:4a:dd,32899923,408,11716,32899515,32899923
7185,6,6,1,2412,-76,-91,15,e6:aa:ea:b7:4a:dd,32912174,408,11843,32911766,32912174
7186,4,1,1,2412,-75,-91,16,54:e4:3a:ec:fb:64,32913508,2160,-826,32911348,32913508
7187,6,6,1,2412,-79,-91,12,e6:aa:ea:b7:4a:dd,32924186,408,10270,32923778,32924186
7188,6,6,1,2412,-77,-91,14,e6:aa:ea:b7:4a:dd,32936261,408,11667,32935853,32936261
7189,4,1,1,2412,-77,-91,14,b8:3a:5a:88:e6:e0,32943357,2360,4736,32940997,32943357
7190,4,1,1,2412,-78,-91,13,b8:3a:5a:88:e6:e1,32945746,2376,13,32943370,32945746
7191,6,6,1,2412,-56,-91,35,40:e3:d6:da:ba:21,32957157,368,11043,32956789,32957157
7192,6,12,1,2412,-56,-91,35,40:e3:d6:da:ba:24,32957985,176,652,32957809,32957985
7193,6,12,1,2412,-56,-91,35,40:e3:d6:da:ba:25,32958214,160,69,32958054,32958214
7194,6,6,1,2412,-56,-91,35,40:e3:d6:da:ba:26,32958406,380,-188,32958026,32958406
7195,6,12,1,2412,-85,-91,6,84:d4:7e:f2:42:24,32958814,176,232,32958638,32958814
7196,6,12,1,2412,-86,-91,5,84:d4:7e:f2:42:25,32959024,160,50,32958864,32959024
7197,6,6,1,2412,-85,-91,6,84:d4:7e:f2:42:26,32959234,380,-170,32958854,32959234
7198,4,1,1,2412,-73,-91,18,54:e4:3a:ec:fb:64,33015833,2160,54439,33013673,33015833
7199,6,12,1,2412,-55,-91,36,40:e3:d6:da:ba:20,33059361,160,43368,33059201,33059361
7200,6,6,1,2412,-55,-91,36,40:e3:d6:da:ba:21,33059562,368,-167,33059194,33059562
7201,6,12,1,2412,-55,-91,36,40:e3:d6:da:ba:22,33059976,180,234,33059796,33059976
7202,6,12,1,2412,-54,-91,37,40:e3:d6:da:ba:23,33060209,184,49,33060025,33060209
7203,4,1,1,2412,-74,-91,17,a6:e5:7c:28:b1:d3,33089560,944,28407,33088616,33089560
7204,4,1,1,2412,-76,-91,15,a6:e5:7c:28:b1:d3,33090629,944,125,33089685,33090629
7205,4,1,1,2412,-75,-91,16,a6:e5:7c:28:b1:d3,33091689,944,116,33090745,33091689
7206,4,1,1,2412,-75,-91,16,a6:e5:7c:28:b1:d3,33092785,944,152,33091841,33092785
7207,4,1,1,2412,-76,-91,15,a6:e5:7c:28:b1:d3,33093890,944,161,33092946,33093890
7208,4,1,1,2412,-75,-91,16,a6:e5:7c:28:b1:d3,33095992,944,1158,33095048,33095992
7209,4,1,1,2412,-76,-91,15,a6:e5:7c:28:b1:d3,33097043,944,107,33096099,33097043
7210,4,1,1,2412,-70,-91,21,a6:e5:7c:28:b1:d3,33098103,944,116,33097159,33098103
7211,4,1,1,2412,-76,-91,15,a6:e5:7c:28:b1:d3,33099172,944,125,33098228,33099172
7212,4,1,1,2412,-67,-91,24,a6:e5:7c:28:b1:d3,33100241,944,125,33099297,33100241
7213,4,1,1,2412,-76,-91,15,a6:e5:7c:28:b1:d3,33105089,992,3856,33104097,33105089
7214,6,12,1,2412,-81,-91,10,40:e3:d6:da:c5:80,33116839,960,10790,33115879,33116839
7215,4,1,1,2412,-71,-91,20,54:e4:3a:ec:fb:64,33118333,2160,-666,33116173,33118333
7216,4,1,1,2412,-78,-91,13,b8:3a:5a:88:e6:e0,33145724,2360,25031,33143364,33145724
7217,4,1,1,2412,-79,-91,12,b8:3a:5a:88:e6:e1,33148239,2376,139,33145863,33148239
7218,6,12,1,2412,-56,-91,35,40:e3:d6:da:ba:20,33161772,160,13373,33161612,33161772
7219,6,6,1,2412,-55,-91,36,40:e3:d6:da:ba:21,33162008,368,-132,33161640,33162008
7220,6,12,1,2412,-56,-91,35,40:e3:d6:da:ba:22,33162395,180,207,33162215,33162395
7221,6,12,1,2412,-55,-91,36,40:e3:d6:da:ba:23,33162601,184,22,33162417,33162601
7222,6,12,1,2412,-56,-91,35,40:e3:d6:da:ba:24,33162810,176,33,33162634,33162810
7223,6,12,1,2412,-56,-91,35,40:e3:d6:da:ba:25,33163012,160,42,33162852,33163012
7224,6,6,1,2412,-55,-91,36,40:e3:d6:da:ba:26,33163221,380,-171,33162841,33163221
7225,4,1,1,2412,-72,-91,19,54:e4:3a:ec:fb:64,33220746,2160,55365,33218586,33220746
7226,4,1,1,2412,-75,-91,16,b8:3a:5a:88:e6:e1,33250476,2376,27354,33248100,33250476
7227,6,12,1,2412,-57,-91,34,40:e3:d6:da:ba:20,33264162,160,13526,33264002,33264162
7228,6,6,1,2412,-57,-91,34,40:e3:d6:da:ba:21,33264363,368,-167,33263995,33264363
7229,6,12,1,2412,-57,-91,34,40:e3:d6:da:ba:22,33264768,180,225,33264588,33264768
7230,6,12,1,2412,-57,-91,34,40:e3:d6:da:ba:23,33264992,184,40,33264808,33264992
7231,6,12,1,2412,-57,-91,34,40:e3:d6:da:ba:24,33265219,176,51,33265043,33265219
7232,6,12,1,2412,-57,-91,34,40:e3:d6:da:ba:25,33265429,160,50,33265269,33265429
7233,6,6,1,2412,-57,-91,34,40:e3:d6:da:ba:26,33265639,380,-170,33265259,33265639
7234,6,6,1,2412,-59,-91,32,e6:aa:ea:c9:ea:33,33296982,408,30935,33296574,33296982
7235,6,6,1,2412,-58,-91,33,e6:aa:ea:c9:ea:33,33321037,408,23647,33320629,33321037
7236,4,1,1,2412,-70,-91,21,54:e4:3a:ec:fb:64,33323111,2160,-86,33320951,33323111
7237,6,6,1,2412,-58,-91,33,e6:aa:ea:c9:ea:33,33333154,408,9635,33332746,33333154
7238,6,6,1,2412,-58,-91,33,e6:aa:ea:c9:ea:33,33345337,408,11775,33344929,33345337
7239,4,1,1,2412,-74,-91,17,b8:3a:5a:88:e6:e1,33355991,2376,8278,33353615,33355991
7240,6,12,1,2412,-55,-91,36,40:e3:d6:da:ba:20,33366556,160,10405,33366396,33366556
7241,6,6,1,2412,-55,-91,36,40:e3:d6:da:ba:21,33366758,368,-166,33366390,33366758
7242,6,12,1,2412,-55,-91,36,40:e3:d6:da:ba:23,33367359,184,417,33367175,33367359
7243,6,12,1,2412,-55,-91,36,40:e3:d6:da:ba:24,33367595,176,60,33367419,33367595
7244,6,6,1,2412,-55,-91,36,40:e3:d6:da:ba:26,33368006,380,31,33367626,33368006
7245,4,1,1,2412,-83,-91,8,,33401117,304,32807,33400813,33401117
7246,6,6,1,2412,-74,-91,17,e6:aa:ea:b7:4a:dd,33420256,408,18731,33419848,33420256
7247,4,1,1,2412,-83,-91,8,,33421408,304,848,33421104,33421408
7248,6,6,1,2412,-74,-91,17,e6:aa:ea:b7:4a:dd,33444289,408,22473,33443881,33444289
7249,6,12,1,2412,-52,-91,39,40:e3:d6:da:ba:20,33468968,160,24519,33468808,33468968
7250,6,6,1,2412,-52,-91,39,40:e3:d6:da:ba:21,33469187,368,-149,33468819,33469187
7251,6,12,1,2412,-52,-91,39,40:e3:d6:da:ba:22,33469601,180,234,33469421,33469601
7252,6,12,1,2412,-52,-91,39,40:e3:d6:da:ba:23,33469815,184,30,33469631,33469815
7253,6,12,1,2412,-52,-91,39,40:e3:d6:da:ba:24,33470051,176,60,33469875,33470051
7254,6,12,1,2412,-52,-91,39,40:e3:d6:da:ba:25,33470253,160,42,33470093,33470253
7255,6,6,1,2412,-52,-91,39,40:e3:d6:da:ba:26,33470463,380,-170,33470083,33470463
7256,4,1,1,2412,-56,-91,35,a6:e5:7c:28:b1:d3,33515961,992,44506,33514969,33515961
7257,4,1,1,2412,-78,-91,13,b8:3a:5a:88:e6:e0,33555378,2360,37057,33553018,33555378
7258,6,12,1,2412,-54,-91,37,40:e3:d6:da:ba:20,33571459,160,15921,33571299,33571459
7259,6,6,1,2412,-54,-91,37,40:e3:d6:da:ba:21,33571651,368,-176,33571283,33571651
7260,6,12,1,2412,-54,-91,37,40:e3:d6:da:ba:22,33572038,180,207,33571858,33572038
7261,6,12,1,2412,-54,-91,37,40:e3:d6:da:ba:23,33572243,184,21,33572059,33572243
7262,6,12,1,2412,-54,-91,37,40:e3:d6:da:ba:25,33572708,160,305,33572548,33572708
7263,4,1,1,2412,-75,-91,16,a4:e5:7c:28:b1:d3,33612541,688,39145,33611853,33612541
7264,4,1,1,2412,-83,-91,8,,33613246,304,401,33612942,33613246
7265,4,1,1,2412,-76,-91,15,a6:e5:7c:28:b1:d3,33617110,992,2872,33616118,33617110
7266,4,1,1,2412,-73,-91,18,54:e4:3a:ec:fb:64,33630303,2160,11033,33628143,33630303
7267,6,24,1,2412,-85,-91,6,,33647627,28,17296,33647599,33647627
7268,6,12,1,2412,-86,-91,5,,33647672,32,13,33647640,33647672
7269,6,12,1,2412,-86,-91,5,,33647786,32,82,33647754,33647786
7270,4,1,1,2412,-75,-91,16,b8:3a:5a:88:e6:e1,33660289,2376,10127,33657913,33660289
7271,6,6,1,2412,-85,-91,6,40:e3:d6:da:bb:e1,33670637,368,9980,33670269,33670637
7272,6,12,1,2412,-85,-91,6,40:e3:d6:da:bb:e2,33671041,176,228,33670865,33671041
7273,6,12,1,2412,-85,-91,6,40:e3:d6:da:bb:e3,33671261,180,40,33671081,33671261
7274,6,12,1,2412,-84,-91,7,40:e3:d6:da:bb:e4,33671466,172,33,33671294,33671466
7275,6,6,1,2412,-52,-91,39,40:e3:d6:da:ba:21,33673949,368,2115,33673581,33673949
7276,6,12,1,2412,-52,-91,39,40:e3:d6:da:ba:22,33674345,180,216,33674165,33674345
7277,6,12,1,2412,-52,-91,39,40:e3:d6:da:ba:23,33674560,184,31,33674376,33674560
7278,6,12,1,2412,-52,-91,39,40:e3:d6:da:ba:24,33674778,176,42,33674602,33674778
7279,6,12,1,2412,-52,-91,39,40:e3:d6:da:ba:25,33674979,160,41,33674819,33674979
7280,6,6,1,2412,-52,-91,39,40:e3:d6:da:ba:26,33675198,380,-161,33674818,33675198
7281,4,1,1,2412,-75,-91,16,a4:e5:7c:28:b1:d3,33703927,688,28041,33703239,33703927
7282,6,6,1,2412,-53,-91,38,e6:aa:ea:c9:ea:33,33714044,408,9709,33713636,33714044
7283,6,6,1,2412,-78,-91,13,e6:aa:ea:b7:4a:dd,33723295,408,8843,33722887,33723295
7284,6,6,1,2412,-53,-91,38,e6:aa:ea:c9:ea:33,33726299,408,2596,33725891,33726299
7285,6,6,1,2412,-77,-91,14,e6:aa:ea:b7:4a:dd,33735420,408,8713,33735012,33735420
7286,6,6,1,2412,-77,-91,14,e6:aa:ea:b7:4a:dd,33747700,408,11872,33747292,33747700
7287,6,6,1,2412,-55,-91,36,e6:aa:ea:c9:ea:33,33750389,408,2281,33749981,33750389
7288,4,1,1,2412,-77,-91,14,b8:3a:5a:88:e6:e1,33766365,2376,13600,33763989,33766365
7289,6,6,1,2412,-78,-91,13,e6:aa:ea:b7:4a:dd,33771780,408,5007,33771372,33771780
7290,6,12,1,2412,-86,-91,5,40:e3:d6:da:bb:e4,33774641,172,2689,33774469,33774641
7291,6,12,1,2412,-55,-91,36,40:e3:d6:da:ba:20,33776178,160,1377,33776018,33776178
7292,6,12,1,2412,-55,-91,36,40:e3:d6:da:ba:22,33776793,180,435,33776613,33776793
7293,6,12,1,2412,-56,-91,35,40:e3:d6:da:ba:23,33776999,184,22,33776815,33776999
7294,6,12,1,2412,-55,-91,36,40:e3:d6:da:ba:24,33777217,176,42,33777041,33777217
7295,6,12,1,2412,-55,-91,36,40:e3:d6:da:ba:25,33777428,160,51,33777268,33777428
7296,6,6,1,2412,-55,-91,36,40:e3:d6:da:ba:26,33777638,380,-170,33777258,33777638
7297,4,1,1,2412,-75,-91,16,c0:c9:e3:4d:6e:bf,33810133,872,31623,33809261,33810133
7298,4,1,1,2412,-78,-91,13,,33811022,304,585,33810718,33811022
7299,4,1,1,2412,-73,-91,18,54:e4:3a:ec:fb:64,33835144,2160,21962,33832984,33835144
7300,4,1,1,2412,-74,-91,17,b8:3a:5a:88:e6:e0,33862504,2360,25000,33860144,33862504
7301,4,1,1,2412,-76,-91,15,b8:3a:5a:88:e6:e1,33864976,2376,96,33862600,33864976
7302,6,12,1,2412,-57,-91,34,40:e3:d6:da:ba:22,33883241,180,18085,33883061,33883241
7303,6,6,1,2412,-57,-91,34,40:e3:d6:da:ba:26,33884058,380,437,33883678,33884058
7304,6,12,1,2412,-57,-91,34,40:e3:d6:da:ba:20,33891998,960,6980,33891038,33891998
7305,4,1,1,2412,-73,-91,18,54:e4:3a:ec:fb:64,33937496,2160,43338,33935336,33937496
7306,4,1,1,2412,-77,-91,14,b8:3a:5a:88:e6:e0,33964925,2360,25069,33962565,33964925
7307,4,1,1,2412,-79,-91,12,b8:3a:5a:88:e6:e1,33967305,2376,4,33964929,33967305
7308,6,12,1,2412,-86,-91,5,84:d4:7e:f2:34:22,33970138,180,2653,33969958,33970138
7309,6,12,1,2412,-86,-91,5,84:d4:7e:f2:34:23,33970343,180,25,33970163,33970343
7310,6,12,1,2412,-86,-91,5,84:d4:7e:f2:34:24,33970575,176,56,33970399,33970575
7311,6,12,1,2412,-86,-91,5,84:d4:7e:f2:34:25,33970795,160,60,33970635,33970795
7312,6,12,1,2412,-58,-91,33,40:e3:d6:da:ba:20,33980980,160,10025,33980820,33980980
7313,6,6,1,2412,-57,-91,34,40:e3:d6:da:ba:21,33981199,368,-149,33980831,33981199
7314,6,12,1,2412,-57,-91,34,40:e3:d6:da:ba:22,33981613,180,234,33981433,33981613
7315,6,12,1,2412,-57,-91,34,40:e3:d6:da:ba:23,33981845,184,48,33981661,33981845
7316,6,12,1,2412,-57,-91,34,40:e3:d6:da:ba:24,33982055,176,34,33981879,33982055
7317,6,12,1,2412,-58,-91,33,40:e3:d6:da:ba:25,33982283,160,68,33982123,33982283
7318,6,6,1,2412,-57,-91,34,40:e3:d6:da:ba:26,33982502,380,-161,33982122,33982502
7319,4,1,1,2412,-68,-91,23,54:e4:3a:ec:fb:64,34039966,2160,55304,34037806,34039966
7320,6,12,1,2412,-86,-91,5,40:e3:d6:da:bb:e2,34049320,156,9198,34049164,34049320
7321,6,12,1,2412,-87,-91,4,40:e3:d6:da:bb:e3,34049538,156,62,34049382,34049538
7322,6,12,1,2412,-88,-91,3,40:e3:d6:da:bb:e0,34080058,156,30364,34079902,34080058
7323,6,6,1,2412,-87,-91,4,40:e3:d6:da:bb:e1,34080254,368,-172,34079886,34080254
7324,6,12,1,2412,-86,-91,5,40:e3:d6:da:bb:e2,34080650,176,220,34080474,34080650
7325,6,12,1,2412,-86,-91,5,40:e3:d6:da:bb:e3,34080879,180,49,34080699,34080879
7326,6,12,1,2412,-87,-91,4,40:e3:d6:da:bb:e4,34081111,172,60,34080939,34081111
7327,6,6,1,2412,-84,-91,7,40:e3:d6:da:bb:e6,34081546,380,55,34081166,34081546
7328,6,12,1,2412,-56,-91,35,40:e3:d6:da:ba:20,34083375,160,1669,34083215,34083375
7329,6,6,1,2412,-56,-91,35,40:e3:d6:da:ba:21,34083567,368,-176,34083199,34083567
7330,6,12,1,2412,-56,-91,35,40:e3:d6:da:ba:22,34083981,180,234,34083801,34083981
7331,6,12,1,2412,-56,-91,35,40:e3:d6:da:ba:23,34084204,184,39,34084020,34084204
7332,6,12,1,2412,-55,-91,36,40:e3:d6:da:ba:24,34084441,176,61,34084265,34084441
7333,6,12,1,2412,-56,-91,35,40:e3:d6:da:ba:25,34084652,160,51,34084492,34084652
7334,6,6,1,2412,-56,-91,35,40:e3:d6:da:ba:26,34084852,380,-180,34084472,34084852
7335,4,1,1,2412,-91,-91,0,bc:d7:13:00:2f:51,34089832,880,4100,34088952,34089832
7336,6,12,1,2412,-87,-91,4,40:e3:d6:da:bb:e5,34091835,136,1867,34091699,34091835
7337,4,1,1,2412,-85,-91,6,,34092739,304,600,34092435,34092739
7338,4,1,1,2412,-86,-91,5,,34105751,304,12708,34105447,34105751
7339,4,1,1,2412,-86,-91,5,,34111829,304,5774,34111525,34111829
7340,4,1,1,2412,-69,-91,22,54:e4:3a:ec:fb:64,34113144,2112,-797,34111032,34113144
7341,4,1,1,2412,-69,-91,22,54:e4:3a:ec:fb:64,34115591,2112,335,34113479,34115591
7342,4,1,1,2412,-68,-91,23,54:e4:3a:ec:fb:64,34117948,2112,245,34115836,34117948
7343,4,1,1,2412,-69,-91,22,54:e4:3a:ec:fb:64,34121514,2112,1454,34119402,34121514
7344,6,6,1,2412,-51,-91,40,e6:aa:ea:c9:ea:33,34131448,408,9526,34131040,34131448
7345,6,6,1,2412,-73,-91,18,78:8a:20:fa:27:f9,34135422,88,3886,34135334,34135422
7346,6,6,1,2412,-77,-91,14,,34135528,44,62,34135484,34135528
7347,6,6,1,2412,-73,-91,18,,34139442,44,3870,34139398,34139442
7348,6,12,1,2412,-73,-91,18,,34139981,32,507,34139949,34139981
7349,6,12,1,2412,-73,-91,18,,34140222,32,209,34140190,34140222
7350,6,6,1,2412,-51,-91,40,e6:aa:ea:c9:ea:33,34155460,408,14830,34155052,34155460
7351,6,6,1,2412,-50,-91,41,e6:aa:ea:c9:ea:33,34167580,408,11712,34167172,34167580
7352,4,1,1,2412,-74,-91,17,b8:3a:5a:88:e6:e0,34169699,2360,-241,34167339,34169699
7353,6,6,1,2412,-50,-91,41,e6:aa:ea:c9:ea:33,34179703,408,9596,34179295,34179703
7354,6,6,1,2412,-69,-91,22,78:8a:20:fa:27:f9,34185173,88,5382,34185085,34185173
7355,6,12,1,2412,-57,-91,34,40:e3:d6:da:ba:20,34185783,160,450,34185623,34185783
7356,6,6,1,2412,-57,-91,34,40:e3:d6:da:ba:21,34185975,368,-176,34185607,34185975
7357,6,12,1,2412,-57,-91,34,40:e3:d6:da:ba:22,34186389,180,234,34186209,34186389
7358,6,12,1,2412,-57,-91,34,40:e3:d6:da:ba:23,34186612,184,39,34186428,34186612
7359,6,12,1,2412,-57,-91,34,40:e3:d6:da:ba:24,34186840,176,52,34186664,34186840
7360,6,12,1,2412,-57,-91,34,40:e3:d6:da:ba:25,34187050,160,50,34186890,34187050
7361,6,6,1,2412,-57,-91,34,40:e3:d6:da:ba:26,34187242,380,-188,34186862,34187242
7362,4,1,1,2412,-79,-91,12,a6:e5:7c:28:b1:d3,34231670,992,43436,34230678,34231670
7363,4,1,1,2412,-70,-91,21,54:e4:3a:ec:fb:64,34244746,2160,10916,34242586,34244746
7364,6,6,1,2412,-79,-91,12,e6:aa:ea:b7:4a:dd,34256038,408,10884,34255630,34256038
7365,4,1,1,2412,-82,-91,9,c0:c9:e3:4d:6e:bf,34257634,872,724,34256762,34257634
7366,4,1,1,2412,-72,-91,19,b8:3a:5a:88:e6:e0,34272105,2360,12111,34269745,34272105
7367,4,1,1,2412,-74,-91,17,b8:3a:5a:88:e6:e1,34274484,2376,3,34272108,34274484
7368,6,6,1,2412,-79,-91,12,e6:aa:ea:b7:4a:dd,34280259,408,5367,34279851,34280259
7369,6,12,1,2412,-57,-91,34,40:e3:d6:da:ba:20,34288184,160,7765,34288024,34288184
7370,6,12,1,2412,-57,-91,34,40:e3:d6:da:ba:22,34288781,180,417,34288601,34288781
7371,6,12,1,2412,-57,-91,34,40:e3:d6:da:ba:23,34288986,184,21,34288802,34288986
7372,6,12,1,2412,-57,-91,34,40:e3:d6:da:ba:24,34289223,176,61,34289047,34289223
7373,6,12,1,2412,-57,-91,34,40:e3:d6:da:ba:25,34289424,160,41,34289264,34289424
7374,6,6,1,2412,-57,-91,34,40:e3:d6:da:ba:26,34289643,380,-161,34289263,34289643
7375,6,12,1,2412,-87,-91,4,84:d4:7e:f2:42:25,34290239,160,436,34290079,34290239
7376,6,6,1,2412,-78,-91,13,e6:aa:ea:b7:4a:dd,34292382,408,1735,34291974,34292382
7377,4,1,1,2412,-84,-91,7,,34302728,304,10042,34302424,34302728
7378,4,1,1,2412,-75,-91,16,a6:e5:7c:28:b1:d3,34333873,992,30153,34332881,34333873
7379,4,1,1,2412,-72,-91,19,54:e4:3a:ec:fb:64,34347129,2160,11096,34344969,34347129
7380,6,12,1,2412,-58,-91,33,40:e3:d6:da:ba:20,34390563,160,43274,34390403,34390563
7381,6,6,1,2412,-57,-91,34,40:e3:d6:da:ba:21,34390782,368,-149,34390414,34390782
7382,6,12,1,2412,-57,-91,34,40:e3:d6:da:ba:22,34391196,180,234,34391016,34391196
7383,6,12,1,2412,-57,-91,34,40:e3:d6:da:ba:23,34391411,184,31,34391227,34391411
7384,6,12,1,2412,-57,-91,34,40:e3:d6:da:ba:24,34391638,176,51,34391462,34391638
7385,6,12,1,2412,-58,-91,33,40:e3:d6:da:ba:25,34391858,160,60,34391698,34391858
7386,6,6,1,2412,-57,-91,34,40:e3:d6:da:ba:26,34392049,380,-189,34391669,34392049
7387,4,1,1,2412,-74,-91,17,a6:e5:7c:28:b1:d3,34437551,992,44510,34436559,34437551
7388,4,1,1,2412,-71,-91,20,54:e4:3a:ec:fb:64,34449538,2160,9827,34447378,34449538
7389,4,1,1,2412,-69,-91,22,b8:3a:5a:88:e6:e0,34476902,2360,25004,34474542,34476902
7390,6,12,1,2412,-58,-91,33,40:e3:d6:da:ba:20,34492961,160,15899,34492801,34492961
7391,6,6,1,2412,-59,-91,32,40:e3:d6:da:ba:21,34493162,368,-167,34492794,34493162
7392,6,12,1,2412,-59,-91,32,40:e3:d6:da:ba:22,34493576,180,234,34493396,34493576
7393,6,12,1,2412,-59,-91,32,40:e3:d6:da:ba:23,34493808,184,48,34493624,34493808
7394,6,12,1,2412,-58,-91,33,40:e3:d6:da:ba:24,34494027,176,43,34493851,34494027
7395,6,12,1,2412,-59,-91,32,40:e3:d6:da:ba:25,34494228,160,41,34494068,34494228
7396,6,6,1,2412,-59,-91,32,40:e3:d6:da:ba:26,34494438,380,-170,34494058,34494438
7397,6,12,1,2412,-84,-91,7,84:d4:7e:f2:42:25,34495011,160,413,34494851,34495011
7398,6,6,1,2412,-85,-91,6,84:d4:7e:f2:42:26,34495221,380,-170,34494841,34495221
7399,6,6,1,2412,-57,-91,34,e6:aa:ea:c9:ea:33,34560553,408,64924,34560145,34560553
7400,6,12,1,2412,-84,-91,7,84:d4:7e:f2:42:20,34567102,140,6409,34566962,34567102
7401,6,6,1,2412,-81,-91,10,84:d4:7e:f2:42:21,34567293,348,-157,34566945,34567293
7402,6,12,1,2412,-85,-91,6,84:d4:7e:f2:42:22,34567668,160,215,34567508,34567668
7403,6,6,1,2412,-58,-91,33,e6:aa:ea:c9:ea:33,34572896,408,4820,34572488,34572896
7404,4,1,1,2412,-74,-91,17,b8:3a:5a:88:e6:e0,34579338,2360,4082,34576978,34579338
7405,4,1,1,2412,-75,-91,16,b8:3a:5a:88:e6:e1,34581745,2376,31,34579369,34581745
7406,6,6,1,2412,-59,-91,32,e6:aa:ea:c9:ea:33,34584762,408,2609,34584354,34584762
7407,6,6,1,2412,-59,-91,32,40:e3:d6:da:ba:21,34595588,368,10458,34595220,34595588
7408,6,12,1,2412,-57,-91,34,40:e3:d6:da:ba:22,34595976,180,208,34595796,34595976
7409,6,12,1,2412,-56,-91,35,40:e3:d6:da:ba:23,34596208,184,48,34596024,34596208
7410,6,12,1,2412,-57,-91,34,40:e3:d6:da:ba:24,34596427,176,43,34596251,34596427
7411,6,6,1,2412,-57,-91,34,40:e3:d6:da:ba:26,34597756,380,949,34597376,34597756
7412,4,1,1,2412,-72,-91,19,b8:3a:5a:88:e6:e0,34681739,2360,81623,34679379,34681739
7413,6,6,1,2412,-55,-91,36,40:e3:d6:da:ba:21,34697973,368,15866,34697605,34697973
7414,6,12,1,2412,-55,-91,36,40:e3:d6:da:ba:22,34698387,180,234,34698207,34698387
7415,6,12,1,2412,-55,-91,36,40:e3:d6:da:ba:23,34698593,184,22,34698409,34698593
7416,6,12,1,2412,-55,-91,36,40:e3:d6:da:ba:24,34698820,176,51,34698644,34698820
7417,6,12,1,2412,-55,-91,36,40:e3:d6:da:ba:25,34699049,160,69,34698889,34699049
7418,6,6,1,2412,-55,-91,36,40:e3:d6:da:ba:26,34699268,380,-161,34698888,34699268
7419,6,12,1,2412,-81,-91,10,84:d4:7e:f2:42:24,34699726,176,282,34699550,34699726
7420,4,1,1,2412,-77,-91,14,54:e4:3a:ec:fb:64,34756751,2160,54865,34754591,34756751
7421,6,6,1,2412,-77,-91,14,e6:aa:ea:b7:4a:dd,34763921,408,6762,34763513,34763921
7422,6,6,1,2412,-77,-91,14,e6:aa:ea:b7:4a:dd,34776032,408,11703,34775624,34776032
7423,4,1,1,2412,-78,-91,13,b8:3a:5a:88:e6:e0,34784100,2360,5708,34781740,34784100
7424,4,1,1,2412,-77,-91,14,b8:3a:5a:88:e6:e1,34786498,2376,22,34784122,34786498
7425,4,1,1,2412,-86,-91,5,,34792972,304,6170,34792668,34792972
7426,6,12,1,2412,-54,-91,37,40:e3:d6:da:ba:20,34800162,160,7030,34800002,34800162
7427,6,6,1,2412,-54,-91,37,40:e3:d6:da:ba:21,34800363,368,-167,34799995,34800363
7428,6,12,1,2412,-54,-91,37,40:e3:d6:da:ba:22,34800759,180,216,34800579,34800759
7429,6,12,1,2412,-54,-91,37,40:e3:d6:da:ba:23,34800982,184,39,34800798,34800982
7430,6,12,1,2412,-54,-91,37,40:e3:d6:da:ba:24,34801201,176,43,34801025,34801201
7431,6,12,1,2412,-54,-91,37,40:e3:d6:da:ba:25,34801402,160,41,34801242,34801402
7432,6,12,1,2412,-88,-91,3,40:e3:d6:da:ca:c0,34814979,156,13421,34814823,34814979
7433,6,12,1,2412,-87,-91,4,40:e3:d6:da:ca:c3,34815800,180,641,34815620,34815800
7434,6,6,1,2412,-86,-91,5,,34825067,52,9215,34825015,34825067
7435,6,12,1,2412,-87,-91,4,40:e3:d6:da:bb:e3,34825705,44,594,34825661,34825705
7436,7,21.6667,1,2412,0,-91,91,00:1f:26:41:f0:00,34826005,71,229,34825934,34826005
7437,7,21.6667,1,2412,-87,-91,4,00:1f:26:41:f0:00,34826005,141,-141,34825864,34826005
7438,7,21.6667,1,2412,-88,-91,3,00:1f:26:41:f0:00,34836469,90,10374,34836379,34836469
7439,4,1,1,2412,-76,-91,15,54:e4:3a:ec:fb:64,34859119,2160,20490,34856959,34859119
7440,4,1,1,2412,-78,-91,13,b8:3a:5a:88:e6:e0,34886525,2360,25046,34884165,34886525
7441,4,1,1,2412,-79,-91,12,b8:3a:5a:88:e6:e1,34888923,2376,22,34886547,34888923
7442,6,12,1,2412,-55,-91,36,40:e3:d6:da:ba:20,34902562,160,13479,34902402,34902562
7443,6,6,1,2412,-55,-91,36,40:e3:d6:da:ba:21,34902772,368,-158,34902404,34902772
7444,6,12,1,2412,-55,-91,36,40:e3:d6:da:ba:22,34903168,180,216,34902988,34903168
7445,6,12,1,2412,-55,-91,36,40:e3:d6:da:ba:23,34903382,184,30,34903198,34903382
7446,6,12,1,2412,-55,-91,36,40:e3:d6:da:ba:24,34903592,176,34,34903416,34903592
7447,6,12,1,2412,-55,-91,36,40:e3:d6:da:ba:25,34903803,160,51,34903643,34903803
7448,6,6,1,2412,-55,-91,36,40:e3:d6:da:ba:26,34903994,380,-189,34903614,34903994
7449,6,12,1,2412,-87,-91,4,84:d4:7e:f2:42:24,34904415,176,245,34904239,34904415
7450,6,6,1,2412,-88,-91,3,40:e3:d6:da:ca:c1,34917573,368,12790,34917205,34917573
7451,6,12,1,2412,-87,-91,4,40:e3:d6:da:ca:c5,34918645,156,916,34918489,34918645
7452,6,6,1,2412,-59,-91,32,e6:aa:ea:c9:ea:33,34965758,408,46705,34965350,34965758
7453,4,1,1,2412,-79,-91,12,b8:3a:5a:88:e6:e1,34991688,2376,23554,34989312,34991688
7454,6,6,1,2412,-59,-91,32,e6:aa:ea:c9:ea:33,35002095,408,9999,35001687,35002095
7455,6,12,1,2412,-58,-91,33,40:e3:d6:da:ba:20,35004975,160,2720,35004815,35004975
7456,6,6,1,2412,-58,-91,33,40:e3:d6:da:ba:21,35005176,368,-167,35004808,35005176
7457,6,12,1,2412,-58,-91,33,40:e3:d6:da:ba:22,35005572,180,216,35005392,35005572
7458,6,12,1,2412,-58,-91,33,40:e3:d6:da:ba:23,35005796,184,40,35005612,35005796
7459,6,12,1,2412,-58,-91,33,40:e3:d6:da:ba:24,35006032,176,60,35005856,35006032
7460,6,12,1,2412,-58,-91,33,40:e3:d6:da:ba:25,35006261,160,69,35006101,35006261
7461,6,6,1,2412,-58,-91,33,40:e3:d6:da:ba:26,35006462,380,-179,35006082,35006462
7462,6,12,1,2412,-86,-91,5,84:d4:7e:f2:42:25,35007031,160,409,35006871,35007031
7463,6,6,1,2412,-86,-91,5,84:d4:7e:f2:42:26,35007240,380,-171,35006860,35007240
7464,6,6,1,2412,-59,-91,32,e6:aa:ea:c9:ea:33,35014209,408,6561,35013801,35014209
7465,6,12,1,2412,-60,-91,31,40:e3:d6:da:ba:20,35107387,160,93018,35107227,35107387
7466,6,6,1,2412,-60,-91,31,40:e3:d6:da:ba:21,35107597,368,-158,35107229,35107597
7467,6,12,1,2412,-59,-91,32,40:e3:d6:da:ba:22,35107993,180,216,35107813,35107993
7468,6,12,1,2412,-59,-91,32,40:e3:d6:da:ba:23,35108225,184,48,35108041,35108225
7469,6,12,1,2412,-59,-91,32,40:e3:d6:da:ba:24,35108444,176,43,35108268,35108444
7470,6,12,1,2412,-59,-91,32,40:e3:d6:da:ba:25,35108645,160,41,35108485,35108645
7471,4,1,1,2412,-78,-91,13,54:e4:3a:ec:fb:64,35166346,2160,55541,35164186,35166346
7472,4,1,1,2412,-78,-91,13,b8:3a:5a:88:e6:e0,35193702,2360,24996,35191342,35193702
7473,6,12,1,2412,-60,-91,31,40:e3:d6:da:ba:20,35209788,160,15926,35209628,35209788
7474,6,6,1,2412,-60,-91,31,40:e3:d6:da:ba:21,35210007,368,-149,35209639,35210007
7475,6,12,1,2412,-60,-91,31,40:e3:d6:da:ba:22,35210402,180,215,35210222,35210402
7476,6,12,1,2412,-60,-91,31,40:e3:d6:da:ba:23,35210626,184,40,35210442,35210626
7477,6,12,1,2412,-60,-91,31,40:e3:d6:da:ba:24,35210853,176,51,35210677,35210853
7478,6,12,1,2412,-60,-91,31,40:e3:d6:da:ba:25,35211073,160,60,35210913,35211073
7479,6,6,1,2412,-60,-91,31,40:e3:d6:da:ba:26,35211283,380,-170,35210903,35211283
7480,4,1,1,2412,-77,-91,14,c0:c9:e3:4d:6e:bf,35242087,872,29932,35241215,35242087
7481,4,1,1,2412,-86,-91,5,,35242977,304,586,35242673,35242977
7482,4,1,1,2412,-78,-91,13,54:e4:3a:ec:fb:64,35268778,2160,23641,35266618,35268778
7483,4,1,1,2412,-78,-91,13,c0:c9:e3:4d:6e:bf,35287163,872,17513,35286291,35287163
7484,4,1,1,2412,-84,-91,7,,35288052,304,585,35287748,35288052
7485,6,6,1,2412,-77,-91,14,e6:aa:ea:b7:4a:dd,35296352,408,7892,35295944,35296352
7486,4,1,1,2412,-78,-91,13,b8:3a:5a:88:e6:e0,35297372,2360,-1340,35295012,35297372
7487,4,1,1,2412,-77,-91,14,b8:3a:5a:88:e6:e1,35301320,2376,1572,35298944,35301320
7488,4,1,1,2412,-78,-91,13,b8:3a:5a:88:e6:e1,35306039,2256,2463,35303783,35306039
7489,6,6,1,2412,-77,-91,14,e6:aa:ea:b7:4a:dd,35308469,408,2022,35308061,35308469
7490,6,12,1,2412,-59,-91,32,40:e3:d6:da:ba:22,35313764,180,5115,35313584,35313764
7491,6,12,1,2412,-59,-91,32,40:e3:d6:da:ba:23,35313979,184,31,35313795,35313979
7492,6,12,1,2412,-59,-91,32,40:e3:d6:da:ba:24,35314206,176,51,35314030,35314206
7493,6,6,1,2412,-59,-91,32,40:e3:d6:da:ba:26,35314627,380,41,35314247,35314627
7494,6,6,1,2412,-76,-91,15,e6:aa:ea:b7:4a:dd,35320595,408,5560,35320187,35320595
7495,4,1,1,2412,-68,-91,23,56:ee:5b:1d:f5:8a,35342236,1224,20417,35341012,35342236
7496,4,1,1,2412,-68,-91,23,76:5f:fb:f3:ff:5b,35344129,1248,645,35342881,35344129
7497,4,1,1,2412,-68,-91,23,76:6c:42:f3:8b:2b,35346899,1320,1450,35345579,35346899
7498,4,1,1,2412,-71,-91,20,86:d8:bb:f5:5c:cd,35348509,1296,314,35347213,35348509
7499,4,1,1,2412,-73,-91,18,8e:b2:03:1d:fb:89,35350134,1232,393,35348902,35350134
7500,4,1,1,2412,-73,-91,18,9a:25:93:3f:1c:58,35351975,1280,561,35350695,35351975
7501,4,1,1,2412,-74,-91,17,4a:69:04:88:fa:30,35353604,1240,389,35352364,35353604
7502,4,1,1,2412,-72,-91,19,92:b1:13:0d:ac:b5,35355512,1224,684,35354288,35355512
7503,4,1,1,2412,-72,-91,19,be:17:30:a9:50:65,35357355,1128,715,35356227,35357355
7504,4,1,1,2412,-78,-91,13,b8:3a:5a:88:e6:e0,35398501,2360,38786,35396141,35398501
7505,4,1,1,2412,-72,-91,19,76:7d:53:cb:f0:64,35403747,1184,4062,35402563,35403747
7506,4,1,1,2412,-73,-91,18,76:6c:42:f3:8b:2b,35405040,1320,-27,35403720,35405040
7507,4,1,1,2412,-73,-91,18,86:d8:bb:f5:5c:cd,35406651,1296,315,35405355,35406651
7508,4,1,1,2412,-72,-91,19,92:b1:13:0d:ac:b5,35413215,1224,5340,35411991,35413215
7509,6,12,1,2412,-57,-91,34,40:e3:d6:da:ba:20,35414569,160,1194,35414409,35414569
7510,6,6,1,2412,-57,-91,34,40:e3:d6:da:ba:21,35414788,368,-149,35414420,35414788
7511,6,12,1,2412,-56,-91,35,40:e3:d6:da:ba:22,35415201,180,233,35415021,35415201
7512,6,12,1,2412,-57,-91,34,40:e3:d6:da:ba:25,35416472,160,1111,35416312,35416472
7513,6,12,1,2412,-85,-91,6,84:d4:7e:f2:42:23,35419583,180,2931,35419403,35419583
7514,6,12,1,2412,-84,-91,7,84:d4:7e:f2:42:24,35419788,176,29,35419612,35419788
7515,6,6,1,2412,-85,-91,6,84:d4:7e:f2:42:26,35421258,380,1090,35420878,35421258
7516,6,12,1,2412,-85,-91,6,84:d4:7e:f2:42:20,35421683,140,285,35421543,35421683
7517,6,6,1,2412,-85,-91,6,84:d4:7e:f2:42:21,35421882,348,-149,35421534,35421882
7518,6,12,1,2412,-84,-91,7,84:d4:7e:f2:42:22,35422267,160,225,35422107,35422267
7519,6,12,1,2412,-84,-91,7,84:d4:7e:f2:42:25,35422683,140,276,35422543,35422683
7520,6,6,1,2412,-59,-91,32,e6:aa:ea:c9:ea:33,35486083,408,62992,35485675,35486083
7521,4,1,1,2412,-75,-91,16,b8:3a:5a:88:e6:e0,35500944,2360,12501,35498584,35500944
7522,4,1,1,2412,-76,-91,15,b8:3a:5a:88:e6:e1,35503350,2376,30,35500974,35503350
7523,6,6,1,2412,-58,-91,33,e6:aa:ea:c9:ea:33,35510776,408,7018,35510368,35510776
7524,6,12,1,2412,-55,-91,36,40:e3:d6:da:ba:22,35517583,180,6627,35517403,35517583
7525,6,12,1,2412,-55,-91,36,40:e3:d6:da:ba:23,35517797,184,30,35517613,35517797
7526,6,12,1,2412,-55,-91,36,40:e3:d6:da:ba:24,35518016,176,43,35517840,35518016
7527,6,12,1,2412,-55,-91,36,40:e3:d6:da:ba:25,35518235,160,59,35518075,35518235
7528,6,6,1,2412,-55,-91,36,40:e3:d6:da:ba:26,35518437,380,-178,35518057,35518437
7529,6,12,1,2412,-88,-91,3,40:e3:d6:da:ca:c2,35532367,176,13754,35532191,35532367
7530,6,6,1,2412,-57,-91,34,e6:aa:ea:c9:ea:33,35534478,408,1703,35534070,35534478
7531,6,12,1,2412,-87,-91,4,,35535916,32,1406,35535884,35535916
7532,6,12,1,2412,-87,-91,4,40:e3:d6:da:ca:c3,35545502,156,9430,35545346,35545502
7533,6,12,1,2412,-86,-91,5,,35557236,32,11702,35557204,35557236
7534,6,12,1,2412,-85,-91,6,84:d4:7e:f2:42:25,35567478,140,10102,35567338,35567478
7535,4,1,1,2412,-74,-91,17,54:e4:3a:ec:fb:64,35575926,2160,6288,35573766,35575926
7536,4,1,1,2412,-93,-91,-2,,35586518,304,10288,35586214,35586518
7537,4,5.5,1,2412,-90,-91,1,c4:75:ab:d8:f8:dd,35602149,395,15236,35601754,35602149
7538,4,5.5,1,2412,-81,-91,10,,35602561,213,199,35602348,35602561
7539,4,1,1,2412,-69,-91,22,b8:3a:5a:88:e6:e0,35602806,2240,-1995,35600566,35602806
7540,4,1,1,2412,-77,-91,14,b8:3a:5a:88:e6:e0,35605083,2360,-83,35602723,35605083
7541,4,1,1,2412,-76,-91,15,b8:3a:5a:88:e6:e1,35612072,2256,4733,35609816,35612072
7542,6,12,1,2412,-55,-91,36,40:e3:d6:da:ba:20,35619366,160,7134,35619206,35619366
7543,6,6,1,2412,-55,-91,36,40:e3:d6:da:ba:21,35619585,368,-149,35619217,35619585
7544,6,12,1,2412,-55,-91,36,40:e3:d6:da:ba:22,35619999,180,234,35619819,35619999
7545,6,12,1,2412,-55,-91,36,40:e3:d6:da:ba:25,35620642,160,483,35620482,35620642
7546,6,6,1,2412,-55,-91,36,40:e3:d6:da:ba:26,35620861,380,-161,35620481,35620861
7547,6,12,1,2412,-89,-91,2,40:e3:d6:da:ca:c5,35635450,156,14433,35635294,35635450
7548,6,6,1,2412,-84,-91,7,,35665645,44,30151,35665601,35665645
7549,4,1,1,2412,-77,-91,14,b8:3a:5a:88:e6:e0,35667374,2240,-511,35665134,35667374
7550,4,1,1,2412,-90,-91,1,,35669625,304,1947,35669321,35669625
7551,4,1,1,2412,-76,-91,15,b8:3a:5a:88:e6:e1,35670258,2256,-1623,35668002,35670258
7552,4,1,1,2412,-90,-91,1,,35672525,304,1963,35672221,35672525
7553,4,1,1,2412,-73,-91,18,54:e4:3a:ec:fb:64,35678208,2160,3523,35676048,35678208
7554,6,6,1,2412,-75,-91,16,e6:aa:ea:b7:4a:dd,35701676,408,23060,35701268,35701676
7555,6,6,1,2412,-76,-91,15,e6:aa:ea:b7:4a:dd,35713553,408,11469,35713145,35713553
7556,6,12,1,2412,-86,-91,5,40:e3:d6:da:bb:e2,35719060,176,5331,35718884,35719060
7557,6,12,1,2412,-86,-91,5,40:e3:d6:da:bb:e3,35719262,180,22,35719082,35719262
7558,6,12,1,2412,-55,-91,36,40:e3:d6:da:ba:20,35721767,160,2345,35721607,35721767
7559,6,6,1,2412,-55,-91,36,40:e3:d6:da:ba:21,35721986,368,-149,35721618,35721986
7560,6,12,1,2412,-55,-91,36,40:e3:d6:da:ba:22,35722382,180,216,35722202,35722382
7561,6,12,1,2412,-55,-91,36,40:e3:d6:da:ba:23,35722597,184,31,35722413,35722597
7562,6,12,1,2412,-55,-91,36,40:e3:d6:da:ba:24,35722824,176,51,35722648,35722824
7563,6,12,1,2412,-54,-91,37,40:e3:d6:da:ba:25,35723034,160,50,35722874,35723034
7564,6,6,1,2412,-55,-91,36,40:e3:d6:da:ba:26,35723244,380,-170,35722864,35723244
7565,6,6,1,2412,-75,-91,16,e6:aa:ea:b7:4a:dd,35725668,408,2016,35725260,35725668
7566,4,1,1,2412,-77,-91,14,c0:c9:e3:4d:6e:bf,35732088,872,5548,35731216,35732088
7567,6,12,1,2412,-88,-91,3,40:e3:d6:da:ca:c2,35737187,176,4923,35737011,35737187
7568,6,12,1,2412,-87,-91,4,40:e3:d6:da:ca:c3,35737389,180,22,35737209,35737389
7569,6,12,1,2412,-88,-91,3,40:e3:d6:da:ca:c4,35737594,172,33,35737422,35737594
7570,6,6,1,2412,-76,-91,15,e6:aa:ea:b7:4a:dd,35737788,408,-214,35737380,35737788
7571,6,6,1,2412,-76,-91,15,e6:aa:ea:b7:4a:dd,35750098,408,11902,35749690,35750098
7572,4,1,1,2412,-78,-91,13,c0:c9:e3:4d:6e:bf,35775921,872,24951,35775049,35775921
7573,4,1,1,2412,-72,-91,19,,35776811,304,586,35776507,35776811
7574,4,1,1,2412,-71,-91,20,54:e4:3a:ec:fb:64,35780922,2160,1951,35778762,35780922
7575,6,6,1,2412,-54,-91,37,e6:aa:ea:c9:ea:33,35814833,408,33503,35814425,35814833
7576,6,12,1,2412,-86,-91,5,40:e3:d6:da:bb:e2,35821454,176,6445,35821278,35821454
7577,6,12,1,2412,-88,-91,3,40:e3:d6:da:bb:e5,35822121,156,511,35821965,35822121
7578,6,6,1,2412,-86,-91,5,40:e3:d6:da:bb:e6,35822327,380,-174,35821947,35822327
7579,6,12,1,2412,-56,-91,35,40:e3:d6:da:ba:20,35825379,160,2892,35825219,35825379
7580,6,12,1,2412,-56,-91,35,40:e3:d6:da:ba:23,35826254,184,691,35826070,35826254
7581,6,12,1,2412,-56,-91,35,40:e3:d6:da:ba:24,35826473,176,43,35826297,35826473
7582,6,12,1,2412,-56,-91,35,40:e3:d6:da:ba:25,35826674,160,41,35826514,35826674
7583,6,6,1,2412,-56,-91,35,40:e3:d6:da:ba:26,35826866,380,-188,35826486,35826866
7584,6,6,1,2412,-54,-91,37,e6:aa:ea:c9:ea:33,35827290,408,16,35826882,35827290
7585,6,6,1,2412,-54,-91,37,e6:aa:ea:c9:ea:33,35839156,408,11458,35838748,35839156
7586,6,6,1,2412,-54,-91,37,e6:aa:ea:c9:ea:33,35851255,408,11691,35850847,35851255
7587,4,1,1,2412,-74,-91,17,a6:e5:7c:28:b1:d3,35869955,992,17708,35868963,35869955
7588,4,1,1,2412,-71,-91,20,54:e4:3a:ec:fb:64,35883145,2160,11030,35880985,35883145
7589,4,1,1,2412,-75,-91,16,a4:e5:7c:28:b1:d3,35905236,688,21403,35904548,35905236
7590,4,1,1,2412,-82,-91,9,,35905941,304,401,35905637,35905941
7591,4,1,1,2412,-77,-91,14,b8:3a:5a:88:e6:e0,35910936,2360,2635,35908576,35910936
7592,6,12,1,2412,-58,-91,33,40:e3:d6:da:ba:20,35926585,160,15489,35926425,35926585
7593,6,6,1,2412,-58,-91,33,40:e3:d6:da:ba:21,35926786,368,-167,35926418,35926786
7594,6,12,1,2412,-58,-91,33,40:e3:d6:da:ba:22,35927191,180,225,35927011,35927191
7595,6,12,1,2412,-58,-91,33,40:e3:d6:da:ba:23,35927397,184,22,35927213,35927397
7596,6,12,1,2412,-57,-91,34,40:e3:d6:da:ba:24,35927633,176,60,35927457,35927633
7597,4,1,1,2412,-73,-91,18,a6:e5:7c:28:b1:d3,35972125,992,43500,35971133,35972125
7598,4,1,1,2412,-72,-91,19,a4:e5:7c:28:b1:d3,35996635,688,23822,35995947,35996635
7599,4,1,1,2412,-83,-91,8,,35997339,304,400,35997035,35997339
7600,6,6,1,2412,-74,-91,17,e6:aa:ea:b7:4a:dd,36017777,408,20030,36017369,36017777
7601,6,12,1,2412,-58,-91,33,40:e3:d6:da:ba:20,36028981,160,11044,36028821,36028981
7602,6,6,1,2412,-58,-91,33,40:e3:d6:da:ba:21,36029182,368,-167,36028814,36029182
7603,6,12,1,2412,-58,-91,33,40:e3:d6:da:ba:22,36029578,180,216,36029398,36029578
7604,6,12,1,2412,-58,-91,33,40:e3:d6:da:ba:23,36029801,184,39,36029617,36029801
7605,6,12,1,2412,-59,-91,32,40:e3:d6:da:ba:25,36030266,160,305,36030106,36030266
7606,6,6,1,2412,-59,-91,32,40:e3:d6:da:ba:26,36030467,380,-179,36030087,36030467
7607,6,6,1,2412,-75,-91,16,e6:aa:ea:b7:4a:dd,36031262,408,387,36030854,36031262
7608,6,6,1,2412,-75,-91,16,e6:aa:ea:b7:4a:dd,36042156,408,10486,36041748,36042156
7609,6,6,1,2412,-75,-91,16,e6:aa:ea:b7:4a:dd,36054137,408,11573,36053729,36054137
7610,6,6,1,2412,-75,-91,16,e6:aa:ea:b7:4a:dd,36066255,408,11710,36065847,36066255
7611,4,1,1,2412,-75,-91,16,a6:e5:7c:28:b1:d3,36075294,992,8047,36074302,36075294
7612,4,1,1,2412,-73,-91,18,54:e4:3a:ec:fb:64,36087975,2160,10521,36085815,36087975
7613,6,6,1,2412,-80,-91,11,84:1b:5e:df:1b:99,36096021,80,7966,36095941,36096021
7614,4,1,1,2412,-78,-91,13,b8:3a:5a:88:e6:e0,36115315,2360,16934,36112955,36115315
7615,4,1,1,2412,-77,-91,14,b8:3a:5a:88:e6:e1,36117713,2376,22,36115337,36117713
7616,6,12,1,2412,-58,-91,33,40:e3:d6:da:ba:20,36131678,160,13805,36131518,36131678
7617,6,6,1,2412,-58,-91,33,40:e3:d6:da:ba:21,36131870,368,-176,36131502,36131870
7618,6,12,1,2412,-58,-91,33,40:e3:d6:da:ba:22,36132257,180,207,36132077,36132257
7619,6,12,1,2412,-58,-91,33,40:e3:d6:da:ba:23,36132489,184,48,36132305,36132489
7620,6,12,1,2412,-58,-91,33,40:e3:d6:da:ba:24,36132699,176,34,36132523,36132699
7621,6,12,1,2412,-58,-91,33,40:e3:d6:da:ba:25,36132900,160,41,36132740,36132900
7622,6,6,1,2412,-58,-91,33,40:e3:d6:da:ba:26,36133101,380,-179,36132721,36133101
7623,4,1,1,2412,-74,-91,17,54:e4:3a:ec:fb:64,36190349,2160,55088,36188189,36190349
7624,4,1,1,2412,-76,-91,15,c0:c9:e3:4d:6e:bf,36228659,872,37438,36227787,36228659
7625,4,1,1,2412,-82,-91,9,,36229549,304,586,36229245,36229549
7626,6,12,1,2412,-87,-91,4,40:e3:d6:da:bb:e3,36231263,180,1534,36231083,36231263
7627,6,12,1,2412,-85,-91,6,40:e3:d6:da:bb:e4,36231496,172,61,36231324,36231496
7628,6,12,1,2412,-85,-91,6,40:e3:d6:da:bb:e5,36231702,156,50,36231546,36231702
7629,6,6,1,2412,-86,-91,5,40:e3:d6:da:bb:e6,36231916,380,-166,36231536,36231916
7630,6,12,1,2412,-57,-91,34,40:e3:d6:da:ba:20,36234371,160,2295,36234211,36234371
7631,6,6,1,2412,-57,-91,34,40:e3:d6:da:ba:21,36234581,368,-158,36234213,36234581
7632,6,12,1,2412,-57,-91,34,40:e3:d6:da:ba:22,36234968,180,207,36234788,36234968
7633,6,12,1,2412,-57,-91,34,40:e3:d6:da:ba:23,36235182,184,30,36234998,36235182
7634,6,12,1,2412,-57,-91,34,40:e3:d6:da:ba:24,36235419,176,61,36235243,36235419
7635,6,12,1,2412,-57,-91,34,40:e3:d6:da:ba:25,36235620,160,41,36235460,36235620
7636,6,6,1,2412,-57,-91,34,40:e3:d6:da:ba:26,36235830,380,-170,36235450,36235830
7637,4,1,1,2412,-76,-91,15,c0:c9:e3:4d:6e:bf,36275340,872,38638,36274468,36275340
7638,4,1,1,2412,-73,-91,18,,36276229,304,585,36275925,36276229
7639,4,1,1,2412,-73,-91,18,b8:3a:5a:88:e6:e0,36320113,2360,41524,36317753,36320113
7640,6,12,1,2412,-86,-91,5,40:e3:d6:da:bb:e0,36332851,156,12582,36332695,36332851
7641,6,6,1,2412,-84,-91,7,40:e3:d6:da:bb:e1,36333039,368,-180,36332671,36333039
7642,6,12,1,2412,-86,-91,5,40:e3:d6:da:bb:e2,36333444,176,229,36333268,36333444
7643,6,12,1,2412,-84,-91,7,40:e3:d6:da:bb:e3,36333654,180,30,36333474,36333654
7644,6,12,1,2412,-85,-91,6,40:e3:d6:da:bb:e4,36333869,172,43,36333697,36333869
7645,6,6,1,2412,-58,-91,33,e6:aa:ea:c9:ea:33,36335233,408,956,36334825,36335233
7646,6,12,1,2412,-59,-91,32,40:e3:d6:da:ba:20,36336219,160,826,36336059,36336219
7647,6,6,1,2412,-56,-91,35,40:e3:d6:da:ba:21,36336428,368,-159,36336060,36336428
7648,6,12,1,2412,-56,-91,35,40:e3:d6:da:ba:22,36336815,180,207,36336635,36336815
7649,6,12,1,2412,-56,-91,35,40:e3:d6:da:ba:23,36337039,184,40,36336855,36337039
7650,6,12,1,2412,-56,-91,35,40:e3:d6:da:ba:24,36337257,176,42,36337081,36337257
7651,6,12,1,2412,-56,-91,35,40:e3:d6:da:ba:25,36337468,160,51,36337308,36337468
7652,6,6,1,2412,-60,-91,31,e6:aa:ea:c9:ea:33,36347377,408,9501,36346969,36347377
7653,6,6,1,2412,-61,-91,30,e6:aa:ea:c9:ea:33,36371590,408,23805,36371182,36371590
7654,4,1,1,2412,-74,-91,17,54:e4:3a:ec:fb:64,36395146,2160,21396,36392986,36395146
7655,4,1,1,2412,-72,-91,19,b8:3a:5a:88:e6:e0,36422803,2360,25297,36420443,36422803
7656,6,6,1,2412,-82,-91,9,40:e3:d6:da:bb:e1,36435452,368,12281,36435084,36435452
7657,6,12,1,2412,-84,-91,7,40:e3:d6:da:bb:e2,36435867,176,239,36435691,36435867
7658,6,12,1,2412,-84,-91,7,40:e3:d6:da:bb:e3,36436077,180,30,36435897,36436077
7659,6,12,1,2412,-86,-91,5,40:e3:d6:da:bb:e4,36436310,172,61,36436138,36436310
7660,6,12,1,2412,-60,-91,31,40:e3:d6:da:ba:20,36438575,160,2105,36438415,36438575
7661,6,6,1,2412,-60,-91,31,40:e3:d6:da:ba:21,36438794,368,-149,36438426,36438794
7662,6,12,1,2412,-60,-91,31,40:e3:d6:da:ba:22,36439208,180,234,36439028,36439208
7663,6,12,1,2412,-60,-91,31,40:e3:d6:da:ba:24,36439677,176,293,36439501,36439677
7664,6,12,1,2412,-60,-91,31,40:e3:d6:da:ba:25,36439905,160,68,36439745,36439905
7665,6,6,1,2412,-60,-91,31,40:e3:d6:da:ba:26,36440097,380,-188,36439717,36440097
7666,4,1,1,2412,-72,-91,19,b8:3a:5a:88:e6:e1,36527319,2376,84846,36524943,36527319
7667,6,12,1,2412,-86,-91,5,40:e3:d6:da:bb:e0,36537660,156,10185,36537504,36537660
7668,6,6,1,2412,-87,-91,4,40:e3:d6:da:bb:e1,36537874,368,-154,36537506,36537874
7669,6,12,1,2412,-86,-91,5,40:e3:d6:da:bb:e2,36538262,176,212,36538086,36538262
7670,6,12,1,2412,-86,-91,5,40:e3:d6:da:bb:e3,36538472,180,30,36538292,36538472
7671,6,6,1,2412,-71,-91,20,e6:aa:ea:b7:4a:dd,36538877,408,-3,36538469,36538877
7672,6,12,1,2412,-59,-91,32,40:e3:d6:da:ba:20,36540969,160,1932,36540809,36540969
7673,6,6,1,2412,-58,-91,33,40:e3:d6:da:ba:21,36541178,368,-159,36540810,36541178
7674,6,6,1,2412,-68,-91,23,40:e3:d6:da:ba:26,36542435,380,877,36542055,36542435
7675,6,6,1,2412,-72,-91,19,e6:aa:ea:b7:4a:dd,36551001,408,8158,36550593,36551001
7676,6,6,1,2412,-73,-91,18,e6:aa:ea:b7:4a:dd,36563114,408,11705,36562706,36563114
7677,6,6,1,2412,-73,-91,18,e6:aa:ea:b7:4a:dd,36575228,408,11706,36574820,36575228
7678,6,6,1,2412,-73,-91,18,e6:aa:ea:b7:4a:dd,36587351,408,11715,36586943,36587351
7679,4,1,1,2412,-74,-91,17,54:e4:3a:ec:fb:64,36599802,2160,10291,36597642,36599802
7680,4,1,1,2412,-76,-91,15,a6:e5:7c:28:b1:d3,36618531,944,17785,36617587,36618531
7681,4,1,1,2412,-76,-91,15,a6:e5:7c:28:b1:d3,36622497,944,3022,36621553,36622497
7682,4,1,1,2412,-75,-91,16,a6:e5:7c:28:b1:d3,36623602,944,161,36622658,36623602
7683,4,1,1,2412,-78,-91,13,b8:3a:5a:88:e6:e1,36629685,2376,3707,36627309,36629685
7684,6,12,1,2412,-57,-91,34,40:e3:d6:da:ba:20,36643371,160,13526,36643211,36643371
7685,6,6,1,2412,-57,-91,34,40:e3:d6:da:ba:21,36643590,368,-149,36643222,36643590
7686,6,12,1,2412,-57,-91,34,40:e3:d6:da:ba:22,36644004,180,234,36643824,36644004
7687,6,12,1,2412,-57,-91,34,40:e3:d6:da:ba:23,36644218,184,30,36644034,36644218
7688,6,12,1,2412,-57,-91,34,40:e3:d6:da:ba:24,36644427,176,33,36644251,36644427
7689,6,12,1,2412,-57,-91,34,40:e3:d6:da:ba:25,36644656,160,69,36644496,36644656
7690,6,6,1,2412,-57,-91,34,40:e3:d6:da:ba:26,36644848,380,-188,36644468,36644848
7691,6,6,1,2412,-56,-91,35,e6:aa:ea:c9:ea:33,36650851,408,5595,36650443,36650851
7692,6,6,1,2412,-56,-91,35,e6:aa:ea:c9:ea:33,36663020,408,11761,36662612,36663020
7693,6,6,1,2412,-56,-91,35,e6:aa:ea:c9:ea:33,36675141,408,11713,36674733,36675141
7694,6,6,1,2412,-56,-91,35,e6:aa:ea:c9:ea:33,36687195,408,11646,36686787,36687195
7695,4,1,1,2412,-74,-91,17,54:e4:3a:ec:fb:64,36702374,2160,13019,36700214,36702374
7696,4,1,1,2412,-77,-91,14,a6:e5:7c:28:b1:d3,36705416,944,2098,36704472,36705416
7697,4,1,1,2412,-56,-91,35,a6:e5:7c:28:b1:d3,36707608,944,1248,36706664,36707608
7698,4,1,1,2412,-78,-91,13,a6:e5:7c:28:b1:d3,36708722,944,170,36707778,36708722
7699,4,1,1,2412,-50,-91,41,a6:e5:7c:28:b1:d3,36710851,944,1185,36709907,36710851
7700,4,1,1,2412,-77,-91,14,a6:e5:7c:28:b1:d3,36711929,944,134,36710985,36711929
7701,4,1,1,2412,-78,-91,13,a6:e5:7c:28:b1:d3,36712998,944,125,36712054,36712998
7702,4,1,1,2412,-78,-91,13,a6:e5:7c:28:b1:d3,36715199,944,1257,36714255,36715199
7703,4,1,1,2412,-77,-91,14,a6:e5:7c:28:b1:d3,36716277,944,134,36715333,36716277
7704,4,1,1,2412,-73,-91,18,c0:c9:e3:4d:6e:bf,36726018,872,8869,36725146,36726018
7705,4,1,1,2412,-74,-91,17,,36726907,304,585,36726603,36726907
7706,4,1,1,2412,-79,-91,12,b8:3a:5a:88:e6:e0,36729718,2360,451,36727358,36729718
7707,6,12,1,2412,-55,-91,36,40:e3:d6:da:ba:20,36745771,160,15893,36745611,36745771
7708,6,6,1,2412,-55,-91,36,40:e3:d6:da:ba:21,36745980,368,-159,36745612,36745980
7709,6,12,1,2412,-55,-91,36,40:e3:d6:da:ba:22,36746367,180,207,36746187,36746367
7710,6,12,1,2412,-55,-91,36,40:e3:d6:da:ba:23,36746600,184,49,36746416,36746600
7711,6,12,1,2412,-55,-91,36,40:e3:d6:da:ba:24,36746827,176,51,36746651,36746827
7712,6,12,1,2412,-55,-91,36,40:e3:d6:da:ba:25,36747056,160,69,36746896,36747056
7713,6,6,1,2412,-55,-91,36,40:e3:d6:da:ba:26,36747248,380,-188,36746868,36747248
7714,4,1,1,2412,-82,-91,9,,36753272,304,5720,36752968,36753272
7715,4,1,1,2412,-74,-91,17,c0:c9:e3:4d:6e:bf,36770379,872,16235,36769507,36770379
7716,4,1,1,2412,-83,-91,8,,36771268,304,585,36770964,36771268
7717,4,1,1,2412,-75,-91,16,a6:e5:7c:28:b1:d3,36797933,944,25721,36796989,36797933
7718,4,1,1,2412,-75,-91,16,a6:e5:7c:28:b1:d3,36798984,944,107,36798040,36798984
7719,4,1,1,2412,-75,-91,16,a6:e5:7c:28:b1:d3,36800053,944,125,36799109,36800053
7720,4,1,1,2412,-76,-91,15,a6:e5:7c:28:b1:d3,36801113,944,116,36800169,36801113
7721,4,1,1,2412,-76,-91,15,a6:e5:7c:28:b1:d3,36802209,944,152,36801265,36802209
7722,4,1,1,2412,-51,-91,40,a6:e5:7c:28:b1:d3,36803278,944,125,36802334,36803278
7723,4,1,1,2412,-53,-91,38,a6:e5:7c:28:b1:d3,36804392,944,170,36803448,36804392
7724,4,1,1,2412,-52,-91,39,a6:e5:7c:28:b1:d3,36805443,944,107,36804499,36805443
7725,4,1,1,2412,-73,-91,18,a6:e5:7c:28:b1:d3,36806557,944,170,36805613,36806557
7726,4,1,1,2412,-74,-91,17,a6:e5:7c:28:b1:d3,36807662,944,161,36806718,36807662
7727,4,1,1,2412,-76,-91,15,a6:e5:7c:28:b1:d3,36808766,944,160,36807822,36808766
7728,4,1,1,2412,-78,-91,13,c0:c9:e3:4d:6e:bf,36814011,872,4373,36813139,36814011
7729,4,1,1,2412,-76,-91,15,b8:3a:5a:88:e6:e0,36832130,2360,15759,36829770,36832130
7730,6,6,1,2412,-49,-91,42,40:e3:d6:da:ba:21,36848362,368,15864,36847994,36848362
7731,6,12,1,2412,-55,-91,36,40:e3:d6:da:ba:24,36849191,176,653,36849015,36849191
7732,6,12,1,2412,-55,-91,36,40:e3:d6:da:ba:25,36849411,160,60,36849251,36849411
7733,6,6,1,2412,-54,-91,37,40:e3:d6:da:ba:26,36849630,380,-161,36849250,36849630
7734,6,12,1,2412,-83,-91,8,84:d4:7e:f2:42:25,36850231,160,441,36850071,36850231
7735,6,6,1,2412,-87,-91,4,40:e3:d6:da:ca:c1,36863145,368,12546,36862777,36863145
7736,6,12,1,2412,-86,-91,5,40:e3:d6:da:ca:c3,36863761,180,436,36863581,36863761
7737,6,12,1,2412,-87,-91,4,40:e3:d6:da:ca:c4,36863975,172,42,36863803,36863975
7738,6,12,1,2412,-87,-91,4,40:e3:d6:da:ca:c5,36864200,156,69,36864044,36864200
7739,4,1,1,2412,-73,-91,18,54:e4:3a:ec:fb:64,36906996,2160,40636,36904836,36906996
7740,4,1,1,2412,-76,-91,15,b8:3a:5a:88:e6:e1,36936988,2376,27616,36934612,36936988
7741,6,12,1,2412,-55,-91,36,40:e3:d6:da:ba:20,36950572,160,13424,36950412,36950572
7742,6,6,1,2412,-54,-91,37,40:e3:d6:da:ba:21,36950764,368,-176,36950396,36950764
7743,6,12,1,2412,-55,-91,36,40:e3:d6:da:ba:22,36951178,180,234,36950998,36951178
7744,6,12,1,2412,-55,-91,36,40:e3:d6:da:ba:23,36951401,184,39,36951217,36951401
7745,6,12,1,2412,-55,-91,36,40:e3:d6:da:ba:24,36951638,176,61,36951462,36951638
7746,6,12,1,2412,-55,-91,36,40:e3:d6:da:ba:25,36951848,160,50,36951688,36951848
7747,6,6,1,2412,-55,-91,36,40:e3:d6:da:ba:26,36952049,380,-179,36951669,36952049
7748,6,6,1,2412,-69,-91,22,e6:aa:ea:b7:4a:dd,36956600,408,4143,36956192,36956600
7749,6,12,1,2412,-83,-91,8,40:e3:d6:da:ca:c0,36965367,156,8611,36965211,36965367
7750,6,6,1,2412,-87,-91,4,40:e3:d6:da:ca:c1,36965582,368,-153,36965214,36965582
7751,6,12,1,2412,-88,-91,3,40:e3:d6:da:ca:c2,36965996,176,238,36965820,36965996
7752,6,12,1,2412,-89,-91,2,40:e3:d6:da:ca:c3,36966207,180,31,36966027,36966207
7753,6,12,1,2412,-89,-91,2,40:e3:d6:da:ca:c5,36966654,156,291,36966498,36966654
7754,6,6,1,2412,-77,-91,14,e6:aa:ea:b7:4a:dd,36968719,408,1657,36968311,36968719
7755,6,6,1,2412,-78,-91,13,e6:aa:ea:b7:4a:dd,36980832,408,11705,36980424,36980832
7756,6,6,1,2412,-77,-91,14,e6:aa:ea:b7:4a:dd,36992949,408,11709,36992541,36992949
7757,4,1,1,2412,-72,-91,19,22:90:7d:1c:d4:ee,36996013,1224,1840,36994789,36996013
7758,6,12,1,2412,-56,-91,35,40:e3:d6:da:ba:20,36999755,136,3606,36999619,36999755
7759,6,6,1,2412,-56,-91,35,40:e3:d6:da:ba:21,36999941,348,-162,36999593,36999941
7760,6,12,1,2412,-56,-91,35,40:e3:d6:da:ba:22,37000344,156,247,37000188,37000344
7761,6,12,1,2412,-55,-91,36,40:e3:d6:da:ba:23,37001674,156,1174,37001518,37001674
7762,6,12,1,2412,-56,-91,35,40:e3:d6:da:ba:25,37001864,136,54,37001728,37001864
7763,4,1,1,2412,-70,-91,21,54:e4:3a:ec:fb:64,37009404,2160,5380,37007244,37009404
7764,4,1,1,2412,-77,-91,14,22:90:7d:1c:d4:ee,37017764,1224,7136,37016540,37017764
7765,4,1,1,2412,-77,-91,14,a2:49:2f:b0:8a:4d,37019657,1128,765,37018529,37019657
7766,4,1,1,2412,-77,-91,14,4a:da:90:58:99:94,37024651,1320,3674,37023331,37024651
7767,4,1,1,2412,-73,-91,18,b8:3a:5a:88:e6:e0,37036921,2360,9910,37034561,37036921
7768,4,1,1,2412,-75,-91,16,b8:3a:5a:88:e6:e1,37039765,2376,468,37037389,37039765
7769,6,12,1,2412,-55,-91,36,40:e3:d6:da:ba:20,37052981,160,13056,37052821,37052981
7770,6,6,1,2412,-56,-91,35,40:e3:d6:da:ba:21,37053191,368,-158,37052823,37053191
7771,6,12,1,2412,-56,-91,35,40:e3:d6:da:ba:22,37053578,180,207,37053398,37053578
7772,6,12,1,2412,-56,-91,35,40:e3:d6:da:ba:23,37053783,184,21,37053599,37053783
7773,6,12,1,2412,-56,-91,35,40:e3:d6:da:ba:24,37054002,176,43,37053826,37054002
7774,6,6,1,2412,-56,-91,35,40:e3:d6:da:ba:26,37056583,380,2201,37056203,37056583
7775,6,6,1,2412,-56,-91,35,e6:aa:ea:c9:ea:33,37068937,408,11946,37068529,37068937
7776,6,6,1,2412,-56,-91,35,e6:aa:ea:c9:ea:33,37081098,408,11753,37080690,37081098
7777,6,6,1,2412,-56,-91,35,e6:aa:ea:c9:ea:33,37093349,408,11843,37092941,37093349
7778,6,6,1,2412,-56,-91,35,e6:aa:ea:c9:ea:33,37105311,408,11554,37104903,37105311
7779,4,1,1,2412,-76,-91,15,b8:3a:5a:88:e6:e0,37139327,2360,31656,37136967,37139327
7780,4,1,1,2412,-75,-91,16,b8:3a:5a:88:e6:e1,37141725,2376,22,37139349,37141725
7781,6,12,1,2412,-86,-91,5,84:d4:7e:f2:34:22,37144093,180,2188,37143913,37144093
7782,6,12,1,2412,-86,-91,5,84:d4:7e:f2:34:23,37144298,180,25,37144118,37144298
7783,6,12,1,2412,-87,-91,4,84:d4:7e:f2:34:24,37144530,176,56,37144354,37144530
7784,6,6,1,2412,-88,-91,3,84:d4:7e:f2:34:26,37144942,380,32,37144562,37144942
7785,6,12,1,2412,-57,-91,34,40:e3:d6:da:ba:20,37155383,160,10281,37155223,37155383
7786,6,6,1,2412,-57,-91,34,40:e3:d6:da:ba:21,37155584,368,-167,37155216,37155584
7787,6,12,1,2412,-57,-91,34,40:e3:d6:da:ba:22,37155980,180,216,37155800,37155980
7788,6,12,1,2412,-57,-91,34,40:e3:d6:da:ba:23,37156213,184,49,37156029,37156213
7789,6,12,1,2412,-57,-91,34,40:e3:d6:da:ba:24,37156431,176,42,37156255,37156431
7790,6,12,1,2412,-56,-91,35,40:e3:d6:da:ba:25,37156642,160,51,37156482,37156642
7791,6,6,1,2412,-56,-91,35,40:e3:d6:da:ba:26,37156852,380,-170,37156472,37156852
7792,4,1,1,2412,-77,-91,14,54:e4:3a:ec:fb:64,37214193,2160,55181,37212033,37214193
7793,4,1,1,2412,-82,-91,9,,37219104,304,4607,37218800,37219104
7794,4,1,1,2412,-75,-91,16,b8:3a:5a:88:e6:e0,37241741,2360,20277,37239381,37241741
7795,4,1,1,2412,-75,-91,16,b8:3a:5a:88:e6:e1,37244206,2376,89,37241830,37244206
7796,6,12,1,2412,-82,-91,9,84:d4:7e:f2:34:22,37247039,180,2653,37246859,37247039
7797,6,12,1,2412,-85,-91,6,84:d4:7e:f2:34:23,37247262,180,43,37247082,37247262
7798,6,12,1,2412,-87,-91,4,84:d4:7e:f2:34:24,37247477,176,39,37247301,37247477
7799,6,6,1,2412,-85,-91,6,84:d4:7e:f2:34:26,37247915,380,58,37247535,37247915
7800,6,12,1,2412,-58,-91,33,40:e3:d6:da:ba:20,37257786,160,9711,37257626,37257786
7801,6,6,1,2412,-58,-91,33,40:e3:d6:da:ba:21,37257978,368,-176,37257610,37257978
7802,6,12,1,2412,-57,-91,34,40:e3:d6:da:ba:22,37258382,180,224,37258202,37258382
7803,6,12,1,2412,-58,-91,33,40:e3:d6:da:ba:23,37258615,184,49,37258431,37258615
7804,6,12,1,2412,-58,-91,33,40:e3:d6:da:ba:24,37258851,176,60,37258675,37258851
7805,6,12,1,2412,-58,-91,33,40:e3:d6:da:ba:25,37259053,160,42,37258893,37259053
7806,6,6,1,2412,-58,-91,33,40:e3:d6:da:ba:26,37259254,380,-179,37258874,37259254
7807,4,1,1,2412,-79,-91,12,,37264091,304,4533,37263787,37264091
7808,4,1,1,2412,-82,-91,9,,37275956,304,11561,37275652,37275956
7809,6,6,1,2412,-87,-91,4,84:d4:7e:f2:34:21,37276310,348,6,37275962,37276310
7810,4,1,1,2412,-80,-91,11,,37296674,304,20060,37296370,37296674
7811,4,1,1,2412,-75,-91,16,a6:e5:7c:28:b1:d3,37303427,992,5761,37302435,37303427
7812,4,1,1,2412,-78,-91,13,54:e4:3a:ec:fb:64,37316739,2160,11152,37314579,37316739
7813,4,1,1,2412,-74,-91,17,ce:5b:83:4e:da:e4,37329981,1480,11762,37328501,37329981
7814,6,12,1,2412,-57,-91,34,40:e3:d6:da:ba:23,37331439,156,1302,37331283,37331439
7815,6,12,1,2412,-72,-91,19,,37331622,32,151,37331590,37331622
7816,4,1,1,2412,-72,-91,19,b8:3a:5a:88:e6:e1,37346736,2376,12738,37344360,37346736
7817,6,12,1,2412,-86,-91,5,84:d4:7e:f2:34:20,37349277,160,2381,37349117,37349277
7818,6,6,1,2412,-84,-91,7,84:d4:7e:f2:34:21,37349479,368,-166,37349111,37349479
7819,6,12,1,2412,-87,-91,4,84:d4:7e:f2:34:22,37349874,180,215,37349694,37349874
7820,6,6,1,2412,-84,-91,7,84:d4:7e:f2:34:26,37350751,380,497,37350371,37350751
7821,6,6,1,2412,-57,-91,34,40:e3:d6:da:ba:21,37360405,368,9286,37360037,37360405
7822,6,12,1,2412,-57,-91,34,40:e3:d6:da:ba:22,37360835,180,250,37360655,37360835
7823,6,12,1,2412,-57,-91,34,40:e3:d6:da:ba:23,37361067,184,48,37360883,37361067
7824,6,12,1,2412,-57,-91,34,40:e3:d6:da:ba:24,37361286,176,43,37361110,37361286
7825,6,12,1,2412,-57,-91,34,40:e3:d6:da:ba:25,37361505,160,59,37361345,37361505
7826,6,6,1,2412,-57,-91,34,40:e3:d6:da:ba:26,37361715,380,-170,37361335,37361715
7827,6,6,1,2412,-59,-91,32,e6:aa:ea:c9:ea:33,37372239,408,10116,37371831,37372239
7828,6,6,1,2412,-59,-91,32,e6:aa:ea:c9:ea:33,37384388,408,11741,37383980,37384388
7829,6,6,1,2412,-59,-91,32,e6:aa:ea:c9:ea:33,37396476,408,11680,37396068,37396476
7830,6,6,1,2412,-60,-91,31,e6:aa:ea:c9:ea:33,37408882,408,11998,37408474,37408882
7831,6,12,1,2412,-87,-91,4,84:d4:7e:f2:34:22,37451551,180,42489,37451371,37451551
7832,6,12,1,2412,-86,-91,5,84:d4:7e:f2:34:23,37451774,180,43,37451594,37451774
7833,6,12,1,2412,-85,-91,6,84:d4:7e:f2:34:24,37451988,176,38,37451812,37451988
7834,6,12,1,2412,-86,-91,5,84:d4:7e:f2:34:25,37452216,160,68,37452056,37452216
7835,4,1,1,2412,-77,-91,14,,37453119,304,599,37452815,37453119
7836,6,12,1,2412,-57,-91,34,40:e3:d6:da:ba:20,37462573,160,9294,37462413,37462573
7837,6,6,1,2412,-57,-91,34,40:e3:d6:da:ba:21,37462774,368,-167,37462406,37462774
7838,6,12,1,2412,-56,-91,35,40:e3:d6:da:ba:24,37463621,176,671,37463445,37463621
7839,6,12,1,2412,-57,-91,34,40:e3:d6:da:ba:25,37463831,160,50,37463671,37463831
7840,6,6,1,2412,-57,-91,34,40:e3:d6:da:ba:26,37464050,380,-161,37463670,37464050
7841,4,1,1,2412,-80,-91,11,,37473527,304,9173,37473223,37473527
7842,6,6,1,2412,-77,-91,14,e6:aa:ea:b7:4a:dd,37488207,408,14272,37487799,37488207
7843,6,6,1,2412,-79,-91,12,e6:aa:ea:b7:4a:dd,37512418,408,23803,37512010,37512418
7844,4,1,1,2412,-57,-91,34,54:e4:3a:ec:fb:64,37521418,2160,6840,37519258,37521418
7845,6,6,1,2412,-79,-91,12,e6:aa:ea:b7:4a:dd,37524596,408,2770,37524188,37524596
7846,4,1,1,2412,-80,-91,11,,37547286,304,22386,37546982,37547286
7847,4,1,1,2412,-73,-91,18,b8:3a:5a:88:e6:e0,37547622,2240,-1904,37545382,37547622
7848,4,1,1,2412,-73,-91,18,b8:3a:5a:88:e6:e0,37550965,2360,983,37548605,37550965
7849,4,1,1,2412,-72,-91,19,b8:3a:5a:88:e6:e1,37553354,2376,13,37550978,37553354
7850,4,1,1,2412,-73,-91,18,b8:3a:5a:88:e6:e1,37555758,2256,148,37553502,37555758
7851,6,12,1,2412,-57,-91,34,40:e3:d6:da:ba:20,37564974,160,9056,37564814,37564974
7852,6,6,1,2412,-57,-91,34,40:e3:d6:da:ba:21,37565193,368,-149,37564825,37565193
7853,6,12,1,2412,-57,-91,34,40:e3:d6:da:ba:22,37565607,180,234,37565427,37565607
7854,6,12,1,2412,-57,-91,34,40:e3:d6:da:ba:23,37565822,184,31,37565638,37565822
7855,6,12,1,2412,-57,-91,34,40:e3:d6:da:ba:24,37566058,176,60,37565882,37566058
7856,6,12,1,2412,-57,-91,34,40:e3:d6:da:ba:25,37566278,160,60,37566118,37566278
7857,6,6,1,2412,-56,-91,35,40:e3:d6:da:ba:26,37566487,380,-171,37566107,37566487
7858,4,1,1,2412,-80,-91,11,,37572636,304,5845,37572332,37572636
7859,4,1,1,2412,-74,-91,17,b8:3a:5a:88:e6:e0,37572972,2240,-1904,37570732,37572972
7860,4,1,1,2412,-74,-91,17,b8:3a:5a:88:e6:e1,37575241,2256,13,37572985,37575241
7861,4,1,1,2412,-70,-91,21,b8:3a:5a:88:e6:e0,37651314,2360,73713,37648954,37651314
7862,4,1,1,2412,-73,-91,18,b8:3a:5a:88:e6:e1,37653712,2376,22,37651336,37653712
7863,6,6,1,2412,-87,-91,4,84:d4:7e:f2:34:21,37656482,368,2402,37656114,37656482
7864,6,12,1,2412,-86,-91,5,84:d4:7e:f2:34:24,37657307,176,649,37657131,37657307
7865,6,12,1,2412,-57,-91,34,40:e3:d6:da:ba:20,37667374,160,9907,37667214,37667374
7866,6,6,1,2412,-57,-91,34,40:e3:d6:da:ba:21,37667575,368,-167,37667207,37667575
7867,6,12,1,2412,-57,-91,34,40:e3:d6:da:ba:22,37667971,180,216,37667791,37667971
7868,6,12,1,2412,-57,-91,34,40:e3:d6:da:ba:23,37668185,184,30,37668001,37668185
7869,6,12,1,2412,-56,-91,35,40:e3:d6:da:ba:24,37668395,176,34,37668219,37668395
7870,6,12,1,2412,-56,-91,35,40:e3:d6:da:ba:25,37668623,160,68,37668463,37668623
7871,6,6,1,2412,-57,-91,34,40:e3:d6:da:ba:26,37668824,380,-179,37668444,37668824
7872,6,6,1,2412,-60,-91,31,e6:aa:ea:c9:ea:33,37712489,408,43257,37712081,37712489
7873,4,1,1,2412,-77,-91,14,a6:e5:7c:28:b1:d3,37713755,992,274,37712763,37713755
7874,6,6,1,2412,-59,-91,32,e6:aa:ea:c9:ea:33,37724599,408,10436,37724191,37724599
7875,4,1,1,2412,-74,-91,17,54:e4:3a:ec:fb:64,37726189,2160,-570,37724029,37726189
7876,6,6,1,2412,-59,-91,32,e6:aa:ea:c9:ea:33,37736795,408,10198,37736387,37736795
7877,4,1,1,2412,-73,-91,18,b8:3a:5a:88:e6:e0,37753727,2360,14572,37751367,37753727
7878,6,12,1,2412,-56,-91,35,40:e3:d6:da:ba:20,37769775,160,15888,37769615,37769775
7879,6,6,1,2412,-56,-91,35,40:e3:d6:da:ba:21,37769985,368,-158,37769617,37769985
7880,6,12,1,2412,-56,-91,35,40:e3:d6:da:ba:22,37770381,180,216,37770201,37770381
7881,6,12,1,2412,-55,-91,36,40:e3:d6:da:ba:23,37770605,184,40,37770421,37770605
7882,6,12,1,2412,-56,-91,35,40:e3:d6:da:ba:24,37770841,176,60,37770665,37770841
7883,6,12,1,2412,-56,-91,35,40:e3:d6:da:ba:25,37771042,160,41,37770882,37771042
7884,6,6,1,2412,-56,-91,35,40:e3:d6:da:ba:26,37771261,380,-161,37770881,37771261
7885,4,1,1,2412,-71,-91,20,54:e4:3a:ec:fb:64,37828756,2160,55335,37826596,37828756
7886,4,1,1,2412,-73,-91,18,b8:3a:5a:88:e6:e0,37856110,2360,24994,37853750,37856110
7887,6,12,1,2412,-53,-91,38,40:e3:d6:da:ba:20,37872175,160,15905,37872015,37872175
7888,6,6,1,2412,-53,-91,38,40:e3:d6:da:ba:21,37872394,368,-149,37872026,37872394
7889,6,12,1,2412,-53,-91,38,40:e3:d6:da:ba:22,37872781,180,207,37872601,37872781
7890,6,12,1,2412,-53,-91,38,40:e3:d6:da:ba:23,37873013,184,48,37872829,37873013
7891,6,12,1,2412,-53,-91,38,40:e3:d6:da:ba:24,37873232,176,43,37873056,37873232
7892,6,12,1,2412,-53,-91,38,40:e3:d6:da:ba:25,37873467,160,75,37873307,37873467
7893,6,6,1,2412,-53,-91,38,40:e3:d6:da:ba:26,37873659,380,-188,37873279,37873659
7894,6,6,1,2412,-78,-91,13,e6:aa:ea:b7:4a:dd,37893625,408,19558,37893217,37893625
7895,4,1,1,2412,-84,-91,7,,37898316,304,4387,37898012,37898316
7896,6,6,1,2412,-78,-91,13,e6:aa:ea:b7:4a:dd,37905750,408,7026,37905342,37905750
7897,4,1,1,2412,-71,-91,20,54:e4:3a:ec:fb:64,37930987,2160,23077,37928827,37930987
7898,6,6,1,2412,-76,-91,15,e6:aa:ea:b7:4a:dd,37942094,408,10699,37941686,37942094
7899,4,1,1,2412,-75,-91,16,b8:3a:5a:88:e6:e0,37958506,2360,14052,37956146,37958506
7900,4,1,1,2412,-76,-91,15,b8:3a:5a:88:e6:e1,37960913,2376,31,37958537,37960913
7901,6,12,1,2412,-50,-91,41,40:e3:d6:da:ba:22,37975172,180,14079,37974992,37975172
7902,6,12,1,2412,-50,-91,41,40:e3:d6:da:ba:23,37975378,184,22,37975194,37975378
7903,6,12,1,2412,-50,-91,41,40:e3:d6:da:ba:24,37975605,176,51,37975429,37975605
7904,6,12,1,2412,-50,-91,41,40:e3:d6:da:ba:25,37975825,160,60,37975665,37975825
7905,6,6,1,2412,-50,-91,41,40:e3:d6:da:ba:26,37976035,380,-170,37975655,37976035
7906,4,1,1,2412,-72,-91,19,54:e4:3a:ec:fb:64,38033562,2160,55367,38031402,38033562
7907,4,1,1,2412,-70,-91,21,b8:3a:5a:88:e6:e0,38060914,2360,24992,38058554,38060914
7908,4,1,1,2412,-66,-91,25,b8:3a:5a:88:e6:e1,38063294,2376,4,38060918,38063294
7909,6,12,1,2412,-87,-91,4,40:e3:d6:da:bb:e2,38074282,176,10812,38074106,38074282
7910,6,12,1,2412,-86,-91,5,40:e3:d6:da:bb:e3,38074501,180,39,38074321,38074501
7911,6,12,1,2412,-88,-91,3,40:e3:d6:da:bb:e4,38074715,172,42,38074543,38074715
7912,6,12,1,2412,-87,-91,4,40:e3:d6:da:bb:e5,38074939,156,68,38074783,38074939
7913,6,6,1,2412,-53,-91,38,40:e3:d6:da:ba:21,38077929,368,2622,38077561,38077929
7914,6,12,1,2412,-53,-91,38,40:e3:d6:da:ba:24,38078784,176,679,38078608,38078784
7915,6,12,1,2412,-53,-91,38,40:e3:d6:da:ba:25,38078995,160,51,38078835,38078995
7916,6,6,1,2412,-53,-91,38,40:e3:d6:da:ba:26,38079187,380,-188,38078807,38079187
7917,6,6,1,2412,-59,-91,32,e6:aa:ea:c9:ea:33,38106817,408,27222,38106409,38106817
7918,6,6,1,2412,-58,-91,33,e6:aa:ea:c9:ea:33,38118926,408,11701,38118518,38118926
7919,4,1,1,2412,-72,-91,19,a6:e5:7c:28:b1:d3,38127017,992,7099,38126025,38127017
7920,6,6,1,2412,-58,-91,33,e6:aa:ea:c9:ea:33,38131048,408,3623,38130640,38131048
7921,4,1,1,2412,-71,-91,20,54:e4:3a:ec:fb:64,38135832,2160,2624,38133672,38135832
7922,6,6,1,2412,-58,-91,33,e6:aa:ea:c9:ea:33,38143163,408,6923,38142755,38143163
7923,4,1,1,2412,-74,-91,17,b8:3a:5a:88:e6:e0,38164212,2360,18689,38161852,38164212
7924,4,1,1,2412,-75,-91,16,b8:3a:5a:88:e6:e1,38166618,2376,30,38164242,38166618
7925,6,12,1,2412,-85,-91,6,40:e3:d6:da:bb:e3,38176899,180,10101,38176719,38176899
7926,6,12,1,2412,-54,-91,37,40:e3:d6:da:ba:20,38179378,160,2319,38179218,38179378
7927,6,6,1,2412,-54,-91,37,40:e3:d6:da:ba:21,38179579,368,-167,38179211,38179579
7928,6,12,1,2412,-54,-91,37,40:e3:d6:da:ba:22,38179975,180,216,38179795,38179975
7929,6,12,1,2412,-54,-91,37,40:e3:d6:da:ba:23,38180190,184,31,38180006,38180190
7930,6,12,1,2412,-54,-91,37,40:e3:d6:da:ba:24,38180399,176,33,38180223,38180399
7931,6,12,1,2412,-54,-91,37,40:e3:d6:da:ba:25,38180619,160,60,38180459,38180619
7932,6,6,1,2412,-54,-91,37,40:e3:d6:da:ba:26,38180820,380,-179,38180440,38180820
7933,6,12,1,2412,-87,-91,4,84:d4:7e:f2:42:24,38181220,176,224,38181044,38181220
7934,4,1,1,2412,-83,-91,8,c0:c9:e3:4d:6e:bf,38200701,872,18609,38199829,38200701
7935,4,1,1,2412,-71,-91,20,,38201590,304,585,38201286,38201590
7936,4,1,1,2412,-71,-91,20,a4:e5:7c:28:b1:d3,38220800,688,18522,38220112,38220800
7937,4,1,1,2412,-82,-91,9,,38221504,304,400,38221200,38221504
7938,4,1,1,2412,-71,-91,20,a6:e5:7c:28:b1:d3,38227701,992,5205,38226709,38227701
7939,4,1,1,2412,-71,-91,20,,38246099,304,18094,38245795,38246099
7940,4,1,1,2412,-76,-91,15,b8:3a:5a:88:e6:e0,38265753,2360,17294,38263393,38265753
7941,4,1,1,2412,-76,-91,15,b8:3a:5a:88:e6:e1,38268142,2376,13,38265766,38268142
7942,6,12,1,2412,-54,-91,37,40:e3:d6:da:ba:20,38281779,160,13477,38281619,38281779
7943,6,6,1,2412,-54,-91,37,40:e3:d6:da:ba:21,38281971,368,-176,38281603,38281971
7944,6,12,1,2412,-54,-91,37,40:e3:d6:da:ba:22,38282358,180,207,38282178,38282358
7945,6,12,1,2412,-53,-91,38,40:e3:d6:da:ba:23,38282563,184,21,38282379,38282563
7946,6,12,1,2412,-54,-91,37,40:e3:d6:da:ba:24,38282800,176,61,38282624,38282800
7947,6,12,1,2412,-54,-91,37,40:e3:d6:da:ba:25,38283019,160,59,38282859,38283019
7948,6,6,1,2412,-54,-91,37,40:e3:d6:da:ba:26,38283238,380,-161,38282858,38283238
7949,4,1,1,2412,-70,-91,21,a4:e5:7c:28:b1:d3,38311506,688,27580,38310818,38311506
7950,4,1,1,2412,-82,-91,9,,38312210,304,400,38311906,38312210
7951,4,1,1,2412,-77,-91,14,b8:3a:5a:88:e6:e0,38368214,2360,53644,38365854,38368214
7952,6,12,1,2412,-54,-91,37,40:e3:d6:da:ba:20,38384177,160,15803,38384017,38384177
7953,6,6,1,2412,-54,-91,37,40:e3:d6:da:ba:21,38384396,368,-149,38384028,38384396
7954,6,12,1,2412,-53,-91,38,40:e3:d6:da:ba:22,38384801,180,225,38384621,38384801
7955,6,12,1,2412,-53,-91,38,40:e3:d6:da:ba:23,38385034,184,49,38384850,38385034
7956,6,12,1,2412,-53,-91,38,40:e3:d6:da:ba:24,38385252,176,42,38385076,38385252
7957,6,12,1,2412,-54,-91,37,40:e3:d6:da:ba:25,38385472,160,60,38385312,38385472
7958,6,6,1,2412,-63,-91,28,e6:aa:ea:c9:ea:33,38434780,408,48900,38434372,38434780
7959,6,6,1,2412,-76,-91,15,e6:aa:ea:b7:4a:dd,38438054,408,2866,38437646,38438054
7960,6,6,1,2412,-63,-91,28,e6:aa:ea:c9:ea:33,38446887,408,8425,38446479,38446887
7961,6,6,1,2412,-76,-91,15,e6:aa:ea:b7:4a:dd,38449995,408,2700,38449587,38449995
7962,6,6,1,2412,-76,-91,15,e6:aa:ea:b7:4a:dd,38462113,408,11710,38461705,38462113
7963,6,12,1,2412,-86,-91,5,40:e3:d6:da:bb:e0,38483260,156,20991,38483104,38483260
7964,6,6,1,2412,-87,-91,4,40:e3:d6:da:bb:e1,38483474,368,-154,38483106,38483474
7965,6,12,1,2412,-87,-91,4,40:e3:d6:da:bb:e2,38483861,176,211,38483685,38483861
7966,6,12,1,2412,-86,-91,5,40:e3:d6:da:bb:e3,38484072,180,31,38483892,38484072
7967,6,12,1,2412,-86,-91,5,40:e3:d6:da:bb:e5,38484493,156,265,38484337,38484493
7968,6,12,1,2412,-54,-91,37,40:e3:d6:da:ba:20,38486588,160,1935,38486428,38486588
7969,6,6,1,2412,-54,-91,37,40:e3:d6:da:ba:21,38486807,368,-149,38486439,38486807
7970,6,12,1,2412,-54,-91,37,40:e3:d6:da:ba:23,38487426,184,435,38487242,38487426
7971,6,12,1,2412,-54,-91,37,40:e3:d6:da:ba:24,38487663,176,61,38487487,38487663
7972,6,12,1,2412,-54,-91,37,40:e3:d6:da:ba:25,38487891,160,68,38487731,38487891
7973,6,6,1,2412,-54,-91,37,40:e3:d6:da:ba:26,38488092,380,-179,38487712,38488092
7974,4,1,1,2412,-66,-91,25,e2:de:f0:17:03:a6,38499718,1128,10498,38498590,38499718
7975,4,1,1,2412,-70,-91,21,8a:68:96:9d:7e:b6,38510437,1320,9399,38509117,38510437
7976,4,1,1,2412,-69,-91,22,6e:29:37:2c:9f:95,38523354,1248,11669,38522106,38523354
7977,4,1,1,2412,-69,-91,22,2a:56:95:4d:ee:d3,38536502,1224,11924,38535278,38536502
7978,4,1,1,2412,-74,-91,17,54:e4:3a:ec:fb:64,38545414,2160,6752,38543254,38545414
7979,4,1,1,2412,-69,-91,22,3e:08:66:0e:08:b5,38548755,1224,2117,38547531,38548755
7980,4,1,1,2412,-69,-91,22,a2:19:da:87:f9:ee,38555860,1296,5809,38554564,38555860
7981,4,1,1,2412,-74,-91,17,b8:3a:5a:88:e6:e0,38572932,2360,14712,38570572,38572932
7982,4,1,1,2412,-74,-91,17,b8:3a:5a:88:e6:e1,38575312,2376,4,38572936,38575312
7983,6,6,1,2412,-87,-91,4,40:e3:d6:da:bb:e1,38585866,368,10186,38585498,38585866
7984,6,12,1,2412,-88,-91,3,40:e3:d6:da:bb:e2,38586262,176,220,38586086,38586262
7985,6,12,1,2412,-88,-91,3,40:e3:d6:da:bb:e3,38586473,180,31,38586293,38586473
7986,6,12,1,2412,-86,-91,5,40:e3:d6:da:bb:e4,38586687,172,42,38586515,38586687
7987,6,12,1,2412,-84,-91,7,40:e3:d6:da:bb:e5,38586912,156,69,38586756,38586912
7988,6,6,1,2412,-54,-91,37,40:e3:d6:da:ba:21,38589195,368,1915,38588827,38589195
7989,6,12,1,2412,-54,-91,37,40:e3:d6:da:ba:22,38589582,180,207,38589402,38589582
7990,6,12,1,2412,-54,-91,37,40:e3:d6:da:ba:23,38589796,184,30,38589612,38589796
7991,6,12,1,2412,-53,-91,38,40:e3:d6:da:ba:24,38590033,176,61,38589857,38590033
7992,6,12,1,2412,-54,-91,37,40:e3:d6:da:ba:25,38590261,160,68,38590101,38590261
7993,6,6,1,2412,-54,-91,37,40:e3:d6:da:ba:26,38590471,380,-170,38590091,38590471
7994,6,6,1,2412,-85,-91,6,e6:aa:ea:c9:ea:1b,38603629,408,12750,38603221,38603629
7995,6,6,1,2412,-86,-91,5,a8:5b:f7:55:1a:40,38607578,72,3877,38607506,38607578
7996,6,6,1,2412,-87,-91,4,a8:5b:f7:55:1a:40,38608152,72,502,38608080,38608152
7997,6,6,1,2412,-87,-91,4,a8:5b:f7:55:1a:40,38608260,72,36,38608188,38608260
7998,6,6,1,2412,-86,-91,5,a8:5b:f7:55:1a:40,38608834,72,502,38608762,38608834
7999,6,6,1,2412,-85,-91,6,a8:5b:f7:55:1a:40,38608941,72,35,38608869,38608941
8000,6,6,1,2412,-85,-91,6,e6:aa:ea:c9:ea:1b,38615645,408,6296,38615237,38615645
8001,6,6,1,2412,-84,-91,7,e6:aa:ea:c9:ea:1b,38651928,408,35875,38651520,38651928
8002,4,1,1,2412,-72,-91,19,b8:3a:5a:88:e6:e0,38675329,2360,21041,38672969,38675329
8003,4,1,1,2412,-74,-91,17,b8:3a:5a:88:e6:e1,38677795,2376,90,38675419,38677795
8004,6,12,1,2412,-55,-91,36,40:e3:d6:da:ba:20,38691378,160,13423,38691218,38691378
8005,6,12,1,2412,-85,-91,6,84:d4:7e:f2:42:25,38693407,160,1869,38693247,38693407
8006,4,1,1,2412,-73,-91,18,c0:c9:e3:4d:6e:bf,38737220,872,42941,38736348,38737220
8007,4,1,1,2412,-85,-91,6,,38738110,304,586,38737806,38738110
8008,6,12,1,2412,-86,-91,5,40:e3:d6:da:bb:e2,38791059,176,52773,38790883,38791059
8009,6,12,1,2412,-56,-91,35,40:e3:d6:da:ba:20,38793779,160,2560,38793619,38793779
8010,6,6,1,2412,-56,-91,35,40:e3:d6:da:ba:21,38794013,368,-134,38793645,38794013
8011,6,12,1,2412,-56,-91,35,40:e3:d6:da:ba:22,38794419,180,226,38794239,38794419
8012,4,1,1,2412,-82,-91,9,fe:86:68:3d:cb:90,38804090,1128,8543,38802962,38804090
8013,4,1,1,2412,-72,-91,19,72:ac:98:50:a1:2e,38819156,1128,13938,38818028,38819156
8014,6,6,1,2412,-86,-91,5,40:e3:d6:da:bb:e1,38820439,348,935,38820091,38820439
8015,6,12,1,2412,-85,-91,6,,38820997,32,526,38820965,38820997
8016,6,12,1,2412,-87,-91,4,40:e3:d6:da:bb:e3,38821064,156,-89,38820908,38821064
8017,4,1,1,2412,-79,-91,12,fe:86:68:3d:cb:90,38825335,1128,3143,38824207,38825335
8018,6,12,1,2412,-56,-91,35,40:e3:d6:da:ba:20,38830884,136,5413,38830748,38830884
8019,6,6,1,2412,-56,-91,35,40:e3:d6:da:ba:21,38831079,348,-153,38830731,38831079
8020,6,12,1,2412,-56,-91,35,40:e3:d6:da:ba:22,38831473,156,238,38831317,38831473
8021,6,12,1,2412,-56,-91,35,40:e3:d6:da:ba:23,38831672,156,43,38831516,38831672
8022,6,12,1,2412,-56,-91,35,40:e3:d6:da:ba:25,38831881,136,73,38831745,38831881
8023,4,1,1,2412,-73,-91,18,a6:e5:7c:28:b1:d3,38840759,992,7886,38839767,38840759
8024,4,1,1,2412,-75,-91,16,54:e4:3a:ec:fb:64,38852583,2160,9664,38850423,38852583
8025,4,1,1,2412,-78,-91,13,b8:3a:5a:88:e6:e0,38880114,2360,25171,38877754,38880114
8026,6,12,1,2412,-56,-91,35,40:e3:d6:da:ba:20,38896180,160,15906,38896020,38896180
8027,6,6,1,2412,-56,-91,35,40:e3:d6:da:ba:21,38896381,368,-167,38896013,38896381
8028,6,12,1,2412,-87,-91,4,40:e3:d6:da:c8:03,38943637,184,47072,38943453,38943637
8029,6,6,1,2412,-72,-91,19,e6:aa:ea:b7:4a:dd,38946225,408,2180,38945817,38946225
8030,6,6,1,2412,-54,-91,37,e6:aa:ea:c9:ea:33,38954120,408,7487,38953712,38954120
8031,4,1,1,2412,-75,-91,16,54:e4:3a:ec:fb:64,38955145,2160,-1135,38952985,38955145
8032,6,6,1,2412,-54,-91,37,e6:aa:ea:c9:ea:33,38966204,408,10651,38965796,38966204
8033,6,6,1,2412,-72,-91,19,e6:aa:ea:b7:4a:dd,38970456,408,3844,38970048,38970456
8034,6,6,1,2412,-54,-91,37,e6:aa:ea:c9:ea:33,38978369,408,7505,38977961,38978369
8035,6,6,1,2412,-55,-91,36,e6:aa:ea:c9:ea:33,38990442,408,11665,38990034,38990442
8036,6,12,1,2412,-55,-91,36,40:e3:d6:da:ba:20,38998580,160,7978,38998420,38998580
8037,6,6,1,2412,-56,-91,35,40:e3:d6:da:ba:21,38998799,368,-149,38998431,38998799
8038,6,12,1,2412,-56,-91,35,40:e3:d6:da:ba:22,38999186,180,207,38999006,38999186
8039,6,12,1,2412,-56,-91,35,40:e3:d6:da:ba:23,38999400,184,30,38999216,38999400
8040,6,12,1,2412,-56,-91,35,40:e3:d6:da:ba:24,38999637,176,61,38999461,38999637
8041,6,12,1,2412,-56,-91,35,40:e3:d6:da:ba:25,38999856,160,59,38999696,38999856
8042,6,6,1,2412,-56,-91,35,40:e3:d6:da:ba:26,39000075,380,-161,38999695,39000075
8043,6,12,1,2412,-88,-91,3,84:d4:7e:f2:42:25,39000595,160,360,39000435,39000595
8044,6,6,1,2412,-88,-91,3,84:d4:7e:f2:42:26,39000813,380,-162,39000433,39000813
8045,6,6,1,2412,-82,-91,9,84:1b:5e:df:1b:99,39015804,80,14911,39015724,39015804
8046,4,1,1,2412,-71,-91,20,a6:e5:7c:28:b1:d3,39044123,992,27327,39043131,39044123
8047,4,1,1,2412,-73,-91,18,b8:3a:5a:88:e6:e0,39084926,2360,38443,39082566,39084926
8048,6,12,1,2412,-57,-91,34,40:e3:d6:da:ba:20,39100994,160,15908,39100834,39100994
8049,6,6,1,2412,-56,-91,35,40:e3:d6:da:ba:21,39101186,368,-176,39100818,39101186
8050,6,12,1,2412,-56,-91,35,40:e3:d6:da:ba:22,39101573,180,207,39101393,39101573
8051,6,12,1,2412,-56,-91,35,40:e3:d6:da:ba:23,39101797,184,40,39101613,39101797
8052,6,12,1,2412,-56,-91,35,40:e3:d6:da:ba:24,39102049,176,76,39101873,39102049
8053,6,12,1,2412,-56,-91,35,40:e3:d6:da:ba:25,39102278,160,69,39102118,39102278
8054,6,6,1,2412,-56,-91,35,40:e3:d6:da:ba:26,39102469,380,-189,39102089,39102469
8055,6,6,1,2412,-86,-91,5,e6:aa:ea:c9:ea:1b,39126045,408,23168,39125637,39126045
8056,6,6,1,2412,-85,-91,6,e6:aa:ea:c9:ea:1b,39138168,408,11715,39137760,39138168
8057,6,12,1,2412,-87,-91,4,,39139870,32,1670,39139838,39139870
8058,6,6,1,2412,-86,-91,5,e6:aa:ea:c9:ea:1b,39150381,408,10103,39149973,39150381
8059,4,1,1,2412,-72,-91,19,54:e4:3a:ec:fb:64,39159975,2160,7434,39157815,39159975
8060,6,6,1,2412,-86,-91,5,e6:aa:ea:c9:ea:1b,39162396,408,2013,39161988,39162396
8061,4,1,1,2412,-80,-91,11,c0:c9:e3:4d:6e:bf,39180888,872,17620,39180016,39180888
8062,4,1,1,2412,-86,-91,5,,39181776,304,584,39181472,39181776
8063,6,12,1,2412,-88,-91,3,40:e3:d6:da:bb:e3,39195265,156,13333,39195109,39195265
8064,6,12,1,2412,-87,-91,4,40:e3:d6:da:bb:e5,39201310,156,5889,39201154,39201310
8065,6,12,1,2412,-56,-91,35,40:e3:d6:da:ba:20,39203405,160,1935,39203245,39203405
8066,6,6,1,2412,-56,-91,35,40:e3:d6:da:ba:21,39203606,368,-167,39203238,39203606
8067,6,12,1,2412,-56,-91,35,40:e3:d6:da:ba:23,39204216,184,426,39204032,39204216
8068,6,12,1,2412,-56,-91,35,40:e3:d6:da:ba:24,39204443,176,51,39204267,39204443
8069,6,12,1,2412,-56,-91,35,40:e3:d6:da:ba:25,39204645,160,42,39204485,39204645
8070,6,6,1,2412,-56,-91,35,40:e3:d6:da:ba:26,39204837,380,-188,39204457,39204837
8071,6,24,1,2412,-83,-91,8,,39213130,28,8265,39213102,39213130
8072,6,12,1,2412,-86,-91,5,,39213176,32,14,39213144,39213176
8073,6,12,1,2412,-87,-91,4,,39213290,32,82,39213258,39213290
8074,4,1,1,2412,-76,-91,15,c0:c9:e3:4d:6e:bf,39224430,872,10268,39223558,39224430
8075,4,1,1,2412,-75,-91,16,,39225318,304,584,39225014,39225318
8076,6,12,1,2412,-86,-91,5,40:e3:d6:da:bb:e5,39225509,48,143,39225461,39225509
8077,6,12,1,2412,-84,-91,7,,39225575,32,34,39225543,39225575
8078,6,6,1,2412,-82,-91,9,,39226535,52,908,39226483,39226535
8079,6,6,1,2412,-82,-91,9,,39226654,52,67,39226602,39226654
8080,6,6,1,2412,-86,-91,5,,39226801,52,95,39226749,39226801
8081,6,6,1,2412,-86,-91,5,,39226870,44,25,39226826,39226870
8082,6,12,1,2412,-84,-91,7,fc:f8:ae:51:0a:f9,39226925,48,7,39226877,39226925
8083,6,12,1,2412,-85,-91,6,,39226990,32,33,39226958,39226990
8084,6,24,1,2412,-82,-91,9,,39227127,28,109,39227099,39227127
8085,6,24,1,2412,-84,-91,7,,39227394,28,239,39227366,39227394
8086,6,12,1,2412,-86,-91,5,,39236947,32,9521,39236915,39236947
8087,6,12,1,2412,-86,-91,5,,39239917,36,2934,39239881,39239917
8088,6,12,1,2412,-85,-91,6,,39239970,32,21,39239938,39239970
8089,6,24,1,2412,-82,-91,9,,39240903,28,905,39240875,39240903
8090,6,12,1,2412,-87,-91,4,,39240948,32,13,39240916,39240948
8091,6,12,1,2412,-86,-91,5,,39241063,32,83,39241031,39241063
8092,6,24,1,2412,-83,-91,8,,39241255,28,164,39241227,39241255
8093,6,12,1,2412,-87,-91,4,,39241301,32,14,39241269,39241301
8094,6,24,1,2412,-84,-91,7,,39241610,28,281,39241582,39241610
8095,6,12,1,2412,-85,-91,6,,39242037,32,395,39242005,39242037
8096,6,6,1,2412,-57,-91,34,e6:aa:ea:c9:ea:33,39256825,408,14380,39256417,39256825
8097,4,1,1,2412,-74,-91,17,54:e4:3a:ec:fb:64,39262209,2160,3224,39260049,39262209
8098,6,6,1,2412,-57,-91,34,e6:aa:ea:c9:ea:33,39268955,408,6338,39268547,39268955
8099,6,6,1,2412,-57,-91,34,e6:aa:ea:c9:ea:33,39286983,408,17620,39286575,39286983
8100,4,1,1,2412,-72,-91,19,b8:3a:5a:88:e6:e0,39289709,2360,366,39287349,39289709
8101,6,12,1,2412,-85,-91,6,84:d4:7e:f2:34:23,39294759,180,4870,39294579,39294759
8102,6,12,1,2412,-87,-91,4,84:d4:7e:f2:34:24,39294992,176,57,39294816,39294992
8103,6,12,1,2412,-86,-91,5,84:d4:7e:f2:34:25,39295211,160,59,39295051,39295211
8104,6,12,1,2412,-85,-91,6,40:e3:d6:da:bb:e2,39303107,176,7720,39302931,39303107
8105,6,12,1,2412,-85,-91,6,40:e3:d6:da:bb:e4,39303541,172,262,39303369,39303541
8106,6,12,1,2412,-85,-91,6,40:e3:d6:da:bb:e5,39303765,156,68,39303609,39303765
8107,6,6,1,2412,-84,-91,7,40:e3:d6:da:bb:e6,39303962,380,-183,39303582,39303962
8108,6,12,1,2412,-55,-91,36,40:e3:d6:da:ba:20,39307885,160,3763,39307725,39307885
8109,6,12,1,2412,-54,-91,37,40:e3:d6:da:ba:23,39308719,184,650,39308535,39308719
8110,6,12,1,2412,-54,-91,37,40:e3:d6:da:ba:24,39308956,176,61,39308780,39308956
8111,6,12,1,2412,-54,-91,37,40:e3:d6:da:ba:25,39309184,160,68,39309024,39309184
8112,6,6,1,2412,-54,-91,37,40:e3:d6:da:ba:26,39309403,380,-161,39309023,39309403
8113,6,6,1,2412,-79,-91,12,e6:aa:ea:b7:4a:dd,39351925,408,42114,39351517,39351925
8114,6,6,1,2412,-79,-91,12,e6:aa:ea:b7:4a:dd,39364040,408,11707,39363632,39364040
8115,4,1,1,2412,-73,-91,18,54:e4:3a:ec:fb:64,39365590,2160,-610,39363430,39365590
8116,4,1,1,2412,-77,-91,14,b8:3a:5a:88:e6:e0,39392126,2360,24176,39389766,39392126
8117,4,1,1,2412,-78,-91,13,b8:3a:5a:88:e6:e1,39394624,2376,122,39392248,39394624
8118,6,6,1,2412,-86,-91,5,84:d4:7e:f2:34:21,39397384,368,2392,39397016,39397384
8119,6,12,1,2412,-87,-91,4,84:d4:7e:f2:34:22,39397798,180,234,39397618,39397798
8120,6,6,1,2412,-78,-91,13,e6:aa:ea:b7:4a:dd,39400388,408,2182,39399980,39400388
8121,6,12,1,2412,-83,-91,8,40:e3:d6:da:bb:e0,39404881,156,4337,39404725,39404881
8122,6,12,1,2412,-84,-91,7,40:e3:d6:da:bb:e3,39405759,180,698,39405579,39405759
8123,6,12,1,2412,-83,-91,8,40:e3:d6:da:bb:e4,39405965,172,34,39405793,39405965
8124,6,12,1,2412,-83,-91,8,40:e3:d6:da:bb:e5,39406162,156,41,39406006,39406162
8125,6,6,1,2412,-83,-91,8,40:e3:d6:da:bb:e6,39406383,380,-159,39406003,39406383
8126,6,12,1,2412,-55,-91,36,40:e3:d6:da:ba:20,39408190,160,1647,39408030,39408190
8127,6,6,1,2412,-55,-91,36,40:e3:d6:da:ba:21,39408400,368,-158,39408032,39408400
8128,6,12,1,2412,-55,-91,36,40:e3:d6:da:ba:22,39408805,180,225,39408625,39408805
8129,6,12,1,2412,-55,-91,36,40:e3:d6:da:ba:23,39409011,184,22,39408827,39409011
8130,6,12,1,2412,-55,-91,36,40:e3:d6:da:ba:24,39409229,176,42,39409053,39409229
8131,6,12,1,2412,-55,-91,36,40:e3:d6:da:ba:25,39409439,160,50,39409279,39409439
8132,6,24,1,2412,-82,-91,9,,39437289,28,27822,39437261,39437289
8133,6,12,1,2412,-84,-91,7,,39437602,32,281,39437570,39437602
8134,6,12,1,2412,-83,-91,8,,39440720,36,3082,39440684,39440720
8135,6,12,1,2412,-82,-91,9,,39440774,32,22,39440742,39440774
8136,6,24,1,2412,-84,-91,7,,39441737,28,935,39441709,39441737
8137,6,12,1,2412,-83,-91,8,,39441782,32,13,39441750,39441782
8138,6,12,1,2412,-83,-91,8,,39441896,32,82,39441864,39441896
8139,6,12,1,2412,-83,-91,8,,39442291,32,363,39442259,39442291
8140,6,12,1,2412,-83,-91,8,,39445077,36,2750,39445041,39445077
8141,6,12,1,2412,-82,-91,9,,39445129,32,20,39445097,39445129
8142,6,12,1,2412,-83,-91,8,,39445420,36,255,39445384,39445420
8143,6,12,1,2412,-82,-91,9,,39445473,32,21,39445441,39445473
8144,6,6,1,2412,-86,-91,5,e6:aa:ea:c9:ea:1b,39445968,408,87,39445560,39445968
8145,6,24,1,2412,-83,-91,8,,39446409,28,413,39446381,39446409
8146,6,12,1,2412,-84,-91,7,,39446454,32,13,39446422,39446454
8147,6,12,1,2412,-84,-91,7,,39446568,32,82,39446536,39446568
8148,6,6,1,2412,-85,-91,6,e6:aa:ea:c9:ea:1b,39458090,408,11114,39457682,39458090
8149,6,6,1,2412,-85,-91,6,e6:aa:ea:c9:ea:1b,39470205,408,11707,39469797,39470205
8150,6,6,1,2412,-83,-91,8,e6:aa:ea:c9:ea:1b,39482325,408,11712,39481917,39482325
8151,4,1,1,2412,-74,-91,17,b8:3a:5a:88:e6:e1,39496925,2376,12224,39494549,39496925
8152,6,12,1,2412,-54,-91,37,40:e3:d6:da:ba:20,39510581,160,13496,39510421,39510581
8153,6,6,1,2412,-54,-91,37,40:e3:d6:da:ba:21,39510782,368,-167,39510414,39510782
8154,6,12,1,2412,-54,-91,37,40:e3:d6:da:ba:22,39511196,180,234,39511016,39511196
8155,6,12,1,2412,-54,-91,37,40:e3:d6:da:ba:23,39511411,184,31,39511227,39511411
8156,6,12,1,2412,-54,-91,37,40:e3:d6:da:ba:24,39511647,176,60,39511471,39511647
8157,6,12,1,2412,-54,-91,37,40:e3:d6:da:ba:25,39511848,160,41,39511688,39511848
8158,4,1,1,2412,-60,-91,31,,39551611,304,39459,39551307,39551611
8159,6,12,1,2412,-85,-91,6,,39555824,32,4181,39555792,39555824
8160,4,1,1,2412,-72,-91,19,54:e4:3a:ec:fb:64,39569453,2160,11469,39567293,39569453
8161,4,1,1,2412,-75,-91,16,b8:3a:5a:88:e6:e0,39596919,2360,25106,39594559,39596919
8162,4,1,1,2412,-75,-91,16,b8:3a:5a:88:e6:e1,39599326,2376,31,39596950,39599326
8163,6,12,1,2412,-53,-91,38,40:e3:d6:da:ba:25,39614213,160,14727,39614053,39614213
8164,6,6,1,2412,-53,-91,38,40:e3:d6:da:ba:26,39614423,380,-170,39614043,39614423
8165,4,1,1,2412,-72,-91,19,54:e4:3a:ec:fb:64,39671794,2160,55211,39669634,39671794
8166,4,1,1,2412,-84,-91,7,,39674663,304,2565,39674359,39674663
8167,6,6,1,2412,-56,-91,35,40:e3:d6:da:ba:21,39715596,368,40565,39715228,39715596
8168,6,12,1,2412,-56,-91,35,40:e3:d6:da:ba:23,39716225,184,445,39716041,39716225
8169,6,12,1,2412,-56,-91,35,40:e3:d6:da:ba:24,39716452,176,51,39716276,39716452
8170,6,6,1,2412,-56,-91,35,40:e3:d6:da:ba:26,39716873,380,41,39716493,39716873
8171,6,12,1,2412,-86,-91,5,,39740411,32,23506,39740379,39740411
8172,6,12,1,2412,-86,-91,5,,39740793,32,350,39740761,39740793
8173,6,12,1,2412,-86,-91,5,,39741184,32,359,39741152,39741184
8174,6,12,1,2412,-86,-91,5,,39741584,32,368,39741552,39741584
8175,6,12,1,2412,-85,-91,6,,39756573,36,14953,39756537,39756573
8176,6,12,1,2412,-86,-91,5,,39756977,36,368,39756941,39756977
8177,6,6,1,2412,-87,-91,4,40:e3:d6:da:c8:01,39762958,368,5613,39762590,39762958
8178,6,12,1,2412,-87,-91,4,40:e3:d6:da:c8:03,39764452,184,1310,39764268,39764452
8179,6,12,1,2412,-86,-91,5,40:e3:d6:da:c8:04,39764680,176,52,39764504,39764680
8180,4,1,1,2412,-73,-91,18,54:e4:3a:ec:fb:64,39777964,2112,11172,39775852,39777964
8181,4,1,1,2412,-76,-91,15,54:e4:3a:ec:fb:64,39782067,2112,1991,39779955,39782067
8182,6,6,1,2412,-86,-91,5,e6:aa:ea:c9:ea:1b,39787228,408,4753,39786820,39787228
8183,6,6,1,2412,-61,-91,30,e6:aa:ea:c9:ea:33,39788070,408,434,39787662,39788070
8184,4,1,1,2412,-93,-91,-2,,39788992,304,618,39788688,39788992
8185,4,1,1,2412,-69,-91,22,54:e4:3a:ec:fb:64,39793599,2112,2495,39791487,39793599
8186,6,6,1,2412,-60,-91,31,e6:aa:ea:c9:ea:33,39800312,408,6305,39799904,39800312
8187,4,1,1,2412,-71,-91,20,b8:3a:5a:88:e6:e0,39801738,2360,-934,39799378,39801738
8188,6,12,1,2412,-86,-91,5,84:d4:7e:f2:34:20,39805825,160,3927,39805665,39805825
8189,6,6,1,2412,-86,-91,5,84:d4:7e:f2:34:21,39806095,368,-98,39805727,39806095
8190,6,6,1,2412,-86,-91,5,84:d4:7e:f2:34:26,39807472,380,997,39807092,39807472
8191,6,12,1,2412,-86,-91,5,,39809146,32,1642,39809114,39809146
8192,6,6,1,2412,-60,-91,31,e6:aa:ea:c9:ea:33,39812301,408,2747,39811893,39812301
8193,6,12,1,2412,-56,-91,35,40:e3:d6:da:ba:23,39816056,156,3599,39815900,39816056
8194,6,12,1,2412,-85,-91,6,40:e3:d6:da:bb:e3,39816765,180,529,39816585,39816765
8195,6,12,1,2412,-87,-91,4,40:e3:d6:da:bb:e4,39816989,172,52,39816817,39816989
8196,6,12,1,2412,-86,-91,5,40:e3:d6:da:bb:e5,39817204,156,59,39817048,39817204
8197,6,12,1,2412,-56,-91,35,40:e3:d6:da:ba:20,39817785,160,421,39817625,39817785
8198,6,6,1,2412,-56,-91,35,40:e3:d6:da:ba:21,39818004,368,-149,39817636,39818004
8199,6,12,1,2412,-56,-91,35,40:e3:d6:da:ba:22,39818418,180,234,39818238,39818418
8200,6,12,1,2412,-56,-91,35,40:e3:d6:da:ba:23,39818651,184,49,39818467,39818651
8201,6,12,1,2412,-56,-91,35,40:e3:d6:da:ba:24,39818887,176,60,39818711,39818887
8202,6,12,1,2412,-56,-91,35,40:e3:d6:da:ba:25,39819107,160,60,39818947,39819107
8203,6,6,1,2412,-56,-91,35,40:e3:d6:da:ba:26,39819317,380,-170,39818937,39819317
8204,6,6,1,2412,-58,-91,33,e6:aa:ea:c9:ea:33,39824426,408,4701,39824018,39824426
8205,4,1,1,2412,-85,-91,6,ce:5b:83:4e:da:e4,39835250,1480,9344,39833770,39835250
8206,6,12,1,2412,-87,-91,4,40:e3:d6:da:bb:e3,39836709,156,1303,39836553,39836709
8207,6,6,1,2412,-71,-91,20,e6:aa:ea:b7:4a:dd,39871853,408,34736,39871445,39871853
8208,4,1,1,2412,-79,-91,12,54:e4:3a:ec:fb:64,39876581,2160,2568,39874421,39876581
8209,6,6,1,2412,-70,-91,21,e6:aa:ea:b7:4a:dd,39896104,408,19115,39895696,39896104
8210,4,1,1,2412,-73,-91,18,b8:3a:5a:88:e6:e0,39904121,2360,5657,39901761,39904121
8211,4,1,1,2412,-72,-91,19,b8:3a:5a:88:e6:e1,39906501,2376,4,39904125,39906501
8212,6,12,1,2412,-85,-91,6,84:d4:7e:f2:34:22,39908944,180,2263,39908764,39908944
8213,6,12,1,2412,-85,-91,6,84:d4:7e:f2:34:23,39909159,180,35,39908979,39909159
8214,6,12,1,2412,-85,-91,6,84:d4:7e:f2:34:24,39909441,176,106,39909265,39909441
8215,6,12,1,2412,-83,-91,8,84:d4:7e:f2:34:25,39909642,160,41,39909482,39909642
8216,6,6,1,2412,-85,-91,6,84:d4:7e:f2:34:26,39909843,380,-179,39909463,39909843
8217,6,12,1,2412,-85,-91,6,40:e3:d6:da:bb:e0,39916882,156,6883,39916726,39916882
8218,6,12,1,2412,-82,-91,9,40:e3:d6:da:bb:e3,39917703,180,641,39917523,39917703
8219,6,12,1,2412,-85,-91,6,40:e3:d6:da:bb:e4,39917909,172,34,39917737,39917909
8220,6,12,1,2412,-85,-91,6,40:e3:d6:da:bb:e5,39918124,156,59,39917968,39918124
8221,6,6,1,2412,-85,-91,6,40:e3:d6:da:bb:e6,39918339,380,-165,39917959,39918339
8222,6,12,1,2412,-51,-91,40,40:e3:d6:da:ba:20,39920199,160,1700,39920039,39920199
8223,6,6,1,2412,-51,-91,40,40:e3:d6:da:ba:21,39920409,368,-158,39920041,39920409
8224,6,12,1,2412,-50,-91,41,40:e3:d6:da:ba:22,39921051,180,462,39920871,39921051
8225,6,12,1,2412,-50,-91,41,40:e3:d6:da:ba:23,39921266,184,31,39921082,39921266
8226,6,12,1,2412,-51,-91,40,40:e3:d6:da:ba:24,39921475,176,33,39921299,39921475
8227,6,12,1,2412,-50,-91,41,40:e3:d6:da:ba:25,39921686,160,51,39921526,39921686
8228,6,6,1,2412,-50,-91,41,40:e3:d6:da:ba:26,39921887,380,-179,39921507,39921887
8229,6,12,1,2412,-84,-91,7,,39924745,32,2826,39924713,39924745
8230,6,12,1,2412,-84,-91,7,,39927139,32,2362,39927107,39927139
8231,6,12,1,2412,-83,-91,8,,39954524,32,27353,39954492,39954524
8232,6,12,1,2412,-84,-91,7,,39955009,32,453,39954977,39955009
8233,4,1,1,2412,-78,-91,13,b8:3a:5a:88:e6:e0,40006511,2360,49142,40004151,40006511
8234,4,1,1,2412,-78,-91,13,b8:3a:5a:88:e6:e1,40008909,2376,22,40006533,40008909
8235,6,12,1,2412,-86,-91,5,84:d4:7e:f2:34:22,40011750,180,2661,40011570,40011750
8236,6,12,1,2412,-85,-91,6,84:d4:7e:f2:34:24,40012291,176,365,40012115,40012291
8237,6,12,1,2412,-86,-91,5,84:d4:7e:f2:34:25,40012492,160,41,40012332,40012492
8238,6,6,1,2412,-85,-91,6,40:e3:d6:da:bb:e1,40019472,368,6612,40019104,40019472
8239,6,12,1,2412,-84,-91,7,40:e3:d6:da:bb:e3,40020079,180,427,40019899,40020079
8240,6,12,1,2412,-84,-91,7,40:e3:d6:da:bb:e5,40020518,156,283,40020362,40020518
8241,6,12,1,2412,-83,-91,8,,40020749,32,199,40020717,40020749
8242,6,12,1,2412,-54,-91,37,40:e3:d6:da:ba:20,40022585,160,1676,40022425,40022585
8243,6,6,1,2412,-54,-91,37,40:e3:d6:da:ba:21,40022776,368,-177,40022408,40022776
8244,6,12,1,2412,-54,-91,37,40:e3:d6:da:ba:22,40023163,180,207,40022983,40023163
8245,6,12,1,2412,-54,-91,37,40:e3:d6:da:ba:23,40023378,184,31,40023194,40023378
8246,6,12,1,2412,-54,-91,37,40:e3:d6:da:ba:24,40023605,176,51,40023429,40023605
8247,6,12,1,2412,-54,-91,37,40:e3:d6:da:ba:25,40023825,160,60,40023665,40023825
8248,6,6,1,2412,-54,-91,37,40:e3:d6:da:ba:26,40024026,380,-179,40023646,40024026
8249,6,12,1,2412,-82,-91,9,84:d4:7e:f2:42:25,40024645,160,459,40024485,40024645
8250,6,6,1,2412,-86,-91,5,84:d4:7e:f2:42:26,40024837,380,-188,40024457,40024837
8251,4,1,1,2412,-77,-91,14,56:84:2c:be:cf:f4,40068688,1152,42699,40067536,40068688
8252,4,1,1,2412,-72,-91,19,54:e4:3a:ec:fb:64,40069961,2112,-839,40067849,40069961
8253,4,1,1,2412,-77,-91,14,,40072086,304,1821,40071782,40072086
8254,6,12,1,2412,-56,-91,35,40:e3:d6:da:ba:20,40072249,136,27,40072113,40072249
8255,6,6,1,2412,-56,-91,35,40:e3:d6:da:ba:21,40072435,348,-162,40072087,40072435
8256,6,12,1,2412,-56,-91,35,40:e3:d6:da:ba:22,40072820,156,229,40072664,40072820
8257,6,12,1,2412,-56,-91,35,40:e3:d6:da:ba:23,40073020,156,44,40072864,40073020
8258,6,12,1,2412,-56,-91,35,40:e3:d6:da:ba:25,40073219,136,63,40073083,40073219
8259,4,1,1,2412,-81,-91,10,b8:3a:5a:88:e6:e0,40108914,2360,33335,40106554,40108914
8260,4,1,1,2412,-83,-91,8,b8:3a:5a:88:e6:e1,40111347,2376,57,40108971,40111347
8261,6,6,1,2412,-88,-91,3,84:d4:7e:f2:34:21,40114117,368,2402,40113749,40114117
8262,6,12,1,2412,-53,-91,38,40:e3:d6:da:ba:20,40124987,160,10710,40124827,40124987
8263,6,6,1,2412,-53,-91,38,40:e3:d6:da:ba:21,40125179,368,-176,40124811,40125179
8264,6,12,1,2412,-53,-91,38,40:e3:d6:da:ba:22,40125584,180,225,40125404,40125584
8265,6,12,1,2412,-53,-91,38,40:e3:d6:da:ba:23,40125823,184,55,40125639,40125823
8266,6,12,1,2412,-53,-91,38,40:e3:d6:da:ba:24,40126041,176,42,40125865,40126041
8267,6,12,1,2412,-53,-91,38,40:e3:d6:da:ba:25,40126243,160,42,40126083,40126243
8268,6,6,1,2412,-53,-91,38,40:e3:d6:da:ba:26,40126444,380,-179,40126064,40126444
8269,6,12,1,2412,-87,-91,4,84:d4:7e:f2:42:24,40126831,176,211,40126655,40126831
8270,4,1,1,2412,-75,-91,16,54:e4:3a:ec:fb:64,40183812,2160,54821,40181652,40183812
8271,6,12,1,2412,-50,-91,41,40:e3:d6:da:ba:20,40227385,160,43413,40227225,40227385
8272,6,6,1,2412,-50,-91,41,40:e3:d6:da:ba:21,40227576,368,-177,40227208,40227576
8273,6,12,1,2412,-50,-91,41,40:e3:d6:da:ba:22,40227981,180,225,40227801,40227981
8274,6,12,1,2412,-50,-91,41,40:e3:d6:da:ba:23,40228214,184,49,40228030,40228214
8275,6,12,1,2412,-50,-91,41,40:e3:d6:da:ba:24,40228423,176,33,40228247,40228423
8276,6,12,1,2412,-50,-91,41,40:e3:d6:da:ba:25,40228625,160,42,40228465,40228625
8277,6,6,1,2412,-50,-91,41,40:e3:d6:da:ba:26,40228844,380,-161,40228464,40228844
8278,4,1,1,2412,-77,-91,14,54:e4:3a:ec:fb:64,40286187,2160,55183,40284027,40286187
8279,6,6,1,2412,-77,-91,14,e6:aa:ea:b7:4a:dd,40288872,408,2277,40288464,40288872
8280,6,6,1,2412,-58,-91,33,e6:aa:ea:c9:ea:33,40299943,408,10663,40299535,40299943
8281,6,6,1,2412,-57,-91,34,e6:aa:ea:c9:ea:33,40311859,408,11508,40311451,40311859
8282,6,6,1,2412,-80,-91,11,e6:aa:ea:b7:4a:dd,40313112,408,845,40312704,40313112
8283,4,1,1,2412,-80,-91,11,b8:3a:5a:88:e6:e0,40313914,2360,-1558,40311554,40313914
8284,4,1,1,2412,-79,-91,12,b8:3a:5a:88:e6:e1,40316321,2376,31,40313945,40316321
8285,6,6,1,2412,-62,-91,29,e6:aa:ea:c9:ea:33,40327012,408,10283,40326604,40327012
8286,6,12,1,2412,-51,-91,40,40:e3:d6:da:ba:20,40329798,160,2626,40329638,40329798
8287,6,6,1,2412,-51,-91,40,40:e3:d6:da:ba:21,40330008,368,-158,40329640,40330008
8288,6,12,1,2412,-52,-91,39,40:e3:d6:da:ba:22,40330395,180,207,40330215,40330395
8289,6,12,1,2412,-52,-91,39,40:e3:d6:da:ba:23,40330609,184,30,40330425,40330609
8290,6,12,1,2412,-52,-91,39,40:e3:d6:da:ba:24,40330837,176,52,40330661,40330837
8291,6,12,1,2412,-48,-91,43,40:e3:d6:da:ba:25,40331084,160,87,40330924,40331084
8292,6,6,1,2412,-52,-91,39,40:e3:d6:da:ba:26,40331294,380,-170,40330914,40331294
8293,6,6,1,2412,-57,-91,34,e6:aa:ea:c9:ea:33,40336130,408,4428,40335722,40336130
8294,4,1,1,2412,-76,-91,15,54:e4:3a:ec:fb:64,40388614,2160,50324,40386454,40388614
8295,4,1,1,2412,-73,-91,18,b8:3a:5a:88:e6:e0,40416735,2360,25761,40414375,40416735
8296,6,12,1,2412,-86,-91,5,,40423640,32,6873,40423608,40423640
8297,6,12,1,2412,-86,-91,5,40:e3:d6:da:bb:e4,40430128,172,6316,40429956,40430128
8298,6,12,1,2412,-87,-91,4,40:e3:d6:da:bb:e5,40430334,156,50,40430178,40430334
8299,6,12,1,2412,-54,-91,37,40:e3:d6:da:ba:20,40432201,160,1707,40432041,40432201
8300,6,6,1,2412,-54,-91,37,40:e3:d6:da:ba:21,40432411,368,-158,40432043,40432411
8301,6,12,1,2412,-54,-91,37,40:e3:d6:da:ba:22,40432798,180,207,40432618,40432798
8302,6,12,1,2412,-54,-91,37,40:e3:d6:da:ba:23,40433013,184,31,40432829,40433013
8303,6,12,1,2412,-54,-91,37,40:e3:d6:da:ba:24,40433231,176,42,40433055,40433231
8304,6,12,1,2412,-54,-91,37,40:e3:d6:da:ba:25,40433451,160,60,40433291,40433451
8305,6,12,1,2412,-84,-91,7,,40436675,32,3192,40436643,40436675
8306,6,24,1,2412,-86,-91,5,,40438023,28,1320,40437995,40438023
8307,6,12,1,2412,-87,-91,4,,40441566,36,3507,40441530,40441566
8308,6,12,1,2412,-85,-91,6,,40441620,32,22,40441588,40441620
8309,6,12,1,2412,-88,-91,3,,40442281,36,625,40442245,40442281
8310,6,12,1,2412,-86,-91,5,,40450889,32,8576,40450857,40450889
8311,4,1,1,2412,-80,-91,11,a6:e5:7c:28:b1:d3,40478026,992,26145,40477034,40478026
8312,6,12,1,2412,-88,-91,3,84:d4:7e:f2:34:23,40523419,180,45213,40523239,40523419
8313,6,6,1,2412,-87,-91,4,84:d4:7e:f2:34:26,40524072,380,273,40523692,40524072
8314,6,12,1,2412,-86,-91,5,,40526028,32,1924,40525996,40526028
8315,4,1,1,2412,-87,-91,4,,40529405,304,3073,40529101,40529405
8316,6,12,1,2412,-86,-91,5,40:e3:d6:da:bb:e2,40532462,176,2881,40532286,40532462
8317,6,12,1,2412,-86,-91,5,40:e3:d6:da:bb:e3,40532794,180,152,40532614,40532794
8318,6,12,1,2412,-86,-91,5,40:e3:d6:da:bb:e4,40533000,172,34,40532828,40533000
8319,6,12,1,2412,-55,-91,36,40:e3:d6:da:ba:20,40534587,160,1427,40534427,40534587
8320,6,6,1,2412,-55,-91,36,40:e3:d6:da:ba:21,40534779,368,-176,40534411,40534779
8321,6,12,1,2412,-55,-91,36,40:e3:d6:da:ba:22,40535184,180,225,40535004,40535184
8322,6,12,1,2412,-55,-91,36,40:e3:d6:da:ba:23,40535417,184,49,40535233,40535417
8323,6,12,1,2412,-55,-91,36,40:e3:d6:da:ba:24,40535644,176,51,40535468,40535644
8324,6,12,1,2412,-54,-91,37,40:e3:d6:da:ba:25,40535845,160,41,40535685,40535845
8325,6,6,1,2412,-56,-91,35,40:e3:d6:da:ba:26,40536064,380,-161,40535684,40536064
8326,6,6,1,2412,-86,-91,5,40:e3:d6:da:ca:c1,40549552,368,13120,40549184,40549552
8327,6,12,1,2412,-87,-91,4,,40551321,32,1737,40551289,40551321
8328,4,1,1,2412,-70,-91,21,54:e4:3a:ec:fb:64,40593381,2160,39900,40591221,40593381
8329,6,12,1,2412,-86,-91,5,,40617506,32,24093,40617474,40617506
8330,4,1,1,2412,-79,-91,12,b8:3a:5a:88:e6:e0,40623561,2360,3695,40621201,40623561
8331,4,1,1,2412,-76,-91,15,b8:3a:5a:88:e6:e1,40625982,2376,45,40623606,40625982
8332,6,12,1,2412,-87,-91,4,,40632105,32,6091,40632073,40632105
8333,6,12,1,2412,-86,-91,5,,40632239,32,102,40632207,40632239
8334,6,6,1,2412,-85,-91,6,40:e3:d6:da:bb:e1,40633889,368,1282,40633521,40633889
8335,6,12,1,2412,-86,-91,5,40:e3:d6:da:bb:e2,40634285,176,220,40634109,40634285
8336,6,12,1,2412,-87,-91,4,40:e3:d6:da:bb:e3,40634505,180,40,40634325,40634505
8337,6,12,1,2412,-87,-91,4,40:e3:d6:da:bb:e4,40634728,172,51,40634556,40634728
8338,6,12,1,2412,-85,-91,6,40:e3:d6:da:bb:e5,40634953,156,69,40634797,40634953
8339,6,6,1,2412,-85,-91,6,40:e3:d6:da:bb:e6,40635140,380,-193,40634760,40635140
8340,6,12,1,2412,-57,-91,34,40:e3:d6:da:ba:20,40636987,160,1687,40636827,40636987
8341,6,6,1,2412,-57,-91,34,40:e3:d6:da:ba:21,40637197,368,-158,40636829,40637197
8342,6,12,1,2412,-57,-91,34,40:e3:d6:da:ba:22,40637602,180,225,40637422,40637602
8343,6,12,1,2412,-57,-91,34,40:e3:d6:da:ba:23,40637826,184,40,40637642,40637826
8344,6,12,1,2412,-57,-91,34,40:e3:d6:da:ba:24,40638053,176,51,40637877,40638053
8345,6,12,1,2412,-57,-91,34,40:e3:d6:da:ba:25,40638272,160,59,40638112,40638272
8346,6,12,1,2412,-87,-91,4,,40657934,32,19630,40657902,40657934
8347,4,1,1,2412,-77,-91,14,c0:c9:e3:4d:6e:bf,40658273,872,-533,40657401,40658273
8348,6,6,1,2412,-86,-91,5,,40659508,44,1191,40659464,40659508
8349,4,1,1,2412,-80,-91,11,a6:e5:7c:28:b1:d3,40683377,992,22877,40682385,40683377
8350,4,1,1,2412,-70,-91,21,54:e4:3a:ec:fb:64,40695819,2160,10282,40693659,40695819
8351,6,12,1,2412,-86,-91,5,,40699461,32,3610,40699429,40699461
8352,6,6,1,2412,-57,-91,34,e6:aa:ea:c9:ea:33,40717428,408,17559,40717020,40717428
8353,6,12,1,2412,-58,-91,33,40:e3:d6:da:ba:20,40739410,160,21822,40739250,40739410
8354,6,6,1,2412,-58,-91,33,40:e3:d6:da:ba:21,40739602,368,-176,40739234,40739602
8355,6,12,1,2412,-58,-91,33,40:e3:d6:da:ba:22,40739998,180,216,40739818,40739998
8356,6,12,1,2412,-58,-91,33,40:e3:d6:da:ba:23,40740204,184,22,40740020,40740204
8357,6,12,1,2412,-57,-91,34,40:e3:d6:da:ba:24,40740431,176,51,40740255,40740431
8358,6,12,1,2412,-58,-91,33,40:e3:d6:da:ba:25,40740650,160,59,40740490,40740650
8359,6,6,1,2412,-58,-91,33,40:e3:d6:da:ba:26,40740851,380,-179,40740471,40740851
8360,6,12,1,2412,-81,-91,10,84:d4:7e:f2:42:25,40741457,160,446,40741297,40741457
8361,6,6,1,2412,-58,-91,33,e6:aa:ea:c9:ea:33,40741826,408,-39,40741418,40741826
8362,4,1,1,2412,-75,-91,16,,40750962,304,8832,40750658,40750962
8363,6,6,1,2412,-58,-91,33,e6:aa:ea:c9:ea:33,40753781,408,2411,40753373,40753781
8364,6,6,1,2412,-57,-91,34,e6:aa:ea:c9:ea:33,40766004,408,11815,40765596,40766004
8365,4,1,1,2412,-75,-91,16,a6:e5:7c:28:b1:d3,40785562,992,18566,40784570,40785562
8366,6,6,1,2412,-77,-91,14,e6:aa:ea:b7:4a:dd,40808610,408,22640,40808202,40808610
8367,6,6,1,2412,-78,-91,13,e6:aa:ea:b7:4a:dd,40820501,408,11483,40820093,40820501
8368,6,6,1,2412,-58,-91,33,40:e3:d6:da:ba:21,40842020,368,21151,40841652,40842020
8369,6,12,1,2412,-58,-91,33,40:e3:d6:da:ba:22,40842452,180,252,40842272,40842452
8370,6,12,1,2412,-58,-91,33,40:e3:d6:da:ba:23,40842658,184,22,40842474,40842658
8371,6,12,1,2412,-58,-91,33,40:e3:d6:da:ba:24,40842895,176,61,40842719,40842895
8372,6,12,1,2412,-58,-91,33,40:e3:d6:da:ba:25,40843105,160,50,40842945,40843105
8373,6,6,1,2412,-58,-91,33,40:e3:d6:da:ba:26,40843306,380,-179,40842926,40843306
8374,6,6,1,2412,-78,-91,13,e6:aa:ea:b7:4a:dd,40844743,408,1029,40844335,40844743
8375,4,1,1,2412,-71,-91,20,54:e4:3a:ec:fb:64,40854810,2112,7955,40852698,40854810
8376,4,1,1,2412,-73,-91,18,54:e4:3a:ec:fb:64,40859218,2112,2296,40857106,40859218
8377,4,1,1,2412,-71,-91,20,54:e4:3a:ec:fb:64,40861530,2112,200,40859418,40861530
8378,4,1,1,2412,-71,-91,20,54:e4:3a:ec:fb:64,40900643,2160,36953,40898483,40900643
8379,6,6,1,2412,-58,-91,33,40:e3:d6:da:ba:21,40944409,368,43398,40944041,40944409
8380,6,12,1,2412,-58,-91,33,40:e3:d6:da:ba:22,40944805,180,216,40944625,40944805
8381,6,12,1,2412,-58,-91,33,40:e3:d6:da:ba:23,40945019,184,30,40944835,40945019
8382,6,12,1,2412,-58,-91,33,40:e3:d6:da:ba:24,40945238,176,43,40945062,40945238
8383,6,12,1,2412,-58,-91,33,40:e3:d6:da:ba:25,40945448,160,50,40945288,40945448
8384,6,6,1,2412,-58,-91,33,40:e3:d6:da:ba:26,40945640,380,-188,40945260,40945640
8385,4,1,1,2412,-72,-91,19,54:e4:3a:ec:fb:64,41003029,2160,55229,41000869,41003029
8386,4,1,1,2412,-77,-91,14,b8:3a:5a:88:e6:e1,41032901,2376,27496,41030525,41032901
8387,6,12,1,2412,-57,-91,34,40:e3:d6:da:ba:20,41046596,160,13535,41046436,41046596
8388,6,6,1,2412,-57,-91,34,40:e3:d6:da:ba:21,41046797,368,-167,41046429,41046797
8389,6,12,1,2412,-57,-91,34,40:e3:d6:da:ba:22,41047211,180,234,41047031,41047211
8390,6,12,1,2412,-57,-91,34,40:e3:d6:da:ba:23,41047443,184,48,41047259,41047443
8391,6,12,1,2412,-57,-91,34,40:e3:d6:da:ba:24,41047662,176,43,41047486,41047662
8392,6,12,1,2412,-57,-91,34,40:e3:d6:da:ba:25,41047881,160,59,41047721,41047881
8393,6,6,1,2412,-57,-91,34,40:e3:d6:da:ba:26,41048091,380,-170,41047711,41048091
8394,6,6,1,2412,-86,-91,5,a8:5b:f7:55:1a:40,41065100,72,16937,41065028,41065100
8395,4,1,1,2412,-73,-91,18,54:e4:3a:ec:fb:64,41105406,2160,38146,41103246,41105406
8396,6,6,1,2412,-77,-91,14,e6:aa:ea:b7:4a:dd,41123822,408,18008,41123414,41123822
8397,4,1,1,2412,-76,-91,15,b8:3a:5a:88:e6:e0,41132918,2360,6736,41130558,41132918
8398,6,6,1,2412,-57,-91,34,e6:aa:ea:c9:ea:33,41135541,408,2215,41135133,41135541
8399,6,6,1,2412,-57,-91,34,e6:aa:ea:c9:ea:33,41147663,408,11714,41147255,41147663
8400,6,12,1,2412,-55,-91,36,40:e3:d6:da:ba:20,41148995,160,1172,41148835,41148995
8401,6,6,1,2412,-55,-91,36,40:e3:d6:da:ba:21,41149187,368,-176,41148819,41149187
8402,6,12,1,2412,-55,-91,36,40:e3:d6:da:ba:22,41149600,180,233,41149420,41149600
8403,6,12,1,2412,-55,-91,36,40:e3:d6:da:ba:23,41149815,184,31,41149631,41149815
8404,6,12,1,2412,-55,-91,36,40:e3:d6:da:ba:24,41150024,176,33,41149848,41150024
8405,4,1,1,2412,-78,-91,13,c0:c9:e3:4d:6e:bf,41154562,872,3666,41153690,41154562
8406,4,1,1,2412,-77,-91,14,,41155451,304,585,41155147,41155451
8407,6,6,1,2412,-56,-91,35,e6:aa:ea:c9:ea:33,41159781,408,3922,41159373,41159781
8408,6,6,1,2412,-56,-91,35,e6:aa:ea:c9:ea:33,41177302,408,17113,41176894,41177302
8409,6,6,1,2412,-56,-91,35,e6:aa:ea:c9:ea:33,41184013,408,6303,41183605,41184013
8410,4,1,1,2412,-74,-91,17,c0:c9:e3:4d:6e:bf,41200502,872,15617,41199630,41200502
8411,4,1,1,2412,-83,-91,8,,41201391,304,585,41201087,41201391
8412,4,1,1,2412,-72,-91,19,54:e4:3a:ec:fb:64,41207836,2160,4285,41205676,41207836
8413,4,1,1,2412,-75,-91,16,b8:3a:5a:88:e6:e0,41235313,2360,25117,41232953,41235313
8414,6,12,1,2412,-55,-91,36,40:e3:d6:da:ba:20,41251411,160,15938,41251251,41251411
8415,6,6,1,2412,-54,-91,37,40:e3:d6:da:ba:21,41251612,368,-167,41251244,41251612
8416,6,12,1,2412,-54,-91,37,40:e3:d6:da:ba:22,41252026,180,234,41251846,41252026
8417,6,12,1,2412,-54,-91,37,40:e3:d6:da:ba:23,41252231,184,21,41252047,41252231
8418,6,12,1,2412,-54,-91,37,40:e3:d6:da:ba:24,41252484,176,77,41252308,41252484
8419,6,12,1,2412,-54,-91,37,40:e3:d6:da:ba:25,41252694,160,50,41252534,41252694
8420,6,6,1,2412,-54,-91,37,40:e3:d6:da:ba:26,41252904,380,-170,41252524,41252904
8421,4,1,1,2412,-74,-91,17,54:e4:3a:ec:fb:64,41310233,2160,55169,41308073,41310233
8422,4,1,1,2412,-54,-91,37,b8:3a:5a:88:e6:e1,41340366,2376,27757,41337990,41340366
8423,6,6,1,2412,-56,-91,35,40:e3:d6:da:ba:21,41354008,368,13274,41353640,41354008
8424,4,1,1,2412,-77,-91,14,54:e4:3a:ec:fb:64,41412625,2160,56457,41410465,41412625
8425,4,1,1,2412,-78,-91,13,b8:3a:5a:88:e6:e1,41442522,2376,27521,41440146,41442522
8426,6,6,1,2412,-54,-91,37,e6:aa:ea:c9:ea:33,41450478,408,7548,41450070,41450478
8427,6,12,1,2412,-55,-91,36,40:e3:d6:da:ba:20,41456190,160,5552,41456030,41456190
8428,6,6,1,2412,-55,-91,36,40:e3:d6:da:ba:21,41456400,368,-158,41456032,41456400
8429,6,12,1,2412,-55,-91,36,40:e3:d6:da:ba:22,41456814,180,234,41456634,41456814
8430,6,12,1,2412,-55,-91,36,40:e3:d6:da:ba:23,41457028,184,30,41456844,41457028
8431,6,12,1,2412,-55,-91,36,40:e3:d6:da:ba:24,41457247,176,43,41457071,41457247
8432,6,12,1,2412,-55,-91,36,40:e3:d6:da:ba:25,41457457,160,50,41457297,41457457
8433,6,6,1,2412,-55,-91,36,40:e3:d6:da:ba:26,41457657,380,-180,41457277,41457657
8434,6,6,1,2412,-54,-91,37,e6:aa:ea:c9:ea:33,41462602,408,4537,41462194,41462602
8435,6,6,1,2412,-54,-91,37,e6:aa:ea:c9:ea:33,41474709,408,11699,41474301,41474709
8436,6,6,1,2412,-53,-91,38,e6:aa:ea:c9:ea:33,41486818,408,11701,41486410,41486818
8437,4,1,1,2412,-84,-91,7,,41493110,304,5988,41492806,41493110
8438,6,6,1,2412,-53,-91,38,e6:aa:ea:c9:ea:33,41499144,408,5626,41498736,41499144
8439,4,1,1,2412,-73,-91,18,b8:3a:5a:88:e6:e0,41543119,2360,41615,41540759,41543119
8440,4,1,1,2412,-64,-91,27,6e:c0:cf:ec:b8:c5,41552301,1224,7958,41551077,41552301
8441,4,1,1,2412,-66,-91,25,16:57:27:84:fa:01,41553995,1240,454,41552755,41553995
8442,4,1,1,2412,-65,-91,26,a6:17:5a:c4:c1:9a,41555644,1320,329,41554324,41555644
8443,4,1,1,2412,-64,-91,27,e2:44:18:a5:89:83,41557093,1296,153,41555797,41557093
8444,4,1,1,2412,-70,-91,21,ee:74:1a:b2:5c:a6,41558518,1224,201,41557294,41558518
8445,6,12,1,2412,-55,-91,36,40:e3:d6:da:ba:20,41559602,160,924,41559442,41559602
8446,6,12,1,2412,-54,-91,37,40:e3:d6:da:ba:22,41560226,180,444,41560046,41560226
8447,6,12,1,2412,-54,-91,37,40:e3:d6:da:ba:23,41560459,184,49,41560275,41560459
8448,6,6,1,2412,-54,-91,37,40:e3:d6:da:ba:26,41561070,380,231,41560690,41561070
8449,4,1,1,2412,-70,-91,21,5e:d6:58:35:dd:45,41563532,1248,1214,41562284,41563532
8450,4,1,1,2412,-69,-91,22,2e:a4:2c:52:ac:72,41564969,1128,309,41563841,41564969
8451,4,1,1,2412,-76,-91,15,54:e4:3a:ec:fb:64,41566212,2112,-869,41564100,41566212
8452,4,1,1,2412,-70,-91,21,fe:fb:6e:30:f5:cf,41570665,1184,3269,41569481,41570665
8453,6,12,1,2412,-55,-91,36,40:e3:d6:da:ba:20,41571709,136,908,41571573,41571709
8454,6,12,1,2412,-70,-91,21,,41571862,32,121,41571830,41571862
8455,6,6,1,2412,-55,-91,36,40:e3:d6:da:ba:21,41571948,348,-262,41571600,41571948
8456,6,6,1,2412,-70,-91,21,,41572313,44,321,41572269,41572313
8457,6,12,1,2412,-55,-91,36,40:e3:d6:da:ba:22,41572389,156,-80,41572233,41572389
8458,6,12,1,2412,-68,-91,23,,41572562,32,141,41572530,41572562
8459,6,12,1,2412,-55,-91,36,40:e3:d6:da:ba:23,41572635,156,-83,41572479,41572635
8460,6,12,1,2412,-69,-91,22,,41572807,32,140,41572775,41572807
8461,6,12,1,2412,-55,-91,36,40:e3:d6:da:ba:25,41572879,136,-64,41572743,41572879
8462,6,12,1,2412,-72,-91,19,,41573031,32,120,41572999,41573031
8463,4,1,1,2412,-69,-91,22,ee:d0:42:2a:30:7e,41573791,1232,-472,41572559,41573791
8464,4,1,1,2412,-66,-91,25,ca:76:3d:bd:3d:ea,41575372,1280,301,41574092,41575372
8465,4,1,1,2412,-76,-91,15,54:e4:3a:ec:fb:64,41577171,2112,-313,41575059,41577171
8466,4,1,1,2412,-77,-91,14,54:e4:3a:ec:fb:64,41579681,2112,398,41577569,41579681
8467,4,1,1,2412,-70,-91,21,,41581806,304,1821,41581502,41581806
8468,4,1,1,2412,-77,-91,14,12:67:62:0d:1b:71,41606934,1152,23976,41605782,41606934
8469,4,1,1,2412,-71,-91,20,6e:c0:cf:ec:b8:c5,41608978,1224,820,41607754,41608978
8470,4,1,1,2412,-71,-91,20,16:57:27:84:fa:01,41610551,1240,333,41609311,41610551
8471,4,1,1,2412,-71,-91,20,a6:17:5a:c4:c1:9a,41612240,1320,369,41610920,41612240
8472,4,1,1,2412,-49,-91,42,e2:44:18:a5:89:83,41614411,1296,875,41613115,41614411
8473,4,1,1,2412,-70,-91,21,ee:74:1a:b2:5c:a6,41616077,1224,442,41614853,41616077
8474,4,1,1,2412,-70,-91,21,5e:d6:58:35:dd:45,41619856,1248,2531,41618608,41619856
8475,4,1,1,2412,-71,-91,20,2e:a4:2c:52:ac:72,41621173,1128,189,41620045,41621173
8476,6,12,1,2412,-57,-91,34,40:e3:d6:da:ba:20,41622264,136,955,41622128,41622264
8477,6,6,1,2412,-57,-91,34,40:e3:d6:da:ba:21,41622441,348,-171,41622093,41622441
8478,6,6,1,2412,-72,-91,19,,41622805,44,320,41622761,41622805
8479,6,12,1,2412,-57,-91,34,40:e3:d6:da:ba:22,41622859,156,-102,41622703,41622859
8480,6,12,1,2412,-57,-91,34,40:e3:d6:da:ba:23,41623085,156,70,41622929,41623085
8481,4,1,1,2412,-70,-91,21,fe:fb:6e:30:f5:cf,41624160,1184,-109,41622976,41624160
8482,4,1,1,2412,-70,-91,21,ee:d0:42:2a:30:7e,41625908,1232,516,41624676,41625908
8483,4,1,1,2412,-69,-91,22,ca:76:3d:bd:3d:ea,41628975,1280,1787,41627695,41628975
8484,4,1,1,2412,-73,-91,18,b8:3a:5a:88:e6:e0,41645166,2360,13831,41642806,41645166
8485,6,6,1,2412,-58,-91,33,40:e3:d6:da:ba:21,41661206,368,15672,41660838,41661206
8486,6,12,1,2412,-58,-91,33,40:e3:d6:da:ba:22,41661620,180,234,41661440,41661620
8487,6,12,1,2412,-58,-91,33,40:e3:d6:da:ba:23,41661843,184,39,41661659,41661843
8488,6,12,1,2412,-58,-91,33,40:e3:d6:da:ba:24,41662053,176,34,41661877,41662053
8489,6,12,1,2412,-58,-91,33,40:e3:d6:da:ba:25,41662272,160,59,41662112,41662272
8490,6,6,1,2412,-58,-91,33,40:e3:d6:da:ba:26,41662473,380,-179,41662093,41662473
8491,6,6,1,2412,-71,-91,20,e6:aa:ea:b7:4a:dd,41667625,408,4744,41667217,41667625
8492,6,6,1,2412,-71,-91,20,e6:aa:ea:b7:4a:dd,41679747,408,11714,41679339,41679747
8493,6,6,1,2412,-70,-91,21,e6:aa:ea:b7:4a:dd,41691874,408,11719,41691466,41691874
8494,6,12,1,2412,-86,-91,5,40:e3:d6:da:bb:e0,41760073,156,68043,41759917,41760073
8495,6,12,1,2412,-57,-91,34,40:e3:d6:da:ba:20,41763397,160,3164,41763237,41763397
8496,6,6,1,2412,-57,-91,34,40:e3:d6:da:ba:21,41763598,368,-167,41763230,41763598
8497,6,12,1,2412,-57,-91,34,40:e3:d6:da:ba:22,41763994,180,216,41763814,41763994
8498,6,12,1,2412,-57,-91,34,40:e3:d6:da:ba:23,41764208,184,30,41764024,41764208
8499,6,12,1,2412,-57,-91,34,40:e3:d6:da:ba:24,41764418,176,34,41764242,41764418
8500,6,12,1,2412,-57,-91,34,40:e3:d6:da:ba:25,41764619,160,41,41764459,41764619
8501,6,6,1,2412,-57,-91,34,40:e3:d6:da:ba:26,41764820,380,-179,41764440,41764820
8502,6,12,1,2412,-82,-91,9,84:d4:7e:f2:42:24,41765241,176,245,41765065,41765241
8503,6,12,1,2412,-83,-91,8,84:d4:7e:f2:42:25,41765451,160,50,41765291,41765451
8504,6,6,1,2412,-83,-91,8,84:d4:7e:f2:42:26,41765643,380,-188,41765263,41765643
8505,6,6,1,2412,-87,-91,4,a8:5b:f7:55:1a:40,41781906,72,16191,41781834,41781906
8506,6,6,1,2412,-85,-91,6,a8:5b:f7:55:1a:40,41784058,72,2080,41783986,41784058
8507,6,6,1,2412,-90,-91,1,a8:5b:f7:55:1a:40,41785973,72,1843,41785901,41785973
8508,4,1,1,2412,-75,-91,16,b8:3a:5a:88:e6:e0,41849722,2360,61389,41847362,41849722
8509,6,12,1,2412,-88,-91,3,40:e3:d6:da:bb:e0,41862484,156,12606,41862328,41862484
8510,6,12,1,2412,-88,-91,3,40:e3:d6:da:bb:e5,41863771,156,1131,41863615,41863771
8511,6,6,1,2412,-86,-91,5,40:e3:d6:da:bb:e6,41863968,380,-183,41863588,41863968
8512,6,12,1,2412,-58,-91,33,40:e3:d6:da:ba:20,41865802,160,1674,41865642,41865802
8513,6,6,1,2412,-57,-91,34,40:e3:d6:da:ba:21,41865994,368,-176,41865626,41865994
8514,6,12,1,2412,-57,-91,34,40:e3:d6:da:ba:22,41866381,180,207,41866201,41866381
8515,6,12,1,2412,-57,-91,34,40:e3:d6:da:ba:23,41866586,184,21,41866402,41866586
8516,6,12,1,2412,-57,-91,34,40:e3:d6:da:ba:24,41866805,176,43,41866629,41866805
8517,6,12,1,2412,-57,-91,34,40:e3:d6:da:ba:25,41867015,160,50,41866855,41867015
8518,6,6,1,2412,-57,-91,34,40:e3:d6:da:ba:26,41867225,380,-170,41866845,41867225
8519,6,6,1,2412,-52,-91,39,e6:aa:ea:c9:ea:33,41868802,408,1169,41868394,41868802
8520,6,6,1,2412,-53,-91,38,e6:aa:ea:c9:ea:33,41880930,408,11720,41880522,41880930
8521,6,6,1,2412,-55,-91,36,e6:aa:ea:c9:ea:33,41905163,408,23825,41904755,41905163
8522,4,1,1,2412,-70,-91,21,a6:e5:7c:28:b1:d3,41912067,992,5912,41911075,41912067
8523,6,6,1,2412,-55,-91,36,e6:aa:ea:c9:ea:33,41917280,408,4805,41916872,41917280
8524,4,1,1,2412,-76,-91,15,54:e4:3a:ec:fb:64,41924658,2160,5218,41922498,41924658
8525,6,6,1,2412,-75,-91,16,84:1b:5e:df:1b:99,41935801,80,11063,41935721,41935801
8526,6,12,1,2412,-57,-91,34,40:e3:d6:da:ba:20,41968192,160,32231,41968032,41968192
8527,6,6,1,2412,-57,-91,34,40:e3:d6:da:ba:21,41968393,368,-167,41968025,41968393
8528,6,12,1,2412,-56,-91,35,40:e3:d6:da:ba:22,41968788,180,215,41968608,41968788
8529,6,12,1,2412,-57,-91,34,40:e3:d6:da:ba:23,41968994,184,22,41968810,41968994
8530,6,12,1,2412,-56,-91,35,40:e3:d6:da:ba:25,41969459,160,305,41969299,41969459
8531,6,6,1,2412,-57,-91,34,40:e3:d6:da:ba:26,41969678,380,-161,41969298,41969678
8532,6,12,1,2412,-56,-91,35,40:e3:d6:da:ba:20,42070597,160,100759,42070437,42070597
8533,6,12,1,2412,-56,-91,35,40:e3:d6:da:ba:22,42071185,180,408,42071005,42071185
8534,6,12,1,2412,-56,-91,35,40:e3:d6:da:ba:23,42071390,184,21,42071206,42071390
8535,6,12,1,2412,-56,-91,35,40:e3:d6:da:ba:24,42071600,176,34,42071424,42071600
8536,6,12,1,2412,-56,-91,35,40:e3:d6:da:ba:25,42071819,160,59,42071659,42071819
8537,4,1,1,2412,-78,-91,13,54:e4:3a:ec:fb:64,42129455,2160,55476,42127295,42129455
8538,4,1,1,2412,-75,-91,16,b8:3a:5a:88:e6:e1,42150448,2256,18737,42148192,42150448
8539,4,1,1,2412,-73,-91,18,b8:3a:5a:88:e6:e0,42156914,2360,4106,42154554,42156914
8540,4,1,1,2412,-74,-91,17,b8:3a:5a:88:e6:e1,42159294,2376,4,42156918,42159294
8541,4,1,1,2412,-75,-91,16,b8:3a:5a:88:e6:e0,42168688,2240,7154,42166448,42168688
8542,4,1,1,2412,-72,-91,19,b8:3a:5a:88:e6:e1,42172006,2256,1062,42169750,42172006
8543,6,12,1,2412,-58,-91,33,40:e3:d6:da:ba:20,42174122,160,1956,42173962,42174122
8544,6,6,1,2412,-57,-91,34,40:e3:d6:da:ba:21,42174332,368,-158,42173964,42174332
8545,6,12,1,2412,-57,-91,34,40:e3:d6:da:ba:24,42175188,176,680,42175012,42175188
8546,6,12,1,2412,-57,-91,34,40:e3:d6:da:ba:25,42175389,160,41,42175229,42175389
8547,6,6,1,2412,-57,-91,34,40:e3:d6:da:ba:26,42175615,380,-154,42175235,42175615
8548,6,6,1,2412,-77,-91,14,e6:aa:ea:b7:4a:dd,42177286,408,1263,42176878,42177286
8549,4,1,1,2412,-74,-91,17,b8:3a:5a:88:e6:e0,42179536,2240,10,42177296,42179536
8550,4,1,1,2412,-74,-91,17,b8:3a:5a:88:e6:e1,42182952,2256,1160,42180696,42182952
8551,4,1,1,2412,-75,-91,16,54:e4:3a:ec:fb:64,42185770,2112,706,42183658,42185770
8552,4,1,1,2412,-74,-91,17,54:e4:3a:ec:fb:64,42204980,2112,17098,42202868,42204980
8553,6,6,1,2412,-78,-91,13,e6:aa:ea:b7:4a:dd,42211938,408,6550,42211530,42211938
8554,6,12,1,2412,-85,-91,6,,42271871,32,59901,42271839,42271871
8555,6,12,1,2412,-86,-91,5,,42274056,32,2153,42274024,42274056
8556,6,12,1,2412,-58,-91,33,40:e3:d6:da:ba:20,42275405,160,1189,42275245,42275405
8557,6,12,1,2412,-57,-91,34,40:e3:d6:da:ba:23,42276226,184,637,42276042,42276226
8558,6,12,1,2412,-58,-91,33,40:e3:d6:da:ba:24,42276452,176,50,42276276,42276452
8559,6,12,1,2412,-58,-91,33,40:e3:d6:da:ba:25,42276672,160,60,42276512,42276672
8560,6,6,1,2412,-58,-91,33,40:e3:d6:da:ba:26,42276891,380,-161,42276511,42276891
8561,6,12,1,2412,-90,-91,1,40:e3:d6:da:ca:c5,42291378,156,14331,42291222,42291378
8562,4,1,1,2412,-74,-91,17,a6:e5:7c:28:b1:d3,42327868,992,35498,42326876,42327868
8563,4,1,1,2412,-74,-91,17,54:e4:3a:ec:fb:64,42334218,2160,4190,42332058,42334218
8564,4,1,1,2412,-64,-91,27,24:f6:77:10:02:c8,42345968,704,11046,42345264,42345968
8565,6,12,1,2412,-58,-91,33,40:e3:d6:da:ba:23,42347318,156,1194,42347162,42347318
8566,6,12,1,2412,-59,-91,32,40:e3:d6:da:ba:23,42368830,156,21356,42368674,42368830
8567,6,12,1,2412,-82,-91,9,,42376585,32,7723,42376553,42376585
8568,6,12,1,2412,-83,-91,8,,42376837,32,220,42376805,42376837
8569,6,12,1,2412,-82,-91,9,,42377060,32,191,42377028,42377060
8570,6,12,1,2412,-59,-91,32,40:e3:d6:da:ba:20,42377795,160,575,42377635,42377795
8571,6,6,1,2412,-58,-91,33,40:e3:d6:da:ba:21,42378014,368,-149,42377646,42378014
8572,6,12,1,2412,-58,-91,33,40:e3:d6:da:ba:22,42378428,180,234,42378248,42378428
8573,6,12,1,2412,-58,-91,33,40:e3:d6:da:ba:23,42378642,184,30,42378458,42378642
8574,6,12,1,2412,-58,-91,33,40:e3:d6:da:ba:24,42378852,176,34,42378676,42378852
8575,6,12,1,2412,-58,-91,33,40:e3:d6:da:ba:25,42379062,160,50,42378902,42379062
8576,4,1,1,2412,-67,-91,24,24:f6:77:10:02:c8,42387434,704,7668,42386730,42387434
8577,4,1,1,2412,-66,-91,25,24:f6:77:10:02:c8,42388149,664,51,42387485,42388149
8578,6,12,1,2412,-59,-91,32,40:e3:d6:da:ba:23,42388778,156,473,42388622,42388778
8579,6,6,1,2412,-58,-91,33,e6:aa:ea:c9:ea:33,42390285,408,1099,42389877,42390285
8580,6,6,1,2412,-57,-91,34,e6:aa:ea:c9:ea:33,42401014,408,10321,42400606,42401014
8581,6,6,1,2412,-57,-91,34,e6:aa:ea:c9:ea:33,42413119,408,11697,42412711,42413119
8582,6,6,1,2412,-58,-91,33,e6:aa:ea:c9:ea:33,42425229,408,11702,42424821,42425229
8583,6,6,1,2412,-77,-91,14,e6:aa:ea:b7:4a:dd,42478601,408,52964,42478193,42478601
8584,6,12,1,2412,-60,-91,31,40:e3:d6:da:ba:20,42480203,160,1442,42480043,42480203
8585,6,6,1,2412,-60,-91,31,40:e3:d6:da:ba:21,42480404,368,-167,42480036,42480404
8586,6,12,1,2412,-60,-91,31,40:e3:d6:da:ba:22,42480800,180,216,42480620,42480800
8587,6,12,1,2412,-60,-91,31,40:e3:d6:da:ba:23,42481032,184,48,42480848,42481032
8588,6,12,1,2412,-60,-91,31,40:e3:d6:da:ba:24,42481251,176,43,42481075,42481251
8589,6,12,1,2412,-60,-91,31,40:e3:d6:da:ba:25,42481470,160,59,42481310,42481470
8590,6,6,1,2412,-60,-91,31,40:e3:d6:da:ba:26,42481671,380,-179,42481291,42481671
8591,6,6,1,2412,-88,-91,3,e6:aa:ea:c9:ea:1b,42524233,408,42154,42523825,42524233
8592,6,6,1,2412,-77,-91,14,e6:aa:ea:b7:4a:dd,42527075,408,2434,42526667,42527075
8593,4,1,1,2412,-75,-91,16,b8:3a:5a:88:e6:e0,42566516,2360,37081,42564156,42566516
8594,6,12,1,2412,-57,-91,34,40:e3:d6:da:ba:20,42582608,160,15932,42582448,42582608
8595,6,6,1,2412,-57,-91,34,40:e3:d6:da:ba:21,42582809,368,-167,42582441,42582809
8596,6,12,1,2412,-57,-91,34,40:e3:d6:da:ba:22,42583214,180,225,42583034,42583214
8597,6,12,1,2412,-57,-91,34,40:e3:d6:da:ba:23,42583438,184,40,42583254,42583438
8598,6,12,1,2412,-57,-91,34,40:e3:d6:da:ba:24,42583665,176,51,42583489,42583665
8599,6,12,1,2412,-57,-91,34,40:e3:d6:da:ba:25,42583893,160,68,42583733,42583893
8600,6,6,1,2412,-57,-91,34,40:e3:d6:da:ba:26,42584103,380,-170,42583723,42584103
8601,4,1,1,2412,-85,-91,6,,42635817,304,51410,42635513,42635817
8602,4,1,1,2412,-73,-91,18,54:e4:3a:ec:fb:64,42641346,2160,3369,42639186,42641346
8603,6,6,1,2412,-70,-91,21,,42660418,44,19028,42660374,42660418
8604,6,12,1,2412,-70,-91,21,,42660911,32,461,42660879,42660911
8605,6,12,1,2412,-70,-91,21,,42661154,32,211,42661122,42661154
8606,6,12,1,2412,-70,-91,21,,42661631,32,445,42661599,42661631
8607,6,12,1,2412,-70,-91,21,,42661978,32,315,42661946,42661978
8608,4,1,1,2412,-77,-91,14,c0:c9:e3:4d:6e:bf,42679845,872,16995,42678973,42679845
8609,4,1,1,2412,-86,-91,5,,42680734,304,585,42680430,42680734
8610,6,12,1,2412,-55,-91,36,40:e3:d6:da:ba:20,42684996,160,4102,42684836,42684996
8611,6,6,1,2412,-55,-91,36,40:e3:d6:da:ba:21,42685206,368,-158,42684838,42685206
8612,6,12,1,2412,-55,-91,36,40:e3:d6:da:ba:22,42685593,180,207,42685413,42685593
8613,6,12,1,2412,-55,-91,36,40:e3:d6:da:ba:23,42685807,184,30,42685623,42685807
8614,6,12,1,2412,-55,-91,36,40:e3:d6:da:ba:24,42686025,176,42,42685849,42686025
8615,6,12,1,2412,-55,-91,36,40:e3:d6:da:ba:25,42686227,160,42,42686067,42686227
8616,6,6,1,2412,-55,-91,36,40:e3:d6:da:ba:26,42686437,380,-170,42686057,42686437
8617,6,6,1,2412,-84,-91,7,,42694549,44,8068,42694505,42694549
8618,4,1,1,2412,-71,-91,20,,42711786,304,16933,42711482,42711786
8619,4,1,1,2412,-76,-91,15,b8:3a:5a:88:e6:e0,42771331,2360,57185,42768971,42771331
8620,6,12,1,2412,-55,-91,36,40:e3:d6:da:ba:20,42787408,160,15917,42787248,42787408
8621,6,6,1,2412,-55,-91,36,40:e3:d6:da:ba:21,42787600,368,-176,42787232,42787600
8622,6,12,1,2412,-55,-91,36,40:e3:d6:da:ba:22,42787996,180,216,42787816,42787996
8623,6,12,1,2412,-54,-91,37,40:e3:d6:da:ba:23,42788220,184,40,42788036,42788220
8624,6,12,1,2412,-55,-91,36,40:e3:d6:da:ba:24,42788447,176,51,42788271,42788447
8625,6,12,1,2412,-55,-91,36,40:e3:d6:da:ba:25,42788648,160,41,42788488,42788648
8626,6,6,1,2412,-54,-91,37,40:e3:d6:da:ba:26,42788849,380,-179,42788469,42788849
8627,6,6,1,2412,-57,-91,34,e6:aa:ea:c9:ea:33,42807008,408,17751,42806600,42807008
8628,6,6,1,2412,-57,-91,34,e6:aa:ea:c9:ea:33,42819130,408,11714,42818722,42819130
8629,4,1,1,2412,-81,-91,10,,42828609,304,9175,42828305,42828609
8630,6,6,1,2412,-57,-91,34,e6:aa:ea:c9:ea:33,42831246,408,2229,42830838,42831246
8631,4,1,1,2412,-76,-91,15,a6:e5:7c:28:b1:d3,42833113,992,875,42832121,42833113
8632,4,1,1,2412,-53,-91,38,54:e4:3a:ec:fb:64,42839695,2160,4422,42837535,42839695
8633,6,6,1,2412,-57,-91,34,e6:aa:ea:c9:ea:33,42843362,408,3259,42842954,42843362
8634,6,6,1,2412,-57,-91,34,e6:aa:ea:c9:ea:33,42855490,408,11720,42855082,42855490
8635,4,1,1,2412,-76,-91,15,b8:3a:5a:88:e6:e0,42877254,2360,19404,42874894,42877254
8636,6,12,1,2412,-55,-91,36,40:e3:d6:da:ba:20,42889799,160,12385,42889639,42889799
8637,6,6,1,2412,-55,-91,36,40:e3:d6:da:ba:21,42890018,368,-149,42889650,42890018
8638,6,12,1,2412,-55,-91,36,40:e3:d6:da:ba:22,42890432,180,234,42890252,42890432
8639,6,12,1,2412,-55,-91,36,40:e3:d6:da:ba:23,42890665,184,49,42890481,42890665
8640,6,12,1,2412,-55,-91,36,40:e3:d6:da:ba:24,42890874,176,33,42890698,42890874
8641,6,12,1,2412,-55,-91,36,40:e3:d6:da:ba:25,42891094,160,60,42890934,42891094
8642,6,6,1,2412,-55,-91,36,40:e3:d6:da:ba:26,42891313,380,-161,42890933,42891313
8643,4,1,1,2412,-84,-91,7,,42920023,304,28406,42919719,42920023
8644,4,1,1,2412,-75,-91,16,54:e4:3a:ec:fb:64,42948646,2160,26463,42946486,42948646
8645,6,12,1,2412,-57,-91,34,40:e3:d6:da:ba:20,42992196,160,43390,42992036,42992196
8646,6,6,1,2412,-56,-91,35,40:e3:d6:da:ba:21,42992406,368,-158,42992038,42992406
8647,6,12,1,2412,-56,-91,35,40:e3:d6:da:ba:22,42992802,180,216,42992622,42992802
8648,6,12,1,2412,-56,-91,35,40:e3:d6:da:ba:23,42993035,184,49,42992851,42993035
8649,6,12,1,2412,-57,-91,34,40:e3:d6:da:ba:25,42993473,160,278,42993313,42993473
8650,6,6,1,2412,-56,-91,35,40:e3:d6:da:ba:26,42993674,380,-179,42993294,42993674
8651,6,6,1,2412,-85,-91,6,40:e3:d6:da:bb:e1,43049754,348,55732,43049406,43049754
8652,6,12,1,2412,-84,-91,7,40:e3:d6:da:bb:e2,43050210,156,300,43050054,43050210
8653,6,12,1,2412,-85,-91,6,40:e3:d6:da:bb:e3,43050459,156,93,43050303,43050459
8654,4,1,1,2412,-72,-91,19,54:e4:3a:ec:fb:64,43051011,2160,-1608,43048851,43051011
8655,4,1,1,2412,-77,-91,14,b8:3a:5a:88:e6:e1,43080923,2376,27536,43078547,43080923
8656,6,12,1,2412,-58,-91,33,40:e3:d6:da:ba:20,43094597,160,13514,43094437,43094597
8657,6,6,1,2412,-58,-91,33,40:e3:d6:da:ba:21,43094789,368,-176,43094421,43094789
8658,6,12,1,2412,-58,-91,33,40:e3:d6:da:ba:22,43095176,180,207,43094996,43095176
8659,6,12,1,2412,-58,-91,33,40:e3:d6:da:ba:23,43095409,184,49,43095225,43095409
8660,6,12,1,2412,-58,-91,33,40:e3:d6:da:ba:24,43095627,176,42,43095451,43095627
8661,6,12,1,2412,-58,-91,33,40:e3:d6:da:ba:25,43095838,160,51,43095678,43095838
8662,6,6,1,2412,-58,-91,33,40:e3:d6:da:ba:26,43096057,380,-161,43095677,43096057
8663,4,1,1,2412,-80,-91,11,,43147600,304,51239,43147296,43147600
8664,4,1,1,2412,-71,-91,20,54:e4:3a:ec:fb:64,43153386,2160,3626,43151226,43153386
8665,4,1,1,2412,-72,-91,19,a6:e5:7c:28:b1:d3,43164992,944,10662,43164048,43164992
8666,4,1,1,2412,-71,-91,20,a6:e5:7c:28:b1:d3,43166267,944,331,43165323,43166267
8667,4,1,1,2412,-71,-91,20,a6:e5:7c:28:b1:d3,43167381,944,170,43166437,43167381
8668,4,1,1,2412,-68,-91,23,a6:e5:7c:28:b1:d3,43168441,944,116,43167497,43168441
8669,4,1,1,2412,-73,-91,18,a6:e5:7c:28:b1:d3,43169528,944,143,43168584,43169528
8670,4,1,1,2412,-71,-91,20,a6:e5:7c:28:b1:d3,43170579,944,107,43169635,43170579
8671,4,1,1,2412,-71,-91,20,a6:e5:7c:28:b1:d3,43174225,944,2702,43173281,43174225
8672,4,1,1,2412,-70,-91,21,,43176085,304,1556,43175781,43176085
8673,4,1,1,2412,-71,-91,20,a6:e5:7c:28:b1:d3,43177519,944,490,43176575,43177519
8674,4,1,1,2412,-71,-91,20,a6:e5:7c:28:b1:d3,43178588,944,125,43177644,43178588
8675,4,1,1,2412,-64,-91,27,a6:e5:7c:28:b1:d3,43179639,944,107,43178695,43179639
8676,4,1,1,2412,-75,-91,16,b8:3a:5a:88:e6:e0,43180916,2360,-1083,43178556,43180916
8677,6,12,1,2412,-57,-91,34,40:e3:d6:da:ba:20,43197003,160,15927,43196843,43197003
8678,6,6,1,2412,-56,-91,35,40:e3:d6:da:ba:21,43197213,368,-158,43196845,43197213
8679,6,12,1,2412,-56,-91,35,40:e3:d6:da:ba:22,43197627,180,234,43197447,43197627
8680,6,12,1,2412,-56,-91,35,40:e3:d6:da:ba:23,43197842,184,31,43197658,43197842
8681,6,12,1,2412,-56,-91,35,40:e3:d6:da:ba:24,43198060,176,42,43197884,43198060
8682,6,6,1,2412,-56,-91,35,40:e3:d6:da:ba:26,43198499,380,59,43198119,43198499
8683,4,1,1,2412,-73,-91,18,be:fe:70:e6:2d:11,43232782,1240,33043,43231542,43232782
8684,4,1,1,2412,-72,-91,19,3e:6c:6c:7a:82:39,43239663,1128,5753,43238535,43239663
8685,4,1,1,2412,-72,-91,19,02:aa:35:95:d2:0c,43250857,1224,9970,43249633,43250857
8686,4,1,1,2412,-72,-91,19,66:64:c1:78:98:46,43255544,1224,3463,43254320,43255544
8687,4,1,1,2412,-71,-91,20,54:e4:3a:ec:fb:64,43257443,2160,-261,43255283,43257443
8688,4,1,1,2412,-45,-91,46,3e:6c:6c:7a:82:39,43260896,1128,2325,43259768,43260896
8689,6,12,1,2412,-56,-91,35,40:e3:d6:da:ba:20,43261991,136,959,43261855,43261991
8690,6,6,1,2412,-56,-91,35,40:e3:d6:da:ba:21,43262195,348,-144,43261847,43262195
8691,6,12,1,2412,-56,-91,35,40:e3:d6:da:ba:22,43262598,156,247,43262442,43262598
8692,6,12,1,2412,-56,-91,35,40:e3:d6:da:ba:23,43262806,156,52,43262650,43262806
8693,6,12,1,2412,-56,-91,35,40:e3:d6:da:ba:25,43262997,136,55,43262861,43262997
8694,4,1,1,2412,-78,-91,13,,43293658,304,30357,43293354,43293658
8695,4,1,1,2412,-79,-91,12,,43295149,304,1187,43294845,43295149
8696,6,12,1,2412,-56,-91,35,40:e3:d6:da:ba:20,43299424,160,4115,43299264,43299424
8697,6,6,1,2412,-56,-91,35,40:e3:d6:da:ba:21,43299643,368,-149,43299275,43299643
8698,6,12,1,2412,-56,-91,35,40:e3:d6:da:ba:22,43300030,180,207,43299850,43300030
8699,6,12,1,2412,-56,-91,35,40:e3:d6:da:ba:23,43300244,184,30,43300060,43300244
8700,6,12,1,2412,-56,-91,35,40:e3:d6:da:ba:24,43302756,176,2336,43302580,43302756
8701,6,12,1,2412,-56,-91,35,40:e3:d6:da:ba:25,43302958,160,42,43302798,43302958
8702,6,6,1,2412,-87,-91,4,a8:5b:f7:55:1a:40,43317921,72,14891,43317849,43317921
8703,6,6,1,2412,-87,-91,4,a8:5b:f7:55:1a:40,43318028,72,35,43317956,43318028
8704,6,6,1,2412,-86,-91,5,a8:5b:f7:55:1a:40,43318360,72,260,43318288,43318360
8705,6,6,1,2412,-87,-91,4,a8:5b:f7:55:1a:40,43318692,72,260,43318620,43318692
8706,6,6,1,2412,-86,-91,5,a8:5b:f7:55:1a:40,43318799,72,35,43318727,43318799
8707,6,6,1,2412,-87,-91,4,a8:5b:f7:55:1a:40,43319311,72,440,43319239,43319311
8708,6,6,1,2412,-87,-91,4,a8:5b:f7:55:1a:40,43319419,72,36,43319347,43319419
8709,6,6,1,2412,-84,-91,7,a8:5b:f7:55:1a:40,43319554,72,63,43319482,43319554
8710,6,6,1,2412,-86,-91,5,a8:5b:f7:55:1a:40,43319750,72,124,43319678,43319750
8711,6,6,1,2412,-85,-91,6,a8:5b:f7:55:1a:40,43319858,72,36,43319786,43319858
8712,6,6,1,2412,-86,-91,5,a8:5b:f7:55:1a:40,43320092,72,162,43320020,43320092
8713,6,6,1,2412,-87,-91,4,a8:5b:f7:55:1a:40,43320328,72,164,43320256,43320328
8714,6,6,1,2412,-54,-91,37,e6:aa:ea:c9:ea:33,43327644,408,6908,43327236,43327644
8715,6,6,1,2412,-54,-91,37,e6:aa:ea:c9:ea:33,43339463,408,11411,43339055,43339463
8716,6,6,1,2412,-53,-91,38,e6:aa:ea:c9:ea:33,43351579,408,11708,43351171,43351579
8717,4,1,1,2412,-73,-91,18,54:e4:3a:ec:fb:64,43358292,2160,4553,43356132,43358292
8718,4,1,1,2412,-80,-91,11,,43361421,304,2825,43361117,43361421
8719,6,6,1,2412,-54,-91,37,e6:aa:ea:c9:ea:33,43363687,408,1858,43363279,43363687
8720,6,6,1,2412,-54,-91,37,e6:aa:ea:c9:ea:33,43375812,408,11717,43375404,43375812
8721,4,1,1,2412,-80,-91,11,,43380445,304,4329,43380141,43380445
8722,6,12,1,2412,-83,-91,8,84:d4:7e:f2:42:23,43381570,160,965,43381410,43381570
8723,4,1,1,2412,-79,-91,12,b8:3a:5a:88:e6:e0,43385771,2360,1841,43383411,43385771
8724,4,1,1,2412,-79,-91,12,b8:3a:5a:88:e6:e1,43388150,2376,3,43385774,43388150
8725,6,12,1,2412,-57,-91,34,40:e3:d6:da:ba:20,43401798,160,13488,43401638,43401798
8726,6,6,1,2412,-57,-91,34,40:e3:d6:da:ba:21,43402017,368,-149,43401649,43402017
8727,6,12,1,2412,-57,-91,34,40:e3:d6:da:ba:22,43402413,180,216,43402233,43402413
8728,6,12,1,2412,-57,-91,34,40:e3:d6:da:ba:23,43402618,184,21,43402434,43402618
8729,6,12,1,2412,-57,-91,34,40:e3:d6:da:ba:24,43402854,176,60,43402678,43402854
8730,6,12,1,2412,-57,-91,34,40:e3:d6:da:ba:25,43403065,160,51,43402905,43403065
8731,6,6,1,2412,-57,-91,34,40:e3:d6:da:ba:26,43403257,380,-188,43402877,43403257
8732,6,12,1,2412,-85,-91,6,84:d4:7e:f2:42:25,43403840,160,423,43403680,43403840
8733,6,6,1,2412,-76,-91,15,e6:aa:ea:b7:4a:dd,43417548,408,13300,43417140,43417548
8734,6,6,1,2412,-76,-91,15,e6:aa:ea:b7:4a:dd,43429669,408,11713,43429261,43429669
8735,6,6,1,2412,-76,-91,15,e6:aa:ea:b7:4a:dd,43441791,408,11714,43441383,43441791
8736,6,12,1,2412,-58,-91,33,40:e3:d6:da:ba:20,43504219,160,62268,43504059,43504219
8737,6,6,1,2412,-58,-91,33,40:e3:d6:da:ba:21,43504412,368,-175,43504044,43504412
8738,6,12,1,2412,-58,-91,33,40:e3:d6:da:ba:22,43504825,180,233,43504645,43504825
8739,6,12,1,2412,-58,-91,33,40:e3:d6:da:ba:23,43505058,184,49,43504874,43505058
8740,6,6,1,2412,-58,-91,33,40:e3:d6:da:ba:26,43505723,380,285,43505343,43505723
8741,4,1,1,2412,-70,-91,21,a6:e5:7c:28:b1:d3,43549982,992,43267,43548990,43549982
8742,4,1,1,2412,-78,-91,13,54:e4:3a:ec:fb:64,43563022,2160,10880,43560862,43563022
8743,4,1,1,2412,-79,-91,12,b8:3a:5a:88:e6:e0,43590518,2360,25136,43588158,43590518
8744,6,6,1,2412,-58,-91,33,40:e3:d6:da:ba:21,43606813,368,15927,43606445,43606813
8745,6,12,1,2412,-58,-91,33,40:e3:d6:da:ba:22,43607227,180,234,43607047,43607227
8746,6,12,1,2412,-58,-91,33,40:e3:d6:da:ba:23,43607451,184,40,43607267,43607451
8747,6,12,1,2412,-58,-91,33,40:e3:d6:da:ba:24,43607687,176,60,43607511,43607687
8748,6,12,1,2412,-58,-91,33,40:e3:d6:da:ba:25,43607888,160,41,43607728,43607888
8749,6,6,1,2412,-58,-91,33,40:e3:d6:da:ba:26,43608080,380,-188,43607700,43608080
8750,6,12,1,2412,-85,-91,6,84:d4:7e:f2:42:25,43608608,160,368,43608448,43608608
8751,6,6,1,2412,-80,-91,11,84:d4:7e:f2:42:26,43608818,380,-170,43608438,43608818
8752,4,1,1,2412,-71,-91,20,be:00:2b:6b:b0:e2,43615958,1128,6012,43614830,43615958
8753,6,12,1,2412,-58,-91,33,40:e3:d6:da:ba:20,43617059,136,965,43616923,43617059
8754,6,12,1,2412,-71,-91,20,,43617211,32,120,43617179,43617211
8755,6,6,1,2412,-58,-91,33,40:e3:d6:da:ba:21,43617300,348,-259,43616952,43617300
8756,6,6,1,2412,-71,-91,20,,43617664,44,320,43617620,43617664
8757,6,12,1,2412,-58,-91,33,40:e3:d6:da:ba:22,43617732,156,-88,43617576,43617732
8758,6,12,1,2412,-72,-91,19,,43617904,32,140,43617872,43617904
8759,6,12,1,2412,-58,-91,33,40:e3:d6:da:ba:23,43617987,156,-73,43617831,43617987
8760,6,12,1,2412,-71,-91,20,,43618159,32,140,43618127,43618159
8761,6,12,1,2412,-72,-91,19,,43618394,32,203,43618362,43618394
8762,4,1,1,2412,-70,-91,21,be:00:2b:6b:b0:e2,43636184,1128,16662,43635056,43636184
8763,6,12,1,2412,-71,-91,20,,43642218,32,6002,43642186,43642218
8764,6,6,1,2412,-58,-91,33,40:e3:d6:da:ba:21,43642289,348,-277,43641941,43642289
8765,6,6,1,2412,-71,-91,20,,43642653,44,320,43642609,43642653
8766,6,6,1,2412,-58,-91,33,e6:aa:ea:c9:ea:33,43642732,408,-329,43642324,43642732
8767,6,12,1,2412,-58,-91,33,40:e3:d6:da:ba:22,43643177,156,289,43643021,43643177
8768,6,12,1,2412,-71,-91,20,,43643350,32,141,43643318,43643350
8769,6,12,1,2412,-58,-91,33,40:e3:d6:da:ba:23,43643405,156,-101,43643249,43643405
8770,6,12,1,2412,-71,-91,20,,43643577,32,140,43643545,43643577
8771,6,12,1,2412,-58,-91,33,40:e3:d6:da:ba:25,43643633,136,-80,43643497,43643633
8772,6,12,1,2412,-71,-91,20,,43643785,32,120,43643753,43643785
8773,4,1,1,2412,-71,-91,20,a6:e5:7c:28:b1:d3,43652143,992,7366,43651151,43652143
8774,6,6,1,2412,-58,-91,33,e6:aa:ea:c9:ea:33,43654497,408,1946,43654089,43654497
8775,4,1,1,2412,-76,-91,15,,43666142,304,11341,43665838,43666142
8776,6,6,1,2412,-58,-91,33,e6:aa:ea:c9:ea:33,43690783,408,24233,43690375,43690783
8777,4,1,1,2412,-78,-91,13,b8:3a:5a:88:e6:e0,43692917,2360,-226,43690557,43692917
8778,6,12,1,2412,-57,-91,34,40:e3:d6:da:ba:20,43709013,160,15936,43708853,43709013
8779,6,6,1,2412,-57,-91,34,40:e3:d6:da:ba:21,43709205,368,-176,43708837,43709205
8780,6,12,1,2412,-57,-91,34,40:e3:d6:da:ba:22,43709619,180,234,43709439,43709619
8781,6,12,1,2412,-58,-91,33,40:e3:d6:da:ba:23,43709842,184,39,43709658,43709842
8782,6,12,1,2412,-58,-91,33,40:e3:d6:da:ba:24,43710079,176,61,43709903,43710079
8783,6,12,1,2412,-57,-91,34,40:e3:d6:da:ba:25,43710280,160,41,43710120,43710280
8784,6,6,1,2412,-57,-91,34,40:e3:d6:da:ba:26,43710472,380,-188,43710092,43710472
8785,6,12,1,2412,-87,-91,4,84:d4:7e:f2:42:25,43711045,160,413,43710885,43711045
8786,6,6,1,2412,-85,-91,6,84:d4:7e:f2:42:26,43711264,380,-161,43710884,43711264
8787,4,1,1,2412,-70,-91,21,a6:e5:7c:28:b1:d3,43755308,992,43052,43754316,43755308
8788,4,1,1,2412,-77,-91,14,b8:3a:5a:88:e6:e1,43797729,2376,40045,43795353,43797729
8789,6,12,1,2412,-56,-91,35,40:e3:d6:da:ba:22,43812028,180,14119,43811848,43812028
8790,6,12,1,2412,-56,-91,35,40:e3:d6:da:ba:23,43812251,184,39,43812067,43812251
8791,6,12,1,2412,-57,-91,34,40:e3:d6:da:ba:24,43812470,176,43,43812294,43812470
8792,6,12,1,2412,-57,-91,34,40:e3:d6:da:ba:25,43812690,160,60,43812530,43812690
8793,6,6,1,2412,-57,-91,34,40:e3:d6:da:ba:26,43812881,380,-189,43812501,43812881
8794,4,1,1,2412,-75,-91,16,54:e4:3a:ec:fb:64,43870287,2160,55246,43868127,43870287
8795,4,1,1,2412,-76,-91,15,b8:3a:5a:88:e6:e0,43897718,2360,25071,43895358,43897718
8796,4,1,1,2412,-76,-91,15,b8:3a:5a:88:e6:e1,43900124,2376,30,43897748,43900124
8797,6,12,1,2412,-57,-91,34,40:e3:d6:da:ba:20,43913801,160,13517,43913641,43913801
8798,6,6,1,2412,-57,-91,34,40:e3:d6:da:ba:21,43913993,368,-176,43913625,43913993
8799,6,12,1,2412,-57,-91,34,40:e3:d6:da:ba:22,43914397,180,224,43914217,43914397
8800,6,12,1,2412,-57,-91,34,40:e3:d6:da:ba:23,43914612,184,31,43914428,43914612
8801,6,12,1,2412,-57,-91,34,40:e3:d6:da:ba:24,43914839,176,51,43914663,43914839
8802,6,12,1,2412,-57,-91,34,40:e3:d6:da:ba:25,43915050,160,51,43914890,43915050
8803,6,6,1,2412,-57,-91,34,40:e3:d6:da:ba:26,43915269,380,-161,43914889,43915269
8804,6,12,1,2412,-84,-91,7,84:d4:7e:f2:42:25,43915867,160,438,43915707,43915867
8805,6,6,1,2412,-87,-91,4,84:d4:7e:f2:42:26,43916086,380,-161,43915706,43916086
8806,6,6,1,2412,-75,-91,16,e6:aa:ea:b7:4a:dd,43950349,408,33855,43949941,43950349
8807,6,6,1,2412,-58,-91,33,e6:aa:ea:c9:ea:33,43956968,408,6211,43956560,43956968
8808,6,6,1,2412,-75,-91,16,e6:aa:ea:b7:4a:dd,43962463,408,5087,43962055,43962463
8809,6,6,1,2412,-58,-91,33,e6:aa:ea:c9:ea:33,43969095,408,6224,43968687,43969095
8810,4,1,1,2412,-75,-91,16,54:e4:3a:ec:fb:64,43972690,2160,1435,43970530,43972690
8811,6,6,1,2412,-58,-91,33,e6:aa:ea:c9:ea:33,43981213,408,8115,43980805,43981213
8812,6,6,1,2412,-58,-91,33,e6:aa:ea:c9:ea:33,43993322,408,11701,43992914,43993322
8813,4,1,1,2412,-77,-91,14,b8:3a:5a:88:e6:e0,44001011,2360,5329,43998651,44001011
8814,6,12,1,2412,-57,-91,34,40:e3:d6:da:ba:20,44016206,160,15035,44016046,44016206
8815,6,6,1,2412,-57,-91,34,40:e3:d6:da:ba:21,44016425,368,-149,44016057,44016425
8816,6,12,1,2412,-57,-91,34,40:e3:d6:da:ba:22,44016812,180,207,44016632,44016812
8817,6,12,1,2412,-57,-91,34,40:e3:d6:da:ba:23,44017044,184,48,44016860,44017044
8818,6,12,1,2412,-57,-91,34,40:e3:d6:da:ba:24,44017271,176,51,44017095,44017271
8819,6,12,1,2412,-57,-91,34,40:e3:d6:da:ba:25,44017491,160,60,44017331,44017491
8820,6,6,1,2412,-57,-91,34,40:e3:d6:da:ba:26,44017701,380,-170,44017321,44017701
8821,6,12,1,2412,-86,-91,5,84:d4:7e:f2:42:25,44018234,160,373,44018074,44018234
8822,6,6,1,2412,-84,-91,7,84:d4:7e:f2:42:26,44018453,380,-161,44018073,44018453
8823,4,1,1,2412,-78,-91,13,c0:c9:e3:4d:6e:bf,44108257,872,88932,44107385,44108257
8824,4,1,1,2412,-84,-91,7,,44109146,304,585,44108842,44109146
8825,6,12,1,2412,-57,-91,34,40:e3:d6:da:ba:20,44118606,160,9300,44118446,44118606
8826,6,6,1,2412,-57,-91,34,40:e3:d6:da:ba:21,44118798,368,-176,44118430,44118798
8827,6,12,1,2412,-57,-91,34,40:e3:d6:da:ba:23,44119409,184,427,44119225,44119409
8828,6,12,1,2412,-57,-91,34,40:e3:d6:da:ba:24,44119627,176,42,44119451,44119627
8829,6,12,1,2412,-57,-91,34,40:e3:d6:da:ba:25,44119828,160,41,44119668,44119828
8830,6,6,1,2412,-57,-91,34,40:e3:d6:da:ba:26,44120038,380,-170,44119658,44120038
8831,4,1,1,2412,-73,-91,18,,44140936,304,20594,44140632,44140936
8832,4,1,1,2412,-83,-91,8,,44152476,304,11236,44152172,44152476
8833,4,1,1,2412,-84,-91,7,,44164431,304,11651,44164127,44164431
8834,4,1,1,2412,-73,-91,18,54:e4:3a:ec:fb:64,44177465,2160,10874,44175305,44177465
8835,4,1,1,2412,-82,-91,9,,44185194,304,7425,44184890,44185194
8836,4,1,1,2412,-75,-91,16,b8:3a:5a:88:e6:e0,44185530,2240,-1904,44183290,44185530
8837,4,1,1,2412,-66,-91,25,b8:3a:5a:88:e6:e1,44191063,2256,3277,44188807,44191063
8838,6,6,1,2412,-86,-91,5,84:d4:7e:f2:42:21,44221978,368,30547,44221610,44221978
8839,6,12,1,2412,-85,-91,6,84:d4:7e:f2:42:22,44222365,180,207,44222185,44222365
8840,6,12,1,2412,-83,-91,8,84:d4:7e:f2:42:24,44222794,176,253,44222618,44222794
8841,6,12,1,2412,-87,-91,4,84:d4:7e:f2:42:25,44223004,160,50,44222844,44223004
8842,6,12,1,2412,-58,-91,33,40:e3:d6:da:ba:20,44227154,160,3990,44226994,44227154
8843,6,6,1,2412,-58,-91,33,40:e3:d6:da:ba:21,44227380,368,-142,44227012,44227380
8844,6,12,1,2412,-58,-91,33,40:e3:d6:da:ba:22,44227794,180,234,44227614,44227794
8845,6,12,1,2412,-58,-91,33,40:e3:d6:da:ba:23,44228008,184,30,44227824,44228008
8846,6,12,1,2412,-58,-91,33,40:e3:d6:da:ba:24,44228227,176,43,44228051,44228227
8847,6,12,1,2412,-58,-91,33,40:e3:d6:da:ba:25,44228446,160,59,44228286,44228446
8848,6,6,1,2412,-58,-91,33,40:e3:d6:da:ba:26,44228647,380,-179,44228267,44228647
8849,6,6,1,2412,-74,-91,17,e6:aa:ea:b7:4a:dd,44265579,408,36524,44265171,44265579
8850,4,1,1,2412,-74,-91,17,54:e4:3a:ec:fb:64,44279843,2160,12104,44277683,44279843
8851,6,6,1,2412,-74,-91,17,e6:aa:ea:b7:4a:dd,44289814,408,9563,44289406,44289814
8852,6,6,1,2412,-74,-91,17,e6:aa:ea:b7:4a:dd,44301926,408,11704,44301518,44301926
8853,4,1,1,2412,-74,-91,17,b8:3a:5a:88:e6:e0,44307326,2360,3040,44304966,44307326
8854,6,12,1,2412,-58,-91,33,40:e3:d6:da:ba:20,44324154,160,16668,44323994,44324154
8855,6,12,1,2412,-58,-91,33,40:e3:d6:da:ba:22,44324742,180,408,44324562,44324742
8856,6,6,1,2412,-58,-91,33,40:e3:d6:da:ba:26,44325613,380,491,44325233,44325613
8857,4,1,1,2412,-74,-91,17,54:e4:3a:ec:fb:64,44382274,2160,54501,44380114,44382274
8858,4,1,1,2412,-75,-91,16,b8:3a:5a:88:e6:e0,44409719,2360,25085,44407359,44409719
8859,6,12,1,2412,-58,-91,33,40:e3:d6:da:ba:20,44425803,160,15924,44425643,44425803
8860,6,6,1,2412,-58,-91,33,40:e3:d6:da:ba:21,44426013,368,-158,44425645,44426013
8861,6,12,1,2412,-58,-91,33,40:e3:d6:da:ba:22,44426400,180,207,44426220,44426400
8862,6,12,1,2412,-58,-91,33,40:e3:d6:da:ba:23,44426632,184,48,44426448,44426632
8863,6,12,1,2412,-58,-91,33,40:e3:d6:da:ba:24,44426842,176,34,44426666,44426842
8864,6,12,1,2412,-58,-91,33,40:e3:d6:da:ba:25,44427052,160,50,44426892,44427052
8865,6,6,1,2412,-58,-91,33,40:e3:d6:da:ba:26,44427244,380,-188,44426864,44427244
8866,6,6,1,2412,-54,-91,37,e6:aa:ea:c9:ea:33,44476863,408,49211,44476455,44476863
8867,6,6,1,2412,-54,-91,37,e6:aa:ea:c9:ea:33,44488989,408,11718,44488581,44488989
8868,6,6,1,2412,-53,-91,38,e6:aa:ea:c9:ea:33,44501112,408,11715,44500704,44501112
8869,4,1,1,2412,-76,-91,15,b8:3a:5a:88:e6:e1,44516807,2376,13319,44514431,44516807
8870,6,6,1,2412,-53,-91,38,e6:aa:ea:c9:ea:33,44525341,408,8126,44524933,44525341
8871,6,12,1,2412,-58,-91,33,40:e3:d6:da:ba:20,44528226,160,2725,44528066,44528226
8872,6,6,1,2412,-58,-91,33,40:e3:d6:da:ba:21,44528427,368,-167,44528059,44528427
8873,6,12,1,2412,-58,-91,33,40:e3:d6:da:ba:22,44528823,180,216,44528643,44528823
8874,6,12,1,2412,-58,-91,33,40:e3:d6:da:ba:23,44529046,184,39,44528862,44529046
8875,6,12,1,2412,-58,-91,33,40:e3:d6:da:ba:24,44529256,176,34,44529080,44529256
8876,6,12,1,2412,-58,-91,33,40:e3:d6:da:ba:25,44529466,160,50,44529306,44529466
8877,6,6,1,2412,-58,-91,33,40:e3:d6:da:ba:26,44529676,380,-170,44529296,44529676
8878,4,1,1,2412,-73,-91,18,54:e4:3a:ec:fb:64,44587052,2160,55216,44584892,44587052
8879,4,1,1,2412,-78,-91,13,c0:c9:e3:4d:6e:bf,44599503,872,11579,44598631,44599503
8880,4,1,1,2412,-76,-91,15,b8:3a:5a:88:e6:e1,44616939,2376,15060,44614563,44616939
8881,6,12,1,2412,-59,-91,32,40:e3:d6:da:ba:20,44630623,160,13524,44630463,44630623
8882,6,12,1,2412,-59,-91,32,40:e3:d6:da:ba:22,44631229,180,426,44631049,44631229
8883,6,12,1,2412,-58,-91,33,40:e3:d6:da:ba:23,44631461,184,48,44631277,44631461
8884,6,12,1,2412,-59,-91,32,40:e3:d6:da:ba:24,44631698,176,61,44631522,44631698
8885,6,12,1,2412,-59,-91,32,40:e3:d6:da:ba:25,44631908,160,50,44631748,44631908
8886,4,1,1,2412,-77,-91,14,,44646001,304,13789,44645697,44646001
8887,6,6,1,2412,-75,-91,16,e6:aa:ea:b7:4a:dd,44683559,408,37150,44683151,44683559
8888,4,1,1,2412,-74,-91,17,54:e4:3a:ec:fb:64,44689495,2160,3776,44687335,44689495
8889,4,1,1,2412,-76,-91,15,b8:3a:5a:88:e6:e0,44716939,2360,25084,44714579,44716939
8890,6,12,1,2412,-59,-91,32,40:e3:d6:da:ba:20,44733010,160,15911,44732850,44733010
8891,6,6,1,2412,-58,-91,33,40:e3:d6:da:ba:21,44733228,368,-150,44732860,44733228
8892,6,12,1,2412,-59,-91,32,40:e3:d6:da:ba:22,44733642,180,234,44733462,44733642
8893,6,12,1,2412,-59,-91,32,40:e3:d6:da:ba:23,44733875,184,49,44733691,44733875
8894,6,12,1,2412,-58,-91,33,40:e3:d6:da:ba:24,44734128,176,77,44733952,44734128
8895,6,12,1,2412,-59,-91,32,40:e3:d6:da:ba:25,44734339,160,51,44734179,44734339
8896,6,6,1,2412,-59,-91,32,40:e3:d6:da:ba:26,44734558,380,-161,44734178,44734558
8897,6,6,1,2412,-52,-91,39,e6:aa:ea:c9:ea:33,44804320,408,69354,44803912,44804320
8898,4,1,1,2412,-71,-91,20,b8:3a:5a:88:e6:e1,44821738,2376,15042,44819362,44821738
8899,6,6,1,2412,-53,-91,38,e6:aa:ea:c9:ea:33,44828570,408,6424,44828162,44828570
8900,6,12,1,2412,-58,-91,33,40:e3:d6:da:ba:20,44835432,160,6702,44835272,44835432
8901,6,6,1,2412,-58,-91,33,40:e3:d6:da:ba:21,44835624,368,-176,44835256,44835624
8902,6,12,1,2412,-58,-91,33,40:e3:d6:da:ba:22,44836189,180,385,44836009,44836189
8903,6,12,1,2412,-58,-91,33,40:e3:d6:da:ba:23,44836412,184,39,44836228,44836412
8904,6,12,1,2412,-58,-91,33,40:e3:d6:da:ba:24,44836631,176,43,44836455,44836631
8905,6,12,1,2412,-58,-91,33,40:e3:d6:da:ba:25,44836841,160,50,44836681,44836841
8906,6,6,1,2412,-58,-91,33,40:e3:d6:da:ba:26,44837033,380,-188,44836653,44837033
8907,6,6,1,2412,-53,-91,38,e6:aa:ea:c9:ea:33,44840564,408,3123,44840156,44840564
8908,4,1,1,2412,-75,-91,16,54:e4:3a:ec:fb:64,44894276,2160,51552,44892116,44894276
8909,4,1,1,2412,-75,-91,16,b8:3a:5a:88:e6:e0,44921745,2360,25109,44919385,44921745
8910,6,12,1,2412,-74,-91,17,40:e3:d6:da:bb:e5,44935784,156,13883,44935628,44935784
8911,6,12,1,2412,-57,-91,34,40:e3:d6:da:ba:23,44938634,184,2666,44938450,44938634
8912,6,12,1,2412,-57,-91,34,40:e3:d6:da:ba:24,44938853,176,43,44938677,44938853
8913,6,12,1,2412,-57,-91,34,40:e3:d6:da:ba:25,44939063,160,50,44938903,44939063
8914,6,6,1,2412,-57,-91,34,40:e3:d6:da:ba:26,44939298,380,-145,44938918,44939298
8915,6,12,1,2412,-87,-91,4,,45019635,32,80305,45019603,45019635
8916,4,1,1,2412,-76,-91,15,b8:3a:5a:88:e6:e0,45024127,2360,2132,45021767,45024127
8917,6,6,1,2412,-83,-91,8,40:e3:d6:da:bb:e6,45038343,380,13836,45037963,45038343
8918,6,12,1,2412,-57,-91,34,40:e3:d6:da:ba:20,45040205,160,1702,45040045,45040205
8919,6,6,1,2412,-54,-91,37,40:e3:d6:da:ba:21,45040415,368,-158,45040047,45040415
8920,6,12,1,2412,-56,-91,35,40:e3:d6:da:ba:22,45040820,180,225,45040640,45040820
8921,6,12,1,2412,-56,-91,35,40:e3:d6:da:ba:23,45041053,184,49,45040869,45041053
8922,6,12,1,2412,-56,-91,35,40:e3:d6:da:ba:24,45041262,176,33,45041086,45041262
8923,6,12,1,2412,-56,-91,35,40:e3:d6:da:ba:25,45041481,160,59,45041321,45041481
8924,6,6,1,2412,-56,-91,35,40:e3:d6:da:ba:26,45041682,380,-179,45041302,45041682
8925,4,1,1,2412,-77,-91,14,a6:e5:7c:28:b1:d3,45085857,992,43183,45084865,45085857
8926,6,6,1,2412,-75,-91,16,e6:aa:ea:b7:4a:dd,45088956,408,2691,45088548,45088956
8927,4,1,1,2412,-74,-91,17,54:e4:3a:ec:fb:64,45099098,2160,7982,45096938,45099098
8928,6,6,1,2412,-75,-91,16,e6:aa:ea:b7:4a:dd,45101135,408,1629,45100727,45101135
8929,6,6,1,2412,-75,-91,16,e6:aa:ea:b7:4a:dd,45113183,408,11640,45112775,45113183
8930,6,6,1,2412,-75,-91,16,e6:aa:ea:b7:4a:dd,45125308,408,11717,45124900,45125308
8931,4,1,1,2412,-78,-91,13,b8:3a:5a:88:e6:e1,45128930,2376,1246,45126554,45128930
8932,4,1,1,2412,-78,-91,13,a4:e5:7c:28:b1:d3,45138263,688,8645,45137575,45138263
8933,6,6,1,2412,-56,-91,35,40:e3:d6:da:ba:21,45142816,368,4185,45142448,45142816
8934,6,12,1,2412,-57,-91,34,40:e3:d6:da:ba:22,45143222,180,226,45143042,45143222
8935,6,12,1,2412,-57,-91,34,40:e3:d6:da:ba:24,45143691,176,293,45143515,45143691
8936,6,12,1,2412,-57,-91,34,40:e3:d6:da:ba:25,45143892,160,41,45143732,45143892
8937,6,6,1,2412,-57,-91,34,40:e3:d6:da:ba:26,45144102,380,-170,45143722,45144102
8938,6,12,1,2412,-86,-91,5,84:d4:7e:f2:42:23,45144628,180,346,45144448,45144628
8939,6,12,1,2412,-87,-91,4,84:d4:7e:f2:42:25,45145071,160,283,45144911,45145071
8940,4,1,1,2412,-77,-91,14,a6:e5:7c:28:b1:d3,45189013,992,42950,45188021,45189013
8941,4,1,1,2412,-63,-91,28,54:e4:3a:ec:fb:64,45201464,2160,10291,45199304,45201464
8942,6,6,1,2412,-63,-91,28,e6:aa:ea:c9:ea:33,45208348,408,6476,45207940,45208348
8943,6,6,1,2412,-58,-91,33,e6:aa:ea:c9:ea:33,45220363,408,11607,45219955,45220363
8944,6,6,1,2412,-57,-91,34,e6:aa:ea:c9:ea:33,45244505,408,23734,45244097,45244505
8945,6,12,1,2412,-58,-91,33,40:e3:d6:da:ba:20,45245006,160,341,45244846,45245006
8946,6,6,1,2412,-57,-91,34,40:e3:d6:da:ba:21,45245198,368,-176,45244830,45245198
8947,6,12,1,2412,-57,-91,34,40:e3:d6:da:ba:23,45246006,184,624,45245822,45246006
8948,6,12,1,2412,-57,-91,34,40:e3:d6:da:ba:25,45246453,160,287,45246293,45246453
8949,6,6,1,2412,-57,-91,34,40:e3:d6:da:ba:26,45246672,380,-161,45246292,45246672
8950,6,6,1,2412,-87,-91,4,84:d4:7e:f2:42:26,45247285,380,233,45246905,45247285
8951,6,6,1,2412,-57,-91,34,e6:aa:ea:c9:ea:33,45256633,408,8940,45256225,45256633
8952,4,1,1,2412,-78,-91,13,a6:e5:7c:28:b1:d3,45303034,992,45409,45302042,45303034
8953,4,1,1,2412,-80,-91,11,b8:3a:5a:88:e6:e0,45331320,2360,25926,45328960,45331320
8954,6,12,1,2412,-58,-91,33,40:e3:d6:da:ba:20,45347407,160,15927,45347247,45347407
8955,6,6,1,2412,-58,-91,33,40:e3:d6:da:ba:21,45347617,368,-158,45347249,45347617
8956,6,12,1,2412,-57,-91,34,40:e3:d6:da:ba:22,45348022,180,225,45347842,45348022
8957,6,12,1,2412,-57,-91,34,40:e3:d6:da:ba:23,45348245,184,39,45348061,45348245
8958,6,12,1,2412,-57,-91,34,40:e3:d6:da:ba:24,45348473,176,52,45348297,45348473
8959,6,12,1,2412,-57,-91,34,40:e3:d6:da:ba:25,45348701,160,68,45348541,45348701
8960,6,6,1,2412,-57,-91,34,40:e3:d6:da:ba:26,45348911,380,-170,45348531,45348911
8961,4,1,1,2412,-76,-91,15,54:e4:3a:ec:fb:64,45406151,2160,55080,45403991,45406151
8962,6,12,1,2412,-58,-91,33,40:e3:d6:da:ba:20,45452838,160,46527,45452678,45452838
8963,6,6,1,2412,-58,-91,33,40:e3:d6:da:ba:21,45453029,368,-177,45452661,45453029
8964,6,12,1,2412,-58,-91,33,40:e3:d6:da:ba:22,45453434,180,225,45453254,45453434
8965,6,12,1,2412,-58,-91,33,40:e3:d6:da:ba:23,45453640,184,22,45453456,45453640
8966,6,12,1,2412,-58,-91,33,40:e3:d6:da:ba:24,45453858,176,42,45453682,45453858
8967,6,12,1,2412,-58,-91,33,40:e3:d6:da:ba:25,45454078,160,60,45453918,45454078
8968,6,6,1,2412,-58,-91,33,40:e3:d6:da:ba:26,45454278,380,-180,45453898,45454278
8969,4,1,1,2412,-78,-91,13,a6:e5:7c:28:b1:d3,45495275,992,40005,45494283,45495275
8970,4,1,1,2412,-68,-91,23,54:e4:3a:ec:fb:64,45508681,2160,11246,45506521,45508681
8971,6,6,1,2412,-76,-91,15,e6:aa:ea:b7:4a:dd,45518207,408,9118,45517799,45518207
8972,6,6,1,2412,-76,-91,15,e6:aa:ea:b7:4a:dd,45542440,408,23825,45542032,45542440
8973,6,12,1,2412,-57,-91,34,40:e3:d6:da:ba:20,45552209,160,9609,45552049,45552209
8974,6,6,1,2412,-57,-91,34,40:e3:d6:da:ba:21,45552428,368,-149,45552060,45552428
8975,6,12,1,2412,-57,-91,34,40:e3:d6:da:ba:23,45553056,184,444,45552872,45553056
8976,6,12,1,2412,-57,-91,34,40:e3:d6:da:ba:24,45553275,176,43,45553099,45553275
8977,6,12,1,2412,-57,-91,34,40:e3:d6:da:ba:25,45553486,160,51,45553326,45553486
8978,4,1,1,2412,-77,-91,14,c0:c9:e3:4d:6e:bf,45584075,872,29717,45583203,45584075
8979,4,1,1,2412,-78,-91,13,,45584963,304,584,45584659,45584963
8980,4,1,1,2412,-79,-91,12,a6:e5:7c:28:b1:d3,45598477,992,12522,45597485,45598477
8981,4,1,1,2412,-69,-91,22,54:e4:3a:ec:fb:64,45611050,2160,10413,45608890,45611050
8982,4,1,1,2412,-80,-91,11,c0:c9:e3:4d:6e:bf,45631169,872,19247,45630297,45631169
8983,4,1,1,2412,-84,-91,7,,45632058,304,585,45631754,45632058
8984,4,1,1,2412,-76,-91,15,b8:3a:5a:88:e6:e0,45638545,2360,4127,45636185,45638545
8985,4,1,1,2412,-76,-91,15,b8:3a:5a:88:e6:e1,45640943,2376,22,45638567,45640943
8986,6,12,1,2412,-58,-91,33,40:e3:d6:da:ba:20,45654624,160,13521,45654464,45654624
8987,6,6,1,2412,-58,-91,33,40:e3:d6:da:ba:21,45654816,368,-176,45654448,45654816
8988,6,12,1,2412,-58,-91,33,40:e3:d6:da:ba:22,45655221,180,225,45655041,45655221
8989,6,12,1,2412,-58,-91,33,40:e3:d6:da:ba:23,45655444,184,39,45655260,45655444
8990,6,12,1,2412,-58,-91,33,40:e3:d6:da:ba:24,45655653,176,33,45655477,45655653
8991,6,12,1,2412,-58,-91,33,40:e3:d6:da:ba:25,45655873,160,60,45655713,45655873
8992,6,6,1,2412,-58,-91,33,40:e3:d6:da:ba:26,45656074,380,-179,45655694,45656074
8993,4,1,1,2412,-73,-91,18,54:e4:3a:ec:fb:64,45713675,2160,55441,45711515,45713675
8994,6,6,1,2412,-57,-91,34,e6:aa:ea:c9:ea:33,45727983,408,13900,45727575,45727983
8995,6,6,1,2412,-62,-91,29,e6:aa:ea:c9:ea:33,45752269,408,23878,45751861,45752269
8996,6,12,1,2412,-60,-91,31,40:e3:d6:da:ba:20,45757009,160,4580,45756849,45757009
8997,6,6,1,2412,-60,-91,31,40:e3:d6:da:ba:21,45757210,368,-167,45756842,45757210
8998,6,12,1,2412,-60,-91,31,40:e3:d6:da:ba:22,45757606,180,216,45757426,45757606
8999,6,12,1,2412,-60,-91,31,40:e3:d6:da:ba:23,45757839,184,49,45757655,45757839
9000,6,12,1,2412,-60,-91,31,40:e3:d6:da:ba:24,45758057,176,42,45757881,45758057
9001,6,12,1,2412,-60,-91,31,40:e3:d6:da:ba:25,45758259,160,42,45758099,45758259
9002,6,6,1,2412,-60,-91,31,40:e3:d6:da:ba:26,45758478,380,-161,45758098,45758478
9003,6,6,1,2412,-58,-91,33,e6:aa:ea:c9:ea:33,45764362,408,5476,45763954,45764362
9004,6,6,1,2412,-58,-91,33,e6:aa:ea:c9:ea:33,45776455,408,11685,45776047,45776455
9005,4,1,1,2412,-74,-91,17,54:e4:3a:ec:fb:64,45815798,2160,37183,45813638,45815798
9006,4,1,1,2412,-83,-91,8,b8:3a:5a:88:e6:e0,45843346,2360,25188,45840986,45843346
9007,6,12,1,2412,-58,-91,33,40:e3:d6:da:ba:20,45859420,160,15914,45859260,45859420
9008,6,6,1,2412,-58,-91,33,40:e3:d6:da:ba:21,45859639,368,-149,45859271,45859639
9009,6,12,1,2412,-57,-91,34,40:e3:d6:da:ba:22,45860053,180,234,45859873,45860053
9010,6,12,1,2412,-57,-91,34,40:e3:d6:da:ba:23,45860268,184,31,45860084,45860268
9011,6,12,1,2412,-58,-91,33,40:e3:d6:da:ba:24,45860495,176,51,45860319,45860495
9012,6,12,1,2412,-58,-91,33,40:e3:d6:da:ba:25,45860714,160,59,45860554,45860714
9013,6,6,1,2412,-58,-91,33,40:e3:d6:da:ba:26,45860906,380,-188,45860526,45860906
9014,4,1,1,2412,-81,-91,10,b8:3a:5a:88:e6:e1,45917364,2256,54202,45915108,45917364
9015,4,1,1,2412,-80,-91,11,b8:3a:5a:88:e6:e0,45942568,2240,22964,45940328,45942568
9016,4,1,1,2412,-78,-91,13,b8:3a:5a:88:e6:e1,45952213,2256,7389,45949957,45952213
9017,6,12,1,2412,-61,-91,30,40:e3:d6:da:ba:20,45961810,160,9437,45961650,45961810
9018,6,6,1,2412,-61,-91,30,40:e3:d6:da:ba:21,45962020,368,-158,45961652,45962020
9019,6,12,1,2412,-61,-91,30,40:e3:d6:da:ba:22,45962416,180,216,45962236,45962416
9020,6,12,1,2412,-61,-91,30,40:e3:d6:da:ba:23,45962639,184,39,45962455,45962639
9021,6,12,1,2412,-61,-91,30,40:e3:d6:da:ba:24,45962849,176,34,45962673,45962849
9022,6,12,1,2412,-61,-91,30,40:e3:d6:da:ba:25,45963050,160,41,45962890,45963050
9023,6,6,1,2412,-61,-91,30,40:e3:d6:da:ba:26,45963260,380,-170,45962880,45963260
9024,6,6,1,2412,-89,-91,2,84:d4:7e:f2:42:26,45964047,380,407,45963667,45964047
9025,6,6,1,2412,-79,-91,12,e6:aa:ea:b7:4a:dd,46026618,408,62163,46026210,46026618
9026,6,6,1,2412,-81,-91,10,e6:aa:ea:b7:4a:dd,46038724,408,11698,46038316,46038724
9027,6,6,1,2412,-56,-91,35,e6:aa:ea:c9:ea:33,46043116,408,3984,46042708,46043116
9028,4,1,1,2412,-80,-91,11,b8:3a:5a:88:e6:e1,46051729,2376,6237,46049353,46051729
9029,6,6,1,2412,-56,-91,35,e6:aa:ea:c9:ea:33,46055344,408,3207,46054936,46055344
9030,6,6,1,2412,-81,-91,10,e6:aa:ea:b7:4a:dd,46062973,408,7221,46062565,46062973
9031,6,6,1,2412,-77,-91,14,e6:aa:ea:b7:4a:dd,46075083,408,11702,46074675,46075083
9032,6,6,1,2412,-46,-91,45,e6:aa:ea:c9:ea:33,46091561,408,16070,46091153,46091561
9033,4,1,1,2412,-74,-91,17,54:e4:3a:ec:fb:64,46123082,2160,29361,46120922,46123082
9034,4,1,1,2412,-77,-91,14,b8:3a:5a:88:e6:e0,46150535,2360,25093,46148175,46150535
9035,6,12,1,2412,-58,-91,33,40:e3:d6:da:ba:20,46166615,160,15920,46166455,46166615
9036,6,6,1,2412,-58,-91,33,40:e3:d6:da:ba:21,46166834,368,-149,46166466,46166834
9037,6,12,1,2412,-57,-91,34,40:e3:d6:da:ba:22,46167248,180,234,46167068,46167248
9038,6,12,1,2412,-58,-91,33,40:e3:d6:da:ba:23,46167471,184,39,46167287,46167471
9039,6,12,1,2412,-58,-91,33,40:e3:d6:da:ba:24,46167681,176,34,46167505,46167681
9040,6,12,1,2412,-58,-91,33,40:e3:d6:da:ba:25,46167925,160,84,46167765,46167925
9041,6,6,1,2412,-57,-91,34,40:e3:d6:da:ba:26,46168160,380,-145,46167780,46168160
9042,4,1,1,2412,-78,-91,13,54:e4:3a:ec:fb:64,46225484,2160,55164,46223324,46225484
9043,6,6,1,2412,-58,-91,33,40:e3:d6:da:ba:21,46269237,368,43385,46268869,46269237
9044,6,12,1,2412,-58,-91,33,40:e3:d6:da:ba:22,46269633,180,216,46269453,46269633
9045,6,12,1,2412,-58,-91,33,40:e3:d6:da:ba:23,46269866,184,49,46269682,46269866
9046,6,12,1,2412,-58,-91,33,40:e3:d6:da:ba:24,46270075,176,33,46269899,46270075
9047,4,1,1,2412,-77,-91,14,b8:3a:5a:88:e6:e0,46355322,2360,82887,46352962,46355322
9048,6,12,1,2412,-58,-91,33,40:e3:d6:da:ba:20,46371425,160,15943,46371265,46371425
9049,6,6,1,2412,-58,-91,33,40:e3:d6:da:ba:21,46371644,368,-149,46371276,46371644
9050,6,12,1,2412,-58,-91,33,40:e3:d6:da:ba:22,46372058,180,234,46371878,46372058
9051,6,12,1,2412,-58,-91,33,40:e3:d6:da:ba:23,46372291,184,49,46372107,46372291
9052,6,12,1,2412,-58,-91,33,40:e3:d6:da:ba:24,46372527,176,60,46372351,46372527
9053,6,12,1,2412,-58,-91,33,40:e3:d6:da:ba:25,46372746,160,59,46372586,46372746
9054,6,6,1,2412,-58,-91,33,40:e3:d6:da:ba:26,46372956,380,-170,46372576,46372956
9055,4,1,1,2412,-74,-91,17,54:e4:3a:ec:fb:64,46430108,2160,54992,46427948,46430108
9056,6,6,1,2412,-75,-91,16,e6:aa:ea:b7:4a:dd,46443965,408,13449,46443557,46443965
9057,4,1,1,2412,-75,-91,16,b8:3a:5a:88:e6:e1,46460114,2376,13773,46457738,46460114
9058,6,6,1,2412,-87,-91,4,e6:aa:ea:c9:ea:1b,46469864,408,9342,46469456,46469864
9059,6,12,1,2412,-58,-91,33,40:e3:d6:da:ba:20,46473815,160,3791,46473655,46473815
9060,6,6,1,2412,-58,-91,33,40:e3:d6:da:ba:21,46474007,368,-176,46473639,46474007
9061,6,12,1,2412,-57,-91,34,40:e3:d6:da:ba:22,46474421,180,234,46474241,46474421
9062,6,12,1,2412,-58,-91,33,40:e3:d6:da:ba:23,46474653,184,48,46474469,46474653
9063,6,12,1,2412,-58,-91,33,40:e3:d6:da:ba:24,46474872,176,43,46474696,46474872
9064,6,12,1,2412,-58,-91,33,40:e3:d6:da:ba:25,46475091,160,59,46474931,46475091
9065,6,6,1,2412,-58,-91,33,40:e3:d6:da:ba:26,46475292,380,-179,46474912,46475292
9066,6,6,1,2412,-75,-91,16,e6:aa:ea:b7:4a:dd,46480337,408,4637,46479929,46480337
9067,6,6,1,2412,-86,-91,5,e6:aa:ea:c9:ea:1b,46481974,408,1229,46481566,46481974
9068,4,1,1,2412,-78,-91,13,b8:3a:5a:88:e6:e0,46560279,2360,75945,46557919,46560279
9069,6,6,1,2412,-59,-91,32,e6:aa:ea:c9:ea:33,46575985,408,15298,46575577,46575985
9070,6,12,1,2412,-56,-91,35,40:e3:d6:da:ba:20,46576422,160,277,46576262,46576422
9071,6,6,1,2412,-56,-91,35,40:e3:d6:da:ba:21,46576641,368,-149,46576273,46576641
9072,6,12,1,2412,-55,-91,36,40:e3:d6:da:ba:23,46577251,184,426,46577067,46577251
9073,6,12,1,2412,-56,-91,35,40:e3:d6:da:ba:24,46577487,176,60,46577311,46577487
9074,6,12,1,2412,-56,-91,35,40:e3:d6:da:ba:25,46577716,160,69,46577556,46577716
9075,6,6,1,2412,-59,-91,32,e6:aa:ea:c9:ea:33,46588091,408,9967,46587683,46588091
9076,6,6,1,2412,-60,-91,31,e6:aa:ea:c9:ea:33,46600198,408,11699,46599790,46600198
9077,4,1,1,2412,-84,-91,7,,46621506,304,21004,46621202,46621506
9078,6,12,1,2412,-54,-91,37,40:e3:d6:da:ba:20,46678658,160,56992,46678498,46678658
9079,6,6,1,2412,-54,-91,37,40:e3:d6:da:ba:21,46678859,368,-167,46678491,46678859
9080,6,12,1,2412,-50,-91,41,40:e3:d6:da:ba:22,46679264,180,225,46679084,46679264
9081,6,12,1,2412,-51,-91,40,40:e3:d6:da:ba:23,46679487,184,39,46679303,46679487
9082,6,12,1,2412,-47,-91,44,40:e3:d6:da:ba:24,46679724,176,61,46679548,46679724
9083,6,12,1,2412,-51,-91,40,40:e3:d6:da:ba:25,46679934,160,50,46679774,46679934
9084,6,6,1,2412,-49,-91,42,40:e3:d6:da:ba:26,46680135,380,-179,46679755,46680135
9085,4,1,1,2412,-75,-91,16,54:e4:3a:ec:fb:64,46737305,2160,55010,46735145,46737305
9086,4,1,1,2412,-80,-91,11,b8:3a:5a:88:e6:e0,46764924,2360,25259,46762564,46764924
9087,6,12,1,2412,-55,-91,36,40:e3:d6:da:ba:20,46781020,160,15936,46780860,46781020
9088,6,6,1,2412,-55,-91,36,40:e3:d6:da:ba:21,46781212,368,-176,46780844,46781212
9089,6,12,1,2412,-54,-91,37,40:e3:d6:da:ba:22,46781599,180,207,46781419,46781599
9090,6,12,1,2412,-55,-91,36,40:e3:d6:da:ba:23,46781822,184,39,46781638,46781822
9091,6,12,1,2412,-54,-91,37,40:e3:d6:da:ba:24,46782059,176,61,46781883,46782059
9092,6,12,1,2412,-54,-91,37,40:e3:d6:da:ba:25,46782278,160,59,46782118,46782278
9093,6,6,1,2412,-55,-91,36,40:e3:d6:da:ba:26,46782470,380,-188,46782090,46782470
9094,6,6,1,2412,-80,-91,11,e6:aa:ea:b7:4a:dd,46794698,408,11820,46794290,46794698
9095,6,6,1,2412,-80,-91,11,e6:aa:ea:b7:4a:dd,46806798,408,11692,46806390,46806798
9096,4,1,1,2412,-73,-91,18,54:e4:3a:ec:fb:64,46839855,2160,30897,46837695,46839855
9097,6,6,1,2412,-60,-91,31,e6:aa:ea:c9:ea:33,46879387,408,39124,46878979,46879387
9098,6,12,1,2412,-57,-91,34,40:e3:d6:da:ba:20,46884063,160,4516,46883903,46884063
9099,6,12,1,2412,-57,-91,34,40:e3:d6:da:ba:23,46884947,184,700,46884763,46884947
9100,6,12,1,2412,-57,-91,34,40:e3:d6:da:ba:24,46885166,176,43,46884990,46885166
9101,6,12,1,2412,-57,-91,34,40:e3:d6:da:ba:25,46885385,160,59,46885225,46885385
9102,6,6,1,2412,-57,-91,34,40:e3:d6:da:ba:26,46885577,380,-188,46885197,46885577
9103,6,6,1,2412,-59,-91,32,e6:aa:ea:c9:ea:33,46891505,408,5520,46891097,46891505
9104,6,12,1,2412,-57,-91,34,40:e3:d6:da:ba:20,46896019,960,3554,46895059,46896019
9105,6,6,1,2412,-59,-91,32,e6:aa:ea:c9:ea:33,46915749,408,19322,46915341,46915749
9106,6,6,1,2412,-59,-91,32,e6:aa:ea:c9:ea:33,46927890,408,11733,46927482,46927890
9107,4,1,1,2412,-74,-91,17,a6:e5:7c:28:b1:d3,46929458,992,576,46928466,46929458
9108,4,1,1,2412,-73,-91,18,54:e4:3a:ec:fb:64,46943370,2160,11752,46941210,46943370
9109,6,12,1,2412,-56,-91,35,40:e3:d6:da:ba:20,46985821,160,42291,46985661,46985821
9110,6,6,1,2412,-56,-91,35,40:e3:d6:da:ba:21,46986040,368,-149,46985672,46986040
9111,6,12,1,2412,-56,-91,35,40:e3:d6:da:ba:22,46986436,180,216,46986256,46986436
9112,6,12,1,2412,-56,-91,35,40:e3:d6:da:ba:24,46986878,176,266,46986702,46986878
9113,6,12,1,2412,-56,-91,35,40:e3:d6:da:ba:25,46987089,160,51,46986929,46987089
9114,6,6,1,2412,-56,-91,35,40:e3:d6:da:ba:26,46987307,380,-162,46986927,46987307
9115,4,1,1,2412,-72,-91,19,54:e4:3a:ec:fb:64,47046472,2160,57005,47044312,47046472
9116,4,1,1,2412,-76,-91,15,c0:c9:e3:4d:6e:bf,47068909,872,21565,47068037,47068909
9117,4,1,1,2412,-86,-91,5,,47069798,304,585,47069494,47069798
9118,6,6,1,2412,-56,-91,35,40:e3:d6:da:ba:21,47088453,368,18287,47088085,47088453
9119,6,12,1,2412,-55,-91,36,40:e3:d6:da:ba:22,47088839,180,206,47088659,47088839
9120,6,12,1,2412,-56,-91,35,40:e3:d6:da:ba:24,47091591,176,2576,47091415,47091591
9121,6,12,1,2412,-56,-91,35,40:e3:d6:da:ba:25,47091820,160,69,47091660,47091820
9122,4,1,1,2412,-74,-91,17,54:e4:3a:ec:fb:64,47146901,2160,52921,47144741,47146901
9123,4,1,1,2412,-79,-91,12,b8:3a:5a:88:e6:e0,47174535,2360,25274,47172175,47174535
9124,6,12,1,2412,-57,-91,34,40:e3:d6:da:ba:20,47190622,160,15927,47190462,47190622
9125,6,6,1,2412,-57,-91,34,40:e3:d6:da:ba:21,47190814,368,-176,47190446,47190814
9126,6,12,1,2412,-56,-91,35,40:e3:d6:da:ba:22,47191201,180,207,47191021,47191201
9127,6,12,1,2412,-57,-91,34,40:e3:d6:da:ba:24,47191669,176,292,47191493,47191669
9128,6,12,1,2412,-56,-91,35,40:e3:d6:da:ba:25,47191889,160,60,47191729,47191889
9129,6,6,1,2412,-57,-91,34,40:e3:d6:da:ba:26,47192108,380,-161,47191728,47192108
9130,6,6,1,2412,-78,-91,13,e6:aa:ea:b7:4a:dd,47200519,408,8003,47200111,47200519
9131,6,6,1,2412,-77,-91,14,e6:aa:ea:b7:4a:dd,47224753,408,23826,47224345,47224753
9132,6,12,1,2412,-54,-91,37,40:e3:d6:da:ba:20,47293039,160,68126,47292879,47293039
9133,6,6,1,2412,-54,-91,37,40:e3:d6:da:ba:21,47293240,368,-167,47292872,47293240
9134,6,12,1,2412,-54,-91,37,40:e3:d6:da:ba:22,47293636,180,216,47293456,47293636
9135,6,12,1,2412,-54,-91,37,40:e3:d6:da:ba:23,47293850,184,30,47293666,47293850
9136,6,12,1,2412,-54,-91,37,40:e3:d6:da:ba:24,47294087,176,61,47293911,47294087
9137,6,12,1,2412,-54,-91,37,40:e3:d6:da:ba:25,47294306,160,59,47294146,47294306
9138,6,6,1,2412,-54,-91,37,40:e3:d6:da:ba:26,47294498,380,-188,47294118,47294498
9139,4,1,1,2412,-57,-91,34,ee:0c:a7:12:50:1d,47301456,1152,5806,47300304,47301456
9140,4,1,1,2412,-78,-91,13,54:e4:3a:ec:fb:64,47302725,2112,-843,47300613,47302725
9141,4,1,1,2412,-78,-91,13,54:e4:3a:ec:fb:64,47308168,2112,3331,47306056,47308168
9142,6,6,1,2412,-83,-91,8,,47310948,44,2736,47310904,47310948
9143,4,1,1,2412,-78,-91,13,54:e4:3a:ec:fb:64,47311677,2112,-1383,47309565,47311677
9144,4,1,1,2412,-57,-91,34,,47313801,304,1820,47313497,47313801
9145,4,1,1,2412,-57,-91,34,ee:0c:a7:12:50:1d,47316653,1152,1700,47315501,47316653
9146,4,1,1,2412,-55,-91,36,,47320052,304,3095,47319748,47320052
9147,4,5.5,1,2412,-86,-91,5,,47326970,213,6705,47326757,47326970
9148,4,1,1,2412,-81,-91,10,b8:3a:5a:88:e6:e0,47327214,2240,-1996,47324974,47327214
9149,4,1,1,2412,-81,-91,10,b8:3a:5a:88:e6:e1,47329492,2256,22,47327236,47329492
9150,4,1,1,2412,-76,-91,15,a6:e5:7c:28:b1:d3,47338828,992,8344,47337836,47338828
9151,6,12,1,2412,-56,-91,35,40:e3:d6:da:ba:20,47395416,160,56428,47395256,47395416
9152,6,6,1,2412,-56,-91,35,40:e3:d6:da:ba:21,47395617,368,-167,47395249,47395617
9153,6,12,1,2412,-56,-91,35,40:e3:d6:da:ba:22,47396022,180,225,47395842,47396022
9154,6,12,1,2412,-55,-91,36,40:e3:d6:da:ba:25,47396664,160,482,47396504,47396664
9155,6,6,1,2412,-54,-91,37,e6:aa:ea:c9:ea:33,47399089,408,2017,47398681,47399089
9156,6,6,1,2412,-53,-91,38,e6:aa:ea:c9:ea:33,47411259,408,11762,47410851,47411259
9157,6,6,1,2412,-53,-91,38,e6:aa:ea:c9:ea:33,47423389,408,11722,47422981,47423389
9158,4,1,1,2412,-75,-91,16,a6:e5:7c:28:b1:d3,47441011,992,16630,47440019,47441011
9159,4,1,1,2412,-77,-91,14,a4:e5:7c:28:b1:d3,47451778,688,10079,47451090,47451778
9160,4,1,1,2412,-87,-91,4,,47452483,304,401,47452179,47452483
9161,6,12,1,2412,-56,-91,35,40:e3:d6:da:ba:20,47497843,160,45200,47497683,47497843
9162,6,6,1,2412,-56,-91,35,40:e3:d6:da:ba:21,47498044,368,-167,47497676,47498044
9163,6,12,1,2412,-56,-91,35,40:e3:d6:da:ba:22,47498431,180,207,47498251,47498431
9164,6,12,1,2412,-55,-91,36,40:e3:d6:da:ba:23,47498636,184,21,47498452,47498636
9165,6,12,1,2412,-56,-91,35,40:e3:d6:da:ba:24,47498855,176,43,47498679,47498855
9166,6,12,1,2412,-56,-91,35,40:e3:d6:da:ba:25,47499083,160,68,47498923,47499083
9167,6,6,1,2412,-56,-91,35,40:e3:d6:da:ba:26,47499293,380,-170,47498913,47499293
9168,4,1,1,2412,-76,-91,15,a4:e5:7c:28:b1:d3,47543168,688,43187,47542480,47543168
9169,4,1,1,2412,-87,-91,4,,47543871,304,399,47543567,47543871
9170,4,1,1,2412,-76,-91,15,54:e4:3a:ec:fb:64,47556658,2160,10627,47554498,47556658
9171,4,1,1,2412,-78,-91,13,b8:3a:5a:88:e6:e0,47586941,2360,27923,47584581,47586941
9172,6,6,1,2412,-78,-91,13,e6:aa:ea:b7:4a:dd,47594062,408,6713,47593654,47594062
9173,6,12,1,2412,-53,-91,38,40:e3:d6:da:ba:20,47600215,160,5993,47600055,47600215
9174,6,6,1,2412,-53,-91,38,40:e3:d6:da:ba:21,47600425,368,-158,47600057,47600425
9175,6,12,1,2412,-53,-91,38,40:e3:d6:da:ba:22,47600839,180,234,47600659,47600839
9176,6,12,1,2412,-53,-91,38,40:e3:d6:da:ba:24,47601263,176,248,47601087,47601263
9177,6,12,1,2412,-53,-91,38,40:e3:d6:da:ba:25,47601474,160,51,47601314,47601474
9178,6,6,1,2412,-53,-91,38,40:e3:d6:da:ba:26,47601693,380,-161,47601313,47601693
9179,4,1,1,2412,-78,-91,13,c0:c9:e3:4d:6e:bf,47604960,872,2395,47604088,47604960
9180,4,1,1,2412,-79,-91,12,,47605849,304,585,47605545,47605849
9181,6,6,1,2412,-78,-91,13,e6:aa:ea:b7:4a:dd,47606181,408,-76,47605773,47606181
9182,6,6,1,2412,-78,-91,13,e6:aa:ea:b7:4a:dd,47618324,408,11735,47617916,47618324
9183,6,6,1,2412,-78,-91,13,e6:aa:ea:b7:4a:dd,47630420,408,11688,47630012,47630420
9184,4,1,1,2412,-76,-91,15,54:e4:3a:ec:fb:64,47658897,2160,26317,47656737,47658897
9185,6,12,1,2412,-52,-91,39,40:e3:d6:da:ba:20,47702617,160,43560,47702457,47702617
9186,6,6,1,2412,-52,-91,39,40:e3:d6:da:ba:21,47702818,368,-167,47702450,47702818
9187,6,12,1,2412,-52,-91,39,40:e3:d6:da:ba:22,47703214,180,216,47703034,47703214
9188,6,12,1,2412,-52,-91,39,40:e3:d6:da:ba:23,47703428,184,30,47703244,47703428
9189,6,12,1,2412,-52,-91,39,40:e3:d6:da:ba:24,47703637,176,33,47703461,47703637
9190,6,12,1,2412,-52,-91,39,40:e3:d6:da:ba:25,47703857,160,60,47703697,47703857
9191,6,6,1,2412,-52,-91,39,40:e3:d6:da:ba:26,47704076,380,-161,47703696,47704076
9192,6,6,1,2412,-62,-91,29,e6:aa:ea:c9:ea:33,47726237,408,21753,47725829,47726237
9193,6,6,1,2412,-62,-91,29,e6:aa:ea:c9:ea:33,47738348,408,11703,47737940,47738348
9194,6,6,1,2412,-61,-91,30,e6:aa:ea:c9:ea:33,47750461,408,11705,47750053,47750461
9195,6,6,1,2412,-61,-91,30,e6:aa:ea:c9:ea:33,47769416,408,18547,47769008,47769416
9196,6,12,1,2412,-52,-91,39,40:e3:d6:da:ba:20,47805017,160,35441,47804857,47805017
9197,6,6,1,2412,-52,-91,39,40:e3:d6:da:ba:21,47805227,368,-158,47804859,47805227
9198,6,12,1,2412,-52,-91,39,40:e3:d6:da:ba:22,47805614,180,207,47805434,47805614
9199,6,12,1,2412,-52,-91,39,40:e3:d6:da:ba:23,47805837,184,39,47805653,47805837
9200,6,12,1,2412,-52,-91,39,40:e3:d6:da:ba:24,47806065,176,52,47805889,47806065
9201,6,12,1,2412,-52,-91,39,40:e3:d6:da:ba:25,47806275,160,50,47806115,47806275
9202,6,6,1,2412,-52,-91,39,40:e3:d6:da:ba:26,47806494,380,-161,47806114,47806494
9203,4,1,1,2412,-76,-91,15,54:e4:3a:ec:fb:64,47864254,2160,55600,47862094,47864254
9204,6,6,1,2412,-71,-91,20,,47866265,44,1967,47866221,47866265
9205,4,1,1,2412,-81,-91,10,b8:3a:5a:88:e6:e0,47891334,2360,22709,47888974,47891334
9206,6,12,1,2412,-52,-91,39,40:e3:d6:da:ba:20,47907431,160,15937,47907271,47907431
9207,6,6,1,2412,-52,-91,39,40:e3:d6:da:ba:21,47907632,368,-167,47907264,47907632
9208,6,12,1,2412,-52,-91,39,40:e3:d6:da:ba:22,47908019,180,207,47907839,47908019
9209,6,12,1,2412,-52,-91,39,40:e3:d6:da:ba:23,47908233,184,30,47908049,47908233
9210,6,12,1,2412,-52,-91,39,40:e3:d6:da:ba:24,47908461,176,52,47908285,47908461
9211,6,12,1,2412,-52,-91,39,40:e3:d6:da:ba:25,47908671,160,50,47908511,47908671
9212,6,6,1,2412,-52,-91,39,40:e3:d6:da:ba:26,47908872,380,-179,47908492,47908872
9213,4,1,1,2412,-78,-91,13,54:e4:3a:ec:fb:64,47966095,2160,55063,47963935,47966095
9214,6,12,1,2412,-52,-91,39,40:e3:d6:da:ba:20,48009840,160,43585,48009680,48009840
9215,6,6,1,2412,-52,-91,39,40:e3:d6:da:ba:21,48010032,368,-176,48009664,48010032
9216,6,12,1,2412,-58,-91,33,40:e3:d6:da:ba:25,48011080,160,888,48010920,48011080
9217,6,6,1,2412,-58,-91,33,40:e3:d6:da:ba:26,48011299,380,-161,48010919,48011299
9218,4,1,1,2412,-86,-91,5,,48051263,304,39660,48050959,48051263
9219,4,1,1,2412,-87,-91,4,,48055254,304,3687,48054950,48055254
9220,4,1,1,2412,-78,-91,13,54:e4:3a:ec:fb:64,48068493,2160,11079,48066333,48068493
9221,4,1,1,2412,-75,-91,16,b8:3a:5a:88:e6:e0,48097313,2360,26460,48094953,48097313
9222,4,1,1,2412,-76,-91,15,b8:3a:5a:88:e6:e1,48099693,2376,4,48097317,48099693
9223,6,12,1,2412,-54,-91,37,40:e3:d6:da:ba:20,48112220,160,12367,48112060,48112220
9224,6,6,1,2412,-54,-91,37,40:e3:d6:da:ba:21,48112421,368,-167,48112053,48112421
9225,6,12,1,2412,-54,-91,37,40:e3:d6:da:ba:22,48112817,180,216,48112637,48112817
9226,6,12,1,2412,-54,-91,37,40:e3:d6:da:ba:23,48113022,184,21,48112838,48113022
9227,6,12,1,2412,-54,-91,37,40:e3:d6:da:ba:24,48113250,176,52,48113074,48113250
9228,6,12,1,2412,-54,-91,37,40:e3:d6:da:ba:25,48113745,160,335,48113585,48113745
9229,6,6,1,2412,-54,-91,37,40:e3:d6:da:ba:26,48113955,380,-170,48113575,48113955
9230,6,6,1,2412,-77,-91,14,e6:aa:ea:b7:4a:dd,48137518,408,23155,48137110,48137518
9231,4,1,1,2412,-87,-91,4,,48142551,304,4729,48142247,48142551
9232,6,6,1,2412,-58,-91,33,e6:aa:ea:c9:ea:33,48143325,408,366,48142917,48143325
9233,6,6,1,2412,-72,-91,19,,48143751,44,382,48143707,48143751
9234,6,6,1,2412,-77,-91,14,e6:aa:ea:b7:4a:dd,48149631,408,5472,48149223,48149631
9235,6,6,1,2412,-58,-91,33,e6:aa:ea:c9:ea:33,48155320,408,5281,48154912,48155320
9236,6,6,1,2412,-71,-91,20,,48157171,44,1807,48157127,48157171
9237,6,6,1,2412,-76,-91,15,e6:aa:ea:b7:4a:dd,48161811,408,4232,48161403,48161811
9238,6,6,1,2412,-58,-91,33,e6:aa:ea:c9:ea:33,48167417,408,5198,48167009,48167417
9239,6,6,1,2412,-72,-91,19,,48170908,44,3447,48170864,48170908
9240,6,6,1,2412,-57,-91,34,e6:aa:ea:c9:ea:33,48179627,408,8311,48179219,48179627
9241,6,12,1,2412,-55,-91,36,40:e3:d6:da:ba:20,48214643,160,34856,48214483,48214643
9242,6,6,1,2412,-55,-91,36,40:e3:d6:da:ba:21,48214844,368,-167,48214476,48214844
9243,6,12,1,2412,-54,-91,37,40:e3:d6:da:ba:22,48215258,180,234,48215078,48215258
9244,6,12,1,2412,-55,-91,36,40:e3:d6:da:ba:23,48215463,184,21,48215279,48215463
9245,6,12,1,2412,-55,-91,36,40:e3:d6:da:ba:24,48215691,176,52,48215515,48215691
9246,6,12,1,2412,-55,-91,36,40:e3:d6:da:ba:25,48215919,160,68,48215759,48215919
9247,6,6,1,2412,-55,-91,36,40:e3:d6:da:ba:26,48216120,380,-179,48215740,48216120
9248,6,6,1,2412,-71,-91,20,,48239001,44,22837,48238957,48239001
9249,6,12,1,2412,-55,-91,36,40:e3:d6:da:ba:20,48317021,160,77860,48316861,48317021
9250,6,12,1,2412,-55,-91,36,40:e3:d6:da:ba:22,48317609,180,408,48317429,48317609
9251,6,12,1,2412,-55,-91,36,40:e3:d6:da:ba:23,48317841,184,48,48317657,48317841
9252,6,12,1,2412,-55,-91,36,40:e3:d6:da:ba:24,48318069,176,52,48317893,48318069
9253,6,12,1,2412,-55,-91,36,40:e3:d6:da:ba:25,48318270,160,41,48318110,48318270
9254,6,6,1,2412,-55,-91,36,40:e3:d6:da:ba:26,48318462,380,-188,48318082,48318462
9255,6,6,1,2412,-71,-91,20,,48319201,44,695,48319157,48319201
9256,4,1,1,2412,-76,-91,15,54:e4:3a:ec:fb:64,48375705,2160,54344,48373545,48375705
9257,6,12,1,2412,-56,-91,35,40:e3:d6:da:ba:20,48419446,160,43581,48419286,48419446
9258,6,6,1,2412,-56,-91,35,40:e3:d6:da:ba:21,48419647,368,-167,48419279,48419647
9259,6,12,1,2412,-56,-91,35,40:e3:d6:da:ba:22,48420061,180,234,48419881,48420061
9260,6,12,1,2412,-56,-91,35,40:e3:d6:da:ba:23,48420266,184,21,48420082,48420266
9261,6,12,1,2412,-56,-91,35,40:e3:d6:da:ba:24,48420484,176,42,48420308,48420484
9262,6,12,1,2412,-56,-91,35,40:e3:d6:da:ba:25,48420704,160,60,48420544,48420704
9263,6,6,1,2412,-56,-91,35,40:e3:d6:da:ba:26,48420905,380,-179,48420525,48420905
9264,6,6,1,2412,-71,-91,20,,48475709,44,54760,48475665,48475709
9265,4,1,1,2412,-75,-91,16,54:e4:3a:ec:fb:64,48480340,2160,2471,48478180,48480340
9266,6,12,1,2412,-76,-91,15,40:e3:d6:da:bb:60,48482574,960,1274,48481614,48482574
9267,4,1,1,2412,-75,-91,16,b8:3a:5a:88:e6:e0,48505728,2360,20794,48503368,48505728
9268,4,1,1,2412,-76,-91,15,b8:3a:5a:88:e6:e1,48508125,2376,21,48505749,48508125
9269,6,12,1,2412,-57,-91,34,40:e3:d6:da:ba:20,48521838,160,13553,48521678,48521838
9270,6,6,1,2412,-57,-91,34,40:e3:d6:da:ba:21,48522039,368,-167,48521671,48522039
9271,6,12,1,2412,-56,-91,35,40:e3:d6:da:ba:22,48522426,180,207,48522246,48522426
9272,6,12,1,2412,-56,-91,35,40:e3:d6:da:ba:23,48522658,184,48,48522474,48522658
9273,6,12,1,2412,-57,-91,34,40:e3:d6:da:ba:24,48522885,176,51,48522709,48522885
9274,6,12,1,2412,-57,-91,34,40:e3:d6:da:ba:25,48523096,160,51,48522936,48523096
9275,6,6,1,2412,-57,-91,34,40:e3:d6:da:ba:26,48523315,380,-161,48522935,48523315
9276,6,6,1,2412,-80,-91,11,e6:aa:ea:b7:4a:dd,48542484,408,18761,48542076,48542484
9277,4,1,1,2412,-78,-91,13,c0:c9:e3:4d:6e:bf,48551121,872,7765,48550249,48551121
9278,4,1,1,2412,-85,-91,6,,48552010,304,585,48551706,48552010
9279,6,6,1,2412,-80,-91,11,e6:aa:ea:b7:4a:dd,48554586,408,2168,48554178,48554586
9280,4,1,1,2412,-79,-91,12,c0:c9:e3:4d:6e:bf,48595231,872,39773,48594359,48595231
9281,4,1,1,2412,-87,-91,4,,48596120,304,585,48595816,48596120
9282,4,1,1,2412,-77,-91,14,b8:3a:5a:88:e6:e1,48610525,2376,12029,48608149,48610525
9283,6,12,1,2412,-57,-91,34,40:e3:d6:da:ba:20,48624236,160,13551,48624076,48624236
9284,6,6,1,2412,-71,-91,20,,48624822,44,542,48624778,48624822
9285,6,12,1,2412,-57,-91,34,40:e3:d6:da:ba:22,48624890,180,-112,48624710,48624890
9286,6,12,1,2412,-57,-91,34,40:e3:d6:da:ba:23,48625114,184,40,48624930,48625114
9287,6,12,1,2412,-57,-91,34,40:e3:d6:da:ba:24,48625332,176,42,48625156,48625332
9288,6,12,1,2412,-56,-91,35,40:e3:d6:da:ba:25,48625561,160,69,48625401,48625561
9289,6,6,1,2412,-57,-91,34,40:e3:d6:da:ba:26,48625771,380,-170,48625391,48625771
9290,6,6,1,2412,-54,-91,37,e6:aa:ea:c9:ea:33,48650901,408,24722,48650493,48650901
9291,6,6,1,2412,-54,-91,37,e6:aa:ea:c9:ea:33,48675184,408,23875,48674776,48675184
9292,4,1,1,2412,-77,-91,14,54:e4:3a:ec:fb:64,48682887,2160,5543,48680727,48682887
9293,6,6,1,2412,-54,-91,37,e6:aa:ea:c9:ea:33,48687286,408,3991,48686878,48687286
9294,6,6,1,2412,-54,-91,37,e6:aa:ea:c9:ea:33,48699389,408,11695,48698981,48699389
9295,6,12,1,2412,-58,-91,33,40:e3:d6:da:ba:20,48726633,160,27084,48726473,48726633
9296,6,12,1,2412,-58,-91,33,40:e3:d6:da:ba:23,48727489,184,672,48727305,48727489
9297,6,12,1,2412,-58,-91,33,40:e3:d6:da:ba:24,48727717,176,52,48727541,48727717
9298,6,12,1,2412,-58,-91,33,40:e3:d6:da:ba:25,48727918,160,41,48727758,48727918
9299,6,6,1,2412,-58,-91,33,40:e3:d6:da:ba:26,48728128,380,-170,48727748,48728128
9300,4,1,1,2412,-78,-91,13,ca:72:4e:99:63:f0,48757664,984,28552,48756680,48757664
9301,4,1,1,2412,-63,-91,28,54:e4:3a:ec:fb:64,48758765,2112,-1011,48756653,48758765
9302,4,1,1,2412,-77,-91,14,,48760886,304,1817,48760582,48760886
9303,6,12,1,2412,-58,-91,33,40:e3:d6:da:ba:20,48761051,136,29,48760915,48761051
9304,6,12,1,2412,-78,-91,13,,48761201,32,118,48761169,48761201
9305,6,6,1,2412,-58,-91,33,40:e3:d6:da:ba:21,48761272,348,-277,48760924,48761272
9306,6,6,1,2412,-79,-91,12,,48761635,44,319,48761591,48761635
9307,6,12,1,2412,-58,-91,33,40:e3:d6:da:ba:22,48761703,156,-88,48761547,48761703
9308,6,12,1,2412,-78,-91,13,,48761873,32,138,48761841,48761873
9309,6,12,1,2412,-58,-91,33,40:e3:d6:da:ba:23,48761946,156,-83,48761790,48761946
9310,6,12,1,2412,-78,-91,13,,48762117,32,139,48762085,48762117
9311,6,12,1,2412,-58,-91,33,40:e3:d6:da:ba:25,48762182,136,-71,48762046,48762182
9312,4,1,1,2412,-74,-91,17,54:e4:3a:ec:fb:64,48785286,2160,20944,48783126,48785286
9313,4,1,1,2412,-63,-91,28,6e:e6:df:30:cf:88,48787601,1128,1187,48786473,48787601
9314,6,12,1,2412,-58,-91,33,40:e3:d6:da:ba:20,48788698,136,961,48788562,48788698
9315,6,6,1,2412,-58,-91,33,40:e3:d6:da:ba:21,48793718,348,4672,48793370,48793718
9316,6,6,1,2412,-64,-91,27,,48794082,44,320,48794038,48794082
9317,6,12,1,2412,-58,-91,33,40:e3:d6:da:ba:22,48794171,156,-67,48794015,48794171
9318,6,12,1,2412,-64,-91,27,,48794343,32,140,48794311,48794343
9319,6,12,1,2412,-58,-91,33,40:e3:d6:da:ba:23,48794618,156,119,48794462,48794618
9320,6,12,1,2412,-64,-91,27,,48794791,32,141,48794759,48794791
9321,6,12,1,2412,-58,-91,33,40:e3:d6:da:ba:25,48794867,136,-60,48794731,48794867
9322,6,12,1,2412,-66,-91,25,,48795019,32,120,48794987,48795019
9323,4,1,1,2412,-89,-91,2,66:d8:ff:ae:5d:41,48797906,416,2471,48797490,48797906
9324,4,1,1,2412,-89,-91,2,,48798335,304,125,48798031,48798335
9325,4,1,1,2412,-89,-91,2,66:d8:ff:ae:5d:41,48798660,416,-91,48798244,48798660
9326,4,1,1,2412,-89,-91,2,,48799090,304,126,48798786,48799090
9327,4,1,1,2412,-90,-91,1,66:d8:ff:ae:5d:41,48801971,416,2465,48801555,48801971
9328,4,1,1,2412,-89,-91,2,66:d8:ff:ae:5d:41,48802729,416,342,48802313,48802729
9329,4,1,1,2412,-89,-91,2,,48803159,304,126,48802855,48803159
9330,4,1,1,2412,-89,-91,2,66:d8:ff:ae:5d:41,48803484,416,-91,48803068,48803484
9331,4,1,1,2412,-63,-91,28,6e:e6:df:30:cf:88,48809138,1128,4526,48808010,48809138
9332,6,12,1,2412,-58,-91,33,40:e3:d6:da:ba:23,48815073,156,5779,48814917,48815073
9333,4,1,1,2412,-80,-91,11,b8:3a:5a:88:e6:e0,48816233,2360,-1200,48813873,48816233
9334,6,12,1,2412,-58,-91,33,40:e3:d6:da:ba:20,48829024,160,12631,48828864,48829024
9335,6,6,1,2412,-58,-91,33,40:e3:d6:da:ba:21,48829216,368,-176,48828848,48829216
9336,6,12,1,2412,-58,-91,33,40:e3:d6:da:ba:22,48829612,180,216,48829432,48829612
9337,6,12,1,2412,-58,-91,33,40:e3:d6:da:ba:23,48829826,184,30,48829642,48829826
9338,6,12,1,2412,-58,-91,33,40:e3:d6:da:ba:24,48830036,176,34,48829860,48830036
9339,6,12,1,2412,-58,-91,33,40:e3:d6:da:ba:25,48830246,160,50,48830086,48830246
9340,6,6,1,2412,-58,-91,33,40:e3:d6:da:ba:26,48830465,380,-161,48830085,48830465
9341,4,1,1,2412,-70,-91,21,ca:72:4e:99:63:f0,48831939,984,490,48830955,48831939
9342,4,1,1,2412,-61,-91,30,,48835169,304,2926,48834865,48835169
9343,6,12,1,2412,-58,-91,33,40:e3:d6:da:ba:20,48835333,136,28,48835197,48835333
9344,6,6,1,2412,-58,-91,33,40:e3:d6:da:ba:21,48835716,348,35,48835368,48835716
9345,6,12,1,2412,-58,-91,33,40:e3:d6:da:ba:22,48836092,156,220,48835936,48836092
9346,6,12,1,2412,-72,-91,19,,48836263,32,139,48836231,48836263
9347,6,12,1,2412,-58,-91,33,40:e3:d6:da:ba:23,48836336,156,-83,48836180,48836336
9348,6,12,1,2412,-72,-91,19,,48836507,32,139,48836475,48836507
9349,6,12,1,2412,-58,-91,33,40:e3:d6:da:ba:25,48836571,136,-72,48836435,48836571
9350,4,1,1,2412,-77,-91,14,54:e4:3a:ec:fb:64,48837039,2112,-1644,48834927,48837039
9351,4,1,1,2412,-75,-91,16,54:e4:3a:ec:fb:64,48839555,2112,404,48837443,48839555
9352,4,1,1,2412,-69,-91,22,,48841676,304,1817,48841372,48841676
9353,6,6,1,2412,-74,-91,17,,48902585,44,60865,48902541,48902585
9354,4,1,1,2412,-69,-91,22,ca:72:4e:99:63:f0,48905676,984,2107,48904692,48905676
9355,4,1,1,2412,-76,-91,15,54:e4:3a:ec:fb:64,48906779,2112,-1009,48904667,48906779
9356,4,1,1,2412,-75,-91,16,54:e4:3a:ec:fb:64,48909180,2112,289,48907068,48909180
9357,4,1,1,2412,-70,-91,21,,48911302,304,1818,48910998,48911302
9358,6,12,1,2412,-57,-91,34,40:e3:d6:da:ba:20,48911466,136,28,48911330,48911466
9359,6,12,1,2412,-70,-91,21,,48911617,32,119,48911585,48911617
9360,6,6,1,2412,-57,-91,34,40:e3:d6:da:ba:21,48911679,348,-286,48911331,48911679
9361,6,6,1,2412,-71,-91,20,,48912042,44,319,48911998,48912042
9362,6,12,1,2412,-57,-91,34,40:e3:d6:da:ba:22,48912119,156,-79,48911963,48912119
9363,6,12,1,2412,-71,-91,20,,48912289,32,138,48912257,48912289
9364,6,12,1,2412,-57,-91,34,40:e3:d6:da:ba:23,48912354,156,-91,48912198,48912354
9365,6,12,1,2412,-71,-91,20,,48912524,32,138,48912492,48912524
9366,6,12,1,2412,-57,-91,34,40:e3:d6:da:ba:25,48912589,136,-71,48912453,48912589
9367,6,12,1,2412,-71,-91,20,,48912740,32,119,48912708,48912740
9368,4,1,1,2412,-74,-91,17,b8:3a:5a:88:e6:e0,48916906,2360,1806,48914546,48916906
9369,6,12,1,2412,-57,-91,34,40:e3:d6:da:ba:20,48931423,160,14357,48931263,48931423
9370,6,6,1,2412,-57,-91,34,40:e3:d6:da:ba:21,48931624,368,-167,48931256,48931624
9371,6,12,1,2412,-57,-91,34,40:e3:d6:da:ba:22,48932029,180,225,48931849,48932029
9372,6,12,1,2412,-57,-91,34,40:e3:d6:da:ba:23,48932261,184,48,48932077,48932261
9373,6,12,1,2412,-57,-91,34,40:e3:d6:da:ba:24,48932489,176,52,48932313,48932489
9374,6,12,1,2412,-57,-91,34,40:e3:d6:da:ba:25,48932717,160,68,48932557,48932717
9375,6,6,1,2412,-48,-91,43,40:e3:d6:da:ba:26,48932933,380,-164,48932553,48932933
9376,6,6,1,2412,-78,-91,13,e6:aa:ea:b7:4a:dd,48960095,408,26754,48959687,48960095
9377,6,6,1,2412,-80,-91,11,e6:aa:ea:b7:4a:dd,48972205,408,11702,48971797,48972205
9378,4,1,1,2412,-70,-91,21,ca:72:4e:99:63:f0,48979404,984,6215,48978420,48979404
9379,6,12,1,2412,-57,-91,34,40:e3:d6:da:ba:20,48982787,136,3247,48982651,48982787
9380,6,6,1,2412,-57,-91,34,40:e3:d6:da:ba:21,48983000,348,-135,48982652,48983000
9381,6,6,1,2412,-71,-91,20,,48983362,44,318,48983318,48983362
9382,6,12,1,2412,-57,-91,34,40:e3:d6:da:ba:22,48983448,156,-70,48983292,48983448
9383,6,12,1,2412,-71,-91,20,,48983619,32,139,48983587,48983619
9384,6,12,1,2412,-57,-91,34,40:e3:d6:da:ba:23,48983684,156,-91,48983528,48983684
9385,6,12,1,2412,-71,-91,20,,48983854,32,138,48983822,48983854
9386,6,12,1,2412,-57,-91,34,40:e3:d6:da:ba:25,48983937,136,-53,48983801,48983937
9387,6,6,1,2412,-80,-91,11,e6:aa:ea:b7:4a:dd,48984380,408,35,48983972,48984380
9388,4,1,1,2412,-75,-91,16,54:e4:3a:ec:fb:64,48990085,2160,3545,48987925,48990085
9389,4,1,1,2412,-83,-91,8,b8:3a:5a:88:e6:e1,49020134,2376,27673,49017758,49020134
9390,6,6,1,2412,-71,-91,20,,49030593,44,10415,49030549,49030593
9391,6,12,1,2412,-57,-91,34,40:e3:d6:da:ba:20,49033836,160,3083,49033676,49033836
9392,6,12,1,2412,-58,-91,33,40:e3:d6:da:ba:22,49034460,180,444,49034280,49034460
9393,6,12,1,2412,-58,-91,33,40:e3:d6:da:ba:23,49034684,184,40,49034500,49034684
9394,6,12,1,2412,-58,-91,33,40:e3:d6:da:ba:24,49034902,176,42,49034726,49034902
9395,6,12,1,2412,-58,-91,33,40:e3:d6:da:ba:25,49035122,160,60,49034962,49035122
9396,6,6,1,2412,-58,-91,33,40:e3:d6:da:ba:26,49035332,380,-170,49034952,49035332
9397,4,1,1,2412,-84,-91,7,c0:c9:e3:4d:6e:bf,49042287,872,6083,49041415,49042287
9398,4,1,1,2412,-88,-91,3,,49043177,304,586,49042873,49043177
9399,4,1,1,2412,-87,-91,4,,49088086,304,44605,49087782,49088086
9400,4,1,1,2412,-87,-91,4,,49106714,304,18324,49106410,49106714
9401,4,1,1,2412,-75,-91,16,54:e4:3a:ec:fb:64,49108244,2112,-582,49106132,49108244
9402,4,1,1,2412,-75,-91,16,54:e4:3a:ec:fb:64,49110582,2112,226,49108470,49110582
9403,4,1,1,2412,-75,-91,16,54:e4:3a:ec:fb:64,49116112,2112,3418,49114000,49116112
9404,4,1,1,2412,-82,-91,9,bc:d7:13:00:2f:51,49130849,880,13857,49129969,49130849
9405,4,1,1,2412,-75,-91,16,54:e4:3a:ec:fb:64,49135982,2112,3021,49133870,49135982
9406,4,1,1,2412,-75,-91,16,54:e4:3a:ec:fb:64,49138303,2112,209,49136191,49138303
9407,6,12,1,2412,-57,-91,34,40:e3:d6:da:ba:20,49140589,160,2126,49140429,49140589
9408,6,6,1,2412,-57,-91,34,40:e3:d6:da:ba:21,49140808,368,-149,49140440,49140808
9409,6,12,1,2412,-57,-91,34,40:e3:d6:da:ba:22,49141195,180,207,49141015,49141195
9410,6,12,1,2412,-57,-91,34,40:e3:d6:da:ba:23,49141409,184,30,49141225,49141409
9411,6,12,1,2412,-57,-91,34,40:e3:d6:da:ba:24,49141637,176,52,49141461,49141637
9412,6,12,1,2412,-57,-91,34,40:e3:d6:da:ba:25,49141838,160,41,49141678,49141838
9413,6,6,1,2412,-57,-91,34,40:e3:d6:da:ba:26,49142048,380,-170,49141668,49142048
9414,4,1,1,2412,-85,-91,6,,49150552,304,8200,49150248,49150552
9415,6,6,1,2412,-61,-91,30,e6:aa:ea:c9:ea:33,49171311,408,20351,49170903,49171311
9416,6,6,1,2412,-62,-91,29,e6:aa:ea:c9:ea:33,49207668,408,35949,49207260,49207668
9417,6,6,1,2412,-61,-91,30,e6:aa:ea:c9:ea:33,49219833,408,11757,49219425,49219833
9418,4,1,1,2412,-80,-91,11,b8:3a:5a:88:e6:e0,49222536,2360,343,49220176,49222536
9419,6,12,1,2412,-57,-91,34,40:e3:d6:da:ba:20,49238635,160,15939,49238475,49238635
9420,6,6,1,2412,-57,-91,34,40:e3:d6:da:ba:21,49238836,368,-167,49238468,49238836
9421,6,12,1,2412,-56,-91,35,40:e3:d6:da:ba:22,49239232,180,216,49239052,49239232
9422,6,12,1,2412,-56,-91,35,40:e3:d6:da:ba:23,49239455,184,39,49239271,49239455
9423,6,12,1,2412,-56,-91,35,40:e3:d6:da:ba:24,49239692,176,61,49239516,49239692
9424,6,12,1,2412,-56,-91,35,40:e3:d6:da:ba:25,49239893,160,41,49239733,49239893
9425,6,6,1,2412,-56,-91,35,40:e3:d6:da:ba:26,49240085,380,-188,49239705,49240085
9426,4,1,1,2412,-88,-91,3,,49296873,304,56484,49296569,49296873
9427,4,1,1,2412,-79,-91,12,b8:3a:5a:88:e6:e1,49327335,2376,28086,49324959,49327335
9428,6,12,1,2412,-57,-91,34,40:e3:d6:da:ba:20,49341026,160,13531,49340866,49341026
9429,6,6,1,2412,-57,-91,34,40:e3:d6:da:ba:21,49341227,368,-167,49340859,49341227
9430,6,12,1,2412,-57,-91,34,40:e3:d6:da:ba:22,49341614,180,207,49341434,49341614
9431,6,12,1,2412,-56,-91,35,40:e3:d6:da:ba:23,49341820,184,22,49341636,49341820
9432,6,12,1,2412,-56,-91,35,40:e3:d6:da:ba:24,49342047,176,51,49341871,49342047
9433,6,12,1,2412,-57,-91,34,40:e3:d6:da:ba:25,49342266,160,59,49342106,49342266
9434,6,6,1,2412,-57,-91,34,40:e3:d6:da:ba:26,49342476,380,-170,49342096,49342476
9435,4,1,1,2412,-73,-91,18,,49344803,304,2023,49344499,49344803
9436,4,1,1,2412,-89,-91,2,,49374569,304,29462,49374265,49374569
9437,6,12,1,2412,-56,-91,35,40:e3:d6:da:ba:20,49443424,160,68695,49443264,49443424
9438,6,6,1,2412,-56,-91,35,40:e3:d6:da:ba:21,49443642,368,-150,49443274,49443642
9439,6,12,1,2412,-56,-91,35,40:e3:d6:da:ba:22,49444029,180,207,49443849,49444029
9440,6,12,1,2412,-56,-91,35,40:e3:d6:da:ba:23,49444244,184,31,49444060,49444244
9441,6,12,1,2412,-56,-91,35,40:e3:d6:da:ba:24,49444471,176,51,49444295,49444471
9442,6,12,1,2412,-56,-91,35,40:e3:d6:da:ba:25,49444700,160,69,49444540,49444700
9443,6,6,1,2412,-56,-91,35,40:e3:d6:da:ba:26,49444892,380,-188,49444512,49444892
9444,6,6,1,2412,-77,-91,14,e6:aa:ea:b7:4a:dd,49468039,408,22739,49467631,49468039
9445,6,6,1,2412,-53,-91,38,e6:aa:ea:c9:ea:33,49486316,408,17869,49485908,49486316
9446,6,6,1,2412,-77,-91,14,e6:aa:ea:b7:4a:dd,49492275,408,5551,49491867,49492275
9447,6,6,1,2412,-53,-91,38,e6:aa:ea:c9:ea:33,49498380,408,5697,49497972,49498380
9448,4,1,1,2412,-74,-91,17,54:e4:3a:ec:fb:64,49503157,2160,2617,49500997,49503157
9449,6,6,1,2412,-53,-91,38,e6:aa:ea:c9:ea:33,49511160,408,7595,49510752,49511160
9450,4,1,1,2412,-84,-91,7,,49514803,304,3339,49514499,49514803
9451,6,6,1,2412,-78,-91,13,e6:aa:ea:b7:4a:dd,49516512,408,1301,49516104,49516512
9452,6,6,1,2412,-53,-91,38,e6:aa:ea:c9:ea:33,49522653,408,5733,49522245,49522653
9453,4,1,1,2412,-80,-91,11,b8:3a:5a:88:e6:e0,49529753,2360,4740,49527393,49529753
9454,4,1,1,2412,-80,-91,11,b8:3a:5a:88:e6:e1,49532141,2376,12,49529765,49532141
9455,6,6,1,2412,-53,-91,38,e6:aa:ea:c9:ea:33,49534754,408,2205,49534346,49534754
9456,4,1,1,2412,-83,-91,8,c0:c9:e3:4d:6e:bf,49535386,872,-240,49534514,49535386
9457,4,1,1,2412,-86,-91,5,,49536275,304,585,49535971,49536275
9458,6,12,1,2412,-56,-91,35,40:e3:d6:da:ba:20,49545825,160,9390,49545665,49545825
9459,6,6,1,2412,-56,-91,35,40:e3:d6:da:ba:21,49546025,368,-168,49545657,49546025
9460,6,12,1,2412,-56,-91,35,40:e3:d6:da:ba:22,49546440,180,235,49546260,49546440
9461,6,12,1,2412,-55,-91,36,40:e3:d6:da:ba:24,49549180,176,2564,49549004,49549180
9462,6,12,1,2412,-55,-91,36,40:e3:d6:da:ba:25,49549408,160,68,49549248,49549408
9463,6,6,1,2412,-55,-91,36,40:e3:d6:da:ba:26,49549600,380,-188,49549220,49549600
9464,4,1,1,2412,-81,-91,10,c0:c9:e3:4d:6e:bf,49581161,872,30689,49580289,49581161
9465,4,1,1,2412,-85,-91,6,,49582050,304,585,49581746,49582050
9466,4,1,1,2412,-74,-91,17,54:e4:3a:ec:fb:64,49604480,2160,20270,49602320,49604480
9467,4,1,1,2412,-70,-91,21,b8:3a:5a:88:e6:e1,49634548,2376,27692,49632172,49634548
9468,6,12,1,2412,-58,-91,33,40:e3:d6:da:ba:20,49648246,160,13538,49648086,49648246
9469,6,6,1,2412,-58,-91,33,40:e3:d6:da:ba:21,49648447,368,-167,49648079,49648447
9470,6,12,1,2412,-57,-91,34,40:e3:d6:da:ba:22,49648861,180,234,49648681,49648861
9471,6,12,1,2412,-57,-91,34,40:e3:d6:da:ba:24,49649330,176,293,49649154,49649330
9472,6,12,1,2412,-57,-91,34,40:e3:d6:da:ba:25,49649549,160,59,49649389,49649549
9473,6,6,1,2412,-57,-91,34,40:e3:d6:da:ba:26,49649768,380,-161,49649388,49649768
9474,4,1,1,2412,-75,-91,16,54:e4:3a:ec:fb:64,49706905,2160,54977,49704745,49706905
9475,4,1,1,2412,-70,-91,21,b8:3a:5a:88:e6:e0,49734556,2360,25291,49732196,49734556
9476,4,1,1,2412,-76,-91,15,b8:3a:5a:88:e6:e1,49736936,2376,4,49734560,49736936
9477,4,1,1,2412,-85,-91,6,,49744286,304,7046,49743982,49744286
9478,6,6,1,2412,-55,-91,36,40:e3:d6:da:ba:21,49750864,368,6210,49750496,49750864
9479,6,12,1,2412,-55,-91,36,40:e3:d6:da:ba:22,49751269,180,225,49751089,49751269
9480,6,12,1,2412,-55,-91,36,40:e3:d6:da:ba:23,49751475,184,22,49751291,49751475
9481,6,12,1,2412,-55,-91,36,40:e3:d6:da:ba:24,49751684,176,33,49751508,49751684
9482,6,12,1,2412,-55,-91,36,40:e3:d6:da:ba:25,49751903,160,59,49751743,49751903
9483,6,6,1,2412,-55,-91,36,40:e3:d6:da:ba:26,49752104,380,-179,49751724,49752104
9484,4,1,1,2412,-80,-91,11,,49789425,304,37017,49789121,49789425
9485,4,1,1,2412,-80,-91,11,a6:e5:7c:28:b1:d3,49789980,944,-389,49789036,49789980
9486,4,1,1,2412,-91,-91,0,,49790938,304,654,49790634,49790938
9487,4,1,1,2412,-81,-91,10,a6:e5:7c:28:b1:d3,49796737,992,4807,49795745,49796737
9488,4,1,1,2412,-80,-91,11,,49830857,304,33816,49830553,49830857
9489,4,1,1,2412,-81,-91,10,a6:e5:7c:28:b1:d3,49832440,944,639,49831496,49832440
9490,4,1,1,2412,-81,-91,10,b8:3a:5a:88:e6:e0,49837168,2360,2368,49834808,49837168
9491,4,1,1,2412,-81,-91,10,b8:3a:5a:88:e6:e1,49839589,2376,45,49837213,49839589
9492,6,12,1,2412,-56,-91,35,40:e3:d6:da:ba:20,49853191,160,13442,49853031,49853191
9493,6,6,1,2412,-56,-91,35,40:e3:d6:da:ba:21,49853391,368,-168,49853023,49853391
9494,6,12,1,2412,-56,-91,35,40:e3:d6:da:ba:22,49853805,180,234,49853625,49853805
9495,6,12,1,2412,-56,-91,35,40:e3:d6:da:ba:23,49854011,184,22,49853827,49854011
9496,6,12,1,2412,-56,-91,35,40:e3:d6:da:ba:24,49854238,176,51,49854062,49854238
9497,6,6,1,2412,-56,-91,35,40:e3:d6:da:ba:26,49854650,380,32,49854270,49854650
9498,6,6,1,2412,-76,-91,15,e6:aa:ea:b7:4a:dd,49886036,408,30978,49885628,49886036
9499,6,6,1,2412,-76,-91,15,e6:aa:ea:b7:4a:dd,49898147,408,11703,49897739,49898147
9500,6,6,1,2412,-55,-91,36,e6:aa:ea:c9:ea:33,49904210,408,5655,49903802,49904210
9501,4,1,1,2412,-83,-91,8,a6:e5:7c:28:b1:d3,49906042,944,888,49905098,49906042
9502,4,1,1,2412,-82,-91,9,a6:e5:7c:28:b1:d3,49907156,944,170,49906212,49907156
9503,4,1,1,2412,-76,-91,15,a6:e5:7c:28:b1:d3,49908207,944,107,49907263,49908207
9504,4,1,1,2412,-82,-91,9,a6:e5:7c:28:b1:d3,49909276,944,125,49908332,49909276
9505,4,1,1,2412,-82,-91,9,a6:e5:7c:28:b1:d3,49914630,944,4410,49913686,49914630
9506,6,6,1,2412,-56,-91,35,e6:aa:ea:c9:ea:33,49916248,408,1210,49915840,49916248
9507,4,1,1,2412,-83,-91,8,a6:e5:7c:28:b1:d3,49916984,944,-208,49916040,49916984
9508,4,1,1,2412,-83,-91,8,a6:e5:7c:28:b1:d3,49918278,992,302,49917286,49918278
9509,6,6,1,2412,-77,-91,14,e6:aa:ea:b7:4a:dd,49922371,408,3685,49921963,49922371
9510,6,6,1,2412,-58,-91,33,e6:aa:ea:c9:ea:33,49928341,408,5562,49927933,49928341
9511,6,6,1,2412,-77,-91,14,e6:aa:ea:b7:4a:dd,49934492,408,5743,49934084,49934492
9512,4,1,1,2412,-78,-91,13,b8:3a:5a:88:e6:e1,49941771,2376,4903,49939395,49941771
9513,6,6,1,2412,-60,-91,31,e6:aa:ea:c9:ea:33,49952615,408,10436,49952207,49952615
9514,6,12,1,2412,-57,-91,34,40:e3:d6:da:ba:20,49955426,160,2651,49955266,49955426
9515,6,6,1,2412,-57,-91,34,40:e3:d6:da:ba:21,49955645,368,-149,49955277,49955645
9516,6,12,1,2412,-57,-91,34,40:e3:d6:da:ba:22,49956032,180,207,49955852,49956032
9517,6,12,1,2412,-57,-91,34,40:e3:d6:da:ba:23,49956237,184,21,49956053,49956237
9518,6,12,1,2412,-57,-91,34,40:e3:d6:da:ba:24,49956474,176,61,49956298,49956474
9519,6,12,1,2412,-57,-91,34,40:e3:d6:da:ba:25,49956702,160,68,49956542,49956702
9520,6,6,1,2412,-57,-91,34,40:e3:d6:da:ba:26,49956921,380,-161,49956541,49956921
9521,4,1,1,2412,-81,-91,10,a6:e5:7c:28:b1:d3,49998342,944,40477,49997398,49998342
9522,4,1,1,2412,-81,-91,10,a6:e5:7c:28:b1:d3,49999438,944,152,49998494,49999438
9523,4,1,1,2412,-81,-91,10,a6:e5:7c:28:b1:d3,50000543,944,161,49999599,50000543
9524,4,1,1,2412,-82,-91,9,a6:e5:7c:28:b1:d3,50001630,944,143,50000686,50001630
9525,4,1,1,2412,-81,-91,10,a6:e5:7c:28:b1:d3,50002904,944,330,50001960,50002904
9526,4,1,1,2412,-75,-91,16,a6:e5:7c:28:b1:d3,50005087,944,1239,50004143,50005087
9527,4,1,1,2412,-78,-91,13,a6:e5:7c:28:b1:d3,50006165,944,134,50005221,50006165
9528,4,1,1,2412,-83,-91,8,a6:e5:7c:28:b1:d3,50007350,944,241,50006406,50007350
9529,4,1,1,2412,-82,-91,9,a6:e5:7c:28:b1:d3,50008428,944,134,50007484,50008428
9530,4,1,1,2412,-84,-91,7,c0:c9:e3:4d:6e:bf,50027473,872,18173,50026601,50027473
9531,4,1,1,2412,-87,-91,4,,50028362,304,585,50028058,50028362
9532,6,12,1,2412,-56,-91,35,40:e3:d6:da:ba:20,50057835,160,29313,50057675,50057835
9533,6,6,1,2412,-56,-91,35,40:e3:d6:da:ba:21,50058036,368,-167,50057668,50058036
9534,6,12,1,2412,-56,-91,35,40:e3:d6:da:ba:22,50058432,180,216,50058252,50058432
9535,6,12,1,2412,-56,-91,35,40:e3:d6:da:ba:23,50058647,184,31,50058463,50058647
9536,6,12,1,2412,-56,-91,35,40:e3:d6:da:ba:24,50058883,176,60,50058707,50058883
9537,6,6,1,2412,-56,-91,35,40:e3:d6:da:ba:26,50059329,380,66,50058949,50059329
9538,4,1,1,2412,-74,-91,17,54:e4:3a:ec:fb:64,50116599,2160,55110,50114439,50116599
9539,4,1,1,2412,-80,-91,11,b8:3a:5a:88:e6:e1,50146527,2376,27552,50144151,50146527
9540,6,12,1,2412,-55,-91,36,40:e3:d6:da:ba:20,50160276,160,13589,50160116,50160276
9541,6,12,1,2412,-55,-91,36,40:e3:d6:da:ba:23,50161178,184,718,50160994,50161178
9542,6,12,1,2412,-55,-91,36,40:e3:d6:da:ba:24,50161396,176,42,50161220,50161396
9543,6,12,1,2412,-55,-91,36,40:e3:d6:da:ba:25,50161646,160,90,50161486,50161646
9544,6,6,1,2412,-55,-91,36,40:e3:d6:da:ba:26,50161847,380,-179,50161467,50161847
9545,4,1,1,2412,-78,-91,13,a6:e5:7c:28:b1:d3,50206260,992,43421,50205268,50206260
9546,4,1,1,2412,-75,-91,16,54:e4:3a:ec:fb:64,50219442,2160,11022,50217282,50219442
9547,4,1,1,2412,-73,-91,18,b8:3a:5a:88:e6:e0,50246530,2360,24728,50244170,50246530
9548,4,1,1,2412,-73,-91,18,b8:3a:5a:88:e6:e1,50248910,2376,4,50246534,50248910
9549,6,12,1,2412,-58,-91,33,40:e3:d6:da:ba:24,50263700,176,14614,50263524,50263700
9550,6,12,1,2412,-58,-91,33,40:e3:d6:da:ba:25,50263920,160,60,50263760,50263920
9551,6,6,1,2412,-81,-91,10,e6:aa:ea:b7:4a:dd,50303507,408,39179,50303099,50303507
9552,6,6,1,2412,-81,-91,10,e6:aa:ea:b7:4a:dd,50315441,408,11526,50315033,50315441
9553,4,1,1,2412,-76,-91,15,54:e4:3a:ec:fb:64,50321315,2160,3714,50319155,50321315
9554,6,6,1,2412,-81,-91,10,e6:aa:ea:b7:4a:dd,50327553,408,5830,50327145,50327553
9555,4,1,1,2412,-73,-91,18,b8:3a:5a:88:e6:e1,50351332,2376,21403,50348956,50351332
9556,6,12,1,2412,-57,-91,34,40:e3:d6:da:ba:20,50365040,160,13548,50364880,50365040
9557,6,6,1,2412,-57,-91,34,40:e3:d6:da:ba:21,50365259,368,-149,50364891,50365259
9558,6,12,1,2412,-57,-91,34,40:e3:d6:da:ba:22,50365645,180,206,50365465,50365645
9559,6,12,1,2412,-57,-91,34,40:e3:d6:da:ba:23,50365878,184,49,50365694,50365878
9560,6,12,1,2412,-57,-91,34,40:e3:d6:da:ba:24,50366097,176,43,50365921,50366097
9561,6,12,1,2412,-57,-91,34,40:e3:d6:da:ba:25,50366317,160,60,50366157,50366317
9562,6,6,1,2412,-57,-91,34,40:e3:d6:da:ba:26,50366509,380,-188,50366129,50366509
9563,6,6,1,2412,-62,-91,29,e6:aa:ea:c9:ea:33,50427629,408,60712,50427221,50427629
9564,6,6,1,2412,-62,-91,29,e6:aa:ea:c9:ea:33,50439732,408,11695,50439324,50439732
9565,4,1,1,2412,-74,-91,17,b8:3a:5a:88:e6:e1,50453730,2376,11622,50451354,50453730
9566,6,12,1,2412,-60,-91,31,40:e3:d6:da:ba:20,50467428,160,13538,50467268,50467428
9567,6,6,1,2412,-60,-91,31,40:e3:d6:da:ba:21,50467629,368,-167,50467261,50467629
9568,6,12,1,2412,-60,-91,31,40:e3:d6:da:ba:22,50468025,180,216,50467845,50468025
9569,6,12,1,2412,-59,-91,32,40:e3:d6:da:ba:23,50468231,184,22,50468047,50468231
9570,6,12,1,2412,-59,-91,32,40:e3:d6:da:ba:25,50468651,160,260,50468491,50468651
9571,6,6,1,2412,-60,-91,31,40:e3:d6:da:ba:26,50468842,380,-189,50468462,50468842
9572,4,1,1,2412,-76,-91,15,54:e4:3a:ec:fb:64,50526084,2160,55082,50523924,50526084
9573,4,1,1,2412,-71,-91,20,b8:3a:5a:88:e6:e0,50553880,2360,25436,50551520,50553880
9574,6,12,1,2412,-59,-91,32,40:e3:d6:da:ba:20,50569922,160,15882,50569762,50569922
9575,6,6,1,2412,-59,-91,32,40:e3:d6:da:ba:21,50570114,368,-176,50569746,50570114
9576,6,12,1,2412,-59,-91,32,40:e3:d6:da:ba:22,50570535,180,241,50570355,50570535
9577,6,12,1,2412,-59,-91,32,40:e3:d6:da:ba:23,50570749,184,30,50570565,50570749
9578,6,12,1,2412,-59,-91,32,40:e3:d6:da:ba:24,50570986,176,61,50570810,50570986
9579,6,12,1,2412,-59,-91,32,40:e3:d6:da:ba:25,50571214,160,68,50571054,50571214
9580,6,6,1,2412,-59,-91,32,40:e3:d6:da:ba:26,50571415,380,-179,50571035,50571415
9581,4,1,1,2412,-72,-91,19,b8:3a:5a:88:e6:e0,50656130,2360,82355,50653770,50656130
9582,4,1,1,2412,-73,-91,18,b8:3a:5a:88:e6:e1,50658518,2376,12,50656142,50658518
9583,6,6,1,2412,-59,-91,32,40:e3:d6:da:ba:21,50672450,368,13564,50672082,50672450
9584,6,12,1,2412,-59,-91,32,40:e3:d6:da:ba:23,50673042,184,408,50672858,50673042
9585,6,12,1,2412,-59,-91,32,40:e3:d6:da:ba:24,50673278,176,60,50673102,50673278
9586,6,12,1,2412,-60,-91,31,40:e3:d6:da:ba:25,50673507,160,69,50673347,50673507
9587,6,6,1,2412,-59,-91,32,40:e3:d6:da:ba:26,50673708,380,-179,50673328,50673708
9588,6,6,1,2412,-83,-91,8,84:1b:5e:df:1b:99,50695778,80,21990,50695698,50695778
9589,6,6,1,2412,-87,-91,4,,50695877,44,55,50695833,50695877
9590,4,1,1,2412,-74,-91,17,54:e4:3a:ec:fb:64,50730868,2160,32831,50728708,50730868
9591,4,1,1,2412,-72,-91,19,b8:3a:5a:88:e6:e0,50758546,2360,25318,50756186,50758546
9592,4,1,1,2412,-73,-91,18,b8:3a:5a:88:e6:e1,50761652,2376,730,50759276,50761652
9593,6,12,1,2412,-60,-91,31,40:e3:d6:da:ba:20,50774636,160,12824,50774476,50774636
9594,6,6,1,2412,-60,-91,31,40:e3:d6:da:ba:21,50774846,368,-158,50774478,50774846
9595,6,12,1,2412,-61,-91,30,40:e3:d6:da:ba:22,50775242,180,216,50775062,50775242
9596,6,12,1,2412,-59,-91,32,40:e3:d6:da:ba:23,50775474,184,48,50775290,50775474
9597,6,12,1,2412,-60,-91,31,40:e3:d6:da:ba:24,50775702,176,52,50775526,50775702
9598,6,12,1,2412,-60,-91,31,40:e3:d6:da:ba:25,50775930,160,68,50775770,50775930
9599,6,6,1,2412,-60,-91,31,40:e3:d6:da:ba:26,50776132,380,-178,50775752,50776132
9600,6,12,1,2412,-86,-91,5,84:d4:7e:f2:42:25,50776649,160,357,50776489,50776649
9601,6,6,1,2412,-83,-91,8,84:d4:7e:f2:42:26,50776868,380,-161,50776488,50776868
9602,6,6,1,2412,-75,-91,16,e6:aa:ea:b7:4a:dd,50824149,408,46873,50823741,50824149
9603,4,1,1,2412,-76,-91,15,54:e4:3a:ec:fb:64,50833306,2160,6997,50831146,50833306
9604,6,6,1,2412,-75,-91,16,e6:aa:ea:b7:4a:dd,50860506,408,26792,50860098,50860506
9605,4,1,1,2412,-72,-91,19,b8:3a:5a:88:e6:e0,50864780,2360,1914,50862420,50864780
9606,4,1,1,2412,-71,-91,20,b8:3a:5a:88:e6:e1,50867187,2376,31,50864811,50867187
9607,6,6,1,2412,-75,-91,16,e6:aa:ea:b7:4a:dd,50872622,408,5027,50872214,50872622
9608,6,12,1,2412,-60,-91,31,40:e3:d6:da:ba:20,50877536,160,4754,50877376,50877536
9609,6,12,1,2412,-59,-91,32,40:e3:d6:da:ba:22,50878142,180,426,50877962,50878142
9610,6,12,1,2412,-59,-91,32,40:e3:d6:da:ba:23,50878347,184,21,50878163,50878347
9611,6,12,1,2412,-59,-91,32,40:e3:d6:da:ba:24,50878565,176,42,50878389,50878565
9612,6,12,1,2412,-60,-91,31,40:e3:d6:da:ba:25,50878785,160,60,50878625,50878785
9613,6,6,1,2412,-59,-91,32,40:e3:d6:da:ba:26,50878986,380,-179,50878606,50878986
9614,6,6,1,2412,-56,-91,35,e6:aa:ea:c9:ea:33,50971304,408,91910,50970896,50971304
9615,6,12,1,2412,-60,-91,31,40:e3:d6:da:ba:20,50979432,160,7968,50979272,50979432
9616,6,6,1,2412,-59,-91,32,40:e3:d6:da:ba:21,50979624,368,-176,50979256,50979624
9617,6,12,1,2412,-60,-91,31,40:e3:d6:da:ba:22,50980011,180,207,50979831,50980011
9618,6,12,1,2412,-60,-91,31,40:e3:d6:da:ba:23,50980216,184,21,50980032,50980216
9619,6,12,1,2412,-59,-91,32,40:e3:d6:da:ba:24,50980426,176,34,50980250,50980426
9620,6,12,1,2412,-59,-91,32,40:e3:d6:da:ba:25,50980645,160,59,50980485,50980645
9621,6,6,1,2412,-60,-91,31,40:e3:d6:da:ba:26,50980864,380,-161,50980484,50980864
9622,6,6,1,2412,-56,-91,35,e6:aa:ea:c9:ea:33,50983459,408,2187,50983051,50983459
9623,6,6,1,2412,-56,-91,35,e6:aa:ea:c9:ea:33,50995549,408,11682,50995141,50995549
9624,4,1,1,2412,-81,-91,10,c0:c9:e3:4d:6e:bf,51008306,872,11885,51007434,51008306
9625,4,1,1,2412,-74,-91,17,b8:3a:5a:88:e6:e0,51065751,2360,55085,51063391,51065751
9626,4,1,1,2412,-74,-91,17,b8:3a:5a:88:e6:e1,51068149,2376,22,51065773,51068149
9627,6,12,1,2412,-59,-91,32,40:e3:d6:da:ba:20,51081843,160,13534,51081683,51081843
9628,6,6,1,2412,-59,-91,32,40:e3:d6:da:ba:21,51082034,368,-177,51081666,51082034
9629,6,12,1,2412,-59,-91,32,40:e3:d6:da:ba:22,51082430,180,216,51082250,51082430
9630,6,12,1,2412,-59,-91,32,40:e3:d6:da:ba:23,51082654,184,40,51082470,51082654
9631,6,12,1,2412,-59,-91,32,40:e3:d6:da:ba:24,51082863,176,33,51082687,51082863
9632,6,12,1,2412,-59,-91,32,40:e3:d6:da:ba:25,51083092,160,69,51082932,51083092
9633,6,6,1,2412,-59,-91,32,40:e3:d6:da:ba:26,51083311,380,-161,51082931,51083311
9634,6,12,1,2412,-87,-91,4,84:d4:7e:f2:42:25,51083887,160,416,51083727,51083887
9635,4,1,1,2412,-75,-91,16,54:e4:3a:ec:fb:64,51140518,2160,54471,51138358,51140518
9636,4,1,1,2412,-75,-91,16,b8:3a:5a:88:e6:e0,51168132,2360,25254,51165772,51168132
9637,4,1,1,2412,-75,-91,16,b8:3a:5a:88:e6:e1,51170521,2376,13,51168145,51170521
9638,6,6,1,2412,-78,-91,13,78:8a:20:fa:27:f9,51183772,88,13163,51183684,51183772
9639,6,12,1,2412,-77,-91,14,,51184155,32,351,51184123,51184155
9640,6,12,1,2412,-60,-91,31,40:e3:d6:da:ba:20,51184231,160,-84,51184071,51184231
9641,6,6,1,2412,-60,-91,31,40:e3:d6:da:ba:21,51184441,368,-158,51184073,51184441
9642,6,12,1,2412,-87,-91,4,84:d4:7e:f2:42:25,51189188,160,4587,51189028,51189188
9643,6,12,1,2412,-60,-91,31,40:e3:d6:da:ba:25,51189453,160,105,51189293,51189453
9644,6,6,1,2412,-60,-91,31,40:e3:d6:da:ba:26,51189663,380,-170,51189283,51189663
9645,6,12,1,2412,-88,-91,3,84:d4:7e:f2:42:25,51190249,140,446,51190109,51190249
9646,6,6,1,2412,-76,-91,15,78:8a:20:fa:27:f9,51234050,88,43713,51233962,51234050
9647,4,1,1,2412,-76,-91,15,b8:3a:5a:88:e6:e0,51234552,2240,-1738,51232312,51234552
9648,4,1,1,2412,-77,-91,14,b8:3a:5a:88:e6:e1,51236821,2256,13,51234565,51236821
9649,4,1,1,2412,-74,-91,17,54:e4:3a:ec:fb:64,51242884,2160,3903,51240724,51242884
9650,4,1,1,2412,-78,-91,13,b8:3a:5a:88:e6:e0,51270540,2360,25296,51268180,51270540
9651,4,1,1,2412,-74,-91,17,b8:3a:5a:88:e6:e1,51272920,2376,4,51270544,51272920
9652,6,12,1,2412,-62,-91,29,40:e3:d6:da:ba:20,51286685,160,13605,51286525,51286685
9653,6,6,1,2412,-62,-91,29,40:e3:d6:da:ba:21,51286876,368,-177,51286508,51286876
9654,6,12,1,2412,-62,-91,29,40:e3:d6:da:ba:22,51287290,180,234,51287110,51287290
9655,6,12,1,2412,-62,-91,29,40:e3:d6:da:ba:23,51287496,184,22,51287312,51287496
9656,6,6,1,2412,-62,-91,29,40:e3:d6:da:ba:26,51290235,380,2359,51289855,51290235
9657,4,1,1,2412,-77,-91,14,b8:3a:5a:88:e6:e0,51300254,2240,7779,51298014,51300254
9658,4,1,1,2412,-78,-91,13,b8:3a:5a:88:e6:e1,51302523,2256,13,51300267,51302523
9659,6,6,1,2412,-82,-91,9,e6:aa:ea:b7:4a:dd,51344569,408,41638,51344161,51344569
9660,4,1,1,2412,-72,-91,19,54:e4:3a:ec:fb:64,51345553,2160,-1176,51343393,51345553
9661,6,6,1,2412,-81,-91,10,e6:aa:ea:b7:4a:dd,51356693,408,10732,51356285,51356693
9662,6,6,1,2412,-58,-91,33,e6:aa:ea:c9:ea:33,51364473,408,7372,51364065,51364473
9663,6,6,1,2412,-81,-91,10,e6:aa:ea:b7:4a:dd,51368811,408,3930,51368403,51368811
9664,4,1,1,2412,-77,-91,14,b8:3a:5a:88:e6:e0,51373361,2360,2190,51371001,51373361
9665,6,12,1,2412,-62,-91,29,40:e3:d6:da:ba:22,51375599,156,2082,51375443,51375599
9666,6,12,1,2412,-62,-91,29,40:e3:d6:da:ba:25,51378060,136,2325,51377924,51378060
9667,6,6,1,2412,-57,-91,34,e6:aa:ea:c9:ea:33,51388691,408,10223,51388283,51388691
9668,6,12,1,2412,-62,-91,29,40:e3:d6:da:ba:20,51389137,160,286,51388977,51389137
9669,6,6,1,2412,-62,-91,29,40:e3:d6:da:ba:21,51389337,368,-168,51388969,51389337
9670,6,12,1,2412,-62,-91,29,40:e3:d6:da:ba:22,51389742,180,225,51389562,51389742
9671,6,12,1,2412,-62,-91,29,40:e3:d6:da:ba:23,51389957,184,31,51389773,51389957
9672,6,12,1,2412,-62,-91,29,40:e3:d6:da:ba:24,51390166,176,33,51389990,51390166
9673,6,12,1,2412,-62,-91,29,40:e3:d6:da:ba:25,51390395,160,69,51390235,51390395
9674,6,6,1,2412,-62,-91,29,40:e3:d6:da:ba:26,51390596,380,-179,51390216,51390596
9675,6,6,1,2412,-57,-91,34,e6:aa:ea:c9:ea:33,51400809,408,9805,51400401,51400809
9676,6,6,1,2412,-57,-91,34,e6:aa:ea:c9:ea:33,51412937,408,11720,51412529,51412937
9677,6,12,1,2412,-61,-91,30,40:e3:d6:da:ba:20,51491433,160,78336,51491273,51491433
9678,6,6,1,2412,-61,-91,30,40:e3:d6:da:ba:21,51491625,368,-176,51491257,51491625
9679,6,12,1,2412,-60,-91,31,40:e3:d6:da:ba:22,51492030,180,225,51491850,51492030
9680,6,12,1,2412,-60,-91,31,40:e3:d6:da:ba:23,51492262,184,48,51492078,51492262
9681,6,12,1,2412,-60,-91,31,40:e3:d6:da:ba:24,51492490,176,52,51492314,51492490
9682,6,12,1,2412,-60,-91,31,40:e3:d6:da:ba:25,51492709,160,59,51492549,51492709
9683,4,1,1,2412,-78,-91,13,b8:3a:5a:88:e6:e1,51525391,2256,30426,51523135,51525391
9684,4,1,1,2412,-76,-91,15,54:e4:3a:ec:fb:64,51550126,2160,22575,51547966,51550126
9685,6,12,1,2412,-58,-91,33,40:e3:d6:da:ba:20,51593834,160,43548,51593674,51593834
9686,6,6,1,2412,-58,-91,33,40:e3:d6:da:ba:21,51594044,368,-158,51593676,51594044
9687,6,12,1,2412,-58,-91,33,40:e3:d6:da:ba:22,51594440,180,216,51594260,51594440
9688,6,12,1,2412,-58,-91,33,40:e3:d6:da:ba:23,51594645,184,21,51594461,51594645
9689,6,12,1,2412,-58,-91,33,40:e3:d6:da:ba:24,51594863,176,42,51594687,51594863
9690,6,12,1,2412,-58,-91,33,40:e3:d6:da:ba:25,51595065,160,42,51594905,51595065
9691,6,6,1,2412,-58,-91,33,40:e3:d6:da:ba:26,51595257,380,-188,51594877,51595257
9692,4,1,1,2412,-80,-91,11,b8:3a:5a:88:e6:e0,51680150,2360,82533,51677790,51680150
9693,6,12,1,2412,-60,-91,31,40:e3:d6:da:ba:20,51696259,160,15949,51696099,51696259
9694,6,6,1,2412,-60,-91,31,40:e3:d6:da:ba:21,51696460,368,-167,51696092,51696460
9695,6,12,1,2412,-60,-91,31,40:e3:d6:da:ba:22,51696865,180,225,51696685,51696865
9696,6,12,1,2412,-60,-91,31,40:e3:d6:da:ba:23,51697079,184,30,51696895,51697079
9697,6,12,1,2412,-59,-91,32,40:e3:d6:da:ba:24,51697307,176,52,51697131,51697307
9698,6,12,1,2412,-59,-91,32,40:e3:d6:da:ba:25,51697517,160,50,51697357,51697517
9699,6,6,1,2412,-60,-91,31,40:e3:d6:da:ba:26,51697736,380,-161,51697356,51697736
9700,4,1,1,2412,-77,-91,14,54:e4:3a:ec:fb:64,51700099,2112,251,51697987,51700099
9701,4,1,1,2412,-90,-91,1,,51702229,304,1826,51701925,51702229
9702,6,12,1,2412,-60,-91,31,40:e3:d6:da:ba:20,51702393,136,28,51702257,51702393
9703,6,6,1,2412,-60,-91,31,40:e3:d6:da:ba:21,51702588,348,-153,51702240,51702588
9704,6,12,1,2412,-60,-91,31,40:e3:d6:da:ba:22,51702982,156,238,51702826,51702982
9705,6,12,1,2412,-60,-91,31,40:e3:d6:da:ba:23,51703199,156,61,51703043,51703199
9706,6,12,1,2412,-60,-91,31,40:e3:d6:da:ba:25,51703398,136,63,51703262,51703398
9707,4,1,1,2412,-87,-91,4,,51706504,304,2802,51706200,51706504
9708,4,1,1,2412,-75,-91,16,b8:3a:5a:88:e6:e0,51782540,2360,73676,51780180,51782540
9709,6,6,1,2412,-55,-91,36,e6:aa:ea:c9:ea:33,51794002,408,11054,51793594,51794002
9710,6,12,1,2412,-63,-91,28,40:e3:d6:da:ba:20,51798660,160,4498,51798500,51798660
9711,6,6,1,2412,-63,-91,28,40:e3:d6:da:ba:21,51798879,368,-149,51798511,51798879
9712,6,12,1,2412,-63,-91,28,40:e3:d6:da:ba:22,51799293,180,234,51799113,51799293
9713,6,12,1,2412,-63,-91,28,40:e3:d6:da:ba:23,51799516,184,39,51799332,51799516
9714,6,12,1,2412,-63,-91,28,40:e3:d6:da:ba:24,51799726,176,34,51799550,51799726
9715,6,12,1,2412,-63,-91,28,40:e3:d6:da:ba:25,51799945,160,59,51799785,51799945
9716,6,6,1,2412,-63,-91,28,40:e3:d6:da:ba:26,51800164,380,-161,51799784,51800164
9717,6,6,1,2412,-55,-91,36,e6:aa:ea:c9:ea:33,51806072,408,5500,51805664,51806072
9718,6,6,1,2412,-55,-91,36,e6:aa:ea:c9:ea:33,51818105,408,11625,51817697,51818105
9719,6,6,1,2412,-55,-91,36,e6:aa:ea:c9:ea:33,51830398,408,11885,51829990,51830398
9720,6,6,1,2412,-81,-91,10,e6:aa:ea:b7:4a:dd,51864487,408,33681,51864079,51864487
9721,6,6,1,2412,-81,-91,10,e6:aa:ea:b7:4a:dd,51876630,408,11735,51876222,51876630
9722,4,1,1,2412,-76,-91,15,b8:3a:5a:88:e6:e0,51884932,2360,5942,51882572,51884932
9723,4,1,1,2412,-75,-91,16,b8:3a:5a:88:e6:e1,51887339,2376,31,51884963,51887339
9724,6,12,1,2412,-62,-91,29,40:e3:d6:da:ba:20,51901275,160,13776,51901115,51901275
9725,6,6,1,2412,-62,-91,29,40:e3:d6:da:ba:21,51901476,368,-167,51901108,51901476
9726,6,12,1,2412,-62,-91,29,40:e3:d6:da:ba:22,51901872,180,216,51901692,51901872
9727,6,12,1,2412,-62,-91,29,40:e3:d6:da:ba:23,51902087,184,31,51901903,51902087
9728,6,12,1,2412,-62,-91,29,40:e3:d6:da:ba:24,51902323,176,60,51902147,51902323
9729,6,12,1,2412,-62,-91,29,40:e3:d6:da:ba:25,51902552,160,69,51902392,51902552
9730,6,6,1,2412,-62,-91,29,40:e3:d6:da:ba:26,51902771,380,-161,51902391,51902771
9731,6,6,1,2412,-89,-91,2,84:d4:7e:f2:42:26,51903288,380,137,51902908,51903288
9732,6,6,1,2412,-77,-91,14,e6:aa:ea:b7:4a:dd,51912946,408,9250,51912538,51912946
9733,4,1,1,2412,-59,-91,32,a6:e5:7c:28:b1:d3,51946952,992,33014,51945960,51946952
9734,4,1,1,2412,-79,-91,12,b8:3a:5a:88:e6:e0,51981875,2240,32683,51979635,51981875
9735,4,1,1,2412,-81,-91,10,b8:3a:5a:88:e6:e1,51984144,2256,13,51981888,51984144
9736,4,1,1,2412,-81,-91,10,b8:3a:5a:88:e6:e0,51999872,2240,13488,51997632,51999872
9737,6,12,1,2412,-60,-91,31,40:e3:d6:da:ba:20,52003461,160,3429,52003301,52003461
9738,6,6,1,2412,-60,-91,31,40:e3:d6:da:ba:21,52003662,368,-167,52003294,52003662
9739,6,12,1,2412,-60,-91,31,40:e3:d6:da:ba:25,52006137,160,2315,52005977,52006137
9740,6,6,1,2412,-60,-91,31,40:e3:d6:da:ba:26,52006329,380,-188,52005949,52006329
9741,6,12,1,2412,-87,-91,4,84:d4:7e:f2:42:24,52007136,176,631,52006960,52007136
9742,4,1,1,2412,-83,-91,8,,52029239,304,21799,52028935,52029239
9743,4,1,1,2412,-83,-91,8,a4:e5:7c:28:b1:d3,52069897,688,39970,52069209,52069897
9744,4,1,1,2412,-79,-91,12,c0:c9:e3:4d:6e:bf,52074523,872,3754,52073651,52074523
9745,4,1,1,2412,-84,-91,7,,52075411,304,584,52075107,52075411
9746,6,12,1,2412,-59,-91,32,40:e3:d6:da:ba:20,52105837,160,30266,52105677,52105837
9747,6,6,1,2412,-59,-91,32,40:e3:d6:da:ba:21,52106029,368,-176,52105661,52106029
9748,6,12,1,2412,-59,-91,32,40:e3:d6:da:ba:22,52106443,180,234,52106263,52106443
9749,6,12,1,2412,-59,-91,32,40:e3:d6:da:ba:23,52106675,184,48,52106491,52106675
9750,6,12,1,2412,-59,-91,32,40:e3:d6:da:ba:24,52106903,176,52,52106727,52106903
9751,6,12,1,2412,-59,-91,32,40:e3:d6:da:ba:25,52107113,160,50,52106953,52107113
9752,6,6,1,2412,-59,-91,32,40:e3:d6:da:ba:26,52107332,380,-161,52106952,52107332
9753,4,1,1,2412,-86,-91,5,a6:e5:7c:28:b1:d3,52151334,992,43010,52150342,52151334
9754,4,1,1,2412,-90,-91,1,,52162067,304,10429,52161763,52162067
9755,4,1,1,2412,-58,-91,33,b8:3a:5a:88:e6:e1,52194522,2376,30079,52192146,52194522
9756,6,12,1,2412,-57,-91,34,40:e3:d6:da:ba:20,52208237,160,13555,52208077,52208237
9757,6,12,1,2412,-57,-91,34,40:e3:d6:da:ba:22,52208870,180,453,52208690,52208870
9758,6,12,1,2412,-57,-91,34,40:e3:d6:da:ba:24,52209294,176,248,52209118,52209294
9759,6,12,1,2412,-57,-91,34,40:e3:d6:da:ba:25,52209514,160,60,52209354,52209514
9760,6,6,1,2412,-57,-91,34,40:e3:d6:da:ba:26,52209715,380,-179,52209335,52209715
9761,4,1,1,2412,-81,-91,10,a6:e5:7c:28:b1:d3,52254523,992,43816,52253531,52254523
9762,4,1,1,2412,-76,-91,15,54:e4:3a:ec:fb:64,52266994,2160,10311,52264834,52266994
9763,6,6,1,2412,-77,-91,14,e6:aa:ea:b7:4a:dd,52281878,408,14476,52281470,52281878
9764,6,6,1,2412,-77,-91,14,e6:aa:ea:b7:4a:dd,52293993,408,11707,52293585,52293993
9765,4,1,1,2412,-79,-91,12,b8:3a:5a:88:e6:e0,52294545,2360,-1808,52292185,52294545
9766,4,1,1,2412,-80,-91,11,b8:3a:5a:88:e6:e1,52296952,2376,31,52294576,52296952
9767,6,6,1,2412,-63,-91,28,e6:aa:ea:c9:ea:33,52301918,408,4558,52301510,52301918
9768,6,6,1,2412,-77,-91,14,e6:aa:ea:b7:4a:dd,52306097,408,3771,52305689,52306097
9769,6,12,1,2412,-59,-91,32,40:e3:d6:da:ba:20,52310636,160,4379,52310476,52310636
9770,6,6,1,2412,-59,-91,32,40:e3:d6:da:ba:21,52310855,368,-149,52310487,52310855
9771,6,12,1,2412,-59,-91,32,40:e3:d6:da:ba:22,52311251,180,216,52311071,52311251
9772,6,12,1,2412,-59,-91,32,40:e3:d6:da:ba:23,52311457,184,22,52311273,52311457
9773,6,6,1,2412,-77,-91,14,e6:aa:ea:b7:4a:dd,52318225,408,6360,52317817,52318225
9774,6,6,1,2412,-62,-91,29,e6:aa:ea:c9:ea:33,52338260,408,19627,52337852,52338260
9775,6,6,1,2412,-61,-91,30,e6:aa:ea:c9:ea:33,52350362,408,11694,52349954,52350362
9776,4,1,1,2412,-76,-91,15,54:e4:3a:ec:fb:64,52369358,2160,16836,52367198,52369358
9777,6,12,1,2412,-61,-91,30,40:e3:d6:da:ba:20,52413045,160,43527,52412885,52413045
9778,6,6,1,2412,-61,-91,30,40:e3:d6:da:ba:21,52413263,368,-150,52412895,52413263
9779,6,12,1,2412,-61,-91,30,40:e3:d6:da:ba:22,52413650,180,207,52413470,52413650
9780,6,12,1,2412,-61,-91,30,40:e3:d6:da:ba:23,52413865,184,31,52413681,52413865
9781,6,12,1,2412,-61,-91,30,40:e3:d6:da:ba:25,52414276,160,251,52414116,52414276
9782,6,6,1,2412,-61,-91,30,40:e3:d6:da:ba:26,52414485,380,-171,52414105,52414485
9783,6,12,1,2412,-60,-91,31,40:e3:d6:da:ba:20,52515449,160,100804,52515289,52515449
9784,6,6,1,2412,-60,-91,31,40:e3:d6:da:ba:21,52515659,368,-158,52515291,52515659
9785,6,12,1,2412,-61,-91,30,40:e3:d6:da:ba:22,52516064,180,225,52515884,52516064
9786,6,12,1,2412,-61,-91,30,40:e3:d6:da:ba:23,52516288,184,40,52516104,52516288
9787,6,12,1,2412,-61,-91,30,40:e3:d6:da:ba:25,52516734,160,286,52516574,52516734
9788,4,1,1,2412,-79,-91,12,,52524692,304,7654,52524388,52524692
9789,4,1,1,2412,-91,-91,0,,52568923,304,43927,52568619,52568923
9790,4,1,1,2412,-81,-91,10,b8:3a:5a:88:e6:e1,52604770,2376,33471,52602394,52604770
9791,6,12,1,2412,-61,-91,30,40:e3:d6:da:ba:20,52617847,160,12917,52617687,52617847
9792,6,6,1,2412,-61,-91,30,40:e3:d6:da:ba:21,52618066,368,-149,52617698,52618066
9793,6,12,1,2412,-61,-91,30,40:e3:d6:da:ba:22,52618462,180,216,52618282,52618462
9794,6,12,1,2412,-61,-91,30,40:e3:d6:da:ba:23,52618694,184,48,52618510,52618694
9795,6,12,1,2412,-61,-91,30,40:e3:d6:da:ba:24,52618912,176,42,52618736,52618912
9796,6,12,1,2412,-60,-91,31,40:e3:d6:da:ba:25,52619132,160,60,52618972,52619132
9797,6,6,1,2412,-61,-91,30,40:e3:d6:da:ba:26,52619333,380,-179,52618953,52619333
9798,4,1,1,2412,-76,-91,15,54:e4:3a:ec:fb:64,52676529,2160,55036,52674369,52676529
9799,6,6,1,2412,-81,-91,10,e6:aa:ea:b7:4a:dd,52700098,408,23161,52699690,52700098
9800,4,1,1,2412,-80,-91,11,b8:3a:5a:88:e6:e0,52704401,2360,1943,52702041,52704401
9801,4,1,1,2412,-79,-91,12,b8:3a:5a:88:e6:e1,52706808,2376,31,52704432,52706808
9802,6,6,1,2412,-82,-91,9,e6:aa:ea:b7:4a:dd,52712220,408,5004,52711812,52712220
9803,6,12,1,2412,-62,-91,29,40:e3:d6:da:ba:20,52720238,160,7858,52720078,52720238
9804,6,6,1,2412,-61,-91,30,40:e3:d6:da:ba:21,52720457,368,-149,52720089,52720457
9805,6,12,1,2412,-61,-91,30,40:e3:d6:da:ba:22,52720853,180,216,52720673,52720853
9806,6,12,1,2412,-61,-91,30,40:e3:d6:da:ba:23,52721068,184,31,52720884,52721068
9807,6,6,1,2412,-61,-91,30,40:e3:d6:da:ba:26,52721707,380,259,52721327,52721707
9808,6,6,1,2412,-82,-91,9,e6:aa:ea:b7:4a:dd,52724345,408,2230,52723937,52724345
9809,6,6,1,2412,-82,-91,9,e6:aa:ea:b7:4a:dd,52736463,408,11710,52736055,52736463
9810,6,6,1,2412,-81,-91,10,e6:aa:ea:b7:4a:dd,52748582,408,11711,52748174,52748582
9811,4,1,1,2412,-61,-91,30,54:e4:3a:ec:fb:64,52778955,2160,28213,52776795,52778955
9812,6,6,1,2412,-58,-91,33,e6:aa:ea:c9:ea:33,52822062,408,42699,52821654,52822062
9813,6,12,1,2412,-60,-91,31,40:e3:d6:da:ba:20,52822643,160,421,52822483,52822643
9814,6,6,1,2412,-59,-91,32,40:e3:d6:da:ba:21,52822852,368,-159,52822484,52822852
9815,6,12,1,2412,-59,-91,32,40:e3:d6:da:ba:22,52823239,180,207,52823059,52823239
9816,6,12,1,2412,-59,-91,32,40:e3:d6:da:ba:23,52823472,184,49,52823288,52823472
9817,6,12,1,2412,-59,-91,32,40:e3:d6:da:ba:24,52823690,176,42,52823514,52823690
9818,6,12,1,2412,-59,-91,32,40:e3:d6:da:ba:25,52823891,160,41,52823731,52823891
9819,6,6,1,2412,-59,-91,32,40:e3:d6:da:ba:26,52824084,380,-187,52823704,52824084
9820,6,6,1,2412,-58,-91,33,e6:aa:ea:c9:ea:33,52834158,408,9666,52833750,52834158
9821,6,6,1,2412,-58,-91,33,e6:aa:ea:c9:ea:33,52846295,408,11729,52845887,52846295
9822,6,6,1,2412,-58,-91,33,e6:aa:ea:c9:ea:33,52870501,408,23798,52870093,52870501
9823,4,1,1,2412,-73,-91,18,54:e4:3a:ec:fb:64,52881346,2160,8685,52879186,52881346
9824,6,12,1,2412,-58,-91,33,40:e3:d6:da:ba:20,52925065,160,43559,52924905,52925065
9825,6,6,1,2412,-58,-91,33,40:e3:d6:da:ba:21,52925265,368,-168,52924897,52925265
9826,6,12,1,2412,-59,-91,32,40:e3:d6:da:ba:22,52925653,180,208,52925473,52925653
9827,6,12,1,2412,-58,-91,33,40:e3:d6:da:ba:23,52925858,184,21,52925674,52925858
9828,6,12,1,2412,-58,-91,33,40:e3:d6:da:ba:24,52926094,176,60,52925918,52926094
9829,6,12,1,2412,-58,-91,33,40:e3:d6:da:ba:25,52926296,160,42,52926136,52926296
9830,6,6,1,2412,-58,-91,33,40:e3:d6:da:ba:26,52926497,380,-179,52926117,52926497
9831,4,1,1,2412,-73,-91,18,54:e4:3a:ec:fb:64,52983783,2160,55126,52981623,52983783
9832,4,1,1,2412,-79,-91,12,b8:3a:5a:88:e6:e0,53011339,2360,25196,53008979,53011339
9833,6,6,1,2412,-81,-91,10,e6:aa:ea:b7:4a:dd,53016045,408,4298,53015637,53016045
9834,4,1,1,2412,-83,-91,8,c0:c9:e3:4d:6e:bf,53016530,872,-387,53015658,53016530
9835,4,1,1,2412,-87,-91,4,,53017419,304,585,53017115,53017419
9836,6,12,1,2412,-58,-91,33,40:e3:d6:da:ba:20,53027447,160,9868,53027287,53027447
9837,6,6,1,2412,-58,-91,33,40:e3:d6:da:ba:21,53027648,368,-167,53027280,53027648
9838,6,12,1,2412,-58,-91,33,40:e3:d6:da:ba:22,53028053,180,225,53027873,53028053
9839,6,12,1,2412,-58,-91,33,40:e3:d6:da:ba:23,53028277,184,40,53028093,53028277
9840,6,12,1,2412,-57,-91,34,40:e3:d6:da:ba:24,53028513,176,60,53028337,53028513
9841,6,12,1,2412,-58,-91,33,40:e3:d6:da:ba:25,53028742,160,69,53028582,53028742
9842,6,6,1,2412,-58,-91,33,40:e3:d6:da:ba:26,53028961,380,-161,53028581,53028961
9843,6,6,1,2412,-80,-91,11,e6:aa:ea:b7:4a:dd,53029738,408,369,53029330,53029738
9844,4,1,1,2412,-88,-91,3,,53061155,304,31113,53060851,53061155
9845,6,6,1,2412,-80,-91,11,e6:aa:ea:b7:4a:dd,53064538,408,2975,53064130,53064538
9846,4,1,1,2412,-85,-91,6,a6:e5:7c:28:b1:d3,53073102,992,7572,53072110,53073102
9847,6,6,1,2412,-87,-91,4,e6:aa:ea:c9:ea:1b,53108196,408,34686,53107788,53108196
9848,4,1,1,2412,-80,-91,11,b8:3a:5a:88:e6:e0,53113740,2360,3184,53111380,53113740
9849,4,1,1,2412,-74,-91,17,b8:3a:5a:88:e6:e1,53116147,2376,31,53113771,53116147
9850,6,12,1,2412,-57,-91,34,40:e3:d6:da:ba:20,53129862,160,13555,53129702,53129862
9851,6,6,1,2412,-58,-91,33,40:e3:d6:da:ba:21,53130063,368,-167,53129695,53130063
9852,6,12,1,2412,-58,-91,33,40:e3:d6:da:ba:22,53130478,180,235,53130298,53130478
9853,6,12,1,2412,-58,-91,33,40:e3:d6:da:ba:23,53130683,184,21,53130499,53130683
9854,6,12,1,2412,-58,-91,33,40:e3:d6:da:ba:24,53130892,176,33,53130716,53130892
9855,6,12,1,2412,-58,-91,33,40:e3:d6:da:ba:25,53131121,160,69,53130961,53131121
9856,6,6,1,2412,-58,-91,33,40:e3:d6:da:ba:26,53131313,380,-188,53130933,53131313
9857,4,5.5,1,2412,-80,-91,11,,53171140,213,39614,53170927,53171140
9858,4,1,1,2412,-73,-91,18,54:e4:3a:ec:fb:64,53188602,2160,15302,53186442,53188602
9859,6,12,1,2412,-56,-91,35,40:e3:d6:da:ba:23,53233117,184,44331,53232933,53233117
9860,6,12,1,2412,-59,-91,32,40:e3:d6:da:ba:24,53233353,176,60,53233177,53233353
9861,6,6,1,2412,-59,-91,32,40:e3:d6:da:ba:26,53233764,380,31,53233384,53233764
9862,6,6,1,2412,-56,-91,35,e6:aa:ea:c9:ea:33,53252350,408,18178,53251942,53252350
9863,6,6,1,2412,-56,-91,35,e6:aa:ea:c9:ea:33,53264467,408,11709,53264059,53264467
9864,4,1,1,2412,-79,-91,12,b8:3a:5a:88:e6:e0,53284018,2240,17311,53281778,53284018
9865,4,1,1,2412,-73,-91,18,54:e4:3a:ec:fb:64,53290964,2160,4786,53288804,53290964
9866,4,1,1,2412,-78,-91,13,b8:3a:5a:88:e6:e0,53318546,2360,25222,53316186,53318546
9867,6,6,1,2412,-79,-91,12,e6:aa:ea:b7:4a:dd,53355213,408,36259,53354805,53355213
9868,6,6,1,2412,-81,-91,10,e6:aa:ea:b7:4a:dd,53379448,408,23827,53379040,53379448
9869,4,1,1,2412,-75,-91,16,54:e4:3a:ec:fb:64,53393337,2160,11729,53391177,53393337
9870,4,1,1,2412,-78,-91,13,b8:3a:5a:88:e6:e0,53420937,2360,25240,53418577,53420937
9871,6,12,1,2412,-58,-91,33,40:e3:d6:da:ba:20,53437057,160,15960,53436897,53437057
9872,6,12,1,2412,-58,-91,33,40:e3:d6:da:ba:22,53437663,180,426,53437483,53437663
9873,6,12,1,2412,-58,-91,33,40:e3:d6:da:ba:23,53437878,184,31,53437694,53437878
9874,6,12,1,2412,-58,-91,33,40:e3:d6:da:ba:24,53438114,176,60,53437938,53438114
9875,6,12,1,2412,-58,-91,33,40:e3:d6:da:ba:25,53438325,160,51,53438165,53438325
9876,6,6,1,2412,-57,-91,34,40:e3:d6:da:ba:26,53438535,380,-170,53438155,53438535
9877,4,1,1,2412,-82,-91,9,a6:e5:7c:28:b1:d3,53482497,992,42970,53481505,53482497
9878,6,12,1,2412,-58,-91,33,40:e3:d6:da:ba:20,53539441,160,56784,53539281,53539441
9879,6,6,1,2412,-58,-91,33,40:e3:d6:da:ba:21,53539642,368,-167,53539274,53539642
9880,6,12,1,2412,-58,-91,33,40:e3:d6:da:ba:22,53540056,180,234,53539876,53540056
9881,6,12,1,2412,-58,-91,33,40:e3:d6:da:ba:25,53540727,160,511,53540567,53540727
9882,4,1,1,2412,-88,-91,3,,53554362,304,13331,53554058,53554362
9883,4,1,1,2412,-78,-91,13,54:e4:3a:ec:fb:64,53598155,2160,41633,53595995,53598155
9884,6,6,1,2412,-85,-91,6,84:1b:5e:df:1b:99,53615737,80,17502,53615657,53615737
9885,4,1,1,2412,-66,-91,25,b8:3a:5a:88:e6:e0,53625759,2360,7662,53623399,53625759
9886,4,1,1,2412,-76,-91,15,b8:3a:5a:88:e6:e1,53628148,2376,13,53625772,53628148
9887,6,12,1,2412,-58,-91,33,40:e3:d6:da:ba:20,53642749,160,14441,53642589,53642749
9888,6,6,1,2412,-58,-91,33,40:e3:d6:da:ba:21,53642949,368,-168,53642581,53642949
9889,6,12,1,2412,-58,-91,33,40:e3:d6:da:ba:23,53643644,184,511,53643460,53643644
9890,6,12,1,2412,-58,-91,33,40:e3:d6:da:ba:24,53643907,176,87,53643731,53643907
9891,6,12,1,2412,-58,-91,33,40:e3:d6:da:ba:25,53644109,160,42,53643949,53644109
9892,6,6,1,2412,-58,-91,33,40:e3:d6:da:ba:26,53644301,380,-188,53643921,53644301
9893,6,6,1,2412,-61,-91,30,e6:aa:ea:c9:ea:33,53657185,408,12476,53656777,53657185
9894,6,6,1,2412,-60,-91,31,e6:aa:ea:c9:ea:33,53669236,408,11643,53668828,53669236
9895,6,6,1,2412,-60,-91,31,e6:aa:ea:c9:ea:33,53681356,408,11712,53680948,53681356
9896,6,6,1,2412,-60,-91,31,e6:aa:ea:c9:ea:33,53693478,408,11714,53693070,53693478
9897,4,1,1,2412,-76,-91,15,54:e4:3a:ec:fb:64,53700558,2160,4920,53698398,53700558
9898,4,1,1,2412,-75,-91,16,b8:3a:5a:88:e6:e1,53730612,2376,27678,53728236,53730612
9899,6,12,1,2412,-57,-91,34,40:e3:d6:da:ba:20,53744257,160,13485,53744097,53744257
9900,6,6,1,2412,-57,-91,34,40:e3:d6:da:ba:21,53744458,368,-167,53744090,53744458
9901,6,12,1,2412,-57,-91,34,40:e3:d6:da:ba:22,53744845,180,207,53744665,53744845
9902,6,12,1,2412,-57,-91,34,40:e3:d6:da:ba:23,53745078,184,49,53744894,53745078
9903,6,12,1,2412,-57,-91,34,40:e3:d6:da:ba:25,53745498,160,260,53745338,53745498
9904,6,6,1,2412,-56,-91,35,40:e3:d6:da:ba:26,53745699,380,-179,53745319,53745699
9905,4,1,1,2412,-74,-91,17,54:e4:3a:ec:fb:64,53802958,2160,55099,53800798,53802958
9906,4,1,1,2412,-78,-91,13,b8:3a:5a:88:e6:e0,53830541,2360,25223,53828181,53830541
9907,6,12,1,2412,-58,-91,33,40:e3:d6:da:ba:20,53846655,160,15954,53846495,53846655
9908,6,6,1,2412,-58,-91,33,40:e3:d6:da:ba:21,53846856,368,-167,53846488,53846856
9909,6,12,1,2412,-58,-91,33,40:e3:d6:da:ba:22,53847243,180,207,53847063,53847243
9910,6,12,1,2412,-58,-91,33,40:e3:d6:da:ba:23,53847457,184,30,53847273,53847457
9911,6,12,1,2412,-58,-91,33,40:e3:d6:da:ba:24,53847667,176,34,53847491,53847667
9912,6,12,1,2412,-58,-91,33,40:e3:d6:da:ba:25,53847868,160,41,53847708,53847868
9913,6,6,1,2412,-58,-91,33,40:e3:d6:da:ba:26,53848060,380,-188,53847680,53848060
9914,6,6,1,2412,-78,-91,13,e6:aa:ea:b7:4a:dd,53851069,408,2601,53850661,53851069
9915,6,6,1,2412,-76,-91,15,e6:aa:ea:b7:4a:dd,53863177,408,11700,53862769,53863177
9916,6,6,1,2412,-77,-91,14,e6:aa:ea:b7:4a:dd,53899535,408,35950,53899127,53899535
9917,4,1,1,2412,-70,-91,21,54:e4:3a:ec:fb:64,53905349,2160,3654,53903189,53905349
9918,4,1,1,2412,-80,-91,11,b8:3a:5a:88:e6:e1,53937632,2376,29907,53935256,53937632
9919,6,12,1,2412,-62,-91,29,40:e3:d6:da:ba:20,53949065,160,11273,53948905,53949065
9920,6,6,1,2412,-62,-91,29,40:e3:d6:da:ba:21,53949256,368,-177,53948888,53949256
9921,6,12,1,2412,-62,-91,29,40:e3:d6:da:ba:22,53949670,180,234,53949490,53949670
9922,6,12,1,2412,-63,-91,28,40:e3:d6:da:ba:23,53949885,184,31,53949701,53949885
9923,6,12,1,2412,-63,-91,28,40:e3:d6:da:ba:25,53950314,160,269,53950154,53950314
9924,6,6,1,2412,-63,-91,28,40:e3:d6:da:ba:26,53950524,380,-170,53950144,53950524
9925,4,1,1,2412,-69,-91,22,c0:c9:e3:4d:6e:bf,54001703,872,50307,54000831,54001703
9926,4,1,1,2412,-73,-91,18,,54002592,304,585,54002288,54002592
9927,4,1,1,2412,-72,-91,19,54:e4:3a:ec:fb:64,54007750,2160,2998,54005590,54007750
9928,4,1,1,2412,-79,-91,12,b8:3a:5a:88:e6:e1,54037745,2376,27619,54035369,54037745
9929,4,1,1,2412,-86,-91,5,,54047285,304,9236,54046981,54047285
9930,6,12,1,2412,-61,-91,30,40:e3:d6:da:ba:20,54052685,160,5240,54052525,54052685
9931,6,6,1,2412,-61,-91,30,40:e3:d6:da:ba:21,54052904,368,-149,54052536,54052904
9932,6,12,1,2412,-61,-91,30,40:e3:d6:da:ba:22,54053317,180,233,54053137,54053317
9933,6,12,1,2412,-61,-91,30,40:e3:d6:da:ba:23,54053532,184,31,54053348,54053532
9934,6,12,1,2412,-61,-91,30,40:e3:d6:da:ba:24,54053741,176,33,54053565,54053741
9935,6,12,1,2412,-61,-91,30,40:e3:d6:da:ba:25,54053970,160,69,54053810,54053970
9936,6,6,1,2412,-61,-91,30,40:e3:d6:da:ba:26,54054189,380,-161,54053809,54054189
9937,4,1,1,2412,-76,-91,15,b8:3a:5a:88:e6:e0,54137755,2360,81206,54135395,54137755
9938,6,12,1,2412,-62,-91,29,40:e3:d6:da:ba:20,54153847,160,15932,54153687,54153847
9939,6,6,1,2412,-62,-91,29,40:e3:d6:da:ba:21,54154039,368,-176,54153671,54154039
9940,6,12,1,2412,-62,-91,29,40:e3:d6:da:ba:22,54154443,180,224,54154263,54154443
9941,6,12,1,2412,-62,-91,29,40:e3:d6:da:ba:24,54154867,176,248,54154691,54154867
9942,6,12,1,2412,-62,-91,29,40:e3:d6:da:ba:25,54155078,160,51,54154918,54155078
9943,6,6,1,2412,-62,-91,29,40:e3:d6:da:ba:26,54155279,380,-179,54154899,54155279
9944,6,6,1,2412,-78,-91,13,e6:aa:ea:b7:4a:dd,54166154,408,10467,54165746,54166154
9945,6,6,1,2412,-59,-91,32,e6:aa:ea:c9:ea:33,54176891,408,10329,54176483,54176891
9946,6,6,1,2412,-79,-91,12,e6:aa:ea:b7:4a:dd,54178454,408,1155,54178046,54178454
9947,6,6,1,2412,-58,-91,33,e6:aa:ea:c9:ea:33,54188631,408,9769,54188223,54188631
9948,6,6,1,2412,-58,-91,33,e6:aa:ea:c9:ea:33,54200752,408,11713,54200344,54200752
9949,6,6,1,2412,-78,-91,13,e6:aa:ea:b7:4a:dd,54202511,408,1351,54202103,54202511
9950,6,6,1,2412,-79,-91,12,e6:aa:ea:b7:4a:dd,54214625,408,11706,54214217,54214625
9951,6,6,1,2412,-59,-91,32,e6:aa:ea:c9:ea:33,54224996,408,9963,54224588,54224996
9952,6,12,1,2412,-60,-91,31,40:e3:d6:da:ba:20,54256269,160,31113,54256109,54256269
9953,6,6,1,2412,-60,-91,31,40:e3:d6:da:ba:21,54256460,368,-177,54256092,54256460
9954,6,12,1,2412,-60,-91,31,40:e3:d6:da:ba:22,54256874,180,234,54256694,54256874
9955,6,12,1,2412,-60,-91,31,40:e3:d6:da:ba:23,54257080,184,22,54256896,54257080
9956,6,12,1,2412,-60,-91,31,40:e3:d6:da:ba:24,54257298,176,42,54257122,54257298
9957,6,12,1,2412,-60,-91,31,40:e3:d6:da:ba:25,54257509,160,51,54257349,54257509
9958,6,6,1,2412,-60,-91,31,40:e3:d6:da:ba:26,54257719,380,-170,54257339,54257719
9959,4,1,1,2412,-87,-91,4,a6:e5:7c:28:b1:d3,54302191,992,43480,54301199,54302191
9960,4,1,1,2412,-71,-91,20,54:e4:3a:ec:fb:64,54314927,2160,10576,54312767,54314927
9961,4,1,1,2412,-79,-91,12,b8:3a:5a:88:e6:e0,54342610,2360,25323,54340250,54342610
9962,4,1,1,2412,-79,-91,12,b8:3a:5a:88:e6:e1,54345008,2376,22,54342632,54345008
9963,6,12,1,2412,-60,-91,31,40:e3:d6:da:ba:20,54358987,160,13819,54358827,54358987
9964,6,6,1,2412,-60,-91,31,40:e3:d6:da:ba:21,54359206,368,-149,54358838,54359206
9965,6,12,1,2412,-60,-91,31,40:e3:d6:da:ba:23,54359893,184,503,54359709,54359893
9966,6,12,1,2412,-60,-91,31,40:e3:d6:da:ba:24,54360130,176,61,54359954,54360130
9967,6,12,1,2412,-60,-91,31,40:e3:d6:da:ba:25,54360358,160,68,54360198,54360358
9968,6,6,1,2412,-60,-91,31,40:e3:d6:da:ba:26,54360559,380,-179,54360179,54360559
9969,4,1,1,2412,-85,-91,6,a4:e5:7c:28:b1:d3,54373696,688,12449,54373008,54373696
9970,4,1,1,2412,-88,-91,3,,54374402,304,402,54374098,54374402
9971,4,1,1,2412,-85,-91,6,a6:e5:7c:28:b1:d3,54404499,992,29105,54403507,54404499
9972,4,1,1,2412,-72,-91,19,54:e4:3a:ec:fb:64,54417405,2160,10746,54415245,54417405
9973,4,1,1,2412,-72,-91,19,b8:3a:5a:88:e6:e0,54444944,2360,25179,54442584,54444944
9974,4,1,1,2412,-79,-91,12,b8:3a:5a:88:e6:e1,54447444,2376,124,54445068,54447444
9975,4,1,1,2412,-80,-91,11,,54455421,304,7673,54455117,54455421
9976,6,12,1,2412,-62,-91,29,40:e3:d6:da:ba:20,54461047,160,5466,54460887,54461047
9977,6,6,1,2412,-61,-91,30,40:e3:d6:da:ba:21,54461248,368,-167,54460880,54461248
9978,6,12,1,2412,-62,-91,29,40:e3:d6:da:ba:22,54461644,180,216,54461464,54461644
9979,6,12,1,2412,-61,-91,30,40:e3:d6:da:ba:23,54461892,184,64,54461708,54461892
9980,6,12,1,2412,-61,-91,30,40:e3:d6:da:ba:24,54462101,176,33,54461925,54462101
9981,6,12,1,2412,-61,-91,30,40:e3:d6:da:ba:25,54462330,160,69,54462170,54462330
9982,6,6,1,2412,-61,-91,30,40:e3:d6:da:ba:26,54462549,380,-161,54462169,54462549
9983,4,1,1,2412,-85,-91,6,,54465837,304,2984,54465533,54465837
9984,4,1,1,2412,-89,-91,2,,54475683,304,9542,54475379,54475683
9985,4,1,1,2412,-84,-91,7,c0:c9:e3:4d:6e:bf,54496612,872,20057,54495740,54496612
9986,4,1,1,2412,-77,-91,14,b8:3a:5a:88:e6:e0,54547438,2360,48466,54545078,54547438
9987,6,12,1,2412,-62,-91,29,40:e3:d6:da:ba:20,54563463,160,15865,54563303,54563463
9988,6,6,1,2412,-62,-91,29,40:e3:d6:da:ba:21,54563682,368,-149,54563314,54563682
9989,6,12,1,2412,-62,-91,29,40:e3:d6:da:ba:22,54564096,180,234,54563916,54564096
9990,6,12,1,2412,-62,-91,29,40:e3:d6:da:ba:23,54564329,184,49,54564145,54564329
9991,6,12,1,2412,-62,-91,29,40:e3:d6:da:ba:24,54564547,176,42,54564371,54564547
9992,6,12,1,2412,-62,-91,29,40:e3:d6:da:ba:25,54564749,160,42,54564589,54564749
9993,6,6,1,2412,-62,-91,29,40:e3:d6:da:ba:26,54564941,380,-188,54564561,54564941
9994,6,6,1,2412,-60,-91,31,e6:aa:ea:c9:ea:33,54593965,408,28616,54593557,54593965
9995,6,6,1,2412,-79,-91,12,e6:aa:ea:b7:4a:dd,54595892,408,1519,54595484,54595892
9996,6,6,1,2412,-60,-91,31,e6:aa:ea:c9:ea:33,54606126,408,9826,54605718,54606126
9997,6,6,1,2412,-79,-91,12,e6:aa:ea:b7:4a:dd,54608006,408,1472,54607598,54608006
9998,6,6,1,2412,-79,-91,12,e6:aa:ea:b7:4a:dd,54620118,408,11704,54619710,54620118
9999,6,6,1,2412,-58,-91,33,e6:aa:ea:c9:ea:33,54630477,408,9951,54630069,54630477
10000,4,1,1,2412,-78,-91,13,b8:3a:5a:88:e6:e0,54649777,2360,16940,54647417,54649777
10001,4,1,1,2412,-69,-91,22,b8:3a:5a:88:e6:e1,54652166,2376,13,54649790,54652166
10002,6,12,1,2412,-61,-91,30,40:e3:d6:da:ba:22,54666470,180,14124,54666290,54666470
10003,6,12,1,2412,-62,-91,29,40:e3:d6:da:ba:23,54666684,184,30,54666500,54666684
10004,6,12,1,2412,-61,-91,30,40:e3:d6:da:ba:24,54666912,176,52,54666736,54666912
10005,6,12,1,2412,-62,-91,29,40:e3:d6:da:ba:25,54667113,160,41,54666953,54667113
10006,6,6,1,2412,-62,-91,29,40:e3:d6:da:ba:26,54667314,380,-179,54666934,54667314
10007,4,1,1,2412,-73,-91,18,54:e4:3a:ec:fb:64,54724549,2160,55075,54722389,54724549
10008,4,1,1,2412,-81,-91,10,b8:3a:5a:88:e6:e0,54752139,2360,25230,54749779,54752139
10009,4,1,1,2412,-80,-91,11,b8:3a:5a:88:e6:e1,54754537,2376,22,54752161,54754537
10010,6,12,1,2412,-58,-91,33,40:e3:d6:da:ba:20,54768296,160,13599,54768136,54768296
10011,6,6,1,2412,-58,-91,33,40:e3:d6:da:ba:21,54768488,368,-176,54768120,54768488
10012,6,12,1,2412,-58,-91,33,40:e3:d6:da:ba:22,54768875,180,207,54768695,54768875
10013,6,12,1,2412,-58,-91,33,40:e3:d6:da:ba:23,54769108,184,49,54768924,54769108
10014,6,12,1,2412,-58,-91,33,40:e3:d6:da:ba:24,54769344,176,60,54769168,54769344
10015,6,12,1,2412,-58,-91,33,40:e3:d6:da:ba:25,54769546,160,42,54769386,54769546
10016,6,6,1,2412,-58,-91,33,40:e3:d6:da:ba:26,54769747,380,-179,54769367,54769747
10017,4,1,1,2412,-81,-91,10,b8:3a:5a:88:e6:e0,54776503,2240,4516,54774263,54776503
10018,4,1,1,2412,-84,-91,7,a6:e5:7c:28:b1:d3,54814033,992,36538,54813041,54814033
10019,4,1,1,2412,-79,-91,12,54:e4:3a:ec:fb:64,54827042,2160,10849,54824882,54827042
10020,4,1,1,2412,-65,-91,26,b8:3a:5a:88:e6:e0,54854629,2360,25227,54852269,54854629
10021,4,1,1,2412,-80,-91,11,b8:3a:5a:88:e6:e1,54857009,2376,4,54854633,54857009
10022,6,6,1,2412,-58,-91,33,40:e3:d6:da:ba:21,54870860,368,13483,54870492,54870860
10023,6,12,1,2412,-58,-91,33,40:e3:d6:da:ba:22,54871265,180,225,54871085,54871265
10024,6,12,1,2412,-58,-91,33,40:e3:d6:da:ba:23,54871488,184,39,54871304,54871488
10025,6,12,1,2412,-58,-91,33,40:e3:d6:da:ba:24,54871716,176,52,54871540,54871716
10026,6,12,1,2412,-58,-91,33,40:e3:d6:da:ba:25,54871935,160,59,54871775,54871935
10027,6,6,1,2412,-58,-91,33,40:e3:d6:da:ba:26,54872127,380,-188,54871747,54872127
10028,4,1,1,2412,-86,-91,5,a6:e5:7c:28:b1:d3,54916211,992,43092,54915219,54916211
10029,4,1,1,2412,-78,-91,13,54:e4:3a:ec:fb:64,54929269,2160,10898,54927109,54929269
10030,4,1,1,2412,-77,-91,14,b8:3a:5a:88:e6:e0,54957241,2360,25612,54954881,54957241
10031,4,1,1,2412,-78,-91,13,b8:3a:5a:88:e6:e1,54959648,2376,31,54957272,54959648
10032,6,12,1,2412,-57,-91,34,40:e3:d6:da:ba:20,54973960,160,14152,54973800,54973960
10033,6,6,1,2412,-57,-91,34,40:e3:d6:da:ba:21,54974151,368,-177,54973783,54974151
10034,6,12,1,2412,-57,-91,34,40:e3:d6:da:ba:24,54975119,176,792,54974943,54975119
10035,6,12,1,2412,-57,-91,34,40:e3:d6:da:ba:25,54975321,160,42,54975161,54975321
10036,6,6,1,2412,-58,-91,33,40:e3:d6:da:ba:26,54975512,380,-189,54975132,54975512
10037,6,6,1,2412,-79,-91,12,e6:aa:ea:b7:4a:dd,55001229,408,25309,55000821,55001229
10038,6,6,1,2412,-60,-91,31,e6:aa:ea:c9:ea:33,55011635,408,9998,55011227,55011635
10039,6,6,1,2412,-79,-91,12,e6:aa:ea:b7:4a:dd,55013365,408,1322,55012957,55013365
10040,6,6,1,2412,-60,-91,31,e6:aa:ea:c9:ea:33,55023911,408,10138,55023503,55023911
10041,4,1,1,2412,-92,-91,-1,,55030051,304,5836,55029747,55030051
10042,6,6,1,2412,-80,-91,11,e6:aa:ea:b7:4a:dd,55037706,408,7247,55037298,55037706
10043,6,6,1,2412,-61,-91,30,e6:aa:ea:c9:ea:33,55048077,408,9963,55047669,55048077
10044,6,6,1,2412,-80,-91,11,e6:aa:ea:b7:4a:dd,55049699,408,1214,55049291,55049699
10045,6,12,1,2412,-58,-91,33,40:e3:d6:da:ba:20,55075448,160,25589,55075288,55075448
10046,6,6,1,2412,-58,-91,33,40:e3:d6:da:ba:21,55075640,368,-176,55075272,55075640
10047,6,12,1,2412,-58,-91,33,40:e3:d6:da:ba:22,55076027,180,207,55075847,55076027
10048,6,12,1,2412,-58,-91,33,40:e3:d6:da:ba:23,55076241,184,30,55076057,55076241
10049,6,12,1,2412,-58,-91,33,40:e3:d6:da:ba:24,55076460,176,43,55076284,55076460
10050,6,12,1,2412,-58,-91,33,40:e3:d6:da:ba:25,55076661,160,41,55076501,55076661
10051,6,6,1,2412,-58,-91,33,40:e3:d6:da:ba:26,55076853,380,-188,55076473,55076853
10052,4,1,1,2412,-77,-91,14,54:e4:3a:ec:fb:64,55134142,2160,55129,55131982,55134142
10053,4,1,1,2412,-77,-91,14,b8:3a:5a:88:e6:e0,55163437,2360,26935,55161077,55163437
10054,4,1,1,2412,-76,-91,15,b8:3a:5a:88:e6:e1,55165817,2376,4,55163441,55165817
10055,6,12,1,2412,-58,-91,33,40:e3:d6:da:ba:20,55177848,160,11871,55177688,55177848
10056,6,6,1,2412,-58,-91,33,40:e3:d6:da:ba:21,55178058,368,-158,55177690,55178058
10057,6,12,1,2412,-58,-91,33,40:e3:d6:da:ba:22,55178454,180,216,55178274,55178454
10058,6,12,1,2412,-58,-91,33,40:e3:d6:da:ba:23,55178678,184,40,55178494,55178678
10059,6,12,1,2412,-58,-91,33,40:e3:d6:da:ba:24,55178914,176,60,55178738,55178914
10060,6,12,1,2412,-57,-91,34,40:e3:d6:da:ba:25,55179134,160,60,55178974,55179134
10061,6,6,1,2412,-57,-91,34,40:e3:d6:da:ba:26,55179344,380,-170,55178964,55179344
10062,4,1,1,2412,-79,-91,12,54:e4:3a:ec:fb:64,55236567,2160,55063,55234407,55236567
10063,4,1,1,2412,-86,-91,5,,55247092,304,10221,55246788,55247092
10064,4,1,1,2412,-76,-91,15,b8:3a:5a:88:e6:e0,55248610,2240,-722,55246370,55248610
10065,4,1,1,2412,-76,-91,15,b8:3a:5a:88:e6:e1,55253108,2256,2242,55250852,55253108
10066,4,1,1,2412,-78,-91,13,b8:3a:5a:88:e6:e0,55264160,2360,8692,55261800,55264160
10067,4,1,1,2412,-77,-91,14,b8:3a:5a:88:e6:e1,55266539,2376,3,55264163,55266539
10068,4,1,1,2412,-87,-91,4,,55270046,304,3203,55269742,55270046
10069,4,1,1,2412,-77,-91,14,b8:3a:5a:88:e6:e0,55272012,2240,-274,55269772,55272012
10070,4,1,1,2412,-74,-91,17,b8:3a:5a:88:e6:e1,55274280,2256,12,55272024,55274280
10071,6,12,1,2412,-56,-91,35,40:e3:d6:da:ba:20,55280269,160,5829,55280109,55280269
10072,6,6,1,2412,-56,-91,35,40:e3:d6:da:ba:21,55280470,368,-167,55280102,55280470
10073,6,12,1,2412,-56,-91,35,40:e3:d6:da:ba:22,55280857,180,207,55280677,55280857
10074,6,12,1,2412,-56,-91,35,40:e3:d6:da:ba:23,55281090,184,49,55280906,55281090
10075,6,12,1,2412,-56,-91,35,40:e3:d6:da:ba:24,55281299,176,33,55281123,55281299
10076,6,12,1,2412,-56,-91,35,40:e3:d6:da:ba:25,55281500,160,41,55281340,55281500
10077,6,6,1,2412,-56,-91,35,40:e3:d6:da:ba:26,55281710,380,-170,55281330,55281710
10078,6,6,1,2412,-78,-91,13,e6:aa:ea:b7:4a:dd,55315789,408,33671,55315381,55315789
10079,6,6,1,2412,-58,-91,33,e6:aa:ea:c9:ea:33,55326496,408,10299,55326088,55326496
10080,6,6,1,2412,-59,-91,32,e6:aa:ea:c9:ea:33,55338686,408,11782,55338278,55338686
10081,4,1,1,2412,-63,-91,28,54:e4:3a:ec:fb:64,55339804,2160,-1042,55337644,55339804
10082,4,1,1,2412,-89,-91,2,,55348595,304,8487,55348291,55348595
10083,6,6,1,2412,-59,-91,32,e6:aa:ea:c9:ea:33,55350737,408,1734,55350329,55350737
10084,6,6,1,2412,-78,-91,13,e6:aa:ea:b7:4a:dd,55352139,408,994,55351731,55352139
10085,6,6,1,2412,-59,-91,32,e6:aa:ea:c9:ea:33,55362856,408,10309,55362448,55362856
10086,6,6,1,2412,-78,-91,13,e6:aa:ea:b7:4a:dd,55364265,408,1001,55363857,55364265
10087,4,1,1,2412,-75,-91,16,b8:3a:5a:88:e6:e1,55368950,2376,2309,55366574,55368950
10088,6,6,1,2412,-60,-91,31,e6:aa:ea:c9:ea:33,55374984,408,5626,55374576,55374984
10089,6,12,1,2412,-58,-91,33,40:e3:d6:da:ba:20,55384138,160,8994,55383978,55384138
10090,6,12,1,2412,-58,-91,33,40:e3:d6:da:ba:23,55384941,184,619,55384757,55384941
10091,6,12,1,2412,-58,-91,33,40:e3:d6:da:ba:24,55385150,176,33,55384974,55385150
10092,6,12,1,2412,-58,-91,33,40:e3:d6:da:ba:25,55385378,160,68,55385218,55385378
10093,6,6,1,2412,-58,-91,33,40:e3:d6:da:ba:26,55385579,380,-179,55385199,55385579
10094,4,1,1,2412,-72,-91,19,24:f6:77:10:02:c8,55462611,1064,75968,55461547,55462611
10095,4,1,1,2412,-72,-91,19,24:f6:77:10:02:c8,55474851,1064,11176,55473787,55474851
10096,4,1,1,2412,-83,-91,8,c0:c9:e3:4d:6e:bf,55476750,872,1027,55475878,55476750
10097,4,1,1,2412,-75,-91,16,,55477639,304,585,55477335,55477639
10098,6,12,1,2412,-60,-91,31,40:e3:d6:da:ba:20,55485051,160,7252,55484891,55485051
10099,6,6,1,2412,-60,-91,31,40:e3:d6:da:ba:21,55485252,368,-167,55484884,55485252
10100,6,12,1,2412,-60,-91,31,40:e3:d6:da:ba:22,55485648,180,216,55485468,55485648
10101,6,12,1,2412,-60,-91,31,40:e3:d6:da:ba:23,55485871,184,39,55485687,55485871
10102,6,12,1,2412,-60,-91,31,40:e3:d6:da:ba:24,55486081,176,34,55485905,55486081
10103,6,12,1,2412,-60,-91,31,40:e3:d6:da:ba:25,55486291,160,50,55486131,55486291
10104,4,1,1,2412,-86,-91,5,,55522668,304,36073,55522364,55522668
10105,4,1,1,2412,-71,-91,20,24:f6:77:10:02:c8,55559761,1064,36029,55558697,55559761
10106,6,12,1,2412,-59,-91,32,40:e3:d6:da:ba:20,55598178,160,38257,55598018,55598178
10107,6,12,1,2412,-59,-91,32,40:e3:d6:da:ba:22,55598793,180,435,55598613,55598793
10108,6,12,1,2412,-59,-91,32,40:e3:d6:da:ba:24,55599208,176,239,55599032,55599208
10109,6,12,1,2412,-59,-91,32,40:e3:d6:da:ba:25,55599436,160,68,55599276,55599436
10110,6,6,1,2412,-59,-91,32,40:e3:d6:da:ba:26,55599655,380,-161,55599275,55599655
10111,6,6,1,2412,-60,-91,31,e6:aa:ea:c9:ea:33,55642229,408,42166,55641821,55642229
10112,4,1,1,2412,-78,-91,13,54:e4:3a:ec:fb:64,55646198,2160,1809,55644038,55646198
10113,6,6,1,2412,-60,-91,31,e6:aa:ea:c9:ea:33,55656939,408,10333,55656531,55656939
10114,6,6,1,2412,-60,-91,31,e6:aa:ea:c9:ea:33,55666432,408,9085,55666024,55666432
10115,4,1,1,2412,-79,-91,12,b8:3a:5a:88:e6:e1,55676158,2376,7350,55673782,55676158
10116,6,6,1,2412,-59,-91,32,e6:aa:ea:c9:ea:33,55678537,408,1971,55678129,55678537
10117,6,12,1,2412,-59,-91,32,40:e3:d6:da:ba:20,55689874,160,11177,55689714,55689874
10118,6,6,1,2412,-59,-91,32,40:e3:d6:da:ba:21,55690066,368,-176,55689698,55690066
10119,6,12,1,2412,-59,-91,32,40:e3:d6:da:ba:22,55690471,180,225,55690291,55690471
10120,6,12,1,2412,-59,-91,32,40:e3:d6:da:ba:24,55691144,176,497,55690968,55691144
10121,6,12,1,2412,-58,-91,33,40:e3:d6:da:ba:25,55691363,160,59,55691203,55691363
10122,6,6,1,2412,-59,-91,32,40:e3:d6:da:ba:26,55691573,380,-170,55691193,55691573
10123,6,6,1,2412,-79,-91,12,e6:aa:ea:b7:4a:dd,55732426,408,40445,55732018,55732426
10124,6,6,1,2412,-78,-91,13,e6:aa:ea:b7:4a:dd,55744553,408,11719,55744145,55744553
10125,4,1,1,2412,-59,-91,32,54:e4:3a:ec:fb:64,55748579,2160,1866,55746419,55748579
10126,6,6,1,2412,-79,-91,12,e6:aa:ea:b7:4a:dd,55756667,408,7680,55756259,55756667
10127,4,1,1,2412,-79,-91,12,b8:3a:5a:88:e6:e1,55778547,2376,19504,55776171,55778547
10128,6,6,1,2412,-59,-91,32,40:e3:d6:da:ba:21,55792578,368,13663,55792210,55792578
10129,6,12,1,2412,-59,-91,32,40:e3:d6:da:ba:23,55793416,184,654,55793232,55793416
10130,6,12,1,2412,-59,-91,32,40:e3:d6:da:ba:24,55793625,176,33,55793449,55793625
10131,6,12,1,2412,-59,-91,32,40:e3:d6:da:ba:25,55793853,160,68,55793693,55793853
10132,6,12,1,2412,-59,-91,32,40:e3:d6:da:ba:20,55801526,136,7537,55801390,55801526
10133,6,6,1,2412,-59,-91,32,40:e3:d6:da:ba:21,55801703,348,-171,55801355,55801703
10134,6,12,1,2412,-59,-91,32,40:e3:d6:da:ba:22,55802113,156,254,55801957,55802113
10135,6,12,1,2412,-59,-91,32,40:e3:d6:da:ba:23,55802304,156,35,55802148,55802304
10136,6,12,1,2412,-58,-91,33,40:e3:d6:da:ba:25,55802503,136,63,55802367,55802503
10137,6,12,1,2412,-59,-91,32,40:e3:d6:da:ba:20,55802683,136,44,55802547,55802683
10138,6,6,1,2412,-59,-91,32,40:e3:d6:da:ba:21,55802922,348,-109,55802574,55802922
10139,6,12,1,2412,-59,-91,32,40:e3:d6:da:ba:22,55803325,156,247,55803169,55803325
10140,6,12,1,2412,-59,-91,32,40:e3:d6:da:ba:23,55803543,156,62,55803387,55803543
10141,6,12,1,2412,-59,-91,32,40:e3:d6:da:ba:25,55803751,136,72,55803615,55803751
10142,4,1,1,2412,-80,-91,11,b8:3a:5a:88:e6:e0,55878567,2360,72456,55876207,55878567
10143,6,12,1,2412,-59,-91,32,40:e3:d6:da:ba:20,55894652,160,15925,55894492,55894652
10144,6,6,1,2412,-59,-91,32,40:e3:d6:da:ba:21,55894844,368,-176,55894476,55894844
10145,6,12,1,2412,-59,-91,32,40:e3:d6:da:ba:22,55895231,180,207,55895051,55895231
10146,6,12,1,2412,-59,-91,32,40:e3:d6:da:ba:23,55895445,184,30,55895261,55895445
10147,6,12,1,2412,-59,-91,32,40:e3:d6:da:ba:24,55895664,176,43,55895488,55895664
10148,6,12,1,2412,-59,-91,32,40:e3:d6:da:ba:25,55895865,160,41,55895705,55895865
10149,6,6,1,2412,-58,-91,33,40:e3:d6:da:ba:26,55896075,380,-170,55895695,55896075
10150,4,1,1,2412,-56,-91,35,54:e4:3a:ec:fb:64,55953354,2160,55119,55951194,55953354
10151,4,1,1,2412,-78,-91,13,b8:3a:5a:88:e6:e0,55980941,2360,25227,55978581,55980941
10152,4,1,1,2412,-79,-91,12,b8:3a:5a:88:e6:e1,55983348,2376,31,55980972,55983348
10153,6,12,1,2412,-59,-91,32,40:e3:d6:da:ba:20,55997053,160,13545,55996893,55997053
10154,6,12,1,2412,-59,-91,32,40:e3:d6:da:ba:22,55997686,180,453,55997506,55997686
10155,6,12,1,2412,-59,-91,32,40:e3:d6:da:ba:23,55997918,184,48,55997734,55997918
10156,6,12,1,2412,-59,-91,32,40:e3:d6:da:ba:24,55998136,176,42,55997960,55998136
10157,6,12,1,2412,-59,-91,32,40:e3:d6:da:ba:25,55998356,160,60,55998196,55998356
10158,6,6,1,2412,-59,-91,32,40:e3:d6:da:ba:26,55998548,380,-188,55998168,55998548
10159,4,1,1,2412,-87,-91,4,,56015199,304,16347,56014895,56015199
10160,4,1,1,2412,-78,-91,13,54:e4:3a:ec:fb:64,56055782,2160,38423,56053622,56055782
10161,4,1,1,2412,-78,-91,13,b8:3a:5a:88:e6:e0,56083341,2360,25199,56080981,56083341
10162,4,1,1,2412,-79,-91,12,b8:3a:5a:88:e6:e1,56085721,2376,4,56083345,56085721
10163,6,12,1,2412,-59,-91,32,40:e3:d6:da:ba:20,56099470,160,13589,56099310,56099470
10164,6,6,1,2412,-58,-91,33,40:e3:d6:da:ba:21,56099680,368,-158,56099312,56099680
10165,6,12,1,2412,-59,-91,32,40:e3:d6:da:ba:22,56100094,180,234,56099914,56100094
10166,6,12,1,2412,-58,-91,33,40:e3:d6:da:ba:23,56100349,184,71,56100165,56100349
10167,6,12,1,2412,-58,-91,33,40:e3:d6:da:ba:24,56100593,176,68,56100417,56100593
10168,6,12,1,2412,-58,-91,33,40:e3:d6:da:ba:25,56100795,160,42,56100635,56100795
10169,6,6,1,2412,-58,-91,33,40:e3:d6:da:ba:26,56100995,380,-180,56100615,56100995
10170,4,1,1,2412,-84,-91,7,a6:e5:7c:28:b1:d3,56145566,992,43579,56144574,56145566
10171,6,12,1,2412,-58,-91,33,40:e3:d6:da:ba:20,56151619,136,5917,56151483,56151619
10172,6,6,1,2412,-58,-91,33,40:e3:d6:da:ba:21,56151796,348,-171,56151448,56151796
10173,6,12,1,2412,-58,-91,33,40:e3:d6:da:ba:22,56153093,156,1141,56152937,56153093
10174,6,12,1,2412,-58,-91,33,40:e3:d6:da:ba:23,56153284,156,35,56153128,56153284
10175,6,12,1,2412,-58,-91,33,40:e3:d6:da:ba:25,56153501,136,81,56153365,56153501
10176,6,12,1,2412,-58,-91,33,40:e3:d6:da:ba:20,56153699,136,62,56153563,56153699
10177,6,6,1,2412,-58,-91,33,40:e3:d6:da:ba:21,56153885,348,-162,56153537,56153885
10178,6,12,1,2412,-58,-91,33,40:e3:d6:da:ba:22,56154279,156,238,56154123,56154279
10179,6,12,1,2412,-58,-91,33,40:e3:d6:da:ba:23,56154469,156,34,56154313,56154469
10180,6,12,1,2412,-58,-91,33,40:e3:d6:da:ba:25,56154659,136,54,56154523,56154659
10181,6,6,1,2412,-57,-91,34,e6:aa:ea:c9:ea:33,56164334,408,9267,56163926,56164334
10182,6,6,1,2412,-57,-91,34,e6:aa:ea:c9:ea:33,56176449,408,11707,56176041,56176449
10183,6,6,1,2412,-54,-91,37,e6:aa:ea:c9:ea:33,56188601,408,11744,56188193,56188601
10184,6,6,1,2412,-56,-91,35,e6:aa:ea:c9:ea:33,56200695,408,11686,56200287,56200695
10185,6,12,1,2412,-58,-91,33,40:e3:d6:da:ba:20,56201879,160,1024,56201719,56201879
10186,6,6,1,2412,-58,-91,33,40:e3:d6:da:ba:21,56202071,368,-176,56201703,56202071
10187,6,12,1,2412,-58,-91,33,40:e3:d6:da:ba:22,56202467,180,216,56202287,56202467
10188,4,1,1,2412,-65,-91,26,ce:56:d9:9b:16:7d,56209613,904,6242,56208709,56209613
10189,6,12,1,2412,-58,-91,33,40:e3:d6:da:ba:20,56210499,136,750,56210363,56210499
10190,6,6,1,2412,-58,-91,33,40:e3:d6:da:ba:21,56210719,348,-128,56210371,56210719
10191,6,12,1,2412,-58,-91,33,40:e3:d6:da:ba:22,56212031,156,1156,56211875,56212031
10192,6,12,1,2412,-58,-91,33,40:e3:d6:da:ba:23,56212231,156,44,56212075,56212231
10193,6,12,1,2412,-58,-91,33,40:e3:d6:da:ba:25,56212430,136,63,56212294,56212430
10194,6,12,1,2412,-58,-91,33,40:e3:d6:da:ba:20,56212610,136,44,56212474,56212610
10195,6,6,1,2412,-58,-91,33,40:e3:d6:da:ba:21,56212805,348,-153,56212457,56212805
10196,6,12,1,2412,-58,-91,33,40:e3:d6:da:ba:22,56213190,156,229,56213034,56213190
10197,6,12,1,2412,-58,-91,33,40:e3:d6:da:ba:23,56213407,156,61,56213251,56213407
10198,4,1,1,2412,-77,-91,14,54:e4:3a:ec:fb:64,56226137,2112,10618,56224025,56226137
10199,4,1,1,2412,-67,-91,24,,56228260,304,1819,56227956,56228260
10200,6,6,1,2412,-75,-91,16,e6:aa:ea:b7:4a:dd,56252874,408,24206,56252466,56252874
10201,4,1,1,2412,-76,-91,15,54:e4:3a:ec:fb:64,56260558,2160,5524,56258398,56260558
10202,6,6,1,2412,-75,-91,16,e6:aa:ea:b7:4a:dd,56264995,408,4029,56264587,56264995
10203,6,6,1,2412,-75,-91,16,e6:aa:ea:b7:4a:dd,56277111,408,11708,56276703,56277111
10204,4,1,1,2412,-80,-91,11,b8:3a:5a:88:e6:e0,56288144,2360,8673,56285784,56288144
10205,4,1,1,2412,-80,-91,11,b8:3a:5a:88:e6:e1,56290523,2376,3,56288147,56290523
10206,6,6,1,2412,-75,-91,16,e6:aa:ea:b7:4a:dd,56301345,408,10414,56300937,56301345
10207,6,12,1,2412,-58,-91,33,40:e3:d6:da:ba:20,56306533,160,5028,56306373,56306533
10208,6,12,1,2412,-58,-91,33,40:e3:d6:da:ba:23,56307411,184,694,56307227,56307411
10209,6,12,1,2412,-58,-91,33,40:e3:d6:da:ba:24,56307629,176,42,56307453,56307629
10210,6,12,1,2412,-58,-91,33,40:e3:d6:da:ba:25,56307858,160,69,56307698,56307858
10211,6,6,1,2412,-58,-91,33,40:e3:d6:da:ba:26,56308068,380,-170,56307688,56308068
10212,4,1,1,2412,-77,-91,14,54:e4:3a:ec:fb:64,56362983,2160,52755,56360823,56362983
10213,4,1,1,2412,-84,-91,7,b8:3a:5a:88:e6:e0,56390548,2360,25205,56388188,56390548
10214,6,12,1,2412,-59,-91,32,40:e3:d6:da:ba:20,56406675,160,15967,56406515,56406675
10215,6,6,1,2412,-58,-91,33,40:e3:d6:da:ba:21,56406884,368,-159,56406516,56406884
10216,6,12,1,2412,-58,-91,33,40:e3:d6:da:ba:22,56407280,180,216,56407100,56407280
10217,6,12,1,2412,-58,-91,33,40:e3:d6:da:ba:23,56407486,184,22,56407302,56407486
10218,6,12,1,2412,-58,-91,33,40:e3:d6:da:ba:24,56407695,176,33,56407519,56407695
10219,6,12,1,2412,-58,-91,33,40:e3:d6:da:ba:25,56407931,160,76,56407771,56407931
10220,6,6,1,2412,-58,-91,33,40:e3:d6:da:ba:26,56408123,380,-188,56407743,56408123
10221,4,1,1,2412,-77,-91,14,54:e4:3a:ec:fb:64,56465217,2160,54934,56463057,56465217
10222,6,12,1,2412,-59,-91,32,40:e3:d6:da:ba:20,56509073,160,43696,56508913,56509073
10223,6,6,1,2412,-59,-91,32,40:e3:d6:da:ba:21,56509265,368,-176,56508897,56509265
10224,6,12,1,2412,-59,-91,32,40:e3:d6:da:ba:22,56509679,180,234,56509499,56509679
10225,6,12,1,2412,-59,-91,32,40:e3:d6:da:ba:23,56509893,184,30,56509709,56509893
10226,6,12,1,2412,-59,-91,32,40:e3:d6:da:ba:24,56510112,176,43,56509936,56510112
10227,6,12,1,2412,-59,-91,32,40:e3:d6:da:ba:25,56510322,160,50,56510162,56510322
10228,6,6,1,2412,-59,-91,32,40:e3:d6:da:ba:26,56510523,380,-179,56510143,56510523
10229,4,1,1,2412,-75,-91,16,,56552680,304,41853,56552376,56552680
10230,4,1,1,2412,-84,-91,7,a6:e5:7c:28:b1:d3,56555078,992,1406,56554086,56555078
10231,6,6,1,2412,-75,-91,16,e6:aa:ea:b7:4a:dd,56567595,408,12109,56567187,56567595
10232,4,1,1,2412,-76,-91,15,54:e4:3a:ec:fb:64,56569061,2160,-694,56566901,56569061
10233,6,6,1,2412,-57,-91,34,e6:aa:ea:c9:ea:33,56582090,408,12621,56581682,56582090
10234,6,6,1,2412,-75,-91,16,e6:aa:ea:b7:4a:dd,56591824,408,9326,56591416,56591824
10235,6,6,1,2412,-58,-91,33,e6:aa:ea:c9:ea:33,56594240,408,2008,56593832,56594240
10236,4,1,1,2412,-83,-91,8,b8:3a:5a:88:e6:e0,56595361,2360,-1239,56593001,56595361
10237,6,6,1,2412,-75,-91,16,e6:aa:ea:b7:4a:dd,56603938,408,8169,56603530,56603938
10238,6,6,1,2412,-58,-91,33,e6:aa:ea:c9:ea:33,56606343,408,1997,56605935,56606343
10239,6,12,1,2412,-57,-91,34,40:e3:d6:da:ba:20,56611757,160,5254,56611597,56611757
10240,6,6,1,2412,-57,-91,34,40:e3:d6:da:ba:21,56611967,368,-158,56611599,56611967
10241,6,12,1,2412,-57,-91,34,40:e3:d6:da:ba:22,56612372,180,225,56612192,56612372
10242,6,12,1,2412,-57,-91,34,40:e3:d6:da:ba:23,56612605,184,49,56612421,56612605
10243,6,12,1,2412,-57,-91,34,40:e3:d6:da:ba:24,56612832,176,51,56612656,56612832
10244,6,12,1,2412,-57,-91,34,40:e3:d6:da:ba:25,56613042,160,50,56612882,56613042
10245,6,6,1,2412,-57,-91,34,40:e3:d6:da:ba:26,56613243,380,-179,56612863,56613243
10246,6,6,1,2412,-75,-91,16,e6:aa:ea:b7:4a:dd,56616057,408,2406,56615649,56616057
10247,6,6,1,2412,-58,-91,33,e6:aa:ea:c9:ea:33,56618446,408,1981,56618038,56618446
10248,6,6,1,2412,-59,-91,32,e6:aa:ea:c9:ea:33,56630585,408,11731,56630177,56630585
10249,4,1,1,2412,-82,-91,9,a4:e5:7c:28:b1:d3,56667011,688,35738,56666323,56667011
10250,4,1,1,2412,-76,-91,15,b8:3a:5a:88:e6:e1,56700145,2376,30758,56697769,56700145
10251,6,12,1,2412,-56,-91,35,40:e3:d6:da:ba:20,56713857,160,13552,56713697,56713857
10252,6,6,1,2412,-56,-91,35,40:e3:d6:da:ba:21,56714067,368,-158,56713699,56714067
10253,6,12,1,2412,-56,-91,35,40:e3:d6:da:ba:22,56714463,180,216,56714283,56714463
10254,6,12,1,2412,-56,-91,35,40:e3:d6:da:ba:23,56714696,184,49,56714512,56714696
10255,6,12,1,2412,-56,-91,35,40:e3:d6:da:ba:24,56714932,176,60,56714756,56714932
10256,6,12,1,2412,-56,-91,35,40:e3:d6:da:ba:25,56715160,160,68,56715000,56715160
10257,6,6,1,2412,-56,-91,35,40:e3:d6:da:ba:26,56715361,380,-179,56714981,56715361
10258,4,1,1,2412,-87,-91,4,,56759796,304,44131,56759492,56759796
10259,4,1,1,2412,-75,-91,16,b8:3a:5a:88:e6:e0,56800158,2360,38002,56797798,56800158
10260,4,1,1,2412,-75,-91,16,b8:3a:5a:88:e6:e1,56802573,2376,39,56800197,56802573
10261,6,12,1,2412,-56,-91,35,40:e3:d6:da:ba:20,56816287,160,13554,56816127,56816287
10262,6,6,1,2412,-56,-91,35,40:e3:d6:da:ba:21,56816496,368,-159,56816128,56816496
10263,6,12,1,2412,-56,-91,35,40:e3:d6:da:ba:22,56816883,180,207,56816703,56816883
10264,6,12,1,2412,-56,-91,35,40:e3:d6:da:ba:23,56817116,184,49,56816932,56817116
10265,6,12,1,2412,-56,-91,35,40:e3:d6:da:ba:24,56817343,176,51,56817167,56817343
10266,6,12,1,2412,-56,-91,35,40:e3:d6:da:ba:25,56817545,160,42,56817385,56817545
10267,6,6,1,2412,-56,-91,35,40:e3:d6:da:ba:26,56817736,380,-189,56817356,56817736
10268,4,1,1,2412,-77,-91,14,54:e4:3a:ec:fb:64,56875621,2160,55725,56873461,56875621
10269,4,1,1,2412,-74,-91,17,b8:3a:5a:88:e6:e0,56902549,2360,24568,56900189,56902549
10270,6,12,1,2412,-57,-91,34,40:e3:d6:da:ba:20,56918655,160,15946,56918495,56918655
10271,6,6,1,2412,-57,-91,34,40:e3:d6:da:ba:21,56918874,368,-149,56918506,56918874
10272,6,12,1,2412,-57,-91,34,40:e3:d6:da:ba:22,56919288,180,234,56919108,56919288
10273,6,12,1,2412,-57,-91,34,40:e3:d6:da:ba:23,56919512,184,40,56919328,56919512
10274,6,12,1,2412,-57,-91,34,40:e3:d6:da:ba:24,56919730,176,42,56919554,56919730
10275,6,12,1,2412,-57,-91,34,40:e3:d6:da:ba:25,56919950,160,60,56919790,56919950
10276,6,6,1,2412,-57,-91,34,40:e3:d6:da:ba:26,56920150,380,-180,56919770,56920150
10277,4,1,1,2412,-86,-91,5,c0:c9:e3:4d:6e:bf,56954751,872,33729,56953879,56954751
10278,4,1,1,2412,-88,-91,3,,56955640,304,585,56955336,56955640
10279,4,1,1,2412,-71,-91,20,c2:3d:b7:10:44:6a,56978844,904,22300,56977940,56978844
10280,6,12,1,2412,-55,-91,36,40:e3:d6:da:ba:20,56979608,136,628,56979472,56979608
10281,6,6,1,2412,-56,-91,35,40:e3:d6:da:ba:21,56979793,348,-163,56979445,56979793
10282,6,12,1,2412,-55,-91,36,40:e3:d6:da:ba:23,56980368,156,419,56980212,56980368
10283,6,12,1,2412,-55,-91,36,40:e3:d6:da:ba:25,56980559,136,55,56980423,56980559
10284,4,1,1,2412,-88,-91,3,,57002493,304,21630,57002189,57002493
10285,4,1,1,2412,-72,-91,19,b8:3a:5a:88:e6:e1,57007610,2376,2741,57005234,57007610
10286,6,6,1,2412,-58,-91,33,e6:aa:ea:c9:ea:33,57012032,408,4014,57011624,57012032
10287,6,12,1,2412,-58,-91,33,40:e3:d6:da:ba:20,57021261,160,9069,57021101,57021261
10288,6,6,1,2412,-58,-91,33,40:e3:d6:da:ba:21,57021462,368,-167,57021094,57021462
10289,6,12,1,2412,-58,-91,33,40:e3:d6:da:ba:22,57021867,180,225,57021687,57021867
10290,6,12,1,2412,-58,-91,33,40:e3:d6:da:ba:23,57022072,184,21,57021888,57022072
10291,6,12,1,2412,-58,-91,33,40:e3:d6:da:ba:24,57022299,176,51,57022123,57022299
10292,6,12,1,2412,-58,-91,33,40:e3:d6:da:ba:25,57022501,160,42,57022341,57022501
10293,6,6,1,2412,-58,-91,33,40:e3:d6:da:ba:26,57022693,380,-188,57022313,57022693
10294,6,6,1,2412,-58,-91,33,e6:aa:ea:c9:ea:33,57024068,408,967,57023660,57024068
10295,6,6,1,2412,-59,-91,32,e6:aa:ea:c9:ea:33,57036183,408,11707,57035775,57036183
10296,4,1,1,2412,-89,-91,2,,57046213,304,9726,57045909,57046213
10297,6,6,1,2412,-59,-91,32,e6:aa:ea:c9:ea:33,57048291,408,1670,57047883,57048291
10298,6,6,1,2412,-78,-91,13,e6:aa:ea:b7:4a:dd,57099716,408,51017,57099308,57099716
10299,6,12,1,2412,-60,-91,31,40:e3:d6:da:ba:20,57123468,160,23592,57123308,57123468
10300,6,12,1,2412,-60,-91,31,40:e3:d6:da:ba:22,57124093,180,445,57123913,57124093
10301,6,12,1,2412,-60,-91,31,40:e3:d6:da:ba:23,57124325,184,48,57124141,57124325
10302,6,12,1,2412,-60,-91,31,40:e3:d6:da:ba:24,57124552,176,51,57124376,57124552
10303,6,12,1,2412,-60,-91,31,40:e3:d6:da:ba:25,57124781,160,69,57124621,57124781
10304,6,6,1,2412,-60,-91,31,40:e3:d6:da:ba:26,57124991,380,-170,57124611,57124991
10305,6,6,1,2412,-77,-91,14,e6:aa:ea:b7:4a:dd,57136063,408,10664,57135655,57136063
10306,6,12,1,2412,-60,-91,31,40:e3:d6:da:ba:20,57225866,160,89643,57225706,57225866
10307,6,6,1,2412,-60,-91,31,40:e3:d6:da:ba:21,57226076,368,-158,57225708,57226076
10308,6,12,1,2412,-60,-91,31,40:e3:d6:da:ba:22,57226481,180,225,57226301,57226481
10309,6,12,1,2412,-60,-91,31,40:e3:d6:da:ba:23,57226695,184,30,57226511,57226695
10310,6,12,1,2412,-60,-91,31,40:e3:d6:da:ba:24,57226923,176,52,57226747,57226923
10311,6,12,1,2412,-60,-91,31,40:e3:d6:da:ba:25,57227151,160,68,57226991,57227151
10312,6,6,1,2412,-60,-91,31,40:e3:d6:da:ba:26,57227361,380,-170,57226981,57227361
10313,4,1,1,2412,-73,-91,18,54:e4:3a:ec:fb:64,57284605,2160,55084,57282445,57284605
10314,4,1,1,2412,-63,-91,28,be:b3:83:b0:b4:99,57298362,1152,12605,57297210,57298362
10315,4,1,1,2412,-71,-91,20,54:e4:3a:ec:fb:64,57299633,2112,-841,57297521,57299633
10316,4,1,1,2412,-75,-91,16,54:e4:3a:ec:fb:64,57302080,2112,335,57299968,57302080
10317,4,1,1,2412,-78,-91,13,,57304205,304,1821,57303901,57304205
10318,6,6,1,2412,-61,-91,30,e6:aa:ea:c9:ea:33,57315463,408,10850,57315055,57315463
10319,4,1,1,2412,-75,-91,16,54:e4:3a:ec:fb:64,57319928,2112,2353,57317816,57319928
10320,4,1,1,2412,-83,-91,8,,57322053,304,1821,57321749,57322053
10321,6,12,1,2412,-63,-91,28,40:e3:d6:da:ba:20,57322217,136,28,57322081,57322217
10322,4,1,1,2412,-73,-91,18,54:e4:3a:ec:fb:64,57322544,2112,-1785,57320432,57322544
10323,6,6,1,2412,-63,-91,28,40:e3:d6:da:ba:21,57325414,348,2522,57325066,57325414
10324,4,1,1,2412,-73,-91,18,54:e4:3a:ec:fb:64,57331074,2112,3548,57328962,57331074
10325,6,12,1,2412,-60,-91,31,40:e3:d6:da:ba:25,57333803,136,2593,57333667,57333803
10326,6,6,1,2412,-60,-91,31,e6:aa:ea:c9:ea:33,57339839,408,5628,57339431,57339839
10327,6,6,1,2412,-59,-91,32,e6:aa:ea:c9:ea:33,57363950,408,23703,57363542,57363950
10328,4,1,1,2412,-77,-91,14,54:e4:3a:ec:fb:64,57386952,2160,20842,57384792,57386952
10329,4,1,1,2412,-85,-91,6,,57409792,304,22536,57409488,57409792
10330,4,1,1,2412,-87,-91,4,a6:e5:7c:28:b1:d3,57412470,944,1734,57411526,57412470
10331,4,1,1,2412,-77,-91,14,b8:3a:5a:88:e6:e0,57414543,2360,-287,57412183,57414543
10332,6,12,1,2412,-59,-91,32,40:e3:d6:da:ba:20,57430669,160,15966,57430509,57430669
10333,6,6,1,2412,-59,-91,32,40:e3:d6:da:ba:21,57430870,368,-167,57430502,57430870
10334,6,12,1,2412,-59,-91,32,40:e3:d6:da:ba:22,57431275,180,225,57431095,57431275
10335,6,12,1,2412,-59,-91,32,40:e3:d6:da:ba:23,57431507,184,48,57431323,57431507
10336,6,12,1,2412,-59,-91,32,40:e3:d6:da:ba:24,57431744,176,61,57431568,57431744
10337,6,12,1,2412,-59,-91,32,40:e3:d6:da:ba:25,57431972,160,68,57431812,57431972
10338,6,6,1,2412,-59,-91,32,40:e3:d6:da:ba:26,57432164,380,-188,57431784,57432164
10339,6,6,1,2412,-78,-91,13,e6:aa:ea:b7:4a:dd,57438923,408,6351,57438515,57438923
10340,4,1,1,2412,-83,-91,8,c0:c9:e3:4d:6e:bf,57447745,872,7950,57446873,57447745
10341,4,1,1,2412,-75,-91,16,54:e4:3a:ec:fb:64,57489398,2160,39493,57487238,57489398
10342,4,1,1,2412,-79,-91,12,b8:3a:5a:88:e6:e0,57516944,2360,25186,57514584,57516944
10343,4,1,1,2412,-79,-91,12,b8:3a:5a:88:e6:e1,57519341,2376,21,57516965,57519341
10344,6,12,1,2412,-57,-91,34,40:e3:d6:da:ba:20,57533059,160,13558,57532899,57533059
10345,6,6,1,2412,-57,-91,34,40:e3:d6:da:ba:21,57533260,368,-167,57532892,57533260
10346,6,12,1,2412,-57,-91,34,40:e3:d6:da:ba:22,57533798,180,358,57533618,57533798
10347,6,12,1,2412,-57,-91,34,40:e3:d6:da:ba:23,57534021,184,39,57533837,57534021
10348,6,12,1,2412,-57,-91,34,40:e3:d6:da:ba:24,57534231,176,34,57534055,57534231
10349,6,12,1,2412,-57,-91,34,40:e3:d6:da:ba:25,57534450,160,59,57534290,57534450
10350,4,1,1,2412,-82,-91,9,a6:e5:7c:28:b1:d3,57579161,992,43719,57578169,57579161
10351,4,1,1,2412,-72,-91,19,b8:3a:5a:88:e6:e0,57619344,2360,37823,57616984,57619344
10352,4,1,1,2412,-80,-91,11,b8:3a:5a:88:e6:e1,57621751,2376,31,57619375,57621751
10353,6,6,1,2412,-58,-91,33,e6:aa:ea:c9:ea:33,57629742,408,7583,57629334,57629742
10354,6,12,1,2412,-57,-91,34,40:e3:d6:da:ba:20,57635459,160,5557,57635299,57635459
10355,6,6,1,2412,-57,-91,34,40:e3:d6:da:ba:21,57635651,368,-176,57635283,57635651
10356,6,12,1,2412,-56,-91,35,40:e3:d6:da:ba:22,57636065,180,234,57635885,57636065
10357,6,12,1,2412,-56,-91,35,40:e3:d6:da:ba:23,57636280,184,31,57636096,57636280
10358,6,12,1,2412,-56,-91,35,40:e3:d6:da:ba:24,57636516,176,60,57636340,57636516
10359,6,12,1,2412,-56,-91,35,40:e3:d6:da:ba:25,57636727,160,51,57636567,57636727
10360,6,6,1,2412,-57,-91,34,40:e3:d6:da:ba:26,57636927,380,-180,57636547,57636927
10361,6,6,1,2412,-58,-91,33,e6:aa:ea:c9:ea:33,57642073,408,4738,57641665,57642073
10362,4,1,1,2412,-85,-91,6,a6:e5:7c:28:b1:d3,57662042,944,19025,57661098,57662042
10363,4,1,1,2412,-84,-91,7,a6:e5:7c:28:b1:d3,57663102,944,116,57662158,57663102
10364,4,1,1,2412,-85,-91,6,a6:e5:7c:28:b1:d3,57664162,944,116,57663218,57664162
10365,4,1,1,2412,-84,-91,7,a6:e5:7c:28:b1:d3,57665276,944,170,57664332,57665276
10366,6,6,1,2412,-58,-91,33,e6:aa:ea:c9:ea:33,57666092,408,408,57665684,57666092
10367,4,1,1,2412,-85,-91,6,a6:e5:7c:28:b1:d3,57667396,944,360,57666452,57667396
10368,4,1,1,2412,-84,-91,7,a6:e5:7c:28:b1:d3,57668465,944,125,57667521,57668465
10369,4,1,1,2412,-85,-91,6,a6:e5:7c:28:b1:d3,57669525,944,116,57668581,57669525
10370,4,1,1,2412,-84,-91,7,a6:e5:7c:28:b1:d3,57671681,944,1212,57670737,57671681
10371,6,6,1,2412,-58,-91,33,e6:aa:ea:c9:ea:33,57678207,408,6118,57677799,57678207
10372,4,1,1,2412,-76,-91,15,54:e4:3a:ec:fb:64,57694006,2160,13639,57691846,57694006
10373,4,1,1,2412,-80,-91,11,b8:3a:5a:88:e6:e0,57723884,2360,27518,57721524,57723884
10374,4,1,1,2412,-81,-91,10,b8:3a:5a:88:e6:e1,57726290,2376,30,57723914,57726290
10375,6,6,1,2412,-78,-91,13,e6:aa:ea:b7:4a:dd,57729664,408,2966,57729256,57729664
10376,6,12,1,2412,-57,-91,34,40:e3:d6:da:ba:20,57737860,160,8036,57737700,57737860
10377,6,6,1,2412,-57,-91,34,40:e3:d6:da:ba:21,57738070,368,-158,57737702,57738070
10378,6,12,1,2412,-57,-91,34,40:e3:d6:da:ba:22,57738457,180,207,57738277,57738457
10379,6,12,1,2412,-57,-91,34,40:e3:d6:da:ba:23,57738689,184,48,57738505,57738689
10380,6,12,1,2412,-57,-91,34,40:e3:d6:da:ba:24,57738899,176,34,57738723,57738899
10381,6,12,1,2412,-57,-91,34,40:e3:d6:da:ba:25,57739109,160,50,57738949,57739109
10382,6,6,1,2412,-57,-91,34,40:e3:d6:da:ba:26,57739319,380,-170,57738939,57739319
10383,6,6,1,2412,-77,-91,14,e6:aa:ea:b7:4a:dd,57741777,408,2050,57741369,57741777
10384,6,6,1,2412,-78,-91,13,e6:aa:ea:b7:4a:dd,57753898,408,11713,57753490,57753898
10385,6,6,1,2412,-77,-91,14,e6:aa:ea:b7:4a:dd,57766016,408,11710,57765608,57766016
10386,4,1,1,2412,-75,-91,16,54:e4:3a:ec:fb:64,57796412,2160,28236,57794252,57796412
10387,6,12,1,2412,-54,-91,37,40:e3:d6:da:ba:20,57840263,160,43691,57840103,57840263
10388,6,6,1,2412,-54,-91,37,40:e3:d6:da:ba:21,57840455,368,-176,57840087,57840455
10389,6,12,1,2412,-54,-91,37,40:e3:d6:da:ba:22,57840860,180,225,57840680,57840860
10390,6,12,1,2412,-54,-91,37,40:e3:d6:da:ba:23,57841074,184,30,57840890,57841074
10391,6,12,1,2412,-54,-91,37,40:e3:d6:da:ba:24,57841311,176,61,57841135,57841311
10392,6,12,1,2412,-54,-91,37,40:e3:d6:da:ba:25,57841512,160,41,57841352,57841512
10393,6,6,1,2412,-54,-91,37,40:e3:d6:da:ba:26,57841731,380,-161,57841351,57841731
10394,4,1,1,2412,-77,-91,14,54:e4:3a:ec:fb:64,57898866,2160,54975,57896706,57898866
10395,4,1,1,2412,-78,-91,13,b8:3a:5a:88:e6:e0,57926550,2360,25324,57924190,57926550
10396,4,1,1,2412,-76,-91,15,b8:3a:5a:88:e6:e1,57928948,2376,22,57926572,57928948
10397,6,6,1,2412,-53,-91,38,40:e3:d6:da:ba:21,57943239,368,13923,57942871,57943239
10398,6,12,1,2412,-53,-91,38,40:e3:d6:da:ba:23,57943876,184,453,57943692,57943876
10399,6,6,1,2412,-63,-91,28,e6:aa:ea:c9:ea:33,57945366,408,1082,57944958,57945366
10400,6,6,1,2412,-62,-91,29,e6:aa:ea:c9:ea:33,57957397,408,11623,57956989,57957397
10401,6,6,1,2412,-62,-91,29,e6:aa:ea:c9:ea:33,57969513,408,11708,57969105,57969513
10402,4,1,1,2412,-82,-91,9,c0:c9:e3:4d:6e:bf,57986602,872,16217,57985730,57986602
10403,4,1,1,2412,-90,-91,1,,57987492,304,586,57987188,57987492
10404,6,6,1,2412,-60,-91,31,e6:aa:ea:c9:ea:33,57993753,408,5853,57993345,57993753
10405,4,1,1,2412,-75,-91,16,b8:3a:5a:88:e6:e0,58029201,2360,33088,58026841,58029201
10406,4,1,1,2412,-76,-91,15,b8:3a:5a:88:e6:e1,58031590,2376,13,58029214,58031590
10407,6,12,1,2412,-51,-91,40,40:e3:d6:da:ba:20,58045073,160,13323,58044913,58045073
10408,6,6,1,2412,-51,-91,40,40:e3:d6:da:ba:21,58045266,368,-175,58044898,58045266
10409,6,12,1,2412,-51,-91,40,40:e3:d6:da:ba:22,58045671,180,225,58045491,58045671
10410,6,12,1,2412,-51,-91,40,40:e3:d6:da:ba:23,58045876,184,21,58045692,58045876
10411,6,12,1,2412,-51,-91,40,40:e3:d6:da:ba:24,58046123,176,71,58045947,58046123
10412,6,12,1,2412,-51,-91,40,40:e3:d6:da:ba:25,58046325,160,42,58046165,58046325
10413,4,1,1,2412,-63,-91,28,a6:e5:7c:28:b1:d3,58055654,944,8385,58054710,58055654
10414,4,1,1,2412,-86,-91,5,a6:e5:7c:28:b1:d3,58056928,944,330,58055984,58056928
10415,4,1,1,2412,-85,-91,6,a6:e5:7c:28:b1:d3,58057997,944,125,58057053,58057997
10416,4,1,1,2412,-86,-91,5,a6:e5:7c:28:b1:d3,58060126,944,1185,58059182,58060126
10417,4,1,1,2412,-74,-91,17,a6:e5:7c:28:b1:d3,58061231,944,161,58060287,58061231
10418,4,1,1,2412,-81,-91,10,a6:e5:7c:28:b1:d3,58062414,944,239,58061470,58062414
10419,4,1,1,2412,-79,-91,12,a6:e5:7c:28:b1:d3,58063479,944,121,58062535,58063479
10420,4,1,1,2412,-79,-91,12,a6:e5:7c:28:b1:d3,58064576,944,153,58063632,58064576
10421,4,1,1,2412,-86,-91,5,a6:e5:7c:28:b1:d3,58065802,944,282,58064858,58065802
10422,4,1,1,2412,-73,-91,18,a6:e5:7c:28:b1:d3,58066870,944,124,58065926,58066870
10423,4,1,1,2412,-84,-91,7,a6:e5:7c:28:b1:d3,58070041,944,2227,58069097,58070041
10424,4,1,1,2412,-85,-91,6,a6:e5:7c:28:b1:d3,58071101,944,116,58070157,58071101
10425,4,1,1,2412,-49,-91,42,a6:e5:7c:28:b1:d3,58075619,944,3574,58074675,58075619
10426,4,1,1,2412,-74,-91,17,a6:e5:7c:28:b1:d3,58077838,944,1275,58076894,58077838
10427,4,1,1,2412,-86,-91,5,a6:e5:7c:28:b1:d3,58078889,944,107,58077945,58078889
10428,4,1,1,2412,-85,-91,6,a6:e5:7c:28:b1:d3,58079949,944,116,58079005,58079949
10429,4,1,1,2412,-79,-91,12,a6:e5:7c:28:b1:d3,58081018,944,125,58080074,58081018
10430,4,1,1,2412,-85,-91,6,a6:e5:7c:28:b1:d3,58082096,944,134,58081152,58082096
10431,4,1,1,2412,-81,-91,10,54:e4:3a:ec:fb:64,58103795,2160,19539,58101635,58103795
10432,4,1,1,2412,-89,-91,2,,58110153,304,6054,58109849,58110153
10433,4,1,1,2412,-88,-91,3,,58114383,304,3926,58114079,58114383
10434,4,1,1,2412,-74,-91,17,b8:3a:5a:88:e6:e1,58135252,2376,18493,58132876,58135252
10435,6,12,1,2412,-56,-91,35,40:e3:d6:da:ba:20,58147464,160,12052,58147304,58147464
10436,6,6,1,2412,-56,-91,35,40:e3:d6:da:ba:21,58147674,368,-158,58147306,58147674
10437,6,12,1,2412,-56,-91,35,40:e3:d6:da:ba:22,58148079,180,225,58147899,58148079
10438,6,12,1,2412,-56,-91,35,40:e3:d6:da:ba:23,58148294,184,31,58148110,58148294
10439,6,12,1,2412,-56,-91,35,40:e3:d6:da:ba:24,58148512,176,42,58148336,58148512
10440,6,12,1,2412,-56,-91,35,40:e3:d6:da:ba:25,58148714,160,42,58148554,58148714
10441,6,6,1,2412,-55,-91,36,40:e3:d6:da:ba:26,58148914,380,-180,58148534,58148914
10442,4,1,1,2412,-74,-91,17,b8:3a:5a:88:e6:e0,58234760,2360,83486,58232400,58234760
10443,4,1,1,2412,-74,-91,17,b8:3a:5a:88:e6:e1,58237139,2376,3,58234763,58237139
10444,6,12,1,2412,-54,-91,37,40:e3:d6:da:ba:20,58249862,160,12563,58249702,58249862
10445,6,6,1,2412,-54,-91,37,40:e3:d6:da:ba:21,58250097,368,-133,58249729,58250097
10446,6,12,1,2412,-54,-91,37,40:e3:d6:da:ba:23,58250743,184,462,58250559,58250743
10447,6,6,1,2412,-54,-91,37,40:e3:d6:da:ba:26,58251355,380,232,58250975,58251355
10448,6,6,1,2412,-60,-91,31,e6:aa:ea:c9:ea:33,58259945,408,8182,58259537,58259945
10449,6,6,1,2412,-76,-91,15,e6:aa:ea:b7:4a:dd,58261187,408,834,58260779,58261187
10450,6,6,1,2412,-60,-91,31,e6:aa:ea:c9:ea:33,58271915,408,10320,58271507,58271915
10451,6,6,1,2412,-76,-91,15,e6:aa:ea:b7:4a:dd,58273305,408,982,58272897,58273305
10452,6,6,1,2412,-60,-91,31,e6:aa:ea:c9:ea:33,58284025,408,10312,58283617,58284025
10453,6,6,1,2412,-76,-91,15,e6:aa:ea:b7:4a:dd,58285422,408,989,58285014,58285422
10454,6,6,1,2412,-61,-91,30,e6:aa:ea:c9:ea:33,58296182,408,10352,58295774,58296182
10455,4,1,1,2412,-77,-91,14,b8:3a:5a:88:e6:e0,58336162,2360,37620,58333802,58336162
10456,6,12,1,2412,-57,-91,34,40:e3:d6:da:ba:20,58352288,160,15966,58352128,58352288
10457,6,6,1,2412,-56,-91,35,40:e3:d6:da:ba:21,58352480,368,-176,58352112,58352480
10458,6,12,1,2412,-56,-91,35,40:e3:d6:da:ba:22,58352901,180,241,58352721,58352901
10459,6,12,1,2412,-56,-91,35,40:e3:d6:da:ba:23,58353107,184,22,58352923,58353107
10460,6,12,1,2412,-57,-91,34,40:e3:d6:da:ba:24,58353325,176,42,58353149,58353325
10461,6,12,1,2412,-57,-91,34,40:e3:d6:da:ba:25,58353554,160,69,58353394,58353554
10462,6,6,1,2412,-56,-91,35,40:e3:d6:da:ba:26,58353763,380,-171,58353383,58353763
10463,4,1,1,2412,-80,-91,11,54:e4:3a:ec:fb:64,58410993,2160,55070,58408833,58410993
10464,4,1,1,2412,-82,-91,9,,58422149,304,10852,58421845,58422149
10465,4,1,1,2412,-79,-91,12,b8:3a:5a:88:e6:e0,58422486,2240,-1903,58420246,58422486
10466,4,1,1,2412,-86,-91,5,,58433746,304,10956,58433442,58433746
10467,4,1,1,2412,-80,-91,11,b8:3a:5a:88:e6:e0,58438745,2360,2639,58436385,58438745
10468,4,1,1,2412,-71,-91,20,b8:3a:5a:88:e6:e1,58441125,2376,4,58438749,58441125
10469,4,1,1,2412,-89,-91,2,,58444700,304,3271,58444396,58444700
10470,6,12,1,2412,-57,-91,34,40:e3:d6:da:ba:20,58454670,160,9810,58454510,58454670
10471,6,6,1,2412,-57,-91,34,40:e3:d6:da:ba:21,58454889,368,-149,58454521,58454889
10472,6,12,1,2412,-57,-91,34,40:e3:d6:da:ba:22,58455276,180,207,58455096,58455276
10473,6,12,1,2412,-57,-91,34,40:e3:d6:da:ba:23,58455509,184,49,58455325,58455509
10474,6,12,1,2412,-57,-91,34,40:e3:d6:da:ba:24,58455745,176,60,58455569,58455745
10475,6,6,1,2412,-57,-91,34,40:e3:d6:da:ba:26,58456156,380,31,58455776,58456156
10476,4,1,1,2412,-89,-91,2,,58467989,304,11529,58467685,58467989
10477,4,1,1,2412,-88,-91,3,,58479604,304,11311,58479300,58479604
10478,4,1,1,2412,-73,-91,18,b8:3a:5a:88:e6:e1,58545085,2376,63105,58542709,58545085
10479,6,12,1,2412,-56,-91,35,40:e3:d6:da:ba:23,58557911,184,12642,58557727,58557911
10480,6,12,1,2412,-56,-91,35,40:e3:d6:da:ba:24,58558148,176,61,58557972,58558148
10481,6,12,1,2412,-56,-91,35,40:e3:d6:da:ba:25,58558376,160,68,58558216,58558376
10482,6,6,1,2412,-56,-91,35,40:e3:d6:da:ba:26,58558586,380,-170,58558206,58558586
10483,4,1,1,2412,-77,-91,14,54:e4:3a:ec:fb:64,58615603,2160,54857,58613443,58615603
10484,6,6,1,2412,-75,-91,16,e6:aa:ea:b7:4a:dd,58654828,408,38817,58654420,58654828
10485,6,6,1,2412,-59,-91,32,40:e3:d6:da:ba:21,58659664,368,4468,58659296,58659664
10486,6,12,1,2412,-59,-91,32,40:e3:d6:da:ba:22,58660061,180,217,58659881,58660061
10487,6,12,1,2412,-59,-91,32,40:e3:d6:da:ba:23,58660284,184,39,58660100,58660284
10488,6,12,1,2412,-59,-91,32,40:e3:d6:da:ba:24,58660493,176,33,58660317,58660493
10489,6,12,1,2412,-59,-91,32,40:e3:d6:da:ba:25,58660713,160,60,58660553,58660713
10490,6,6,1,2412,-59,-91,32,40:e3:d6:da:ba:26,58660932,380,-161,58660552,58660932
10491,6,6,1,2412,-74,-91,17,e6:aa:ea:b7:4a:dd,58666951,408,5611,58666543,58666951
10492,6,6,1,2412,-75,-91,16,e6:aa:ea:b7:4a:dd,58691184,408,23825,58690776,58691184
10493,6,6,1,2412,-74,-91,17,e6:aa:ea:b7:4a:dd,58703313,408,11721,58702905,58703313
10494,4,1,1,2412,-73,-91,18,54:e4:3a:ec:fb:64,58717996,2160,12523,58715836,58717996
10495,4,1,1,2412,-80,-91,11,b8:3a:5a:88:e6:e0,58748587,2360,28231,58746227,58748587
10496,4,1,1,2412,-81,-91,10,b8:3a:5a:88:e6:e1,58750985,2376,22,58748609,58750985
10497,6,12,1,2412,-62,-91,29,40:e3:d6:da:ba:20,58761868,160,10723,58761708,58761868
10498,6,6,1,2412,-62,-91,29,40:e3:d6:da:ba:21,58762078,368,-158,58761710,58762078
10499,6,12,1,2412,-62,-91,29,40:e3:d6:da:ba:22,58762508,180,250,58762328,58762508
10500,6,12,1,2412,-62,-91,29,40:e3:d6:da:ba:23,58762740,184,48,58762556,58762740
10501,6,12,1,2412,-62,-91,29,40:e3:d6:da:ba:24,58762958,176,42,58762782,58762958
10502,6,12,1,2412,-62,-91,29,40:e3:d6:da:ba:25,58763160,160,42,58763000,58763160
10503,6,6,1,2412,-62,-91,29,40:e3:d6:da:ba:26,58763370,380,-170,58762990,58763370
10504,6,6,1,2412,-58,-91,33,e6:aa:ea:c9:ea:33,58780020,408,16242,58779612,58780020
10505,6,6,1,2412,-58,-91,33,e6:aa:ea:c9:ea:33,58816420,408,35992,58816012,58816420
10506,4,1,1,2412,-78,-91,13,b8:3a:5a:88:e6:e0,58848172,2360,29392,58845812,58848172
10507,4,1,1,2412,-75,-91,16,b8:3a:5a:88:e6:e1,58850570,2376,22,58848194,58850570
10508,6,12,1,2412,-61,-91,30,40:e3:d6:da:ba:20,58864282,160,13552,58864122,58864282
10509,6,6,1,2412,-61,-91,30,40:e3:d6:da:ba:21,58864474,368,-176,58864106,58864474
10510,6,12,1,2412,-61,-91,30,40:e3:d6:da:ba:22,58864879,180,225,58864699,58864879
10511,6,12,1,2412,-61,-91,30,40:e3:d6:da:ba:23,58865112,184,49,58864928,58865112
10512,6,12,1,2412,-62,-91,29,40:e3:d6:da:ba:24,58865330,176,42,58865154,58865330
10513,6,12,1,2412,-62,-91,29,40:e3:d6:da:ba:25,58865558,160,68,58865398,58865558
10514,6,6,1,2412,-62,-91,29,40:e3:d6:da:ba:26,58865759,380,-179,58865379,58865759
10515,4,1,1,2412,-77,-91,14,54:e4:3a:ec:fb:64,58922996,2160,55077,58920836,58922996
10516,6,12,1,2412,-62,-91,29,40:e3:d6:da:ba:20,58966674,160,43518,58966514,58966674
10517,6,6,1,2412,-62,-91,29,40:e3:d6:da:ba:21,58966866,368,-176,58966498,58966866
10518,6,12,1,2412,-62,-91,29,40:e3:d6:da:ba:22,58967271,180,225,58967091,58967271
10519,6,12,1,2412,-62,-91,29,40:e3:d6:da:ba:23,58967476,184,21,58967292,58967476
10520,6,12,1,2412,-62,-91,29,40:e3:d6:da:ba:24,58967686,176,34,58967510,58967686
10521,6,12,1,2412,-62,-91,29,40:e3:d6:da:ba:25,58967905,160,59,58967745,58967905
10522,6,6,1,2412,-62,-91,29,40:e3:d6:da:ba:26,58968124,380,-161,58967744,58968124
10523,4,1,1,2412,-87,-91,4,,58976925,304,8497,58976621,58976925
10524,4,1,1,2412,-88,-91,3,6e:e9:52:28:21:11,58999052,1152,20975,58997900,58999052
10525,4,1,1,2412,-64,-91,27,a6:e5:7c:28:b1:d3,59012284,992,12240,59011292,59012284
10526,4,1,1,2412,-76,-91,15,b8:3a:5a:88:e6:e0,59052948,2360,38304,59050588,59052948
10527,4,1,1,2412,-76,-91,15,b8:3a:5a:88:e6:e1,59055336,2376,12,59052960,59055336
10528,6,12,1,2412,-63,-91,28,40:e3:d6:da:ba:20,59069078,160,13582,59068918,59069078
10529,6,12,1,2412,-62,-91,29,40:e3:d6:da:ba:23,59069916,184,654,59069732,59069916
10530,6,12,1,2412,-63,-91,28,40:e3:d6:da:ba:24,59070126,176,34,59069950,59070126
10531,6,12,1,2412,-62,-91,29,40:e3:d6:da:ba:25,59070336,160,50,59070176,59070336
10532,6,6,1,2412,-62,-91,29,40:e3:d6:da:ba:26,59070537,380,-179,59070157,59070537
10533,6,6,1,2412,-76,-91,15,e6:aa:ea:b7:4a:dd,59085185,408,14240,59084777,59085185
10534,6,6,1,2412,-76,-91,15,e6:aa:ea:b7:4a:dd,59121542,408,35949,59121134,59121542
10535,4,1,1,2412,-76,-91,15,54:e4:3a:ec:fb:64,59127597,2160,3895,59125437,59127597
10536,4,1,1,2412,-77,-91,14,b8:3a:5a:88:e6:e0,59155361,2360,25404,59153001,59155361
10537,4,1,1,2412,-76,-91,15,b8:3a:5a:88:e6:e1,59158057,2376,320,59155681,59158057
10538,6,12,1,2412,-62,-91,29,40:e3:d6:da:ba:20,59171489,160,13272,59171329,59171489
10539,6,6,1,2412,-62,-91,29,40:e3:d6:da:ba:21,59171681,368,-176,59171313,59171681
10540,6,12,1,2412,-61,-91,30,40:e3:d6:da:ba:22,59172076,180,215,59171896,59172076
10541,6,12,1,2412,-62,-91,29,40:e3:d6:da:ba:23,59172282,184,22,59172098,59172282
10542,6,12,1,2412,-61,-91,30,40:e3:d6:da:ba:25,59172702,160,260,59172542,59172702
10543,4,1,1,2412,-76,-91,15,b8:3a:5a:88:e6:e1,59176014,2256,1056,59173758,59176014
10544,6,6,1,2412,-86,-91,5,48:e7:da:41:38:ff,59204628,88,28526,59204540,59204628
10545,6,6,1,2412,-62,-91,29,e6:aa:ea:c9:ea:33,59209930,408,4894,59209522,59209930
10546,4,1,1,2412,-88,-91,3,a6:e5:7c:28:b1:d3,59217501,992,6579,59216509,59217501
10547,6,6,1,2412,-62,-91,29,e6:aa:ea:c9:ea:33,59222607,408,4698,59222199,59222607
10548,6,6,1,2412,-62,-91,29,e6:aa:ea:c9:ea:33,59234156,408,11141,59233748,59234156
10549,6,6,1,2412,-62,-91,29,e6:aa:ea:c9:ea:33,59246277,408,11713,59245869,59246277
10550,4,1,1,2412,-77,-91,14,b8:3a:5a:88:e6:e0,59257770,2360,9133,59255410,59257770
10551,4,1,1,2412,-77,-91,14,b8:3a:5a:88:e6:e1,59260149,2376,3,59257773,59260149
10552,6,12,1,2412,-62,-91,29,40:e3:d6:da:ba:20,59273884,160,13575,59273724,59273884
10553,6,6,1,2412,-61,-91,30,40:e3:d6:da:ba:21,59274076,368,-176,59273708,59274076
10554,6,12,1,2412,-61,-91,30,40:e3:d6:da:ba:22,59274463,180,207,59274283,59274463
10555,6,12,1,2412,-61,-91,30,40:e3:d6:da:ba:23,59274668,184,21,59274484,59274668
10556,6,12,1,2412,-61,-91,30,40:e3:d6:da:ba:24,59274896,176,52,59274720,59274896
10557,6,12,1,2412,-61,-91,30,40:e3:d6:da:ba:25,59275124,160,68,59274964,59275124
10558,4,1,1,2412,-71,-91,20,54:e4:3a:ec:fb:64,59340739,2112,63503,59338627,59340739
10559,4,1,1,2412,-78,-91,13,b8:3a:5a:88:e6:e1,59362706,2376,19591,59360330,59362706
10560,6,12,1,2412,-61,-91,30,40:e3:d6:da:ba:20,59376267,160,13401,59376107,59376267
10561,6,6,1,2412,-61,-91,30,40:e3:d6:da:ba:21,59376476,368,-159,59376108,59376476
10562,6,12,1,2412,-61,-91,30,40:e3:d6:da:ba:22,59376864,180,208,59376684,59376864
10563,6,12,1,2412,-61,-91,30,40:e3:d6:da:ba:23,59377096,184,48,59376912,59377096
10564,6,12,1,2412,-61,-91,30,40:e3:d6:da:ba:24,59377323,176,51,59377147,59377323
10565,6,12,1,2412,-61,-91,30,40:e3:d6:da:ba:25,59377534,160,51,59377374,59377534
10566,6,6,1,2412,-61,-91,30,40:e3:d6:da:ba:26,59377753,380,-161,59377373,59377753
10567,6,6,1,2412,-79,-91,12,e6:aa:ea:b7:4a:dd,59400253,408,22092,59399845,59400253
10568,6,6,1,2412,-78,-91,13,e6:aa:ea:b7:4a:dd,59412391,408,11730,59411983,59412391
10569,4,1,1,2412,-79,-91,12,c0:c9:e3:4d:6e:bf,59422191,872,8928,59421319,59422191
10570,4,1,1,2412,-85,-91,6,,59423081,304,586,59422777,59423081
10571,6,6,1,2412,-78,-91,13,e6:aa:ea:b7:4a:dd,59424484,408,995,59424076,59424484
10572,4,1,1,2412,-86,-91,5,a6:e5:7c:28:b1:d3,59427620,992,2144,59426628,59427620
10573,4,1,1,2412,-76,-91,15,54:e4:3a:ec:fb:64,59434970,2160,5190,59432810,59434970
10574,6,6,1,2412,-81,-91,10,84:1b:5e:df:1b:99,59455805,80,20755,59455725,59455805
10575,4,1,1,2412,-79,-91,12,b8:3a:5a:88:e6:e0,59465385,2360,7220,59463025,59465385
10576,4,1,1,2412,-78,-91,13,b8:3a:5a:88:e6:e1,59467783,2376,22,59465407,59467783
10577,6,12,1,2412,-61,-91,30,40:e3:d6:da:ba:20,59478676,160,10733,59478516,59478676
10578,6,6,1,2412,-61,-91,30,40:e3:d6:da:ba:21,59478886,368,-158,59478518,59478886
10579,6,12,1,2412,-61,-91,30,40:e3:d6:da:ba:22,59479282,180,216,59479102,59479282
10580,6,12,1,2412,-61,-91,30,40:e3:d6:da:ba:23,59479505,184,39,59479321,59479505
10581,6,12,1,2412,-61,-91,30,40:e3:d6:da:ba:24,59479742,176,61,59479566,59479742
10582,6,12,1,2412,-61,-91,30,40:e3:d6:da:ba:25,59479952,160,50,59479792,59479952
10583,6,6,1,2412,-61,-91,30,40:e3:d6:da:ba:26,59480171,380,-161,59479791,59480171
10584,6,6,1,2412,-63,-91,28,e6:aa:ea:c9:ea:33,59525729,408,45150,59525321,59525729
10585,4,1,1,2412,-86,-91,5,a6:e5:7c:28:b1:d3,59527641,992,920,59526649,59527641
10586,6,6,1,2412,-63,-91,28,e6:aa:ea:c9:ea:33,59549838,408,21789,59549430,59549838
10587,6,6,1,2412,-63,-91,28,e6:aa:ea:c9:ea:33,59561938,408,11692,59561530,59561938
10588,6,12,1,2412,-61,-91,30,40:e3:d6:da:ba:20,59581069,160,18971,59580909,59581069
10589,6,6,1,2412,-60,-91,31,40:e3:d6:da:ba:21,59581279,368,-158,59580911,59581279
10590,6,12,1,2412,-60,-91,31,40:e3:d6:da:ba:22,59581666,180,207,59581486,59581666
10591,6,12,1,2412,-61,-91,30,40:e3:d6:da:ba:23,59581872,184,22,59581688,59581872
10592,6,12,1,2412,-61,-91,30,40:e3:d6:da:ba:24,59582099,176,51,59581923,59582099
10593,6,12,1,2412,-61,-91,30,40:e3:d6:da:ba:25,59582300,160,41,59582140,59582300
10594,6,6,1,2412,-61,-91,30,40:e3:d6:da:ba:26,59582519,380,-161,59582139,59582519
10595,4,1,1,2412,-77,-91,14,54:e4:3a:ec:fb:64,59639627,2160,54948,59637467,59639627
10596,4,5.5,1,2412,-81,-91,10,e2:da:f6:6d:37:67,59657233,302,17304,59656931,59657233
10597,6,12,1,2412,-61,-91,30,40:e3:d6:da:ba:20,59657605,136,236,59657469,59657605
10598,6,12,1,2412,-61,-91,30,40:e3:d6:da:ba:25,59659910,136,2169,59659774,59659910
10599,6,12,1,2412,-83,-91,8,,59662943,32,3001,59662911,59662943
10600,4,5.5,1,2412,-80,-91,11,96:6b:46:82:67:bb,59678430,421,15066,59678009,59678430
10601,6,12,1,2412,-60,-91,31,40:e3:d6:da:ba:20,59678921,136,355,59678785,59678921
10602,6,12,1,2412,-61,-91,30,40:e3:d6:da:ba:23,59681341,156,2264,59681185,59681341
10603,6,12,1,2412,-60,-91,31,40:e3:d6:da:ba:25,59681540,136,63,59681404,59681540
10604,6,6,1,2412,-61,-91,30,40:e3:d6:da:ba:21,59684927,368,3019,59684559,59684927
10605,6,12,1,2412,-61,-91,30,40:e3:d6:da:ba:22,59685332,180,225,59685152,59685332
10606,6,12,1,2412,-60,-91,31,40:e3:d6:da:ba:23,59685537,184,21,59685353,59685537
10607,6,12,1,2412,-61,-91,30,40:e3:d6:da:ba:24,59685774,176,61,59685598,59685774
10608,6,12,1,2412,-61,-91,30,40:e3:d6:da:ba:25,59685984,160,50,59685824,59685984
10609,6,6,1,2412,-60,-91,31,40:e3:d6:da:ba:26,59686185,380,-179,59685805,59686185
10610,4,1,1,2412,-81,-91,10,96:6b:46:82:67:bb,59699936,1448,12303,59698488,59699936
10611,4,1,1,2412,-87,-91,4,,59701401,304,1161,59701097,59701401
10612,6,12,1,2412,-61,-91,30,40:e3:d6:da:ba:20,59701565,136,28,59701429,59701565
10613,6,12,1,2412,-81,-91,10,,59701722,32,125,59701690,59701722
10614,4,1,1,2412,-86,-91,5,a6:e5:7c:28:b1:d3,59701895,944,-771,59700951,59701895
10615,4,1,1,2412,-81,-91,10,,59702853,304,654,59702549,59702853
10616,6,6,1,2412,-61,-91,30,40:e3:d6:da:ba:21,59703024,348,-177,59702676,59703024
10617,6,12,1,2412,-60,-91,31,40:e3:d6:da:ba:22,59703399,156,219,59703243,59703399
10618,6,12,1,2412,-61,-91,30,40:e3:d6:da:ba:23,59703599,156,44,59703443,59703599
10619,6,6,1,2412,-83,-91,8,,59704024,44,381,59703980,59704024
10620,6,12,1,2412,-82,-91,9,,59704274,32,218,59704242,59704274
10621,6,12,1,2412,-83,-91,8,,59704518,32,212,59704486,59704518
10622,6,12,1,2412,-82,-91,9,,59704762,32,212,59704730,59704762
10623,6,12,1,2412,-82,-91,9,,59705014,32,220,59704982,59705014
10624,6,6,1,2412,-78,-91,13,78:8a:20:fa:27:f9,59707930,88,2828,59707842,59707930
10625,6,6,1,2412,-78,-91,13,,59708037,44,63,59707993,59708037
10626,4,1,1,2412,-79,-91,12,b8:3a:5a:88:e6:e0,59708414,2240,-1863,59706174,59708414
10627,4,1,1,2412,-78,-91,13,b8:3a:5a:88:e6:e1,59710700,2256,30,59708444,59710700
10628,4,1,1,2412,-81,-91,10,96:6b:46:82:67:bb,59717620,1448,5472,59716172,59717620
10629,6,12,1,2412,-61,-91,30,40:e3:d6:da:ba:20,59719249,136,1493,59719113,59719249
10630,6,12,1,2412,-82,-91,9,,59721868,32,2587,59721836,59721868
10631,4,1,1,2412,-79,-91,12,b8:3a:5a:88:e6:e1,59722912,2256,-1212,59720656,59722912
10632,6,12,1,2412,-83,-91,8,,59725232,32,2288,59725200,59725232
10633,6,6,1,2412,-78,-91,13,78:8a:20:fa:27:f9,59758230,88,32910,59758142,59758230
10634,6,6,1,2412,-78,-91,13,,59759543,44,1269,59759499,59759543
10635,6,12,1,2412,-78,-91,13,,59760758,32,1183,59760726,59760758
10636,4,1,1,2412,-78,-91,13,b8:3a:5a:88:e6:e0,59769757,2360,6639,59767397,59769757
10637,4,1,1,2412,-78,-91,13,b8:3a:5a:88:e6:e1,59772146,2376,13,59769770,59772146
10638,4,1,1,2412,-84,-91,7,a6:e5:7c:28:b1:d3,59781632,944,8542,59780688,59781632
10639,4,1,1,2412,-86,-91,5,a6:e5:7c:28:b1:d3,59782728,944,152,59781784,59782728
10640,4,1,1,2412,-86,-91,5,a6:e5:7c:28:b1:d3,59783842,944,170,59782898,59783842
10641,4,1,1,2412,-85,-91,6,a6:e5:7c:28:b1:d3,59785156,944,370,59784212,59785156
10642,4,1,1,2412,-79,-91,12,a6:e5:7c:28:b1:d3,59786379,944,279,59785435,59786379
10643,4,1,1,2412,-85,-91,6,a6:e5:7c:28:b1:d3,59787475,944,152,59786531,59787475
10644,6,12,1,2412,-61,-91,30,40:e3:d6:da:ba:20,59788264,160,629,59788104,59788264
10645,6,6,1,2412,-61,-91,30,40:e3:d6:da:ba:21,59788474,368,-158,59788106,59788474
10646,6,12,1,2412,-60,-91,31,40:e3:d6:da:ba:22,59789552,180,898,59789372,59789552
10647,6,12,1,2412,-61,-91,30,40:e3:d6:da:ba:25,59790602,160,890,59790442,59790602
10648,4,1,1,2412,-86,-91,5,a6:e5:7c:28:b1:d3,59790895,944,-651,59789951,59790895
10649,4,1,1,2412,-87,-91,4,a6:e5:7c:28:b1:d3,59791973,944,134,59791029,59791973
10650,4,1,1,2412,-85,-91,6,a6:e5:7c:28:b1:d3,59793078,944,161,59792134,59793078
10651,6,6,1,2412,-61,-91,30,40:e3:d6:da:ba:26,59794211,380,753,59793831,59794211
10652,6,6,1,2412,-78,-91,13,e6:aa:ea:b7:4a:dd,59806020,408,11401,59805612,59806020
10653,6,6,1,2412,-63,-91,28,e6:aa:ea:c9:ea:33,59828574,408,22146,59828166,59828574
10654,6,6,1,2412,-78,-91,13,e6:aa:ea:b7:4a:dd,59830308,408,1326,59829900,59830308
10655,4,1,1,2412,-77,-91,14,54:e4:3a:ec:fb:64,59844392,2160,11924,59842232,59844392
10656,6,6,1,2412,-63,-91,28,e6:aa:ea:c9:ea:33,59852721,408,7921,59852313,59852721
10657,6,6,1,2412,-79,-91,12,e6:aa:ea:b7:4a:dd,59854629,408,1500,59854221,59854629
10658,6,6,1,2412,-63,-91,28,e6:aa:ea:c9:ea:33,59864836,408,9799,59864428,59864836
10659,4,1,1,2412,-86,-91,5,a6:e5:7c:28:b1:d3,59873964,944,8184,59873020,59873964
10660,4,1,1,2412,-87,-91,4,a6:e5:7c:28:b1:d3,59875042,944,134,59874098,59875042
10661,4,1,1,2412,-86,-91,5,a6:e5:7c:28:b1:d3,59878321,944,2335,59877377,59878321
10662,4,1,1,2412,-77,-91,14,a6:e5:7c:28:b1:d3,59879417,944,152,59878473,59879417
10663,4,1,1,2412,-86,-91,5,a6:e5:7c:28:b1:d3,59881582,944,1221,59880638,59881582
10664,4,1,1,2412,-86,-91,5,a6:e5:7c:28:b1:d3,59883315,944,789,59882371,59883315
10665,4,1,1,2412,-86,-91,5,a6:e5:7c:28:b1:d3,59885188,944,929,59884244,59885188
10666,4,1,1,2412,-87,-91,4,a6:e5:7c:28:b1:d3,59886248,944,116,59885304,59886248
10667,6,12,1,2412,-61,-91,30,40:e3:d6:da:ba:20,59888269,160,1861,59888109,59888269
10668,6,6,1,2412,-61,-91,30,40:e3:d6:da:ba:21,59888461,368,-176,59888093,59888461
10669,6,12,1,2412,-61,-91,30,40:e3:d6:da:ba:22,59888866,180,225,59888686,59888866
10670,6,12,1,2412,-61,-91,30,40:e3:d6:da:ba:23,59889099,184,49,59888915,59889099
10671,6,12,1,2412,-61,-91,30,40:e3:d6:da:ba:24,59889326,176,51,59889150,59889326
10672,6,12,1,2412,-61,-91,30,40:e3:d6:da:ba:25,59889546,160,60,59889386,59889546
10673,6,6,1,2412,-61,-91,30,40:e3:d6:da:ba:26,59889737,380,-189,59889357,59889737
10674,4,1,1,2412,-88,-91,3,c0:c9:e3:4d:6e:bf,59914671,872,24062,59913799,59914671
10675,4,1,1,2412,-78,-91,13,54:e4:3a:ec:fb:64,59946794,2160,29963,59944634,59946794
10676,4,1,1,2412,-87,-91,4,a6:e5:7c:28:b1:d3,59966447,944,18709,59965503,59966447
10677,4,1,1,2412,-86,-91,5,a6:e5:7c:28:b1:d3,59967498,944,107,59966554,59967498
10678,4,1,1,2412,-82,-91,9,a6:e5:7c:28:b1:d3,59969760,944,1318,59968816,59969760
10679,4,1,1,2412,-86,-91,5,a6:e5:7c:28:b1:d3,59970874,944,170,59969930,59970874
10680,4,1,1,2412,-86,-91,5,a6:e5:7c:28:b1:d3,59972097,944,279,59971153,59972097
10681,4,1,1,2412,-87,-91,4,a6:e5:7c:28:b1:d3,59973487,944,446,59972543,59973487
10682,4,1,1,2412,-66,-91,25,b8:3a:5a:88:e6:e0,59974560,2360,-1287,59972200,59974560
10683,4,1,1,2412,-88,-91,3,a6:e5:7c:28:b1:d3,59976902,944,1398,59975958,59976902
10684,4,1,1,2412,-86,-91,5,a6:e5:7c:28:b1:d3,59978016,944,170,59977072,59978016
10685,4,1,1,2412,-86,-91,5,a6:e5:7c:28:b1:d3,59988029,944,9069,59987085,59988029
10686,6,12,1,2412,-60,-91,31,40:e3:d6:da:ba:22,59992149,180,3940,59991969,59992149
10687,6,12,1,2412,-60,-91,31,40:e3:d6:da:ba:24,59993238,176,913,59993062,59993238
10688,4,1,1,2412,-75,-91,16,54:e4:3a:ec:fb:64,60049184,2160,53786,60047024,60049184
10689,4,1,1,2412,-78,-91,13,b8:3a:5a:88:e6:e0,60076973,2360,25429,60074613,60076973
10690,4,1,1,2412,-78,-91,13,b8:3a:5a:88:e6:e1,60080425,2376,1076,60078049,60080425
10691,6,12,1,2412,-58,-91,33,40:e3:d6:da:ba:20,60093096,160,12511,60092936,60093096
10692,6,6,1,2412,-58,-91,33,40:e3:d6:da:ba:21,60093288,368,-176,60092920,60093288
10693,6,12,1,2412,-58,-91,33,40:e3:d6:da:ba:22,60093683,180,215,60093503,60093683
10694,6,12,1,2412,-58,-91,33,40:e3:d6:da:ba:23,60093916,184,49,60093732,60093916
10695,6,12,1,2412,-58,-91,33,40:e3:d6:da:ba:24,60094134,176,42,60093958,60094134
10696,6,12,1,2412,-58,-91,33,40:e3:d6:da:ba:25,60094336,160,42,60094176,60094336
10697,6,6,1,2412,-58,-91,33,40:e3:d6:da:ba:26,60094555,380,-161,60094175,60094555
10698,6,6,1,2412,-79,-91,12,e6:aa:ea:b7:4a:dd,60133305,408,38342,60132897,60133305
10699,6,6,1,2412,-61,-91,30,e6:aa:ea:c9:ea:33,60144324,408,10611,60143916,60144324
10700,6,6,1,2412,-61,-91,30,e6:aa:ea:c9:ea:33,60168568,408,23836,60168160,60168568
10701,6,6,1,2412,-79,-91,12,e6:aa:ea:b7:4a:dd,60169643,408,667,60169235,60169643
10702,4,1,1,2412,-77,-91,14,b8:3a:5a:88:e6:e1,60181765,2376,9746,60179389,60181765
10703,6,12,1,2412,-57,-91,34,40:e3:d6:da:ba:20,60195470,160,13545,60195310,60195470
10704,6,6,1,2412,-57,-91,34,40:e3:d6:da:ba:21,60195689,368,-149,60195321,60195689
10705,6,12,1,2412,-57,-91,34,40:e3:d6:da:ba:22,60196085,180,216,60195905,60196085
10706,6,12,1,2412,-57,-91,34,40:e3:d6:da:ba:23,60196299,184,30,60196115,60196299
10707,6,12,1,2412,-57,-91,34,40:e3:d6:da:ba:24,60196518,176,43,60196342,60196518
10708,6,12,1,2412,-57,-91,34,40:e3:d6:da:ba:25,60196737,160,59,60196577,60196737
10709,6,6,1,2412,-57,-91,34,40:e3:d6:da:ba:26,60196929,380,-188,60196549,60196929
10710,4,1,1,2412,-78,-91,13,b8:3a:5a:88:e6:e0,60282261,2360,82972,60279901,60282261
10711,4,1,1,2412,-77,-91,14,b8:3a:5a:88:e6:e1,60284649,2376,12,60282273,60284649
10712,6,12,1,2412,-52,-91,39,40:e3:d6:da:ba:20,60297871,160,13062,60297711,60297871
10713,4,1,1,2412,-77,-91,14,b8:3a:5a:88:e6:e0,60384187,2360,83956,60381827,60384187
10714,4,1,1,2412,-77,-91,14,b8:3a:5a:88:e6:e1,60386584,2376,21,60384208,60386584
10715,6,12,1,2412,-57,-91,34,40:e3:d6:da:ba:20,60400275,160,13531,60400115,60400275
10716,6,6,1,2412,-57,-91,34,40:e3:d6:da:ba:21,60400494,368,-149,60400126,60400494
10717,6,12,1,2412,-57,-91,34,40:e3:d6:da:ba:22,60400899,180,225,60400719,60400899
10718,6,12,1,2412,-57,-91,34,40:e3:d6:da:ba:23,60401131,184,48,60400947,60401131
10719,6,12,1,2412,-53,-91,38,40:e3:d6:da:ba:24,60401349,176,42,60401173,60401349
10720,4,1,1,2412,-56,-91,35,c0:c9:e3:4d:6e:bf,60401653,872,-568,60400781,60401653
10721,6,12,1,2412,-57,-91,34,40:e3:d6:da:ba:25,60402394,160,581,60402234,60402394
10722,6,6,1,2412,-57,-91,34,40:e3:d6:da:ba:26,60402788,380,14,60402408,60402788
10723,4,1,1,2412,-90,-91,1,,60445301,304,42209,60444997,60445301
10724,4,1,1,2412,-81,-91,10,54:e4:3a:ec:fb:64,60458780,2160,11319,60456620,60458780
10725,4,1,1,2412,-77,-91,14,b8:3a:5a:88:e6:e0,60486551,2360,25411,60484191,60486551
10726,4,1,1,2412,-78,-91,13,b8:3a:5a:88:e6:e1,60488939,2376,12,60486563,60488939
10727,6,12,1,2412,-58,-91,33,40:e3:d6:da:ba:20,60502678,160,13579,60502518,60502678
10728,6,6,1,2412,-57,-91,34,40:e3:d6:da:ba:21,60502912,368,-134,60502544,60502912
10729,6,12,1,2412,-57,-91,34,40:e3:d6:da:ba:22,60503317,180,225,60503137,60503317
10730,6,12,1,2412,-57,-91,34,40:e3:d6:da:ba:23,60503541,184,40,60503357,60503541
10731,6,12,1,2412,-58,-91,33,40:e3:d6:da:ba:24,60503750,176,33,60503574,60503750
10732,6,12,1,2412,-58,-91,33,40:e3:d6:da:ba:25,60503979,160,69,60503819,60503979
10733,6,6,1,2412,-57,-91,34,40:e3:d6:da:ba:26,60504189,380,-170,60503809,60504189
10734,6,6,1,2412,-82,-91,9,e6:aa:ea:b7:4a:dd,60550896,408,46299,60550488,60550896
10735,4,1,1,2412,-86,-91,5,f0:a6:54:13:7d:d3,60572389,1432,20061,60570957,60572389
10736,6,12,1,2412,-57,-91,34,40:e3:d6:da:ba:23,60573803,156,1258,60573647,60573803
10737,6,6,1,2412,-81,-91,10,e6:aa:ea:b7:4a:dd,60575194,408,983,60574786,60575194
10738,6,6,1,2412,-84,-91,7,,60575831,44,593,60575787,60575831
10739,6,6,1,2412,-84,-91,7,,60576087,44,212,60576043,60576087
10740,6,6,1,2412,-81,-91,10,e6:aa:ea:b7:4a:dd,60587230,408,10735,60586822,60587230
10741,4,1,1,2412,-71,-91,20,b8:3a:5a:88:e6:e1,60591384,2376,1778,60589008,60591384
10742,6,12,1,2412,-58,-91,33,40:e3:d6:da:ba:20,60605086,160,13542,60604926,60605086
10743,6,6,1,2412,-59,-91,32,40:e3:d6:da:ba:21,60605287,368,-167,60604919,60605287
10744,6,12,1,2412,-58,-91,33,40:e3:d6:da:ba:22,60605701,180,234,60605521,60605701
10745,6,12,1,2412,-58,-91,33,40:e3:d6:da:ba:23,60605907,184,22,60605723,60605907
10746,6,12,1,2412,-59,-91,32,40:e3:d6:da:ba:24,60606134,176,51,60605958,60606134
10747,6,12,1,2412,-58,-91,33,40:e3:d6:da:ba:25,60606362,160,68,60606202,60606362
10748,6,6,1,2412,-59,-91,32,40:e3:d6:da:ba:26,60606572,380,-170,60606192,60606572
10749,6,6,1,2412,-58,-91,33,e6:aa:ea:c9:ea:33,60677121,408,70141,60676713,60677121
10750,6,6,1,2412,-58,-91,33,e6:aa:ea:c9:ea:33,60689218,408,11689,60688810,60689218
10751,6,6,1,2412,-58,-91,33,e6:aa:ea:c9:ea:33,60701333,408,11707,60700925,60701333
10752,6,12,1,2412,-61,-91,30,40:e3:d6:da:ba:20,60707474,160,5981,60707314,60707474
10753,6,6,1,2412,-61,-91,30,40:e3:d6:da:ba:21,60707684,368,-158,60707316,60707684
10754,6,12,1,2412,-60,-91,31,40:e3:d6:da:ba:22,60708071,180,207,60707891,60708071
10755,6,12,1,2412,-61,-91,30,40:e3:d6:da:ba:23,60708276,184,21,60708092,60708276
10756,6,12,1,2412,-60,-91,31,40:e3:d6:da:ba:24,60708504,176,52,60708328,60708504
10757,6,12,1,2412,-60,-91,31,40:e3:d6:da:ba:25,60708732,160,68,60708572,60708732
10758,6,6,1,2412,-60,-91,31,40:e3:d6:da:ba:26,60708924,380,-188,60708544,60708924
10759,6,6,1,2412,-58,-91,33,e6:aa:ea:c9:ea:33,60713451,408,4119,60713043,60713451
10760,4,1,1,2412,-78,-91,13,b8:3a:5a:88:e6:e0,60714279,2240,-1412,60712039,60714279
10761,4,1,1,2412,-78,-91,13,b8:3a:5a:88:e6:e1,60716547,2256,12,60714291,60716547
10762,4,1,1,2412,-83,-91,8,,60718818,304,1967,60718514,60718818
10763,6,12,1,2412,-80,-91,11,,60721345,32,2495,60721313,60721345
10764,4,1,1,2412,-86,-91,5,a6:e5:7c:28:b1:d3,60752962,992,30625,60751970,60752962
10765,4,1,1,2412,-78,-91,13,b8:3a:5a:88:e6:e0,60793762,2360,38440,60791402,60793762
10766,4,1,1,2412,-79,-91,12,b8:3a:5a:88:e6:e1,60796168,2376,30,60793792,60796168
10767,6,12,1,2412,-62,-91,29,40:e3:d6:da:ba:20,60809891,160,13563,60809731,60809891
10768,6,6,1,2412,-62,-91,29,40:e3:d6:da:ba:21,60810092,368,-167,60809724,60810092
10769,6,12,1,2412,-62,-91,29,40:e3:d6:da:ba:22,60810497,180,225,60810317,60810497
10770,6,12,1,2412,-62,-91,29,40:e3:d6:da:ba:23,60810720,184,39,60810536,60810720
10771,6,12,1,2412,-62,-91,29,40:e3:d6:da:ba:24,60810948,176,52,60810772,60810948
10772,6,12,1,2412,-62,-91,29,40:e3:d6:da:ba:25,60811159,160,51,60810999,60811159
10773,4,1,1,2412,-85,-91,6,c0:c9:e3:4d:6e:bf,60891585,872,79554,60890713,60891585
10774,4,1,1,2412,-93,-91,-2,,60892474,304,585,60892170,60892474
10775,4,1,1,2412,-79,-91,12,b8:3a:5a:88:e6:e0,60896930,2360,2096,60894570,60896930
10776,6,12,1,2412,-62,-91,29,40:e3:d6:da:ba:24,60913331,176,16225,60913155,60913331
10777,6,12,1,2412,-62,-91,29,40:e3:d6:da:ba:25,60913560,160,69,60913400,60913560
10778,6,6,1,2412,-62,-91,29,40:e3:d6:da:ba:26,60913761,380,-179,60913381,60913761
10779,4,5.5,1,2412,-83,-91,8,ae:6a:50:8c:bb:bd,60922177,363,8053,60921814,60922177
10780,6,12,1,2412,-82,-91,9,,60922786,32,577,60922754,60922786
10781,6,6,1,2412,-82,-91,9,,60923225,44,395,60923181,60923225
10782,6,12,1,2412,-82,-91,9,,60923475,32,218,60923443,60923475
10783,6,6,1,2412,-82,-91,9,,60923914,44,395,60923870,60923914
10784,4,1,1,2412,-84,-91,7,c0:c9:e3:4d:6e:bf,60935758,872,10972,60934886,60935758
10785,6,12,1,2412,-81,-91,10,,60940806,32,5016,60940774,60940806
10786,6,6,1,2412,-82,-91,9,,60941263,44,413,60941219,60941263
10787,6,12,1,2412,-81,-91,10,,60941669,32,374,60941637,60941669
10788,6,12,1,2412,-83,-91,8,,60941913,32,212,60941881,60941913
10789,6,12,1,2412,-81,-91,10,,60942176,32,231,60942144,60942176
10790,6,12,1,2412,-81,-91,10,,60942418,32,210,60942386,60942418
10791,6,12,1,2412,-82,-91,9,,60942642,32,192,60942610,60942642
10792,4,1,1,2412,-91,-91,0,,60945683,304,2737,60945379,60945683
10793,4,1,1,2412,-92,-91,-1,,60947681,304,1694,60947377,60947681
10794,6,6,1,2412,-79,-91,12,e6:aa:ea:b7:4a:dd,60956624,408,8535,60956216,60956624
10795,4,1,1,2412,-88,-91,3,,60966031,304,9103,60965727,60966031
10796,4,1,1,2412,-92,-91,-1,,60968049,304,1714,60967745,60968049
10797,6,6,1,2412,-79,-91,12,e6:aa:ea:b7:4a:dd,60968740,408,283,60968332,60968740
10798,4,1,1,2412,-78,-91,13,54:e4:3a:ec:fb:64,60971785,2160,885,60969625,60971785
10799,6,6,1,2412,-57,-91,34,e6:aa:ea:c9:ea:33,60979694,408,7501,60979286,60979694
10800,6,6,1,2412,-76,-91,15,e6:aa:ea:b7:4a:dd,60981908,408,1806,60981500,60981908
10801,6,6,1,2412,-57,-91,34,e6:aa:ea:c9:ea:33,60991836,408,9520,60991428,60991836
10802,6,6,1,2412,-79,-91,12,e6:aa:ea:b7:4a:dd,60992976,408,732,60992568,60992976
10803,6,6,1,2412,-58,-91,33,e6:aa:ea:c9:ea:33,61003949,408,10565,61003541,61003949
10804,6,6,1,2412,-78,-91,13,e6:aa:ea:b7:4a:dd,61005085,408,728,61004677,61005085
10805,6,12,1,2412,-62,-91,29,40:e3:d6:da:ba:20,61014682,160,9437,61014522,61014682
10806,6,12,1,2412,-62,-91,29,40:e3:d6:da:ba:22,61015293,180,431,61015113,61015293
10807,6,12,1,2412,-62,-91,29,40:e3:d6:da:ba:24,61015810,176,341,61015634,61015810
10808,6,12,1,2412,-62,-91,29,40:e3:d6:da:ba:25,61016011,160,41,61015851,61016011
10809,6,6,1,2412,-58,-91,33,e6:aa:ea:c9:ea:33,61016212,408,-207,61015804,61016212
10810,6,6,1,2412,-58,-91,33,e6:aa:ea:c9:ea:33,61028176,408,11556,61027768,61028176
10811,4,1,1,2412,-75,-91,16,54:e4:3a:ec:fb:64,61073231,2160,42895,61071071,61073231
10812,4,1,1,2412,-81,-91,10,b8:3a:5a:88:e6:e0,61100955,2360,25364,61098595,61100955
10813,4,1,1,2412,-74,-91,17,b8:3a:5a:88:e6:e1,61103344,2376,13,61100968,61103344
10814,6,12,1,2412,-61,-91,30,40:e3:d6:da:ba:20,61117095,160,13591,61116935,61117095
10815,6,6,1,2412,-61,-91,30,40:e3:d6:da:ba:21,61117305,368,-158,61116937,61117305
10816,6,12,1,2412,-61,-91,30,40:e3:d6:da:ba:22,61117719,180,234,61117539,61117719
10817,6,12,1,2412,-61,-91,30,40:e3:d6:da:ba:23,61117951,184,48,61117767,61117951
10818,6,12,1,2412,-61,-91,30,40:e3:d6:da:ba:24,61118170,176,43,61117994,61118170
10819,6,12,1,2412,-61,-91,30,40:e3:d6:da:ba:25,61118398,160,68,61118238,61118398
10820,6,6,1,2412,-61,-91,30,40:e3:d6:da:ba:26,61118599,380,-179,61118219,61118599
10821,4,1,1,2412,-82,-91,9,,61141341,304,22438,61141037,61141341
10822,4,1,1,2412,-87,-91,4,a6:e5:7c:28:b1:d3,61163320,992,20987,61162328,61163320
10823,4,1,1,2412,-62,-91,29,54:e4:3a:ec:fb:64,61175860,2160,10380,61173700,61175860
10824,4,1,1,2412,-85,-91,6,,61188851,304,12687,61188547,61188851
10825,4,1,1,2412,-85,-91,6,a6:e5:7c:28:b1:d3,61189352,944,-443,61188408,61189352
10826,4,1,1,2412,-86,-91,5,a6:e5:7c:28:b1:d3,61191535,944,1239,61190591,61191535
10827,4,1,1,2412,-86,-91,5,a6:e5:7c:28:b1:d3,61192604,944,125,61191660,61192604
10828,4,1,1,2412,-86,-91,5,a6:e5:7c:28:b1:d3,61194787,944,1239,61193843,61194787
10829,4,1,1,2412,-86,-91,5,a6:e5:7c:28:b1:d3,61195865,944,134,61194921,61195865
10830,4,1,1,2412,-86,-91,5,a6:e5:7c:28:b1:d3,61196952,944,143,61196008,61196952
10831,4,1,1,2412,-87,-91,4,a6:e5:7c:28:b1:d3,61198057,944,161,61197113,61198057
10832,4,1,1,2412,-85,-91,6,a6:e5:7c:28:b1:d3,61199153,944,152,61198209,61199153
10833,4,1,1,2412,-87,-91,4,a6:e5:7c:28:b1:d3,61200249,944,152,61199305,61200249
10834,4,1,1,2412,-82,-91,9,b8:3a:5a:88:e6:e0,61203451,2360,842,61201091,61203451
10835,6,12,1,2412,-61,-91,30,40:e3:d6:da:ba:20,61219475,160,15864,61219315,61219475
10836,6,6,1,2412,-61,-91,30,40:e3:d6:da:ba:21,61219676,368,-167,61219308,61219676
10837,6,12,1,2412,-61,-91,30,40:e3:d6:da:ba:22,61220063,180,207,61219883,61220063
10838,6,12,1,2412,-61,-91,30,40:e3:d6:da:ba:23,61220269,184,22,61220085,61220269
10839,6,12,1,2412,-61,-91,30,40:e3:d6:da:ba:24,61220505,176,60,61220329,61220505
10840,6,12,1,2412,-61,-91,30,40:e3:d6:da:ba:25,61220724,160,59,61220564,61220724
10841,6,6,1,2412,-61,-91,30,40:e3:d6:da:ba:26,61220916,380,-188,61220536,61220916
10842,4,1,1,2412,-87,-91,4,a6:e5:7c:28:b1:d3,61265475,992,43567,61264483,61265475
10843,6,6,1,2412,-57,-91,34,e6:aa:ea:c9:ea:33,61294533,408,28650,61294125,61294533
10844,4,1,1,2412,-87,-91,4,b8:3a:5a:88:e6:e1,61308185,2376,11276,61305809,61308185
10845,6,12,1,2412,-60,-91,31,40:e3:d6:da:ba:20,61321883,160,13538,61321723,61321883
10846,6,6,1,2412,-60,-91,31,40:e3:d6:da:ba:21,61322074,368,-177,61321706,61322074
10847,6,12,1,2412,-60,-91,31,40:e3:d6:da:ba:22,61322461,180,207,61322281,61322461
10848,6,12,1,2412,-60,-91,31,40:e3:d6:da:ba:23,61322667,184,22,61322483,61322667
10849,6,12,1,2412,-60,-91,31,40:e3:d6:da:ba:25,61323105,160,278,61322945,61323105
10850,6,6,1,2412,-60,-91,31,40:e3:d6:da:ba:26,61323324,380,-161,61322944,61323324
10851,6,6,1,2412,-57,-91,34,e6:aa:ea:c9:ea:33,61343022,408,19290,61342614,61343022
10852,4,1,1,2412,-71,-91,20,a6:e5:7c:28:b1:d3,61367659,992,23645,61366667,61367659
10853,6,6,1,2412,-79,-91,12,e6:aa:ea:b7:4a:dd,61373855,408,5788,61373447,61373855
10854,4,1,1,2412,-81,-91,10,54:e4:3a:ec:fb:64,61380372,2160,4357,61378212,61380372
10855,6,6,1,2412,-79,-91,12,e6:aa:ea:b7:4a:dd,61385985,408,5205,61385577,61385985
10856,4,1,1,2412,-86,-91,5,c0:c9:e3:4d:6e:bf,61387188,872,331,61386316,61387188
10857,4,1,1,2412,-82,-91,9,,61388078,304,586,61387774,61388078
10858,6,6,1,2412,-79,-91,12,e6:aa:ea:b7:4a:dd,61398110,408,9624,61397702,61398110
10859,6,6,1,2412,-77,-91,14,e6:aa:ea:b7:4a:dd,61410219,408,11701,61409811,61410219
10860,6,12,1,2412,-59,-91,32,40:e3:d6:da:ba:22,61424884,180,14485,61424704,61424884
10861,6,12,1,2412,-59,-91,32,40:e3:d6:da:ba:23,61425090,184,22,61424906,61425090
10862,6,12,1,2412,-59,-91,32,40:e3:d6:da:ba:25,61425519,160,269,61425359,61425519
10863,6,6,1,2412,-59,-91,32,40:e3:d6:da:ba:26,61425710,380,-189,61425330,61425710
10864,4,1,1,2412,-79,-91,12,,61431548,304,5534,61431244,61431548
10865,4,1,1,2412,-81,-91,10,b8:3a:5a:88:e6:e1,61512959,2376,79035,61510583,61512959
10866,6,12,1,2412,-58,-91,33,40:e3:d6:da:ba:20,61526683,160,13564,61526523,61526683
10867,6,6,1,2412,-58,-91,33,40:e3:d6:da:ba:21,61526884,368,-167,61526516,61526884
10868,6,12,1,2412,-58,-91,33,40:e3:d6:da:ba:22,61527280,180,216,61527100,61527280
10869,6,12,1,2412,-58,-91,33,40:e3:d6:da:ba:23,61527486,184,22,61527302,61527486
10870,6,12,1,2412,-58,-91,33,40:e3:d6:da:ba:24,61527704,176,42,61527528,61527704
10871,6,12,1,2412,-58,-91,33,40:e3:d6:da:ba:25,61527905,160,41,61527745,61527905
10872,6,6,1,2412,-58,-91,33,40:e3:d6:da:ba:26,61528124,380,-161,61527744,61528124
10873,4,1,1,2412,-81,-91,10,54:e4:3a:ec:fb:64,61585215,2160,54931,61583055,61585215
10874,4,1,1,2412,-81,-91,10,54:e4:3a:ec:fb:64,61603784,2112,16457,61601672,61603784
10875,4,1,1,2412,-81,-91,10,54:e4:3a:ec:fb:64,61606248,2112,352,61604136,61606248
10876,4,1,1,2412,-82,-91,9,b8:3a:5a:88:e6:e1,61616818,2376,8194,61614442,61616818
10877,4,1,1,2412,-81,-91,10,54:e4:3a:ec:fb:64,61626004,2112,7074,61623892,61626004
10878,4,1,1,2412,-80,-91,11,54:e4:3a:ec:fb:64,61628333,2112,217,61626221,61628333
10879,4,1,1,2412,-90,-91,1,,61630458,304,1821,61630154,61630458
10880,6,12,1,2412,-57,-91,34,40:e3:d6:da:ba:20,61630622,160,4,61630462,61630622
10881,6,6,1,2412,-57,-91,34,40:e3:d6:da:ba:21,61630814,368,-176,61630446,61630814
10882,6,12,1,2412,-57,-91,34,40:e3:d6:da:ba:23,61631451,184,453,61631267,61631451
10883,6,12,1,2412,-57,-91,34,40:e3:d6:da:ba:24,61631688,176,61,61631512,61631688
10884,6,12,1,2412,-57,-91,34,40:e3:d6:da:ba:25,61631898,160,50,61631738,61631898
10885,6,6,1,2412,-57,-91,34,40:e3:d6:da:ba:26,61632117,380,-161,61631737,61632117
10886,4,1,1,2412,-81,-91,10,54:e4:3a:ec:fb:64,61687602,2160,53325,61685442,61687602
10887,4,1,1,2412,-79,-91,12,b8:3a:5a:88:e6:e1,61717759,2376,27781,61715383,61717759
10888,6,6,1,2412,-59,-91,32,40:e3:d6:da:ba:21,61731722,368,13595,61731354,61731722
10889,6,12,1,2412,-59,-91,32,40:e3:d6:da:ba:22,61732118,180,216,61731938,61732118
10890,6,12,1,2412,-59,-91,32,40:e3:d6:da:ba:23,61732323,184,21,61732139,61732323
10891,6,12,1,2412,-59,-91,32,40:e3:d6:da:ba:24,61732560,176,61,61732384,61732560
10892,6,6,1,2412,-59,-91,32,40:e3:d6:da:ba:26,61732987,380,47,61732607,61732987
10893,4,1,1,2412,-67,-91,24,54:e4:3a:ec:fb:64,61790053,2160,54906,61787893,61790053
10894,6,6,1,2412,-60,-91,31,e6:aa:ea:c9:ea:33,61814684,408,24223,61814276,61814684
10895,4,1,1,2412,-79,-91,12,b8:3a:5a:88:e6:e0,61817776,2360,732,61815416,61817776
10896,6,6,1,2412,-60,-91,31,e6:aa:ea:c9:ea:33,61826917,408,8733,61826509,61826917
10897,6,12,1,2412,-62,-91,29,40:e3:d6:da:ba:20,61833895,160,6818,61833735,61833895
10898,6,6,1,2412,-62,-91,29,40:e3:d6:da:ba:21,61834087,368,-176,61833719,61834087
10899,6,12,1,2412,-62,-91,29,40:e3:d6:da:ba:22,61834501,180,234,61834321,61834501
10900,6,12,1,2412,-62,-91,29,40:e3:d6:da:ba:23,61834725,184,40,61834541,61834725
10901,6,12,1,2412,-62,-91,29,40:e3:d6:da:ba:24,61834943,176,42,61834767,61834943
10902,6,12,1,2412,-62,-91,29,40:e3:d6:da:ba:25,61835154,160,51,61834994,61835154
10903,6,6,1,2412,-62,-91,29,40:e3:d6:da:ba:26,61835346,380,-188,61834966,61835346
10904,6,6,1,2412,-61,-91,30,e6:aa:ea:c9:ea:33,61838914,408,3160,61838506,61838914
10905,6,6,1,2412,-60,-91,31,e6:aa:ea:c9:ea:33,61851030,408,11708,61850622,61851030
10906,6,6,1,2412,-62,-91,29,e6:aa:ea:c9:ea:33,61863134,408,11696,61862726,61863134
10907,4,1,1,2412,-90,-91,1,,61868058,304,4620,61867754,61868058
10908,4,1,1,2412,-79,-91,12,b8:3a:5a:88:e6:e0,61868394,2240,-1904,61866154,61868394
10909,4,1,1,2412,-79,-91,12,b8:3a:5a:88:e6:e1,61871806,2256,1156,61869550,61871806
10910,4,1,1,2412,-84,-91,7,c0:c9:e3:4d:6e:bf,61878367,872,5689,61877495,61878367
10911,4,1,1,2412,-91,-91,0,,61879256,304,585,61878952,61879256
10912,4,1,1,2412,-90,-91,1,,61889428,304,9868,61889124,61889428
10913,4,1,1,2412,-79,-91,12,54:e4:3a:ec:fb:64,61892366,2160,778,61890206,61892366
10914,6,6,1,2412,-78,-91,13,e6:aa:ea:b7:4a:dd,61906172,408,13398,61905764,61906172
10915,6,6,1,2412,-78,-91,13,e6:aa:ea:b7:4a:dd,61918290,408,11710,61917882,61918290
10916,4,1,1,2412,-80,-91,11,b8:3a:5a:88:e6:e0,61920168,2360,-482,61917808,61920168
10917,6,6,1,2412,-79,-91,12,e6:aa:ea:b7:4a:dd,61930426,408,9850,61930018,61930426
10918,6,12,1,2412,-62,-91,29,40:e3:d6:da:ba:20,61936294,160,5708,61936134,61936294
10919,6,6,1,2412,-62,-91,29,40:e3:d6:da:ba:21,61936504,368,-158,61936136,61936504
10920,6,12,1,2412,-62,-91,29,40:e3:d6:da:ba:22,61936900,180,216,61936720,61936900
10921,6,12,1,2412,-62,-91,29,40:e3:d6:da:ba:23,61937105,184,21,61936921,61937105
10922,6,12,1,2412,-62,-91,29,40:e3:d6:da:ba:24,61937315,176,34,61937139,61937315
10923,6,12,1,2412,-62,-91,29,40:e3:d6:da:ba:25,61937534,160,59,61937374,61937534
10924,6,6,1,2412,-62,-91,29,40:e3:d6:da:ba:26,61937735,380,-179,61937355,61937735
10925,6,6,1,2412,-79,-91,12,e6:aa:ea:b7:4a:dd,61942520,408,4377,61942112,61942520
10926,4,1,1,2412,-77,-91,14,b8:3a:5a:88:e6:e1,62024974,2376,80078,62022598,62024974
10927,6,12,1,2412,-62,-91,29,40:e3:d6:da:ba:20,62042925,160,17791,62042765,62042925
10928,6,6,1,2412,-61,-91,30,40:e3:d6:da:ba:21,62043160,368,-133,62042792,62043160
10929,6,12,1,2412,-60,-91,31,40:e3:d6:da:ba:22,62043574,180,234,62043394,62043574
10930,6,12,1,2412,-59,-91,32,40:e3:d6:da:ba:23,62043789,184,31,62043605,62043789
10931,6,12,1,2412,-61,-91,30,40:e3:d6:da:ba:24,62044025,176,60,62043849,62044025
10932,6,12,1,2412,-61,-91,30,40:e3:d6:da:ba:25,62044236,160,51,62044076,62044236
10933,6,6,1,2412,-62,-91,29,40:e3:d6:da:ba:26,62044437,380,-179,62044057,62044437
10934,4,1,1,2412,-75,-91,16,b8:3a:5a:88:e6:e0,62124979,2360,78182,62122619,62124979
10935,6,12,1,2412,-60,-91,31,40:e3:d6:da:ba:20,62141078,160,15939,62140918,62141078
10936,6,6,1,2412,-60,-91,31,40:e3:d6:da:ba:21,62141288,368,-158,62140920,62141288
10937,6,12,1,2412,-60,-91,31,40:e3:d6:da:ba:22,62141684,180,216,62141504,62141684
10938,6,12,1,2412,-60,-91,31,40:e3:d6:da:ba:23,62141890,184,22,62141706,62141890
10939,6,12,1,2412,-60,-91,31,40:e3:d6:da:ba:24,62142126,176,60,62141950,62142126
10940,6,12,1,2412,-60,-91,31,40:e3:d6:da:ba:25,62142345,160,59,62142185,62142345
10941,6,6,1,2412,-60,-91,31,40:e3:d6:da:ba:26,62142564,380,-161,62142184,62142564
10942,4,1,1,2412,-76,-91,15,54:e4:3a:ec:fb:64,62199606,2160,54882,62197446,62199606
10943,6,6,1,2412,-81,-91,10,e6:aa:ea:b7:4a:dd,62209967,408,9953,62209559,62209967
10944,6,6,1,2412,-81,-91,10,e6:aa:ea:b7:4a:dd,62222081,408,11706,62221673,62222081
10945,6,6,1,2412,-81,-91,10,e6:aa:ea:b7:4a:dd,62234193,408,11704,62233785,62234193
10946,6,12,1,2412,-61,-91,30,40:e3:d6:da:ba:20,62243481,160,9128,62243321,62243481
10947,6,6,1,2412,-61,-91,30,40:e3:d6:da:ba:21,62243682,368,-167,62243314,62243682
10948,6,12,1,2412,-60,-91,31,40:e3:d6:da:ba:22,62244096,180,234,62243916,62244096
10949,6,12,1,2412,-60,-91,31,40:e3:d6:da:ba:23,62244319,184,39,62244135,62244319
10950,6,12,1,2412,-60,-91,31,40:e3:d6:da:ba:24,62244556,176,61,62244380,62244556
10951,6,12,1,2412,-60,-91,31,40:e3:d6:da:ba:25,62244784,160,68,62244624,62244784
10952,6,6,1,2412,-60,-91,31,40:e3:d6:da:ba:26,62244994,380,-170,62244614,62244994
10953,6,6,1,2412,-76,-91,15,e6:aa:ea:b7:4a:dd,62246321,408,919,62245913,62246321
10954,6,6,1,2412,-81,-91,10,e6:aa:ea:b7:4a:dd,62258659,408,11930,62258251,62258659
10955,4,1,1,2412,-79,-91,12,54:e4:3a:ec:fb:64,62302486,2160,41667,62300326,62302486
10956,6,6,1,2412,-64,-91,27,e6:aa:ea:c9:ea:33,62334481,408,31587,62334073,62334481
10957,6,12,1,2412,-55,-91,36,40:e3:d6:da:ba:20,62345880,160,11239,62345720,62345880
10958,6,6,1,2412,-55,-91,36,40:e3:d6:da:ba:21,62346090,368,-158,62345722,62346090
10959,6,12,1,2412,-55,-91,36,40:e3:d6:da:ba:22,62346477,180,207,62346297,62346477
10960,6,6,1,2412,-63,-91,28,e6:aa:ea:c9:ea:33,62346707,408,-178,62346299,62346707
10961,6,12,1,2412,-55,-91,36,40:e3:d6:da:ba:23,62347161,184,270,62346977,62347161
10962,6,12,1,2412,-55,-91,36,40:e3:d6:da:ba:24,62347380,176,43,62347204,62347380
10963,6,12,1,2412,-55,-91,36,40:e3:d6:da:ba:25,62347581,160,41,62347421,62347581
10964,6,6,1,2412,-55,-91,36,40:e3:d6:da:ba:26,62347791,380,-170,62347411,62347791
10965,6,6,1,2412,-62,-91,29,e6:aa:ea:c9:ea:33,62358766,408,10567,62358358,62358766
10966,4,1,1,2412,-85,-91,6,c0:c9:e3:4d:6e:bf,62369769,872,10131,62368897,62369769
10967,4,1,1,2412,-91,-91,0,,62370658,304,585,62370354,62370658
10968,6,6,1,2412,-61,-91,30,e6:aa:ea:c9:ea:33,62370878,408,-188,62370470,62370878
10969,6,6,1,2412,-81,-91,10,84:1b:5e:df:1b:99,62375718,80,4760,62375638,62375718
10970,4,1,1,2412,-92,-91,-1,,62414852,304,38830,62414548,62414852
10971,4,1,1,2412,-74,-91,17,b8:3a:5a:88:e6:e0,62432197,2360,14985,62429837,62432197
10972,6,12,1,2412,-60,-91,31,40:e3:d6:da:ba:20,62448301,160,15944,62448141,62448301
10973,6,6,1,2412,-61,-91,30,40:e3:d6:da:ba:21,62448493,368,-176,62448125,62448493
10974,6,12,1,2412,-60,-91,31,40:e3:d6:da:ba:22,62448889,180,216,62448709,62448889
10975,6,12,1,2412,-60,-91,31,40:e3:d6:da:ba:23,62449121,184,48,62448937,62449121
10976,6,12,1,2412,-60,-91,31,40:e3:d6:da:ba:24,62449331,176,34,62449155,62449331
10977,6,6,1,2412,-60,-91,31,40:e3:d6:da:ba:26,62449778,380,67,62449398,62449778
10978,4,1,1,2412,-78,-91,13,54:e4:3a:ec:fb:64,62506766,2160,54828,62504606,62506766
10979,4,1,1,2412,-72,-91,19,b8:3a:5a:88:e6:e0,62534557,2360,25431,62532197,62534557
10980,4,1,1,2412,-72,-91,19,b8:3a:5a:88:e6:e1,62536955,2376,22,62534579,62536955
10981,6,12,1,2412,-62,-91,29,40:e3:d6:da:ba:20,62550690,160,13575,62550530,62550690
10982,6,6,1,2412,-62,-91,29,40:e3:d6:da:ba:21,62550916,368,-142,62550548,62550916
10983,6,12,1,2412,-62,-91,29,40:e3:d6:da:ba:22,62551330,180,234,62551150,62551330
10984,6,12,1,2412,-62,-91,29,40:e3:d6:da:ba:23,62551535,184,21,62551351,62551535
10985,6,12,1,2412,-62,-91,29,40:e3:d6:da:ba:24,62551772,176,61,62551596,62551772
10986,6,12,1,2412,-62,-91,29,40:e3:d6:da:ba:25,62551991,160,59,62551831,62551991
10987,6,6,1,2412,-62,-91,29,40:e3:d6:da:ba:26,62552210,380,-161,62551830,62552210
10988,4,1,1,2412,-77,-91,14,54:e4:3a:ec:fb:64,62609233,2160,54863,62607073,62609233
10989,6,6,1,2412,-80,-91,11,e6:aa:ea:b7:4a:dd,62627283,408,17642,62626875,62627283
10990,4,1,1,2412,-73,-91,18,b8:3a:5a:88:e6:e1,62639663,2376,10004,62637287,62639663
10991,6,6,1,2412,-82,-91,9,e6:aa:ea:b7:4a:dd,62651525,408,11454,62651117,62651525
10992,6,12,1,2412,-60,-91,31,40:e3:d6:da:ba:20,62653081,160,1396,62652921,62653081
10993,6,6,1,2412,-60,-91,31,40:e3:d6:da:ba:21,62653291,368,-158,62652923,62653291
10994,6,12,1,2412,-60,-91,31,40:e3:d6:da:ba:22,62653678,180,207,62653498,62653678
10995,6,6,1,2412,-82,-91,9,e6:aa:ea:b7:4a:dd,62663644,408,9558,62663236,62663644
10996,6,6,1,2412,-82,-91,9,e6:aa:ea:b7:4a:dd,62675758,408,11706,62675350,62675758
10997,4,1,1,2412,-72,-91,19,b8:3a:5a:88:e6:e0,62739356,2360,61238,62736996,62739356
10998,4,1,1,2412,-74,-91,17,b8:3a:5a:88:e6:e1,62741754,2376,22,62739378,62741754
10999,6,6,1,2412,-64,-91,27,40:e3:d6:da:ba:21,62755682,368,13560,62755314,62755682
11000,6,12,1,2412,-64,-91,27,40:e3:d6:da:ba:22,62756069,180,207,62755889,62756069
11001,6,12,1,2412,-64,-91,27,40:e3:d6:da:ba:23,62756275,184,22,62756091,62756275
11002,6,12,1,2412,-64,-91,27,40:e3:d6:da:ba:24,62756493,176,42,62756317,62756493
11003,6,12,1,2412,-64,-91,27,40:e3:d6:da:ba:25,62756703,160,50,62756543,62756703
11004,6,6,1,2412,-64,-91,27,40:e3:d6:da:ba:26,62756905,380,-178,62756525,62756905
11005,4,1,1,2412,-78,-91,13,54:e4:3a:ec:fb:64,62814053,2160,54988,62811893,62814053
11006,4,1,1,2412,-73,-91,18,b8:3a:5a:88:e6:e0,62841773,2360,25360,62839413,62841773
11007,4,1,1,2412,-73,-91,18,b8:3a:5a:88:e6:e1,62844318,2376,169,62841942,62844318
11008,6,6,1,2412,-61,-91,30,e6:aa:ea:c9:ea:33,62854547,408,9821,62854139,62854547
11009,6,12,1,2412,-62,-91,29,40:e3:d6:da:ba:20,62857900,160,3193,62857740,62857900
11010,6,6,1,2412,-62,-91,29,40:e3:d6:da:ba:21,62858110,368,-158,62857742,62858110
11011,6,12,1,2412,-62,-91,29,40:e3:d6:da:ba:23,62858711,184,417,62858527,62858711
11012,6,12,1,2412,-62,-91,29,40:e3:d6:da:ba:24,62858955,176,68,62858779,62858955
11013,6,12,1,2412,-62,-91,29,40:e3:d6:da:ba:25,62859156,160,41,62858996,62859156
11014,6,6,1,2412,-62,-91,29,40:e3:d6:da:ba:26,62859348,380,-188,62858968,62859348
11015,4,1,1,2412,-86,-91,5,c0:c9:e3:4d:6e:bf,62860291,872,71,62859419,62860291
11016,6,6,1,2412,-58,-91,33,e6:aa:ea:c9:ea:33,62866636,408,5937,62866228,62866636
11017,4,1,1,2412,-82,-91,9,,62887825,304,20885,62887521,62887825
11018,6,6,1,2412,-60,-91,31,e6:aa:ea:c9:ea:33,62890873,408,2640,62890465,62890873
11019,6,6,1,2412,-78,-91,13,e6:aa:ea:b7:4a:dd,62942943,408,51662,62942535,62942943
11020,4,1,1,2412,-75,-91,16,b8:3a:5a:88:e6:e0,62944155,2360,-1148,62941795,62944155
11021,6,12,1,2412,-59,-91,32,40:e3:d6:da:ba:20,62960296,160,15981,62960136,62960296
11022,6,6,1,2412,-59,-91,32,40:e3:d6:da:ba:21,62960506,368,-158,62960138,62960506
11023,6,12,1,2412,-59,-91,32,40:e3:d6:da:ba:22,62960911,180,225,62960731,62960911
11024,6,12,1,2412,-59,-91,32,40:e3:d6:da:ba:23,62961144,184,49,62960960,62961144
11025,6,12,1,2412,-59,-91,32,40:e3:d6:da:ba:24,62961353,176,33,62961177,62961353
11026,6,12,1,2412,-59,-91,32,40:e3:d6:da:ba:25,62961572,160,59,62961412,62961572
11027,6,6,1,2412,-59,-91,32,40:e3:d6:da:ba:26,62961792,380,-160,62961412,62961792
11028,6,6,1,2412,-78,-91,13,e6:aa:ea:b7:4a:dd,62979286,408,17086,62978878,62979286
11029,6,6,1,2412,-78,-91,13,e6:aa:ea:b7:4a:dd,62991587,408,11893,62991179,62991587
11030,4,1,1,2412,-77,-91,14,54:e4:3a:ec:fb:64,63018931,2160,25184,63016771,63018931
11031,4,1,1,2412,-78,-91,13,b8:3a:5a:88:e6:e0,63046562,2360,25271,63044202,63046562
11032,4,1,1,2412,-77,-91,14,b8:3a:5a:88:e6:e1,63048950,2376,12,63046574,63048950
11033,6,12,1,2412,-58,-91,33,40:e3:d6:da:ba:20,63062682,160,13572,63062522,63062682
11034,6,6,1,2412,-58,-91,33,40:e3:d6:da:ba:21,63062874,368,-176,63062506,63062874
11035,6,12,1,2412,-58,-91,33,40:e3:d6:da:ba:22,63063288,180,234,63063108,63063288
11036,6,12,1,2412,-58,-91,33,40:e3:d6:da:ba:23,63063502,184,30,63063318,63063502
11037,6,12,1,2412,-58,-91,33,40:e3:d6:da:ba:24,63063730,176,52,63063554,63063730
11038,6,12,1,2412,-58,-91,33,40:e3:d6:da:ba:25,63063958,160,68,63063798,63063958
11039,6,6,1,2412,-58,-91,33,40:e3:d6:da:ba:26,63064168,380,-170,63063788,63064168
11040,4,1,1,2412,-76,-91,15,54:e4:3a:ec:fb:64,63121256,2160,54928,63119096,63121256
11041,4,1,1,2412,-91,-91,0,,63124615,304,3055,63124311,63124615
11042,6,12,1,2412,-60,-91,31,40:e3:d6:da:ba:20,63165082,160,40307,63164922,63165082
11043,6,12,1,2412,-59,-91,32,40:e3:d6:da:ba:22,63165688,180,426,63165508,63165688
11044,6,12,1,2412,-59,-91,32,40:e3:d6:da:ba:23,63165903,184,31,63165719,63165903
11045,6,12,1,2412,-59,-91,32,40:e3:d6:da:ba:24,63166121,176,42,63165945,63166121
11046,6,12,1,2412,-59,-91,32,40:e3:d6:da:ba:25,63166350,160,69,63166190,63166350
11047,6,6,1,2412,-59,-91,32,40:e3:d6:da:ba:26,63166550,380,-180,63166170,63166550
11048,4,1,1,2412,-73,-91,18,54:e4:3a:ec:fb:64,63223644,2160,54934,63221484,63223644
11049,4,1,1,2412,-82,-91,9,b8:3a:5a:88:e6:e1,63253748,2376,27728,63251372,63253748
11050,6,12,1,2412,-62,-91,29,40:e3:d6:da:ba:20,63267508,160,13600,63267348,63267508
11051,6,6,1,2412,-61,-91,30,40:e3:d6:da:ba:21,63267700,368,-176,63267332,63267700
11052,6,12,1,2412,-61,-91,30,40:e3:d6:da:ba:22,63268105,180,225,63267925,63268105
11053,6,12,1,2412,-61,-91,30,40:e3:d6:da:ba:23,63268310,184,21,63268126,63268310
11054,6,12,1,2412,-61,-91,30,40:e3:d6:da:ba:24,63268537,176,51,63268361,63268537
11055,6,12,1,2412,-61,-91,30,40:e3:d6:da:ba:25,63268739,160,42,63268579,63268739
11056,6,6,1,2412,-61,-91,30,40:e3:d6:da:ba:26,63268931,380,-188,63268551,63268931
11057,4,1,1,2412,-70,-91,21,92:b0:0c:d0:05:c6,63273940,1152,3857,63272788,63273940
11058,4,1,1,2412,-77,-91,14,54:e4:3a:ec:fb:64,63326045,2160,49945,63323885,63326045
11059,4,1,1,2412,-87,-91,4,c0:c9:e3:4d:6e:bf,63349649,872,22732,63348777,63349649
11060,4,1,1,2412,-80,-91,11,b8:3a:5a:88:e6:e1,63356397,2376,4372,63354021,63356397
11061,6,6,1,2412,-80,-91,11,e6:aa:ea:b7:4a:dd,63360193,408,3388,63359785,63360193
11062,6,12,1,2412,-60,-91,31,40:e3:d6:da:ba:22,63374858,180,14485,63374678,63374858
11063,6,12,1,2412,-60,-91,31,40:e3:d6:da:ba:23,63375063,184,21,63374879,63375063
11064,6,12,1,2412,-59,-91,32,40:e3:d6:da:ba:25,63375501,160,278,63375341,63375501
11065,6,12,1,2412,-59,-91,32,40:e3:d6:da:ba:20,63376135,136,498,63375999,63376135
11066,6,12,1,2412,-72,-91,19,,63376287,32,120,63376255,63376287
11067,4,1,1,2412,-78,-91,13,54:e4:3a:ec:fb:64,63376525,2112,-1874,63374413,63376525
11068,4,1,1,2412,-71,-91,20,,63378650,304,1821,63378346,63378650
11069,6,6,1,2412,-60,-91,31,40:e3:d6:da:ba:21,63378820,348,-178,63378472,63378820
11070,6,12,1,2412,-59,-91,32,40:e3:d6:da:ba:22,63379214,156,238,63379058,63379214
11071,6,12,1,2412,-59,-91,32,40:e3:d6:da:ba:23,63379404,156,34,63379248,63379404
11072,6,12,1,2412,-60,-91,31,40:e3:d6:da:ba:25,63379604,136,64,63379468,63379604
11073,4,1,1,2412,-92,-91,-1,,63382916,304,3008,63382612,63382916
11074,4,1,1,2412,-78,-91,13,b8:3a:5a:88:e6:e0,63384972,2240,-184,63382732,63384972
11075,4,1,1,2412,-71,-91,20,32:81:c8:eb:72:97,63389608,1152,3484,63388456,63389608
11076,4,1,1,2412,-91,-91,0,,63394142,304,4230,63393838,63394142
11077,6,6,1,2412,-81,-91,10,e6:aa:ea:b7:4a:dd,63396549,408,1999,63396141,63396549
11078,6,6,1,2412,-60,-91,31,e6:aa:ea:c9:ea:33,63399045,408,2088,63398637,63399045
11079,4,1,1,2412,-91,-91,0,,63404686,304,5337,63404382,63404686
11080,4,1,1,2412,-91,-91,0,,63406360,304,1370,63406056,63406360
11081,6,6,1,2412,-81,-91,10,e6:aa:ea:b7:4a:dd,63408672,408,1904,63408264,63408672
11082,6,6,1,2412,-60,-91,31,e6:aa:ea:c9:ea:33,63411146,408,2066,63410738,63411146
11083,6,6,1,2412,-59,-91,32,e6:aa:ea:c9:ea:33,63423261,408,11707,63422853,63423261
11084,4,1,1,2412,-78,-91,13,54:e4:3a:ec:fb:64,63428451,2160,3030,63426291,63428451
11085,4,1,1,2412,-77,-91,14,b8:3a:5a:88:e6:e0,63456161,2360,25350,63453801,63456161
11086,6,12,1,2412,-59,-91,32,40:e3:d6:da:ba:20,63472297,160,15976,63472137,63472297
11087,6,6,1,2412,-59,-91,32,40:e3:d6:da:ba:21,63472507,368,-158,63472139,63472507
11088,6,12,1,2412,-59,-91,32,40:e3:d6:da:ba:22,63472903,180,216,63472723,63472903
11089,6,12,1,2412,-59,-91,32,40:e3:d6:da:ba:23,63473117,184,30,63472933,63473117
11090,6,12,1,2412,-59,-91,32,40:e3:d6:da:ba:24,63473326,176,33,63473150,63473326
11091,6,12,1,2412,-59,-91,32,40:e3:d6:da:ba:25,63473546,160,60,63473386,63473546
11092,6,6,1,2412,-59,-91,32,40:e3:d6:da:ba:26,63473756,380,-170,63473376,63473756
11093,4,1,1,2412,-78,-91,13,a6:e5:7c:28:b1:d3,63517993,992,43245,63517001,63517993
11094,4,1,1,2412,-76,-91,15,54:e4:3a:ec:fb:64,63530846,2160,10693,63528686,63530846
11095,4,1,1,2412,-74,-91,17,b8:3a:5a:88:e6:e0,63558612,2360,25406,63556252,63558612
11096,4,1,1,2412,-75,-91,16,b8:3a:5a:88:e6:e1,63561694,2376,706,63559318,63561694
11097,6,6,1,2412,-57,-91,34,40:e3:d6:da:ba:21,63574877,368,12815,63574509,63574877
11098,6,12,1,2412,-57,-91,34,40:e3:d6:da:ba:22,63575282,180,225,63575102,63575282
11099,6,12,1,2412,-57,-91,34,40:e3:d6:da:ba:23,63575505,184,39,63575321,63575505
11100,6,12,1,2412,-57,-91,34,40:e3:d6:da:ba:24,63575742,176,61,63575566,63575742
11101,6,12,1,2412,-57,-91,34,40:e3:d6:da:ba:25,63575943,160,41,63575783,63575943
11102,6,6,1,2412,-57,-91,34,40:e3:d6:da:ba:26,63576153,380,-170,63575773,63576153
11103,4,1,1,2412,-68,-91,23,a6:e5:7c:28:b1:d3,63626932,992,49787,63625940,63626932
11104,4,1,1,2412,-77,-91,14,54:e4:3a:ec:fb:64,63633163,2160,4071,63631003,63633163
11105,4,1,1,2412,-83,-91,8,a4:e5:7c:28:b1:d3,63642530,688,8679,63641842,63642530
11106,4,1,1,2412,-75,-91,16,b8:3a:5a:88:e6:e0,63660971,2360,16081,63658611,63660971
11107,4,1,1,2412,-77,-91,14,b8:3a:5a:88:e6:e1,63663351,2376,4,63660975,63663351
11108,6,12,1,2412,-58,-91,33,40:e3:d6:da:ba:20,63677088,160,13577,63676928,63677088
11109,6,6,1,2412,-59,-91,32,40:e3:d6:da:ba:21,63677298,368,-158,63676930,63677298
11110,6,12,1,2412,-58,-91,33,40:e3:d6:da:ba:22,63677712,180,234,63677532,63677712
11111,6,12,1,2412,-58,-91,33,40:e3:d6:da:ba:23,63677926,184,30,63677742,63677926
11112,6,12,1,2412,-58,-91,33,40:e3:d6:da:ba:24,63678145,176,43,63677969,63678145
11113,6,12,1,2412,-58,-91,33,40:e3:d6:da:ba:25,63678383,160,78,63678223,63678383
11114,6,6,1,2412,-58,-91,33,40:e3:d6:da:ba:26,63678574,380,-189,63678194,63678574
11115,6,6,1,2412,-82,-91,9,e6:aa:ea:b7:4a:dd,63687294,408,8312,63686886,63687294
11116,6,6,1,2412,-56,-91,35,e6:aa:ea:c9:ea:33,63689890,408,2188,63689482,63689890
11117,6,6,1,2412,-57,-91,34,e6:aa:ea:c9:ea:33,63701947,408,11649,63701539,63701947
11118,6,6,1,2412,-82,-91,9,e6:aa:ea:b7:4a:dd,63711581,408,9226,63711173,63711581
11119,6,6,1,2412,-57,-91,34,e6:aa:ea:c9:ea:33,63714725,408,2736,63714317,63714725
11120,6,6,1,2412,-82,-91,9,e6:aa:ea:b7:4a:dd,63723650,408,8517,63723242,63723650
11121,6,6,1,2412,-57,-91,34,e6:aa:ea:c9:ea:33,63726184,408,2126,63725776,63726184
11122,4,1,1,2412,-88,-91,3,a6:e5:7c:28:b1:d3,63727787,992,611,63726795,63727787
11123,4,1,1,2412,-81,-91,10,54:e4:3a:ec:fb:64,63735640,2160,5693,63733480,63735640
11124,4,1,1,2412,-90,-91,1,,63751674,304,15730,63751370,63751674
11125,4,1,1,2412,-78,-91,13,b8:3a:5a:88:e6:e1,63765747,2376,11697,63763371,63765747
11126,6,12,1,2412,-64,-91,27,40:e3:d6:da:ba:20,63779493,160,13586,63779333,63779493
11127,6,6,1,2412,-63,-91,28,40:e3:d6:da:ba:21,63779685,368,-176,63779317,63779685
11128,6,12,1,2412,-63,-91,28,40:e3:d6:da:ba:22,63780072,180,207,63779892,63780072
11129,6,12,1,2412,-63,-91,28,40:e3:d6:da:ba:23,63780304,184,48,63780120,63780304
11130,6,12,1,2412,-64,-91,27,40:e3:d6:da:ba:24,63780532,176,52,63780356,63780532
11131,6,12,1,2412,-63,-91,28,40:e3:d6:da:ba:25,63780760,160,68,63780600,63780760
11132,6,6,1,2412,-63,-91,28,40:e3:d6:da:ba:26,63780952,380,-188,63780572,63780952
11133,4,1,1,2412,-85,-91,6,a6:e5:7c:28:b1:d3,63827859,992,45915,63826867,63827859
11134,4,1,1,2412,-78,-91,13,54:e4:3a:ec:fb:64,63837949,2160,7930,63835789,63837949
11135,4,1,1,2412,-77,-91,14,,63840410,304,2157,63840106,63840410
11136,4,1,1,2412,-76,-91,15,b8:3a:5a:88:e6:e0,63865820,2360,23050,63863460,63865820
11137,4,1,1,2412,-76,-91,15,b8:3a:5a:88:e6:e1,63868199,2376,3,63865823,63868199
11138,6,12,1,2412,-62,-91,29,40:e3:d6:da:ba:20,63881889,160,13530,63881729,63881889
11139,6,6,1,2412,-62,-91,29,40:e3:d6:da:ba:21,63882108,368,-149,63881740,63882108
11140,4,1,1,2412,-78,-91,13,54:e4:3a:ec:fb:64,63940469,2160,56201,63938309,63940469
11141,4,1,1,2412,-78,-91,13,b8:3a:5a:88:e6:e0,63968177,2360,25348,63965817,63968177
11142,4,1,1,2412,-78,-91,13,b8:3a:5a:88:e6:e1,63970557,2376,4,63968181,63970557
11143,6,12,1,2412,-62,-91,29,40:e3:d6:da:ba:20,63984310,160,13593,63984150,63984310
11144,6,6,1,2412,-62,-91,29,40:e3:d6:da:ba:21,63984529,368,-149,63984161,63984529
11145,6,12,1,2412,-62,-91,29,40:e3:d6:da:ba:22,63984934,180,225,63984754,63984934
11146,6,12,1,2412,-62,-91,29,40:e3:d6:da:ba:23,63985148,184,30,63984964,63985148
11147,6,12,1,2412,-62,-91,29,40:e3:d6:da:ba:24,63985385,176,61,63985209,63985385
11148,6,12,1,2412,-62,-91,29,40:e3:d6:da:ba:25,63985595,160,50,63985435,63985595
11149,6,6,1,2412,-62,-91,29,40:e3:d6:da:ba:26,63985814,380,-161,63985434,63985814
11150,4,1,1,2412,-76,-91,15,54:e4:3a:ec:fb:64,64042849,2160,54875,64040689,64042849
11151,6,12,1,2412,-65,-91,26,40:e3:d6:da:ba:20,64088066,160,45057,64087906,64088066
11152,6,12,1,2412,-64,-91,27,40:e3:d6:da:ba:22,64088773,180,527,64088593,64088773
11153,6,12,1,2412,-64,-91,27,40:e3:d6:da:ba:23,64088988,184,31,64088804,64088988
11154,6,12,1,2412,-64,-91,27,40:e3:d6:da:ba:24,64089206,176,42,64089030,64089206
11155,6,12,1,2412,-65,-91,26,40:e3:d6:da:ba:25,64089435,160,69,64089275,64089435
11156,6,6,1,2412,-65,-91,26,40:e3:d6:da:ba:26,64089636,380,-179,64089256,64089636
11157,4,1,1,2412,-75,-91,16,54:e4:3a:ec:fb:64,64118154,2112,26406,64116042,64118154
11158,6,6,1,2412,-81,-91,10,e6:aa:ea:b7:4a:dd,64128961,408,10399,64128553,64128961
11159,6,6,1,2412,-81,-91,10,e6:aa:ea:b7:4a:dd,64141068,408,11699,64140660,64141068
11160,4,1,1,2412,-74,-91,17,54:e4:3a:ec:fb:64,64148944,2112,5764,64146832,64148944
11161,6,12,1,2412,-66,-91,25,40:e3:d6:da:ba:20,64189088,160,39984,64188928,64189088
11162,6,6,1,2412,-66,-91,25,40:e3:d6:da:ba:21,64189297,368,-159,64188929,64189297
11163,6,12,1,2412,-65,-91,26,40:e3:d6:da:ba:22,64189703,180,226,64189523,64189703
11164,6,12,1,2412,-65,-91,26,40:e3:d6:da:ba:23,64189916,184,29,64189732,64189916
11165,6,12,1,2412,-65,-91,26,40:e3:d6:da:ba:24,64190126,176,34,64189950,64190126
11166,6,12,1,2412,-65,-91,26,40:e3:d6:da:ba:25,64190337,160,51,64190177,64190337
11167,6,6,1,2412,-65,-91,26,40:e3:d6:da:ba:26,64190556,380,-161,64190176,64190556
11168,6,6,1,2412,-61,-91,30,e6:aa:ea:c9:ea:33,64209355,408,18391,64208947,64209355
11169,6,6,1,2412,-61,-91,30,e6:aa:ea:c9:ea:33,64221479,408,11716,64221071,64221479
11170,6,6,1,2412,-62,-91,29,e6:aa:ea:c9:ea:33,64233600,408,11713,64233192,64233600
11171,6,6,1,2412,-62,-91,29,e6:aa:ea:c9:ea:33,64246352,408,12344,64245944,64246352
11172,4,1,1,2412,-75,-91,16,54:e4:3a:ec:fb:64,64247710,2160,-802,64245550,64247710
11173,6,6,1,2412,-61,-91,30,e6:aa:ea:c9:ea:33,64257858,408,9740,64257450,64257858
11174,6,12,1,2412,-64,-91,27,40:e3:d6:da:ba:20,64291489,160,33471,64291329,64291489
11175,6,6,1,2412,-64,-91,27,40:e3:d6:da:ba:21,64291681,368,-176,64291313,64291681
11176,6,12,1,2412,-63,-91,28,40:e3:d6:da:ba:22,64292086,180,225,64291906,64292086
11177,6,12,1,2412,-64,-91,27,40:e3:d6:da:ba:23,64292300,184,30,64292116,64292300
11178,6,12,1,2412,-64,-91,27,40:e3:d6:da:ba:24,64292510,176,34,64292334,64292510
11179,6,12,1,2412,-63,-91,28,40:e3:d6:da:ba:25,64292711,160,41,64292551,64292711
11180,6,6,1,2412,-64,-91,27,40:e3:d6:da:ba:26,64292921,380,-170,64292541,64292921
11181,4,1,1,2412,-78,-91,13,54:e4:3a:ec:fb:64,64350059,2160,54978,64347899,64350059
11182,4,1,1,2412,-79,-91,12,b8:3a:5a:88:e6:e0,64377889,2360,25470,64375529,64377889
11183,4,1,1,2412,-78,-91,13,b8:3a:5a:88:e6:e1,64380269,2376,4,64377893,64380269
11184,4,1,1,2412,-84,-91,7,,64386260,304,5687,64385956,64386260
11185,6,12,1,2412,-62,-91,29,40:e3:d6:da:ba:20,64393889,160,7469,64393729,64393889
11186,6,6,1,2412,-63,-91,28,40:e3:d6:da:ba:21,64394108,368,-149,64393740,64394108
11187,6,12,1,2412,-62,-91,29,40:e3:d6:da:ba:22,64394522,180,234,64394342,64394522
11188,6,12,1,2412,-63,-91,28,40:e3:d6:da:ba:23,64394745,184,39,64394561,64394745
11189,6,12,1,2412,-62,-91,29,40:e3:d6:da:ba:24,64394955,176,34,64394779,64394955
11190,6,12,1,2412,-63,-91,28,40:e3:d6:da:ba:25,64395156,160,41,64394996,64395156
11191,4,1,1,2412,-77,-91,14,b8:3a:5a:88:e6:e0,64480164,2360,82648,64477804,64480164
11192,6,12,1,2412,-62,-91,29,40:e3:d6:da:ba:20,64496289,160,15965,64496129,64496289
11193,6,6,1,2412,-62,-91,29,40:e3:d6:da:ba:21,64496508,368,-149,64496140,64496508
11194,6,12,1,2412,-61,-91,30,40:e3:d6:da:ba:22,64496969,180,281,64496789,64496969
11195,6,12,1,2412,-62,-91,29,40:e3:d6:da:ba:23,64497175,184,22,64496991,64497175
11196,6,12,1,2412,-61,-91,30,40:e3:d6:da:ba:24,64497411,176,60,64497235,64497411
11197,6,12,1,2412,-62,-91,29,40:e3:d6:da:ba:25,64497613,160,42,64497453,64497613
11198,6,6,1,2412,-62,-91,29,40:e3:d6:da:ba:26,64497839,380,-154,64497459,64497839
11199,6,6,1,2412,-77,-91,14,e6:aa:ea:b7:4a:dd,64510499,408,12252,64510091,64510499
11200,6,6,1,2412,-77,-91,14,e6:aa:ea:b7:4a:dd,64522615,408,11708,64522207,64522615
11201,6,6,1,2412,-75,-91,16,e6:aa:ea:b7:4a:dd,64534738,408,11715,64534330,64534738
11202,6,6,1,2412,-75,-91,16,e6:aa:ea:b7:4a:dd,64546847,408,11701,64546439,64546847
11203,4,1,1,2412,-77,-91,14,54:e4:3a:ec:fb:64,64554943,2160,5936,64552783,64554943
11204,6,6,1,2412,-75,-91,16,e6:aa:ea:b7:4a:dd,64558966,408,3615,64558558,64558966
11205,4,1,1,2412,-77,-91,14,b8:3a:5a:88:e6:e0,64582563,2360,21237,64580203,64582563
11206,4,1,1,2412,-78,-91,13,b8:3a:5a:88:e6:e1,64584969,2376,30,64582593,64584969
11207,6,12,1,2412,-60,-91,31,40:e3:d6:da:ba:20,64598696,160,13567,64598536,64598696
11208,6,6,1,2412,-60,-91,31,40:e3:d6:da:ba:21,64598914,368,-150,64598546,64598914
11209,6,12,1,2412,-60,-91,31,40:e3:d6:da:ba:22,64599320,180,226,64599140,64599320
11210,6,12,1,2412,-60,-91,31,40:e3:d6:da:ba:23,64599534,184,30,64599350,64599534
11211,6,12,1,2412,-60,-91,31,40:e3:d6:da:ba:25,64599945,160,251,64599785,64599945
11212,6,6,1,2412,-60,-91,31,40:e3:d6:da:ba:26,64600155,380,-170,64599775,64600155
11213,6,6,1,2412,-61,-91,30,e6:aa:ea:c9:ea:33,64626639,408,26076,64626231,64626639
11214,6,6,1,2412,-61,-91,30,e6:aa:ea:c9:ea:33,64638783,408,11736,64638375,64638783
11215,4,1,1,2412,-87,-91,4,a6:e5:7c:28:b1:d3,64644637,992,4862,64643645,64644637
11216,6,6,1,2412,-61,-91,30,e6:aa:ea:c9:ea:33,64650882,408,5837,64650474,64650882
11217,4,1,1,2412,-68,-91,23,54:e4:3a:ec:fb:64,64657336,2160,4294,64655176,64657336
11218,6,12,1,2412,-62,-91,29,40:e3:d6:da:ba:20,64701112,160,43616,64700952,64701112
11219,6,6,1,2412,-63,-91,28,40:e3:d6:da:ba:21,64701313,368,-167,64700945,64701313
11220,6,12,1,2412,-62,-91,29,40:e3:d6:da:ba:22,64701718,180,225,64701538,64701718
11221,6,12,1,2412,-63,-91,28,40:e3:d6:da:ba:23,64701951,184,49,64701767,64701951
11222,6,12,1,2412,-63,-91,28,40:e3:d6:da:ba:24,64702178,176,51,64702002,64702178
11223,6,12,1,2412,-63,-91,28,40:e3:d6:da:ba:25,64702407,160,69,64702247,64702407
11224,6,6,1,2412,-63,-91,28,40:e3:d6:da:ba:26,64702633,380,-154,64702253,64702633
11225,4,1,1,2412,-92,-91,-1,,64754434,304,51497,64754130,64754434
11226,4,1,1,2412,-76,-91,15,54:e4:3a:ec:fb:64,64759540,2160,2946,64757380,64759540
11227,4,1,1,2412,-80,-91,11,b8:3a:5a:88:e6:e0,64787377,2360,25477,64785017,64787377
11228,6,12,1,2412,-63,-91,28,40:e3:d6:da:ba:20,64803511,160,15974,64803351,64803511
11229,6,6,1,2412,-63,-91,28,40:e3:d6:da:ba:21,64803712,368,-167,64803344,64803712
11230,6,12,1,2412,-62,-91,29,40:e3:d6:da:ba:22,64804126,180,234,64803946,64804126
11231,6,12,1,2412,-62,-91,29,40:e3:d6:da:ba:25,64804821,160,535,64804661,64804821
11232,6,6,1,2412,-62,-91,29,40:e3:d6:da:ba:26,64805031,380,-170,64804651,64805031
11233,4,1,1,2412,-75,-91,16,54:e4:3a:ec:fb:64,64862124,2160,54933,64859964,64862124
11234,4,1,1,2412,-81,-91,10,b8:3a:5a:88:e6:e0,64889763,2360,25279,64887403,64889763
11235,6,12,1,2412,-62,-91,29,40:e3:d6:da:ba:20,64905973,160,16050,64905813,64905973
11236,6,6,1,2412,-62,-91,29,40:e3:d6:da:ba:21,64906174,368,-167,64905806,64906174
11237,6,12,1,2412,-62,-91,29,40:e3:d6:da:ba:22,64906561,180,207,64906381,64906561
11238,6,12,1,2412,-62,-91,29,40:e3:d6:da:ba:23,64906801,184,56,64906617,64906801
11239,6,12,1,2412,-62,-91,29,40:e3:d6:da:ba:24,64907028,176,51,64906852,64907028
11240,6,12,1,2412,-62,-91,29,40:e3:d6:da:ba:25,64907264,160,76,64907104,64907264
11241,6,6,1,2412,-62,-91,29,40:e3:d6:da:ba:26,64907456,380,-188,64907076,64907456
11242,4,1,1,2412,-73,-91,18,54:e4:3a:ec:fb:64,64964470,2160,54854,64962310,64964470
11243,6,12,1,2412,-63,-91,28,40:e3:d6:da:ba:20,65008303,160,43673,65008143,65008303
11244,6,6,1,2412,-62,-91,29,40:e3:d6:da:ba:21,65008513,368,-158,65008145,65008513
11245,6,12,1,2412,-62,-91,29,40:e3:d6:da:ba:22,65008918,180,225,65008738,65008918
11246,6,12,1,2412,-62,-91,29,40:e3:d6:da:ba:23,65009124,184,22,65008940,65009124
11247,6,12,1,2412,-62,-91,29,40:e3:d6:da:ba:24,65009360,176,60,65009184,65009360
11248,6,12,1,2412,-62,-91,29,40:e3:d6:da:ba:25,65009562,160,42,65009402,65009562
11249,6,6,1,2412,-62,-91,29,40:e3:d6:da:ba:26,65009772,380,-170,65009392,65009772
11250,6,6,1,2412,-79,-91,12,e6:aa:ea:b7:4a:dd,65031128,408,20948,65030720,65031128
11251,6,6,1,2412,-79,-91,12,e6:aa:ea:b7:4a:dd,65043263,408,11727,65042855,65043263
11252,6,6,1,2412,-61,-91,30,e6:aa:ea:c9:ea:33,65044618,408,947,65044210,65044618
11253,6,6,1,2412,-82,-91,9,e6:aa:ea:b7:4a:dd,65055453,408,10427,65055045,65055453
11254,6,6,1,2412,-54,-91,37,e6:aa:ea:c9:ea:33,65056715,408,854,65056307,65056715
11255,6,12,1,2412,-62,-91,29,40:e3:d6:da:ba:20,65110703,160,53828,65110543,65110703
11256,6,6,1,2412,-62,-91,29,40:e3:d6:da:ba:21,65110913,368,-158,65110545,65110913
11257,6,12,1,2412,-62,-91,29,40:e3:d6:da:ba:23,65111550,184,453,65111366,65111550
11258,6,12,1,2412,-62,-91,29,40:e3:d6:da:ba:24,65111760,176,34,65111584,65111760
11259,6,12,1,2412,-62,-91,29,40:e3:d6:da:ba:25,65111961,160,41,65111801,65111961
11260,6,6,1,2412,-62,-91,29,40:e3:d6:da:ba:26,65112180,380,-161,65111800,65112180
11261,4,1,1,2412,-75,-91,16,54:e4:3a:ec:fb:64,65169262,2160,54922,65167102,65169262
11262,4,1,1,2412,-80,-91,11,b8:3a:5a:88:e6:e0,65196960,2360,25338,65194600,65196960
11263,4,1,1,2412,-80,-91,11,b8:3a:5a:88:e6:e1,65199524,2376,188,65197148,65199524
11264,6,12,1,2412,-62,-91,29,40:e3:d6:da:ba:20,65213149,160,13465,65212989,65213149
11265,6,12,1,2412,-62,-91,29,40:e3:d6:da:ba:22,65213829,180,500,65213649,65213829
11266,6,12,1,2412,-62,-91,29,40:e3:d6:da:ba:24,65214379,176,374,65214203,65214379
11267,6,12,1,2412,-62,-91,29,40:e3:d6:da:ba:25,65214608,160,69,65214448,65214608
11268,6,6,1,2412,-62,-91,29,40:e3:d6:da:ba:26,65214808,380,-180,65214428,65214808
11269,4,1,1,2412,-76,-91,15,54:e4:3a:ec:fb:64,65227704,2112,10784,65225592,65227704
11270,6,12,1,2412,-87,-91,4,,65234682,32,6946,65234650,65234682
11271,6,12,1,2412,-87,-91,4,,65234923,32,209,65234891,65234923
11272,6,6,1,2412,-81,-91,10,84:1b:5e:df:1b:99,65295710,80,60707,65295630,65295710
11273,4,1,1,2412,-81,-91,10,b8:3a:5a:88:e6:e0,65299375,2360,1305,65297015,65299375
11274,4,1,1,2412,-80,-91,11,b8:3a:5a:88:e6:e1,65301904,2376,153,65299528,65301904
11275,6,12,1,2412,-61,-91,30,40:e3:d6:da:ba:20,65315511,160,13447,65315351,65315511
11276,6,6,1,2412,-61,-91,30,40:e3:d6:da:ba:21,65315730,368,-149,65315362,65315730
11277,6,12,1,2412,-61,-91,30,40:e3:d6:da:ba:22,65316126,180,216,65315946,65316126
11278,6,12,1,2412,-61,-91,30,40:e3:d6:da:ba:23,65316359,184,49,65316175,65316359
11279,6,12,1,2412,-61,-91,30,40:e3:d6:da:ba:24,65316568,176,33,65316392,65316568
11280,6,12,1,2412,-61,-91,30,40:e3:d6:da:ba:25,65316770,160,42,65316610,65316770
11281,6,6,1,2412,-61,-91,30,40:e3:d6:da:ba:26,65316971,380,-179,65316591,65316971
11282,4,1,1,2412,-89,-91,2,c0:c9:e3:4d:6e:bf,65331840,872,13997,65330968,65331840
11283,4,1,1,2412,-79,-91,12,b8:3a:5a:88:e6:e0,65401846,2360,67646,65399486,65401846
11284,4,1,1,2412,-71,-91,20,b8:3a:5a:88:e6:e1,65404225,2376,3,65401849,65404225
11285,6,12,1,2412,-60,-91,31,40:e3:d6:da:ba:20,65417895,160,13510,65417735,65417895
11286,6,6,1,2412,-60,-91,31,40:e3:d6:da:ba:21,65418105,368,-158,65417737,65418105
11287,6,12,1,2412,-60,-91,31,40:e3:d6:da:ba:22,65418501,180,216,65418321,65418501
11288,6,12,1,2412,-60,-91,31,40:e3:d6:da:ba:23,65418715,184,30,65418531,65418715
11289,6,12,1,2412,-60,-91,31,40:e3:d6:da:ba:24,65418934,176,43,65418758,65418934
11290,6,12,1,2412,-60,-91,31,40:e3:d6:da:ba:25,65419135,160,41,65418975,65419135
11291,6,6,1,2412,-60,-91,31,40:e3:d6:da:ba:26,65419336,380,-179,65418956,65419336
11292,6,6,1,2412,-58,-91,33,e6:aa:ea:c9:ea:33,65461564,408,41820,65461156,65461564
11293,6,6,1,2412,-58,-91,33,e6:aa:ea:c9:ea:33,65473691,408,11719,65473283,65473691
11294,4,1,1,2412,-79,-91,12,54:e4:3a:ec:fb:64,65476465,2160,614,65474305,65476465
11295,6,6,1,2412,-58,-91,33,e6:aa:ea:c9:ea:33,65485804,408,8931,65485396,65485804
11296,6,6,1,2412,-58,-91,33,e6:aa:ea:c9:ea:33,65497941,408,11729,65497533,65497941
11297,4,1,1,2412,-78,-91,13,b8:3a:5a:88:e6:e0,65504164,2360,3863,65501804,65504164
11298,4,1,1,2412,-79,-91,12,b8:3a:5a:88:e6:e1,65506571,2376,31,65504195,65506571
11299,6,6,1,2412,-58,-91,33,e6:aa:ea:c9:ea:33,65510045,408,3066,65509637,65510045
11300,6,12,1,2412,-58,-91,33,40:e3:d6:da:ba:20,65520320,160,10115,65520160,65520320
11301,6,6,1,2412,-58,-91,33,40:e3:d6:da:ba:21,65520530,368,-158,65520162,65520530
11302,6,12,1,2412,-58,-91,33,40:e3:d6:da:ba:22,65520925,180,215,65520745,65520925
11303,6,12,1,2412,-58,-91,33,40:e3:d6:da:ba:23,65521158,184,49,65520974,65521158
11304,6,12,1,2412,-58,-91,33,40:e3:d6:da:ba:24,65521395,176,61,65521219,65521395
11305,6,12,1,2412,-58,-91,33,40:e3:d6:da:ba:25,65521596,160,41,65521436,65521596
11306,6,6,1,2412,-58,-91,33,40:e3:d6:da:ba:26,65521797,380,-179,65521417,65521797
11307,6,6,1,2412,-78,-91,13,e6:aa:ea:b7:4a:dd,65563343,408,41138,65562935,65563343
11308,6,12,1,2412,-57,-91,34,40:e3:d6:da:ba:20,65573024,136,9545,65572888,65573024
11309,6,6,1,2412,-57,-91,34,40:e3:d6:da:ba:21,65573219,348,-153,65572871,65573219
11310,6,12,1,2412,-57,-91,34,40:e3:d6:da:ba:22,65573613,156,238,65573457,65573613
11311,6,12,1,2412,-57,-91,34,40:e3:d6:da:ba:23,65573804,156,35,65573648,65573804
11312,6,12,1,2412,-57,-91,34,40:e3:d6:da:ba:25,65574012,136,72,65573876,65574012
11313,4,1,1,2412,-75,-91,16,b8:3a:5a:88:e6:e1,65582398,2256,6130,65580142,65582398
11314,6,6,1,2412,-78,-91,13,e6:aa:ea:b7:4a:dd,65587581,408,4775,65587173,65587581
11315,4,1,1,2412,-77,-91,14,b8:3a:5a:88:e6:e1,65603424,2256,13587,65601168,65603424
11316,4,1,1,2412,-77,-91,14,b8:3a:5a:88:e6:e0,65606572,2360,788,65604212,65606572
11317,4,1,1,2412,-74,-91,17,b8:3a:5a:88:e6:e1,65608979,2376,31,65606603,65608979
11318,6,12,1,2412,-56,-91,35,40:e3:d6:da:ba:20,65622699,160,13560,65622539,65622699
11319,6,12,1,2412,-58,-91,33,40:e3:d6:da:ba:23,65623501,184,618,65623317,65623501
11320,6,12,1,2412,-57,-91,34,40:e3:d6:da:ba:24,65623720,176,43,65623544,65623720
11321,6,12,1,2412,-57,-91,34,40:e3:d6:da:ba:25,65623930,160,50,65623770,65623930
11322,6,12,1,2412,-60,-91,31,40:e3:d6:da:ba:20,65725109,160,101019,65724949,65725109
11323,6,6,1,2412,-60,-91,31,40:e3:d6:da:ba:21,65725328,368,-149,65724960,65725328
11324,6,12,1,2412,-59,-91,32,40:e3:d6:da:ba:22,65725724,180,216,65725544,65725724
11325,6,12,1,2412,-59,-91,32,40:e3:d6:da:ba:23,65725947,184,39,65725763,65725947
11326,6,12,1,2412,-59,-91,32,40:e3:d6:da:ba:24,65726166,176,43,65725990,65726166
11327,6,12,1,2412,-59,-91,32,40:e3:d6:da:ba:25,65726367,160,41,65726207,65726367
11328,6,6,1,2412,-60,-91,31,40:e3:d6:da:ba:26,65726568,380,-179,65726188,65726568
11329,4,1,1,2412,-79,-91,12,54:e4:3a:ec:fb:64,65783633,2160,54905,65781473,65783633
11330,4,1,1,2412,-76,-91,15,b8:3a:5a:88:e6:e0,65813897,2360,27904,65811537,65813897
11331,4,1,1,2412,-75,-91,16,b8:3a:5a:88:e6:e1,65816277,2376,4,65813901,65816277
11332,4,1,1,2412,-86,-91,5,c0:c9:e3:4d:6e:bf,65820012,872,2863,65819140,65820012
11333,6,12,1,2412,-60,-91,31,40:e3:d6:da:ba:20,65827520,160,7348,65827360,65827520
11334,6,6,1,2412,-60,-91,31,40:e3:d6:da:ba:21,65827730,368,-158,65827362,65827730
11335,6,12,1,2412,-59,-91,32,40:e3:d6:da:ba:22,65828144,180,234,65827964,65828144
11336,6,12,1,2412,-60,-91,31,40:e3:d6:da:ba:23,65828350,184,22,65828166,65828350
11337,6,12,1,2412,-59,-91,32,40:e3:d6:da:ba:24,65828559,176,33,65828383,65828559
11338,6,12,1,2412,-60,-91,31,40:e3:d6:da:ba:25,65828804,160,85,65828644,65828804
11339,6,6,1,2412,-59,-91,32,40:e3:d6:da:ba:26,65829023,380,-161,65828643,65829023
11340,4,1,1,2412,-79,-91,12,54:e4:3a:ec:fb:64,65886087,2160,54904,65883927,65886087
11341,4,1,1,2412,-74,-91,17,b8:3a:5a:88:e6:e0,65913779,2360,25332,65911419,65913779
11342,6,12,1,2412,-59,-91,32,40:e3:d6:da:ba:20,65929895,160,15956,65929735,65929895
11343,6,6,1,2412,-59,-91,32,40:e3:d6:da:ba:21,65930105,368,-158,65929737,65930105
11344,6,12,1,2412,-59,-91,32,40:e3:d6:da:ba:22,65930510,180,225,65930330,65930510
11345,6,12,1,2412,-59,-91,32,40:e3:d6:da:ba:23,65930724,184,30,65930540,65930724
11346,6,12,1,2412,-59,-91,32,40:e3:d6:da:ba:24,65930961,176,61,65930785,65930961
11347,6,12,1,2412,-59,-91,32,40:e3:d6:da:ba:25,65931171,160,50,65931011,65931171
11348,6,6,1,2412,-59,-91,32,40:e3:d6:da:ba:26,65931372,380,-179,65930992,65931372
11349,4,1,1,2412,-86,-91,5,a4:e5:7c:28:b1:d3,65950623,688,18563,65949935,65950623
11350,6,6,1,2412,-63,-91,28,e6:aa:ea:c9:ea:33,65982014,408,30983,65981606,65982014
11351,4,1,1,2412,-78,-91,13,54:e4:3a:ec:fb:64,65988487,2160,4313,65986327,65988487
11352,6,6,1,2412,-63,-91,28,e6:aa:ea:c9:ea:33,65993943,408,5048,65993535,65993943
11353,6,6,1,2412,-63,-91,28,e6:aa:ea:c9:ea:33,66006239,408,11888,66005831,66006239
11354,6,6,1,2412,-63,-91,28,e6:aa:ea:c9:ea:33,66030285,408,23638,66029877,66030285
11355,6,12,1,2412,-59,-91,32,40:e3:d6:da:ba:20,66032296,160,1851,66032136,66032296
11356,6,6,1,2412,-59,-91,32,40:e3:d6:da:ba:21,66032506,368,-158,66032138,66032506
11357,6,12,1,2412,-59,-91,32,40:e3:d6:da:ba:22,66032902,180,216,66032722,66032902
11358,6,12,1,2412,-59,-91,32,40:e3:d6:da:ba:23,66033116,184,30,66032932,66033116
11359,6,12,1,2412,-59,-91,32,40:e3:d6:da:ba:24,66033335,176,43,66033159,66033335
11360,6,12,1,2412,-59,-91,32,40:e3:d6:da:ba:25,66033563,160,68,66033403,66033563
11361,6,6,1,2412,-59,-91,32,40:e3:d6:da:ba:26,66033755,380,-188,66033375,66033755
11362,6,6,1,2412,-77,-91,14,e6:aa:ea:b7:4a:dd,66071054,408,36891,66070646,66071054
11363,6,6,1,2412,-77,-91,14,e6:aa:ea:b7:4a:dd,66083151,408,11689,66082743,66083151
11364,4,1,1,2412,-79,-91,12,54:e4:3a:ec:fb:64,66090889,2160,5578,66088729,66090889
11365,6,6,1,2412,-77,-91,14,e6:aa:ea:b7:4a:dd,66095261,408,3964,66094853,66095261
11366,6,6,1,2412,-78,-91,13,e6:aa:ea:b7:4a:dd,66107496,408,11827,66107088,66107496
11367,4,1,1,2412,-78,-91,13,b8:3a:5a:88:e6:e0,66118562,2360,8706,66116202,66118562
11368,4,1,1,2412,-77,-91,14,b8:3a:5a:88:e6:e1,66121023,2376,85,66118647,66121023
11369,6,12,1,2412,-58,-91,33,40:e3:d6:da:ba:20,66134720,160,13537,66134560,66134720
11370,6,6,1,2412,-57,-91,34,40:e3:d6:da:ba:21,66134930,368,-158,66134562,66134930
11371,6,12,1,2412,-57,-91,34,40:e3:d6:da:ba:22,66135344,180,234,66135164,66135344
11372,6,12,1,2412,-57,-91,34,40:e3:d6:da:ba:23,66135567,184,39,66135383,66135567
11373,6,12,1,2412,-57,-91,34,40:e3:d6:da:ba:24,66135804,176,61,66135628,66135804
11374,6,12,1,2412,-56,-91,35,40:e3:d6:da:ba:20,66237161,160,101197,66237001,66237161
11375,6,6,1,2412,-55,-91,36,40:e3:d6:da:ba:21,66237371,368,-158,66237003,66237371
11376,6,12,1,2412,-55,-91,36,40:e3:d6:da:ba:22,66237758,180,207,66237578,66237758
11377,6,12,1,2412,-55,-91,36,40:e3:d6:da:ba:23,66237973,184,31,66237789,66237973
11378,6,12,1,2412,-55,-91,36,40:e3:d6:da:ba:24,66238182,176,33,66238006,66238182
11379,6,12,1,2412,-55,-91,36,40:e3:d6:da:ba:25,66238402,160,60,66238242,66238402
11380,6,6,1,2412,-55,-91,36,40:e3:d6:da:ba:26,66238620,380,-162,66238240,66238620
11381,4,1,1,2412,-80,-91,11,54:e4:3a:ec:fb:64,66295527,2160,54747,66293367,66295527
11382,4,1,1,2412,-88,-91,3,,66298293,304,2462,66297989,66298293
11383,4,1,1,2412,-86,-91,5,a6:e5:7c:28:b1:d3,66299676,944,439,66298732,66299676
11384,4,1,1,2412,-87,-91,4,,66318734,304,18754,66318430,66318734
11385,4,1,1,2412,-80,-91,11,b8:3a:5a:88:e6:e0,66323759,2360,2665,66321399,66323759
11386,4,1,1,2412,-80,-91,11,b8:3a:5a:88:e6:e1,66326157,2376,22,66323781,66326157
11387,6,12,1,2412,-57,-91,34,40:e3:d6:da:ba:20,66339513,160,13196,66339353,66339513
11388,6,12,1,2412,-57,-91,34,40:e3:d6:da:ba:22,66340128,180,435,66339948,66340128
11389,6,12,1,2412,-57,-91,34,40:e3:d6:da:ba:24,66340552,176,248,66340376,66340552
11390,6,12,1,2412,-57,-91,34,40:e3:d6:da:ba:25,66340781,160,69,66340621,66340781
11391,6,6,1,2412,-57,-91,34,40:e3:d6:da:ba:26,66340973,380,-188,66340593,66340973
11392,4,1,1,2412,-92,-91,-1,,66362474,304,21197,66362170,66362474
11393,4,1,1,2412,-80,-91,11,54:e4:3a:ec:fb:64,66398067,2160,33433,66395907,66398067
11394,4,1,1,2412,-81,-91,10,b8:3a:5a:88:e6:e1,66428169,2376,27726,66425793,66428169
11395,6,12,1,2412,-62,-91,29,40:e3:d6:da:ba:20,66441920,160,13591,66441760,66441920
11396,6,6,1,2412,-62,-91,29,40:e3:d6:da:ba:21,66442112,368,-176,66441744,66442112
11397,6,12,1,2412,-62,-91,29,40:e3:d6:da:ba:22,66442526,180,234,66442346,66442526
11398,6,12,1,2412,-61,-91,30,40:e3:d6:da:ba:23,66442750,184,40,66442566,66442750
11399,6,12,1,2412,-61,-91,30,40:e3:d6:da:ba:24,66442977,176,51,66442801,66442977
11400,6,12,1,2412,-61,-91,30,40:e3:d6:da:ba:25,66443197,160,60,66443037,66443197
11401,6,6,1,2412,-61,-91,30,40:e3:d6:da:ba:26,66443407,380,-170,66443027,66443407
11402,4,1,1,2412,-86,-91,5,a6:e5:7c:28:b1:d3,66487900,992,43501,66486908,66487900
11403,6,6,1,2412,-62,-91,29,e6:aa:ea:c9:ea:33,66513850,408,25542,66513442,66513850
11404,6,6,1,2412,-62,-91,29,e6:aa:ea:c9:ea:33,66525954,408,11696,66525546,66525954
11405,4,1,1,2412,-80,-91,11,b8:3a:5a:88:e6:e0,66528162,2360,-152,66525802,66528162
11406,6,6,1,2412,-63,-91,28,e6:aa:ea:c9:ea:33,66538142,408,9572,66537734,66538142
11407,6,12,1,2412,-60,-91,31,40:e3:d6:da:ba:20,66544298,160,5996,66544138,66544298
11408,6,6,1,2412,-60,-91,31,40:e3:d6:da:ba:21,66544499,368,-167,66544131,66544499
11409,6,12,1,2412,-59,-91,32,40:e3:d6:da:ba:22,66544913,180,234,66544733,66544913
11410,6,12,1,2412,-60,-91,31,40:e3:d6:da:ba:23,66545118,184,21,66544934,66545118
11411,6,12,1,2412,-60,-91,31,40:e3:d6:da:ba:24,66545346,176,52,66545170,66545346
11412,6,12,1,2412,-60,-91,31,40:e3:d6:da:ba:25,66545574,160,68,66545414,66545574
11413,6,6,1,2412,-60,-91,31,40:e3:d6:da:ba:26,66545766,380,-188,66545386,66545766
11414,6,6,1,2412,-63,-91,28,e6:aa:ea:c9:ea:33,66550174,408,4000,66549766,66550174
11415,4,1,1,2412,-88,-91,3,a6:e5:7c:28:b1:d3,66590076,992,38910,66589084,66590076
11416,6,6,1,2412,-75,-91,16,e6:aa:ea:b7:4a:dd,66591401,408,917,66590993,66591401
11417,4,1,1,2412,-72,-91,19,54:e4:3a:ec:fb:64,66602725,2160,9164,66600565,66602725
11418,4,1,1,2412,-77,-91,14,b8:3a:5a:88:e6:e0,66630587,2360,25502,66628227,66630587
11419,4,1,1,2412,-77,-91,14,b8:3a:5a:88:e6:e1,66632994,2376,31,66630618,66632994
11420,6,6,1,2412,-76,-91,15,e6:aa:ea:b7:4a:dd,66639660,408,6258,66639252,66639660
11421,6,12,1,2412,-61,-91,30,40:e3:d6:da:ba:20,66646717,160,6897,66646557,66646717
11422,6,6,1,2412,-61,-91,30,40:e3:d6:da:ba:21,66646936,368,-149,66646568,66646936
11423,6,12,1,2412,-60,-91,31,40:e3:d6:da:ba:22,66647323,180,207,66647143,66647323
11424,6,12,1,2412,-60,-91,31,40:e3:d6:da:ba:23,66647528,184,21,66647344,66647528
11425,6,12,1,2412,-61,-91,30,40:e3:d6:da:ba:24,66647765,176,61,66647589,66647765
11426,6,12,1,2412,-61,-91,30,40:e3:d6:da:ba:25,66647966,160,41,66647806,66647966
11427,6,6,1,2412,-60,-91,31,40:e3:d6:da:ba:26,66648167,380,-179,66647787,66648167
11428,4,1,1,2412,-77,-91,14,b8:3a:5a:88:e6:e1,66735351,2376,84808,66732975,66735351
11429,6,12,1,2412,-59,-91,32,40:e3:d6:da:ba:20,66749098,160,13587,66748938,66749098
11430,6,6,1,2412,-59,-91,32,40:e3:d6:da:ba:21,66749290,368,-176,66748922,66749290
11431,6,12,1,2412,-59,-91,32,40:e3:d6:da:ba:22,66749695,180,225,66749515,66749695
11432,6,12,1,2412,-59,-91,32,40:e3:d6:da:ba:23,66749928,184,49,66749744,66749928
11433,6,12,1,2412,-59,-91,32,40:e3:d6:da:ba:24,66750155,176,51,66749979,66750155
11434,6,12,1,2412,-59,-91,32,40:e3:d6:da:ba:25,66750357,160,42,66750197,66750357
11435,6,6,1,2412,-59,-91,32,40:e3:d6:da:ba:26,66750549,380,-188,66750169,66750549
11436,4,1,1,2412,-84,-91,7,c0:c9:e3:4d:6e:bf,66804951,872,53530,66804079,66804951
11437,4,1,1,2412,-87,-91,4,,66805839,304,584,66805535,66805839
11438,4,1,1,2412,-80,-91,11,54:e4:3a:ec:fb:64,66807690,2160,-309,66805530,66807690
11439,4,1,1,2412,-80,-91,11,b8:3a:5a:88:e6:e0,66835383,2360,25333,66833023,66835383
11440,4,1,1,2412,-83,-91,8,c0:c9:e3:4d:6e:bf,66849388,872,13133,66848516,66849388
11441,4,1,1,2412,-90,-91,1,,66850277,304,585,66849973,66850277
11442,6,12,1,2412,-56,-91,35,40:e3:d6:da:ba:20,66851521,160,1084,66851361,66851521
11443,6,6,1,2412,-56,-91,35,40:e3:d6:da:ba:21,66851713,368,-176,66851345,66851713
11444,6,12,1,2412,-56,-91,35,40:e3:d6:da:ba:22,66852109,180,216,66851929,66852109
11445,6,12,1,2412,-56,-91,35,40:e3:d6:da:ba:23,66852342,184,49,66852158,66852342
11446,6,12,1,2412,-56,-91,35,40:e3:d6:da:ba:24,66852569,176,51,66852393,66852569
11447,6,12,1,2412,-56,-91,35,40:e3:d6:da:ba:25,66852789,160,60,66852629,66852789
11448,6,6,1,2412,-56,-91,35,40:e3:d6:da:ba:26,66852990,380,-179,66852610,66852990
11449,4,1,1,2412,-78,-91,13,54:e4:3a:ec:fb:64,66909983,2160,54833,66907823,66909983
11450,6,6,1,2412,-63,-91,28,e6:aa:ea:c9:ea:33,66919358,408,8967,66918950,66919358
11451,6,6,1,2412,-64,-91,27,e6:aa:ea:c9:ea:33,66931488,408,11722,66931080,66931488
11452,4,1,1,2412,-82,-91,9,b8:3a:5a:88:e6:e0,66937784,2360,3936,66935424,66937784
11453,6,6,1,2412,-65,-91,26,e6:aa:ea:c9:ea:33,66945727,408,7535,66945319,66945727
11454,6,12,1,2412,-55,-91,36,40:e3:d6:da:ba:20,66953911,160,8024,66953751,66953911
11455,6,6,1,2412,-55,-91,36,40:e3:d6:da:ba:21,66954121,368,-158,66953753,66954121
11456,6,12,1,2412,-55,-91,36,40:e3:d6:da:ba:22,66954517,180,216,66954337,66954517
11457,6,12,1,2412,-56,-91,35,40:e3:d6:da:ba:23,66954732,184,31,66954548,66954732
11458,6,12,1,2412,-56,-91,35,40:e3:d6:da:ba:24,66954941,176,33,66954765,66954941
11459,6,12,1,2412,-55,-91,36,40:e3:d6:da:ba:25,66955169,160,68,66955009,66955169
11460,6,6,1,2412,-66,-91,25,e6:aa:ea:c9:ea:33,66967954,408,12377,66967546,66967954
11461,6,6,1,2412,-75,-91,16,e6:aa:ea:b7:4a:dd,67008990,408,40628,67008582,67008990
11462,6,6,1,2412,-76,-91,15,e6:aa:ea:b7:4a:dd,67033225,408,23827,67032817,67033225
11463,4,1,1,2412,-74,-91,17,b8:3a:5a:88:e6:e0,67040167,2360,4582,67037807,67040167
11464,4,1,1,2412,-84,-91,7,b8:3a:5a:88:e6:e1,67042547,2376,4,67040171,67042547
11465,6,6,1,2412,-76,-91,15,e6:aa:ea:b7:4a:dd,67045335,408,2380,67044927,67045335
11466,6,12,1,2412,-55,-91,36,40:e3:d6:da:ba:20,67056306,160,10811,67056146,67056306
11467,6,6,1,2412,-55,-91,36,40:e3:d6:da:ba:21,67056507,368,-167,67056139,67056507
11468,6,12,1,2412,-55,-91,36,40:e3:d6:da:ba:22,67056912,180,225,67056732,67056912
11469,6,12,1,2412,-55,-91,36,40:e3:d6:da:ba:23,67057135,184,39,67056951,67057135
11470,6,12,1,2412,-55,-91,36,40:e3:d6:da:ba:24,67057372,176,61,67057196,67057372
11471,6,12,1,2412,-55,-91,36,40:e3:d6:da:ba:25,67057600,160,68,67057440,67057600
11472,6,6,1,2412,-55,-91,36,40:e3:d6:da:ba:26,67057801,380,-179,67057421,67057801
11473,6,6,1,2412,-76,-91,15,e6:aa:ea:b7:4a:dd,67058348,408,139,67057940,67058348
11474,4,1,1,2412,-79,-91,12,54:e4:3a:ec:fb:64,67114876,2160,54368,67112716,67114876
11475,4,1,1,2412,-78,-91,13,b8:3a:5a:88:e6:e0,67142573,2360,25337,67140213,67142573
11476,6,12,1,2412,-55,-91,36,40:e3:d6:da:ba:20,67158701,160,15968,67158541,67158701
11477,6,6,1,2412,-55,-91,36,40:e3:d6:da:ba:21,67158920,368,-149,67158552,67158920
11478,6,12,1,2412,-55,-91,36,40:e3:d6:da:ba:22,67159307,180,207,67159127,67159307
11479,6,12,1,2412,-55,-91,36,40:e3:d6:da:ba:23,67159522,184,31,67159338,67159522
11480,6,12,1,2412,-55,-91,36,40:e3:d6:da:ba:24,67159749,176,51,67159573,67159749
11481,6,12,1,2412,-55,-91,36,40:e3:d6:da:ba:25,67159978,160,69,67159818,67159978
11482,6,6,1,2412,-55,-91,36,40:e3:d6:da:ba:26,67160179,380,-179,67159799,67160179
11483,4,1,1,2412,-77,-91,14,54:e4:3a:ec:fb:64,67217257,2160,54918,67215097,67217257
11484,4,1,1,2412,-76,-91,15,b8:3a:5a:88:e6:e0,67244965,2360,25348,67242605,67244965
11485,4,1,1,2412,-77,-91,14,b8:3a:5a:88:e6:e1,67247354,2376,13,67244978,67247354
11486,6,12,1,2412,-61,-91,30,40:e3:d6:da:ba:20,67261128,160,13614,67260968,67261128
11487,6,6,1,2412,-60,-91,31,40:e3:d6:da:ba:21,67261338,368,-158,67260970,67261338
11488,6,12,1,2412,-60,-91,31,40:e3:d6:da:ba:22,67261751,180,233,67261571,67261751
11489,6,12,1,2412,-55,-91,36,40:e3:d6:da:ba:23,67261957,184,22,67261773,67261957
11490,6,12,1,2412,-55,-91,36,40:e3:d6:da:ba:24,67262166,176,33,67261990,67262166
11491,6,12,1,2412,-55,-91,36,40:e3:d6:da:ba:25,67262395,160,69,67262235,67262395
11492,6,6,1,2412,-55,-91,36,40:e3:d6:da:ba:26,67262605,380,-170,67262225,67262605
11493,6,12,1,2412,-55,-91,36,40:e3:d6:da:ba:20,67272067,960,8502,67271107,67272067
11494,4,1,1,2412,-88,-91,3,c0:c9:e3:4d:6e:bf,67293178,872,20239,67292306,67293178
11495,4,1,1,2412,-76,-91,15,54:e4:3a:ec:fb:64,67319714,2160,24376,67317554,67319714
11496,4,1,1,2412,-78,-91,13,b8:3a:5a:88:e6:e0,67347373,2360,25299,67345013,67347373
11497,4,1,1,2412,-80,-91,11,b8:3a:5a:88:e6:e1,67349753,2376,4,67347377,67349753
11498,6,12,1,2412,-57,-91,34,40:e3:d6:da:ba:20,67363502,160,13589,67363342,67363502
11499,6,6,1,2412,-57,-91,34,40:e3:d6:da:ba:21,67363721,368,-149,67363353,67363721
11500,6,12,1,2412,-57,-91,34,40:e3:d6:da:ba:22,67364117,180,216,67363937,67364117
11501,6,12,1,2412,-57,-91,34,40:e3:d6:da:ba:23,67364340,184,39,67364156,67364340
11502,6,12,1,2412,-57,-91,34,40:e3:d6:da:ba:24,67364577,176,61,67364401,67364577
11503,6,12,1,2412,-57,-91,34,40:e3:d6:da:ba:25,67364787,160,50,67364627,67364787
11504,6,6,1,2412,-57,-91,34,40:e3:d6:da:ba:26,67364988,380,-179,67364608,67364988
11505,6,6,1,2412,-63,-91,28,e6:aa:ea:c9:ea:33,67440115,408,74719,67439707,67440115
11506,6,6,1,2412,-63,-91,28,e6:aa:ea:c9:ea:33,67464341,408,23818,67463933,67464341
11507,6,12,1,2412,-57,-91,34,40:e3:d6:da:ba:20,67465902,160,1401,67465742,67465902
11508,6,6,1,2412,-57,-91,34,40:e3:d6:da:ba:21,67466111,368,-159,67465743,67466111
11509,6,12,1,2412,-57,-91,34,40:e3:d6:da:ba:22,67466526,180,235,67466346,67466526
11510,6,12,1,2412,-57,-91,34,40:e3:d6:da:ba:23,67466731,184,21,67466547,67466731
11511,6,12,1,2412,-57,-91,34,40:e3:d6:da:ba:24,67466967,176,60,67466791,67466967
11512,6,12,1,2412,-57,-91,34,40:e3:d6:da:ba:25,67467187,160,60,67467027,67467187
11513,6,6,1,2412,-63,-91,28,e6:aa:ea:c9:ea:33,67476447,408,8852,67476039,67476447
11514,6,6,1,2412,-63,-91,28,e6:aa:ea:c9:ea:33,67488564,408,11709,67488156,67488564
11515,4,1,1,2412,-78,-91,13,54:e4:3a:ec:fb:64,67524480,2160,33756,67522320,67524480
11516,6,6,1,2412,-73,-91,18,e6:aa:ea:b7:4a:dd,67541234,408,16346,67540826,67541234
11517,4,1,1,2412,-75,-91,16,b8:3a:5a:88:e6:e1,67554592,2376,10982,67552216,67554592
11518,6,12,1,2412,-56,-91,35,40:e3:d6:da:ba:20,67568312,160,13560,67568152,67568312
11519,6,6,1,2412,-56,-91,35,40:e3:d6:da:ba:21,67568503,368,-177,67568135,67568503
11520,6,12,1,2412,-56,-91,35,40:e3:d6:da:ba:22,67568908,180,225,67568728,67568908
11521,6,12,1,2412,-56,-91,35,40:e3:d6:da:ba:23,67569123,184,31,67568939,67569123
11522,6,12,1,2412,-55,-91,36,40:e3:d6:da:ba:24,67569341,176,42,67569165,67569341
11523,6,12,1,2412,-56,-91,35,40:e3:d6:da:ba:25,67569561,160,60,67569401,67569561
11524,6,6,1,2412,-75,-91,16,e6:aa:ea:b7:4a:dd,67577564,408,7595,67577156,67577564
11525,4,1,1,2412,-80,-91,11,54:e4:3a:ec:fb:64,67626899,2160,47175,67624739,67626899
11526,4,1,1,2412,-75,-91,16,b8:3a:5a:88:e6:e1,67656965,2376,27690,67654589,67656965
11527,6,12,1,2412,-55,-91,36,40:e3:d6:da:ba:20,67670722,160,13597,67670562,67670722
11528,6,6,1,2412,-55,-91,36,40:e3:d6:da:ba:21,67670914,368,-176,67670546,67670914
11529,6,12,1,2412,-55,-91,36,40:e3:d6:da:ba:22,67671328,180,234,67671148,67671328
11530,6,12,1,2412,-55,-91,36,40:e3:d6:da:ba:24,67671788,176,284,67671612,67671788
11531,6,12,1,2412,-55,-91,36,40:e3:d6:da:ba:25,67672017,160,69,67671857,67672017
11532,6,6,1,2412,-55,-91,36,40:e3:d6:da:ba:26,67672218,380,-179,67671838,67672218
11533,4,1,1,2412,-75,-91,16,b8:3a:5a:88:e6:e0,67757953,2360,83375,67755593,67757953
11534,4,1,1,2412,-74,-91,17,b8:3a:5a:88:e6:e1,67760333,2376,4,67757957,67760333
11535,6,12,1,2412,-57,-91,34,40:e3:d6:da:ba:20,67773117,160,12624,67772957,67773117
11536,6,6,1,2412,-58,-91,33,40:e3:d6:da:ba:21,67773327,368,-158,67772959,67773327
11537,6,12,1,2412,-54,-91,37,40:e3:d6:da:ba:22,67773723,180,216,67773543,67773723
11538,6,12,1,2412,-55,-91,36,40:e3:d6:da:ba:24,67776527,176,2628,67776351,67776527
11539,6,12,1,2412,-54,-91,37,40:e3:d6:da:ba:25,67776746,160,59,67776586,67776746
11540,4,1,1,2412,-87,-91,4,c0:c9:e3:4d:6e:bf,67784295,872,6677,67783423,67784295
11541,4,1,1,2412,-84,-91,7,c0:c9:e3:4d:6e:bf,67828510,872,43343,67827638,67828510
11542,4,1,1,2412,-90,-91,1,,67829399,304,585,67829095,67829399
11543,4,1,1,2412,-80,-91,11,54:e4:3a:ec:fb:64,67831692,2160,133,67829532,67831692
11544,4,1,1,2412,-72,-91,19,b8:3a:5a:88:e6:e0,67859365,2360,25313,67857005,67859365
11545,4,1,1,2412,-74,-91,17,b8:3a:5a:88:e6:e1,67861754,2376,13,67859378,67861754
11546,6,12,1,2412,-55,-91,36,40:e3:d6:da:ba:20,67875504,160,13590,67875344,67875504
11547,6,6,1,2412,-54,-91,37,40:e3:d6:da:ba:21,67875696,368,-176,67875328,67875696
11548,6,12,1,2412,-54,-91,37,40:e3:d6:da:ba:22,67876101,180,225,67875921,67876101
11549,6,12,1,2412,-54,-91,37,40:e3:d6:da:ba:23,67876333,184,48,67876149,67876333
11550,6,12,1,2412,-54,-91,37,40:e3:d6:da:ba:24,67876552,176,43,67876376,67876552
11551,6,12,1,2412,-54,-91,37,40:e3:d6:da:ba:25,67876762,160,50,67876602,67876762
11552,6,6,1,2412,-54,-91,37,40:e3:d6:da:ba:26,67876972,380,-170,67876592,67876972
11553,4,1,1,2412,-77,-91,14,54:e4:3a:ec:fb:64,67934099,2160,54967,67931939,67934099
11554,6,6,1,2412,-75,-91,16,e6:aa:ea:b7:4a:dd,67948221,408,13714,67947813,67948221
11555,4,1,1,2412,-73,-91,18,b8:3a:5a:88:e6:e1,67964184,2376,13587,67961808,67964184
11556,6,6,1,2412,-74,-91,17,e6:aa:ea:b7:4a:dd,67972454,408,7862,67972046,67972454
11557,6,12,1,2412,-55,-91,36,40:e3:d6:da:ba:20,67978293,160,5679,67978133,67978293
11558,6,6,1,2412,-54,-91,37,40:e3:d6:da:ba:21,67978503,368,-158,67978135,67978503
11559,6,12,1,2412,-54,-91,37,40:e3:d6:da:ba:22,67978908,180,225,67978728,67978908
11560,6,12,1,2412,-54,-91,37,40:e3:d6:da:ba:23,67979123,184,31,67978939,67979123
11561,6,12,1,2412,-54,-91,37,40:e3:d6:da:ba:24,67979341,176,42,67979165,67979341
11562,6,12,1,2412,-54,-91,37,40:e3:d6:da:ba:25,67979570,160,69,67979410,67979570
11563,6,6,1,2412,-54,-91,37,40:e3:d6:da:ba:26,67979789,380,-161,67979409,67979789
11564,6,6,1,2412,-73,-91,18,e6:aa:ea:b7:4a:dd,67984579,408,4382,67984171,67984579
11565,6,6,1,2412,-67,-91,24,e6:aa:ea:c9:ea:33,67987031,408,2044,67986623,67987031
11566,6,6,1,2412,-75,-91,16,e6:aa:ea:b7:4a:dd,67996694,408,9255,67996286,67996694
11567,6,6,1,2412,-67,-91,24,e6:aa:ea:c9:ea:33,67998485,408,1383,67998077,67998485
11568,4,1,1,2412,-79,-91,12,54:e4:3a:ec:fb:64,68036504,2160,35859,68034344,68036504
11569,4,1,1,2412,-73,-91,18,b8:3a:5a:88:e6:e0,68064178,2360,25314,68061818,68064178
11570,4,1,1,2412,-74,-91,17,b8:3a:5a:88:e6:e1,68066576,2376,22,68064200,68066576
11571,6,12,1,2412,-55,-91,36,40:e3:d6:da:ba:20,68080320,160,13584,68080160,68080320
11572,6,6,1,2412,-55,-91,36,40:e3:d6:da:ba:21,68080512,368,-176,68080144,68080512
11573,6,12,1,2412,-55,-91,36,40:e3:d6:da:ba:22,68080917,180,225,68080737,68080917
11574,6,12,1,2412,-54,-91,37,40:e3:d6:da:ba:25,68081587,160,510,68081427,68081587
11575,6,6,1,2412,-54,-91,37,40:e3:d6:da:ba:26,68081779,380,-188,68081399,68081779
11576,4,1,1,2412,-65,-91,26,a6:e5:7c:28:b1:d3,68128268,992,45497,68127276,68128268
11577,4,1,1,2412,-79,-91,12,54:e4:3a:ec:fb:64,68138757,2160,8329,68136597,68138757
11578,4,1,1,2412,-73,-91,18,b8:3a:5a:88:e6:e0,68166566,2360,25449,68164206,68166566
11579,6,12,1,2412,-54,-91,37,40:e3:d6:da:ba:20,68182705,160,15979,68182545,68182705
11580,6,6,1,2412,-54,-91,37,40:e3:d6:da:ba:21,68182915,368,-158,68182547,68182915
11581,6,12,1,2412,-54,-91,37,40:e3:d6:da:ba:22,68183329,180,234,68183149,68183329
11582,6,12,1,2412,-54,-91,37,40:e3:d6:da:ba:23,68183562,184,49,68183378,68183562
11583,6,12,1,2412,-54,-91,37,40:e3:d6:da:ba:24,68183780,176,42,68183604,68183780
11584,6,12,1,2412,-54,-91,37,40:e3:d6:da:ba:25,68184000,160,60,68183840,68184000
11585,6,6,1,2412,-54,-91,37,40:e3:d6:da:ba:26,68184201,380,-179,68183821,68184201
11586,6,6,1,2412,-80,-91,11,84:1b:5e:df:1b:99,68215698,80,31417,68215618,68215698
11587,4,1,1,2412,-87,-91,4,a6:e5:7c:28:b1:d3,68228445,992,11755,68227453,68228445
11588,6,6,1,2412,-83,-91,8,78:8a:20:fa:27:f9,68234467,88,5934,68234379,68234467
11589,6,6,1,2412,-84,-91,7,,68234574,44,63,68234530,68234574
11590,4,1,1,2412,-78,-91,13,b8:3a:5a:88:e6:e0,68234985,2240,-1829,68232745,68234985
11591,4,1,1,2412,-77,-91,14,54:e4:3a:ec:fb:64,68241286,2160,4141,68239126,68241286
11592,4,1,1,2412,-84,-91,7,a4:e5:7c:28:b1:d3,68251176,688,9202,68250488,68251176
11593,4,1,1,2412,-89,-91,2,,68251880,304,400,68251576,68251880
11594,4,1,1,2412,-85,-91,6,c0:c9:e3:4d:6e:bf,68277544,872,24792,68276672,68277544
11595,4,1,1,2412,-73,-91,18,,68278433,304,585,68278129,68278433
11596,6,6,1,2412,-81,-91,10,78:8a:20:fa:27:f9,68284621,88,6100,68284533,68284621
11597,6,12,1,2412,-82,-91,9,,68285000,32,347,68284968,68285000
11598,6,12,1,2412,-53,-91,38,40:e3:d6:da:ba:20,68285113,160,-47,68284953,68285113
11599,6,6,1,2412,-53,-91,38,40:e3:d6:da:ba:21,68285332,368,-149,68284964,68285332
11600,6,12,1,2412,-53,-91,38,40:e3:d6:da:ba:22,68285737,180,225,68285557,68285737
11601,6,12,1,2412,-53,-91,38,40:e3:d6:da:ba:23,68285952,184,31,68285768,68285952
11602,6,12,1,2412,-53,-91,38,40:e3:d6:da:ba:24,68286195,176,67,68286019,68286195
11603,6,12,1,2412,-53,-91,38,40:e3:d6:da:ba:25,68286415,160,60,68286255,68286415
11604,6,6,1,2412,-53,-91,38,40:e3:d6:da:ba:26,68286616,380,-179,68286236,68286616
11605,4,1,1,2412,-81,-91,10,c0:c9:e3:4d:6e:bf,68320887,872,33399,68320015,68320887
11606,4,1,1,2412,-85,-91,6,,68321776,304,585,68321472,68321776
11607,4,1,1,2412,-57,-91,34,b8:3a:5a:88:e6:e0,68371409,2360,47273,68369049,68371409
11608,6,12,1,2412,-54,-91,37,40:e3:d6:da:ba:20,68387511,160,15942,68387351,68387511
11609,6,12,1,2412,-54,-91,37,40:e3:d6:da:ba:22,68388117,180,426,68387937,68388117
11610,6,12,1,2412,-54,-91,37,40:e3:d6:da:ba:23,68388349,184,48,68388165,68388349
11611,6,12,1,2412,-54,-91,37,40:e3:d6:da:ba:24,68388559,176,34,68388383,68388559
11612,6,6,1,2412,-54,-91,37,40:e3:d6:da:ba:26,68388961,380,22,68388581,68388961
11613,6,6,1,2412,-71,-91,20,e6:aa:ea:b7:4a:dd,68468179,408,78810,68467771,68468179
11614,4,1,1,2412,-77,-91,14,b8:3a:5a:88:e6:e1,68476214,2376,5659,68473838,68476214
11615,6,6,1,2412,-71,-91,20,e6:aa:ea:b7:4a:dd,68480299,408,3677,68479891,68480299
11616,6,6,1,2412,-69,-91,22,e6:aa:ea:c9:ea:33,68481222,408,515,68480814,68481222
11617,4,1,1,2412,-93,-91,-2,,68484093,304,2567,68483789,68484093
11618,6,12,1,2412,-75,-91,16,,68485426,36,1297,68485390,68485426
11619,6,12,1,2412,-56,-91,35,40:e3:d6:da:ba:20,68489909,160,4323,68489749,68489909
11620,6,6,1,2412,-56,-91,35,40:e3:d6:da:ba:21,68490128,368,-149,68489760,68490128
11621,6,12,1,2412,-56,-91,35,40:e3:d6:da:ba:22,68490533,180,225,68490353,68490533
11622,6,12,1,2412,-56,-91,35,40:e3:d6:da:ba:23,68490757,184,40,68490573,68490757
11623,6,12,1,2412,-56,-91,35,40:e3:d6:da:ba:24,68490984,176,51,68490808,68490984
11624,6,12,1,2412,-56,-91,35,40:e3:d6:da:ba:25,68491186,160,42,68491026,68491186
11625,6,6,1,2412,-56,-91,35,40:e3:d6:da:ba:26,68491395,380,-171,68491015,68491395
11626,6,6,1,2412,-71,-91,20,e6:aa:ea:b7:4a:dd,68492593,408,790,68492185,68492593
11627,6,6,1,2412,-69,-91,22,e6:aa:ea:c9:ea:33,68493373,408,372,68492965,68493373
11628,6,6,1,2412,-71,-91,20,e6:aa:ea:b7:4a:dd,68504538,408,10757,68504130,68504538
11629,4,1,1,2412,-87,-91,4,,68505653,304,811,68505349,68505653
11630,6,6,1,2412,-72,-91,19,e6:aa:ea:b7:4a:dd,68516652,408,10591,68516244,68516652
11631,6,6,1,2412,-70,-91,21,e6:aa:ea:c9:ea:33,68517571,408,511,68517163,68517571
11632,4,1,1,2412,-52,-91,39,,68525886,304,8011,68525582,68525886
11633,6,6,1,2412,-70,-91,21,e6:aa:ea:c9:ea:33,68529700,408,3406,68529292,68529700
11634,4,1,1,2412,-76,-91,15,b8:3a:5a:88:e6:e0,68576169,2360,44109,68573809,68576169
11635,4,1,1,2412,-87,-91,4,a6:e5:7c:28:b1:d3,68589772,944,12659,68588828,68589772
11636,6,12,1,2412,-55,-91,36,40:e3:d6:da:ba:20,68592329,160,2397,68592169,68592329
11637,6,6,1,2412,-55,-91,36,40:e3:d6:da:ba:21,68592539,368,-158,68592171,68592539
11638,6,12,1,2412,-55,-91,36,40:e3:d6:da:ba:22,68592935,180,216,68592755,68592935
11639,6,12,1,2412,-55,-91,36,40:e3:d6:da:ba:23,68593158,184,39,68592974,68593158
11640,6,12,1,2412,-55,-91,36,40:e3:d6:da:ba:24,68593377,176,43,68593201,68593377
11641,6,12,1,2412,-55,-91,36,40:e3:d6:da:ba:25,68593605,160,68,68593445,68593605
11642,6,6,1,2412,-55,-91,36,40:e3:d6:da:ba:26,68593824,380,-161,68593444,68593824
11643,4,1,1,2412,-81,-91,10,a6:e5:7c:28:b1:d3,68595126,944,358,68594182,68595126
11644,4,1,1,2412,-87,-91,4,a6:e5:7c:28:b1:d3,68596195,944,125,68595251,68596195
11645,4,1,1,2412,-88,-91,3,a6:e5:7c:28:b1:d3,68599570,944,2431,68598626,68599570
11646,4,1,1,2412,-82,-91,9,a6:e5:7c:28:b1:d3,68600675,944,161,68599731,68600675
11647,4,1,1,2412,-71,-91,20,a6:e5:7c:28:b1:d3,68601906,944,287,68600962,68601906
11648,4,1,1,2412,-89,-91,2,a6:e5:7c:28:b1:d3,68602975,944,125,68602031,68602975
11649,4,1,1,2412,-85,-91,6,a6:e5:7c:28:b1:d3,68607197,944,3278,68606253,68607197
11650,4,1,1,2412,-86,-91,5,a6:e5:7c:28:b1:d3,68609326,944,1185,68608382,68609326
11651,4,1,1,2412,-88,-91,3,a6:e5:7c:28:b1:d3,68610404,944,134,68609460,68610404
11652,4,1,1,2412,-87,-91,4,a6:e5:7c:28:b1:d3,68611464,944,116,68610520,68611464
11653,4,1,1,2412,-88,-91,3,a6:e5:7c:28:b1:d3,68615134,944,2726,68614190,68615134
11654,4,1,1,2412,-88,-91,3,a6:e5:7c:28:b1:d3,68616203,944,125,68615259,68616203
11655,4,1,1,2412,-81,-91,10,a6:e5:7c:28:b1:d3,68617296,944,149,68616352,68617296
11656,4,1,1,2412,-65,-91,26,b8:3a:5a:88:e6:e1,68683519,2376,63847,68681143,68683519
11657,4,1,1,2412,-87,-91,4,a6:e5:7c:28:b1:d3,68686064,944,1601,68685120,68686064
11658,4,1,1,2412,-68,-91,23,a6:e5:7c:28:b1:d3,68687178,944,170,68686234,68687178
11659,4,1,1,2412,-82,-91,9,a6:e5:7c:28:b1:d3,68689325,944,1203,68688381,68689325
11660,4,1,1,2412,-87,-91,4,a6:e5:7c:28:b1:d3,68690412,944,143,68689468,68690412
11661,4,1,1,2412,-88,-91,3,a6:e5:7c:28:b1:d3,68691653,944,297,68690709,68691653
11662,4,1,1,2412,-71,-91,20,a6:e5:7c:28:b1:d3,68696127,944,3530,68695183,68696127
11663,4,1,1,2412,-88,-91,3,a6:e5:7c:28:b1:d3,68697292,944,221,68696348,68697292
11664,4,1,1,2412,-87,-91,4,a6:e5:7c:28:b1:d3,68698451,944,215,68697507,68698451
11665,4,1,1,2412,-89,-91,2,a6:e5:7c:28:b1:d3,68699529,944,134,68698585,68699529
11666,4,1,1,2412,-87,-91,4,a6:e5:7c:28:b1:d3,68700580,944,107,68699636,68700580
11667,4,1,1,2412,-86,-91,5,a6:e5:7c:28:b1:d3,68701658,944,134,68700714,68701658
11668,4,1,1,2412,-88,-91,3,a6:e5:7c:28:b1:d3,68702718,944,116,68701774,68702718
11669,4,1,1,2412,-89,-91,2,a6:e5:7c:28:b1:d3,68703796,944,134,68702852,68703796
11670,4,1,1,2412,-87,-91,4,a6:e5:7c:28:b1:d3,68704847,944,107,68703903,68704847
11671,4,1,1,2412,-88,-91,3,a6:e5:7c:28:b1:d3,68707066,944,1275,68706122,68707066
11672,4,1,1,2412,-88,-91,3,a6:e5:7c:28:b1:d3,68708144,944,134,68707200,68708144
11673,4,1,1,2412,-89,-91,2,a6:e5:7c:28:b1:d3,68709213,944,125,68708269,68709213
11674,4,1,1,2412,-89,-91,2,a6:e5:7c:28:b1:d3,68710291,944,134,68709347,68710291
11675,6,12,1,2412,-54,-91,37,40:e3:d6:da:ba:20,68712470,160,2019,68712310,68712470
11676,6,6,1,2412,-54,-91,37,40:e3:d6:da:ba:21,68712689,368,-149,68712321,68712689
11677,6,12,1,2412,-54,-91,37,40:e3:d6:da:ba:22,68713076,180,207,68712896,68713076
11678,6,12,1,2412,-54,-91,37,40:e3:d6:da:ba:23,68713299,184,39,68713115,68713299
11679,6,12,1,2412,-54,-91,37,40:e3:d6:da:ba:24,68713518,176,43,68713342,68713518
11680,6,12,1,2412,-54,-91,37,40:e3:d6:da:ba:25,68713737,160,59,68713577,68713737
11681,6,6,1,2412,-54,-91,37,40:e3:d6:da:ba:26,68713929,380,-188,68713549,68713929
11682,4,1,1,2412,-56,-91,35,54:e4:3a:ec:fb:64,68753295,2160,37206,68751135,68753295
11683,4,1,1,2412,-90,-91,1,a6:e5:7c:28:b1:d3,68773908,944,19669,68772964,68773908
11684,4,1,1,2412,-90,-91,1,a6:e5:7c:28:b1:d3,68774977,944,125,68774033,68774977
11685,4,1,1,2412,-89,-91,2,a6:e5:7c:28:b1:d3,68776064,944,143,68775120,68776064
11686,4,1,1,2412,-89,-91,2,a6:e5:7c:28:b1:d3,68777151,944,143,68776207,68777151
11687,4,1,1,2412,-87,-91,4,a6:e5:7c:28:b1:d3,68778211,944,116,68777267,68778211
11688,4,1,1,2412,-90,-91,1,a6:e5:7c:28:b1:d3,68779316,944,161,68778372,68779316
11689,4,1,1,2412,-89,-91,2,a6:e5:7c:28:b1:d3,68780394,944,134,68779450,68780394
11690,4,1,1,2412,-88,-91,3,a6:e5:7c:28:b1:d3,68781508,944,170,68780564,68781508
11691,4,1,1,2412,-89,-91,2,a6:e5:7c:28:b1:d3,68782586,944,134,68781642,68782586
11692,4,1,1,2412,-91,-91,0,a6:e5:7c:28:b1:d3,68784733,944,1203,68783789,68784733
11693,4,1,1,2412,-76,-91,15,b8:3a:5a:88:e6:e0,68786023,2360,-1070,68783663,68786023
11694,4,1,1,2412,-77,-91,14,b8:3a:5a:88:e6:e1,68788467,2376,68,68786091,68788467
11695,6,12,1,2412,-55,-91,36,40:e3:d6:da:ba:20,68797115,160,8488,68796955,68797115
11696,6,6,1,2412,-55,-91,36,40:e3:d6:da:ba:21,68797316,368,-167,68796948,68797316
11697,6,12,1,2412,-55,-91,36,40:e3:d6:da:ba:22,68797746,180,250,68797566,68797746
11698,6,12,1,2412,-55,-91,36,40:e3:d6:da:ba:23,68797970,184,40,68797786,68797970
11699,6,12,1,2412,-55,-91,36,40:e3:d6:da:ba:24,68798197,176,51,68798021,68798197
11700,6,12,1,2412,-55,-91,36,40:e3:d6:da:ba:25,68798399,160,42,68798239,68798399
11701,6,6,1,2412,-55,-91,36,40:e3:d6:da:ba:26,68798600,380,-179,68798220,68798600
11702,4,1,1,2412,-90,-91,1,c0:c9:e3:4d:6e:bf,68813927,872,14455,68813055,68813927
11703,4,1,1,2412,-90,-91,1,,68814817,304,586,68814513,68814817
11704,4,1,1,2412,-76,-91,15,ca:60:75:31:bb:d4,68852520,992,36711,68851528,68852520
11705,4,1,1,2412,-55,-91,36,54:e4:3a:ec:fb:64,68853650,2112,-982,68851538,68853650
11706,6,12,1,2412,-55,-91,36,40:e3:d6:da:ba:22,68859907,156,6101,68859751,68859907
11707,6,12,1,2412,-75,-91,16,,68860081,32,142,68860049,68860081
11708,6,12,1,2412,-55,-91,36,40:e3:d6:da:ba:23,68860143,156,-94,68859987,68860143
11709,6,12,1,2412,-75,-91,16,,68860317,32,142,68860285,68860317
11710,6,12,1,2412,-55,-91,36,40:e3:d6:da:ba:25,68860397,136,-56,68860261,68860397
11711,6,12,1,2412,-75,-91,16,,68860551,32,122,68860519,68860551
11712,6,12,1,2412,-75,-91,16,,68860780,32,197,68860748,68860780
11713,6,12,1,2412,-75,-91,16,,68860968,32,156,68860936,68860968
11714,4,1,1,2412,-76,-91,15,ca:60:75:31:bb:d4,68874846,992,12886,68873854,68874846
11715,6,12,1,2412,-55,-91,36,40:e3:d6:da:ba:20,68875801,136,819,68875665,68875801
11716,6,12,1,2412,-75,-91,16,,68875955,32,122,68875923,68875955
11717,4,1,1,2412,-53,-91,38,b8:3a:5a:88:e6:e1,68878467,2256,256,68876211,68878467
11718,4,1,1,2412,-76,-91,15,,68880738,304,1967,68880434,68880738
11719,4,1,1,2412,-78,-91,13,54:e4:3a:ec:fb:64,68881116,2112,-1734,68879004,68881116
11720,4,1,1,2412,-78,-91,13,,68883243,304,1823,68882939,68883243
11721,6,6,1,2412,-80,-91,11,e6:aa:ea:b7:4a:dd,68886261,408,2610,68885853,68886261
11722,6,6,1,2412,-76,-91,15,e6:aa:ea:b7:4a:dd,68898393,408,11724,68897985,68898393
11723,6,12,1,2412,-55,-91,36,40:e3:d6:da:ba:20,68899524,160,971,68899364,68899524
11724,6,6,1,2412,-55,-91,36,40:e3:d6:da:ba:21,68899716,368,-176,68899348,68899716
11725,6,12,1,2412,-55,-91,36,40:e3:d6:da:ba:22,68900112,180,216,68899932,68900112
11726,6,12,1,2412,-55,-91,36,40:e3:d6:da:ba:23,68900336,184,40,68900152,68900336
11727,6,12,1,2412,-55,-91,36,40:e3:d6:da:ba:24,68900572,176,60,68900396,68900572
11728,6,12,1,2412,-55,-91,36,40:e3:d6:da:ba:25,68900774,160,42,68900614,68900774
11729,6,6,1,2412,-55,-91,36,40:e3:d6:da:ba:26,68900975,380,-179,68900595,68900975
11730,4,1,1,2412,-55,-91,36,ca:60:75:31:bb:d4,68903161,992,1194,68902169,68903161
11731,6,6,1,2412,-76,-91,15,e6:aa:ea:b7:4a:dd,68910515,408,6946,68910107,68910515
11732,6,6,1,2412,-75,-91,16,e6:aa:ea:b7:4a:dd,68922624,408,11701,68922216,68922624
11733,4,1,1,2412,-73,-91,18,ca:60:75:31:bb:d4,68925407,992,1791,68924415,68925407
11734,6,6,1,2412,-75,-91,16,e6:aa:ea:b7:4a:dd,68934746,408,8931,68934338,68934746
11735,4,1,1,2412,-77,-91,14,54:e4:3a:ec:fb:64,68957904,2160,20998,68955744,68957904
11736,4,1,1,2412,-76,-91,15,b8:3a:5a:88:e6:e0,68985783,2360,25519,68983423,68985783
11737,6,12,1,2412,-55,-91,36,40:e3:d6:da:ba:20,69001932,160,15989,69001772,69001932
11738,6,6,1,2412,-55,-91,36,40:e3:d6:da:ba:21,69002124,368,-176,69001756,69002124
11739,6,12,1,2412,-54,-91,37,40:e3:d6:da:ba:22,69002537,180,233,69002357,69002537
11740,6,12,1,2412,-55,-91,36,40:e3:d6:da:ba:23,69002978,184,257,69002794,69002978
11741,6,12,1,2412,-55,-91,36,40:e3:d6:da:ba:24,69003187,176,33,69003011,69003187
11742,6,12,1,2412,-55,-91,36,40:e3:d6:da:ba:25,69003398,160,51,69003238,69003398
11743,6,6,1,2412,-54,-91,37,40:e3:d6:da:ba:26,69003607,380,-171,69003227,69003607
11744,6,6,1,2412,-68,-91,23,e6:aa:ea:c9:ea:33,69026322,408,22307,69025914,69026322
11745,6,6,1,2412,-67,-91,24,e6:aa:ea:c9:ea:33,69038377,408,11647,69037969,69038377
11746,4,1,1,2412,-77,-91,14,54:e4:3a:ec:fb:64,69060491,2160,19954,69058331,69060491
11747,4,1,1,2412,-76,-91,15,b8:3a:5a:88:e6:e0,69088168,2360,25317,69085808,69088168
11748,6,12,1,2412,-55,-91,36,40:e3:d6:da:ba:20,69104311,160,15983,69104151,69104311
11749,6,6,1,2412,-54,-91,37,40:e3:d6:da:ba:21,69104521,368,-158,69104153,69104521
11750,6,12,1,2412,-54,-91,37,40:e3:d6:da:ba:22,69104935,180,234,69104755,69104935
11751,6,12,1,2412,-54,-91,37,40:e3:d6:da:ba:23,69105150,184,31,69104966,69105150
11752,6,12,1,2412,-54,-91,37,40:e3:d6:da:ba:24,69105359,176,33,69105183,69105359
11753,6,12,1,2412,-54,-91,37,40:e3:d6:da:ba:25,69105570,160,51,69105410,69105570
11754,6,6,1,2412,-54,-91,37,40:e3:d6:da:ba:26,69105780,380,-170,69105400,69105780
11755,4,1,1,2412,-89,-91,2,a6:e5:7c:28:b1:d3,69150514,992,43742,69149522,69150514
11756,4,1,1,2412,-76,-91,15,b8:3a:5a:88:e6:e0,69190579,2360,37705,69188219,69190579
11757,4,1,1,2412,-75,-91,16,b8:3a:5a:88:e6:e1,69192968,2376,13,69190592,69192968
11758,6,12,1,2412,-54,-91,37,40:e3:d6:da:ba:20,69206731,160,13603,69206571,69206731
11759,6,6,1,2412,-54,-91,37,40:e3:d6:da:ba:21,69206941,368,-158,69206573,69206941
11760,6,12,1,2412,-54,-91,37,40:e3:d6:da:ba:22,69207346,180,225,69207166,69207346
11761,6,12,1,2412,-54,-91,37,40:e3:d6:da:ba:23,69207552,184,22,69207368,69207552
11762,6,12,1,2412,-54,-91,37,40:e3:d6:da:ba:24,69207770,176,42,69207594,69207770
11763,6,12,1,2412,-54,-91,37,40:e3:d6:da:ba:25,69207990,160,60,69207830,69207990
11764,6,6,1,2412,-54,-91,37,40:e3:d6:da:ba:26,69208209,380,-161,69207829,69208209
11765,4,1,1,2412,-76,-91,15,b8:3a:5a:88:e6:e0,69219598,2240,9149,69217358,69219598
11766,4,1,1,2412,-92,-91,-1,a6:e5:7c:28:b1:d3,69252708,992,32118,69251716,69252708
11767,4,1,1,2412,-77,-91,14,b8:3a:5a:88:e6:e0,69271092,2240,16144,69268852,69271092
11768,4,1,1,2412,-77,-91,14,b8:3a:5a:88:e6:e1,69273378,2256,30,69271122,69273378
11769,4,1,1,2412,-88,-91,3,,69292680,304,18998,69292376,69292680
11770,4,1,1,2412,-77,-91,14,b8:3a:5a:88:e6:e1,69297165,2376,2109,69294789,69297165
11771,4,1,1,2412,-76,-91,15,b8:3a:5a:88:e6:e0,69299570,2240,165,69297330,69299570
11772,4,1,1,2412,-77,-91,14,b8:3a:5a:88:e6:e1,69303382,2256,1556,69301126,69303382
11773,6,12,1,2412,-54,-91,37,40:e3:d6:da:ba:20,69309115,160,5573,69308955,69309115
11774,6,12,1,2412,-53,-91,38,40:e3:d6:da:ba:22,69309817,180,522,69309637,69309817
11775,6,12,1,2412,-53,-91,38,40:e3:d6:da:ba:23,69310023,184,22,69309839,69310023
11776,6,12,1,2412,-53,-91,38,40:e3:d6:da:ba:24,69310241,176,42,69310065,69310241
11777,6,12,1,2412,-53,-91,38,40:e3:d6:da:ba:25,69310461,160,60,69310301,69310461
11778,6,6,1,2412,-53,-91,38,40:e3:d6:da:ba:26,69310680,380,-161,69310300,69310680
11779,4,1,1,2412,-78,-91,13,54:e4:3a:ec:fb:64,69370029,2160,57189,69367869,69370029
11780,6,6,1,2412,-73,-91,18,e6:aa:ea:b7:4a:dd,69405984,408,35547,69405576,69405984
11781,6,12,1,2412,-54,-91,37,40:e3:d6:da:ba:20,69411511,160,5367,69411351,69411511
11782,6,6,1,2412,-54,-91,37,40:e3:d6:da:ba:21,69411721,368,-158,69411353,69411721
11783,6,12,1,2412,-54,-91,37,40:e3:d6:da:ba:23,69412461,184,556,69412277,69412461
11784,6,12,1,2412,-54,-91,37,40:e3:d6:da:ba:24,69412688,176,51,69412512,69412688
11785,6,6,1,2412,-54,-91,37,40:e3:d6:da:ba:26,69413082,380,14,69412702,69413082
11786,6,6,1,2412,-73,-91,18,e6:aa:ea:b7:4a:dd,69418110,408,4620,69417702,69418110
11787,6,6,1,2412,-78,-91,13,e6:aa:ea:b7:4a:dd,69430219,408,11701,69429811,69430219
11788,6,6,1,2412,-72,-91,19,e6:aa:ea:b7:4a:dd,69442336,408,11709,69441928,69442336
11789,6,6,1,2412,-72,-91,19,e6:aa:ea:b7:4a:dd,69454456,408,11712,69454048,69454456
11790,4,1,1,2412,-79,-91,12,b8:3a:5a:88:e6:e0,69497885,2360,41069,69495525,69497885
11791,4,1,1,2412,-76,-91,15,b8:3a:5a:88:e6:e1,69500274,2376,13,69497898,69500274
11792,4,5.5,1,2412,-92,-91,-1,,69510701,213,10214,69510488,69510701
11793,6,12,1,2412,-54,-91,37,40:e3:d6:da:ba:20,69513910,160,3049,69513750,69513910
11794,6,6,1,2412,-54,-91,37,40:e3:d6:da:ba:21,69514120,368,-158,69513752,69514120
11795,6,12,1,2412,-54,-91,37,40:e3:d6:da:ba:22,69514525,180,225,69514345,69514525
11796,6,12,1,2412,-54,-91,37,40:e3:d6:da:ba:23,69514730,184,21,69514546,69514730
11797,6,12,1,2412,-54,-91,37,40:e3:d6:da:ba:24,69514949,176,43,69514773,69514949
11798,6,12,1,2412,-54,-91,37,40:e3:d6:da:ba:25,69515150,160,41,69514990,69515150
11799,6,6,1,2412,-54,-91,37,40:e3:d6:da:ba:26,69515342,380,-188,69514962,69515342
11800,6,6,1,2412,-66,-91,25,e6:aa:ea:c9:ea:33,69521890,408,6140,69521482,69521890
11801,6,6,1,2412,-65,-91,26,e6:aa:ea:c9:ea:33,69533999,408,11701,69533591,69533999
11802,6,6,1,2412,-65,-91,26,e6:aa:ea:c9:ea:33,69546125,408,11718,69545717,69546125
11803,4,1,1,2412,-78,-91,13,54:e4:3a:ec:fb:64,69552744,2160,4459,69550584,69552744
11804,6,6,1,2412,-65,-91,26,e6:aa:ea:c9:ea:33,69558272,408,5120,69557864,69558272
11805,6,6,1,2412,-65,-91,26,e6:aa:ea:c9:ea:33,69570409,408,11729,69570001,69570409
11806,4,1,1,2412,-77,-91,14,54:e4:3a:ec:fb:64,69572298,2160,-271,69570138,69572298
11807,4,1,1,2412,-78,-91,13,b8:3a:5a:88:e6:e0,69600169,2360,25511,69597809,69600169
11808,4,1,1,2412,-76,-91,15,b8:3a:5a:88:e6:e1,69602549,2376,4,69600173,69602549
11809,6,12,1,2412,-54,-91,37,40:e3:d6:da:ba:20,69616323,160,13614,69616163,69616323
11810,6,6,1,2412,-54,-91,37,40:e3:d6:da:ba:21,69616515,368,-176,69616147,69616515
11811,6,12,1,2412,-54,-91,37,40:e3:d6:da:ba:22,69616920,180,225,69616740,69616920
11812,6,12,1,2412,-54,-91,37,40:e3:d6:da:ba:23,69617126,184,22,69616942,69617126
11813,6,12,1,2412,-54,-91,37,40:e3:d6:da:ba:24,69617362,176,60,69617186,69617362
11814,6,12,1,2412,-54,-91,37,40:e3:d6:da:ba:25,69617582,160,60,69617422,69617582
11815,6,6,1,2412,-54,-91,37,40:e3:d6:da:ba:26,69617801,380,-161,69617421,69617801
11816,4,1,1,2412,-86,-91,5,a6:e5:7c:28:b1:d3,69662101,992,43308,69661109,69662101
11817,4,1,1,2412,-79,-91,12,54:e4:3a:ec:fb:64,69674696,2160,10435,69672536,69674696
11818,4,1,1,2412,-79,-91,12,b8:3a:5a:88:e6:e1,69704958,2376,27886,69702582,69704958
11819,6,6,1,2412,-54,-91,37,40:e3:d6:da:ba:21,69718922,368,13596,69718554,69718922
11820,6,6,1,2412,-58,-91,33,40:e3:d6:da:ba:26,69720212,380,910,69719832,69720212
11821,4,1,1,2412,-81,-91,10,,69754342,304,33826,69754038,69754342
11822,4,1,1,2412,-78,-91,13,54:e4:3a:ec:fb:64,69777095,2160,20593,69774935,69777095
11823,4,1,1,2412,-79,-91,12,b8:3a:5a:88:e6:e0,69804973,2360,25518,69802613,69804973
11824,4,1,1,2412,-79,-91,12,b8:3a:5a:88:e6:e1,69807353,2376,4,69804977,69807353
11825,6,12,1,2412,-54,-91,37,40:e3:d6:da:ba:22,69821705,180,14172,69821525,69821705
11826,6,12,1,2412,-54,-91,37,40:e3:d6:da:ba:25,69822358,160,493,69822198,69822358
11827,4,1,1,2412,-78,-91,13,54:e4:3a:ec:fb:64,69879495,2160,54977,69877335,69879495
11828,4,1,1,2412,-78,-91,13,b8:3a:5a:88:e6:e0,69907639,2360,25784,69905279,69907639
11829,4,1,1,2412,-78,-91,13,b8:3a:5a:88:e6:e1,69910045,2376,30,69907669,69910045
11830,6,12,1,2412,-54,-91,37,40:e3:d6:da:ba:20,69923513,160,13308,69923353,69923513
11831,6,6,1,2412,-54,-91,37,40:e3:d6:da:ba:21,69923731,368,-150,69923363,69923731
11832,6,12,1,2412,-54,-91,37,40:e3:d6:da:ba:22,69924145,180,234,69923965,69924145
11833,6,12,1,2412,-53,-91,38,40:e3:d6:da:ba:23,69924351,184,22,69924167,69924351
11834,6,12,1,2412,-53,-91,38,40:e3:d6:da:ba:24,69924560,176,33,69924384,69924560
11835,6,12,1,2412,-53,-91,38,40:e3:d6:da:ba:25,69924762,160,42,69924602,69924762
11836,6,6,1,2412,-53,-91,38,40:e3:d6:da:ba:26,69924981,380,-161,69924601,69924981
11837,6,6,1,2412,-68,-91,23,e6:aa:ea:b7:4a:dd,69925441,408,52,69925033,69925441
11838,6,6,1,2412,-68,-91,23,e6:aa:ea:b7:4a:dd,69937570,408,11721,69937162,69937570
11839,6,6,1,2412,-68,-91,23,e6:aa:ea:b7:4a:dd,69949688,408,11710,69949280,69949688
11840,6,6,1,2412,-69,-91,22,e6:aa:ea:b7:4a:dd,69961801,408,11705,69961393,69961801
11841,4,1,1,2412,-68,-91,23,22:a3:7f:87:e5:4e,69969051,1480,5770,69967571,69969051
11842,6,12,1,2412,-58,-91,33,40:e3:d6:da:ba:23,69970511,156,1304,69970355,69970511
11843,6,12,1,2412,-64,-91,27,,69970683,32,140,69970651,69970683
11844,6,6,1,2412,-69,-91,22,e6:aa:ea:b7:4a:dd,69973922,408,2831,69973514,69973922
11845,4,1,1,2412,-76,-91,15,54:e4:3a:ec:fb:64,69981898,2160,5816,69979738,69981898
11846,6,12,1,2412,-78,-91,13,40:e3:d6:da:bb:60,69985754,960,2896,69984794,69985754
11847,4,1,1,2412,-68,-91,23,22:a3:7f:87:e5:4e,69989281,1480,2047,69987801,69989281
11848,6,12,1,2412,-55,-91,36,40:e3:d6:da:ba:23,69990744,156,1307,69990588,69990744
11849,6,12,1,2412,-65,-91,26,,69990916,32,140,69990884,69990916
11850,4,1,1,2412,-80,-91,11,b8:3a:5a:88:e6:e0,70009769,2360,16493,70007409,70009769
11851,4,1,1,2412,-80,-91,11,b8:3a:5a:88:e6:e1,70012261,2376,116,70009885,70012261
11852,6,12,1,2412,-55,-91,36,40:e3:d6:da:ba:20,70025913,160,13492,70025753,70025913
11853,6,6,1,2412,-55,-91,36,40:e3:d6:da:ba:21,70026114,368,-167,70025746,70026114
11854,6,12,1,2412,-55,-91,36,40:e3:d6:da:ba:22,70026519,180,225,70026339,70026519
11855,6,12,1,2412,-55,-91,36,40:e3:d6:da:ba:23,70026743,184,40,70026559,70026743
11856,6,12,1,2412,-55,-91,36,40:e3:d6:da:ba:24,70026979,176,60,70026803,70026979
11857,6,12,1,2412,-55,-91,36,40:e3:d6:da:ba:25,70027181,160,42,70027021,70027181
11858,6,6,1,2412,-55,-91,36,40:e3:d6:da:ba:26,70027382,380,-179,70027002,70027382
11859,6,6,1,2412,-67,-91,24,e6:aa:ea:c9:ea:33,70041557,408,13767,70041149,70041557
11860,6,6,1,2412,-66,-91,25,e6:aa:ea:c9:ea:33,70053676,408,11711,70053268,70053676
11861,6,6,1,2412,-66,-91,25,e6:aa:ea:c9:ea:33,70065794,408,11710,70065386,70065794
11862,6,6,1,2412,-67,-91,24,e6:aa:ea:c9:ea:33,70077929,408,11727,70077521,70077929
11863,6,6,1,2412,-66,-91,25,e6:aa:ea:c9:ea:33,70090184,408,11847,70089776,70090184
11864,4,1,1,2412,-83,-91,8,b8:3a:5a:88:e6:e0,70112170,2360,19626,70109810,70112170
11865,4,1,1,2412,-83,-91,8,b8:3a:5a:88:e6:e1,70114559,2376,13,70112183,70114559
11866,6,12,1,2412,-56,-91,35,40:e3:d6:da:ba:20,70128334,160,13615,70128174,70128334
11867,6,6,1,2412,-56,-91,35,40:e3:d6:da:ba:21,70128544,368,-158,70128176,70128544
11868,6,12,1,2412,-55,-91,36,40:e3:d6:da:ba:22,70128958,180,234,70128778,70128958
11869,6,12,1,2412,-55,-91,36,40:e3:d6:da:ba:23,70129163,184,21,70128979,70129163
11870,6,12,1,2412,-55,-91,36,40:e3:d6:da:ba:24,70129391,176,52,70129215,70129391
11871,6,12,1,2412,-55,-91,36,40:e3:d6:da:ba:25,70129601,160,50,70129441,70129601
11872,6,6,1,2412,-55,-91,36,40:e3:d6:da:ba:26,70129820,380,-161,70129440,70129820
11873,4,1,1,2412,-82,-91,9,54:e4:3a:ec:fb:64,70186883,2160,54903,70184723,70186883
11874,6,12,1,2412,-55,-91,36,40:e3:d6:da:ba:20,70230718,160,43675,70230558,70230718
11875,6,6,1,2412,-55,-91,36,40:e3:d6:da:ba:21,70230928,368,-158,70230560,70230928
11876,6,12,1,2412,-55,-91,36,40:e3:d6:da:ba:22,70231333,180,225,70231153,70231333
11877,6,12,1,2412,-55,-91,36,40:e3:d6:da:ba:25,70231949,160,456,70231789,70231949
11878,6,6,1,2412,-55,-91,36,40:e3:d6:da:ba:26,70232168,380,-161,70231788,70232168
11879,4,1,1,2412,-89,-91,2,c0:c9:e3:4d:6e:bf,70243480,872,10440,70242608,70243480
11880,4,1,1,2412,-93,-91,-2,,70244369,304,585,70244065,70244369
11881,6,6,1,2412,-76,-91,15,e6:aa:ea:b7:4a:dd,70253032,408,8255,70252624,70253032
11882,6,6,1,2412,-72,-91,19,e6:aa:ea:b7:4a:dd,70277275,408,23835,70276867,70277275
11883,4,1,1,2412,-80,-91,11,54:e4:3a:ec:fb:64,70289112,2160,9677,70286952,70289112
11884,4,1,1,2412,-74,-91,17,b8:3a:5a:88:e6:e1,70319368,2376,27880,70316992,70319368
11885,6,12,1,2412,-56,-91,35,40:e3:d6:da:ba:20,70333181,160,13653,70333021,70333181
11886,6,6,1,2412,-56,-91,35,40:e3:d6:da:ba:21,70333400,368,-149,70333032,70333400
11887,6,6,1,2412,-69,-91,22,e6:aa:ea:c9:ea:33,70360250,408,26442,70359842,70360250
11888,6,6,1,2412,-69,-91,22,e6:aa:ea:c9:ea:33,70372377,408,11719,70371969,70372377
11889,6,6,1,2412,-68,-91,23,e6:aa:ea:c9:ea:33,70384483,408,11698,70384075,70384483
11890,4,1,1,2412,-77,-91,14,54:e4:3a:ec:fb:64,70391534,2160,4891,70389374,70391534
11891,6,6,1,2412,-68,-91,23,e6:aa:ea:c9:ea:33,70396610,408,4668,70396202,70396610
11892,4,1,1,2412,-77,-91,14,b8:3a:5a:88:e6:e0,70419395,2360,20425,70417035,70419395
11893,4,1,1,2412,-77,-91,14,b8:3a:5a:88:e6:e1,70422085,2376,314,70419709,70422085
11894,6,12,1,2412,-56,-91,35,40:e3:d6:da:ba:20,70435525,160,13280,70435365,70435525
11895,6,6,1,2412,-56,-91,35,40:e3:d6:da:ba:21,70435717,368,-176,70435349,70435717
11896,6,12,1,2412,-56,-91,35,40:e3:d6:da:ba:22,70436113,180,216,70435933,70436113
11897,6,12,1,2412,-56,-91,35,40:e3:d6:da:ba:23,70436336,184,39,70436152,70436336
11898,6,12,1,2412,-56,-91,35,40:e3:d6:da:ba:24,70436651,176,139,70436475,70436651
11899,6,12,1,2412,-56,-91,35,40:e3:d6:da:ba:25,70436879,160,68,70436719,70436879
11900,6,6,1,2412,-56,-91,35,40:e3:d6:da:ba:26,70437071,380,-188,70436691,70437071
11901,4,1,1,2412,-93,-91,-2,,70441737,304,4362,70441433,70441737
11902,4,1,1,2412,-81,-91,10,b8:3a:5a:88:e6:e0,70521794,2360,77697,70519434,70521794
11903,4,1,1,2412,-81,-91,10,b8:3a:5a:88:e6:e1,70524192,2376,22,70521816,70524192
11904,6,12,1,2412,-57,-91,34,40:e3:d6:da:ba:20,70537915,160,13563,70537755,70537915
11905,6,6,1,2412,-57,-91,34,40:e3:d6:da:ba:21,70538107,368,-176,70537739,70538107
11906,6,12,1,2412,-57,-91,34,40:e3:d6:da:ba:22,70538512,180,225,70538332,70538512
11907,6,12,1,2412,-57,-91,34,40:e3:d6:da:ba:23,70538736,184,40,70538552,70538736
11908,6,12,1,2412,-57,-91,34,40:e3:d6:da:ba:25,70539208,160,312,70539048,70539208
11909,6,6,1,2412,-57,-91,34,40:e3:d6:da:ba:26,70539409,380,-179,70539029,70539409
11910,4,1,1,2412,-85,-91,6,a4:e5:7c:28:b1:d3,70550649,688,10552,70549961,70550649
11911,4,1,1,2412,-83,-91,8,a6:e5:7c:28:b1:d3,70584135,992,32494,70583143,70584135
11912,4,1,1,2412,-80,-91,11,54:e4:3a:ec:fb:64,70596320,2160,10025,70594160,70596320
11913,6,12,1,2412,-56,-91,35,40:e3:d6:da:ba:20,70640338,160,43858,70640178,70640338
11914,6,6,1,2412,-56,-91,35,40:e3:d6:da:ba:21,70640530,368,-176,70640162,70640530
11915,6,12,1,2412,-56,-91,35,40:e3:d6:da:ba:22,70640944,180,234,70640764,70640944
11916,6,12,1,2412,-56,-91,35,40:e3:d6:da:ba:23,70641167,184,39,70640983,70641167
11917,6,12,1,2412,-56,-91,35,40:e3:d6:da:ba:24,70641386,176,43,70641210,70641386
11918,6,12,1,2412,-56,-91,35,40:e3:d6:da:ba:25,70641596,160,50,70641436,70641596
11919,6,6,1,2412,-56,-91,35,40:e3:d6:da:ba:26,70641788,380,-188,70641408,70641788
11920,6,6,1,2412,-75,-91,16,e6:aa:ea:b7:4a:dd,70659731,408,17535,70659323,70659731
11921,6,6,1,2412,-75,-91,16,e6:aa:ea:b7:4a:dd,70671863,408,11724,70671455,70671863
11922,6,6,1,2412,-74,-91,17,e6:aa:ea:b7:4a:dd,70683969,408,11698,70683561,70683969
11923,6,6,1,2412,-74,-91,17,e6:aa:ea:b7:4a:dd,70696085,408,11708,70695677,70696085
11924,6,6,1,2412,-74,-91,17,e6:aa:ea:b7:4a:dd,70708203,408,11710,70707795,70708203
11925,4,1,1,2412,-76,-91,15,54:e4:3a:ec:fb:64,70720317,2112,10002,70718205,70720317
11926,4,1,1,2412,-73,-91,18,b8:3a:5a:88:e6:e0,70726718,2360,4041,70724358,70726718
11927,4,1,1,2412,-75,-91,16,b8:3a:5a:88:e6:e1,70729133,2376,39,70726757,70729133
11928,6,12,1,2412,-55,-91,36,40:e3:d6:da:ba:22,70743704,180,14391,70743524,70743704
11929,6,12,1,2412,-55,-91,36,40:e3:d6:da:ba:23,70743928,184,40,70743744,70743928
11930,6,12,1,2412,-55,-91,36,40:e3:d6:da:ba:24,70744164,176,60,70743988,70744164
11931,6,12,1,2412,-55,-91,36,40:e3:d6:da:ba:25,70744365,160,41,70744205,70744365
11932,6,6,1,2412,-55,-91,36,40:e3:d6:da:ba:26,70744584,380,-161,70744204,70744584
11933,4,1,1,2412,-53,-91,38,54:e4:3a:ec:fb:64,70801085,2160,54341,70798925,70801085
11934,4,1,1,2412,-76,-91,15,b8:3a:5a:88:e6:e0,70829222,2360,25777,70826862,70829222
11935,4,1,1,2412,-78,-91,13,b8:3a:5a:88:e6:e1,70831602,2376,4,70829226,70831602
11936,6,12,1,2412,-56,-91,35,40:e3:d6:da:ba:20,70845132,160,13370,70844972,70845132
11937,6,6,1,2412,-56,-91,35,40:e3:d6:da:ba:21,70845333,368,-167,70844965,70845333
11938,6,12,1,2412,-55,-91,36,40:e3:d6:da:ba:22,70845720,180,207,70845540,70845720
11939,6,12,1,2412,-55,-91,36,40:e3:d6:da:ba:23,70845952,184,48,70845768,70845952
11940,6,12,1,2412,-55,-91,36,40:e3:d6:da:ba:24,70846189,176,61,70846013,70846189
11941,6,12,1,2412,-55,-91,36,40:e3:d6:da:ba:25,70846390,160,41,70846230,70846390
11942,6,6,1,2412,-55,-91,36,40:e3:d6:da:ba:26,70846609,380,-161,70846229,70846609
11943,6,6,1,2412,-68,-91,23,e6:aa:ea:c9:ea:33,70880681,408,33664,70880273,70880681
11944,4,1,1,2412,-82,-91,9,a6:e5:7c:28:b1:d3,70890422,992,8749,70889430,70890422
11945,6,6,1,2412,-68,-91,23,e6:aa:ea:c9:ea:33,70892804,408,1974,70892396,70892804
11946,6,6,1,2412,-69,-91,22,e6:aa:ea:c9:ea:33,70929158,408,35946,70928750,70929158
11947,6,12,1,2412,-56,-91,35,40:e3:d6:da:ba:20,70947518,160,18200,70947358,70947518
11948,6,6,1,2412,-56,-91,35,40:e3:d6:da:ba:21,70947719,368,-167,70947351,70947719
11949,6,12,1,2412,-56,-91,35,40:e3:d6:da:ba:22,70948106,180,207,70947926,70948106
11950,6,12,1,2412,-56,-91,35,40:e3:d6:da:ba:23,70948338,184,48,70948154,70948338
11951,6,12,1,2412,-57,-91,34,40:e3:d6:da:ba:24,70948565,176,51,70948389,70948565
11952,6,12,1,2412,-56,-91,35,40:e3:d6:da:ba:25,70948785,160,60,70948625,70948785
11953,6,6,1,2412,-56,-91,35,40:e3:d6:da:ba:26,70948986,380,-179,70948606,70948986
11954,6,6,1,2412,-84,-91,7,e6:aa:ea:b7:4a:dd,70975071,408,25677,70974663,70975071
11955,6,6,1,2412,-84,-91,7,e6:aa:ea:b7:4a:dd,70987183,408,11704,70986775,70987183
11956,4,1,1,2412,-89,-91,2,a6:e5:7c:28:b1:d3,70993630,992,5455,70992638,70993630
11957,6,6,1,2412,-85,-91,6,e6:aa:ea:b7:4a:dd,70999304,408,5266,70998896,70999304
11958,4,1,1,2412,-77,-91,14,54:e4:3a:ec:fb:64,71005890,2160,4426,71003730,71005890
11959,6,12,1,2412,-83,-91,8,40:e3:d6:da:bb:60,71009890,960,3040,71008930,71009890
11960,6,6,1,2412,-75,-91,16,e6:aa:ea:b7:4a:dd,71011422,408,1124,71011014,71011422
11961,6,12,1,2412,-53,-91,38,40:e3:d6:da:ba:20,71026089,136,14531,71025953,71026089
11962,6,6,1,2412,-53,-91,38,40:e3:d6:da:ba:21,71026266,348,-171,71025918,71026266
11963,6,12,1,2412,-53,-91,38,40:e3:d6:da:ba:22,71026651,156,229,71026495,71026651
11964,6,12,1,2412,-53,-91,38,40:e3:d6:da:ba:23,71026869,156,62,71026713,71026869
11965,6,12,1,2412,-57,-91,34,40:e3:d6:da:ba:25,71027068,136,63,71026932,71027068
11966,4,1,1,2412,-79,-91,12,b8:3a:5a:88:e6:e0,71033785,2360,4357,71031425,71033785
11967,4,1,1,2412,-77,-91,14,b8:3a:5a:88:e6:e1,71036173,2376,12,71033797,71036173
11968,6,12,1,2412,-57,-91,34,40:e3:d6:da:ba:20,71049928,160,13595,71049768,71049928
11969,6,6,1,2412,-57,-91,34,40:e3:d6:da:ba:21,71050138,368,-158,71049770,71050138
11970,6,12,1,2412,-57,-91,34,40:e3:d6:da:ba:22,71050525,180,207,71050345,71050525
11971,6,12,1,2412,-57,-91,34,40:e3:d6:da:ba:23,71050740,184,31,71050556,71050740
11972,6,12,1,2412,-57,-91,34,40:e3:d6:da:ba:24,71050949,176,33,71050773,71050949
11973,6,12,1,2412,-57,-91,34,40:e3:d6:da:ba:25,71051159,160,50,71050999,71051159
11974,6,6,1,2412,-58,-91,33,40:e3:d6:da:ba:26,71051369,380,-170,71050989,71051369
11975,4,1,1,2412,-86,-91,5,a6:e5:7c:28:b1:d3,71095823,992,43462,71094831,71095823
11976,4,1,1,2412,-72,-91,19,54:e4:3a:ec:fb:64,71108289,2160,10306,71106129,71108289
11977,6,6,1,2412,-81,-91,10,84:1b:5e:df:1b:99,71135715,80,27346,71135635,71135715
11978,4,1,1,2412,-78,-91,13,b8:3a:5a:88:e6:e0,71136172,2360,-1903,71133812,71136172
11979,6,12,1,2412,-58,-91,33,40:e3:d6:da:ba:20,71152332,160,16000,71152172,71152332
11980,6,6,1,2412,-58,-91,33,40:e3:d6:da:ba:21,71152542,368,-158,71152174,71152542
11981,6,12,1,2412,-58,-91,33,40:e3:d6:da:ba:22,71152956,180,234,71152776,71152956
11982,6,12,1,2412,-58,-91,33,40:e3:d6:da:ba:23,71153180,184,40,71152996,71153180
11983,6,12,1,2412,-58,-91,33,40:e3:d6:da:ba:24,71153416,176,60,71153240,71153416
11984,6,12,1,2412,-58,-91,33,40:e3:d6:da:ba:25,71153635,160,59,71153475,71153635
11985,6,6,1,2412,-58,-91,33,40:e3:d6:da:ba:26,71153845,380,-170,71153465,71153845
11986,4,1,1,2412,-84,-91,7,c0:c9:e3:4d:6e:bf,71220509,872,65792,71219637,71220509
11987,4,1,1,2412,-80,-91,11,b8:3a:5a:88:e6:e0,71238584,2360,15715,71236224,71238584
11988,4,1,1,2412,-81,-91,10,b8:3a:5a:88:e6:e1,71240991,2376,31,71238615,71240991
11989,6,12,1,2412,-60,-91,31,40:e3:d6:da:ba:20,71254725,160,13574,71254565,71254725
11990,6,6,1,2412,-60,-91,31,40:e3:d6:da:ba:21,71254944,368,-149,71254576,71254944
11991,6,12,1,2412,-60,-91,31,40:e3:d6:da:ba:22,71255358,180,234,71255178,71255358
11992,6,12,1,2412,-60,-91,31,40:e3:d6:da:ba:23,71255582,184,40,71255398,71255582
11993,6,12,1,2412,-60,-91,31,40:e3:d6:da:ba:24,71255791,176,33,71255615,71255791
11994,6,12,1,2412,-59,-91,32,40:e3:d6:da:ba:25,71255993,160,42,71255833,71255993
11995,6,6,1,2412,-59,-91,32,40:e3:d6:da:ba:26,71256203,380,-170,71255823,71256203
11996,4,1,1,2412,-87,-91,4,,71266687,304,10180,71266383,71266687
11997,4,1,1,2412,-79,-91,12,54:e4:3a:ec:fb:64,71313129,2160,44282,71310969,71313129
11998,4,1,1,2412,-82,-91,9,b8:3a:5a:88:e6:e0,71340981,2360,25492,71338621,71340981
11999,4,1,1,2412,-81,-91,10,b8:3a:5a:88:e6:e1,71343370,2376,13,71340994,71343370
12000,6,12,1,2412,-60,-91,31,40:e3:d6:da:ba:20,71357141,160,13611,71356981,71357141
12001,6,6,1,2412,-60,-91,31,40:e3:d6:da:ba:21,71357342,368,-167,71356974,71357342
12002,6,12,1,2412,-60,-91,31,40:e3:d6:da:ba:22,71357738,180,216,71357558,71357738
12003,6,12,1,2412,-60,-91,31,40:e3:d6:da:ba:23,71357961,184,39,71357777,71357961
12004,6,12,1,2412,-60,-91,31,40:e3:d6:da:ba:24,71358189,176,52,71358013,71358189
12005,6,12,1,2412,-60,-91,31,40:e3:d6:da:ba:25,71358390,160,41,71358230,71358390
12006,6,6,1,2412,-60,-91,31,40:e3:d6:da:ba:26,71358609,380,-161,71358229,71358609
12007,6,6,1,2412,-64,-91,27,e6:aa:ea:c9:ea:33,71401095,408,42078,71400687,71401095
12008,6,6,1,2412,-64,-91,27,e6:aa:ea:c9:ea:33,71413214,408,11711,71412806,71413214
12009,4,1,1,2412,-81,-91,10,54:e4:3a:ec:fb:64,71415535,2160,161,71413375,71415535
12010,6,6,1,2412,-63,-91,28,e6:aa:ea:c9:ea:33,71425332,408,9389,71424924,71425332
12011,6,6,1,2412,-63,-91,28,e6:aa:ea:c9:ea:33,71437462,408,11722,71437054,71437462
12012,6,6,1,2412,-64,-91,27,e6:aa:ea:c9:ea:33,71449629,408,11759,71449221,71449629
12013,6,12,1,2412,-60,-91,31,40:e3:d6:da:ba:20,71459520,160,9731,71459360,71459520
12014,6,6,1,2412,-60,-91,31,40:e3:d6:da:ba:21,71459712,368,-176,71459344,71459712
12015,6,12,1,2412,-60,-91,31,40:e3:d6:da:ba:22,71460108,180,216,71459928,71460108
12016,6,12,1,2412,-60,-91,31,40:e3:d6:da:ba:23,71460340,184,48,71460156,71460340
12017,6,12,1,2412,-60,-91,31,40:e3:d6:da:ba:24,71460550,176,34,71460374,71460550
12018,6,12,1,2412,-60,-91,31,40:e3:d6:da:ba:25,71460769,160,59,71460609,71460769
12019,6,6,1,2412,-60,-91,31,40:e3:d6:da:ba:26,71460961,380,-188,71460581,71460961
12020,6,6,1,2412,-78,-91,13,e6:aa:ea:b7:4a:dd,71519192,408,57823,71518784,71519192
12021,6,6,1,2412,-76,-91,15,e6:aa:ea:b7:4a:dd,71543474,408,23874,71543066,71543474
12022,4,1,1,2412,-81,-91,10,b8:3a:5a:88:e6:e0,71545773,2360,-61,71543413,71545773
12023,6,12,1,2412,-60,-91,31,40:e3:d6:da:ba:20,71561930,160,15997,71561770,71561930
12024,6,12,1,2412,-60,-91,31,40:e3:d6:da:ba:22,71562545,180,435,71562365,71562545
12025,6,12,1,2412,-60,-91,31,40:e3:d6:da:ba:23,71562777,184,48,71562593,71562777
12026,6,12,1,2412,-60,-91,31,40:e3:d6:da:ba:24,71563005,176,52,71562829,71563005
12027,6,12,1,2412,-60,-91,31,40:e3:d6:da:ba:25,71563224,160,59,71563064,71563224
12028,6,6,1,2412,-60,-91,31,40:e3:d6:da:ba:26,71563434,380,-170,71563054,71563434
12029,4,1,1,2412,-83,-91,8,54:e4:3a:ec:fb:64,71599092,2112,33546,71596980,71599092
12030,4,1,1,2412,-84,-91,7,54:e4:3a:ec:fb:64,71602320,2112,1116,71600208,71602320
12031,4,1,1,2412,-81,-91,10,54:e4:3a:ec:fb:64,71620337,2160,15857,71618177,71620337
12032,4,1,1,2412,-41,-91,50,b8:3a:5a:88:e6:e0,71648790,2360,26093,71646430,71648790
12033,4,1,1,2412,-82,-91,9,b8:3a:5a:88:e6:e1,71651232,2376,66,71648856,71651232
12034,6,12,1,2412,-61,-91,30,40:e3:d6:da:ba:20,71664337,160,12945,71664177,71664337
12035,6,6,1,2412,-61,-91,30,40:e3:d6:da:ba:21,71664556,368,-149,71664188,71664556
12036,6,12,1,2412,-60,-91,31,40:e3:d6:da:ba:22,71664943,180,207,71664763,71664943
12037,6,12,1,2412,-61,-91,30,40:e3:d6:da:ba:23,71665158,184,31,71664974,71665158
12038,6,12,1,2412,-61,-91,30,40:e3:d6:da:ba:24,71665394,176,60,71665218,71665394
12039,6,12,1,2412,-61,-91,30,40:e3:d6:da:ba:25,71665596,160,42,71665436,71665596
12040,6,6,1,2412,-60,-91,31,40:e3:d6:da:ba:26,71665814,380,-162,71665434,71665814
12041,4,1,1,2412,-83,-91,8,54:e4:3a:ec:fb:64,71722713,2160,54739,71720553,71722713
12042,4,1,1,2412,-81,-91,10,b8:3a:5a:88:e6:e1,71753143,2376,28054,71750767,71753143
12043,6,6,1,2412,-67,-91,24,e6:aa:ea:c9:ea:33,71818892,408,65341,71818484,71818892
12044,4,1,1,2412,-83,-91,8,54:e4:3a:ec:fb:64,71825129,2160,4077,71822969,71825129
12045,6,6,1,2412,-68,-91,23,e6:aa:ea:c9:ea:33,71831020,408,5483,71830612,71831020
12046,6,6,1,2412,-67,-91,24,e6:aa:ea:c9:ea:33,71843129,408,11701,71842721,71843129
12047,4,1,1,2412,-80,-91,11,b8:3a:5a:88:e6:e0,71852976,2360,7487,71850616,71852976
12048,6,6,1,2412,-69,-91,22,e6:aa:ea:c9:ea:33,71867678,408,14294,71867270,71867678
12049,6,12,1,2412,-58,-91,33,40:e3:d6:da:ba:20,71869141,160,1303,71868981,71869141
12050,6,6,1,2412,-58,-91,33,40:e3:d6:da:ba:21,71869360,368,-149,71868992,71869360
12051,6,12,1,2412,-58,-91,33,40:e3:d6:da:ba:22,71869765,180,225,71869585,71869765
12052,6,12,1,2412,-58,-91,33,40:e3:d6:da:ba:23,71869970,184,21,71869786,71869970
12053,6,12,1,2412,-58,-91,33,40:e3:d6:da:ba:24,71870198,176,52,71870022,71870198
12054,6,12,1,2412,-58,-91,33,40:e3:d6:da:ba:25,71870417,160,59,71870257,71870417
12055,6,6,1,2412,-58,-91,33,40:e3:d6:da:ba:26,71870609,380,-188,71870229,71870609
12056,4,1,1,2412,-82,-91,9,54:e4:3a:ec:fb:64,71927540,2160,54771,71925380,71927540
12057,6,12,1,2412,-58,-91,33,40:e3:d6:da:ba:20,71971522,160,43822,71971362,71971522
12058,6,6,1,2412,-58,-91,33,40:e3:d6:da:ba:21,71971722,368,-168,71971354,71971722
12059,6,12,1,2412,-58,-91,33,40:e3:d6:da:ba:22,71972128,180,226,71971948,71972128
12060,6,12,1,2412,-58,-91,33,40:e3:d6:da:ba:23,71972351,184,39,71972167,71972351
12061,6,12,1,2412,-58,-91,33,40:e3:d6:da:ba:24,71972561,176,34,71972385,71972561
12062,6,12,1,2412,-58,-91,33,40:e3:d6:da:ba:25,71972789,160,68,71972629,71972789
12063,6,6,1,2412,-58,-91,33,40:e3:d6:da:ba:26,71972999,380,-170,71972619,71972999
12064,4,1,1,2412,-91,-91,0,,71999543,304,26240,71999239,71999543
12065,6,6,1,2412,-80,-91,11,e6:aa:ea:b7:4a:dd,72015441,408,15490,72015033,72015441
12066,6,6,1,2412,-81,-91,10,e6:aa:ea:b7:4a:dd,72027465,408,11616,72027057,72027465
12067,4,1,1,2412,-81,-91,10,54:e4:3a:ec:fb:64,72029932,2160,307,72027772,72029932
12068,6,6,1,2412,-76,-91,15,e6:aa:ea:b7:4a:dd,72039590,408,9250,72039182,72039590
12069,6,6,1,2412,-77,-91,14,e6:aa:ea:b7:4a:dd,72063825,408,23827,72063417,72063825
12070,6,6,1,2412,-60,-91,31,40:e3:d6:da:ba:21,72074161,368,9968,72073793,72074161
12071,6,12,1,2412,-60,-91,31,40:e3:d6:da:ba:23,72074770,184,425,72074586,72074770
12072,6,12,1,2412,-60,-91,31,40:e3:d6:da:ba:24,72074980,176,34,72074804,72074980
12073,6,6,1,2412,-60,-91,31,40:e3:d6:da:ba:26,72077463,380,2103,72077083,72077463
12074,6,6,1,2412,-63,-91,28,e6:aa:ea:c9:ea:33,72158221,408,80350,72157813,72158221
12075,4,1,1,2412,-78,-91,13,b8:3a:5a:88:e6:e0,72160176,2360,-405,72157816,72160176
12076,4,1,1,2412,-81,-91,10,b8:3a:5a:88:e6:e1,72162583,2376,31,72160207,72162583
12077,6,12,1,2412,-62,-91,29,40:e3:d6:da:ba:20,72176327,160,13584,72176167,72176327
12078,6,6,1,2412,-61,-91,30,40:e3:d6:da:ba:21,72176519,368,-176,72176151,72176519
12079,6,12,1,2412,-62,-91,29,40:e3:d6:da:ba:22,72176906,180,207,72176726,72176906
12080,6,12,1,2412,-61,-91,30,40:e3:d6:da:ba:23,72177138,184,48,72176954,72177138
12081,6,12,1,2412,-61,-91,30,40:e3:d6:da:ba:24,72177347,176,33,72177171,72177347
12082,6,12,1,2412,-61,-91,30,40:e3:d6:da:ba:25,72177549,160,42,72177389,72177549
12083,6,6,1,2412,-61,-91,30,40:e3:d6:da:ba:26,72177759,380,-170,72177379,72177759
12084,6,6,1,2412,-63,-91,28,e6:aa:ea:c9:ea:33,72182453,408,4286,72182045,72182453
12085,4,1,1,2412,-91,-91,0,c0:c9:e3:4d:6e:bf,72201844,872,18519,72200972,72201844
12086,4,1,1,2412,-92,-91,-1,,72202733,304,585,72202429,72202733
12087,4,1,1,2412,-79,-91,12,b8:3a:5a:88:e6:e0,72262574,2360,57481,72260214,72262574
12088,4,1,1,2412,-79,-91,12,b8:3a:5a:88:e6:e1,72264963,2376,13,72262587,72264963
12089,4,1,1,2412,-79,-91,12,b8:3a:5a:88:e6:e0,72276656,2240,9453,72274416,72276656
12090,6,12,1,2412,-62,-91,29,40:e3:d6:da:ba:25,72280265,160,3449,72280105,72280265
12091,4,1,1,2412,-79,-91,12,b8:3a:5a:88:e6:e1,72299173,2256,16652,72296917,72299173
12092,6,6,1,2412,-76,-91,15,e6:aa:ea:b7:4a:dd,72330795,408,31214,72330387,72330795
12093,4,1,1,2412,-87,-91,4,a0:59:50:b4:3a:a2,72335873,1176,3902,72334697,72335873
12094,4,1,1,2412,-81,-91,10,54:e4:3a:ec:fb:64,72337288,2160,-745,72335128,72337288
12095,6,12,1,2412,-61,-91,30,40:e3:d6:da:ba:20,72339308,136,1884,72339172,72339308
12096,6,6,1,2412,-61,-91,30,40:e3:d6:da:ba:21,72339494,348,-162,72339146,72339494
12097,6,12,1,2412,-61,-91,30,40:e3:d6:da:ba:22,72339888,156,238,72339732,72339888
12098,6,12,1,2412,-61,-91,30,40:e3:d6:da:ba:23,72340096,156,52,72339940,72340096
12099,6,12,1,2412,-61,-91,30,40:e3:d6:da:ba:25,72340305,136,73,72340169,72340305
12100,6,6,1,2412,-76,-91,15,e6:aa:ea:b7:4a:dd,72342922,408,2209,72342514,72342922
12101,6,6,1,2412,-82,-91,9,e6:aa:ea:b7:4a:dd,72355036,408,11706,72354628,72355036
12102,4,1,1,2412,-78,-91,13,b8:3a:5a:88:e6:e0,72364994,2360,7598,72362634,72364994
12103,6,6,1,2412,-81,-91,10,e6:aa:ea:b7:4a:dd,72379264,408,13862,72378856,72379264
12104,6,6,1,2412,-61,-91,30,40:e3:d6:da:ba:21,72381336,368,1704,72380968,72381336
12105,6,12,1,2412,-61,-91,30,40:e3:d6:da:ba:22,72381733,180,217,72381553,72381733
12106,6,12,1,2412,-61,-91,30,40:e3:d6:da:ba:23,72381946,184,29,72381762,72381946
12107,6,12,1,2412,-61,-91,30,40:e3:d6:da:ba:24,72382183,176,61,72382007,72382183
12108,6,12,1,2412,-61,-91,30,40:e3:d6:da:ba:25,72382403,160,60,72382243,72382403
12109,6,6,1,2412,-61,-91,30,40:e3:d6:da:ba:26,72382594,380,-189,72382214,72382594
12110,4,1,1,2412,-76,-91,15,b8:3a:5a:88:e6:e0,72467376,2360,82422,72465016,72467376
12111,4,1,1,2412,-76,-91,15,b8:3a:5a:88:e6:e1,72469756,2376,4,72467380,72469756
12112,6,12,1,2412,-61,-91,30,40:e3:d6:da:ba:20,72483538,160,13622,72483378,72483538
12113,6,6,1,2412,-61,-91,30,40:e3:d6:da:ba:21,72483757,368,-149,72483389,72483757
12114,6,12,1,2412,-61,-91,30,40:e3:d6:da:ba:22,72484153,180,216,72483973,72484153
12115,6,12,1,2412,-61,-91,30,40:e3:d6:da:ba:23,72484386,184,49,72484202,72484386
12116,6,12,1,2412,-61,-91,30,40:e3:d6:da:ba:24,72484622,176,60,72484446,72484622
12117,6,12,1,2412,-61,-91,30,40:e3:d6:da:ba:25,72484842,160,60,72484682,72484842
12118,6,6,1,2412,-60,-91,31,40:e3:d6:da:ba:26,72485061,380,-161,72484681,72485061
12119,4,1,1,2412,-78,-91,13,b8:3a:5a:88:e6:e0,72569790,2360,82369,72567430,72569790
12120,4,1,1,2412,-77,-91,14,b8:3a:5a:88:e6:e1,72572170,2376,4,72569794,72572170
12121,6,12,1,2412,-58,-91,33,40:e3:d6:da:ba:22,72586563,180,14213,72586383,72586563
12122,6,12,1,2412,-58,-91,33,40:e3:d6:da:ba:24,72587082,176,343,72586906,72587082
12123,6,12,1,2412,-58,-91,33,40:e3:d6:da:ba:25,72587317,160,75,72587157,72587317
12124,6,6,1,2412,-59,-91,32,40:e3:d6:da:ba:26,72587518,380,-179,72587138,72587518
12125,6,6,1,2412,-62,-91,29,e6:aa:ea:c9:ea:33,72654031,408,66105,72653623,72654031
12126,6,12,1,2412,-62,-91,29,40:e3:d6:da:ba:20,72688349,160,34158,72688189,72688349
12127,6,6,1,2412,-61,-91,30,40:e3:d6:da:ba:21,72688541,368,-176,72688173,72688541
12128,6,12,1,2412,-57,-91,34,40:e3:d6:da:ba:22,72688946,180,225,72688766,72688946
12129,6,12,1,2412,-62,-91,29,40:e3:d6:da:ba:23,72689169,184,39,72688985,72689169
12130,6,12,1,2412,-62,-91,29,40:e3:d6:da:ba:24,72689387,176,42,72689211,72689387
12131,6,12,1,2412,-61,-91,30,40:e3:d6:da:ba:25,72689616,160,69,72689456,72689616
12132,6,6,1,2412,-62,-91,29,40:e3:d6:da:ba:26,72689817,380,-179,72689437,72689817
12133,6,6,1,2412,-61,-91,30,e6:aa:ea:c9:ea:33,72690423,408,198,72690015,72690423
12134,6,6,1,2412,-61,-91,30,e6:aa:ea:c9:ea:33,72702676,408,11845,72702268,72702676
12135,4,1,1,2412,-84,-91,7,a6:e5:7c:28:b1:d3,72734059,992,30391,72733067,72734059
12136,4,1,1,2412,-85,-91,6,,72740142,304,5779,72739838,72740142
12137,6,6,1,2412,-82,-91,9,e6:aa:ea:b7:4a:dd,72749354,408,8804,72748946,72749354
12138,6,6,1,2412,-75,-91,16,e6:aa:ea:b7:4a:dd,72773643,408,23881,72773235,72773643
12139,4,1,1,2412,-77,-91,14,b8:3a:5a:88:e6:e0,72774583,2360,-1420,72772223,72774583
12140,6,6,1,2412,-75,-91,16,e6:aa:ea:b7:4a:dd,72785721,408,10730,72785313,72785721
12141,6,12,1,2412,-56,-91,35,40:e3:d6:da:ba:20,72790752,160,4871,72790592,72790752
12142,6,6,1,2412,-56,-91,35,40:e3:d6:da:ba:21,72790971,368,-149,72790603,72790971
12143,6,12,1,2412,-56,-91,35,40:e3:d6:da:ba:22,72791385,180,234,72791205,72791385
12144,6,12,1,2412,-56,-91,35,40:e3:d6:da:ba:23,72791608,184,39,72791424,72791608
12145,6,12,1,2412,-56,-91,35,40:e3:d6:da:ba:24,72791836,176,52,72791660,72791836
12146,6,12,1,2412,-56,-91,35,40:e3:d6:da:ba:25,72792037,160,41,72791877,72792037
12147,6,6,1,2412,-56,-91,35,40:e3:d6:da:ba:26,72792247,380,-170,72791867,72792247
12148,6,6,1,2412,-81,-91,10,e6:aa:ea:b7:4a:dd,72797833,408,5178,72797425,72797833
12149,4,1,1,2412,-85,-91,6,b8:3a:5a:88:e6:e1,72830047,2256,29958,72827791,72830047
12150,4,1,1,2412,-85,-91,6,a4:e5:7c:28:b1:d3,72843483,688,12748,72842795,72843483
12151,4,1,1,2412,-93,-91,-2,,72844187,304,400,72843883,72844187
12152,4,1,1,2412,-79,-91,12,b8:3a:5a:88:e6:e0,72852272,2240,5845,72850032,72852272
12153,4,1,1,2412,-78,-91,13,b8:3a:5a:88:e6:e0,72877000,2360,22368,72874640,72877000
12154,6,12,1,2412,-61,-91,30,40:e3:d6:da:ba:20,72893127,160,15967,72892967,72893127
12155,6,6,1,2412,-60,-91,31,40:e3:d6:da:ba:21,72893328,368,-167,72892960,72893328
12156,6,12,1,2412,-56,-91,35,40:e3:d6:da:ba:22,72893733,180,225,72893553,72893733
12157,6,12,1,2412,-56,-91,35,40:e3:d6:da:ba:23,72893965,184,48,72893781,72893965
12158,6,12,1,2412,-60,-91,31,40:e3:d6:da:ba:24,72894175,176,34,72893999,72894175
12159,6,12,1,2412,-60,-91,31,40:e3:d6:da:ba:25,72894376,160,41,72894216,72894376
12160,6,6,1,2412,-60,-91,31,40:e3:d6:da:ba:26,72894595,380,-161,72894215,72894595
12161,4,1,1,2412,-92,-91,-1,,72935658,304,40759,72935354,72935658
12162,4,1,1,2412,-69,-91,22,,72941052,304,5090,72940748,72941052
12163,4,1,1,2412,-84,-91,7,b8:3a:5a:88:e6:e1,72981790,2376,38362,72979414,72981790
12164,6,6,1,2412,-55,-91,36,40:e3:d6:da:ba:21,72995754,368,13596,72995386,72995754
12165,6,12,1,2412,-55,-91,36,40:e3:d6:da:ba:22,72996150,180,216,72995970,72996150
12166,6,12,1,2412,-55,-91,36,40:e3:d6:da:ba:23,72996374,184,40,72996190,72996374
12167,6,12,1,2412,-55,-91,36,40:e3:d6:da:ba:24,72996583,176,33,72996407,72996583
12168,6,12,1,2412,-55,-91,36,40:e3:d6:da:ba:25,72996811,160,68,72996651,72996811
12169,6,6,1,2412,-55,-91,36,40:e3:d6:da:ba:26,72997012,380,-179,72996632,72997012
12170,4,1,1,2412,-93,-91,-2,,73004933,304,7617,73004629,73004933
12171,4,1,1,2412,-78,-91,13,b8:3a:5a:88:e6:e0,73005269,2240,-1904,73003029,73005269
12172,4,1,1,2412,-93,-91,-2,,73031870,304,26297,73031566,73031870
12173,4,1,1,2412,-88,-91,3,54:e4:3a:ec:fb:64,73053937,2160,19907,73051777,73053937
12174,6,6,1,2412,-67,-91,24,e6:aa:ea:c9:ea:33,73096218,408,41873,73095810,73096218
12175,6,12,1,2412,-61,-91,30,40:e3:d6:da:ba:20,73097942,160,1564,73097782,73097942
12176,6,6,1,2412,-60,-91,31,40:e3:d6:da:ba:21,73098161,368,-149,73097793,73098161
12177,6,12,1,2412,-60,-91,31,40:e3:d6:da:ba:22,73098575,180,234,73098395,73098575
12178,6,12,1,2412,-55,-91,36,40:e3:d6:da:ba:23,73098780,184,21,73098596,73098780
12179,6,12,1,2412,-55,-91,36,40:e3:d6:da:ba:24,73099017,176,61,73098841,73099017
12180,6,12,1,2412,-60,-91,31,40:e3:d6:da:ba:25,73099218,160,41,73099058,73099218
12181,6,6,1,2412,-67,-91,24,e6:aa:ea:c9:ea:33,73108335,408,8709,73107927,73108335
12182,6,6,1,2412,-66,-91,25,e6:aa:ea:c9:ea:33,73120454,408,11711,73120046,73120454
12183,6,6,1,2412,-73,-91,18,e6:aa:ea:b7:4a:dd,73179964,408,59102,73179556,73179964
12184,4,1,1,2412,-82,-91,9,b8:3a:5a:88:e6:e1,73187578,2376,5238,73185202,73187578
12185,6,6,1,2412,-73,-91,18,e6:aa:ea:b7:4a:dd,73192085,408,4099,73191677,73192085
12186,6,12,1,2412,-55,-91,36,40:e3:d6:da:ba:20,73200343,160,8098,73200183,73200343
12187,6,6,1,2412,-55,-91,36,40:e3:d6:da:ba:21,73200535,368,-176,73200167,73200535
12188,6,12,1,2412,-55,-91,36,40:e3:d6:da:ba:22,73200922,180,207,73200742,73200922
12189,6,12,1,2412,-53,-91,38,40:e3:d6:da:ba:23,73201154,184,48,73200970,73201154
12190,6,12,1,2412,-54,-91,37,40:e3:d6:da:ba:24,73201372,176,42,73201196,73201372
12191,6,12,1,2412,-55,-91,36,40:e3:d6:da:ba:25,73201574,160,42,73201414,73201574
12192,6,6,1,2412,-55,-91,36,40:e3:d6:da:ba:26,73201784,380,-170,73201404,73201784
12193,6,6,1,2412,-73,-91,18,e6:aa:ea:b7:4a:dd,73204206,408,2014,73203798,73204206
12194,6,6,1,2412,-78,-91,13,e6:aa:ea:b7:4a:dd,73216318,408,11704,73215910,73216318
12195,4,1,1,2412,-82,-91,9,c0:c9:e3:4d:6e:bf,73227695,872,10505,73226823,73227695
12196,4,1,1,2412,-79,-91,12,54:e4:3a:ec:fb:64,73258802,2160,28947,73256642,73258802
12197,4,1,1,2412,-82,-91,9,b8:3a:5a:88:e6:e0,73286597,2360,25435,73284237,73286597
12198,4,1,1,2412,-83,-91,8,b8:3a:5a:88:e6:e1,73289004,2376,31,73286628,73289004
12199,6,12,1,2412,-55,-91,36,40:e3:d6:da:ba:20,73302727,160,13563,73302567,73302727
12200,6,6,1,2412,-55,-91,36,40:e3:d6:da:ba:21,73302937,368,-158,73302569,73302937
12201,6,12,1,2412,-55,-91,36,40:e3:d6:da:ba:22,73303324,180,207,73303144,73303324
12202,6,12,1,2412,-55,-91,36,40:e3:d6:da:ba:23,73303529,184,21,73303345,73303529
12203,6,12,1,2412,-55,-91,36,40:e3:d6:da:ba:24,73303748,176,43,73303572,73303748
12204,6,12,1,2412,-55,-91,36,40:e3:d6:da:ba:25,73303958,160,50,73303798,73303958
12205,6,6,1,2412,-55,-91,36,40:e3:d6:da:ba:26,73304168,380,-170,73303788,73304168
12206,4,1,1,2412,-81,-91,10,b8:3a:5a:88:e6:e0,73388978,2360,82450,73386618,73388978
12207,6,12,1,2412,-56,-91,35,40:e3:d6:da:ba:20,73405154,160,16016,73404994,73405154
12208,6,6,1,2412,-56,-91,35,40:e3:d6:da:ba:21,73405346,368,-176,73404978,73405346
12209,6,12,1,2412,-56,-91,35,40:e3:d6:da:ba:22,73405751,180,225,73405571,73405751
12210,6,12,1,2412,-55,-91,36,40:e3:d6:da:ba:23,73405984,184,49,73405800,73405984
12211,6,12,1,2412,-56,-91,35,40:e3:d6:da:ba:24,73406220,176,60,73406044,73406220
12212,6,12,1,2412,-56,-91,35,40:e3:d6:da:ba:25,73406431,160,51,73406271,73406431
12213,6,6,1,2412,-56,-91,35,40:e3:d6:da:ba:26,73406623,380,-188,73406243,73406623
12214,4,1,1,2412,-83,-91,8,54:e4:3a:ec:fb:64,73463595,2160,54812,73461435,73463595
12215,6,6,1,2412,-69,-91,22,e6:aa:ea:c9:ea:33,73490045,408,26042,73489637,73490045
12216,4,1,1,2412,-79,-91,12,b8:3a:5a:88:e6:e0,73491396,2360,-1009,73489036,73491396
12217,4,1,1,2412,-80,-91,11,b8:3a:5a:88:e6:e1,73493785,2376,13,73491409,73493785
12218,6,6,1,2412,-69,-91,22,e6:aa:ea:c9:ea:33,73502163,408,7970,73501755,73502163
12219,6,12,1,2412,-57,-91,34,40:e3:d6:da:ba:20,73507586,160,5263,73507426,73507586
12220,6,6,1,2412,-57,-91,34,40:e3:d6:da:ba:21,73507778,368,-176,73507410,73507778
12221,6,12,1,2412,-57,-91,34,40:e3:d6:da:ba:22,73508174,180,216,73507994,73508174
12222,6,12,1,2412,-57,-91,34,40:e3:d6:da:ba:23,73508406,184,48,73508222,73508406
12223,6,12,1,2412,-57,-91,34,40:e3:d6:da:ba:24,73508616,176,34,73508440,73508616
12224,6,12,1,2412,-57,-91,34,40:e3:d6:da:ba:25,73508826,160,50,73508666,73508826
12225,6,6,1,2412,-69,-91,22,e6:aa:ea:c9:ea:33,73514289,408,5055,73513881,73514289
12226,6,6,1,2412,-69,-91,22,e6:aa:ea:c9:ea:33,73526412,408,11715,73526004,73526412
12227,6,6,1,2412,-68,-91,23,e6:aa:ea:c9:ea:33,73538534,408,11714,73538126,73538534
12228,4,1,1,2412,-83,-91,8,54:e4:3a:ec:fb:64,73565943,2160,25249,73563783,73565943
12229,6,6,1,2412,-82,-91,9,e6:aa:ea:b7:4a:dd,73585721,408,19370,73585313,73585721
12230,6,12,1,2412,-85,-91,6,84:d4:7e:d5:12:c0,73604554,960,17873,73603594,73604554
12231,6,12,1,2412,-57,-91,34,40:e3:d6:da:ba:20,73609944,160,5230,73609784,73609944
12232,6,6,1,2412,-57,-91,34,40:e3:d6:da:ba:21,73610145,368,-167,73609777,73610145
12233,6,12,1,2412,-57,-91,34,40:e3:d6:da:ba:22,73610541,180,216,73610361,73610541
12234,6,12,1,2412,-57,-91,34,40:e3:d6:da:ba:23,73610756,184,31,73610572,73610756
12235,6,6,1,2412,-74,-91,17,e6:aa:ea:b7:4a:dd,73610954,408,-210,73610546,73610954
12236,6,12,1,2412,-58,-91,33,40:e3:d6:da:ba:24,73611377,176,247,73611201,73611377
12237,6,6,1,2412,-57,-91,34,40:e3:d6:da:ba:26,73611797,380,40,73611417,73611797
12238,6,6,1,2412,-74,-91,17,e6:aa:ea:b7:4a:dd,73622071,408,9866,73621663,73622071
12239,6,6,1,2412,-73,-91,18,e6:aa:ea:b7:4a:dd,73634378,408,11899,73633970,73634378
12240,4,1,1,2412,-81,-91,10,54:e4:3a:ec:fb:64,73668301,2160,31763,73666141,73668301
12241,4,1,1,2412,-85,-91,6,c0:c9:e3:4d:6e:bf,73674335,872,5162,73673463,73674335
12242,4,1,1,2412,-85,-91,6,,73675223,304,584,73674919,73675223
12243,4,1,1,2412,-81,-91,10,b8:3a:5a:88:e6:e0,73696549,2360,18966,73694189,73696549
12244,4,1,1,2412,-81,-91,10,b8:3a:5a:88:e6:e1,73699081,2376,156,73696705,73699081
12245,6,12,1,2412,-61,-91,30,40:e3:d6:da:ba:20,73712333,160,13092,73712173,73712333
12246,6,6,1,2412,-56,-91,35,40:e3:d6:da:ba:21,73712543,368,-158,73712175,73712543
12247,6,12,1,2412,-61,-91,30,40:e3:d6:da:ba:22,73712930,180,207,73712750,73712930
12248,6,12,1,2412,-61,-91,30,40:e3:d6:da:ba:23,73713135,184,21,73712951,73713135
12249,6,12,1,2412,-61,-91,30,40:e3:d6:da:ba:24,73713354,176,43,73713178,73713354
12250,6,12,1,2412,-61,-91,30,40:e3:d6:da:ba:25,73713555,160,41,73713395,73713555
12251,6,6,1,2412,-61,-91,30,40:e3:d6:da:ba:26,73713747,380,-188,73713367,73713747
12252,4,1,1,2412,-86,-91,5,a6:e5:7c:28:b1:d3,73758001,992,43262,73757009,73758001
12253,4,1,1,2412,-79,-91,12,54:e4:3a:ec:fb:64,73771408,2160,11247,73769248,73771408
12254,4,1,1,2412,-77,-91,14,b8:3a:5a:88:e6:e0,73798590,2360,24822,73796230,73798590
12255,4,1,1,2412,-82,-91,9,b8:3a:5a:88:e6:e1,73800969,2376,3,73798593,73800969
12256,6,12,1,2412,-55,-91,36,40:e3:d6:da:ba:20,73814753,160,13624,73814593,73814753
12257,6,6,1,2412,-55,-91,36,40:e3:d6:da:ba:21,73814971,368,-150,73814603,73814971
12258,6,12,1,2412,-55,-91,36,40:e3:d6:da:ba:22,73815386,180,235,73815206,73815386
12259,6,12,1,2412,-63,-91,28,40:e3:d6:da:ba:23,73815591,184,21,73815407,73815591
12260,6,12,1,2412,-64,-91,27,40:e3:d6:da:ba:24,73815800,176,33,73815624,73815800
12261,6,12,1,2412,-63,-91,28,40:e3:d6:da:ba:25,73816011,160,51,73815851,73816011
12262,6,6,1,2412,-63,-91,28,40:e3:d6:da:ba:26,73816203,380,-188,73815823,73816203
12263,4,1,1,2412,-85,-91,6,a6:e5:7c:28:b1:d3,73860194,992,42999,73859202,73860194
12264,4,1,1,2412,-70,-91,21,54:e4:3a:ec:fb:64,73873163,2160,10809,73871003,73873163
12265,6,6,1,2412,-82,-91,9,e6:aa:ea:b7:4a:dd,73900642,408,27071,73900234,73900642
12266,6,12,1,2412,-55,-91,36,40:e3:d6:da:ba:20,73917144,160,16342,73916984,73917144
12267,6,6,1,2412,-55,-91,36,40:e3:d6:da:ba:21,73917354,368,-158,73916986,73917354
12268,6,12,1,2412,-55,-91,36,40:e3:d6:da:ba:22,73917750,180,216,73917570,73917750
12269,6,12,1,2412,-55,-91,36,40:e3:d6:da:ba:23,73917974,184,40,73917790,73917974
12270,6,12,1,2412,-55,-91,36,40:e3:d6:da:ba:24,73918192,176,42,73918016,73918192
12271,6,12,1,2412,-55,-91,36,40:e3:d6:da:ba:25,73918394,160,42,73918234,73918394
12272,6,6,1,2412,-55,-91,36,40:e3:d6:da:ba:26,73918604,380,-170,73918224,73918604
12273,6,6,1,2412,-71,-91,20,e6:aa:ea:b7:4a:dd,73937008,408,17996,73936600,73937008
12274,6,6,1,2412,-71,-91,20,e6:aa:ea:b7:4a:dd,73949117,408,11701,73948709,73949117
12275,4,1,1,2412,-63,-91,28,54:e4:3a:ec:fb:64,73975542,2160,24265,73973382,73975542
12276,4,1,1,2412,-82,-91,9,b8:3a:5a:88:e6:e0,74004180,2360,26278,74001820,74004180
12277,6,6,1,2412,-69,-91,22,e6:aa:ea:c9:ea:33,74010193,408,5605,74009785,74010193
12278,6,12,1,2412,-64,-91,27,40:e3:d6:da:ba:20,74019542,160,9189,74019382,74019542
12279,6,6,1,2412,-63,-91,28,40:e3:d6:da:ba:21,74019752,368,-158,74019384,74019752
12280,6,12,1,2412,-63,-91,28,40:e3:d6:da:ba:22,74020165,180,233,74019985,74020165
12281,6,12,1,2412,-63,-91,28,40:e3:d6:da:ba:25,74020818,160,493,74020658,74020818
12282,6,6,1,2412,-63,-91,28,40:e3:d6:da:ba:26,74021010,380,-188,74020630,74021010
12283,6,6,1,2412,-69,-91,22,e6:aa:ea:c9:ea:33,74022320,408,902,74021912,74022320
12284,6,6,1,2412,-69,-91,22,e6:aa:ea:c9:ea:33,74034432,408,11704,74034024,74034432
12285,6,6,1,2412,-69,-91,22,e6:aa:ea:c9:ea:33,74046699,408,11859,74046291,74046699
12286,6,6,1,2412,-69,-91,22,e6:aa:ea:c9:ea:33,74058651,408,11544,74058243,74058651
12287,4,1,1,2412,-76,-91,15,54:e4:3a:ec:fb:64,74077944,2160,17133,74075784,74077944
12288,4,1,1,2412,-81,-91,10,b8:3a:5a:88:e6:e1,74108189,2376,27869,74105813,74108189
12289,6,12,1,2412,-56,-91,35,40:e3:d6:da:ba:20,74121931,160,13582,74121771,74121931
12290,6,6,1,2412,-55,-91,36,40:e3:d6:da:ba:21,74122141,368,-158,74121773,74122141
12291,6,12,1,2412,-55,-91,36,40:e3:d6:da:ba:22,74122546,180,225,74122366,74122546
12292,6,12,1,2412,-56,-91,35,40:e3:d6:da:ba:23,74122779,184,49,74122595,74122779
12293,6,12,1,2412,-56,-91,35,40:e3:d6:da:ba:24,74122988,176,33,74122812,74122988
12294,6,12,1,2412,-55,-91,36,40:e3:d6:da:ba:25,74123199,160,51,74123039,74123199
12295,6,6,1,2412,-55,-91,36,40:e3:d6:da:ba:26,74123409,380,-170,74123029,74123409
12296,4,1,1,2412,-77,-91,14,c0:c9:e3:4d:6e:bf,74169055,872,44774,74168183,74169055
12297,4,1,1,2412,-79,-91,12,b8:3a:5a:88:e6:e0,74208260,2360,36845,74205900,74208260
12298,4,1,1,2412,-76,-91,15,b8:3a:5a:88:e6:e1,74210776,2376,140,74208400,74210776
12299,6,12,1,2412,-62,-91,29,40:e3:d6:da:ba:20,74224355,160,13419,74224195,74224355
12300,6,6,1,2412,-62,-91,29,40:e3:d6:da:ba:21,74224556,368,-167,74224188,74224556
12301,6,12,1,2412,-62,-91,29,40:e3:d6:da:ba:22,74224952,180,216,74224772,74224952
12302,6,12,1,2412,-62,-91,29,40:e3:d6:da:ba:23,74225184,184,48,74225000,74225184
12303,6,12,1,2412,-61,-91,30,40:e3:d6:da:ba:24,74225421,176,61,74225245,74225421
12304,6,12,1,2412,-61,-91,30,40:e3:d6:da:ba:25,74225640,160,59,74225480,74225640
12305,6,6,1,2412,-62,-91,29,40:e3:d6:da:ba:26,74225850,380,-170,74225470,74225850
12306,6,6,1,2412,-71,-91,20,e6:aa:ea:b7:4a:dd,74227833,408,1575,74227425,74227833
12307,6,6,1,2412,-71,-91,20,e6:aa:ea:b7:4a:dd,74264192,408,35951,74263784,74264192
12308,4,1,1,2412,-65,-91,26,54:e4:3a:ec:fb:64,74282741,2160,16389,74280581,74282741
12309,4,1,1,2412,-76,-91,15,b8:3a:5a:88:e6:e0,74310601,2360,25500,74308241,74310601
12310,4,1,1,2412,-78,-91,13,b8:3a:5a:88:e6:e1,74312981,2376,4,74310605,74312981
12311,6,6,1,2412,-71,-91,20,e6:aa:ea:c9:ea:33,74325347,408,11958,74324939,74325347
12312,6,12,1,2412,-60,-91,31,40:e3:d6:da:ba:20,74326737,160,1230,74326577,74326737
12313,6,6,1,2412,-60,-91,31,40:e3:d6:da:ba:21,74326947,368,-158,74326579,74326947
12314,6,12,1,2412,-60,-91,31,40:e3:d6:da:ba:22,74327343,180,216,74327163,74327343
12315,6,12,1,2412,-60,-91,31,40:e3:d6:da:ba:23,74327558,184,31,74327374,74327558
12316,6,12,1,2412,-60,-91,31,40:e3:d6:da:ba:24,74327767,176,33,74327591,74327767
12317,6,12,1,2412,-60,-91,31,40:e3:d6:da:ba:25,74327969,160,42,74327809,74327969
12318,6,6,1,2412,-60,-91,31,40:e3:d6:da:ba:26,74328170,380,-179,74327790,74328170
12319,6,6,1,2412,-69,-91,22,e6:aa:ea:c9:ea:33,74337454,408,8876,74337046,74337454
12320,6,6,1,2412,-71,-91,20,e6:aa:ea:c9:ea:33,74361691,408,23829,74361283,74361691
12321,4,1,1,2412,-80,-91,11,54:e4:3a:ec:fb:64,74385538,2160,21687,74383378,74385538
12322,4,1,1,2412,-77,-91,14,b8:3a:5a:88:e6:e0,74413002,2360,25104,74410642,74413002
12323,4,1,1,2412,-77,-91,14,b8:3a:5a:88:e6:e1,74415391,2376,13,74413015,74415391
12324,6,12,1,2412,-57,-91,34,40:e3:d6:da:ba:20,74429132,160,13581,74428972,74429132
12325,6,6,1,2412,-57,-91,34,40:e3:d6:da:ba:21,74429324,368,-176,74428956,74429324
12326,6,12,1,2412,-57,-91,34,40:e3:d6:da:ba:22,74429720,180,216,74429540,74429720
12327,6,12,1,2412,-57,-91,34,40:e3:d6:da:ba:23,74429926,184,22,74429742,74429926
12328,6,12,1,2412,-56,-91,35,40:e3:d6:da:ba:24,74430153,176,51,74429977,74430153
12329,6,12,1,2412,-57,-91,34,40:e3:d6:da:ba:25,74430355,160,42,74430195,74430355
12330,6,6,1,2412,-57,-91,34,40:e3:d6:da:ba:26,74430565,380,-170,74430185,74430565
12331,4,1,1,2412,-80,-91,11,54:e4:3a:ec:fb:64,74487755,2160,55030,74485595,74487755
12332,4,1,1,2412,-79,-91,12,b8:3a:5a:88:e6:e0,74515380,2360,25265,74513020,74515380
12333,4,1,1,2412,-80,-91,11,b8:3a:5a:88:e6:e1,74517778,2376,22,74515402,74517778
12334,6,12,1,2412,-56,-91,35,40:e3:d6:da:ba:20,74531547,160,13609,74531387,74531547
12335,6,6,1,2412,-55,-91,36,40:e3:d6:da:ba:21,74531766,368,-149,74531398,74531766
12336,6,12,1,2412,-55,-91,36,40:e3:d6:da:ba:22,74532180,180,234,74532000,74532180
12337,6,12,1,2412,-55,-91,36,40:e3:d6:da:ba:23,74532394,184,30,74532210,74532394
12338,6,12,1,2412,-55,-91,36,40:e3:d6:da:ba:24,74532604,176,34,74532428,74532604
12339,6,12,1,2412,-57,-91,34,40:e3:d6:da:ba:25,74532805,160,41,74532645,74532805
12340,6,6,1,2412,-56,-91,35,40:e3:d6:da:ba:26,74533015,380,-170,74532635,74533015
12341,4,1,1,2412,-79,-91,12,54:e4:3a:ec:fb:64,74589936,2160,54761,74587776,74589936
12342,4,1,1,2412,-81,-91,10,b8:3a:5a:88:e6:e0,74617779,2360,25483,74615419,74617779
12343,4,1,1,2412,-80,-91,11,b8:3a:5a:88:e6:e1,74620186,2376,31,74617810,74620186
12344,6,12,1,2412,-59,-91,32,40:e3:d6:da:ba:20,74633934,160,13588,74633774,74633934
12345,6,12,1,2412,-59,-91,32,40:e3:d6:da:ba:23,74634727,184,609,74634543,74634727
12346,6,12,1,2412,-59,-91,32,40:e3:d6:da:ba:24,74634945,176,42,74634769,74634945
12347,6,12,1,2412,-58,-91,33,40:e3:d6:da:ba:25,74635147,160,42,74634987,74635147
12348,6,6,1,2412,-67,-91,24,e6:aa:ea:c9:ea:33,74640777,408,5222,74640369,74640777
12349,6,6,1,2412,-66,-91,25,e6:aa:ea:c9:ea:33,74652743,408,11558,74652335,74652743
12350,6,6,1,2412,-69,-91,22,e6:aa:ea:c9:ea:33,74664816,408,11665,74664408,74664816
12351,6,6,1,2412,-66,-91,25,e6:aa:ea:c9:ea:33,74689045,408,23821,74688637,74689045
12352,4,5.5,1,2412,-64,-91,27,62:08:4b:4b:4b:7a,74704242,277,14920,74703965,74704242
12353,6,12,1,2412,-58,-91,33,40:e3:d6:da:ba:20,74704492,136,114,74704356,74704492
12354,6,12,1,2412,-65,-91,26,,74704645,32,121,74704613,74704645
12355,4,1,1,2412,-79,-91,12,54:e4:3a:ec:fb:64,74704883,2112,-1874,74702771,74704883
12356,4,1,1,2412,-72,-91,19,,74707007,304,1820,74706703,74707007
12357,6,6,1,2412,-58,-91,33,40:e3:d6:da:ba:21,74707196,348,-159,74706848,74707196
12358,6,6,1,2412,-66,-91,25,,74707560,44,320,74707516,74707560
12359,6,12,1,2412,-58,-91,33,40:e3:d6:da:ba:22,74707639,156,-77,74707483,74707639
12360,6,12,1,2412,-66,-91,25,,74707811,32,140,74707779,74707811
12361,6,12,1,2412,-57,-91,34,40:e3:d6:da:ba:23,74707875,156,-92,74707719,74707875
12362,6,12,1,2412,-66,-91,25,,74708047,32,140,74708015,74708047
12363,6,12,1,2412,-58,-91,33,40:e3:d6:da:ba:25,74708139,136,-44,74708003,74708139
12364,4,5.5,1,2412,-73,-91,18,62:08:4b:4b:4b:7a,74726660,277,18244,74726383,74726660
12365,4,1,1,2412,-71,-91,20,,74729186,304,2222,74728882,74729186
12366,4,1,1,2412,-78,-91,13,54:e4:3a:ec:fb:64,74729436,2112,-1862,74727324,74729436
12367,6,12,1,2412,-58,-91,33,40:e3:d6:da:ba:20,74731722,136,2150,74731586,74731722
12368,6,12,1,2412,-66,-91,25,,74731874,32,120,74731842,74731874
12369,6,6,1,2412,-58,-91,33,40:e3:d6:da:ba:21,74731966,348,-256,74731618,74731966
12370,6,6,1,2412,-66,-91,25,,74732331,44,321,74732287,74732331
12371,6,12,1,2412,-58,-91,33,40:e3:d6:da:ba:22,74732422,156,-65,74732266,74732422
12372,6,12,1,2412,-66,-91,25,,74732594,32,140,74732562,74732594
12373,6,12,1,2412,-58,-91,33,40:e3:d6:da:ba:23,74732679,156,-71,74732523,74732679
12374,6,12,1,2412,-65,-91,26,,74732852,32,141,74732820,74732852
12375,6,12,1,2412,-58,-91,33,40:e3:d6:da:ba:25,74732919,136,-69,74732783,74732919
12376,4,1,1,2412,-62,-91,29,,74736290,304,3067,74735986,74736290
12377,6,6,1,2412,-73,-91,18,40:e3:d6:da:ba:21,74736645,368,-13,74736277,74736645
12378,6,12,1,2412,-58,-91,33,40:e3:d6:da:ba:24,74737621,176,800,74737445,74737621
12379,6,12,1,2412,-58,-91,33,40:e3:d6:da:ba:25,74737822,160,41,74737662,74737822
12380,6,6,1,2412,-72,-91,19,e6:aa:ea:b7:4a:dd,74771907,408,33677,74771499,74771907
12381,4,1,1,2412,-90,-91,1,ea:a0:b3:40:f8:07,74779955,1208,6840,74778747,74779955
12382,4,1,1,2412,-89,-91,2,3e:d3:ba:83:2c:bf,74781624,1128,541,74780496,74781624
12383,6,6,1,2412,-71,-91,20,e6:aa:ea:b7:4a:dd,74784021,408,1989,74783613,74784021
12384,4,1,1,2412,-85,-91,6,b8:3a:5a:88:e6:e0,74822732,2360,36351,74820372,74822732
12385,6,12,1,2412,-58,-91,33,40:e3:d6:da:ba:20,74838750,160,15858,74838590,74838750
12386,6,6,1,2412,-57,-91,34,40:e3:d6:da:ba:21,74838942,368,-176,74838574,74838942
12387,6,12,1,2412,-57,-91,34,40:e3:d6:da:ba:22,74839329,180,207,74839149,74839329
12388,6,12,1,2412,-57,-91,34,40:e3:d6:da:ba:23,74839561,184,48,74839377,74839561
12389,6,12,1,2412,-57,-91,34,40:e3:d6:da:ba:24,74839780,176,43,74839604,74839780
12390,6,12,1,2412,-57,-91,34,40:e3:d6:da:ba:25,74840008,160,68,74839848,74840008
12391,6,6,1,2412,-57,-91,34,40:e3:d6:da:ba:26,74840218,380,-170,74839838,74840218
12392,4,1,1,2412,-80,-91,11,54:e4:3a:ec:fb:64,74897155,2160,54777,74894995,74897155
12393,4,1,1,2412,-80,-91,11,b8:3a:5a:88:e6:e0,74925179,2360,25664,74922819,74925179
12394,4,1,1,2412,-83,-91,8,b8:3a:5a:88:e6:e1,74927559,2376,4,74925183,74927559
12395,6,12,1,2412,-59,-91,32,40:e3:d6:da:ba:20,74941150,160,13431,74940990,74941150
12396,6,6,1,2412,-58,-91,33,40:e3:d6:da:ba:21,74941351,368,-167,74940983,74941351
12397,6,12,1,2412,-58,-91,33,40:e3:d6:da:ba:22,74941738,180,207,74941558,74941738
12398,6,12,1,2412,-58,-91,33,40:e3:d6:da:ba:25,74942443,160,545,74942283,74942443
12399,6,6,1,2412,-63,-91,28,e6:aa:ea:c9:ea:33,74955755,408,12904,74955347,74955755
12400,6,6,1,2412,-63,-91,28,e6:aa:ea:c9:ea:33,74967875,408,11712,74967467,74967875
12401,6,6,1,2412,-63,-91,28,e6:aa:ea:c9:ea:33,74992121,408,23838,74991713,74992121
12402,4,1,1,2412,-79,-91,12,b8:3a:5a:88:e6:e1,75030839,2376,36342,75028463,75030839
12403,6,12,1,2412,-58,-91,33,40:e3:d6:da:ba:20,75043536,160,12537,75043376,75043536
12404,6,12,1,2412,-57,-91,34,40:e3:d6:da:ba:23,75044392,184,672,75044208,75044392
12405,6,12,1,2412,-57,-91,34,40:e3:d6:da:ba:25,75044857,160,305,75044697,75044857
12406,6,6,1,2412,-57,-91,34,40:e3:d6:da:ba:26,75045076,380,-161,75044696,75045076
12407,6,6,1,2412,-72,-91,19,e6:aa:ea:b7:4a:dd,75050446,408,4962,75050038,75050446
12408,4,1,1,2412,-80,-91,11,,75059950,304,9200,75059646,75059950
12409,4,1,1,2412,-86,-91,5,1c:bf:ce:04:6b:0c,75060923,928,45,75059995,75060923
12410,4,1,1,2412,-77,-91,14,,75061868,304,641,75061564,75061868
12411,6,6,1,2412,-72,-91,19,e6:aa:ea:b7:4a:dd,75062477,408,201,75062069,75062477
12412,4,1,1,2412,-66,-91,25,a6:e5:7c:28:b1:d3,75068569,944,5148,75067625,75068569
12413,4,1,1,2412,-85,-91,6,a6:e5:7c:28:b1:d3,75069915,944,402,75068971,75069915
12414,4,1,1,2412,-86,-91,5,a6:e5:7c:28:b1:d3,75072305,944,1446,75071361,75072305
12415,4,1,1,2412,-86,-91,5,a6:e5:7c:28:b1:d3,75073646,944,397,75072702,75073646
12416,4,1,1,2412,-86,-91,5,a6:e5:7c:28:b1:d3,75076300,944,1710,75075356,75076300
12417,4,1,1,2412,-86,-91,5,a6:e5:7c:28:b1:d3,75077651,944,407,75076707,75077651
12418,6,6,1,2412,-78,-91,13,e6:aa:ea:b7:4a:dd,75086710,408,8651,75086302,75086710
12419,4,1,1,2412,-77,-91,14,b8:3a:5a:88:e6:e1,75132271,2376,43185,75129895,75132271
12420,6,12,1,2412,-58,-91,33,40:e3:d6:da:ba:20,75145959,160,13528,75145799,75145959
12421,6,6,1,2412,-58,-91,33,40:e3:d6:da:ba:21,75146169,368,-158,75145801,75146169
12422,6,12,1,2412,-57,-91,34,40:e3:d6:da:ba:22,75146583,180,234,75146403,75146583
12423,6,12,1,2412,-58,-91,33,40:e3:d6:da:ba:23,75146816,184,49,75146632,75146816
12424,6,12,1,2412,-57,-91,34,40:e3:d6:da:ba:24,75147043,176,51,75146867,75147043
12425,6,12,1,2412,-57,-91,34,40:e3:d6:da:ba:25,75147244,160,41,75147084,75147244
12426,6,6,1,2412,-58,-91,33,40:e3:d6:da:ba:26,75147463,380,-161,75147083,75147463
12427,4,1,1,2412,-83,-91,8,a4:e5:7c:28:b1:d3,75150737,688,2586,75150049,75150737
12428,4,1,1,2412,-83,-91,8,,75152841,304,1800,75152537,75152841
12429,4,1,1,2412,-90,-91,1,,75199708,304,46563,75199404,75199708
12430,4,1,1,2412,-79,-91,12,54:e4:3a:ec:fb:64,75204364,2160,2496,75202204,75204364
12431,4,1,1,2412,-76,-91,15,b8:3a:5a:88:e6:e0,75232196,2360,25472,75229836,75232196
12432,6,12,1,2412,-57,-91,34,40:e3:d6:da:ba:20,75248346,160,15990,75248186,75248346
12433,6,6,1,2412,-57,-91,34,40:e3:d6:da:ba:21,75248556,368,-158,75248188,75248556
12434,6,12,1,2412,-57,-91,34,40:e3:d6:da:ba:22,75248943,180,207,75248763,75248943
12435,6,12,1,2412,-57,-91,34,40:e3:d6:da:ba:23,75249167,184,40,75248983,75249167
12436,6,6,1,2412,-57,-91,34,40:e3:d6:da:ba:26,75249822,380,275,75249442,75249822
12437,4,1,1,2412,-81,-91,10,54:e4:3a:ec:fb:64,75306766,2160,54784,75304606,75306766
12438,4,1,1,2412,-77,-91,14,b8:3a:5a:88:e6:e0,75334589,2360,25463,75332229,75334589
12439,6,12,1,2412,-63,-91,28,40:e3:d6:da:ba:20,75350737,160,15988,75350577,75350737
12440,6,6,1,2412,-63,-91,28,40:e3:d6:da:ba:21,75350956,368,-149,75350588,75350956
12441,6,12,1,2412,-63,-91,28,40:e3:d6:da:ba:22,75351343,180,207,75351163,75351343
12442,6,12,1,2412,-63,-91,28,40:e3:d6:da:ba:23,75351566,184,39,75351382,75351566
12443,6,12,1,2412,-63,-91,28,40:e3:d6:da:ba:24,75351785,176,43,75351609,75351785
12444,6,12,1,2412,-63,-91,28,40:e3:d6:da:ba:25,75352013,160,68,75351853,75352013
12445,6,6,1,2412,-63,-91,28,40:e3:d6:da:ba:26,75352214,380,-179,75351834,75352214
12446,4,1,1,2412,-90,-91,1,a6:e5:7c:28:b1:d3,75395667,944,42509,75394723,75395667
12447,4,1,1,2412,-82,-91,9,a6:e5:7c:28:b1:d3,75396772,944,161,75395828,75396772
12448,4,1,1,2412,-92,-91,-1,a6:e5:7c:28:b1:d3,75397841,944,125,75396897,75397841
12449,4,1,1,2412,-90,-91,1,a6:e5:7c:28:b1:d3,75398892,944,107,75397948,75398892
12450,4,1,1,2412,-88,-91,3,a6:e5:7c:28:b1:d3,75399952,944,116,75399008,75399952
12451,4,1,1,2412,-87,-91,4,a6:e5:7c:28:b1:d3,75401048,944,152,75400104,75401048
12452,4,1,1,2412,-89,-91,2,a6:e5:7c:28:b1:d3,75402752,944,760,75401808,75402752
12453,4,1,1,2412,-89,-91,2,a6:e5:7c:28:b1:d3,75407181,944,3485,75406237,75407181
12454,4,1,1,2412,-83,-91,8,a6:e5:7c:28:b1:d3,75412724,944,4599,75411780,75412724
12455,4,1,1,2412,-95,-91,-4,,75413684,304,656,75413380,75413684
12456,4,1,1,2412,-90,-91,1,a6:e5:7c:28:b1:d3,75414236,992,-440,75413244,75414236
12457,6,12,1,2412,-59,-91,32,40:e3:d6:da:ba:23,75454018,184,39598,75453834,75454018
12458,6,12,1,2412,-58,-91,33,40:e3:d6:da:ba:24,75454255,176,61,75454079,75454255
12459,6,12,1,2412,-58,-91,33,40:e3:d6:da:ba:25,75454456,160,41,75454296,75454456
12460,6,6,1,2412,-58,-91,33,40:e3:d6:da:ba:26,75454657,380,-179,75454277,75454657
12461,6,6,1,2412,-72,-91,19,e6:aa:ea:b7:4a:dd,75468220,408,13155,75467812,75468220
12462,6,6,1,2412,-77,-91,14,e6:aa:ea:c9:ea:33,75476146,408,7518,75475738,75476146
12463,6,6,1,2412,-80,-91,11,e6:aa:ea:b7:4a:dd,75480171,408,3617,75479763,75480171
12464,6,6,1,2412,-72,-91,19,e6:aa:ea:c9:ea:33,75488261,408,7682,75487853,75488261
12465,6,6,1,2412,-79,-91,12,e6:aa:ea:b7:4a:dd,75492286,408,3617,75491878,75492286
12466,4,1,1,2412,-64,-91,27,a6:e5:7c:28:b1:d3,75498405,992,5127,75497413,75498405
12467,6,6,1,2412,-66,-91,25,e6:aa:ea:c9:ea:33,75500385,408,1572,75499977,75500385
12468,4,1,1,2412,-80,-91,11,54:e4:3a:ec:fb:64,75511549,2160,9004,75509389,75511549
12469,6,6,1,2412,-72,-91,19,e6:aa:ea:b7:4a:dd,75516588,408,4631,75516180,75516588
12470,6,6,1,2412,-66,-91,25,e6:aa:ea:c9:ea:33,75524611,408,7615,75524203,75524611
12471,6,12,1,2412,-56,-91,35,40:e3:d6:da:ba:20,75555538,160,30767,75555378,75555538
12472,6,12,1,2412,-55,-91,36,40:e3:d6:da:ba:22,75556135,180,417,75555955,75556135
12473,6,12,1,2412,-55,-91,36,40:e3:d6:da:ba:23,75556367,184,48,75556183,75556367
12474,6,12,1,2412,-55,-91,36,40:e3:d6:da:ba:24,75556604,176,61,75556428,75556604
12475,6,12,1,2412,-55,-91,36,40:e3:d6:da:ba:25,75556832,160,68,75556672,75556832
12476,6,6,1,2412,-55,-91,36,40:e3:d6:da:ba:26,75557051,380,-161,75556671,75557051
12477,4,1,1,2412,-88,-91,3,a6:e5:7c:28:b1:d3,75581782,944,23787,75580838,75581782
12478,4,1,1,2412,-88,-91,3,a6:e5:7c:28:b1:d3,75582878,944,152,75581934,75582878
12479,4,1,1,2412,-88,-91,3,a6:e5:7c:28:b1:d3,75586130,944,2308,75585186,75586130
12480,4,1,1,2412,-88,-91,3,a6:e5:7c:28:b1:d3,75587226,944,152,75586282,75587226
12481,4,1,1,2412,-90,-91,1,a6:e5:7c:28:b1:d3,75590514,944,2344,75589570,75590514
12482,4,1,1,2412,-91,-91,0,a6:e5:7c:28:b1:d3,75591619,944,161,75590675,75591619
12483,4,1,1,2412,-87,-91,4,a6:e5:7c:28:b1:d3,75592688,944,125,75591744,75592688
12484,4,1,1,2412,-89,-91,2,a6:e5:7c:28:b1:d3,75594988,944,1356,75594044,75594988
12485,4,1,1,2412,-85,-91,6,a6:e5:7c:28:b1:d3,75598235,944,2303,75597291,75598235
12486,4,1,1,2412,-89,-91,2,a6:e5:7c:28:b1:d3,75604616,944,5437,75603672,75604616
12487,4,1,1,2412,-74,-91,17,b8:3a:5a:88:e6:e1,75647516,2376,40524,75645140,75647516
12488,4,1,1,2412,-91,-91,0,,75650209,304,2389,75649905,75650209
12489,6,12,1,2412,-55,-91,36,40:e3:d6:da:ba:23,75658761,184,8368,75658577,75658761
12490,6,12,1,2412,-55,-91,36,40:e3:d6:da:ba:24,75658980,176,43,75658804,75658980
12491,6,12,1,2412,-55,-91,36,40:e3:d6:da:ba:25,75659190,160,50,75659030,75659190
12492,6,6,1,2412,-55,-91,36,40:e3:d6:da:ba:26,75659409,380,-161,75659029,75659409
12493,4,5.5,1,2412,-73,-91,18,62:08:4b:4b:4b:7a,75666890,277,7204,75666613,75666890
12494,6,12,1,2412,-57,-91,34,40:e3:d6:da:ba:20,75667142,136,116,75667006,75667142
12495,6,6,1,2412,-58,-91,33,40:e3:d6:da:ba:21,75667381,348,-109,75667033,75667381
12496,6,6,1,2412,-67,-91,24,,75667746,44,321,75667702,75667746
12497,6,12,1,2412,-56,-91,35,40:e3:d6:da:ba:22,75667837,156,-65,75667681,75667837
12498,6,12,1,2412,-67,-91,24,,75668009,32,140,75667977,75668009
12499,4,1,1,2412,-91,-91,0,a6:e5:7c:28:b1:d3,75685441,944,16488,75684497,75685441
12500,4,1,1,2412,-88,-91,3,a6:e5:7c:28:b1:d3,75687625,944,1240,75686681,75687625
12501,4,1,1,2412,-89,-91,2,a6:e5:7c:28:b1:d3,75699226,944,10657,75698282,75699226
12502,4,1,1,2412,-86,-91,5,a6:e5:7c:28:b1:d3,75702620,944,2450,75701676,75702620
12503,4,1,1,2412,-90,-91,1,a6:e5:7c:28:b1:d3,75704860,944,1296,75703916,75704860
12504,4,1,1,2412,-91,-91,0,a6:e5:7c:28:b1:d3,75705929,944,125,75704985,75705929
12505,4,1,1,2412,-90,-91,1,a6:e5:7c:28:b1:d3,75706998,944,125,75706054,75706998
12506,4,1,1,2412,-89,-91,2,a6:e5:7c:28:b1:d3,75709554,944,1612,75708610,75709554
12507,4,1,1,2412,-80,-91,11,54:e4:3a:ec:fb:64,75716383,2160,4669,75714223,75716383
12508,4,1,1,2412,-74,-91,17,b8:3a:5a:88:e6:e0,75744182,2360,25439,75741822,75744182
12509,4,1,1,2412,-76,-91,15,b8:3a:5a:88:e6:e1,75746571,2376,13,75744195,75746571
12510,6,12,1,2412,-55,-91,36,40:e3:d6:da:ba:20,75760345,160,13614,75760185,75760345
12511,6,6,1,2412,-55,-91,36,40:e3:d6:da:ba:21,75760546,368,-167,75760178,75760546
12512,6,12,1,2412,-56,-91,35,40:e3:d6:da:ba:22,75760960,180,234,75760780,75760960
12513,6,12,1,2412,-56,-91,35,40:e3:d6:da:ba:23,75761183,184,39,75760999,75761183
12514,6,12,1,2412,-56,-91,35,40:e3:d6:da:ba:24,75761402,176,43,75761226,75761402
12515,6,6,1,2412,-56,-91,35,40:e3:d6:da:ba:26,75761831,380,49,75761451,75761831
12516,6,6,1,2412,-64,-91,27,e6:aa:ea:c9:ea:33,75791204,408,28965,75790796,75791204
12517,6,6,1,2412,-63,-91,28,e6:aa:ea:c9:ea:33,75803130,408,11518,75802722,75803130
12518,6,6,1,2412,-64,-91,27,e6:aa:ea:c9:ea:33,75815245,408,11707,75814837,75815245
12519,4,1,1,2412,-82,-91,9,54:e4:3a:ec:fb:64,75818799,2160,1394,75816639,75818799
12520,6,6,1,2412,-64,-91,27,e6:aa:ea:c9:ea:33,75827600,408,8393,75827192,75827600
12521,4,1,1,2412,-75,-91,16,b8:3a:5a:88:e6:e0,75846586,2360,16626,75844226,75846586
12522,4,1,1,2412,-74,-91,17,b8:3a:5a:88:e6:e1,75848974,2376,12,75846598,75848974
12523,6,12,1,2412,-57,-91,34,40:e3:d6:da:ba:20,75862757,160,13623,75862597,75862757
12524,6,6,1,2412,-58,-91,33,40:e3:d6:da:ba:21,75862967,368,-158,75862599,75862967
12525,6,12,1,2412,-57,-91,34,40:e3:d6:da:ba:22,75863363,180,216,75863183,75863363
12526,6,12,1,2412,-55,-91,36,40:e3:d6:da:ba:23,75863578,184,31,75863394,75863578
12527,6,12,1,2412,-55,-91,36,40:e3:d6:da:ba:24,75863805,176,51,75863629,75863805
12528,6,12,1,2412,-55,-91,36,40:e3:d6:da:ba:25,75864007,160,42,75863847,75864007
12529,4,1,1,2412,-81,-91,10,54:e4:3a:ec:fb:64,75921595,2160,55428,75919435,75921595
12530,4,1,1,2412,-78,-91,13,b8:3a:5a:88:e6:e1,75951516,2376,27545,75949140,75951516
12531,6,12,1,2412,-56,-91,35,40:e3:d6:da:ba:20,75965146,160,13470,75964986,75965146
12532,6,12,1,2412,-56,-91,35,40:e3:d6:da:ba:22,75965770,180,444,75965590,75965770
12533,6,12,1,2412,-56,-91,35,40:e3:d6:da:ba:25,75966432,160,502,75966272,75966432
12534,6,6,1,2412,-56,-91,35,40:e3:d6:da:ba:26,75966642,380,-170,75966262,75966642
12535,6,6,1,2412,-78,-91,13,e6:aa:ea:b7:4a:dd,75988076,408,21026,75987668,75988076
12536,6,6,1,2412,-73,-91,18,e6:aa:ea:b7:4a:dd,76000243,408,11759,75999835,76000243
12537,4,1,1,2412,-84,-91,7,f8:89:d2:65:d2:3b,76003216,1048,1925,76002168,76003216
12538,6,12,1,2412,-60,-91,31,40:e3:d6:da:ba:20,76004237,136,885,76004101,76004237
12539,6,6,1,2412,-60,-91,31,40:e3:d6:da:ba:21,76004441,348,-144,76004093,76004441
12540,6,12,1,2412,-60,-91,31,40:e3:d6:da:ba:22,76004826,156,229,76004670,76004826
12541,6,12,1,2412,-60,-91,31,40:e3:d6:da:ba:23,76005035,156,53,76004879,76005035
12542,6,12,1,2412,-60,-91,31,40:e3:d6:da:ba:25,76005234,136,63,76005098,76005234
12543,4,1,1,2412,-77,-91,14,54:e4:3a:ec:fb:64,76005651,2112,-1695,76003539,76005651
12544,4,1,1,2412,-77,-91,14,54:e4:3a:ec:fb:64,76013446,2112,5683,76011334,76013446
12545,4,1,1,2412,-78,-91,13,54:e4:3a:ec:fb:64,76023553,2160,7947,76021393,76023553
12546,6,6,1,2412,-73,-91,18,e6:aa:ea:b7:4a:dd,76036543,408,12582,76036135,76036543
12547,4,1,1,2412,-79,-91,12,b8:3a:5a:88:e6:e0,76051392,2360,12489,76049032,76051392
12548,6,12,1,2412,-62,-91,29,40:e3:d6:da:ba:20,76067555,160,16003,76067395,76067555
12549,6,6,1,2412,-62,-91,29,40:e3:d6:da:ba:21,76067774,368,-149,76067406,76067774
12550,6,12,1,2412,-56,-91,35,40:e3:d6:da:ba:22,76068195,180,241,76068015,76068195
12551,6,12,1,2412,-56,-91,35,40:e3:d6:da:ba:23,76068434,184,55,76068250,76068434
12552,6,12,1,2412,-56,-91,35,40:e3:d6:da:ba:24,76068670,176,60,76068494,76068670
12553,6,12,1,2412,-56,-91,35,40:e3:d6:da:ba:25,76068890,160,60,76068730,76068890
12554,6,6,1,2412,-61,-91,30,40:e3:d6:da:ba:26,76069082,380,-188,76068702,76069082
12555,6,6,1,2412,-69,-91,22,e6:aa:ea:c9:ea:33,76105759,408,36269,76105351,76105759
12556,6,6,1,2412,-69,-91,22,e6:aa:ea:c9:ea:33,76117854,408,11687,76117446,76117854
12557,4,1,1,2412,-76,-91,15,54:e4:3a:ec:fb:64,76125970,2160,5956,76123810,76125970
12558,6,6,1,2412,-68,-91,23,e6:aa:ea:c9:ea:33,76129976,408,3598,76129568,76129976
12559,4,1,1,2412,-72,-91,19,b8:3a:5a:88:e6:e0,76153931,2360,21595,76151571,76153931
12560,4,1,1,2412,-84,-91,7,,76162759,304,8524,76162455,76162759
12561,4,1,1,2412,-85,-91,6,a6:e5:7c:28:b1:d3,76163405,944,-298,76162461,76163405
12562,4,1,1,2412,-85,-91,6,a6:e5:7c:28:b1:d3,76166164,944,1815,76165220,76166164
12563,4,1,1,2412,-73,-91,18,a6:e5:7c:28:b1:d3,76167505,944,397,76166561,76167505
12564,6,12,1,2412,-58,-91,33,40:e3:d6:da:ba:20,76169955,160,2290,76169795,76169955
12565,6,6,1,2412,-58,-91,33,40:e3:d6:da:ba:21,76170174,368,-149,76169806,76170174
12566,6,12,1,2412,-58,-91,33,40:e3:d6:da:ba:22,76170570,180,216,76170390,76170570
12567,6,12,1,2412,-58,-91,33,40:e3:d6:da:ba:23,76170784,184,30,76170600,76170784
12568,6,12,1,2412,-58,-91,33,40:e3:d6:da:ba:24,76170994,176,34,76170818,76170994
12569,6,12,1,2412,-58,-91,33,40:e3:d6:da:ba:25,76171204,160,50,76171044,76171204
12570,6,6,1,2412,-58,-91,33,40:e3:d6:da:ba:26,76171396,380,-188,76171016,76171396
12571,4,1,1,2412,-88,-91,3,c0:c9:e3:4d:6e:bf,76187308,872,15040,76186436,76187308
12572,4,1,1,2412,-92,-91,-1,,76188197,304,585,76187893,76188197
12573,4,1,1,2412,-50,-91,41,54:e4:3a:ec:fb:64,76228349,2160,37992,76226189,76228349
12574,4,1,1,2412,-91,-91,0,,76231823,304,3170,76231519,76231823
12575,6,12,1,2412,-57,-91,34,40:e3:d6:da:ba:20,76272358,160,40375,76272198,76272358
12576,6,6,1,2412,-85,-91,6,40:e3:d6:da:ba:21,76272550,368,-176,76272182,76272550
12577,6,6,1,2412,-56,-91,35,40:e3:d6:da:ba:26,76273867,380,937,76273487,76273867
12578,6,6,1,2412,-75,-91,16,e6:aa:ea:b7:4a:dd,76315421,408,41146,76315013,76315421
12579,6,6,1,2412,-89,-91,2,e6:aa:ea:c9:ea:1b,76328647,408,12818,76328239,76328647
12580,6,6,1,2412,-75,-91,16,e6:aa:ea:b7:4a:dd,76339648,408,10593,76339240,76339648
12581,4,1,1,2412,-81,-91,10,b8:3a:5a:88:e6:e0,76358583,2360,16575,76356223,76358583
12582,4,1,1,2412,-83,-91,8,b8:3a:5a:88:e6:e1,76362603,2376,1644,76360227,76362603
12583,6,12,1,2412,-58,-91,33,40:e3:d6:da:ba:20,76374758,160,11995,76374598,76374758
12584,6,6,1,2412,-58,-91,33,40:e3:d6:da:ba:21,76374977,368,-149,76374609,76374977
12585,6,12,1,2412,-58,-91,33,40:e3:d6:da:ba:22,76375373,180,216,76375193,76375373
12586,6,12,1,2412,-58,-91,33,40:e3:d6:da:ba:23,76375588,184,31,76375404,76375588
12587,6,12,1,2412,-58,-91,33,40:e3:d6:da:ba:24,76375797,176,33,76375621,76375797
12588,6,12,1,2412,-58,-91,33,40:e3:d6:da:ba:25,76376016,160,59,76375856,76376016
12589,6,6,1,2412,-58,-91,33,40:e3:d6:da:ba:26,76376217,380,-179,76375837,76376217
12590,4,1,1,2412,-83,-91,8,b8:3a:5a:88:e6:e0,76409317,2240,30860,76407077,76409317
12591,4,1,1,2412,-77,-91,14,54:e4:3a:ec:fb:64,76433169,2160,21692,76431009,76433169
12592,4,1,1,2412,-73,-91,18,b8:3a:5a:88:e6:e1,76463394,2376,27849,76461018,76463394
12593,6,12,1,2412,-57,-91,34,40:e3:d6:da:ba:20,76477148,160,13594,76476988,76477148
12594,6,6,1,2412,-56,-91,35,40:e3:d6:da:ba:21,76477358,368,-158,76476990,76477358
12595,6,12,1,2412,-57,-91,34,40:e3:d6:da:ba:22,76477763,180,225,76477583,76477763
12596,6,12,1,2412,-59,-91,32,40:e3:d6:da:ba:23,76477969,184,22,76477785,76477969
12597,6,6,1,2412,-59,-91,32,40:e3:d6:da:ba:26,76478598,380,249,76478218,76478598
12598,6,6,1,2412,-65,-91,26,e6:aa:ea:c9:ea:33,76523396,408,44390,76522988,76523396
12599,6,6,1,2412,-64,-91,27,e6:aa:ea:c9:ea:33,76547629,408,23825,76547221,76547629
12600,6,6,1,2412,-64,-91,27,e6:aa:ea:c9:ea:33,76559754,408,11717,76559346,76559754
12601,4,1,1,2412,-77,-91,14,b8:3a:5a:88:e6:e0,76563389,2360,1275,76561029,76563389
12602,6,6,1,2412,-64,-91,27,e6:aa:ea:c9:ea:33,76571865,408,8068,76571457,76571865
12603,6,12,1,2412,-61,-91,30,40:e3:d6:da:ba:20,76581450,160,9425,76581290,76581450
12604,6,12,1,2412,-61,-91,30,40:e3:d6:da:ba:23,76582332,184,698,76582148,76582332
12605,6,12,1,2412,-61,-91,30,40:e3:d6:da:ba:24,76582560,176,52,76582384,76582560
12606,6,12,1,2412,-61,-91,30,40:e3:d6:da:ba:25,76582779,160,59,76582619,76582779
12607,6,6,1,2412,-61,-91,30,40:e3:d6:da:ba:26,76582989,380,-170,76582609,76582989
12608,4,1,1,2412,-89,-91,2,c0:c9:e3:4d:6e:bf,76634228,872,50367,76633356,76634228
12609,6,6,1,2412,-61,-91,30,20:c1:9b:ff:3b:83,76640014,196,5590,76639818,76640014
12610,6,12,1,2412,-61,-91,30,40:e3:d6:da:ba:20,76640358,136,208,76640222,76640358
12611,6,12,1,2412,-61,-91,30,,76640510,32,120,76640478,76640510
12612,6,6,1,2412,-58,-91,33,40:e3:d6:da:ba:21,76640611,348,-247,76640263,76640611
12613,6,6,1,2412,-61,-91,30,,76640975,44,320,76640931,76640975
12614,6,12,1,2412,-57,-91,34,40:e3:d6:da:ba:22,76641056,156,-75,76640900,76641056
12615,6,12,1,2412,-61,-91,30,,76641229,32,141,76641197,76641229
12616,6,12,1,2412,-58,-91,33,40:e3:d6:da:ba:23,76641323,156,-62,76641167,76641323
12617,6,12,1,2412,-61,-91,30,,76641495,32,140,76641463,76641495
12618,6,12,1,2412,-58,-91,33,40:e3:d6:da:ba:25,76641562,136,-69,76641426,76641562
12619,6,12,1,2412,-61,-91,30,,76641715,32,121,76641683,76641715
12620,4,1,1,2412,-61,-91,30,20:c1:9b:ff:3b:83,76653346,1208,10423,76652138,76653346
12621,4,1,1,2412,-78,-91,13,54:e4:3a:ec:fb:64,76654672,2112,-786,76652560,76654672
12622,4,1,1,2412,-61,-91,30,,76656794,304,1818,76656490,76656794
12623,6,12,1,2412,-58,-91,33,40:e3:d6:da:ba:20,76656958,136,28,76656822,76656958
12624,6,12,1,2412,-61,-91,30,,76657110,32,120,76657078,76657110
12625,6,6,1,2412,-58,-91,33,40:e3:d6:da:ba:21,76657184,348,-274,76656836,76657184
12626,6,6,1,2412,-61,-91,30,,76657548,44,320,76657504,76657548
12627,6,12,1,2412,-58,-91,33,40:e3:d6:da:ba:22,76657630,156,-74,76657474,76657630
12628,6,12,1,2412,-61,-91,30,,76657802,32,140,76657770,76657802
12629,6,12,1,2412,-58,-91,33,40:e3:d6:da:ba:23,76657869,156,-89,76657713,76657869
12630,6,12,1,2412,-61,-91,30,,76658041,32,140,76658009,76658041
12631,6,12,1,2412,-61,-91,30,40:e3:d6:da:ba:25,76658118,136,-59,76657982,76658118
12632,6,12,1,2412,-61,-91,30,,76658270,32,120,76658238,76658270
12633,4,1,1,2412,-77,-91,14,f8:89:d2:65:d2:3b,76659633,1048,315,76658585,76659633
12634,4,1,1,2412,-80,-91,11,54:e4:3a:ec:fb:64,76662040,2112,295,76659928,76662040
12635,4,1,1,2412,-80,-91,11,54:e4:3a:ec:fb:64,76664325,2112,173,76662213,76664325
12636,4,1,1,2412,-75,-91,16,b8:3a:5a:88:e6:e0,76666775,2360,90,76664415,76666775
12637,4,1,1,2412,-88,-91,3,c0:c9:e3:4d:6e:bf,76677800,872,10153,76676928,76677800
12638,4,1,1,2412,-91,-91,0,,76678690,304,586,76678386,76678690
12639,6,12,1,2412,-58,-91,33,40:e3:d6:da:ba:20,76682237,160,3387,76682077,76682237
12640,6,6,1,2412,-58,-91,33,40:e3:d6:da:ba:21,76682429,368,-176,76682061,76682429
12641,6,12,1,2412,-58,-91,33,40:e3:d6:da:ba:22,76682825,180,216,76682645,76682825
12642,6,12,1,2412,-58,-91,33,40:e3:d6:da:ba:23,76683058,184,49,76682874,76683058
12643,6,12,1,2412,-58,-91,33,40:e3:d6:da:ba:24,76683267,176,33,76683091,76683267
12644,6,12,1,2412,-58,-91,33,40:e3:d6:da:ba:25,76683468,160,41,76683308,76683468
12645,6,6,1,2412,-58,-91,33,40:e3:d6:da:ba:26,76683669,380,-179,76683289,76683669
12646,4,1,1,2412,-79,-91,12,54:e4:3a:ec:fb:64,76702791,2112,17010,76700679,76702791
12647,6,12,1,2412,-63,-91,28,40:e3:d6:da:ba:20,76707307,136,4380,76707171,76707307
12648,6,6,1,2412,-61,-91,30,40:e3:d6:da:ba:21,76707511,348,-144,76707163,76707511
12649,6,12,1,2412,-58,-91,33,40:e3:d6:da:ba:22,76707887,156,220,76707731,76707887
12650,6,12,1,2412,-61,-91,30,40:e3:d6:da:ba:23,76708087,156,44,76707931,76708087
12651,6,12,1,2412,-61,-91,30,40:e3:d6:da:ba:25,76708295,136,72,76708159,76708295
12652,4,1,1,2412,-81,-91,10,54:e4:3a:ec:fb:64,76711129,2112,722,76709017,76711129
12653,4,1,1,2412,-82,-91,9,54:e4:3a:ec:fb:64,76715113,2112,1872,76713001,76715113
12654,4,1,1,2412,-81,-91,10,54:e4:3a:ec:fb:64,76717515,2112,290,76715403,76717515
12655,4,1,1,2412,-80,-91,11,54:e4:3a:ec:fb:64,76719836,2112,209,76717724,76719836
12656,6,12,1,2412,-59,-91,32,40:e3:d6:da:ba:20,76722122,136,2150,76721986,76722122
12657,6,6,1,2412,-58,-91,33,40:e3:d6:da:ba:21,76722326,348,-144,76721978,76722326
12658,6,12,1,2412,-59,-91,32,40:e3:d6:da:ba:22,76722702,156,220,76722546,76722702
12659,6,12,1,2412,-58,-91,33,40:e3:d6:da:ba:23,76722919,156,61,76722763,76722919
12660,6,12,1,2412,-59,-91,32,40:e3:d6:da:ba:25,76723110,136,55,76722974,76723110
12661,4,1,1,2412,-81,-91,10,54:e4:3a:ec:fb:64,76740374,2160,15104,76738214,76740374
12662,6,6,1,2412,-75,-91,16,e6:aa:ea:b7:4a:dd,76756796,408,16014,76756388,76756796
12663,6,6,1,2412,-82,-91,9,78:8a:20:fa:27:f9,76758951,88,2067,76758863,76758951
12664,6,12,1,2412,-83,-91,8,,76759332,32,349,76759300,76759332
12665,6,12,1,2412,-81,-91,10,,76759556,32,192,76759524,76759556
12666,6,12,1,2412,-59,-91,32,40:e3:d6:da:ba:20,76784352,160,24636,76784192,76784352
12667,6,6,1,2412,-59,-91,32,40:e3:d6:da:ba:21,76784544,368,-176,76784176,76784544
12668,6,12,1,2412,-59,-91,32,40:e3:d6:da:ba:22,76784931,180,207,76784751,76784931
12669,6,12,1,2412,-59,-91,32,40:e3:d6:da:ba:23,76785154,184,39,76784970,76785154
12670,6,12,1,2412,-59,-91,32,40:e3:d6:da:ba:24,76785373,176,43,76785197,76785373
12671,6,12,1,2412,-59,-91,32,40:e3:d6:da:ba:25,76785601,160,68,76785441,76785601
12672,6,6,1,2412,-59,-91,32,40:e3:d6:da:ba:26,76785802,380,-179,76785422,76785802
12673,6,6,1,2412,-82,-91,9,78:8a:20:fa:27:f9,76808871,88,22981,76808783,76808871
12674,6,6,1,2412,-82,-91,9,,76810102,44,1187,76810058,76810102
12675,6,12,1,2412,-82,-91,9,,76810360,32,226,76810328,76810360
12676,6,12,1,2412,-82,-91,9,,76810612,32,220,76810580,76810612
12677,6,12,1,2412,-82,-91,9,,76810856,32,212,76810824,76810856
12678,6,12,1,2412,-82,-91,9,,76811080,32,192,76811048,76811080
12679,6,12,1,2412,-82,-91,9,,76811556,32,444,76811524,76811556
12680,4,1,1,2412,-80,-91,11,54:e4:3a:ec:fb:64,76842783,2160,29067,76840623,76842783
12681,4,1,1,2412,-72,-91,19,b8:3a:5a:88:e6:e0,76870763,2360,25620,76868403,76870763
12682,6,12,1,2412,-60,-91,31,40:e3:d6:da:ba:20,76886743,160,15820,76886583,76886743
12683,6,6,1,2412,-59,-91,32,40:e3:d6:da:ba:21,76886953,368,-158,76886585,76886953
12684,6,12,1,2412,-59,-91,32,40:e3:d6:da:ba:22,76887367,180,234,76887187,76887367
12685,6,12,1,2412,-59,-91,32,40:e3:d6:da:ba:23,76887582,184,31,76887398,76887582
12686,6,12,1,2412,-58,-91,33,40:e3:d6:da:ba:24,76887809,176,51,76887633,76887809
12687,6,12,1,2412,-58,-91,33,40:e3:d6:da:ba:25,76888011,160,42,76887851,76888011
12688,4,1,1,2412,-79,-91,12,54:e4:3a:ec:fb:64,76945200,2160,55029,76943040,76945200
12689,6,6,1,2412,-77,-91,14,84:1b:5e:df:1b:99,76977817,80,32537,76977737,76977817
12690,6,12,1,2412,-59,-91,32,40:e3:d6:da:ba:20,76989146,160,11169,76988986,76989146
12691,6,6,1,2412,-59,-91,32,40:e3:d6:da:ba:21,76989338,368,-176,76988970,76989338
12692,6,12,1,2412,-59,-91,32,40:e3:d6:da:ba:22,76989743,180,225,76989563,76989743
12693,6,12,1,2412,-59,-91,32,40:e3:d6:da:ba:23,76989957,184,30,76989773,76989957
12694,6,12,1,2412,-59,-91,32,40:e3:d6:da:ba:24,76990185,176,52,76990009,76990185
12695,6,12,1,2412,-59,-91,32,40:e3:d6:da:ba:25,76990413,160,68,76990253,76990413
12696,6,6,1,2412,-59,-91,32,40:e3:d6:da:ba:26,76990632,380,-161,76990252,76990632
12697,6,6,1,2412,-80,-91,11,e6:aa:ea:b7:4a:dd,77035722,408,44682,77035314,77035722
12698,6,6,1,2412,-65,-91,26,e6:aa:ea:c9:ea:33,77055645,408,19515,77055237,77055645
12699,6,6,1,2412,-80,-91,11,e6:aa:ea:b7:4a:dd,77059951,408,3898,77059543,77059951
12700,6,6,1,2412,-65,-91,26,e6:aa:ea:c9:ea:33,77067773,408,7414,77067365,77067773
12701,6,6,1,2412,-76,-91,15,e6:aa:ea:b7:4a:dd,77072072,408,3891,77071664,77072072
12702,4,1,1,2412,-75,-91,16,b8:3a:5a:88:e6:e0,77075391,2360,959,77073031,77075391
12703,6,6,1,2412,-80,-91,11,e6:aa:ea:b7:4a:dd,77084185,408,8386,77083777,77084185
12704,6,12,1,2412,-58,-91,33,40:e3:d6:da:ba:20,77091556,160,7211,77091396,77091556
12705,6,12,1,2412,-58,-91,33,40:e3:d6:da:ba:22,77092641,180,905,77092461,77092641
12706,6,12,1,2412,-58,-91,33,40:e3:d6:da:ba:24,77093083,176,266,77092907,77093083
12707,6,12,1,2412,-58,-91,33,40:e3:d6:da:ba:25,77093285,160,42,77093125,77093285
12708,6,6,1,2412,-59,-91,32,40:e3:d6:da:ba:26,77093485,380,-180,77093105,77093485
12709,4,1,1,2412,-78,-91,13,54:e4:3a:ec:fb:64,77151258,2160,55613,77149098,77151258
12710,4,1,1,2412,-72,-91,19,b8:3a:5a:88:e6:e0,77166839,2240,13341,77164599,77166839
12711,4,1,1,2412,-71,-91,20,b8:3a:5a:88:e6:e1,77169925,2256,830,77167669,77169925
12712,4,1,1,2412,-72,-91,19,b8:3a:5a:88:e6:e0,77177840,2360,5555,77175480,77177840
12713,4,1,1,2412,-72,-91,19,b8:3a:5a:88:e6:e1,77180220,2376,4,77177844,77180220
12714,4,1,1,2412,-72,-91,19,b8:3a:5a:88:e6:e1,77192668,2256,10192,77190412,77192668
12715,6,12,1,2412,-58,-91,33,40:e3:d6:da:ba:20,77194802,160,1974,77194642,77194802
12716,6,6,1,2412,-58,-91,33,40:e3:d6:da:ba:21,77194994,368,-176,77194626,77194994
12717,6,12,1,2412,-58,-91,33,40:e3:d6:da:ba:22,77195381,180,207,77195201,77195381
12718,6,12,1,2412,-58,-91,33,40:e3:d6:da:ba:23,77195605,184,40,77195421,77195605
12719,6,12,1,2412,-58,-91,33,40:e3:d6:da:ba:24,77195814,176,33,77195638,77195814
12720,6,12,1,2412,-58,-91,33,40:e3:d6:da:ba:25,77196016,160,42,77195856,77196016
12721,6,6,1,2412,-58,-91,33,40:e3:d6:da:ba:26,77196225,380,-171,77195845,77196225
12722,4,1,1,2412,-70,-91,21,b8:3a:5a:88:e6:e0,77280212,2360,81627,77277852,77280212
12723,6,12,1,2412,-61,-91,30,40:e3:d6:da:ba:20,77296345,160,15973,77296185,77296345
12724,6,6,1,2412,-62,-91,29,40:e3:d6:da:ba:21,77296537,368,-176,77296169,77296537
12725,6,12,1,2412,-62,-91,29,40:e3:d6:da:ba:22,77296942,180,225,77296762,77296942
12726,6,12,1,2412,-62,-91,29,40:e3:d6:da:ba:23,77297174,184,48,77296990,77297174
12727,6,12,1,2412,-62,-91,29,40:e3:d6:da:ba:24,77297411,176,61,77297235,77297411
12728,6,12,1,2412,-62,-91,29,40:e3:d6:da:ba:25,77297639,160,68,77297479,77297639
12729,6,6,1,2412,-68,-91,23,40:e3:d6:da:ba:26,77297858,380,-161,77297478,77297858
12730,4,1,1,2412,-86,-91,5,a6:e5:7c:28:b1:d3,77341638,992,42788,77340646,77341638
12731,4,1,1,2412,-75,-91,16,54:e4:3a:ec:fb:64,77354839,2160,11041,77352679,77354839
12732,6,12,1,2412,-58,-91,33,40:e3:d6:da:ba:20,77398745,160,43746,77398585,77398745
12733,6,6,1,2412,-58,-91,33,40:e3:d6:da:ba:21,77398955,368,-158,77398587,77398955
12734,6,12,1,2412,-60,-91,31,40:e3:d6:da:ba:24,77399821,176,690,77399645,77399821
12735,6,12,1,2412,-58,-91,33,40:e3:d6:da:ba:25,77400040,160,59,77399880,77400040
12736,6,6,1,2412,-58,-91,33,40:e3:d6:da:ba:26,77400258,380,-162,77399878,77400258
12737,4,1,1,2412,-87,-91,4,a6:e5:7c:28:b1:d3,77444857,992,43607,77443865,77444857
12738,6,6,1,2412,-80,-91,11,e6:aa:ea:b7:4a:dd,77452904,408,7639,77452496,77452904
12739,6,6,1,2412,-67,-91,24,e6:aa:ea:c9:ea:33,77461285,408,7973,77460877,77461285
12740,6,6,1,2412,-76,-91,15,e6:aa:ea:b7:4a:dd,77465046,408,3353,77464638,77465046
12741,6,6,1,2412,-68,-91,23,e6:aa:ea:c9:ea:33,77473398,408,7944,77472990,77473398
12742,6,6,1,2412,-80,-91,11,e6:aa:ea:b7:4a:dd,77477146,408,3340,77476738,77477146
12743,4,1,1,2412,-80,-91,11,b8:3a:5a:88:e6:e1,77487405,2376,7883,77485029,77487405
12744,6,6,1,2412,-67,-91,24,e6:aa:ea:c9:ea:33,77497637,408,9824,77497229,77497637
12745,6,12,1,2412,-57,-91,34,40:e3:d6:da:ba:20,77501169,160,3372,77501009,77501169
12746,6,6,1,2412,-58,-91,33,40:e3:d6:da:ba:21,77501361,368,-176,77500993,77501361
12747,6,12,1,2412,-57,-91,34,40:e3:d6:da:ba:22,77501834,180,293,77501654,77501834
12748,6,12,1,2412,-57,-91,34,40:e3:d6:da:ba:23,77502058,184,40,77501874,77502058
12749,6,12,1,2412,-57,-91,34,40:e3:d6:da:ba:24,77502294,176,60,77502118,77502294
12750,6,12,1,2412,-57,-91,34,40:e3:d6:da:ba:25,77502523,160,69,77502363,77502523
12751,6,6,1,2412,-57,-91,34,40:e3:d6:da:ba:26,77502715,380,-188,77502335,77502715
12752,6,6,1,2412,-67,-91,24,e6:aa:ea:c9:ea:33,77509755,408,6632,77509347,77509755
12753,4,1,1,2412,-86,-91,5,a6:e5:7c:28:b1:d3,77547035,992,36288,77546043,77547035
12754,4,1,1,2412,-85,-91,6,a4:e5:7c:28:b1:d3,77550352,688,2629,77549664,77550352
12755,4,1,1,2412,-90,-91,1,,77551056,304,400,77550752,77551056
12756,4,1,1,2412,-76,-91,15,54:e4:3a:ec:fb:64,77559573,2160,6357,77557413,77559573
12757,4,1,1,2412,-80,-91,11,b8:3a:5a:88:e6:e0,77587408,2360,25475,77585048,77587408
12758,4,1,1,2412,-79,-91,12,b8:3a:5a:88:e6:e1,77589797,2376,13,77587421,77589797
12759,6,12,1,2412,-57,-91,34,40:e3:d6:da:ba:20,77603553,160,13596,77603393,77603553
12760,6,6,1,2412,-58,-91,33,40:e3:d6:da:ba:21,77603754,368,-167,77603386,77603754
12761,6,12,1,2412,-57,-91,34,40:e3:d6:da:ba:22,77604168,180,234,77603988,77604168
12762,6,12,1,2412,-57,-91,34,40:e3:d6:da:ba:23,77604383,184,31,77604199,77604383
12763,6,12,1,2412,-58,-91,33,40:e3:d6:da:ba:24,77604601,176,42,77604425,77604601
12764,6,12,1,2412,-57,-91,34,40:e3:d6:da:ba:25,77604803,160,42,77604643,77604803
12765,6,6,1,2412,-57,-91,34,40:e3:d6:da:ba:26,77605003,380,-180,77604623,77605003
12766,4,1,1,2412,-85,-91,6,,77623910,304,18603,77623606,77623910
12767,4,1,1,2412,-75,-91,16,54:e4:3a:ec:fb:64,77662001,2160,35931,77659841,77662001
12768,4,1,1,2412,-90,-91,1,,77667748,304,5443,77667444,77667748
12769,4,1,1,2412,-82,-91,9,b8:3a:5a:88:e6:e0,77689787,2360,19679,77687427,77689787
12770,6,12,1,2412,-57,-91,34,40:e3:d6:da:ba:20,77705949,160,16002,77705789,77705949
12771,6,6,1,2412,-57,-91,34,40:e3:d6:da:ba:21,77706150,368,-167,77705782,77706150
12772,6,12,1,2412,-57,-91,34,40:e3:d6:da:ba:22,77706546,180,216,77706366,77706546
12773,6,12,1,2412,-58,-91,33,40:e3:d6:da:ba:23,77706773,184,43,77706589,77706773
12774,6,12,1,2412,-58,-91,33,40:e3:d6:da:ba:24,77706983,176,34,77706807,77706983
12775,6,12,1,2412,-58,-91,33,40:e3:d6:da:ba:25,77707202,160,59,77707042,77707202
12776,6,6,1,2412,-58,-91,33,40:e3:d6:da:ba:26,77707394,380,-188,77707014,77707394
12777,6,6,1,2412,-68,-91,23,e6:aa:ea:c9:ea:33,77776495,408,68693,77776087,77776495
12778,6,6,1,2412,-67,-91,24,e6:aa:ea:c9:ea:33,77788601,408,11698,77788193,77788601
12779,6,6,1,2412,-68,-91,23,e6:aa:ea:c9:ea:33,77800833,408,11824,77800425,77800833
12780,6,12,1,2412,-58,-91,33,40:e3:d6:da:ba:20,77808353,160,7360,77808193,77808353
12781,6,6,1,2412,-57,-91,34,40:e3:d6:da:ba:21,77808572,368,-149,77808204,77808572
12782,6,12,1,2412,-57,-91,34,40:e3:d6:da:ba:22,77808977,180,225,77808797,77808977
12783,6,12,1,2412,-58,-91,33,40:e3:d6:da:ba:23,77809210,184,49,77809026,77809210
12784,6,12,1,2412,-57,-91,34,40:e3:d6:da:ba:24,77809428,176,42,77809252,77809428
12785,6,12,1,2412,-57,-91,34,40:e3:d6:da:ba:25,77809639,160,51,77809479,77809639
12786,6,6,1,2412,-57,-91,34,40:e3:d6:da:ba:26,77809830,380,-189,77809450,77809830
12787,6,6,1,2412,-68,-91,23,e6:aa:ea:c9:ea:33,77812837,408,2599,77812429,77812837
12788,6,6,1,2412,-68,-91,23,e6:aa:ea:c9:ea:33,77824950,408,11705,77824542,77824950
12789,4,1,1,2412,-80,-91,11,54:e4:3a:ec:fb:64,77866780,2160,39670,77864620,77866780
12790,6,6,1,2412,-76,-91,15,e6:aa:ea:b7:4a:dd,77871328,408,4140,77870920,77871328
12791,6,6,1,2412,-76,-91,15,e6:aa:ea:b7:4a:dd,77883444,408,11708,77883036,77883444
12792,6,6,1,2412,-76,-91,15,e6:aa:ea:b7:4a:dd,77907691,408,23839,77907283,77907691
12793,6,12,1,2412,-57,-91,34,40:e3:d6:da:ba:20,77910748,160,2897,77910588,77910748
12794,6,6,1,2412,-57,-91,34,40:e3:d6:da:ba:21,77910949,368,-167,77910581,77910949
12795,6,12,1,2412,-57,-91,34,40:e3:d6:da:ba:22,77911336,180,207,77911156,77911336
12796,6,12,1,2412,-57,-91,34,40:e3:d6:da:ba:23,77911541,184,21,77911357,77911541
12797,6,12,1,2412,-57,-91,34,40:e3:d6:da:ba:25,77911952,160,251,77911792,77911952
12798,6,6,1,2412,-57,-91,34,40:e3:d6:da:ba:26,77912171,380,-161,77911791,77912171
12799,4,1,1,2412,-78,-91,13,54:e4:3a:ec:fb:64,77969198,2160,54867,77967038,77969198
12800,4,1,1,2412,-79,-91,12,b8:3a:5a:88:e6:e1,77999389,2376,27815,77997013,77999389
12801,6,12,1,2412,-57,-91,34,40:e3:d6:da:ba:20,78013166,160,13617,78013006,78013166
12802,6,6,1,2412,-57,-91,34,40:e3:d6:da:ba:21,78013368,368,-166,78013000,78013368
12803,6,12,1,2412,-57,-91,34,40:e3:d6:da:ba:20,78115551,160,102023,78115391,78115551
12804,6,6,1,2412,-57,-91,34,40:e3:d6:da:ba:21,78115743,368,-176,78115375,78115743
12805,6,12,1,2412,-58,-91,33,40:e3:d6:da:ba:22,78116147,180,224,78115967,78116147
12806,6,12,1,2412,-57,-91,34,40:e3:d6:da:ba:23,78116371,184,40,78116187,78116371
12807,6,12,1,2412,-57,-91,34,40:e3:d6:da:ba:24,78116580,176,33,78116404,78116580
12808,6,12,1,2412,-57,-91,34,40:e3:d6:da:ba:25,78116782,160,42,78116622,78116782
12809,6,6,1,2412,-57,-91,34,40:e3:d6:da:ba:26,78116974,380,-188,78116594,78116974
12810,4,1,1,2412,-89,-91,2,c0:c9:e3:4d:6e:bf,78121979,872,4133,78121107,78121979
12811,4,1,1,2412,-92,-91,-1,,78122868,304,585,78122564,78122868
12812,4,1,1,2412,-80,-91,11,,78166931,304,43759,78166627,78166931
12813,6,6,1,2412,-69,-91,22,e6:aa:ea:c9:ea:33,78195073,408,27734,78194665,78195073
12814,4,1,1,2412,-78,-91,13,b8:3a:5a:88:e6:e0,78201786,2360,4353,78199426,78201786
12815,6,6,1,2412,-69,-91,22,e6:aa:ea:c9:ea:33,78217701,408,15507,78217293,78217701
12816,6,12,1,2412,-57,-91,34,40:e3:d6:da:ba:20,78218138,160,277,78217978,78218138
12817,6,6,1,2412,-57,-91,34,40:e3:d6:da:ba:21,78218330,368,-176,78217962,78218330
12818,6,12,1,2412,-57,-91,34,40:e3:d6:da:ba:22,78218717,180,207,78218537,78218717
12819,6,12,1,2412,-57,-91,34,40:e3:d6:da:ba:23,78218949,184,48,78218765,78218949
12820,6,12,1,2412,-57,-91,34,40:e3:d6:da:ba:24,78219185,176,60,78219009,78219185
12821,6,12,1,2412,-57,-91,34,40:e3:d6:da:ba:25,78219387,160,42,78219227,78219387
12822,6,6,1,2412,-57,-91,34,40:e3:d6:da:ba:26,78219579,380,-188,78219199,78219579
12823,6,6,1,2412,-69,-91,22,e6:aa:ea:c9:ea:33,78241901,408,21914,78241493,78241901
12824,4,1,1,2412,-85,-91,6,a6:e5:7c:28:b1:d3,78265461,992,22568,78264469,78265461
12825,6,6,1,2412,-75,-91,16,e6:aa:ea:b7:4a:dd,78289541,408,23672,78289133,78289541
12826,4,1,1,2412,-79,-91,12,b8:3a:5a:88:e6:e0,78304188,2360,12287,78301828,78304188
12827,4,1,1,2412,-80,-91,11,b8:3a:5a:88:e6:e1,78306586,2376,22,78304210,78306586
12828,6,12,1,2412,-57,-91,34,40:e3:d6:da:ba:20,78320369,160,13623,78320209,78320369
12829,6,6,1,2412,-57,-91,34,40:e3:d6:da:ba:21,78320561,368,-176,78320193,78320561
12830,6,12,1,2412,-57,-91,34,40:e3:d6:da:ba:22,78320975,180,234,78320795,78320975
12831,6,12,1,2412,-57,-91,34,40:e3:d6:da:ba:23,78321189,184,30,78321005,78321189
12832,6,12,1,2412,-57,-91,34,40:e3:d6:da:ba:24,78321426,176,61,78321250,78321426
12833,6,12,1,2412,-57,-91,34,40:e3:d6:da:ba:25,78321654,160,68,78321494,78321654
12834,6,6,1,2412,-57,-91,34,40:e3:d6:da:ba:26,78321855,380,-179,78321475,78321855
12835,6,6,1,2412,-74,-91,17,e6:aa:ea:b7:4a:dd,78325917,408,3654,78325509,78325917
12836,4,1,1,2412,-84,-91,7,54:e4:3a:ec:fb:64,78378808,2160,50731,78376648,78378808
12837,4,1,1,2412,-80,-91,11,b8:3a:5a:88:e6:e0,78406588,2360,25420,78404228,78406588
12838,6,12,1,2412,-57,-91,34,40:e3:d6:da:ba:20,78422777,160,16029,78422617,78422777
12839,6,6,1,2412,-57,-91,34,40:e3:d6:da:ba:21,78422969,368,-176,78422601,78422969
12840,6,12,1,2412,-57,-91,34,40:e3:d6:da:ba:22,78423383,180,234,78423203,78423383
12841,6,12,1,2412,-57,-91,34,40:e3:d6:da:ba:23,78423615,184,48,78423431,78423615
12842,6,12,1,2412,-57,-91,34,40:e3:d6:da:ba:24,78423843,176,52,78423667,78423843
12843,6,12,1,2412,-57,-91,34,40:e3:d6:da:ba:25,78424053,160,50,78423893,78424053
12844,6,6,1,2412,-57,-91,34,40:e3:d6:da:ba:26,78424263,380,-170,78423883,78424263
12845,4,1,1,2412,-85,-91,6,a6:e5:7c:28:b1:d3,78450520,944,25313,78449576,78450520
12846,4,1,1,2412,-85,-91,6,a6:e5:7c:28:b1:d3,78452676,944,1212,78451732,78452676
12847,4,1,1,2412,-90,-91,1,a6:e5:7c:28:b1:d3,78459164,944,5544,78458220,78459164
12848,4,1,1,2412,-93,-91,-2,a6:e5:7c:28:b1:d3,78460269,944,161,78459325,78460269
12849,4,1,1,2412,-88,-91,3,a6:e5:7c:28:b1:d3,78461365,944,152,78460421,78461365
12850,4,1,1,2412,-95,-91,-4,a6:e5:7c:28:b1:d3,78468895,992,6538,78467903,78468895
12851,4,1,1,2412,-82,-91,9,54:e4:3a:ec:fb:64,78481218,2160,10163,78479058,78481218
12852,4,1,1,2412,-79,-91,12,b8:3a:5a:88:e6:e0,78508995,2360,25417,78506635,78508995
12853,4,1,1,2412,-79,-91,12,b8:3a:5a:88:e6:e1,78511383,2376,12,78509007,78511383
12854,6,12,1,2412,-58,-91,33,40:e3:d6:da:ba:20,78525176,160,13633,78525016,78525176
12855,6,6,1,2412,-57,-91,34,40:e3:d6:da:ba:21,78525394,368,-150,78525026,78525394
12856,6,12,1,2412,-57,-91,34,40:e3:d6:da:ba:22,78525781,180,207,78525601,78525781
12857,6,12,1,2412,-58,-91,33,40:e3:d6:da:ba:23,78525996,184,31,78525812,78525996
12858,6,12,1,2412,-57,-91,34,40:e3:d6:da:ba:24,78526205,176,33,78526029,78526205
12859,6,12,1,2412,-58,-91,33,40:e3:d6:da:ba:25,78526434,160,69,78526274,78526434
12860,6,6,1,2412,-58,-91,33,40:e3:d6:da:ba:26,78526644,380,-170,78526264,78526644
12861,6,6,1,2412,-69,-91,22,e6:aa:ea:c9:ea:33,78610566,408,83514,78610158,78610566
12862,4,1,1,2412,-78,-91,13,c0:c9:e3:4d:6e:bf,78611836,872,398,78610964,78611836
12863,6,6,1,2412,-71,-91,20,e6:aa:ea:c9:ea:33,78622773,408,10529,78622365,78622773
12864,6,12,1,2412,-58,-91,33,40:e3:d6:da:ba:20,78627557,160,4624,78627397,78627557
12865,6,12,1,2412,-58,-91,33,40:e3:d6:da:ba:22,78628197,180,460,78628017,78628197
12866,6,12,1,2412,-58,-91,33,40:e3:d6:da:ba:23,78628421,184,40,78628237,78628421
12867,6,12,1,2412,-58,-91,33,40:e3:d6:da:ba:24,78628630,176,33,78628454,78628630
12868,6,12,1,2412,-59,-91,32,40:e3:d6:da:ba:25,78628832,160,42,78628672,78628832
12869,6,6,1,2412,-59,-91,32,40:e3:d6:da:ba:26,78629042,380,-170,78628662,78629042
12870,6,6,1,2412,-70,-91,21,e6:aa:ea:c9:ea:33,78634792,408,5342,78634384,78634792
12871,4,1,1,2412,-88,-91,3,,78656637,304,21541,78656333,78656637
12872,6,6,1,2412,-71,-91,20,e6:aa:ea:c9:ea:33,78659032,408,1987,78658624,78659032
12873,4,1,1,2412,-81,-91,10,54:e4:3a:ec:fb:64,78686025,2160,24833,78683865,78686025
12874,6,12,1,2412,-58,-91,33,40:e3:d6:da:ba:20,78729976,160,43791,78729816,78729976
12875,6,6,1,2412,-58,-91,33,40:e3:d6:da:ba:21,78730168,368,-176,78729800,78730168
12876,6,12,1,2412,-59,-91,32,40:e3:d6:da:ba:22,78730581,180,233,78730401,78730581
12877,6,12,1,2412,-57,-91,34,40:e3:d6:da:ba:23,78730806,184,41,78730622,78730806
12878,6,12,1,2412,-58,-91,33,40:e3:d6:da:ba:24,78731015,176,33,78730839,78731015
12879,6,12,1,2412,-58,-91,33,40:e3:d6:da:ba:25,78731225,160,50,78731065,78731225
12880,6,6,1,2412,-58,-91,33,40:e3:d6:da:ba:26,78731426,380,-179,78731046,78731426
12881,4,1,1,2412,-74,-91,17,54:e4:3a:ec:fb:64,78788398,2160,54812,78786238,78788398
12882,6,6,1,2412,-73,-91,18,e6:aa:ea:b7:4a:dd,78810653,408,21847,78810245,78810653
12883,4,1,1,2412,-78,-91,13,b8:3a:5a:88:e6:e1,78824565,2376,11536,78822189,78824565
12884,6,12,1,2412,-58,-91,33,40:e3:d6:da:ba:20,78834344,160,9619,78834184,78834344
12885,6,6,1,2412,-58,-91,33,40:e3:d6:da:ba:21,78834554,368,-158,78834186,78834554
12886,6,12,1,2412,-58,-91,33,40:e3:d6:da:ba:23,78835156,184,418,78834972,78835156
12887,6,12,1,2412,-58,-91,33,40:e3:d6:da:ba:24,78835374,176,42,78835198,78835374
12888,6,12,1,2412,-58,-91,33,40:e3:d6:da:ba:25,78835594,160,60,78835434,78835594
12889,6,6,1,2412,-58,-91,33,40:e3:d6:da:ba:26,78835785,380,-189,78835405,78835785
12890,6,6,1,2412,-72,-91,19,e6:aa:ea:b7:4a:dd,78836197,408,4,78835789,78836197
12891,4,1,1,2412,-88,-91,3,74:a6:cd:e2:ea:89,78840367,1480,2690,78838887,78840367
12892,6,12,1,2412,-58,-91,33,40:e3:d6:da:ba:20,78844597,136,4094,78844461,78844597
12893,6,6,1,2412,-58,-91,33,40:e3:d6:da:ba:21,78844783,348,-162,78844435,78844783
12894,6,12,1,2412,-58,-91,33,40:e3:d6:da:ba:22,78845159,156,220,78845003,78845159
12895,6,12,1,2412,-58,-91,33,40:e3:d6:da:ba:23,78845376,156,61,78845220,78845376
12896,6,6,1,2412,-74,-91,17,e6:aa:ea:b7:4a:dd,78859270,408,13486,78858862,78859270
12897,6,12,1,2412,-59,-91,32,40:e3:d6:da:ba:20,78865801,136,6395,78865665,78865801
12898,6,6,1,2412,-58,-91,33,40:e3:d6:da:ba:21,78865978,348,-171,78865630,78865978
12899,6,12,1,2412,-58,-91,33,40:e3:d6:da:ba:22,78866381,156,247,78866225,78866381
12900,6,12,1,2412,-58,-91,33,40:e3:d6:da:ba:23,78866571,156,34,78866415,78866571
12901,6,12,1,2412,-59,-91,32,40:e3:d6:da:ba:20,78934761,160,68030,78934601,78934761
12902,6,6,1,2412,-59,-91,32,40:e3:d6:da:ba:21,78934980,368,-149,78934612,78934980
12903,6,12,1,2412,-59,-91,32,40:e3:d6:da:ba:22,78935376,180,216,78935196,78935376
12904,6,12,1,2412,-59,-91,32,40:e3:d6:da:ba:23,78935609,184,49,78935425,78935609
12905,6,12,1,2412,-59,-91,32,40:e3:d6:da:ba:24,78935845,176,60,78935669,78935845
12906,6,12,1,2412,-59,-91,32,40:e3:d6:da:ba:25,78936073,160,68,78935913,78936073
12907,6,6,1,2412,-59,-91,32,40:e3:d6:da:ba:26,78936265,380,-188,78935885,78936265
12908,4,1,1,2412,-80,-91,11,54:e4:3a:ec:fb:64,78993011,2160,54586,78990851,78993011
12909,4,1,1,2412,-76,-91,15,b8:3a:5a:88:e6:e0,79020988,2360,25617,79018628,79020988
12910,4,1,1,2412,-76,-91,15,b8:3a:5a:88:e6:e1,79023454,2376,90,79021078,79023454
12911,6,12,1,2412,-60,-91,31,40:e3:d6:da:ba:22,79038719,180,15085,79038539,79038719
12912,6,12,1,2412,-60,-91,31,40:e3:d6:da:ba:23,79038951,184,48,79038767,79038951
12913,6,12,1,2412,-60,-91,31,40:e3:d6:da:ba:24,79039188,176,61,79039012,79039188
12914,6,12,1,2412,-59,-91,32,40:e3:d6:da:ba:25,79039398,160,50,79039238,79039398
12915,6,6,1,2412,-59,-91,32,40:e3:d6:da:ba:26,79039608,380,-170,79039228,79039608
12916,4,1,1,2412,-91,-91,0,00:c0:ca:b0:52:aa,79090389,752,50029,79089637,79090389
12917,4,1,1,2412,-78,-91,13,54:e4:3a:ec:fb:64,79095598,2160,3049,79093438,79095598
12918,4,1,1,2412,-77,-91,14,b8:3a:5a:88:e6:e0,79123389,2360,25431,79121029,79123389
12919,6,6,1,2412,-76,-91,15,e6:aa:ea:b7:4a:dd,79138247,408,14450,79137839,79138247
12920,6,12,1,2412,-60,-91,31,40:e3:d6:da:ba:20,79139561,160,1154,79139401,79139561
12921,6,6,1,2412,-60,-91,31,40:e3:d6:da:ba:21,79139752,368,-177,79139384,79139752
12922,6,12,1,2412,-60,-91,31,40:e3:d6:da:ba:22,79140139,180,207,79139959,79140139
12923,6,12,1,2412,-60,-91,31,40:e3:d6:da:ba:23,79140345,184,22,79140161,79140345
12924,6,6,1,2412,-66,-91,25,e6:aa:ea:c9:ea:33,79142691,408,1938,79142283,79142691
12925,6,6,1,2412,-74,-91,17,e6:aa:ea:b7:4a:dd,79150367,408,7268,79149959,79150367
12926,6,6,1,2412,-66,-91,25,e6:aa:ea:c9:ea:33,79155436,408,4661,79155028,79155436
12927,4,1,1,2412,-91,-91,0,,79157657,304,1917,79157353,79157657
12928,4,1,1,2412,-78,-91,13,54:e4:3a:ec:fb:64,79161274,2112,1505,79159162,79161274
12929,4,1,1,2412,-77,-91,14,54:e4:3a:ec:fb:64,79164934,2112,1548,79162822,79164934
12930,6,6,1,2412,-66,-91,25,e6:aa:ea:c9:ea:33,79166916,408,1574,79166508,79166916
12931,4,1,1,2412,-78,-91,13,54:e4:3a:ec:fb:64,79170272,2112,1244,79168160,79170272
12932,6,6,1,2412,-76,-91,15,e6:aa:ea:b7:4a:dd,79174603,408,3923,79174195,79174603
12933,6,6,1,2412,-66,-91,25,e6:aa:ea:c9:ea:33,79179027,408,4016,79178619,79179027
12934,4,1,1,2412,-77,-91,14,b8:3a:5a:88:e6:e0,79225988,2360,44601,79223628,79225988
12935,4,1,1,2412,-76,-91,15,b8:3a:5a:88:e6:e1,79228368,2376,4,79225992,79228368
12936,6,12,1,2412,-60,-91,31,40:e3:d6:da:ba:20,79241953,160,13425,79241793,79241953
12937,6,6,1,2412,-61,-91,30,40:e3:d6:da:ba:21,79242145,368,-176,79241777,79242145
12938,6,12,1,2412,-60,-91,31,40:e3:d6:da:ba:22,79242550,180,225,79242370,79242550
12939,6,12,1,2412,-60,-91,31,40:e3:d6:da:ba:23,79242765,184,31,79242581,79242765
12940,6,12,1,2412,-60,-91,31,40:e3:d6:da:ba:24,79243001,176,60,79242825,79243001
12941,6,12,1,2412,-60,-91,31,40:e3:d6:da:ba:25,79243203,160,42,79243043,79243203
12942,6,6,1,2412,-60,-91,31,40:e3:d6:da:ba:26,79243422,380,-161,79243042,79243422
12943,4,1,1,2412,-76,-91,15,b8:3a:5a:88:e6:e0,79328492,2360,82710,79326132,79328492
12944,4,1,1,2412,-77,-91,14,b8:3a:5a:88:e6:e1,79330881,2376,13,79328505,79330881
12945,6,12,1,2412,-60,-91,31,40:e3:d6:da:ba:20,79344354,160,13313,79344194,79344354
12946,6,6,1,2412,-60,-91,31,40:e3:d6:da:ba:21,79344555,368,-167,79344187,79344555
12947,6,12,1,2412,-60,-91,31,40:e3:d6:da:ba:22,79344960,180,225,79344780,79344960
12948,6,12,1,2412,-60,-91,31,40:e3:d6:da:ba:23,79345183,184,39,79344999,79345183
12949,6,12,1,2412,-60,-91,31,40:e3:d6:da:ba:24,79345393,176,34,79345217,79345393
12950,6,12,1,2412,-60,-91,31,40:e3:d6:da:ba:25,79345594,160,41,79345434,79345594
12951,6,6,1,2412,-60,-91,31,40:e3:d6:da:ba:26,79345813,380,-161,79345433,79345813
12952,4,1,1,2412,-78,-91,13,54:e4:3a:ec:fb:64,79402812,2160,54839,79400652,79402812
12953,4,1,1,2412,-76,-91,15,b8:3a:5a:88:e6:e1,79433014,2376,27826,79430638,79433014
12954,6,6,1,2412,-72,-91,19,e6:aa:ea:b7:4a:dd,79441055,408,7633,79440647,79441055
12955,6,12,1,2412,-60,-91,31,40:e3:d6:da:ba:20,79446761,160,5546,79446601,79446761
12956,6,6,1,2412,-59,-91,32,40:e3:d6:da:ba:21,79446962,368,-167,79446594,79446962
12957,6,12,1,2412,-59,-91,32,40:e3:d6:da:ba:22,79447367,180,225,79447187,79447367
12958,6,12,1,2412,-59,-91,32,40:e3:d6:da:ba:23,79447600,184,49,79447416,79447600
12959,6,12,1,2412,-58,-91,33,40:e3:d6:da:ba:24,79447809,176,33,79447633,79447809
12960,6,12,1,2412,-59,-91,32,40:e3:d6:da:ba:25,79448020,160,51,79447860,79448020
12961,6,6,1,2412,-59,-91,32,40:e3:d6:da:ba:26,79448212,380,-188,79447832,79448212
12962,6,6,1,2412,-71,-91,20,e6:aa:ea:b7:4a:dd,79453169,408,4549,79452761,79453169
12963,6,6,1,2412,-77,-91,14,e6:aa:ea:b7:4a:dd,79465291,408,11714,79464883,79465291
12964,6,6,1,2412,-72,-91,19,e6:aa:ea:b7:4a:dd,79477409,408,11710,79477001,79477409
12965,6,6,1,2412,-72,-91,19,e6:aa:ea:b7:4a:dd,79489624,408,11807,79489216,79489624
12966,4,1,1,2412,-74,-91,17,b8:3a:5a:88:e6:e0,79532990,2360,41006,79530630,79532990
12967,4,1,1,2412,-75,-91,16,b8:3a:5a:88:e6:e1,79535391,2376,25,79533015,79535391
12968,6,12,1,2412,-58,-91,33,40:e3:d6:da:ba:20,79549169,160,13618,79549009,79549169
12969,6,6,1,2412,-58,-91,33,40:e3:d6:da:ba:21,79549379,368,-158,79549011,79549379
12970,6,12,1,2412,-58,-91,33,40:e3:d6:da:ba:22,79549784,180,225,79549604,79549784
12971,6,12,1,2412,-58,-91,33,40:e3:d6:da:ba:23,79549998,184,30,79549814,79549998
12972,6,12,1,2412,-58,-91,33,40:e3:d6:da:ba:24,79550235,176,61,79550059,79550235
12973,6,12,1,2412,-58,-91,33,40:e3:d6:da:ba:25,79550455,160,60,79550295,79550455
12974,6,6,1,2412,-58,-91,33,40:e3:d6:da:ba:26,79550673,380,-162,79550293,79550673
12975,4,1,1,2412,-87,-91,4,c0:c9:e3:4d:6e:bf,79598030,872,46485,79597158,79598030
12976,4,1,1,2412,-77,-91,14,54:e4:3a:ec:fb:64,79607596,2160,7406,79605436,79607596
12977,4,1,1,2412,-75,-91,16,b8:3a:5a:88:e6:e0,79635391,2360,25435,79633031,79635391
12978,4,1,1,2412,-86,-91,5,,79643816,304,8121,79643512,79643816
12979,6,6,1,2412,-66,-91,25,e6:aa:ea:c9:ea:33,79650725,408,6501,79650317,79650725
12980,6,6,1,2412,-58,-91,33,40:e3:d6:da:ba:21,79651747,368,654,79651379,79651747
12981,6,12,1,2412,-58,-91,33,40:e3:d6:da:ba:22,79652161,180,234,79651981,79652161
12982,6,12,1,2412,-58,-91,33,40:e3:d6:da:ba:23,79652393,184,48,79652209,79652393
12983,6,12,1,2412,-58,-91,33,40:e3:d6:da:ba:24,79652612,176,43,79652436,79652612
12984,6,12,1,2412,-58,-91,33,40:e3:d6:da:ba:25,79652813,160,41,79652653,79652813
12985,6,6,1,2412,-61,-91,30,e6:aa:ea:c9:ea:33,79663018,408,9797,79662610,79663018
12986,6,6,1,2412,-66,-91,25,e6:aa:ea:c9:ea:33,79674960,408,11534,79674552,79674960
12987,4,1,1,2412,-78,-91,13,54:e4:3a:ec:fb:64,79710040,2160,32920,79707880,79710040
12988,4,1,1,2412,-81,-91,10,b8:3a:5a:88:e6:e1,79740196,2376,27780,79737820,79740196
12989,6,12,1,2412,-61,-91,30,40:e3:d6:da:ba:20,79753956,160,13600,79753796,79753956
12990,6,6,1,2412,-61,-91,30,40:e3:d6:da:ba:21,79754157,368,-167,79753789,79754157
12991,6,12,1,2412,-61,-91,30,40:e3:d6:da:ba:22,79754553,180,216,79754373,79754553
12992,6,12,1,2412,-61,-91,30,40:e3:d6:da:ba:23,79754785,184,48,79754601,79754785
12993,6,12,1,2412,-61,-91,30,40:e3:d6:da:ba:24,79755022,176,61,79754846,79755022
12994,6,12,1,2412,-61,-91,30,40:e3:d6:da:ba:25,79755241,160,59,79755081,79755241
12995,6,6,1,2412,-61,-91,30,40:e3:d6:da:ba:26,79755433,380,-188,79755053,79755433
12996,4,1,1,2412,-87,-91,4,a4:e5:7c:28:b1:d3,79758451,688,2330,79757763,79758451
12997,4,1,1,2412,-87,-91,4,a6:e5:7c:28:b1:d3,79799259,992,39816,79798267,79799259
12998,4,1,1,2412,-80,-91,11,54:e4:3a:ec:fb:64,79812249,2160,10830,79810089,79812249
12999,6,12,1,2412,-63,-91,28,40:e3:d6:da:ba:20,79856362,160,43953,79856202,79856362
13000,6,6,1,2412,-63,-91,28,40:e3:d6:da:ba:21,79856581,368,-149,79856213,79856581
13001,6,12,1,2412,-63,-91,28,40:e3:d6:da:ba:22,79856968,180,207,79856788,79856968
13002,6,12,1,2412,-63,-91,28,40:e3:d6:da:ba:23,79857182,184,30,79856998,79857182
13003,6,12,1,2412,-63,-91,28,40:e3:d6:da:ba:24,79857392,176,34,79857216,79857392
13004,6,12,1,2412,-63,-91,28,40:e3:d6:da:ba:25,79857611,160,59,79857451,79857611
13005,6,6,1,2412,-63,-91,28,40:e3:d6:da:ba:26,79857830,380,-161,79857450,79857830
13006,6,6,1,2412,-73,-91,18,e6:aa:ea:b7:4a:dd,79858743,408,505,79858335,79858743
13007,6,6,1,2412,-73,-91,18,e6:aa:ea:b7:4a:dd,79870859,408,11708,79870451,79870859
13008,6,6,1,2412,-74,-91,17,e6:aa:ea:b7:4a:dd,79882972,408,11705,79882564,79882972
13009,6,6,1,2412,-73,-91,18,e6:aa:ea:b7:4a:dd,79895089,408,11709,79894681,79895089
13010,4,1,1,2412,-81,-91,10,54:e4:3a:ec:fb:64,79914815,2160,17566,79912655,79914815
13011,6,12,1,2412,-63,-91,28,40:e3:d6:da:ba:20,79958768,160,43793,79958608,79958768
13012,6,6,1,2412,-63,-91,28,40:e3:d6:da:ba:21,79958987,368,-149,79958619,79958987
13013,6,12,1,2412,-63,-91,28,40:e3:d6:da:ba:22,79959374,180,207,79959194,79959374
13014,6,12,1,2412,-58,-91,33,40:e3:d6:da:ba:23,79959606,184,48,79959422,79959606
13015,6,12,1,2412,-59,-91,32,40:e3:d6:da:ba:24,79959825,176,43,79959649,79959825
13016,6,12,1,2412,-58,-91,33,40:e3:d6:da:ba:25,79960035,160,50,79959875,79960035
13017,6,6,1,2412,-62,-91,29,40:e3:d6:da:ba:26,79960254,380,-161,79959874,79960254
13018,6,6,1,2412,-64,-91,27,e6:aa:ea:c9:ea:33,79992510,408,31848,79992102,79992510
13019,4,1,1,2412,-92,-91,-1,,80004377,304,11563,80004073,80004377
13020,6,6,1,2412,-66,-91,25,e6:aa:ea:c9:ea:33,80004620,408,-165,80004212,80004620
13021,6,6,1,2412,-70,-91,21,e6:aa:ea:c9:ea:33,80016781,408,11753,80016373,80016781
13022,4,1,1,2412,-82,-91,9,54:e4:3a:ec:fb:64,80017676,2160,-1265,80015516,80017676
13023,4,1,1,2412,-80,-91,11,b8:3a:5a:88:e6:e0,80045012,2360,24976,80042652,80045012
13024,6,12,1,2412,-62,-91,29,40:e3:d6:da:ba:20,80061160,160,15988,80061000,80061160
13025,6,6,1,2412,-61,-91,30,40:e3:d6:da:ba:21,80061379,368,-149,80061011,80061379
13026,6,12,1,2412,-61,-91,30,40:e3:d6:da:ba:22,80061775,180,216,80061595,80061775
13027,6,12,1,2412,-61,-91,30,40:e3:d6:da:ba:23,80061998,184,39,80061814,80061998
13028,6,12,1,2412,-61,-91,30,40:e3:d6:da:ba:24,80062208,176,34,80062032,80062208
13029,6,12,1,2412,-61,-91,30,40:e3:d6:da:ba:25,80062436,160,68,80062276,80062436
13030,6,6,1,2412,-61,-91,30,40:e3:d6:da:ba:26,80062628,380,-188,80062248,80062628
13031,4,1,1,2412,-86,-91,5,c0:c9:e3:4d:6e:bf,80087719,872,24219,80086847,80087719
13032,4,1,1,2412,-92,-91,-1,,80115111,304,27088,80114807,80115111
13033,4,1,1,2412,-77,-91,14,b8:3a:5a:88:e6:e0,80117699,2240,348,80115459,80117699
13034,4,1,1,2412,-77,-91,14,b8:3a:5a:88:e6:e1,80122476,2256,2521,80120220,80122476
13035,4,1,1,2412,-77,-91,14,b8:3a:5a:88:e6:e0,80147731,2360,22895,80145371,80147731
13036,6,12,1,2412,-60,-91,31,40:e3:d6:da:ba:20,80163562,160,15671,80163402,80163562
13037,6,6,1,2412,-60,-91,31,40:e3:d6:da:ba:21,80163771,368,-159,80163403,80163771
13038,6,12,1,2412,-60,-91,31,40:e3:d6:da:ba:22,80164168,180,217,80163988,80164168
13039,6,12,1,2412,-62,-91,29,40:e3:d6:da:ba:23,80164391,184,39,80164207,80164391
13040,6,12,1,2412,-62,-91,29,40:e3:d6:da:ba:24,80164619,176,52,80164443,80164619
13041,6,12,1,2412,-62,-91,29,40:e3:d6:da:ba:25,80164820,160,41,80164660,80164820
13042,4,1,1,2412,-85,-91,6,a6:e5:7c:28:b1:d3,80209178,992,43366,80208186,80209178
13043,4,1,1,2412,-78,-91,13,b8:3a:5a:88:e6:e0,80249792,2360,38254,80247432,80249792
13044,4,1,1,2412,-77,-91,14,b8:3a:5a:88:e6:e1,80252198,2376,30,80249822,80252198
13045,6,12,1,2412,-65,-91,26,40:e3:d6:da:ba:20,80265958,160,13600,80265798,80265958
13046,6,6,1,2412,-65,-91,26,40:e3:d6:da:ba:21,80266168,368,-158,80265800,80266168
13047,6,6,1,2412,-64,-91,27,e6:aa:ea:c9:ea:33,80282727,408,16151,80282319,80282727
13048,6,6,1,2412,-67,-91,24,e6:aa:ea:c9:ea:33,80294852,408,11717,80294444,80294852
13049,6,6,1,2412,-67,-91,24,e6:aa:ea:c9:ea:33,80306973,408,11713,80306565,80306973
13050,4,1,1,2412,-85,-91,6,a6:e5:7c:28:b1:d3,80311370,992,3405,80310378,80311370
13051,6,6,1,2412,-64,-91,27,e6:aa:ea:c9:ea:33,80319081,408,7303,80318673,80319081
13052,6,6,1,2412,-67,-91,24,e6:aa:ea:c9:ea:33,80331192,408,11703,80330784,80331192
13053,4,1,1,2412,-77,-91,14,b8:3a:5a:88:e6:e0,80352205,2360,18653,80349845,80352205
13054,4,1,1,2412,-77,-91,14,b8:3a:5a:88:e6:e1,80354642,2376,61,80352266,80354642
13055,6,12,1,2412,-65,-91,26,40:e3:d6:da:ba:20,80368380,160,13578,80368220,80368380
13056,6,6,1,2412,-64,-91,27,40:e3:d6:da:ba:21,80368590,368,-158,80368222,80368590
13057,6,12,1,2412,-65,-91,26,40:e3:d6:da:ba:22,80369004,180,234,80368824,80369004
13058,6,12,1,2412,-64,-91,27,40:e3:d6:da:ba:23,80369228,184,40,80369044,80369228
13059,6,12,1,2412,-65,-91,26,40:e3:d6:da:ba:24,80369437,176,33,80369261,80369437
13060,6,12,1,2412,-66,-91,25,40:e3:d6:da:ba:25,80369665,160,68,80369505,80369665
13061,6,6,1,2412,-83,-91,8,40:e3:d6:da:ba:26,80369857,380,-188,80369477,80369857
13062,6,6,1,2412,-73,-91,18,e6:aa:ea:b7:4a:dd,80378288,408,8023,80377880,80378288
13063,6,6,1,2412,-72,-91,19,e6:aa:ea:b7:4a:dd,80390182,408,11486,80389774,80390182
13064,6,6,1,2412,-72,-91,19,e6:aa:ea:b7:4a:dd,80414411,408,23821,80414003,80414411
13065,6,6,1,2412,-73,-91,18,e6:aa:ea:b7:4a:dd,80426528,408,11709,80426120,80426528
13066,4,1,1,2412,-75,-91,16,b8:3a:5a:88:e6:e0,80454610,2360,25722,80452250,80454610
13067,6,12,1,2412,-62,-91,29,40:e3:d6:da:ba:20,80470766,160,15996,80470606,80470766
13068,6,6,1,2412,-62,-91,29,40:e3:d6:da:ba:21,80470967,368,-167,80470599,80470967
13069,6,12,1,2412,-63,-91,28,40:e3:d6:da:ba:22,80471354,180,207,80471174,80471354
13070,6,12,1,2412,-63,-91,28,40:e3:d6:da:ba:23,80471560,184,22,80471376,80471560
13071,6,12,1,2412,-62,-91,29,40:e3:d6:da:ba:24,80471796,176,60,80471620,80471796
13072,6,12,1,2412,-62,-91,29,40:e3:d6:da:ba:25,80472015,160,59,80471855,80472015
13073,6,6,1,2412,-62,-91,29,40:e3:d6:da:ba:26,80472226,380,-169,80471846,80472226
13074,4,1,1,2412,-74,-91,17,b8:3a:5a:88:e6:e0,80556991,2360,82405,80554631,80556991
13075,4,1,1,2412,-74,-91,17,b8:3a:5a:88:e6:e1,80559389,2376,22,80557013,80559389
13076,6,12,1,2412,-61,-91,30,40:e3:d6:da:ba:20,80573159,160,13610,80572999,80573159
13077,6,6,1,2412,-61,-91,30,40:e3:d6:da:ba:21,80573360,368,-167,80572992,80573360
13078,6,12,1,2412,-61,-91,30,40:e3:d6:da:ba:22,80573747,180,207,80573567,80573747
13079,6,12,1,2412,-61,-91,30,40:e3:d6:da:ba:23,80573980,184,49,80573796,80573980
13080,6,12,1,2412,-61,-91,30,40:e3:d6:da:ba:24,80574207,176,51,80574031,80574207
13081,6,12,1,2412,-61,-91,30,40:e3:d6:da:ba:25,80574427,160,60,80574267,80574427
13082,6,6,1,2412,-61,-91,30,40:e3:d6:da:ba:26,80574627,380,-180,80574247,80574627
13083,4,1,1,2412,-89,-91,2,c0:c9:e3:4d:6e:bf,80579278,872,3779,80578406,80579278
13084,4,1,1,2412,-79,-91,12,,80580167,304,585,80579863,80580167
13085,4,1,1,2412,-90,-91,1,,80625073,304,44602,80624769,80625073
13086,6,6,1,2412,-62,-91,29,40:e3:d6:da:ba:21,80675753,368,50312,80675385,80675753
13087,6,12,1,2412,-61,-91,30,40:e3:d6:da:ba:23,80676372,184,435,80676188,80676372
13088,6,12,1,2412,-62,-91,29,40:e3:d6:da:ba:24,80676600,176,52,80676424,80676600
13089,6,12,1,2412,-62,-91,29,40:e3:d6:da:ba:25,80676819,160,59,80676659,80676819
13090,6,6,1,2412,-59,-91,32,40:e3:d6:da:ba:26,80677011,380,-188,80676631,80677011
13091,6,6,1,2412,-70,-91,21,e6:aa:ea:c9:ea:33,80699615,408,22196,80699207,80699615
13092,6,6,1,2412,-73,-91,18,e6:aa:ea:c9:ea:33,80711738,408,11715,80711330,80711738
13093,6,6,1,2412,-73,-91,18,e6:aa:ea:c9:ea:33,80723861,408,11715,80723453,80723861
13094,4,1,1,2412,-75,-91,16,b8:3a:5a:88:e6:e0,80761799,2360,35578,80759439,80761799
13095,4,1,1,2412,-74,-91,17,b8:3a:5a:88:e6:e1,80764188,2376,13,80761812,80764188
13096,6,12,1,2412,-66,-91,25,40:e3:d6:da:ba:20,80777961,160,13613,80777801,80777961
13097,6,6,1,2412,-66,-91,25,40:e3:d6:da:ba:21,80778153,368,-176,80777785,80778153
13098,6,12,1,2412,-63,-91,28,40:e3:d6:da:ba:22,80778540,180,207,80778360,80778540
13099,6,12,1,2412,-64,-91,27,40:e3:d6:da:ba:23,80778754,184,30,80778570,80778754
13100,6,12,1,2412,-67,-91,24,40:e3:d6:da:ba:24,80778963,176,33,80778787,80778963
13101,6,12,1,2412,-67,-91,24,40:e3:d6:da:ba:25,80779165,160,42,80779005,80779165
13102,6,6,1,2412,-67,-91,24,40:e3:d6:da:ba:26,80779366,380,-179,80778986,80779366
13103,4,1,1,2412,-78,-91,13,54:e4:3a:ec:fb:64,80836420,2160,54894,80834260,80836420
13104,6,12,1,2412,-63,-91,28,40:e3:d6:da:ba:20,80880378,160,43798,80880218,80880378
13105,6,6,1,2412,-63,-91,28,40:e3:d6:da:ba:21,80880570,368,-176,80880202,80880570
13106,6,12,1,2412,-63,-91,28,40:e3:d6:da:ba:22,80880984,180,234,80880804,80880984
13107,6,12,1,2412,-63,-91,28,40:e3:d6:da:ba:23,80881189,184,21,80881005,80881189
13108,6,12,1,2412,-63,-91,28,40:e3:d6:da:ba:24,80881408,176,43,80881232,80881408
13109,6,12,1,2412,-63,-91,28,40:e3:d6:da:ba:25,80881636,160,68,80881476,80881636
13110,6,6,1,2412,-63,-91,28,40:e3:d6:da:ba:26,80881837,380,-179,80881457,80881837
13111,6,6,1,2412,-74,-91,17,e6:aa:ea:b7:4a:dd,80898931,408,16686,80898523,80898931
13112,6,6,1,2412,-76,-91,15,e6:aa:ea:b7:4a:dd,80911069,408,11730,80910661,80911069
13113,6,6,1,2412,-77,-91,14,e6:aa:ea:b7:4a:dd,80935296,408,23819,80934888,80935296
13114,4,1,1,2412,-79,-91,12,54:e4:3a:ec:fb:64,80938814,2160,1358,80936654,80938814
13115,4,1,1,2412,-77,-91,14,b8:3a:5a:88:e6:e0,80966595,2360,25421,80964235,80966595
13116,6,12,1,2412,-63,-91,28,40:e3:d6:da:ba:20,80982773,160,16018,80982613,80982773
13117,6,6,1,2412,-62,-91,29,40:e3:d6:da:ba:21,80982992,368,-149,80982624,80982992
13118,6,12,1,2412,-63,-91,28,40:e3:d6:da:ba:24,80983839,176,671,80983663,80983839
13119,6,12,1,2412,-63,-91,28,40:e3:d6:da:ba:25,80984058,160,59,80983898,80984058
13120,6,6,1,2412,-63,-91,28,40:e3:d6:da:ba:26,80984250,380,-188,80983870,80984250
13121,6,6,1,2412,-67,-91,24,e6:aa:ea:c9:ea:33,81015072,408,30414,81014664,81015072
13122,6,6,1,2412,-67,-91,24,e6:aa:ea:c9:ea:33,81039327,408,23847,81038919,81039327
13123,4,1,1,2412,-77,-91,14,54:e4:3a:ec:fb:64,81041214,2160,-273,81039054,81041214
13124,6,6,1,2412,-67,-91,24,e6:aa:ea:c9:ea:33,81051448,408,9826,81051040,81051448
13125,4,1,1,2412,-83,-91,8,b8:3a:5a:88:e6:e0,81069586,2360,15778,81067226,81069586
13126,6,12,1,2412,-63,-91,28,40:e3:d6:da:ba:20,81085168,160,15422,81085008,81085168
13127,6,6,1,2412,-63,-91,28,40:e3:d6:da:ba:21,81085378,368,-158,81085010,81085378
13128,6,12,1,2412,-63,-91,28,40:e3:d6:da:ba:22,81085783,180,225,81085603,81085783
13129,6,12,1,2412,-63,-91,28,40:e3:d6:da:ba:23,81085989,184,22,81085805,81085989
13130,6,12,1,2412,-63,-91,28,40:e3:d6:da:ba:24,81086225,176,60,81086049,81086225
13131,6,12,1,2412,-63,-91,28,40:e3:d6:da:ba:25,81086427,160,42,81086267,81086427
13132,6,6,1,2412,-63,-91,28,40:e3:d6:da:ba:26,81086628,380,-179,81086248,81086628
13133,4,1,1,2412,-87,-91,4,,81117063,304,30131,81116759,81117063
13134,4,1,1,2412,-77,-91,14,b8:3a:5a:88:e6:e1,81173818,2376,54379,81171442,81173818
13135,6,12,1,2412,-60,-91,31,40:e3:d6:da:ba:20,81187564,160,13586,81187404,81187564
13136,6,6,1,2412,-60,-91,31,40:e3:d6:da:ba:21,81187756,368,-176,81187388,81187756
13137,6,12,1,2412,-60,-91,31,40:e3:d6:da:ba:22,81188143,180,207,81187963,81188143
13138,6,12,1,2412,-60,-91,31,40:e3:d6:da:ba:23,81188367,184,40,81188183,81188367
13139,6,12,1,2412,-60,-91,31,40:e3:d6:da:ba:24,81188603,176,60,81188427,81188603
13140,6,12,1,2412,-60,-91,31,40:e3:d6:da:ba:25,81188805,160,42,81188645,81188805
13141,6,6,1,2412,-60,-91,31,40:e3:d6:da:ba:26,81189015,380,-170,81188635,81189015
13142,4,1,1,2412,-51,-91,40,6c:4a:85:4f:fb:85,81250587,1312,60260,81249275,81250587
13143,4,1,1,2412,-78,-91,13,b8:3a:5a:88:e6:e0,81273805,2360,20858,81271445,81273805
13144,6,12,1,2412,-64,-91,27,40:e3:d6:da:ba:24,81291043,176,17062,81290867,81291043
13145,6,12,1,2412,-64,-91,27,40:e3:d6:da:ba:25,81291245,160,42,81291085,81291245
13146,6,6,1,2412,-64,-91,27,40:e3:d6:da:ba:26,81291455,380,-170,81291075,81291455
13147,6,6,1,2412,-73,-91,18,e6:aa:ea:b7:4a:dd,81328178,408,36315,81327770,81328178
13148,6,6,1,2412,-73,-91,18,e6:aa:ea:b7:4a:dd,81340290,408,11704,81339882,81340290
13149,4,1,1,2412,-79,-91,12,54:e4:3a:ec:fb:64,81348432,2160,5982,81346272,81348432
13150,6,6,1,2412,-72,-91,19,e6:aa:ea:b7:4a:dd,81352402,408,3562,81351994,81352402
13151,4,1,1,2412,-49,-91,42,c2:56:ca:d8:57:23,81361007,960,7645,81360047,81361007
13152,4,1,1,2412,-79,-91,12,54:e4:3a:ec:fb:64,81362083,2112,-1036,81359971,81362083
13153,4,1,1,2412,-50,-91,41,,81364209,304,1822,81363905,81364209
13154,6,12,1,2412,-62,-91,29,40:e3:d6:da:ba:20,81364373,136,28,81364237,81364373
13155,6,12,1,2412,-55,-91,36,,81364528,32,123,81364496,81364528
13156,6,6,1,2412,-61,-91,30,40:e3:d6:da:ba:21,81364966,348,90,81364618,81364966
13157,6,6,1,2412,-56,-91,35,,81365333,44,323,81365289,81365333
13158,6,12,1,2412,-61,-91,30,40:e3:d6:da:ba:22,81365428,156,-61,81365272,81365428
13159,6,12,1,2412,-60,-91,31,,81365602,32,142,81365570,81365602
13160,6,12,1,2412,-61,-91,30,40:e3:d6:da:ba:25,81365827,136,89,81365691,81365827
13161,6,12,1,2412,-60,-91,31,,81365982,32,123,81365950,81365982
13162,4,1,1,2412,-57,-91,34,c2:56:ca:d8:57:23,81381331,960,14389,81380371,81381331
13163,6,12,1,2412,-61,-91,30,40:e3:d6:da:ba:20,81382248,136,781,81382112,81382248
13164,6,12,1,2412,-60,-91,31,,81382403,32,123,81382371,81382403
13165,6,12,1,2412,-61,-91,30,40:e3:d6:da:ba:22,81382819,156,260,81382663,81382819
13166,6,12,1,2412,-60,-91,31,,81382994,32,143,81382962,81382994
13167,6,12,1,2412,-61,-91,30,40:e3:d6:da:ba:25,81383218,136,88,81383082,81383218
13168,6,12,1,2412,-60,-91,31,,81383373,32,123,81383341,81383373
13169,4,1,1,2412,-78,-91,13,54:e4:3a:ec:fb:64,81383677,2112,-1808,81381565,81383677
13170,4,1,1,2412,-78,-91,13,54:e4:3a:ec:fb:64,81385881,2112,92,81383769,81385881
13171,4,1,1,2412,-58,-91,33,,81388007,304,1822,81387703,81388007
13172,6,12,1,2412,-61,-91,30,40:e3:d6:da:ba:20,81392851,160,4684,81392691,81392851
13173,6,12,1,2412,-60,-91,31,40:e3:d6:da:ba:24,81393926,176,899,81393750,81393926
13174,6,12,1,2412,-61,-91,30,40:e3:d6:da:ba:25,81394146,160,60,81393986,81394146
13175,6,6,1,2412,-61,-91,30,40:e3:d6:da:ba:26,81394347,380,-179,81393967,81394347
13176,6,6,1,2412,-63,-91,28,e6:aa:ea:c9:ea:33,81432216,408,37461,81431808,81432216
13177,6,6,1,2412,-64,-91,27,e6:aa:ea:c9:ea:33,81444498,408,11874,81444090,81444498
13178,6,6,1,2412,-65,-91,26,e6:aa:ea:c9:ea:33,81456506,408,11600,81456098,81456506
13179,6,6,1,2412,-66,-91,25,e6:aa:ea:c9:ea:33,81468572,408,11658,81468164,81468572
13180,4,1,1,2412,-80,-91,11,b8:3a:5a:88:e6:e1,81483637,2376,12689,81481261,81483637
13181,4,1,1,2412,-92,-91,-1,,81490892,304,6951,81490588,81490892
13182,6,12,1,2412,-61,-91,30,40:e3:d6:da:ba:20,81494765,160,3713,81494605,81494765
13183,6,12,1,2412,-61,-91,30,40:e3:d6:da:ba:22,81495371,180,426,81495191,81495371
13184,6,12,1,2412,-61,-91,30,40:e3:d6:da:ba:23,81495594,184,39,81495410,81495594
13185,6,12,1,2412,-60,-91,31,40:e3:d6:da:ba:24,81495804,176,34,81495628,81495804
13186,6,12,1,2412,-60,-91,31,40:e3:d6:da:ba:25,81496014,160,50,81495854,81496014
13187,6,6,1,2412,-60,-91,31,40:e3:d6:da:ba:26,81496206,380,-188,81495826,81496206
13188,4,1,1,2412,-62,-91,29,c2:56:ca:d8:57:23,81532425,960,35259,81531465,81532425
13189,6,12,1,2412,-62,-91,29,40:e3:d6:da:ba:20,81533347,136,786,81533211,81533347
13190,6,6,1,2412,-62,-91,29,40:e3:d6:da:ba:21,81533533,348,-162,81533185,81533533
13191,6,12,1,2412,-62,-91,29,40:e3:d6:da:ba:22,81533927,156,238,81533771,81533927
13192,6,12,1,2412,-62,-91,29,40:e3:d6:da:ba:23,81534117,156,34,81533961,81534117
13193,4,1,1,2412,-55,-91,36,c2:56:ca:d8:57:23,81543239,960,8162,81542279,81543239
13194,4,1,1,2412,-80,-91,11,54:e4:3a:ec:fb:64,81553214,2160,7815,81551054,81553214
13195,4,1,1,2412,-54,-91,37,c2:56:ca:d8:57:23,81560690,960,6516,81559730,81560690
13196,4,1,1,2412,-82,-91,9,b8:3a:5a:88:e6:e0,81581020,2360,17970,81578660,81581020
13197,4,1,1,2412,-74,-91,17,b8:3a:5a:88:e6:e1,81583466,2376,70,81581090,81583466
13198,6,12,1,2412,-62,-91,29,40:e3:d6:da:ba:20,81598821,160,15195,81598661,81598821
13199,6,6,1,2412,-62,-91,29,40:e3:d6:da:ba:21,81599022,368,-167,81598654,81599022
13200,6,12,1,2412,-62,-91,29,40:e3:d6:da:ba:23,81599827,184,621,81599643,81599827
13201,6,12,1,2412,-61,-91,30,40:e3:d6:da:ba:24,81600037,176,34,81599861,81600037
13202,4,1,1,2412,-78,-91,13,54:e4:3a:ec:fb:64,81655642,2160,53445,81653482,81655642
13203,4,1,1,2412,-78,-91,13,b8:3a:5a:88:e6:e0,81683400,2360,25398,81681040,81683400
13204,4,1,1,2412,-78,-91,13,b8:3a:5a:88:e6:e1,81685780,2376,4,81683404,81685780
13205,6,12,1,2412,-64,-91,27,40:e3:d6:da:ba:20,81699568,160,13628,81699408,81699568
13206,6,6,1,2412,-64,-91,27,40:e3:d6:da:ba:21,81699778,368,-158,81699410,81699778
13207,6,12,1,2412,-63,-91,28,40:e3:d6:da:ba:22,81700174,180,216,81699994,81700174
13208,6,12,1,2412,-64,-91,27,40:e3:d6:da:ba:23,81700388,184,30,81700204,81700388
13209,6,6,1,2412,-72,-91,19,e6:aa:ea:b7:4a:dd,81746362,408,45566,81745954,81746362
13210,4,1,1,2412,-79,-91,12,54:e4:3a:ec:fb:64,81758041,2160,9519,81755881,81758041
13211,6,6,1,2412,-78,-91,13,e6:aa:ea:b7:4a:dd,81782724,408,24275,81782316,81782724
13212,4,1,1,2412,-77,-91,14,b8:3a:5a:88:e6:e0,81785936,2360,852,81783576,81785936
13213,4,1,1,2412,-77,-91,14,b8:3a:5a:88:e6:e1,81788324,2376,12,81785948,81788324
13214,6,12,1,2412,-65,-91,26,40:e3:d6:da:ba:20,81801964,160,13480,81801804,81801964
13215,6,6,1,2412,-65,-91,26,40:e3:d6:da:ba:21,81802183,368,-149,81801815,81802183
13216,6,12,1,2412,-65,-91,26,40:e3:d6:da:ba:22,81802570,180,207,81802390,81802570
13217,6,12,1,2412,-64,-91,27,40:e3:d6:da:ba:23,81802776,184,22,81802592,81802776
13218,6,12,1,2412,-64,-91,27,40:e3:d6:da:ba:24,81803012,176,60,81802836,81803012
13219,6,12,1,2412,-65,-91,26,40:e3:d6:da:ba:25,81803222,160,50,81803062,81803222
13220,6,6,1,2412,-65,-91,26,40:e3:d6:da:ba:26,81803442,380,-160,81803062,81803442
13221,4,1,1,2412,-57,-91,34,54:e4:3a:ec:fb:64,81860436,2160,54834,81858276,81860436
13222,6,12,1,2412,-63,-91,28,40:e3:d6:da:ba:20,81904386,160,43790,81904226,81904386
13223,6,6,1,2412,-62,-91,29,40:e3:d6:da:ba:21,81904578,368,-176,81904210,81904578
13224,6,12,1,2412,-63,-91,28,40:e3:d6:da:ba:22,81904965,180,207,81904785,81904965
13225,6,12,1,2412,-63,-91,28,40:e3:d6:da:ba:23,81905188,184,39,81905004,81905188
13226,6,12,1,2412,-63,-91,28,40:e3:d6:da:ba:24,81905416,176,52,81905240,81905416
13227,6,12,1,2412,-63,-91,28,40:e3:d6:da:ba:25,81905644,160,68,81905484,81905644
13228,6,6,1,2412,-63,-91,28,40:e3:d6:da:ba:26,81905845,380,-179,81905465,81905845
13229,4,1,1,2412,-88,-91,3,a6:e5:7c:28:b1:d3,81949606,992,42769,81948614,81949606
13230,4,1,1,2412,-78,-91,13,54:e4:3a:ec:fb:64,81962823,2160,11057,81960663,81962823
13231,6,6,1,2412,-72,-91,19,e6:aa:ea:c9:ea:33,81976449,408,13218,81976041,81976449
13232,6,6,1,2412,-72,-91,19,e6:aa:ea:c9:ea:33,81988854,408,11997,81988446,81988854
13233,4,1,1,2412,-75,-91,16,b8:3a:5a:88:e6:e0,81990617,2360,-597,81988257,81990617
13234,4,1,1,2412,-75,-91,16,b8:3a:5a:88:e6:e1,81993005,2376,12,81990629,81993005
13235,6,6,1,2412,-71,-91,20,e6:aa:ea:c9:ea:33,82000693,408,7280,82000285,82000693
13236,6,12,1,2412,-64,-91,27,40:e3:d6:da:ba:20,82006786,160,5933,82006626,82006786
13237,6,6,1,2412,-62,-91,29,40:e3:d6:da:ba:21,82006978,368,-176,82006610,82006978
13238,6,12,1,2412,-61,-91,30,40:e3:d6:da:ba:25,82008054,160,916,82007894,82008054
13239,6,6,1,2412,-61,-91,30,40:e3:d6:da:ba:26,82008255,380,-179,82007875,82008255
13240,6,6,1,2412,-71,-91,20,e6:aa:ea:b7:4a:dd,82049546,408,40883,82049138,82049546
13241,4,1,1,2412,-74,-91,17,a4:e5:7c:28:b1:d3,82059310,688,9076,82058622,82059310
13242,4,1,1,2412,-85,-91,6,,82061278,304,1664,82060974,82061278
13243,6,6,1,2412,-79,-91,12,e6:aa:ea:b7:4a:dd,82061668,408,-18,82061260,82061668
13244,4,1,1,2412,-76,-91,15,54:e4:3a:ec:fb:64,82065233,2160,1405,82063073,82065233
13245,6,6,1,2412,-71,-91,20,e6:aa:ea:b7:4a:dd,82073793,408,8152,82073385,82073793
13246,4,1,1,2412,-75,-91,16,b8:3a:5a:88:e6:e0,82093007,2360,16854,82090647,82093007
13247,4,1,1,2412,-74,-91,17,b8:3a:5a:88:e6:e1,82095405,2376,22,82093029,82095405
13248,6,6,1,2412,-80,-91,11,e6:aa:ea:b7:4a:dd,82098028,408,2215,82097620,82098028
13249,4,1,1,2412,-87,-91,4,,82105149,304,6817,82104845,82105149
13250,6,6,1,2412,-60,-91,31,40:e3:d6:da:ba:21,82109368,368,3851,82109000,82109368
13251,6,12,1,2412,-59,-91,32,40:e3:d6:da:ba:22,82109755,180,207,82109575,82109755
13252,6,12,1,2412,-60,-91,31,40:e3:d6:da:ba:23,82109960,184,21,82109776,82109960
13253,6,12,1,2412,-60,-91,31,40:e3:d6:da:ba:24,82110179,176,43,82110003,82110179
13254,6,12,1,2412,-60,-91,31,40:e3:d6:da:ba:25,82110407,160,68,82110247,82110407
13255,6,6,1,2412,-60,-91,31,40:e3:d6:da:ba:26,82110617,380,-170,82110237,82110617
13256,4,1,1,2412,-76,-91,15,b8:3a:5a:88:e6:e0,82195398,2360,82421,82193038,82195398
13257,4,1,1,2412,-76,-91,15,b8:3a:5a:88:e6:e1,82197904,2376,130,82195528,82197904
13258,6,12,1,2412,-60,-91,31,40:e3:d6:da:ba:22,82212167,180,14083,82211987,82212167
13259,6,12,1,2412,-59,-91,32,40:e3:d6:da:ba:23,82212391,184,40,82212207,82212391
13260,6,12,1,2412,-60,-91,31,40:e3:d6:da:ba:24,82212618,176,51,82212442,82212618
13261,6,12,1,2412,-60,-91,31,40:e3:d6:da:ba:25,82212846,160,68,82212686,82212846
13262,4,1,1,2412,-77,-91,14,54:e4:3a:ec:fb:64,82270034,2160,55028,82267874,82270034
13263,4,1,1,2412,-74,-91,17,b8:3a:5a:88:e6:e0,82297908,2360,25514,82295548,82297908
13264,4,1,1,2412,-63,-91,28,b8:3a:5a:88:e6:e1,82300297,2376,13,82297921,82300297
13265,6,12,1,2412,-64,-91,27,40:e3:d6:da:ba:23,82314804,184,14323,82314620,82314804
13266,6,12,1,2412,-64,-91,27,40:e3:d6:da:ba:24,82315023,176,43,82314847,82315023
13267,6,12,1,2412,-64,-91,27,40:e3:d6:da:ba:25,82315233,160,50,82315073,82315233
13268,6,6,1,2412,-64,-91,27,40:e3:d6:da:ba:26,82315443,380,-170,82315063,82315443
13269,6,6,1,2412,-66,-91,25,e6:aa:ea:c9:ea:33,82371513,408,55662,82371105,82371513
13270,6,6,1,2412,-64,-91,27,e6:aa:ea:c9:ea:33,82395748,408,23827,82395340,82395748
13271,4,1,1,2412,-76,-91,15,b8:3a:5a:88:e6:e0,82400197,2360,2089,82397837,82400197
13272,6,12,1,2412,-65,-91,26,40:e3:d6:da:ba:20,82416378,160,16021,82416218,82416378
13273,6,12,1,2412,-65,-91,26,40:e3:d6:da:ba:22,82416974,180,416,82416794,82416974
13274,6,12,1,2412,-65,-91,26,40:e3:d6:da:ba:23,82417189,184,31,82417005,82417189
13275,6,12,1,2412,-65,-91,26,40:e3:d6:da:ba:24,82417398,176,33,82417222,82417398
13276,6,12,1,2412,-65,-91,26,40:e3:d6:da:ba:25,82417627,160,69,82417467,82417627
13277,6,6,1,2412,-65,-91,26,40:e3:d6:da:ba:26,82417828,380,-179,82417448,82417828
13278,6,6,1,2412,-79,-91,12,e6:aa:ea:b7:4a:dd,82480031,408,61795,82479623,82480031
13279,4,1,1,2412,-79,-91,12,b8:3a:5a:88:e6:e0,82503310,2360,20919,82500950,82503310
13280,6,6,1,2412,-80,-91,11,e6:aa:ea:b7:4a:dd,82516499,408,12781,82516091,82516499
13281,6,12,1,2412,-66,-91,25,40:e3:d6:da:ba:20,82518767,160,2108,82518607,82518767
13282,6,6,1,2412,-66,-91,25,40:e3:d6:da:ba:21,82518968,368,-167,82518600,82518968
13283,6,12,1,2412,-66,-91,25,40:e3:d6:da:ba:22,82519364,180,216,82519184,82519364
13284,6,12,1,2412,-65,-91,26,40:e3:d6:da:ba:23,82519597,184,49,82519413,82519597
13285,6,12,1,2412,-66,-91,25,40:e3:d6:da:ba:24,82519824,176,51,82519648,82519824
13286,6,12,1,2412,-66,-91,25,40:e3:d6:da:ba:25,82520053,160,69,82519893,82520053
13287,4,1,1,2412,-83,-91,8,,82599309,304,78952,82599005,82599309
13288,4,1,1,2412,-80,-91,11,b8:3a:5a:88:e6:e0,82605081,2360,3412,82602721,82605081
13289,6,12,1,2412,-66,-91,25,40:e3:d6:da:ba:20,82621188,160,15947,82621028,82621188
13290,6,6,1,2412,-66,-91,25,40:e3:d6:da:ba:21,82621389,368,-167,82621021,82621389
13291,6,12,1,2412,-66,-91,25,40:e3:d6:da:ba:22,82621803,180,234,82621623,82621803
13292,6,12,1,2412,-66,-91,25,40:e3:d6:da:ba:23,82622018,184,31,82621834,82622018
13293,6,12,1,2412,-67,-91,24,40:e3:d6:da:ba:24,82622236,176,42,82622060,82622236
13294,6,12,1,2412,-67,-91,24,40:e3:d6:da:ba:25,82622456,160,60,82622296,82622456
13295,6,6,1,2412,-66,-91,25,40:e3:d6:da:ba:26,82622666,380,-170,82622286,82622666
13296,4,1,1,2412,-79,-91,12,54:e4:3a:ec:fb:64,82679662,2160,54836,82677502,82679662
13297,6,12,1,2412,-66,-91,25,40:e3:d6:da:ba:20,82723574,160,43752,82723414,82723574
13298,6,6,1,2412,-66,-91,25,40:e3:d6:da:ba:21,82723766,368,-176,82723398,82723766
13299,6,12,1,2412,-66,-91,25,40:e3:d6:da:ba:22,82724180,180,234,82724000,82724180
13300,6,12,1,2412,-66,-91,25,40:e3:d6:da:ba:23,82724385,184,21,82724201,82724385
13301,6,12,1,2412,-66,-91,25,40:e3:d6:da:ba:24,82724613,176,52,82724437,82724613
13302,6,12,1,2412,-66,-91,25,40:e3:d6:da:ba:25,82724832,160,59,82724672,82724832
13303,6,6,1,2412,-66,-91,25,40:e3:d6:da:ba:26,82725033,380,-179,82724653,82725033
13304,4,1,1,2412,-88,-91,3,a6:e5:7c:28:b1:d3,82768941,992,42916,82767949,82768941
13305,4,1,1,2412,-78,-91,13,54:e4:3a:ec:fb:64,82782023,2160,10922,82779863,82782023
13306,4,1,1,2412,-80,-91,11,b8:3a:5a:88:e6:e0,82809814,2360,25431,82807454,82809814
13307,4,1,1,2412,-77,-91,14,b8:3a:5a:88:e6:e1,82812293,2376,103,82809917,82812293
13308,6,6,1,2412,-78,-91,13,84:1b:5e:df:1b:99,82822003,80,9630,82821923,82822003
13309,6,12,1,2412,-59,-91,32,40:e3:d6:da:ba:20,82825995,160,3832,82825835,82825995
13310,6,6,1,2412,-59,-91,32,40:e3:d6:da:ba:21,82826214,368,-149,82825846,82826214
13311,6,12,1,2412,-59,-91,32,40:e3:d6:da:ba:22,82826619,180,225,82826439,82826619
13312,6,12,1,2412,-59,-91,32,40:e3:d6:da:ba:23,82826824,184,21,82826640,82826824
13313,6,12,1,2412,-60,-91,31,40:e3:d6:da:ba:24,82827043,176,43,82826867,82827043
13314,6,12,1,2412,-60,-91,31,40:e3:d6:da:ba:25,82827262,160,59,82827102,82827262
13315,6,6,1,2412,-59,-91,32,40:e3:d6:da:ba:26,82827463,380,-179,82827083,82827463
13316,4,1,1,2412,-79,-91,12,54:e4:3a:ec:fb:64,82884453,2160,54830,82882293,82884453
13317,6,6,1,2412,-70,-91,21,e6:aa:ea:c9:ea:33,82927730,408,42869,82927322,82927730
13318,6,12,1,2412,-58,-91,33,40:e3:d6:da:ba:20,82928392,160,502,82928232,82928392
13319,6,6,1,2412,-58,-91,33,40:e3:d6:da:ba:21,82928602,368,-158,82928234,82928602
13320,6,12,1,2412,-58,-91,33,40:e3:d6:da:ba:22,82929007,180,225,82928827,82929007
13321,6,12,1,2412,-63,-91,28,40:e3:d6:da:ba:23,82929231,184,40,82929047,82929231
13322,6,12,1,2412,-57,-91,34,40:e3:d6:da:ba:25,82929668,160,277,82929508,82929668
13323,6,6,1,2412,-63,-91,28,40:e3:d6:da:ba:26,82929887,380,-161,82929507,82929887
13324,4,1,1,2412,-85,-91,6,a6:e5:7c:28:b1:d3,82974396,992,43517,82973404,82974396
13325,4,1,1,2412,-77,-91,14,54:e4:3a:ec:fb:64,82986857,2160,10301,82984697,82986857
13326,6,6,1,2412,-75,-91,16,e6:aa:ea:b7:4a:dd,82999638,408,12373,82999230,82999638
13327,6,6,1,2412,-75,-91,16,e6:aa:ea:b7:4a:dd,83011760,408,11714,83011352,83011760
13328,4,1,1,2412,-82,-91,9,b8:3a:5a:88:e6:e1,83017001,2376,2865,83014625,83017001
13329,6,6,1,2412,-75,-91,16,e6:aa:ea:b7:4a:dd,83023877,408,6468,83023469,83023877
13330,6,12,1,2412,-64,-91,27,40:e3:d6:da:ba:20,83030782,160,6745,83030622,83030782
13331,6,12,1,2412,-64,-91,27,40:e3:d6:da:ba:22,83031370,180,408,83031190,83031370
13332,6,12,1,2412,-56,-91,35,40:e3:d6:da:ba:23,83031602,184,48,83031418,83031602
13333,6,12,1,2412,-63,-91,28,40:e3:d6:da:ba:24,83031839,176,61,83031663,83031839
13334,6,12,1,2412,-64,-91,27,40:e3:d6:da:ba:25,83032067,160,68,83031907,83032067
13335,6,6,1,2412,-64,-91,27,40:e3:d6:da:ba:26,83032286,380,-161,83031906,83032286
13336,4,1,1,2412,-88,-91,3,c0:c9:e3:4d:6e:bf,83097435,872,64277,83096563,83097435
13337,6,12,1,2412,-57,-91,34,40:e3:d6:da:ba:20,83133197,160,35602,83133037,83133197
13338,6,6,1,2412,-57,-91,34,40:e3:d6:da:ba:21,83133416,368,-149,83133048,83133416
13339,6,12,1,2412,-57,-91,34,40:e3:d6:da:ba:22,83133803,180,207,83133623,83133803
13340,6,12,1,2412,-57,-91,34,40:e3:d6:da:ba:23,83134017,184,30,83133833,83134017
13341,6,12,1,2412,-57,-91,34,40:e3:d6:da:ba:24,83134227,176,34,83134051,83134227
13342,6,12,1,2412,-57,-91,34,40:e3:d6:da:ba:25,83134455,160,68,83134295,83134455
13343,6,6,1,2412,-57,-91,34,40:e3:d6:da:ba:26,83134656,380,-179,83134276,83134656
13344,6,6,1,2412,-65,-91,26,e6:aa:ea:c9:ea:33,83206549,408,71485,83206141,83206549
13345,6,6,1,2412,-66,-91,25,e6:aa:ea:c9:ea:33,83218655,408,11698,83218247,83218655
13346,4,1,1,2412,-77,-91,14,b8:3a:5a:88:e6:e0,83220853,2360,-162,83218493,83220853
13347,6,6,1,2412,-66,-91,25,e6:aa:ea:c9:ea:33,83230790,408,9529,83230382,83230790
13348,6,12,1,2412,-62,-91,29,40:e3:d6:da:ba:20,83235572,160,4622,83235412,83235572
13349,6,6,1,2412,-62,-91,29,40:e3:d6:da:ba:21,83235763,368,-177,83235395,83235763
13350,6,12,1,2412,-62,-91,29,40:e3:d6:da:ba:22,83236168,180,225,83235988,83236168
13351,6,12,1,2412,-62,-91,29,40:e3:d6:da:ba:23,83236374,184,22,83236190,83236374
13352,6,12,1,2412,-59,-91,32,40:e3:d6:da:ba:24,83236584,176,34,83236408,83236584
13353,6,12,1,2412,-62,-91,29,40:e3:d6:da:ba:25,83236785,160,41,83236625,83236785
13354,6,6,1,2412,-62,-91,29,40:e3:d6:da:ba:26,83236995,380,-170,83236615,83236995
13355,6,6,1,2412,-66,-91,25,e6:aa:ea:c9:ea:33,83243060,408,5657,83242652,83243060
13356,6,6,1,2412,-67,-91,24,e6:aa:ea:c9:ea:33,83255028,408,11560,83254620,83255028
13357,4,1,1,2412,-65,-91,26,54:e4:3a:ec:fb:64,83294054,2160,36866,83291894,83294054
13358,4,1,1,2412,-74,-91,17,b8:3a:5a:88:e6:e0,83321798,2360,25384,83319438,83321798
13359,6,12,1,2412,-59,-91,32,40:e3:d6:da:ba:20,83338059,160,16101,83337899,83338059
13360,6,6,1,2412,-59,-91,32,40:e3:d6:da:ba:21,83338278,368,-149,83337910,83338278
13361,6,12,1,2412,-59,-91,32,40:e3:d6:da:ba:22,83338692,180,234,83338512,83338692
13362,6,12,1,2412,-59,-91,32,40:e3:d6:da:ba:23,83338898,184,22,83338714,83338898
13363,6,12,1,2412,-59,-91,32,40:e3:d6:da:ba:24,83339107,176,33,83338931,83339107
13364,6,12,1,2412,-59,-91,32,40:e3:d6:da:ba:25,83339309,160,42,83339149,83339309
13365,6,6,1,2412,-59,-91,32,40:e3:d6:da:ba:26,83339519,380,-170,83339139,83339519
13366,4,1,1,2412,-91,-91,0,,83365814,304,25991,83365510,83365814
13367,4,1,1,2412,-75,-91,16,b8:3a:5a:88:e6:e0,83366150,2240,-1904,83363910,83366150
13368,4,1,1,2412,-75,-91,16,b8:3a:5a:88:e6:e1,83368446,2256,40,83366190,83368446
13369,4,1,1,2412,-80,-91,11,54:e4:3a:ec:fb:64,83396465,2160,25859,83394305,83396465
13370,4,1,1,2412,-75,-91,16,b8:3a:5a:88:e6:e0,83424204,2360,25379,83421844,83424204
13371,4,1,1,2412,-75,-91,16,b8:3a:5a:88:e6:e1,83426611,2376,31,83424235,83426611
13372,4,1,1,2412,-92,-91,-1,a6:e5:7c:28:b1:d3,83437913,944,10358,83436969,83437913
13373,4,1,1,2412,-92,-91,-1,a6:e5:7c:28:b1:d3,83439000,944,143,83438056,83439000
13374,4,1,1,2412,-92,-91,-1,a6:e5:7c:28:b1:d3,83440096,944,152,83439152,83440096
13375,6,6,1,2412,-61,-91,30,40:e3:d6:da:ba:26,83442744,380,2268,83442364,83442744
13376,4,1,1,2412,-90,-91,1,a6:e5:7c:28:b1:d3,83445590,944,1902,83444646,83445590
13377,4,1,1,2412,-92,-91,-1,a6:e5:7c:28:b1:d3,83446668,944,134,83445724,83446668
13378,4,1,1,2412,-93,-91,-2,a6:e5:7c:28:b1:d3,83447746,944,134,83446802,83447746
13379,4,1,1,2412,-90,-91,1,a6:e5:7c:28:b1:d3,83448806,944,116,83447862,83448806
13380,6,6,1,2412,-72,-91,19,e6:aa:ea:b7:4a:dd,83507902,408,58688,83507494,83507902
13381,6,6,1,2412,-71,-91,20,e6:aa:ea:b7:4a:dd,83520021,408,11711,83519613,83520021
13382,6,6,1,2412,-69,-91,22,e6:aa:ea:c9:ea:33,83521732,408,1303,83521324,83521732
13383,4,1,1,2412,-76,-91,15,b8:3a:5a:88:e6:e0,83526610,2360,2518,83524250,83526610
13384,6,6,1,2412,-76,-91,15,e6:aa:ea:b7:4a:dd,83532315,408,5297,83531907,83532315
13385,6,6,1,2412,-68,-91,23,e6:aa:ea:c9:ea:33,83533856,408,1133,83533448,83533856
13386,6,12,1,2412,-61,-91,30,40:e3:d6:da:ba:20,83542789,160,8773,83542629,83542789
13387,6,6,1,2412,-61,-91,30,40:e3:d6:da:ba:21,83543023,368,-134,83542655,83543023
13388,6,12,1,2412,-61,-91,30,40:e3:d6:da:ba:22,83543429,180,226,83543249,83543429
13389,6,12,1,2412,-61,-91,30,40:e3:d6:da:ba:23,83543643,184,30,83543459,83543643
13390,6,12,1,2412,-61,-91,30,40:e3:d6:da:ba:24,83543880,176,61,83543704,83543880
13391,6,12,1,2412,-59,-91,32,40:e3:d6:da:ba:25,83544099,160,59,83543939,83544099
13392,6,6,1,2412,-61,-91,30,40:e3:d6:da:ba:26,83544318,380,-161,83543938,83544318
13393,6,6,1,2412,-71,-91,20,e6:aa:ea:b7:4a:dd,83556382,408,11656,83555974,83556382
13394,6,6,1,2412,-68,-91,23,e6:aa:ea:c9:ea:33,83558607,408,1817,83558199,83558607
13395,6,6,1,2412,-69,-91,22,e6:aa:ea:c9:ea:33,83570193,408,11178,83569785,83570193
13396,4,1,1,2412,-85,-91,6,b8:3a:5a:88:e6:e0,83606077,2240,33644,83603837,83606077
13397,4,1,1,2412,-85,-91,6,b8:3a:5a:88:e6:e1,83610067,2256,1734,83607811,83610067
13398,4,1,1,2412,-78,-91,13,b8:3a:5a:88:e6:e0,83628435,2240,16128,83626195,83628435
13399,4,1,1,2412,-76,-91,15,b8:3a:5a:88:e6:e0,83630704,2360,-91,83628344,83630704
13400,4,1,1,2412,-77,-91,14,b8:3a:5a:88:e6:e1,83633592,2376,512,83631216,83633592
13401,6,12,1,2412,-60,-91,31,40:e3:d6:da:ba:20,83645181,160,11429,83645021,83645181
13402,6,12,1,2412,-59,-91,32,40:e3:d6:da:ba:22,83645805,180,444,83645625,83645805
13403,6,12,1,2412,-60,-91,31,40:e3:d6:da:ba:25,83646449,160,484,83646289,83646449
13404,6,6,1,2412,-60,-91,31,40:e3:d6:da:ba:26,83646667,380,-162,83646287,83646667
13405,4,1,1,2412,-84,-91,7,b8:3a:5a:88:e6:e0,83731423,2360,82396,83729063,83731423
13406,6,12,1,2412,-59,-91,32,40:e3:d6:da:ba:20,83747573,160,15990,83747413,83747573
13407,6,6,1,2412,-59,-91,32,40:e3:d6:da:ba:21,83747783,368,-158,83747415,83747783
13408,6,12,1,2412,-59,-91,32,40:e3:d6:da:ba:22,83748170,180,207,83747990,83748170
13409,6,12,1,2412,-59,-91,32,40:e3:d6:da:ba:23,83748394,184,40,83748210,83748394
13410,6,12,1,2412,-59,-91,32,40:e3:d6:da:ba:24,83748603,176,33,83748427,83748603
13411,6,12,1,2412,-59,-91,32,40:e3:d6:da:ba:25,83748805,160,42,83748645,83748805
13412,4,1,1,2412,-79,-91,12,54:e4:3a:ec:fb:64,83805768,2160,54803,83803608,83805768
13413,4,1,1,2412,-78,-91,13,b8:3a:5a:88:e6:e0,83833799,2360,25671,83831439,83833799
13414,6,12,1,2412,-60,-91,31,40:e3:d6:da:ba:20,83860301,160,26342,83860141,83860301
13415,6,6,1,2412,-60,-91,31,40:e3:d6:da:ba:21,83860493,368,-176,83860125,83860493
13416,6,12,1,2412,-59,-91,32,40:e3:d6:da:ba:22,83860906,180,233,83860726,83860906
13417,6,12,1,2412,-59,-91,32,40:e3:d6:da:ba:23,83861155,184,65,83860971,83861155
13418,6,12,1,2412,-59,-91,32,40:e3:d6:da:ba:24,83861373,176,42,83861197,83861373
13419,6,12,1,2412,-59,-91,32,40:e3:d6:da:ba:25,83861575,160,42,83861415,83861575
13420,6,6,1,2412,-59,-91,32,40:e3:d6:da:ba:26,83861793,380,-162,83861413,83861793
13421,6,6,1,2412,-77,-91,14,e6:aa:ea:b7:4a:dd,83925585,408,63384,83925177,83925585
13422,4,1,1,2412,-85,-91,6,b8:3a:5a:88:e6:e1,83939404,2376,11443,83937028,83939404
13423,6,6,1,2412,-72,-91,19,e6:aa:ea:b7:4a:dd,83949867,408,10055,83949459,83949867
13424,6,6,1,2412,-59,-91,32,40:e3:d6:da:ba:26,83953891,380,3644,83953511,83953891
13425,6,6,1,2412,-77,-91,14,e6:aa:ea:b7:4a:dd,83974173,408,19874,83973765,83974173
13426,6,6,1,2412,-68,-91,23,e6:aa:ea:c9:ea:33,84053516,408,78935,84053108,84053516
13427,6,12,1,2412,-59,-91,32,40:e3:d6:da:ba:20,84054781,160,1105,84054621,84054781
13428,6,6,1,2412,-59,-91,32,40:e3:d6:da:ba:21,84054982,368,-167,84054614,84054982
13429,6,12,1,2412,-59,-91,32,40:e3:d6:da:ba:22,84055378,180,216,84055198,84055378
13430,6,12,1,2412,-60,-91,31,40:e3:d6:da:ba:23,84055602,184,40,84055418,84055602
13431,6,12,1,2412,-59,-91,32,40:e3:d6:da:ba:24,84055820,176,42,84055644,84055820
13432,6,12,1,2412,-59,-91,32,40:e3:d6:da:ba:25,84056031,160,51,84055871,84056031
13433,6,6,1,2412,-59,-91,32,40:e3:d6:da:ba:26,84056223,380,-188,84055843,84056223
13434,4,1,1,2412,-74,-91,17,24:f6:77:10:02:c8,84059491,1064,2204,84058427,84059491
13435,6,6,1,2412,-69,-91,22,e6:aa:ea:c9:ea:33,84065638,408,5739,84065230,84065638
13436,4,1,1,2412,-74,-91,17,24:f6:77:10:02:c8,84071309,1064,4607,84070245,84071309
13437,6,6,1,2412,-68,-91,23,e6:aa:ea:c9:ea:33,84077757,408,6040,84077349,84077757
13438,4,1,1,2412,-85,-91,6,,84088108,304,10047,84087804,84088108
13439,6,6,1,2412,-70,-91,21,e6:aa:ea:c9:ea:33,84089879,408,1363,84089471,84089879
13440,4,1,1,2412,-83,-91,8,54:e4:3a:ec:fb:64,84113282,2160,21243,84111122,84113282
13441,4,1,1,2412,-83,-91,8,b8:3a:5a:88:e6:e0,84141019,2360,25377,84138659,84141019
13442,6,12,1,2412,-59,-91,32,40:e3:d6:da:ba:20,84157202,160,16023,84157042,84157202
13443,6,6,1,2412,-66,-91,25,40:e3:d6:da:ba:21,84157403,368,-167,84157035,84157403
13444,6,12,1,2412,-59,-91,32,40:e3:d6:da:ba:22,84157799,180,216,84157619,84157799
13445,6,12,1,2412,-59,-91,32,40:e3:d6:da:ba:23,84158013,184,30,84157829,84158013
13446,6,12,1,2412,-59,-91,32,40:e3:d6:da:ba:24,84158223,176,34,84158047,84158223
13447,6,12,1,2412,-59,-91,32,40:e3:d6:da:ba:25,84158442,160,59,84158282,84158442
13448,6,6,1,2412,-59,-91,32,40:e3:d6:da:ba:26,84158643,380,-179,84158263,84158643
13449,4,1,1,2412,-76,-91,15,b8:3a:5a:88:e6:e0,84243406,2360,82403,84241046,84243406
13450,4,1,1,2412,-76,-91,15,b8:3a:5a:88:e6:e1,84245786,2376,4,84243410,84245786
13451,6,12,1,2412,-60,-91,31,40:e3:d6:da:ba:20,84259575,160,13629,84259415,84259575
13452,6,6,1,2412,-60,-91,31,40:e3:d6:da:ba:21,84259785,368,-158,84259417,84259785
13453,6,12,1,2412,-60,-91,31,40:e3:d6:da:ba:22,84260181,180,216,84260001,84260181
13454,6,12,1,2412,-58,-91,33,40:e3:d6:da:ba:23,84260421,184,56,84260237,84260421
13455,4,1,1,2412,-89,-91,2,a6:e5:7c:28:b1:d3,84305319,992,43906,84304327,84305319
13456,6,6,1,2412,-82,-91,9,e6:aa:ea:b7:4a:dd,84343800,408,38073,84343392,84343800
13457,4,1,1,2412,-81,-91,10,b8:3a:5a:88:e6:e0,84345802,2360,-358,84343442,84345802
13458,4,1,1,2412,-83,-91,8,b8:3a:5a:88:e6:e1,84348200,2376,22,84345824,84348200
13459,6,6,1,2412,-75,-91,16,e6:aa:ea:b7:4a:dd,84355907,408,7299,84355499,84355907
13460,6,6,1,2412,-71,-91,20,e6:aa:ea:b7:4a:dd,84368021,408,11706,84367613,84368021
13461,6,6,1,2412,-71,-91,20,e6:aa:ea:b7:4a:dd,84380227,408,11798,84379819,84380227
13462,6,6,1,2412,-71,-91,20,e6:aa:ea:b7:4a:dd,84392433,408,11798,84392025,84392433
13463,4,1,1,2412,-87,-91,4,a6:e5:7c:28:b1:d3,84407485,992,14060,84406493,84407485
13464,6,12,1,2412,-59,-91,32,40:e3:d6:da:ba:20,84464404,160,56759,84464244,84464404
13465,6,6,1,2412,-59,-91,32,40:e3:d6:da:ba:21,84464614,368,-158,84464246,84464614
13466,6,12,1,2412,-58,-91,33,40:e3:d6:da:ba:22,84465019,180,225,84464839,84465019
13467,6,12,1,2412,-58,-91,33,40:e3:d6:da:ba:23,84465259,184,56,84465075,84465259
13468,6,12,1,2412,-58,-91,33,40:e3:d6:da:ba:24,84465469,176,34,84465293,84465469
13469,6,12,1,2412,-58,-91,33,40:e3:d6:da:ba:25,84465697,160,68,84465537,84465697
13470,6,6,1,2412,-58,-91,33,40:e3:d6:da:ba:26,84465898,380,-179,84465518,84465898
13471,4,1,1,2412,-79,-91,12,54:e4:3a:ec:fb:64,84522853,2160,54795,84520693,84522853
13472,4,1,1,2412,-87,-91,4,c0:c9:e3:4d:6e:bf,84537392,872,13667,84536520,84537392
13473,4,1,1,2412,-76,-91,15,b8:3a:5a:88:e6:e0,84550621,2360,10869,84548261,84550621
13474,4,1,1,2412,-76,-91,15,b8:3a:5a:88:e6:e1,84553027,2376,30,84550651,84553027
13475,6,12,1,2412,-59,-91,32,40:e3:d6:da:ba:20,84566798,160,13611,84566638,84566798
13476,6,6,1,2412,-58,-91,33,40:e3:d6:da:ba:21,84567017,368,-149,84566649,84567017
13477,6,12,1,2412,-59,-91,32,40:e3:d6:da:ba:22,84567422,180,225,84567242,84567422
13478,6,12,1,2412,-59,-91,32,40:e3:d6:da:ba:23,84567627,184,21,84567443,84567627
13479,6,6,1,2412,-58,-91,33,40:e3:d6:da:ba:26,84568257,380,250,84567877,84568257
13480,6,6,1,2412,-66,-91,25,e6:aa:ea:c9:ea:33,84586303,408,17638,84585895,84586303
13481,6,6,1,2412,-66,-91,25,e6:aa:ea:c9:ea:33,84598539,408,11828,84598131,84598539
13482,6,6,1,2412,-70,-91,21,e6:aa:ea:c9:ea:33,84610519,408,11572,84610111,84610519
13483,4,1,1,2412,-85,-91,6,a6:e5:7c:28:b1:d3,84613053,992,1542,84612061,84613053
13484,4,1,1,2412,-80,-91,11,54:e4:3a:ec:fb:64,84625259,2160,10046,84623099,84625259
13485,4,1,1,2412,-77,-91,14,b8:3a:5a:88:e6:e0,84653001,2360,25382,84650641,84653001
13486,4,1,1,2412,-76,-91,15,b8:3a:5a:88:e6:e1,84655399,2376,22,84653023,84655399
13487,6,12,1,2412,-61,-91,30,40:e3:d6:da:ba:20,84669201,160,13642,84669041,84669201
13488,6,6,1,2412,-59,-91,32,40:e3:d6:da:ba:21,84669402,368,-167,84669034,84669402
13489,6,12,1,2412,-59,-91,32,40:e3:d6:da:ba:22,84669789,180,207,84669609,84669789
13490,6,12,1,2412,-59,-91,32,40:e3:d6:da:ba:23,84670022,184,49,84669838,84670022
13491,6,12,1,2412,-59,-91,32,40:e3:d6:da:ba:24,84670231,176,33,84670055,84670231
13492,6,12,1,2412,-59,-91,32,40:e3:d6:da:ba:25,84670433,160,42,84670273,84670433
13493,4,1,1,2412,-89,-91,2,a6:e5:7c:28:b1:d3,84715205,992,43780,84714213,84715205
13494,4,1,1,2412,-81,-91,10,54:e4:3a:ec:fb:64,84727666,2160,10301,84725506,84727666
13495,4,1,1,2412,-77,-91,14,b8:3a:5a:88:e6:e0,84755421,2360,25395,84753061,84755421
13496,4,1,1,2412,-77,-91,14,b8:3a:5a:88:e6:e1,84757917,2376,120,84755541,84757917
13497,6,12,1,2412,-58,-91,33,40:e3:d6:da:ba:20,84771586,160,13509,84771426,84771586
13498,6,6,1,2412,-58,-91,33,40:e3:d6:da:ba:21,84771805,368,-149,84771437,84771805
13499,6,12,1,2412,-58,-91,33,40:e3:d6:da:ba:22,84772192,180,207,84772012,84772192
13500,6,12,1,2412,-57,-91,34,40:e3:d6:da:ba:23,84772415,184,39,84772231,84772415
13501,6,12,1,2412,-58,-91,33,40:e3:d6:da:ba:24,84772633,176,42,84772457,84772633
13502,6,12,1,2412,-58,-91,33,40:e3:d6:da:ba:25,84772835,160,42,84772675,84772835
13503,6,6,1,2412,-58,-91,33,40:e3:d6:da:ba:26,84773054,380,-161,84772674,84773054
13504,4,1,1,2412,-88,-91,3,a6:e5:7c:28:b1:d3,84817366,992,43320,84816374,84817366
13505,4,1,1,2412,-84,-91,7,54:e4:3a:ec:fb:64,84830074,2160,10548,84827914,84830074
13506,6,6,1,2412,-76,-91,15,e6:aa:ea:b7:4a:dd,84864088,408,33606,84863680,84864088
13507,6,12,1,2412,-58,-91,33,40:e3:d6:da:ba:20,84884244,160,19996,84884084,84884244
13508,6,6,1,2412,-58,-91,33,40:e3:d6:da:ba:21,84884445,368,-167,84884077,84884445
13509,6,12,1,2412,-58,-91,33,40:e3:d6:da:ba:22,84884832,180,207,84884652,84884832
13510,6,12,1,2412,-58,-91,33,40:e3:d6:da:ba:23,84885046,184,30,84884862,84885046
13511,6,12,1,2412,-57,-91,34,40:e3:d6:da:ba:24,84885256,176,34,84885080,84885256
13512,6,12,1,2412,-58,-91,33,40:e3:d6:da:ba:25,84885466,160,50,84885306,84885466
13513,6,6,1,2412,-58,-91,33,40:e3:d6:da:ba:26,84885685,380,-161,84885305,84885685
13514,6,6,1,2412,-74,-91,17,e6:aa:ea:b7:4a:dd,84888268,408,2175,84887860,84888268
13515,6,6,1,2412,-75,-91,16,e6:aa:ea:b7:4a:dd,84900374,408,11698,84899966,84900374
13516,6,6,1,2412,-74,-91,17,e6:aa:ea:b7:4a:dd,84912495,408,11713,84912087,84912495
13517,4,1,1,2412,-51,-91,40,02:0f:2b:b6:51:ff,84916370,960,2915,84915410,84916370
13518,4,1,1,2412,-80,-91,11,54:e4:3a:ec:fb:64,84917446,2112,-1036,84915334,84917446
13519,4,1,1,2412,-51,-91,40,,84921902,304,4152,84921598,84921902
13520,6,12,1,2412,-58,-91,33,40:e3:d6:da:ba:20,84922065,136,27,84921929,84922065
13521,6,12,1,2412,-55,-91,36,,84922220,32,123,84922188,84922220
13522,6,6,1,2412,-58,-91,33,40:e3:d6:da:ba:21,84922307,348,-261,84921959,84922307
13523,6,6,1,2412,-56,-91,35,,84922674,44,323,84922630,84922674
13524,6,12,1,2412,-58,-91,33,40:e3:d6:da:ba:22,84922760,156,-70,84922604,84922760
13525,6,12,1,2412,-60,-91,31,,84922934,32,142,84922902,84922934
13526,6,12,1,2412,-59,-91,32,40:e3:d6:da:ba:23,84922977,156,-113,84922821,84922977
13527,4,1,1,2412,-80,-91,11,54:e4:3a:ec:fb:64,84932480,2160,7343,84930320,84932480
13528,4,1,1,2412,-59,-91,32,02:0f:2b:b6:51:ff,84936588,960,3148,84935628,84936588
13529,4,1,1,2412,-80,-91,11,54:e4:3a:ec:fb:64,84937663,2112,-1037,84935551,84937663
13530,6,12,1,2412,-58,-91,33,40:e3:d6:da:ba:20,84942241,136,4442,84942105,84942241
13531,6,6,1,2412,-58,-91,33,40:e3:d6:da:ba:21,84942445,348,-144,84942097,84942445
13532,6,12,1,2412,-58,-91,33,40:e3:d6:da:ba:22,84942848,156,247,84942692,84942848
13533,6,12,1,2412,-58,-91,33,40:e3:d6:da:ba:23,84943039,156,35,84942883,84943039
13534,6,12,1,2412,-58,-91,33,40:e3:d6:da:ba:25,84943256,136,81,84943120,84943256
13535,4,1,1,2412,-80,-91,11,54:e4:3a:ec:fb:64,84946711,2112,1343,84944599,84946711
13536,4,1,1,2412,-78,-91,13,b8:3a:5a:88:e6:e0,84960897,2360,11826,84958537,84960897
13537,4,1,1,2412,-78,-91,13,b8:3a:5a:88:e6:e1,84963460,2376,187,84961084,84963460
13538,6,12,1,2412,-58,-91,33,40:e3:d6:da:ba:20,84976413,160,12793,84976253,84976413
13539,6,6,1,2412,-58,-91,33,40:e3:d6:da:ba:21,84976632,368,-149,84976264,84976632
13540,6,12,1,2412,-58,-91,33,40:e3:d6:da:ba:22,84977019,180,207,84976839,84977019
13541,6,12,1,2412,-58,-91,33,40:e3:d6:da:ba:23,84977234,184,31,84977050,84977234
13542,6,12,1,2412,-58,-91,33,40:e3:d6:da:ba:24,84977470,176,60,84977294,84977470
13543,6,12,1,2412,-58,-91,33,40:e3:d6:da:ba:25,84977698,160,68,84977538,84977698
13544,6,6,1,2412,-58,-91,33,40:e3:d6:da:ba:26,84977899,380,-179,84977519,84977899
13545,4,1,1,2412,-92,-91,-1,c0:c9:e3:4d:6e:bf,85033542,872,54771,85032670,85033542
13546,4,1,1,2412,-79,-91,12,54:e4:3a:ec:fb:64,85034642,2160,-1060,85032482,85034642
13547,6,6,1,2412,-60,-91,31,40:e3:d6:da:ba:21,85052744,348,17754,85052396,85052744
13548,6,12,1,2412,-60,-91,31,40:e3:d6:da:ba:25,85053597,136,717,85053461,85053597
13549,4,1,1,2412,-79,-91,12,b8:3a:5a:88:e6:e1,85065639,2376,9666,85063263,85065639
13550,6,12,1,2412,-58,-91,33,40:e3:d6:da:ba:20,85071493,136,5718,85071357,85071493
13551,6,6,1,2412,-57,-91,34,40:e3:d6:da:ba:21,85071679,348,-162,85071331,85071679
13552,6,12,1,2412,-58,-91,33,40:e3:d6:da:ba:22,85072064,156,229,85071908,85072064
13553,6,12,1,2412,-58,-91,33,40:e3:d6:da:ba:23,85072263,156,43,85072107,85072263
13554,6,12,1,2412,-58,-91,33,40:e3:d6:da:ba:25,85072472,136,73,85072336,85072472
13555,6,12,1,2412,-58,-91,33,40:e3:d6:da:ba:22,85079785,180,7133,85079605,85079785
13556,6,12,1,2412,-58,-91,33,40:e3:d6:da:ba:23,85079990,184,21,85079806,85079990
13557,6,12,1,2412,-58,-91,33,40:e3:d6:da:ba:24,85080200,176,34,85080024,85080200
13558,6,12,1,2412,-58,-91,33,40:e3:d6:da:ba:25,85080428,160,68,85080268,85080428
13559,6,6,1,2412,-58,-91,33,40:e3:d6:da:ba:26,85080638,380,-170,85080258,85080638
13560,6,6,1,2412,-69,-91,22,e6:aa:ea:c9:ea:33,85083835,408,2789,85083427,85083835
13561,6,6,1,2412,-66,-91,25,e6:aa:ea:c9:ea:33,85108065,408,23822,85107657,85108065
13562,6,6,1,2412,-70,-91,21,e6:aa:ea:c9:ea:33,85132292,408,23819,85131884,85132292
13563,4,1,1,2412,-78,-91,13,54:e4:3a:ec:fb:64,85137277,2160,2825,85135117,85137277
13564,6,12,1,2412,-61,-91,30,40:e3:d6:da:ba:20,85181184,160,43747,85181024,85181184
13565,6,6,1,2412,-86,-91,5,40:e3:d6:da:ba:21,85181393,368,-159,85181025,85181393
13566,6,12,1,2412,-60,-91,31,40:e3:d6:da:ba:23,85181995,184,418,85181811,85181995
13567,6,12,1,2412,-60,-91,31,40:e3:d6:da:ba:24,85182280,176,109,85182104,85182280
13568,4,1,1,2412,-82,-91,9,b8:3a:5a:88:e6:e0,85267477,2360,82837,85265117,85267477
13569,6,12,1,2412,-60,-91,31,40:e3:d6:da:ba:20,85283581,160,15944,85283421,85283581
13570,6,6,1,2412,-60,-91,31,40:e3:d6:da:ba:21,85283799,368,-150,85283431,85283799
13571,6,12,1,2412,-60,-91,31,40:e3:d6:da:ba:22,85284214,180,235,85284034,85284214
13572,6,12,1,2412,-58,-91,33,40:e3:d6:da:ba:25,85284866,160,492,85284706,85284866
13573,6,6,1,2412,-58,-91,33,40:e3:d6:da:ba:26,85285058,380,-188,85284678,85285058
13574,6,6,1,2412,-85,-91,6,78:8a:20:fa:27:f9,85286704,88,1558,85286616,85286704
13575,4,1,1,2412,-81,-91,10,b8:3a:5a:88:e6:e0,85287211,2240,-1733,85284971,85287211
13576,4,1,1,2412,-80,-91,11,b8:3a:5a:88:e6:e1,85289480,2256,13,85287224,85289480
13577,6,12,1,2412,-80,-91,11,,85291738,32,2226,85291706,85291738
13578,6,12,1,2412,-80,-91,11,,85291999,32,229,85291967,85291999
13579,6,6,1,2412,-85,-91,6,78:8a:20:fa:27:f9,85336352,88,44265,85336264,85336352
13580,4,1,1,2412,-73,-91,18,b8:3a:5a:88:e6:e1,85339153,2256,545,85336897,85339153
13581,4,1,1,2412,-78,-91,13,54:e4:3a:ec:fb:64,85342061,2160,748,85339901,85342061
13582,4,1,1,2412,-83,-91,8,b8:3a:5a:88:e6:e0,85369813,2360,25392,85367453,85369813
13583,6,6,1,2412,-72,-91,19,e6:aa:ea:b7:4a:dd,85383311,408,13090,85382903,85383311
13584,6,12,1,2412,-59,-91,32,40:e3:d6:da:ba:22,85386592,180,3101,85386412,85386592
13585,6,12,1,2412,-59,-91,32,40:e3:d6:da:ba:23,85386824,184,48,85386640,85386824
13586,6,12,1,2412,-58,-91,33,40:e3:d6:da:ba:24,85387034,176,34,85386858,85387034
13587,6,12,1,2412,-58,-91,33,40:e3:d6:da:ba:25,85387235,160,41,85387075,85387235
13588,6,6,1,2412,-58,-91,33,40:e3:d6:da:ba:26,85387427,380,-188,85387047,85387427
13589,6,6,1,2412,-71,-91,20,e6:aa:ea:b7:4a:dd,85395431,408,7596,85395023,85395431
13590,6,6,1,2412,-78,-91,13,e6:aa:ea:b7:4a:dd,85419665,408,23826,85419257,85419665
13591,6,6,1,2412,-79,-91,12,e6:aa:ea:b7:4a:dd,85431782,408,11709,85431374,85431782
13592,4,1,1,2412,-77,-91,14,54:e4:3a:ec:fb:64,85444154,2160,10212,85441994,85444154
13593,4,1,1,2412,-83,-91,8,b8:3a:5a:88:e6:e1,85474594,2376,28064,85472218,85474594
13594,6,12,1,2412,-59,-91,32,40:e3:d6:da:ba:20,85488392,160,13638,85488232,85488392
13595,6,6,1,2412,-59,-91,32,40:e3:d6:da:ba:21,85488584,368,-176,85488216,85488584
13596,6,12,1,2412,-59,-91,32,40:e3:d6:da:ba:22,85488998,180,234,85488818,85488998
13597,6,12,1,2412,-59,-91,32,40:e3:d6:da:ba:23,85489221,184,39,85489037,85489221
13598,6,12,1,2412,-59,-91,32,40:e3:d6:da:ba:24,85489449,176,52,85489273,85489449
13599,6,12,1,2412,-59,-91,32,40:e3:d6:da:ba:25,85489717,160,108,85489557,85489717
13600,6,6,1,2412,-59,-91,32,40:e3:d6:da:ba:26,85489927,380,-170,85489547,85489927
13601,6,6,1,2412,-63,-91,28,e6:aa:ea:c9:ea:33,85513748,408,23413,85513340,85513748
13602,6,6,1,2412,-67,-91,24,e6:aa:ea:c9:ea:33,85525864,408,11708,85525456,85525864
13603,4,1,1,2412,-88,-91,3,c0:c9:e3:4d:6e:bf,85528210,872,1474,85527338,85528210
13604,4,1,1,2412,-93,-91,-2,,85529099,304,585,85528795,85529099
13605,6,6,1,2412,-64,-91,27,e6:aa:ea:c9:ea:33,85537977,408,8470,85537569,85537977
13606,4,1,1,2412,-78,-91,13,54:e4:3a:ec:fb:64,85546672,2160,6535,85544512,85546672
13607,6,6,1,2412,-63,-91,28,e6:aa:ea:c9:ea:33,85550272,408,3192,85549864,85550272
13608,4,1,1,2412,-79,-91,12,b8:3a:5a:88:e6:e1,85577024,2376,24376,85574648,85577024
13609,6,12,1,2412,-60,-91,31,40:e3:d6:da:ba:20,85590795,160,13611,85590635,85590795
13610,6,6,1,2412,-59,-91,32,40:e3:d6:da:ba:21,85590996,368,-167,85590628,85590996
13611,6,12,1,2412,-59,-91,32,40:e3:d6:da:ba:22,85591392,180,216,85591212,85591392
13612,6,12,1,2412,-59,-91,32,40:e3:d6:da:ba:23,85591625,184,49,85591441,85591625
13613,6,12,1,2412,-59,-91,32,40:e3:d6:da:ba:24,85591843,176,42,85591667,85591843
13614,6,12,1,2412,-59,-91,32,40:e3:d6:da:ba:25,85592054,160,51,85591894,85592054
13615,6,6,1,2412,-59,-91,32,40:e3:d6:da:ba:26,85592273,380,-161,85591893,85592273
13616,4,1,1,2412,-78,-91,13,54:e4:3a:ec:fb:64,85649199,2160,54766,85647039,85649199
13617,4,1,1,2412,-83,-91,8,b8:3a:5a:88:e6:e1,85679693,2376,28118,85677317,85679693
13618,6,6,1,2412,-60,-91,31,40:e3:d6:da:ba:21,85693381,368,13320,85693013,85693381
13619,6,12,1,2412,-59,-91,32,40:e3:d6:da:ba:22,85693786,180,225,85693606,85693786
13620,6,12,1,2412,-60,-91,31,40:e3:d6:da:ba:23,85694000,184,30,85693816,85694000
13621,6,12,1,2412,-60,-91,31,40:e3:d6:da:ba:25,85694429,160,269,85694269,85694429
13622,6,6,1,2412,-60,-91,31,40:e3:d6:da:ba:26,85694639,380,-170,85694259,85694639
13623,6,6,1,2412,-84,-91,7,84:1b:5e:df:1b:99,85736593,80,41874,85736513,85736593
13624,4,1,1,2412,-83,-91,8,b8:3a:5a:88:e6:e0,85779428,2360,40475,85777068,85779428
13625,6,12,1,2412,-60,-91,31,40:e3:d6:da:ba:20,85795587,160,15999,85795427,85795587
13626,6,6,1,2412,-60,-91,31,40:e3:d6:da:ba:21,85795779,368,-176,85795411,85795779
13627,6,12,1,2412,-60,-91,31,40:e3:d6:da:ba:22,85796175,180,216,85795995,85796175
13628,6,12,1,2412,-60,-91,31,40:e3:d6:da:ba:23,85796427,184,68,85796243,85796427
13629,4,1,1,2412,-80,-91,11,54:e4:3a:ec:fb:64,85845420,2112,46881,85843308,85845420
13630,4,1,1,2412,-89,-91,2,,85852613,304,6889,85852309,85852613
13631,4,1,1,2412,-79,-91,12,54:e4:3a:ec:fb:64,85853886,2160,-887,85851726,85853886
13632,6,12,1,2412,-59,-91,32,40:e3:d6:da:ba:20,85897993,160,43947,85897833,85897993
13633,6,6,1,2412,-59,-91,32,40:e3:d6:da:ba:21,85898185,368,-176,85897817,85898185
13634,6,12,1,2412,-59,-91,32,40:e3:d6:da:ba:22,85898590,180,225,85898410,85898590
13635,6,12,1,2412,-60,-91,31,40:e3:d6:da:ba:23,85898814,184,40,85898630,85898814
13636,6,12,1,2412,-59,-91,32,40:e3:d6:da:ba:24,85899023,176,33,85898847,85899023
13637,6,12,1,2412,-59,-91,32,40:e3:d6:da:ba:25,85899234,160,51,85899074,85899234
13638,6,6,1,2412,-70,-91,21,e6:aa:ea:b7:4a:dd,85903181,408,3539,85902773,85903181
13639,6,6,1,2412,-71,-91,20,e6:aa:ea:b7:4a:dd,85915302,408,11713,85914894,85915302
13640,6,12,1,2412,-60,-91,31,40:e3:d6:da:ba:20,85926514,136,11076,85926378,85926514
13641,6,6,1,2412,-59,-91,32,40:e3:d6:da:ba:21,85926691,348,-171,85926343,85926691
13642,6,12,1,2412,-60,-91,31,40:e3:d6:da:ba:22,85927067,156,220,85926911,85927067
13643,6,12,1,2412,-59,-91,32,40:e3:d6:da:ba:23,85927258,156,35,85927102,85927258
13644,6,12,1,2412,-59,-91,32,40:e3:d6:da:ba:25,85927457,136,63,85927321,85927457
13645,6,6,1,2412,-76,-91,15,e6:aa:ea:b7:4a:dd,85928015,408,150,85927607,85928015
13646,6,6,1,2412,-71,-91,20,e6:aa:ea:b7:4a:dd,85951658,408,23235,85951250,85951658
13647,4,1,1,2412,-78,-91,13,0e:52:ec:fd:25:0d,85982749,1128,29963,85981621,85982749
13648,6,12,1,2412,-60,-91,31,40:e3:d6:da:ba:20,85987164,136,4279,85987028,85987164
13649,4,1,1,2412,-79,-91,12,54:e4:3a:ec:fb:64,85988056,2112,-1220,85985944,85988056
13650,6,12,1,2412,-60,-91,31,40:e3:d6:da:ba:22,85992720,156,4508,85992564,85992720
13651,6,12,1,2412,-58,-91,33,40:e3:d6:da:ba:25,85993127,136,271,85992991,85993127
13652,6,12,1,2412,-59,-91,32,40:e3:d6:da:ba:20,85993325,136,62,85993189,85993325
13653,6,12,1,2412,-59,-91,32,40:e3:d6:da:ba:22,85993896,156,415,85993740,85993896
13654,6,12,1,2412,-78,-91,13,,85994068,32,140,85994036,85994068
13655,6,12,1,2412,-60,-91,31,40:e3:d6:da:ba:23,85994142,156,-82,85993986,85994142
13656,6,12,1,2412,-59,-91,32,40:e3:d6:da:ba:25,85994359,136,81,85994223,85994359
13657,4,1,1,2412,-79,-91,12,54:e4:3a:ec:fb:64,85995808,2112,-663,85993696,85995808
13658,6,12,1,2412,-60,-91,31,40:e3:d6:da:ba:20,86000389,160,4421,86000229,86000389
13659,6,12,1,2412,-56,-91,35,40:e3:d6:da:ba:23,86001225,184,652,86001041,86001225
13660,6,12,1,2412,-59,-91,32,40:e3:d6:da:ba:24,86001444,176,43,86001268,86001444
13661,4,1,1,2412,-87,-91,4,c0:c9:e3:4d:6e:bf,86018841,872,16525,86017969,86018841
13662,6,6,1,2412,-73,-91,18,e6:aa:ea:c9:ea:33,86033636,408,14387,86033228,86033636
13663,6,6,1,2412,-64,-91,27,e6:aa:ea:c9:ea:33,86045747,408,11703,86045339,86045747
13664,6,6,1,2412,-64,-91,27,e6:aa:ea:c9:ea:33,86057852,408,11697,86057444,86057852
13665,4,1,1,2412,-78,-91,13,54:e4:3a:ec:fb:64,86058549,2160,-1463,86056389,86058549
13666,6,6,1,2412,-64,-91,27,e6:aa:ea:c9:ea:33,86070151,408,11194,86069743,86070151
13667,4,1,1,2412,-84,-91,7,b8:3a:5a:88:e6:e0,86087213,2360,14702,86084853,86087213
13668,4,1,1,2412,-84,-91,7,b8:3a:5a:88:e6:e1,86089611,2376,22,86087235,86089611
13669,6,12,1,2412,-58,-91,33,40:e3:d6:da:ba:20,86102798,160,13027,86102638,86102798
13670,6,6,1,2412,-58,-91,33,40:e3:d6:da:ba:21,86102990,368,-176,86102622,86102990
13671,6,12,1,2412,-58,-91,33,40:e3:d6:da:ba:22,86103395,180,225,86103215,86103395
13672,6,12,1,2412,-58,-91,33,40:e3:d6:da:ba:23,86103600,184,21,86103416,86103600
13673,6,12,1,2412,-58,-91,33,40:e3:d6:da:ba:24,86103853,176,77,86103677,86103853
13674,6,12,1,2412,-58,-91,33,40:e3:d6:da:ba:25,86104063,160,50,86103903,86104063
13675,6,6,1,2412,-58,-91,33,40:e3:d6:da:ba:26,86104255,380,-188,86103875,86104255
13676,6,12,1,2412,-57,-91,34,40:e3:d6:da:ba:20,86205198,160,100783,86205038,86205198
13677,6,6,1,2412,-57,-91,34,40:e3:d6:da:ba:21,86205399,368,-167,86205031,86205399
13678,6,12,1,2412,-57,-91,34,40:e3:d6:da:ba:22,86205804,180,225,86205624,86205804
13679,6,12,1,2412,-57,-91,34,40:e3:d6:da:ba:23,86206036,184,48,86205852,86206036
13680,6,12,1,2412,-57,-91,34,40:e3:d6:da:ba:24,86206264,176,52,86206088,86206264
13681,6,12,1,2412,-57,-91,34,40:e3:d6:da:ba:25,86206465,160,41,86206305,86206465
13682,6,6,1,2412,-58,-91,33,40:e3:d6:da:ba:26,86206657,380,-188,86206277,86206657
13683,6,6,1,2412,-74,-91,17,e6:aa:ea:b7:4a:dd,86242457,408,35392,86242049,86242457
13684,6,6,1,2412,-73,-91,18,e6:aa:ea:b7:4a:dd,86254577,408,11712,86254169,86254577
13685,6,6,1,2412,-72,-91,19,e6:aa:ea:b7:4a:dd,86266706,408,11721,86266298,86266706
13686,4,1,1,2412,-85,-91,6,b8:3a:5a:88:e6:e1,86294074,2376,24992,86291698,86294074
13687,6,12,1,2412,-57,-91,34,40:e3:d6:da:ba:20,86307595,160,13361,86307435,86307595
13688,6,6,1,2412,-57,-91,34,40:e3:d6:da:ba:21,86307830,368,-133,86307462,86307830
13689,6,12,1,2412,-57,-91,34,40:e3:d6:da:ba:22,86308235,180,225,86308055,86308235
13690,6,12,1,2412,-57,-91,34,40:e3:d6:da:ba:23,86308468,184,49,86308284,86308468
13691,6,12,1,2412,-57,-91,34,40:e3:d6:da:ba:24,86308704,176,60,86308528,86308704
13692,6,12,1,2412,-57,-91,34,40:e3:d6:da:ba:25,86308933,160,69,86308773,86308933
13693,6,6,1,2412,-57,-91,34,40:e3:d6:da:ba:26,86309152,380,-161,86308772,86309152
13694,4,1,1,2412,-81,-91,10,b8:3a:5a:88:e6:e1,86396295,2376,84767,86393919,86396295
13695,6,12,1,2412,-57,-91,34,40:e3:d6:da:ba:20,86409991,160,13536,86409831,86409991
13696,6,12,1,2412,-57,-91,34,40:e3:d6:da:ba:22,86410606,180,435,86410426,86410606
13697,6,12,1,2412,-57,-91,34,40:e3:d6:da:ba:23,86410830,184,40,86410646,86410830
13698,6,12,1,2412,-57,-91,34,40:e3:d6:da:ba:24,86411048,176,42,86410872,86411048
13699,6,12,1,2412,-57,-91,34,40:e3:d6:da:ba:25,86411250,160,42,86411090,86411250
13700,4,1,1,2412,-75,-91,16,54:e4:3a:ec:fb:64,86468494,2160,55084,86466334,86468494
13701,4,1,1,2412,-79,-91,12,b8:3a:5a:88:e6:e0,86498630,2360,27776,86496270,86498630
13702,6,6,1,2412,-69,-91,22,e6:aa:ea:c9:ea:33,86542619,408,43581,86542211,86542619
13703,4,1,1,2412,-86,-91,5,,86558978,304,16055,86558674,86558978
13704,4,1,1,2412,-88,-91,3,a6:e5:7c:28:b1:d3,86559325,992,-645,86558333,86559325
13705,6,6,1,2412,-68,-91,23,e6:aa:ea:c9:ea:33,86566855,408,7122,86566447,86566855
13706,6,6,1,2412,-68,-91,23,e6:aa:ea:c9:ea:33,86578982,408,11719,86578574,86578982
13707,6,6,1,2412,-68,-91,23,e6:aa:ea:c9:ea:33,86591282,408,11892,86590874,86591282
13708,6,12,1,2412,-56,-91,35,40:e3:d6:da:ba:20,86614786,160,23344,86614626,86614786
13709,6,6,1,2412,-56,-91,35,40:e3:d6:da:ba:21,86614978,368,-176,86614610,86614978
13710,6,12,1,2412,-56,-91,35,40:e3:d6:da:ba:24,86615798,176,644,86615622,86615798
13711,6,6,1,2412,-72,-91,19,e6:aa:ea:b7:4a:dd,86635196,408,18990,86634788,86635196
13712,4,1,1,2412,-86,-91,5,a4:e5:7c:28:b1:d3,86662565,688,26681,86661877,86662565
13713,4,1,1,2412,-80,-91,11,54:e4:3a:ec:fb:64,86673295,2160,8570,86671135,86673295
13714,6,6,1,2412,-71,-91,20,e6:aa:ea:b7:4a:dd,86683679,408,9976,86683271,86683679
13715,6,12,1,2412,-56,-91,35,40:e3:d6:da:ba:20,86717204,160,33365,86717044,86717204
13716,6,6,1,2412,-56,-91,35,40:e3:d6:da:ba:21,86717414,368,-158,86717046,86717414
13717,6,12,1,2412,-56,-91,35,40:e3:d6:da:ba:22,86717801,180,207,86717621,86717801
13718,6,12,1,2412,-56,-91,35,40:e3:d6:da:ba:23,86718006,184,21,86717822,86718006
13719,6,12,1,2412,-56,-91,35,40:e3:d6:da:ba:24,86718233,176,51,86718057,86718233
13720,6,12,1,2412,-56,-91,35,40:e3:d6:da:ba:25,86718435,160,42,86718275,86718435
13721,6,6,1,2412,-56,-91,35,40:e3:d6:da:ba:26,86718627,380,-188,86718247,86718627
13722,6,12,1,2412,-56,-91,35,40:e3:d6:da:ba:20,86819595,160,100808,86819435,86819595
13723,6,6,1,2412,-56,-91,35,40:e3:d6:da:ba:21,86819805,368,-158,86819437,86819805
13724,6,12,1,2412,-56,-91,35,40:e3:d6:da:ba:22,86820201,180,216,86820021,86820201
13725,6,12,1,2412,-56,-91,35,40:e3:d6:da:ba:23,86820434,184,49,86820250,86820434
13726,6,12,1,2412,-56,-91,35,40:e3:d6:da:ba:24,86820661,176,51,86820485,86820661
13727,6,12,1,2412,-56,-91,35,40:e3:d6:da:ba:25,86820889,160,68,86820729,86820889
13728,6,6,1,2412,-56,-91,35,40:e3:d6:da:ba:26,86821108,380,-161,86820728,86821108
13729,6,12,1,2412,-87,-91,4,40:e3:d6:da:c0:20,86893833,156,72569,86893677,86893833
13730,6,12,1,2412,-59,-91,32,40:e3:d6:da:ba:20,86922021,160,28028,86921861,86922021
13731,6,12,1,2412,-56,-91,35,40:e3:d6:da:ba:22,86922661,180,460,86922481,86922661
13732,6,12,1,2412,-57,-91,34,40:e3:d6:da:ba:24,86923085,176,248,86922909,86923085
13733,6,12,1,2412,-59,-91,32,40:e3:d6:da:ba:25,86923304,160,59,86923144,86923304
13734,6,6,1,2412,-59,-91,32,40:e3:d6:da:ba:26,86923496,380,-188,86923116,86923496
13735,6,12,1,2412,-90,-91,1,40:e3:d6:da:c0:22,86945449,156,21797,86945293,86945449
13736,6,6,1,2412,-74,-91,17,e6:aa:ea:b7:4a:dd,86950743,408,4886,86950335,86950743
13737,6,6,1,2412,-66,-91,25,e6:aa:ea:c9:ea:33,86960035,408,8884,86959627,86960035
13738,6,6,1,2412,-75,-91,16,e6:aa:ea:b7:4a:dd,86962816,408,2373,86962408,86962816
13739,4,1,1,2412,-76,-91,15,b8:3a:5a:88:e6:e1,86972804,2256,7732,86970548,86972804
13740,6,6,1,2412,-76,-91,15,e6:aa:ea:b7:4a:dd,86974927,408,1715,86974519,86974927
13741,6,6,1,2412,-66,-91,25,e6:aa:ea:c9:ea:33,86984004,408,8669,86983596,86984004
13742,6,6,1,2412,-74,-91,17,e6:aa:ea:b7:4a:dd,86987049,408,2637,86986641,86987049
13743,4,1,1,2412,-75,-91,16,b8:3a:5a:88:e6:e0,87014166,2240,24877,87011926,87014166
13744,4,1,1,2412,-75,-91,16,b8:3a:5a:88:e6:e1,87016453,2256,31,87014197,87016453
13745,6,12,1,2412,-61,-91,30,40:e3:d6:da:ba:23,87025207,184,8570,87025023,87025207
13746,4,1,1,2412,-75,-91,16,b8:3a:5a:88:e6:e0,87033925,2240,6478,87031685,87033925
13747,4,1,1,2412,-76,-91,15,b8:3a:5a:88:e6:e1,87036523,2256,342,87034267,87036523
13748,4,1,1,2412,-91,-91,0,,87082548,304,45721,87082244,87082548
13749,4,1,1,2412,-78,-91,13,54:e4:3a:ec:fb:64,87083034,2160,-1674,87080874,87083034
13750,4,1,1,2412,-74,-91,17,b8:3a:5a:88:e6:e0,87110806,2360,25412,87108446,87110806
13751,4,1,1,2412,-74,-91,17,b8:3a:5a:88:e6:e1,87113204,2376,22,87110828,87113204
13752,6,12,1,2412,-59,-91,32,40:e3:d6:da:ba:20,87126800,160,13436,87126640,87126800
13753,6,6,1,2412,-58,-91,33,40:e3:d6:da:ba:21,87126992,368,-176,87126624,87126992
13754,6,12,1,2412,-58,-91,33,40:e3:d6:da:ba:22,87127406,180,234,87127226,87127406
13755,6,12,1,2412,-58,-91,33,40:e3:d6:da:ba:23,87127629,184,39,87127445,87127629
13756,6,12,1,2412,-59,-91,32,40:e3:d6:da:ba:24,87127857,176,52,87127681,87127857
13757,6,12,1,2412,-59,-91,32,40:e3:d6:da:ba:25,87128085,160,68,87127925,87128085
13758,6,6,1,2412,-59,-91,32,40:e3:d6:da:ba:26,87128277,380,-188,87127897,87128277
13759,4,1,1,2412,-73,-91,18,b8:3a:5a:88:e6:e1,87166085,2256,35552,87163829,87166085
13760,4,1,1,2412,-87,-91,4,,87168354,304,1965,87168050,87168354
13761,4,1,1,2412,-78,-91,13,54:e4:3a:ec:fb:64,87185325,2160,14811,87183165,87185325
13762,6,12,1,2412,-62,-91,29,40:e3:d6:da:ba:20,87229189,160,43704,87229029,87229189
13763,6,6,1,2412,-62,-91,29,40:e3:d6:da:ba:21,87229381,368,-176,87229013,87229381
13764,6,12,1,2412,-62,-91,29,40:e3:d6:da:ba:22,87229777,180,216,87229597,87229777
13765,6,12,1,2412,-62,-91,29,40:e3:d6:da:ba:23,87229992,184,31,87229808,87229992
13766,6,12,1,2412,-62,-91,29,40:e3:d6:da:ba:24,87230201,176,33,87230025,87230201
13767,6,12,1,2412,-62,-91,29,40:e3:d6:da:ba:25,87230412,160,51,87230252,87230412
13768,6,6,1,2412,-62,-91,29,40:e3:d6:da:ba:26,87230622,380,-170,87230242,87230622
13769,4,1,1,2412,-80,-91,11,54:e4:3a:ec:fb:64,87287337,2160,54555,87285177,87287337
13770,4,1,1,2412,-79,-91,12,b8:3a:5a:88:e6:e1,87317982,2376,28269,87315606,87317982
13771,4,1,1,2412,-79,-91,12,b8:3a:5a:88:e6:e0,87324745,2240,4523,87322505,87324745
13772,4,1,1,2412,-80,-91,11,b8:3a:5a:88:e6:e1,87327023,2256,22,87324767,87327023
13773,6,12,1,2412,-64,-91,27,40:e3:d6:da:ba:20,87331824,160,4641,87331664,87331824
13774,6,6,1,2412,-64,-91,27,40:e3:d6:da:ba:21,87332034,368,-158,87331666,87332034
13775,4,1,1,2412,-90,-91,1,,87341375,304,9037,87341071,87341375
13776,6,12,1,2412,-74,-91,17,,87355274,32,13867,87355242,87355274
13777,4,1,1,2412,-78,-91,13,54:e4:3a:ec:fb:64,87355629,2112,-1757,87353517,87355629
13778,4,1,1,2412,-72,-91,19,,87357756,304,1823,87357452,87357756
13779,4,1,1,2412,-51,-91,40,b2:2d:bf:09:8b:e6,87373273,992,14525,87372281,87373273
13780,6,12,1,2412,-53,-91,38,40:e3:d6:da:ba:20,87374241,136,832,87374105,87374241
13781,6,6,1,2412,-51,-91,40,40:e3:d6:da:ba:21,87374475,348,-114,87374127,87374475
13782,6,12,1,2412,-56,-91,35,40:e3:d6:da:ba:22,87374918,156,287,87374762,87374918
13783,6,12,1,2412,-73,-91,18,,87375092,32,142,87375060,87375092
13784,4,1,1,2412,-77,-91,14,b8:3a:5a:88:e6:e0,87375690,2240,-1642,87373450,87375690
13785,6,6,1,2412,-69,-91,22,e6:aa:ea:c9:ea:33,87377810,408,1712,87377402,87377810
13786,6,12,1,2412,-64,-91,27,40:e3:d6:da:ba:23,87378247,156,281,87378091,87378247
13787,6,12,1,2412,-73,-91,18,,87378420,32,141,87378388,87378420
13788,6,12,1,2412,-63,-91,28,40:e3:d6:da:ba:25,87378492,136,-64,87378356,87378492
13789,6,12,1,2412,-74,-91,17,,87378645,32,121,87378613,87378645
13790,4,1,1,2412,-91,-91,0,a6:e5:7c:28:b1:d3,87383915,944,4326,87382971,87383915
13791,4,1,1,2412,-90,-91,1,a6:e5:7c:28:b1:d3,87385011,944,152,87384067,87385011
13792,4,1,1,2412,-81,-91,10,a6:e5:7c:28:b1:d3,87386062,944,107,87385118,87386062
13793,4,1,1,2412,-90,-91,1,a6:e5:7c:28:b1:d3,87387189,944,183,87386245,87387189
13794,4,1,1,2412,-87,-91,4,a6:e5:7c:28:b1:d3,87393832,944,5699,87392888,87393832
13795,4,1,1,2412,-76,-91,15,a6:e5:7c:28:b1:d3,87394885,944,109,87393941,87394885
13796,6,6,1,2412,-70,-91,21,e6:aa:ea:c9:ea:33,87414039,408,18746,87413631,87414039
13797,6,6,1,2412,-71,-91,20,e6:aa:ea:c9:ea:33,87426149,408,11702,87425741,87426149
13798,6,12,1,2412,-62,-91,29,40:e3:d6:da:ba:20,87434006,160,7697,87433846,87434006
13799,6,6,1,2412,-62,-91,29,40:e3:d6:da:ba:21,87434207,368,-167,87433839,87434207
13800,6,12,1,2412,-61,-91,30,40:e3:d6:da:ba:22,87434603,180,216,87434423,87434603
13801,6,12,1,2412,-62,-91,29,40:e3:d6:da:ba:23,87434817,184,30,87434633,87434817
13802,6,12,1,2412,-61,-91,30,40:e3:d6:da:ba:24,87435027,176,34,87434851,87435027
13803,6,12,1,2412,-62,-91,29,40:e3:d6:da:ba:25,87435228,160,41,87435068,87435228
13804,6,6,1,2412,-61,-91,30,40:e3:d6:da:ba:26,87435419,380,-189,87435039,87435419
13805,4,1,1,2412,-76,-91,15,32:ac:d4:78:25:95,87440557,1128,4010,87439429,87440557
13806,4,1,1,2412,-76,-91,15,54:e4:3a:ec:fb:64,87441797,2112,-872,87439685,87441797
13807,4,1,1,2412,-76,-91,15,54:e4:3a:ec:fb:64,87444073,2112,164,87441961,87444073
13808,6,12,1,2412,-61,-91,30,40:e3:d6:da:ba:20,87446359,136,2150,87446223,87446359
13809,6,12,1,2412,-76,-91,15,,87446511,32,120,87446479,87446511
13810,6,6,1,2412,-61,-91,30,40:e3:d6:da:ba:21,87446597,348,-262,87446249,87446597
13811,6,12,1,2412,-61,-91,30,40:e3:d6:da:ba:22,87446991,156,238,87446835,87446991
13812,6,12,1,2412,-61,-91,30,40:e3:d6:da:ba:23,87447215,156,68,87447059,87447215
13813,6,12,1,2412,-76,-91,15,,87447388,32,141,87447356,87447388
13814,6,12,1,2412,-61,-91,30,40:e3:d6:da:ba:25,87447450,136,-74,87447314,87447450
13815,6,12,1,2412,-76,-91,15,,87447602,32,120,87447570,87447602
13816,4,1,1,2412,-76,-91,15,54:e4:3a:ec:fb:64,87448850,2112,-864,87446738,87448850
13817,4,1,1,2412,-76,-91,15,,87453349,304,4195,87453045,87453349
13818,6,6,1,2412,-73,-91,18,e6:aa:ea:b7:4a:dd,87470730,408,16973,87470322,87470730
13819,6,6,1,2412,-74,-91,17,e6:aa:ea:b7:4a:dd,87482854,408,11716,87482446,87482854
13820,4,1,1,2412,-75,-91,16,54:e4:3a:ec:fb:64,87492479,2160,7465,87490319,87492479
13821,4,1,1,2412,-90,-91,1,c0:c9:e3:4d:6e:bf,87502879,872,9528,87502007,87502879
13822,4,1,1,2412,-92,-91,-1,,87503768,304,585,87503464,87503768
13823,6,6,1,2412,-75,-91,16,e6:aa:ea:b7:4a:dd,87519196,408,15020,87518788,87519196
13824,6,6,1,2412,-59,-91,32,40:e3:d6:da:ba:21,87536582,368,17018,87536214,87536582
13825,6,12,1,2412,-59,-91,32,40:e3:d6:da:ba:22,87536996,180,234,87536816,87536996
13826,6,12,1,2412,-59,-91,32,40:e3:d6:da:ba:23,87537202,184,22,87537018,87537202
13827,6,12,1,2412,-59,-91,32,40:e3:d6:da:ba:24,87537429,176,51,87537253,87537429
13828,6,6,1,2412,-59,-91,32,40:e3:d6:da:ba:26,87540094,380,2285,87539714,87540094
13829,4,1,1,2412,-73,-91,18,b8:3a:5a:88:e6:e0,87622625,2360,80171,87620265,87622625
13830,4,1,1,2412,-75,-91,16,b8:3a:5a:88:e6:e1,87625005,2376,4,87622629,87625005
13831,6,12,1,2412,-60,-91,31,40:e3:d6:da:ba:20,87638812,160,13647,87638652,87638812
13832,6,6,1,2412,-60,-91,31,40:e3:d6:da:ba:21,87639013,368,-167,87638645,87639013
13833,6,12,1,2412,-60,-91,31,40:e3:d6:da:ba:24,87639832,176,643,87639656,87639832
13834,6,12,1,2412,-60,-91,31,40:e3:d6:da:ba:25,87640043,160,51,87639883,87640043
13835,4,1,1,2412,-86,-91,5,a6:e5:7c:28:b1:d3,87684655,992,43620,87683663,87684655
13836,4,1,1,2412,-74,-91,17,54:e4:3a:ec:fb:64,87696934,2160,10119,87694774,87696934
13837,4,1,1,2412,-74,-91,17,b8:3a:5a:88:e6:e1,87727390,2376,28080,87725014,87727390
13838,6,12,1,2412,-60,-91,31,40:e3:d6:da:ba:20,87741215,160,13665,87741055,87741215
13839,6,6,1,2412,-60,-91,31,40:e3:d6:da:ba:21,87741434,368,-149,87741066,87741434
13840,6,12,1,2412,-60,-91,31,40:e3:d6:da:ba:22,87741848,180,234,87741668,87741848
13841,6,12,1,2412,-60,-91,31,40:e3:d6:da:ba:23,87742081,184,49,87741897,87742081
13842,6,12,1,2412,-60,-91,31,40:e3:d6:da:ba:24,87742299,176,42,87742123,87742299
13843,6,12,1,2412,-60,-91,31,40:e3:d6:da:ba:25,87742510,160,51,87742350,87742510
13844,6,6,1,2412,-78,-91,13,e6:aa:ea:b7:4a:dd,87785748,408,42830,87785340,87785748
13845,6,6,1,2412,-65,-91,26,e6:aa:ea:c9:ea:33,87795598,408,9442,87795190,87795598
13846,6,6,1,2412,-77,-91,14,e6:aa:ea:b7:4a:dd,87797861,408,1855,87797453,87797861
13847,6,6,1,2412,-65,-91,26,e6:aa:ea:c9:ea:33,87807723,408,9454,87807315,87807723
13848,6,6,1,2412,-65,-91,26,e6:aa:ea:c9:ea:33,87820118,408,11987,87819710,87820118
13849,6,6,1,2412,-80,-91,11,e6:aa:ea:b7:4a:dd,87822108,408,1582,87821700,87822108
13850,4,1,1,2412,-75,-91,16,b8:3a:5a:88:e6:e0,87827425,2360,2957,87825065,87827425
13851,4,1,1,2412,-76,-91,15,b8:3a:5a:88:e6:e1,87829823,2376,22,87827447,87829823
13852,6,6,1,2412,-65,-91,26,e6:aa:ea:c9:ea:33,87832089,408,1858,87831681,87832089
13853,6,12,1,2412,-59,-91,32,40:e3:d6:da:ba:20,87843612,160,11363,87843452,87843612
13854,6,6,1,2412,-59,-91,32,40:e3:d6:da:ba:21,87843813,368,-167,87843445,87843813
13855,6,12,1,2412,-59,-91,32,40:e3:d6:da:ba:22,87844218,180,225,87844038,87844218
13856,6,12,1,2412,-59,-91,32,40:e3:d6:da:ba:23,87844424,184,22,87844240,87844424
13857,6,6,1,2412,-65,-91,26,e6:aa:ea:c9:ea:33,87844648,408,-184,87844240,87844648
13858,6,12,1,2412,-59,-91,32,40:e3:d6:da:ba:24,87845103,176,279,87844927,87845103
13859,6,12,1,2412,-59,-91,32,40:e3:d6:da:ba:25,87845332,160,69,87845172,87845332
13860,6,6,1,2412,-59,-91,32,40:e3:d6:da:ba:26,87845533,380,-179,87845153,87845533
13861,4,1,1,2412,-75,-91,16,54:e4:3a:ec:fb:64,87901731,2160,54038,87899571,87901731
13862,4,1,1,2412,-74,-91,17,b8:3a:5a:88:e6:e1,87932526,2376,28419,87930150,87932526
13863,6,12,1,2412,-59,-91,32,40:e3:d6:da:ba:20,87946012,160,13326,87945852,87946012
13864,6,6,1,2412,-59,-91,32,40:e3:d6:da:ba:21,87946204,368,-176,87945836,87946204
13865,6,12,1,2412,-59,-91,32,40:e3:d6:da:ba:22,87946600,180,216,87946420,87946600
13866,6,12,1,2412,-59,-91,32,40:e3:d6:da:ba:23,87946833,184,49,87946649,87946833
13867,6,12,1,2412,-59,-91,32,40:e3:d6:da:ba:24,87947042,176,33,87946866,87947042
13868,6,6,1,2412,-58,-91,33,40:e3:d6:da:ba:26,87947480,380,58,87947100,87947480
13869,4,1,1,2412,-76,-91,15,b8:3a:5a:88:e6:e0,88032229,2360,82389,88029869,88032229
13870,4,1,1,2412,-75,-91,16,b8:3a:5a:88:e6:e1,88034627,2376,22,88032251,88034627
13871,4,1,1,2412,-77,-91,14,54:e4:3a:ec:fb:64,88037924,2160,1137,88035764,88037924
13872,4,1,1,2412,-92,-91,-1,,88045183,304,6955,88044879,88045183
13873,6,12,1,2412,-60,-91,31,40:e3:d6:da:ba:20,88048418,160,3075,88048258,88048418
13874,6,6,1,2412,-60,-91,31,40:e3:d6:da:ba:21,88048637,368,-149,88048269,88048637
13875,6,12,1,2412,-59,-91,32,40:e3:d6:da:ba:22,88049051,180,234,88048871,88049051
13876,6,12,1,2412,-59,-91,32,40:e3:d6:da:ba:23,88049265,184,30,88049081,88049265
13877,6,12,1,2412,-60,-91,31,40:e3:d6:da:ba:24,88049474,176,33,88049298,88049474
13878,6,12,1,2412,-59,-91,32,40:e3:d6:da:ba:25,88049703,160,69,88049543,88049703
13879,6,6,1,2412,-59,-91,32,40:e3:d6:da:ba:26,88049904,380,-179,88049524,88049904
13880,4,1,1,2412,-77,-91,14,54:e4:3a:ec:fb:64,88106883,2160,54819,88104723,88106883
13881,4,1,1,2412,-78,-91,13,b8:3a:5a:88:e6:e0,88134619,2360,25376,88132259,88134619
13882,4,1,1,2412,-77,-91,14,b8:3a:5a:88:e6:e1,88137025,2376,30,88134649,88137025
13883,6,12,1,2412,-62,-91,29,40:e3:d6:da:ba:22,88151390,180,14185,88151210,88151390
13884,6,12,1,2412,-62,-91,29,40:e3:d6:da:ba:24,88151805,176,239,88151629,88151805
13885,6,6,1,2412,-70,-91,21,40:e3:d6:da:ba:26,88152225,380,40,88151845,88152225
13886,6,6,1,2412,-71,-91,20,e6:aa:ea:c9:ea:33,88213417,408,60784,88213009,88213417
13887,6,6,1,2412,-70,-91,21,e6:aa:ea:c9:ea:33,88225551,408,11726,88225143,88225551
13888,6,12,1,2412,-63,-91,28,40:e3:d6:da:ba:20,88253193,160,27482,88253033,88253193
13889,6,12,1,2412,-63,-91,28,40:e3:d6:da:ba:22,88253799,180,426,88253619,88253799
13890,6,6,1,2412,-69,-91,22,e6:aa:ea:c9:ea:33,88261899,408,7692,88261491,88261899
13891,6,6,1,2412,-77,-91,14,e6:aa:ea:b7:4a:dd,88305562,408,43255,88305154,88305562
13892,6,6,1,2412,-77,-91,14,e6:aa:ea:b7:4a:dd,88317683,408,11713,88317275,88317683
13893,6,6,1,2412,-77,-91,14,e6:aa:ea:b7:4a:dd,88329798,408,11707,88329390,88329798
13894,6,6,1,2412,-78,-91,13,e6:aa:ea:b7:4a:dd,88354034,408,23828,88353626,88354034
13895,6,12,1,2412,-62,-91,29,40:e3:d6:da:ba:20,88355618,160,1424,88355458,88355618
13896,6,6,1,2412,-61,-91,30,40:e3:d6:da:ba:21,88355837,368,-149,88355469,88355837
13897,6,12,1,2412,-62,-91,29,40:e3:d6:da:ba:22,88356224,180,207,88356044,88356224
13898,6,12,1,2412,-62,-91,29,40:e3:d6:da:ba:23,88356429,184,21,88356245,88356429
13899,6,12,1,2412,-61,-91,30,40:e3:d6:da:ba:25,88356867,160,278,88356707,88356867
13900,6,6,1,2412,-61,-91,30,40:e3:d6:da:ba:26,88357086,380,-161,88356706,88357086
13901,4,1,1,2412,-81,-91,10,54:e4:3a:ec:fb:64,88413726,2160,54480,88411566,88413726
13902,6,12,1,2412,-61,-91,30,40:e3:d6:da:ba:20,88458007,160,44121,88457847,88458007
13903,6,6,1,2412,-61,-91,30,40:e3:d6:da:ba:21,88458217,368,-158,88457849,88458217
13904,6,12,1,2412,-61,-91,30,40:e3:d6:da:ba:22,88458604,180,207,88458424,88458604
13905,6,12,1,2412,-61,-91,30,40:e3:d6:da:ba:23,88458827,184,39,88458643,88458827
13906,6,12,1,2412,-61,-91,30,40:e3:d6:da:ba:24,88459037,176,34,88458861,88459037
13907,6,12,1,2412,-61,-91,30,40:e3:d6:da:ba:25,88459256,160,59,88459096,88459256
13908,6,6,1,2412,-62,-91,29,40:e3:d6:da:ba:26,88459448,380,-188,88459068,88459448
13909,4,1,1,2412,-85,-91,6,c0:c9:e3:4d:6e:bf,88492452,872,32132,88491580,88492452
13910,4,1,1,2412,-84,-91,7,54:e4:3a:ec:fb:64,88516126,2160,21514,88513966,88516126
13911,4,1,1,2412,-73,-91,18,b8:3a:5a:88:e6:e0,88544233,2360,25747,88541873,88544233
13912,4,1,1,2412,-76,-91,15,b8:3a:5a:88:e6:e1,88546622,2376,13,88544246,88546622
13913,6,12,1,2412,-64,-91,27,40:e3:d6:da:ba:23,88561189,184,14383,88561005,88561189
13914,6,12,1,2412,-64,-91,27,40:e3:d6:da:ba:24,88561399,176,34,88561223,88561399
13915,6,6,1,2412,-64,-91,27,40:e3:d6:da:ba:26,88561828,380,49,88561448,88561828
13916,6,6,1,2412,-68,-91,23,e6:aa:ea:c9:ea:33,88642680,408,80444,88642272,88642680
13917,4,1,1,2412,-76,-91,15,b8:3a:5a:88:e6:e0,88646609,2360,1569,88644249,88646609
13918,6,6,1,2412,-67,-91,24,e6:aa:ea:c9:ea:33,88654981,408,7964,88654573,88654981
13919,6,12,1,2412,-62,-91,29,40:e3:d6:da:ba:20,88662799,160,7658,88662639,88662799
13920,6,6,1,2412,-62,-91,29,40:e3:d6:da:ba:21,88663000,368,-167,88662632,88663000
13921,6,12,1,2412,-62,-91,29,40:e3:d6:da:ba:22,88663414,180,234,88663234,88663414
13922,6,12,1,2412,-62,-91,29,40:e3:d6:da:ba:23,88663629,184,31,88663445,88663629
13923,6,12,1,2412,-62,-91,29,40:e3:d6:da:ba:24,88663865,176,60,88663689,88663865
13924,6,12,1,2412,-62,-91,29,40:e3:d6:da:ba:25,88664076,160,51,88663916,88664076
13925,6,6,1,2412,-62,-91,29,40:e3:d6:da:ba:26,88664267,380,-189,88663887,88664267
13926,6,6,1,2412,-67,-91,24,e6:aa:ea:c9:ea:33,88680157,408,15482,88679749,88680157
13927,6,6,1,2412,-78,-91,13,e6:aa:ea:b7:4a:dd,88747961,408,67396,88747553,88747961
13928,4,1,1,2412,-76,-91,15,b8:3a:5a:88:e6:e0,88749023,2360,-1298,88746663,88749023
13929,6,12,1,2412,-61,-91,30,40:e3:d6:da:ba:20,88766369,160,17186,88766209,88766369
13930,6,12,1,2412,-61,-91,30,40:e3:d6:da:ba:24,88767487,176,942,88767311,88767487
13931,6,12,1,2412,-61,-91,30,40:e3:d6:da:ba:25,88767707,160,60,88767547,88767707
13932,6,6,1,2412,-61,-91,30,40:e3:d6:da:ba:26,88767899,380,-188,88767519,88767899
13933,6,6,1,2412,-77,-91,14,e6:aa:ea:b7:4a:dd,88772181,408,3874,88771773,88772181
13934,4,1,1,2412,-57,-91,34,54:e4:3a:ec:fb:64,88823323,2160,48982,88821163,88823323
13935,6,12,1,2412,-60,-91,31,40:e3:d6:da:ba:20,88867607,160,44124,88867447,88867607
13936,6,6,1,2412,-60,-91,31,40:e3:d6:da:ba:21,88867826,368,-149,88867458,88867826
13937,6,12,1,2412,-60,-91,31,40:e3:d6:da:ba:22,88868240,180,234,88868060,88868240
13938,6,12,1,2412,-60,-91,31,40:e3:d6:da:ba:23,88868445,184,21,88868261,88868445
13939,6,12,1,2412,-60,-91,31,40:e3:d6:da:ba:24,88868681,176,60,88868505,88868681
13940,6,12,1,2412,-60,-91,31,40:e3:d6:da:ba:25,88868883,160,42,88868723,88868883
13941,6,6,1,2412,-60,-91,31,40:e3:d6:da:ba:26,88869102,380,-161,88868722,88869102
13942,4,1,1,2412,-81,-91,10,54:e4:3a:ec:fb:64,88926108,2160,54846,88923948,88926108
13943,6,6,1,2412,-66,-91,25,e6:aa:ea:c9:ea:33,88945576,408,19060,88945168,88945576
13944,4,1,1,2412,-78,-91,13,b8:3a:5a:88:e6:e0,88953819,2360,5883,88951459,88953819
13945,4,1,1,2412,-88,-91,3,a4:e5:7c:28:b1:d3,88965786,688,11279,88965098,88965786
13946,4,1,1,2412,-91,-91,0,,88966491,304,401,88966187,88966491
13947,6,12,1,2412,-60,-91,31,40:e3:d6:da:ba:20,88970121,160,3470,88969961,88970121
13948,6,6,1,2412,-59,-91,32,40:e3:d6:da:ba:21,88970331,368,-158,88969963,88970331
13949,6,12,1,2412,-59,-91,32,40:e3:d6:da:ba:22,88970736,180,225,88970556,88970736
13950,6,12,1,2412,-59,-91,32,40:e3:d6:da:ba:23,88970951,184,31,88970767,88970951
13951,6,12,1,2412,-59,-91,32,40:e3:d6:da:ba:24,88971178,176,51,88971002,88971178
13952,6,12,1,2412,-59,-91,32,40:e3:d6:da:ba:25,88971380,160,42,88971220,88971380
13953,6,6,1,2412,-59,-91,32,40:e3:d6:da:ba:26,88971590,380,-170,88971210,88971590
13954,6,6,1,2412,-67,-91,24,e6:aa:ea:c9:ea:33,88981821,408,9823,88981413,88981821
13955,4,1,1,2412,-89,-91,2,c0:c9:e3:4d:6e:bf,88985673,872,2980,88984801,88985673
13956,4,1,1,2412,-88,-91,3,,88986562,304,585,88986258,88986562
13957,4,1,1,2412,-91,-91,0,a6:e5:7c:28:b1:d3,89015613,992,28059,89014621,89015613
13958,4,1,1,2412,-87,-91,4,,89034209,304,18292,89033905,89034209
13959,6,6,1,2412,-75,-91,16,e6:aa:ea:b7:4a:dd,89038465,408,3848,89038057,89038465
13960,6,12,1,2412,-62,-91,29,40:e3:d6:da:ba:20,89072420,160,33795,89072260,89072420
13961,6,6,1,2412,-62,-91,29,40:e3:d6:da:ba:21,89072665,368,-123,89072297,89072665
13962,6,12,1,2412,-62,-91,29,40:e3:d6:da:ba:23,89073285,184,436,89073101,89073285
13963,6,12,1,2412,-62,-91,29,40:e3:d6:da:ba:24,89073521,176,60,89073345,89073521
13964,6,12,1,2412,-62,-91,29,40:e3:d6:da:ba:25,89073750,160,69,89073590,89073750
13965,6,6,1,2412,-62,-91,29,40:e3:d6:da:ba:26,89073960,380,-170,89073580,89073960
13966,6,6,1,2412,-76,-91,15,e6:aa:ea:b7:4a:dd,89074818,408,450,89074410,89074818
13967,6,6,1,2412,-75,-91,16,e6:aa:ea:b7:4a:dd,89086943,408,11717,89086535,89086943
13968,6,12,1,2412,-60,-91,31,40:e3:d6:da:ba:20,89174797,160,87694,89174637,89174797
13969,6,6,1,2412,-60,-91,31,40:e3:d6:da:ba:21,89175016,368,-149,89174648,89175016
13970,6,12,1,2412,-60,-91,31,40:e3:d6:da:ba:22,89175437,180,241,89175257,89175437
13971,6,12,1,2412,-60,-91,31,40:e3:d6:da:ba:23,89175660,184,39,89175476,89175660
13972,6,12,1,2412,-60,-91,31,40:e3:d6:da:ba:24,89175870,176,34,89175694,89175870
13973,6,12,1,2412,-60,-91,31,40:e3:d6:da:ba:25,89176071,160,41,89175911,89176071
13974,6,6,1,2412,-60,-91,31,40:e3:d6:da:ba:26,89176263,380,-188,89175883,89176263
13975,4,1,1,2412,-90,-91,1,a6:e5:7c:28:b1:d3,89227673,992,50418,89226681,89227673
13976,4,1,1,2412,-78,-91,13,54:e4:3a:ec:fb:64,89232921,2160,3088,89230761,89232921
13977,4,1,1,2412,-81,-91,10,b8:3a:5a:88:e6:e0,89261924,2360,26643,89259564,89261924
13978,6,6,1,2412,-69,-91,22,e6:aa:ea:c9:ea:33,89264423,408,2091,89264015,89264423
13979,6,6,1,2412,-69,-91,22,e6:aa:ea:c9:ea:33,89272430,408,7599,89272022,89272430
13980,6,12,1,2412,-62,-91,29,40:e3:d6:da:ba:20,89277305,160,4715,89277145,89277305
13981,6,6,1,2412,-61,-91,30,40:e3:d6:da:ba:21,89277524,368,-149,89277156,89277524
13982,6,12,1,2412,-61,-91,30,40:e3:d6:da:ba:22,89277929,180,225,89277749,89277929
13983,6,12,1,2412,-61,-91,30,40:e3:d6:da:ba:25,89278591,160,502,89278431,89278591
13984,6,6,1,2412,-62,-91,29,40:e3:d6:da:ba:26,89278783,380,-188,89278403,89278783
13985,6,6,1,2412,-69,-91,22,e6:aa:ea:c9:ea:33,89284550,408,5359,89284142,89284550
13986,6,6,1,2412,-69,-91,22,e6:aa:ea:c9:ea:33,89296672,408,11714,89296264,89296672
13987,6,6,1,2412,-69,-91,22,e6:aa:ea:c9:ea:33,89308797,408,11717,89308389,89308797
13988,4,1,1,2412,-88,-91,3,a6:e5:7c:28:b1:d3,89327787,992,17998,89326795,89327787
13989,4,1,1,2412,-78,-91,13,54:e4:3a:ec:fb:64,89335697,2160,5750,89333537,89335697
13990,4,1,1,2412,-82,-91,9,b8:3a:5a:88:e6:e0,89363411,2360,25354,89361051,89363411
13991,6,12,1,2412,-62,-91,29,40:e3:d6:da:ba:20,89379599,160,16028,89379439,89379599
13992,6,6,1,2412,-61,-91,30,40:e3:d6:da:ba:21,89379800,368,-167,89379432,89379800
13993,6,12,1,2412,-61,-91,30,40:e3:d6:da:ba:22,89380214,180,234,89380034,89380214
13994,6,12,1,2412,-61,-91,30,40:e3:d6:da:ba:23,89380428,184,30,89380244,89380428
13995,6,12,1,2412,-61,-91,30,40:e3:d6:da:ba:24,89380638,176,34,89380462,89380638
13996,6,12,1,2412,-62,-91,29,40:e3:d6:da:ba:25,89380839,160,41,89380679,89380839
13997,6,6,1,2412,-61,-91,30,40:e3:d6:da:ba:26,89381040,380,-179,89380660,89381040
13998,4,1,1,2412,-77,-91,14,54:e4:3a:ec:fb:64,89437724,2160,54524,89435564,89437724
13999,4,1,1,2412,-81,-91,10,b8:3a:5a:88:e6:e1,89470255,2376,30155,89467879,89470255
14000,6,12,1,2412,-63,-91,28,40:e3:d6:da:ba:24,89483161,176,12730,89482985,89483161
14001,6,12,1,2412,-64,-91,27,40:e3:d6:da:ba:25,89483380,160,59,89483220,89483380
14002,6,6,1,2412,-64,-91,27,40:e3:d6:da:ba:26,89483581,380,-179,89483201,89483581
14003,4,1,1,2412,-88,-91,3,c0:c9:e3:4d:6e:bf,89488543,872,4090,89487671,89488543
14004,4,1,1,2412,-93,-91,-2,,89489432,304,585,89489128,89489432
14005,4,1,1,2412,-90,-91,1,c0:c9:e3:4d:6e:bf,89533736,872,43432,89532864,89533736
14006,6,6,1,2412,-73,-91,18,e6:aa:ea:b7:4a:dd,89558291,408,24147,89557883,89558291
14007,6,12,1,2412,-60,-91,31,40:e3:d6:da:ba:22,89585035,180,26564,89584855,89585035
14008,6,12,1,2412,-60,-91,31,40:e3:d6:da:ba:23,89585267,184,48,89585083,89585267
14009,6,6,1,2412,-60,-91,31,40:e3:d6:da:ba:26,89586036,380,389,89585656,89586036
14010,6,6,1,2412,-67,-91,24,e6:aa:ea:c9:ea:33,89587541,408,1097,89587133,89587541
14011,6,6,1,2412,-73,-91,18,e6:aa:ea:b7:4a:dd,89594718,408,6769,89594310,89594718
14012,6,6,1,2412,-67,-91,24,e6:aa:ea:c9:ea:33,89599664,408,4538,89599256,89599664
14013,6,6,1,2412,-67,-91,24,e6:aa:ea:c9:ea:33,89624860,408,24788,89624452,89624860
14014,4,1,1,2412,-77,-91,14,b8:3a:5a:88:e6:e0,89670612,2360,43392,89668252,89670612
14015,4,1,1,2412,-90,-91,1,,89676935,304,6019,89676631,89676935
14016,6,12,1,2412,-60,-91,31,40:e3:d6:da:ba:20,89686800,160,9705,89686640,89686800
14017,6,6,1,2412,-60,-91,31,40:e3:d6:da:ba:21,89687001,368,-167,89686633,89687001
14018,6,12,1,2412,-60,-91,31,40:e3:d6:da:ba:22,89687397,180,216,89687217,89687397
14019,6,12,1,2412,-60,-91,31,40:e3:d6:da:ba:23,89687612,184,31,89687428,89687612
14020,6,12,1,2412,-60,-91,31,40:e3:d6:da:ba:24,89687848,176,60,89687672,89687848
14021,6,12,1,2412,-60,-91,31,40:e3:d6:da:ba:25,89688068,160,60,89687908,89688068
14022,6,6,1,2412,-60,-91,31,40:e3:d6:da:ba:26,89688287,380,-161,89687907,89688287
14023,4,1,1,2412,-78,-91,13,b8:3a:5a:88:e6:e1,89775423,2376,84760,89773047,89775423
14024,6,12,1,2412,-60,-91,31,40:e3:d6:da:ba:20,89789221,160,13638,89789061,89789221
14025,6,12,1,2412,-60,-91,31,40:e3:d6:da:ba:22,89789827,180,426,89789647,89789827
14026,6,12,1,2412,-60,-91,31,40:e3:d6:da:ba:23,89790041,184,30,89789857,89790041
14027,6,12,1,2412,-60,-91,31,40:e3:d6:da:ba:24,89790260,176,43,89790084,89790260
14028,6,12,1,2412,-60,-91,31,40:e3:d6:da:ba:25,89790461,160,41,89790301,89790461
14029,6,6,1,2412,-60,-91,31,40:e3:d6:da:ba:26,89790653,380,-188,89790273,89790653
14030,6,12,1,2412,-68,-91,23,,89815383,32,24698,89815351,89815383
14031,4,1,1,2412,-81,-91,10,54:e4:3a:ec:fb:64,89835812,2112,18317,89833700,89835812
14032,4,1,1,2412,-72,-91,19,,89837936,304,1820,89837632,89837936
14033,4,1,1,2412,-79,-91,12,54:e4:3a:ec:fb:64,89847336,2160,7240,89845176,89847336
14034,6,6,1,2412,-83,-91,8,40:e3:d6:da:ba:21,89891822,368,44118,89891454,89891822
14035,6,12,1,2412,-84,-91,7,40:e3:d6:da:ba:22,89892316,180,314,89892136,89892316
14036,6,6,1,2412,-60,-91,31,40:e3:d6:da:ba:26,89893179,380,483,89892799,89893179
14037,6,6,1,2412,-68,-91,23,e6:aa:ea:c9:ea:33,89916081,408,22494,89915673,89916081
14038,6,6,1,2412,-68,-91,23,e6:aa:ea:c9:ea:33,89928179,408,11690,89927771,89928179
14039,6,6,1,2412,-69,-91,22,e6:aa:ea:c9:ea:33,89940303,408,11716,89939895,89940303
14040,4,1,1,2412,-74,-91,17,b8:3a:5a:88:e6:e0,89977861,2360,35198,89975501,89977861
14041,6,12,1,2412,-61,-91,30,40:e3:d6:da:ba:20,89994002,160,15981,89993842,89994002
14042,6,12,1,2412,-67,-91,24,40:e3:d6:da:ba:23,89994858,184,672,89994674,89994858
14043,6,12,1,2412,-63,-91,28,40:e3:d6:da:ba:24,89995068,176,34,89994892,89995068
14044,6,6,1,2412,-67,-91,24,40:e3:d6:da:ba:26,89995497,380,49,89995117,89995497
14045,6,6,1,2412,-74,-91,17,e6:aa:ea:b7:4a:dd,90012824,408,16919,90012416,90012824
14046,6,6,1,2412,-74,-91,17,e6:aa:ea:b7:4a:dd,90024731,408,11499,90024323,90024731
14047,4,1,1,2412,-86,-91,5,c0:c9:e3:4d:6e:bf,90033521,872,7918,90032649,90033521
14048,4,1,1,2412,-92,-91,-1,,90034410,304,585,90034106,90034410
14049,4,1,1,2412,-77,-91,14,b8:3a:5a:88:e6:e0,90080212,2360,43442,90077852,90080212
14050,4,1,1,2412,-79,-91,12,b8:3a:5a:88:e6:e1,90082601,2376,13,90080225,90082601
14051,6,12,1,2412,-61,-91,30,40:e3:d6:da:ba:20,90096403,160,13642,90096243,90096403
14052,6,6,1,2412,-61,-91,30,40:e3:d6:da:ba:21,90096603,368,-168,90096235,90096603
14053,6,12,1,2412,-61,-91,30,40:e3:d6:da:ba:22,90097000,180,217,90096820,90097000
14054,6,12,1,2412,-62,-91,29,40:e3:d6:da:ba:23,90097232,184,48,90097048,90097232
14055,6,12,1,2412,-61,-91,30,40:e3:d6:da:ba:24,90097442,176,34,90097266,90097442
14056,6,12,1,2412,-61,-91,30,40:e3:d6:da:ba:25,90097661,160,59,90097501,90097661
14057,6,6,1,2412,-61,-91,30,40:e3:d6:da:ba:26,90097880,380,-161,90097500,90097880
14058,4,1,1,2412,-78,-91,13,b8:3a:5a:88:e6:e0,90183551,2360,83311,90181191,90183551
14059,4,1,1,2412,-77,-91,14,b8:3a:5a:88:e6:e1,90185940,2376,13,90183564,90185940
14060,6,12,1,2412,-62,-91,29,40:e3:d6:da:ba:20,90198827,160,12727,90198667,90198827
14061,6,6,1,2412,-62,-91,29,40:e3:d6:da:ba:21,90199028,368,-167,90198660,90199028
14062,6,12,1,2412,-61,-91,30,40:e3:d6:da:ba:22,90199442,180,234,90199262,90199442
14063,6,12,1,2412,-62,-91,29,40:e3:d6:da:ba:23,90199752,184,126,90199568,90199752
14064,6,12,1,2412,-62,-91,29,40:e3:d6:da:ba:24,90199961,176,33,90199785,90199961
14065,6,12,1,2412,-61,-91,30,40:e3:d6:da:ba:25,90200172,160,51,90200012,90200172
14066,6,6,1,2412,-62,-91,29,40:e3:d6:da:ba:26,90200391,380,-161,90200011,90200391
14067,6,6,1,2412,-70,-91,21,e6:aa:ea:c9:ea:33,90206906,408,6107,90206498,90206906
14068,6,6,1,2412,-71,-91,20,e6:aa:ea:c9:ea:33,90219174,408,11860,90218766,90219174
14069,6,6,1,2412,-71,-91,20,e6:aa:ea:c9:ea:33,90231126,408,11544,90230718,90231126
14070,6,6,1,2412,-71,-91,20,e6:aa:ea:c9:ea:33,90243250,408,11716,90242842,90243250
14071,4,1,1,2412,-78,-91,13,b8:3a:5a:88:e6:e0,90285027,2360,39417,90282667,90285027
14072,4,1,1,2412,-77,-91,14,b8:3a:5a:88:e6:e1,90287406,2376,3,90285030,90287406
14073,6,12,1,2412,-62,-91,29,40:e3:d6:da:ba:20,90301217,160,13651,90301057,90301217
14074,6,6,1,2412,-62,-91,29,40:e3:d6:da:ba:21,90301436,368,-149,90301068,90301436
14075,6,12,1,2412,-63,-91,28,40:e3:d6:da:ba:25,90302484,160,888,90302324,90302484
14076,6,6,1,2412,-63,-91,28,40:e3:d6:da:ba:26,90302703,380,-161,90302323,90302703
14077,6,12,1,2412,-62,-91,29,40:e3:d6:da:ba:20,90338130,136,35291,90337994,90338130
14078,6,6,1,2412,-62,-91,29,40:e3:d6:da:ba:21,90338307,348,-171,90337959,90338307
14079,6,12,1,2412,-62,-91,29,40:e3:d6:da:ba:22,90338700,156,237,90338544,90338700
14080,6,12,1,2412,-62,-91,29,40:e3:d6:da:ba:23,90338900,156,44,90338744,90338900
14081,6,12,1,2412,-62,-91,29,40:e3:d6:da:ba:25,90339108,136,72,90338972,90339108
14082,4,1,1,2412,-90,-91,1,a6:e5:7c:28:b1:d3,90346418,992,6318,90345426,90346418
14083,4,1,1,2412,-80,-91,11,54:e4:3a:ec:fb:64,90359317,2160,10739,90357157,90359317
14084,4,1,1,2412,-78,-91,13,b8:3a:5a:88:e6:e0,90387487,2360,25810,90385127,90387487
14085,6,12,1,2412,-62,-91,29,40:e3:d6:da:ba:20,90403603,160,15956,90403443,90403603
14086,6,6,1,2412,-62,-91,29,40:e3:d6:da:ba:21,90403804,368,-167,90403436,90403804
14087,6,12,1,2412,-62,-91,29,40:e3:d6:da:ba:22,90404200,180,216,90404020,90404200
14088,6,12,1,2412,-62,-91,29,40:e3:d6:da:ba:23,90404415,184,31,90404231,90404415
14089,6,12,1,2412,-61,-91,30,40:e3:d6:da:ba:24,90404642,176,51,90404466,90404642
14090,6,12,1,2412,-61,-91,30,40:e3:d6:da:ba:25,90404871,160,69,90404711,90404871
14091,6,6,1,2412,-61,-91,30,40:e3:d6:da:ba:26,90405063,380,-188,90404683,90405063
14092,4,1,1,2412,-88,-91,3,c0:c9:e3:4d:6e:bf,90480004,872,74069,90479132,90480004
14093,4,1,1,2412,-92,-91,-1,,90480893,304,585,90480589,90480893
14094,4,1,1,2412,-78,-91,13,b8:3a:5a:88:e6:e0,90489826,2360,6573,90487466,90489826
14095,4,1,1,2412,-80,-91,11,b8:3a:5a:88:e6:e1,90492224,2376,22,90489848,90492224
14096,6,12,1,2412,-63,-91,28,40:e3:d6:da:ba:20,90506023,160,13639,90505863,90506023
14097,6,6,1,2412,-63,-91,28,40:e3:d6:da:ba:21,90506233,368,-158,90505865,90506233
14098,6,12,1,2412,-62,-91,29,40:e3:d6:da:ba:22,90506620,180,207,90506440,90506620
14099,6,12,1,2412,-62,-91,29,40:e3:d6:da:ba:23,90506825,184,21,90506641,90506825
14100,6,12,1,2412,-62,-91,29,40:e3:d6:da:ba:24,90507062,176,61,90506886,90507062
14101,6,12,1,2412,-62,-91,29,40:e3:d6:da:ba:25,90507263,160,41,90507103,90507263
14102,6,6,1,2412,-62,-91,29,40:e3:d6:da:ba:26,90507473,380,-170,90507093,90507473
14103,6,6,1,2412,-74,-91,17,e6:aa:ea:b7:4a:dd,90508473,408,592,90508065,90508473
14104,6,6,1,2412,-74,-91,17,e6:aa:ea:b7:4a:dd,90544322,408,35441,90543914,90544322
14105,4,1,1,2412,-78,-91,13,54:e4:3a:ec:fb:64,90564129,2160,17647,90561969,90564129
14106,4,1,1,2412,-73,-91,18,b8:3a:5a:88:e6:e1,90594711,2376,28206,90592335,90594711
14107,6,12,1,2412,-62,-91,29,40:e3:d6:da:ba:20,90608430,160,13559,90608270,90608430
14108,6,6,1,2412,-62,-91,29,40:e3:d6:da:ba:21,90608640,368,-158,90608272,90608640
14109,6,12,1,2412,-61,-91,30,40:e3:d6:da:ba:22,90609054,180,234,90608874,90609054
14110,6,12,1,2412,-61,-91,30,40:e3:d6:da:ba:23,90609260,184,22,90609076,90609260
14111,6,12,1,2412,-61,-91,30,40:e3:d6:da:ba:24,90609496,176,60,90609320,90609496
14112,6,12,1,2412,-61,-91,30,40:e3:d6:da:ba:25,90609725,160,69,90609565,90609725
14113,6,6,1,2412,-61,-91,30,40:e3:d6:da:ba:26,90609944,380,-161,90609564,90609944
14114,6,6,1,2412,-71,-91,20,e6:aa:ea:c9:ea:33,90624456,408,14104,90624048,90624456
14115,6,6,1,2412,-71,-91,20,e6:aa:ea:c9:ea:33,90648974,408,24110,90648566,90648974
14116,6,6,1,2412,-71,-91,20,e6:aa:ea:c9:ea:33,90660807,408,11425,90660399,90660807
14117,4,1,1,2412,-77,-91,14,54:e4:3a:ec:fb:64,90666508,2160,3541,90664348,90666508
14118,6,6,1,2412,-63,-91,28,e6:aa:ea:c9:ea:33,90672914,408,5998,90672506,90672914
14119,6,12,1,2412,-62,-91,29,40:e3:d6:da:ba:20,90710806,160,37732,90710646,90710806
14120,6,12,1,2412,-62,-91,29,40:e3:d6:da:ba:22,90711439,180,453,90711259,90711439
14121,6,12,1,2412,-62,-91,29,40:e3:d6:da:ba:23,90711653,184,30,90711469,90711653
14122,6,12,1,2412,-62,-91,29,40:e3:d6:da:ba:24,90711881,176,52,90711705,90711881
14123,6,12,1,2412,-62,-91,29,40:e3:d6:da:ba:25,90712100,160,59,90711940,90712100
14124,6,6,1,2412,-62,-91,29,40:e3:d6:da:ba:26,90712319,380,-161,90711939,90712319
14125,4,1,1,2412,-78,-91,13,54:e4:3a:ec:fb:64,90768944,2160,54465,90766784,90768944
14126,4,1,1,2412,-78,-91,13,b8:3a:5a:88:e6:e0,90797015,2360,25711,90794655,90797015
14127,4,1,1,2412,-77,-91,14,b8:3a:5a:88:e6:e1,90799395,2376,4,90797019,90799395
14128,6,6,1,2412,-75,-91,16,e6:aa:ea:b7:4a:dd,90810702,408,10899,90810294,90810702
14129,6,12,1,2412,-62,-91,29,40:e3:d6:da:ba:20,90813213,160,2351,90813053,90813213
14130,6,6,1,2412,-62,-91,29,40:e3:d6:da:ba:21,90813405,368,-176,90813037,90813405
14131,6,12,1,2412,-61,-91,30,40:e3:d6:da:ba:22,90813810,180,225,90813630,90813810
14132,6,12,1,2412,-61,-91,30,40:e3:d6:da:ba:23,90814033,184,39,90813849,90814033
14133,6,12,1,2412,-62,-91,29,40:e3:d6:da:ba:24,90814243,176,34,90814067,90814243
14134,6,12,1,2412,-62,-91,29,40:e3:d6:da:ba:25,90814444,160,41,90814284,90814444
14135,6,6,1,2412,-61,-91,30,40:e3:d6:da:ba:26,90814663,380,-161,90814283,90814663
14136,6,6,1,2412,-75,-91,16,e6:aa:ea:b7:4a:dd,90822824,408,7753,90822416,90822824
14137,6,6,1,2412,-75,-91,16,e6:aa:ea:b7:4a:dd,90834932,408,11700,90834524,90834932
14138,6,6,1,2412,-75,-91,16,e6:aa:ea:b7:4a:dd,90847049,408,11709,90846641,90847049
14139,6,6,1,2412,-75,-91,16,e6:aa:ea:b7:4a:dd,90859172,408,11715,90858764,90859172
14140,6,12,1,2412,-61,-91,30,40:e3:d6:da:ba:20,90915605,160,56273,90915445,90915605
14141,6,6,1,2412,-61,-91,30,40:e3:d6:da:ba:21,90915806,368,-167,90915438,90915806
14142,6,12,1,2412,-61,-91,30,40:e3:d6:da:ba:22,90916193,180,207,90916013,90916193
14143,6,12,1,2412,-60,-91,31,40:e3:d6:da:ba:23,90916426,184,49,90916242,90916426
14144,6,12,1,2412,-61,-91,30,40:e3:d6:da:ba:24,90916662,176,60,90916486,90916662
14145,6,12,1,2412,-61,-91,30,40:e3:d6:da:ba:25,90916882,160,60,90916722,90916882
14146,6,6,1,2412,-60,-91,31,40:e3:d6:da:ba:26,90917101,380,-161,90916721,90917101
14147,4,1,1,2412,-93,-91,-2,,90996005,304,78600,90995701,90996005
14148,6,6,1,2412,-60,-91,31,40:e3:d6:da:ba:21,91018226,368,21853,91017858,91018226
14149,6,12,1,2412,-60,-91,31,40:e3:d6:da:ba:22,91018613,180,207,91018433,91018613
14150,6,12,1,2412,-60,-91,31,40:e3:d6:da:ba:23,91018863,184,66,91018679,91018863
14151,6,12,1,2412,-60,-91,31,40:e3:d6:da:ba:24,91019090,176,51,91018914,91019090
14152,6,12,1,2412,-60,-91,31,40:e3:d6:da:ba:25,91019301,160,51,91019141,91019301
14153,6,6,1,2412,-60,-91,31,40:e3:d6:da:ba:26,91019502,380,-179,91019122,91019502
14154,6,6,1,2412,-68,-91,23,e6:aa:ea:c9:ea:33,91042612,408,22702,91042204,91042612
14155,6,6,1,2412,-72,-91,19,e6:aa:ea:c9:ea:33,91054565,408,11545,91054157,91054565
14156,6,6,1,2412,-68,-91,23,e6:aa:ea:c9:ea:33,91066659,408,11686,91066251,91066659
14157,4,1,1,2412,-82,-91,9,54:e4:3a:ec:fb:64,91076151,2160,7332,91073991,91076151
14158,6,6,1,2412,-67,-91,24,e6:aa:ea:c9:ea:33,91090955,408,14396,91090547,91090955
14159,4,1,1,2412,-77,-91,14,b8:3a:5a:88:e6:e0,91104223,2360,10908,91101863,91104223
14160,4,1,1,2412,-78,-91,13,b8:3a:5a:88:e6:e1,91106603,2376,4,91104227,91106603
14161,6,12,1,2412,-59,-91,32,40:e3:d6:da:ba:20,91120406,160,13643,91120246,91120406
14162,6,6,1,2412,-59,-91,32,40:e3:d6:da:ba:21,91120598,368,-176,91120230,91120598
14163,6,12,1,2412,-59,-91,32,40:e3:d6:da:ba:22,91120993,180,215,91120813,91120993
14164,6,12,1,2412,-59,-91,32,40:e3:d6:da:ba:23,91121199,184,22,91121015,91121199
14165,6,12,1,2412,-59,-91,32,40:e3:d6:da:ba:24,91121426,176,51,91121250,91121426
14166,6,12,1,2412,-59,-91,32,40:e3:d6:da:ba:25,91121646,160,60,91121486,91121646
14167,6,6,1,2412,-59,-91,32,40:e3:d6:da:ba:26,91121838,380,-188,91121458,91121838
14168,6,6,1,2412,-76,-91,15,e6:aa:ea:b7:4a:dd,91137243,408,14997,91136835,91137243
14169,6,6,1,2412,-75,-91,16,e6:aa:ea:b7:4a:dd,91149360,408,11709,91148952,91149360
14170,4,1,1,2412,-71,-91,20,a6:e5:7c:28:b1:d3,91166179,992,15827,91165187,91166179
14171,6,6,1,2412,-76,-91,15,e6:aa:ea:b7:4a:dd,91173594,408,7007,91173186,91173594
14172,4,1,1,2412,-73,-91,18,b8:3a:5a:88:e6:e0,91206721,2360,30767,91204361,91206721
14173,4,1,1,2412,-79,-91,12,b8:3a:5a:88:e6:e1,91209110,2376,13,91206734,91209110
14174,6,12,1,2412,-59,-91,32,40:e3:d6:da:ba:20,91222827,160,13557,91222667,91222827
14175,6,12,1,2412,-68,-91,23,40:e3:d6:da:ba:23,91223663,184,652,91223479,91223663
14176,4,1,1,2412,-88,-91,3,a4:e5:7c:28:b1:d3,91263435,688,39084,91262747,91263435
14177,4,1,1,2412,-93,-91,-2,,91264141,304,402,91263837,91264141
14178,4,1,1,2412,-87,-91,4,a6:e5:7c:28:b1:d3,91268440,992,3307,91267448,91268440
14179,4,1,1,2412,-80,-91,11,54:e4:3a:ec:fb:64,91280949,2160,10349,91278789,91280949
14180,6,12,1,2412,-58,-91,33,40:e3:d6:da:ba:20,91325228,160,44119,91325068,91325228
14181,6,6,1,2412,-57,-91,34,40:e3:d6:da:ba:21,91325438,368,-158,91325070,91325438
14182,6,12,1,2412,-57,-91,34,40:e3:d6:da:ba:22,91325834,180,216,91325654,91325834
14183,6,12,1,2412,-57,-91,34,40:e3:d6:da:ba:23,91326048,184,30,91325864,91326048
14184,6,12,1,2412,-57,-91,34,40:e3:d6:da:ba:24,91326267,176,43,91326091,91326267
14185,6,12,1,2412,-56,-91,35,40:e3:d6:da:ba:25,91326468,160,41,91326308,91326468
14186,4,1,1,2412,-79,-91,12,54:e4:3a:ec:fb:64,91383343,2160,54715,91381183,91383343
14187,4,1,1,2412,-83,-91,8,b8:3a:5a:88:e6:e0,91411416,2360,25713,91409056,91411416
14188,4,1,1,2412,-83,-91,8,b8:3a:5a:88:e6:e1,91413822,2376,30,91411446,91413822
14189,6,12,1,2412,-58,-91,33,40:e3:d6:da:ba:20,91427608,160,13626,91427448,91427608
14190,6,6,1,2412,-58,-91,33,40:e3:d6:da:ba:21,91427827,368,-149,91427459,91427827
14191,6,12,1,2412,-58,-91,33,40:e3:d6:da:ba:22,91428232,180,225,91428052,91428232
14192,6,12,1,2412,-58,-91,33,40:e3:d6:da:ba:23,91428447,184,31,91428263,91428447
14193,6,12,1,2412,-58,-91,33,40:e3:d6:da:ba:24,91428674,176,51,91428498,91428674
14194,6,12,1,2412,-58,-91,33,40:e3:d6:da:ba:25,91428894,160,60,91428734,91428894
14195,6,6,1,2412,-58,-91,33,40:e3:d6:da:ba:26,91429086,380,-188,91428706,91429086
14196,6,6,1,2412,-75,-91,16,e6:aa:ea:b7:4a:dd,91439772,408,10278,91439364,91439772
14197,6,6,1,2412,-75,-91,16,e6:aa:ea:b7:4a:dd,91464136,408,23956,91463728,91464136
14198,4,1,1,2412,-87,-91,4,c0:c9:e3:4d:6e:bf,91464737,872,-271,91463865,91464737
14199,4,1,1,2412,-85,-91,6,,91465626,304,585,91465322,91465626
14200,6,6,1,2412,-65,-91,26,e6:aa:ea:c9:ea:33,91473502,408,7468,91473094,91473502
14201,6,6,1,2412,-65,-91,26,e6:aa:ea:c9:ea:33,91484099,408,10189,91483691,91484099
14202,4,1,1,2412,-78,-91,13,54:e4:3a:ec:fb:64,91485729,2160,-530,91483569,91485729
14203,6,6,1,2412,-74,-91,17,e6:aa:ea:b7:4a:dd,91488244,408,2107,91487836,91488244
14204,6,6,1,2412,-65,-91,26,e6:aa:ea:c9:ea:33,91496219,408,7567,91495811,91496219
14205,4,1,1,2412,-83,-91,8,b8:3a:5a:88:e6:e1,91516205,2376,17610,91513829,91516205
14206,6,12,1,2412,-59,-91,32,40:e3:d6:da:ba:20,91530009,160,13644,91529849,91530009
14207,6,6,1,2412,-59,-91,32,40:e3:d6:da:ba:21,91530201,368,-176,91529833,91530201
14208,6,12,1,2412,-58,-91,33,40:e3:d6:da:ba:22,91530606,180,225,91530426,91530606
14209,6,12,1,2412,-59,-91,32,40:e3:d6:da:ba:23,91530838,184,48,91530654,91530838
14210,6,12,1,2412,-59,-91,32,40:e3:d6:da:ba:24,91531057,176,43,91530881,91531057
14211,6,12,1,2412,-59,-91,32,40:e3:d6:da:ba:25,91531258,160,41,91531098,91531258
14212,6,6,1,2412,-59,-91,32,40:e3:d6:da:ba:26,91531450,380,-188,91531070,91531450
14213,6,6,1,2412,-82,-91,9,84:1b:5e:df:1b:99,91575635,80,44105,91575555,91575635
14214,4,1,1,2412,-73,-91,18,54:e4:3a:ec:fb:64,91588133,2160,10338,91585973,91588133
14215,4,1,1,2412,-82,-91,9,b8:3a:5a:88:e6:e0,91616224,2360,25731,91613864,91616224
14216,4,1,1,2412,-81,-91,10,b8:3a:5a:88:e6:e1,91618622,2376,22,91616246,91618622
14217,6,12,1,2412,-60,-91,31,40:e3:d6:da:ba:20,91632408,160,13626,91632248,91632408
14218,6,6,1,2412,-60,-91,31,40:e3:d6:da:ba:21,91632600,368,-176,91632232,91632600
14219,6,12,1,2412,-60,-91,31,40:e3:d6:da:ba:22,91632996,180,216,91632816,91632996
14220,6,12,1,2412,-60,-91,31,40:e3:d6:da:ba:23,91633229,184,49,91633045,91633229
14221,6,12,1,2412,-60,-91,31,40:e3:d6:da:ba:24,91633447,176,42,91633271,91633447
14222,6,12,1,2412,-60,-91,31,40:e3:d6:da:ba:25,91633658,160,51,91633498,91633658
14223,6,6,1,2412,-60,-91,31,40:e3:d6:da:ba:26,91633859,380,-179,91633479,91633859
14224,4,1,1,2412,-79,-91,12,54:e4:3a:ec:fb:64,91690540,2160,54521,91688380,91690540
14225,6,12,1,2412,-59,-91,32,40:e3:d6:da:ba:20,91734835,160,44135,91734675,91734835
14226,6,6,1,2412,-59,-91,32,40:e3:d6:da:ba:21,91735036,368,-167,91734668,91735036
14227,6,12,1,2412,-59,-91,32,40:e3:d6:da:ba:22,91735432,180,216,91735252,91735432
14228,6,12,1,2412,-59,-91,32,40:e3:d6:da:ba:24,91735874,176,266,91735698,91735874
14229,6,12,1,2412,-59,-91,32,40:e3:d6:da:ba:25,91736102,160,68,91735942,91736102
14230,6,6,1,2412,-59,-91,32,40:e3:d6:da:ba:26,91736295,380,-187,91735915,91736295
14231,6,6,1,2412,-69,-91,22,e6:aa:ea:c9:ea:33,91775466,408,38763,91775058,91775466
14232,6,6,1,2412,-68,-91,23,e6:aa:ea:c9:ea:33,91787588,408,11714,91787180,91787588
14233,4,1,1,2412,-83,-91,8,54:e4:3a:ec:fb:64,91792943,2160,3195,91790783,91792943
14234,6,6,1,2412,-68,-91,23,e6:aa:ea:c9:ea:33,91799878,408,6527,91799470,91799878
14235,6,6,1,2412,-67,-91,24,e6:aa:ea:c9:ea:33,91811880,408,11594,91811472,91811880
14236,4,1,1,2412,-64,-91,27,,91831202,304,19018,91830898,91831202
14237,6,12,1,2412,-58,-91,33,40:e3:d6:da:ba:20,91837235,160,5873,91837075,91837235
14238,6,6,1,2412,-58,-91,33,40:e3:d6:da:ba:21,91837445,368,-158,91837077,91837445
14239,6,12,1,2412,-58,-91,33,40:e3:d6:da:ba:22,91837859,180,234,91837679,91837859
14240,6,12,1,2412,-58,-91,33,40:e3:d6:da:ba:23,91838074,184,31,91837890,91838074
14241,6,12,1,2412,-57,-91,34,40:e3:d6:da:ba:24,91838310,176,60,91838134,91838310
14242,6,12,1,2412,-57,-91,34,40:e3:d6:da:ba:25,91838539,160,69,91838379,91838539
14243,6,6,1,2412,-58,-91,33,40:e3:d6:da:ba:26,91838758,380,-161,91838378,91838758
14244,4,1,1,2412,-90,-91,1,a6:e5:7c:28:b1:d3,91882928,992,43178,91881936,91882928
14245,4,1,1,2412,-82,-91,9,54:e4:3a:ec:fb:64,91895356,2160,10268,91893196,91895356
14246,4,1,1,2412,-79,-91,12,b8:3a:5a:88:e6:e1,91925823,2376,28091,91923447,91925823
14247,6,12,1,2412,-60,-91,31,40:e3:d6:da:ba:20,91939624,160,13641,91939464,91939624
14248,6,6,1,2412,-60,-91,31,40:e3:d6:da:ba:21,91939834,368,-158,91939466,91939834
14249,6,12,1,2412,-60,-91,31,40:e3:d6:da:ba:22,91940231,180,217,91940051,91940231
14250,6,12,1,2412,-60,-91,31,40:e3:d6:da:ba:23,91940436,184,21,91940252,91940436
14251,6,12,1,2412,-60,-91,31,40:e3:d6:da:ba:24,91940664,176,52,91940488,91940664
14252,6,12,1,2412,-60,-91,31,40:e3:d6:da:ba:25,91940883,160,59,91940723,91940883
14253,6,6,1,2412,-60,-91,31,40:e3:d6:da:ba:26,91941075,380,-188,91940695,91941075
14254,4,1,1,2412,-83,-91,8,c0:c9:e3:4d:6e:bf,91958028,872,16081,91957156,91958028
14255,4,1,1,2412,-92,-91,-1,,91958917,304,585,91958613,91958917
14256,6,6,1,2412,-75,-91,16,e6:aa:ea:b7:4a:dd,91983441,408,24116,91983033,91983441
14257,6,6,1,2412,-76,-91,15,e6:aa:ea:b7:4a:dd,91995555,408,11706,91995147,91995555
14258,4,1,1,2412,-87,-91,4,,92004139,304,8280,92003835,92004139
14259,4,1,1,2412,-81,-91,10,b8:3a:5a:88:e6:e0,92025837,2360,19338,92023477,92025837
14260,4,1,1,2412,-81,-91,10,b8:3a:5a:88:e6:e1,92028244,2376,31,92025868,92028244
14261,6,6,1,2412,-62,-91,29,40:e3:d6:da:ba:21,92042254,368,13642,92041886,92042254
14262,6,12,1,2412,-62,-91,29,40:e3:d6:da:ba:22,92042650,180,216,92042470,92042650
14263,6,12,1,2412,-62,-91,29,40:e3:d6:da:ba:23,92042883,184,49,92042699,92042883
14264,6,12,1,2412,-60,-91,31,40:e3:d6:da:ba:24,92043110,176,51,92042934,92043110
14265,6,12,1,2412,-60,-91,31,40:e3:d6:da:ba:25,92043321,160,51,92043161,92043321
14266,6,6,1,2412,-60,-91,31,40:e3:d6:da:ba:26,92043513,380,-188,92043133,92043513
14267,4,1,1,2412,-89,-91,2,a6:e5:7c:28:b1:d3,92087704,992,43199,92086712,92087704
14268,4,1,1,2412,-79,-91,12,54:e4:3a:ec:fb:64,92100138,2160,10274,92097978,92100138
14269,4,1,1,2412,-77,-91,14,b8:3a:5a:88:e6:e0,92128240,2360,25742,92125880,92128240
14270,6,12,1,2412,-65,-91,26,40:e3:d6:da:ba:24,92145465,176,17049,92145289,92145465
14271,6,12,1,2412,-61,-91,30,40:e3:d6:da:ba:25,92145667,160,42,92145507,92145667
14272,6,6,1,2412,-61,-91,30,40:e3:d6:da:ba:26,92145868,380,-179,92145488,92145868
14273,4,1,1,2412,-89,-91,2,,92187153,304,40981,92186849,92187153
14274,4,1,1,2412,-89,-91,2,a6:e5:7c:28:b1:d3,92188551,944,454,92187607,92188551
14275,4,1,1,2412,-83,-91,8,b8:3a:5a:88:e6:e0,92209311,2240,18520,92207071,92209311
14276,6,12,1,2412,-61,-91,30,40:e3:d6:da:ba:20,92246823,160,37352,92246663,92246823
14277,6,6,1,2412,-61,-91,30,40:e3:d6:da:ba:21,92247024,368,-167,92246656,92247024
14278,6,12,1,2412,-61,-91,30,40:e3:d6:da:ba:22,92247420,180,216,92247240,92247420
14279,6,12,1,2412,-60,-91,31,40:e3:d6:da:ba:23,92247635,184,31,92247451,92247635
14280,6,6,1,2412,-60,-91,31,40:e3:d6:da:ba:26,92248319,380,304,92247939,92248319
14281,6,6,1,2412,-65,-91,26,e6:aa:ea:c9:ea:33,92318939,408,70212,92318531,92318939
14282,4,1,1,2412,-75,-91,16,b8:3a:5a:88:e6:e0,92333018,2360,11719,92330658,92333018
14283,4,1,1,2412,-75,-91,16,b8:3a:5a:88:e6:e1,92335397,2376,3,92333021,92335397
14284,6,12,1,2412,-62,-91,29,40:e3:d6:da:ba:20,92349225,160,13668,92349065,92349225
14285,6,6,1,2412,-62,-91,29,40:e3:d6:da:ba:21,92349435,368,-158,92349067,92349435
14286,6,12,1,2412,-62,-91,29,40:e3:d6:da:ba:22,92349840,180,225,92349660,92349840
14287,6,12,1,2412,-62,-91,29,40:e3:d6:da:ba:23,92350046,184,22,92349862,92350046
14288,6,12,1,2412,-62,-91,29,40:e3:d6:da:ba:24,92350264,176,42,92350088,92350264
14289,6,12,1,2412,-62,-91,29,40:e3:d6:da:ba:25,92350466,160,42,92350306,92350466
14290,4,1,1,2412,-80,-91,11,54:e4:3a:ec:fb:64,92407343,2160,54717,92405183,92407343
14291,4,1,1,2412,-90,-91,1,c0:c9:e3:4d:6e:bf,92446421,872,38206,92445549,92446421
14292,6,12,1,2412,-59,-91,32,40:e3:d6:da:ba:20,92452153,160,5572,92451993,92452153
14293,6,6,1,2412,-60,-91,31,40:e3:d6:da:ba:21,92452354,368,-167,92451986,92452354
14294,6,12,1,2412,-60,-91,31,40:e3:d6:da:ba:22,92452768,180,234,92452588,92452768
14295,6,12,1,2412,-59,-91,32,40:e3:d6:da:ba:23,92452982,184,30,92452798,92452982
14296,6,12,1,2412,-59,-91,32,40:e3:d6:da:ba:24,92453210,176,52,92453034,92453210
14297,6,12,1,2412,-59,-91,32,40:e3:d6:da:ba:25,92453438,160,68,92453278,92453438
14298,6,6,1,2412,-59,-91,32,40:e3:d6:da:ba:26,92453657,380,-161,92453277,92453657
14299,6,12,1,2412,-59,-91,32,40:e3:d6:da:ba:20,92462581,960,7964,92461621,92462581
14300,6,6,1,2412,-75,-91,16,e6:aa:ea:b7:4a:dd,92478889,408,15900,92478481,92478889
14301,4,1,1,2412,-92,-91,-1,,92490688,304,11495,92490384,92490688
14302,6,6,1,2412,-76,-91,15,e6:aa:ea:b7:4a:dd,92491011,408,-85,92490603,92491011
14303,6,6,1,2412,-75,-91,16,e6:aa:ea:b7:4a:dd,92527369,408,35950,92526961,92527369
14304,4,1,1,2412,-75,-91,16,b8:3a:5a:88:e6:e0,92537820,2360,8091,92535460,92537820
14305,6,12,1,2412,-60,-91,31,40:e3:d6:da:ba:20,92554014,160,16034,92553854,92554014
14306,6,6,1,2412,-60,-91,31,40:e3:d6:da:ba:21,92554224,368,-158,92553856,92554224
14307,6,12,1,2412,-59,-91,32,40:e3:d6:da:ba:23,92554861,184,453,92554677,92554861
14308,6,12,1,2412,-60,-91,31,40:e3:d6:da:ba:24,92555098,176,61,92554922,92555098
14309,6,12,1,2412,-60,-91,31,40:e3:d6:da:ba:25,92555317,160,59,92555157,92555317
14310,6,6,1,2412,-60,-91,31,40:e3:d6:da:ba:26,92555509,380,-188,92555129,92555509
14311,4,1,1,2412,-64,-91,27,b8:3a:5a:88:e6:e0,92592002,2240,34253,92589762,92592002
14312,4,1,1,2412,-79,-91,12,54:e4:3a:ec:fb:64,92612153,2160,17991,92609993,92612153
14313,4,1,1,2412,-75,-91,16,b8:3a:5a:88:e6:e1,92642625,2376,28096,92640249,92642625
14314,4,1,1,2412,-90,-91,1,a6:e5:7c:28:b1:d3,92649298,944,5729,92648354,92649298
14315,4,1,1,2412,-90,-91,1,a6:e5:7c:28:b1:d3,92650403,944,161,92649459,92650403
14316,4,1,1,2412,-90,-91,1,a6:e5:7c:28:b1:d3,92655192,944,3845,92654248,92655192
14317,4,1,1,2412,-89,-91,2,a6:e5:7c:28:b1:d3,92656252,944,116,92655308,92656252
14318,4,1,1,2412,-89,-91,2,a6:e5:7c:28:b1:d3,92657312,944,116,92656368,92657312
14319,4,1,1,2412,-80,-91,11,a6:e5:7c:28:b1:d3,92658399,944,143,92657455,92658399
14320,4,1,1,2412,-89,-91,2,a6:e5:7c:28:b1:d3,92660555,944,1212,92659611,92660555
14321,6,12,1,2412,-61,-91,30,40:e3:d6:da:ba:20,92661691,160,976,92661531,92661691
14322,6,6,1,2412,-61,-91,30,40:e3:d6:da:ba:21,92661892,368,-167,92661524,92661892
14323,6,12,1,2412,-61,-91,30,40:e3:d6:da:ba:22,92662306,180,234,92662126,92662306
14324,6,12,1,2412,-61,-91,30,40:e3:d6:da:ba:23,92662555,184,65,92662371,92662555
14325,6,12,1,2412,-61,-91,30,40:e3:d6:da:ba:24,92662774,176,43,92662598,92662774
14326,6,12,1,2412,-60,-91,31,40:e3:d6:da:ba:25,92662984,160,50,92662824,92662984
14327,6,6,1,2412,-61,-91,30,40:e3:d6:da:ba:26,92663185,380,-179,92662805,92663185
14328,4,1,1,2412,-81,-91,10,54:e4:3a:ec:fb:64,92714544,2160,49199,92712384,92714544
14329,4,1,1,2412,-75,-91,16,b8:3a:5a:88:e6:e0,92742618,2360,25714,92740258,92742618
14330,6,12,1,2412,-59,-91,32,40:e3:d6:da:ba:20,92758874,160,16096,92758714,92758874
14331,6,6,1,2412,-66,-91,25,e6:aa:ea:c9:ea:33,92815065,408,55783,92814657,92815065
14332,4,1,1,2412,-78,-91,13,54:e4:3a:ec:fb:64,92816947,2160,-278,92814787,92816947
14333,6,6,1,2412,-66,-91,25,e6:aa:ea:c9:ea:33,92827076,408,9721,92826668,92827076
14334,6,6,1,2412,-66,-91,25,e6:aa:ea:c9:ea:33,92839193,408,11709,92838785,92839193
14335,4,1,1,2412,-74,-91,17,b8:3a:5a:88:e6:e0,92845019,2360,3466,92842659,92845019
14336,4,1,1,2412,-75,-91,16,b8:3a:5a:88:e6:e1,92847451,2376,56,92845075,92847451
14337,6,6,1,2412,-67,-91,24,e6:aa:ea:c9:ea:33,92851314,408,3455,92850906,92851314
14338,6,12,1,2412,-60,-91,31,40:e3:d6:da:ba:20,92861221,160,9747,92861061,92861221
14339,6,6,1,2412,-60,-91,31,40:e3:d6:da:ba:21,92861422,368,-167,92861054,92861422
14340,6,12,1,2412,-59,-91,32,40:e3:d6:da:ba:24,92862265,176,667,92862089,92862265
14341,6,12,1,2412,-59,-91,32,40:e3:d6:da:ba:25,92862466,160,41,92862306,92862466
14342,6,6,1,2412,-59,-91,32,40:e3:d6:da:ba:26,92862685,380,-161,92862305,92862685
14343,6,6,1,2412,-67,-91,24,e6:aa:ea:c9:ea:33,92863435,408,342,92863027,92863435
14344,6,6,1,2412,-78,-91,13,e6:aa:ea:b7:4a:dd,92898158,408,34315,92897750,92898158
14345,6,6,1,2412,-75,-91,16,e6:aa:ea:b7:4a:dd,92910060,408,11494,92909652,92910060
14346,4,1,1,2412,-82,-91,9,54:e4:3a:ec:fb:64,92919352,2160,7132,92917192,92919352
14347,4,1,1,2412,-91,-91,0,c0:c9:e3:4d:6e:bf,92934834,872,14610,92933962,92934834
14348,6,6,1,2412,-75,-91,16,e6:aa:ea:b7:4a:dd,92946420,408,11178,92946012,92946420
14349,4,1,1,2412,-76,-91,15,b8:3a:5a:88:e6:e0,92947887,2360,-893,92945527,92947887
14350,6,12,1,2412,-60,-91,31,40:e3:d6:da:ba:20,92963615,160,15568,92963455,92963615
14351,6,6,1,2412,-60,-91,31,40:e3:d6:da:ba:21,92963825,368,-158,92963457,92963825
14352,6,12,1,2412,-60,-91,31,40:e3:d6:da:ba:22,92964239,180,234,92964059,92964239
14353,6,12,1,2412,-60,-91,31,40:e3:d6:da:ba:23,92964471,184,48,92964287,92964471
14354,6,12,1,2412,-60,-91,31,40:e3:d6:da:ba:24,92964708,176,61,92964532,92964708
14355,6,12,1,2412,-60,-91,31,40:e3:d6:da:ba:25,92964909,160,41,92964749,92964909
14356,6,6,1,2412,-60,-91,31,40:e3:d6:da:ba:26,92965101,380,-188,92964721,92965101
14357,4,1,1,2412,-81,-91,10,54:e4:3a:ec:fb:64,93021849,2160,54588,93019689,93021849
14358,6,12,1,2412,-60,-91,31,40:e3:d6:da:ba:20,93066021,160,44012,93065861,93066021
14359,6,6,1,2412,-60,-91,31,40:e3:d6:da:ba:21,93066231,368,-158,93065863,93066231
14360,6,12,1,2412,-60,-91,31,40:e3:d6:da:ba:22,93066618,180,207,93066438,93066618
14361,6,12,1,2412,-60,-91,31,40:e3:d6:da:ba:23,93066850,184,48,93066666,93066850
14362,6,12,1,2412,-60,-91,31,40:e3:d6:da:ba:24,93067078,176,52,93066902,93067078
14363,6,12,1,2412,-60,-91,31,40:e3:d6:da:ba:25,93067279,160,41,93067119,93067279
14364,6,6,1,2412,-60,-91,31,40:e3:d6:da:ba:26,93067471,380,-188,93067091,93067471
14365,4,1,1,2412,-82,-91,9,54:e4:3a:ec:fb:64,93124170,2160,54539,93122010,93124170
14366,6,6,1,2412,-69,-91,22,e6:aa:ea:c9:ea:33,93129336,408,4758,93128928,93129336
14367,6,6,1,2412,-69,-91,22,e6:aa:ea:c9:ea:33,93141452,408,11708,93141044,93141452
14368,4,1,1,2412,-78,-91,13,b8:3a:5a:88:e6:e1,93154620,2376,10792,93152244,93154620
14369,6,6,1,2412,-69,-91,22,e6:aa:ea:c9:ea:33,93165705,408,10677,93165297,93165705
14370,6,12,1,2412,-60,-91,31,40:e3:d6:da:ba:20,93168419,160,2554,93168259,93168419
14371,6,6,1,2412,-60,-91,31,40:e3:d6:da:ba:21,93168638,368,-149,93168270,93168638
14372,6,12,1,2412,-60,-91,31,40:e3:d6:da:ba:22,93169043,180,225,93168863,93169043
14373,6,12,1,2412,-60,-91,31,40:e3:d6:da:ba:23,93169248,184,21,93169064,93169248
14374,6,12,1,2412,-60,-91,31,40:e3:d6:da:ba:24,93169467,176,43,93169291,93169467
14375,6,12,1,2412,-60,-91,31,40:e3:d6:da:ba:25,93169677,160,50,93169517,93169677
14376,6,6,1,2412,-60,-91,31,40:e3:d6:da:ba:26,93169878,380,-179,93169498,93169878
14377,4,1,1,2412,-81,-91,10,54:e4:3a:ec:fb:64,93203608,2112,31618,93201496,93203608
14378,4,1,1,2412,-81,-91,10,54:e4:3a:ec:fb:64,93207347,2112,1627,93205235,93207347
14379,4,1,1,2412,-82,-91,9,54:e4:3a:ec:fb:64,93226484,2160,16977,93224324,93226484
14380,4,1,1,2412,-77,-91,14,b8:3a:5a:88:e6:e0,93254634,2360,25790,93252274,93254634
14381,4,1,1,2412,-82,-91,9,b8:3a:5a:88:e6:e1,93257013,2376,3,93254637,93257013
14382,6,12,1,2412,-60,-91,31,40:e3:d6:da:ba:20,93270816,160,13643,93270656,93270816
14383,6,6,1,2412,-60,-91,31,40:e3:d6:da:ba:21,93271008,368,-176,93270640,93271008
14384,6,12,1,2412,-60,-91,31,40:e3:d6:da:ba:22,93271413,180,225,93271233,93271413
14385,4,1,1,2412,-80,-91,11,54:e4:3a:ec:fb:64,93319186,2112,45661,93317074,93319186
14386,4,1,1,2412,-70,-91,21,54:e4:3a:ec:fb:64,93321381,2112,83,93319269,93321381
14387,4,1,1,2412,-81,-91,10,54:e4:3a:ec:fb:64,93323738,2112,245,93321626,93323738
14388,4,1,1,2412,-81,-91,10,54:e4:3a:ec:fb:64,93330172,2160,4274,93328012,93330172
14389,4,1,1,2412,-78,-91,13,b8:3a:5a:88:e6:e0,93357019,2360,24487,93354659,93357019
14390,4,1,1,2412,-83,-91,8,b8:3a:5a:88:e6:e1,93359426,2376,31,93357050,93359426
14391,6,12,1,2412,-61,-91,30,40:e3:d6:da:ba:22,93373846,180,14240,93373666,93373846
14392,6,12,1,2412,-61,-91,30,40:e3:d6:da:ba:25,93374490,160,484,93374330,93374490
14393,6,6,1,2412,-61,-91,30,40:e3:d6:da:ba:26,93374681,380,-189,93374301,93374681
14394,4,1,1,2412,-81,-91,10,54:e4:3a:ec:fb:64,93398857,2112,22064,93396745,93398857
14395,4,1,1,2412,-80,-91,11,54:e4:3a:ec:fb:64,93401475,2112,506,93399363,93401475
14396,4,1,1,2412,-80,-91,11,54:e4:3a:ec:fb:64,93418915,2112,15328,93416803,93418915
14397,6,6,1,2412,-75,-91,16,e6:aa:ea:b7:4a:dd,93443217,408,23894,93442809,93443217
14398,6,6,1,2412,-76,-91,15,e6:aa:ea:b7:4a:dd,93455343,408,11718,93454935,93455343
14399,4,1,1,2412,-83,-91,8,b8:3a:5a:88:e6:e0,93459419,2360,1716,93457059,93459419
14400,4,1,1,2412,-81,-91,10,b8:3a:5a:88:e6:e1,93461808,2376,13,93459432,93461808
14401,6,12,1,2412,-61,-91,30,40:e3:d6:da:ba:20,93475635,160,13667,93475475,93475635
14402,6,6,1,2412,-61,-91,30,40:e3:d6:da:ba:21,93475854,368,-149,93475486,93475854
14403,6,12,1,2412,-61,-91,30,40:e3:d6:da:ba:22,93476250,180,216,93476070,93476250
14404,6,12,1,2412,-62,-91,29,40:e3:d6:da:ba:23,93476482,184,48,93476298,93476482
14405,6,12,1,2412,-61,-91,30,40:e3:d6:da:ba:24,93476701,176,43,93476525,93476701
14406,6,12,1,2412,-61,-91,30,40:e3:d6:da:ba:25,93476902,160,41,93476742,93476902
14407,4,1,1,2412,-91,-91,0,,93506388,304,29182,93506084,93506388
14408,4,1,1,2412,-89,-91,2,,93511644,304,4952,93511340,93511644
14409,4,1,1,2412,-89,-91,2,,93513709,304,1761,93513405,93513709
14410,4,1,1,2412,-91,-91,0,a6:e5:7c:28:b1:d3,93536926,944,22273,93535982,93536926
14411,4,1,1,2412,-90,-91,1,a6:e5:7c:28:b1:d3,93537977,944,107,93537033,93537977
14412,4,1,1,2412,-90,-91,1,a6:e5:7c:28:b1:d3,93539181,944,260,93538237,93539181
14413,4,1,1,2412,-89,-91,2,a6:e5:7c:28:b1:d3,93540250,944,125,93539306,93540250
14414,4,1,1,2412,-89,-91,2,a6:e5:7c:28:b1:d3,93541364,944,170,93540420,93541364
14415,4,1,1,2412,-90,-91,1,a6:e5:7c:28:b1:d3,93542451,944,143,93541507,93542451
14416,4,1,1,2412,-89,-91,2,a6:e5:7c:28:b1:d3,93543502,944,107,93542558,93543502
14417,4,1,1,2412,-82,-91,9,b8:3a:5a:88:e6:e0,93561820,2360,15958,93559460,93561820
14418,4,1,1,2412,-83,-91,8,b8:3a:5a:88:e6:e1,93564209,2376,13,93561833,93564209
14419,6,6,1,2412,-58,-91,33,40:e3:d6:da:ba:21,93578236,368,13659,93577868,93578236
14420,6,12,1,2412,-61,-91,30,40:e3:d6:da:ba:22,93578632,180,216,93578452,93578632
14421,6,12,1,2412,-61,-91,30,40:e3:d6:da:ba:23,93578847,184,31,93578663,93578847
14422,6,12,1,2412,-61,-91,30,40:e3:d6:da:ba:24,93579065,176,42,93578889,93579065
14423,6,12,1,2412,-61,-91,30,40:e3:d6:da:ba:25,93579275,160,50,93579115,93579275
14424,6,6,1,2412,-60,-91,31,40:e3:d6:da:ba:26,93579495,380,-160,93579115,93579495
14425,4,1,1,2412,-83,-91,8,b8:3a:5a:88:e6:e1,93599471,2256,17720,93597215,93599471
14426,4,1,1,2412,-88,-91,3,a6:e5:7c:28:b1:d3,93628090,992,27627,93627098,93628090
14427,6,6,1,2412,-70,-91,21,e6:aa:ea:c9:ea:33,93650685,408,22187,93650277,93650685
14428,6,6,1,2412,-70,-91,21,e6:aa:ea:c9:ea:33,93662798,408,11705,93662390,93662798
14429,6,6,1,2412,-71,-91,20,e6:aa:ea:c9:ea:33,93674924,408,11718,93674516,93674924
14430,6,12,1,2412,-60,-91,31,40:e3:d6:da:ba:24,93681496,176,6396,93681320,93681496
14431,6,12,1,2412,-60,-91,31,40:e3:d6:da:ba:25,93681698,160,42,93681538,93681698
14432,6,6,1,2412,-70,-91,21,e6:aa:ea:c9:ea:33,93687233,408,5127,93686825,93687233
14433,6,6,1,2412,-71,-91,20,e6:aa:ea:c9:ea:33,93699205,408,11564,93698797,93699205
14434,4,1,1,2412,-89,-91,2,a6:e5:7c:28:b1:d3,93727748,992,27551,93726756,93727748
14435,4,1,1,2412,-81,-91,10,54:e4:3a:ec:fb:64,93738555,2160,8647,93736395,93738555
14436,4,1,1,2412,-83,-91,8,b8:3a:5a:88:e6:e0,93767508,2360,26593,93765148,93767508
14437,4,1,1,2412,-42,-91,49,b8:3a:5a:88:e6:e1,93772337,2256,2573,93770081,93772337
14438,6,12,1,2412,-60,-91,31,40:e3:d6:da:ba:20,93782819,160,10322,93782659,93782819
14439,6,12,1,2412,-61,-91,30,40:e3:d6:da:ba:24,93783893,176,898,93783717,93783893
14440,6,12,1,2412,-61,-91,30,40:e3:d6:da:ba:25,93784113,160,60,93783953,93784113
14441,6,6,1,2412,-85,-91,6,78:8a:20:fa:27:f9,93811043,88,26842,93810955,93811043
14442,4,1,1,2412,-82,-91,9,b8:3a:5a:88:e6:e0,93811545,2240,-1738,93809305,93811545
14443,6,12,1,2412,-87,-91,4,,93816124,32,4547,93816092,93816124
14444,4,1,1,2412,-83,-91,8,54:e4:3a:ec:fb:64,93840977,2160,22693,93838817,93840977
14445,4,1,1,2412,-79,-91,12,b8:3a:5a:88:e6:e0,93861502,2240,18285,93859262,93861502
14446,4,1,1,2412,-82,-91,9,b8:3a:5a:88:e6:e1,93863780,2256,22,93861524,93863780
14447,4,1,1,2412,-81,-91,10,b8:3a:5a:88:e6:e1,93871689,2376,5533,93869313,93871689
14448,6,12,1,2412,-60,-91,31,40:e3:d6:da:ba:25,93886467,160,14618,93886307,93886467
14449,4,1,1,2412,-85,-91,6,c0:c9:e3:4d:6e:bf,93923295,872,35956,93922423,93923295
14450,6,6,1,2412,-76,-91,15,e6:aa:ea:b7:4a:dd,93938453,408,14750,93938045,93938453
14451,6,6,1,2412,-75,-91,16,e6:aa:ea:b7:4a:dd,93950570,408,11709,93950162,93950570
14452,6,6,1,2412,-74,-91,17,e6:aa:ea:b7:4a:dd,93962687,408,11709,93962279,93962687
14453,4,1,1,2412,-79,-91,12,b8:3a:5a:88:e6:e1,93974102,2376,9039,93971726,93974102
14454,6,6,1,2412,-82,-91,9,e6:aa:ea:b7:4a:dd,93986910,408,12400,93986502,93986910
14455,6,12,1,2412,-63,-91,28,40:e3:d6:da:ba:20,93987640,160,570,93987480,93987640
14456,6,12,1,2412,-59,-91,32,40:e3:d6:da:ba:22,93988255,180,435,93988075,93988255
14457,6,12,1,2412,-59,-91,32,40:e3:d6:da:ba:25,93988916,160,501,93988756,93988916
14458,6,6,1,2412,-59,-91,32,40:e3:d6:da:ba:26,93989135,380,-161,93988755,93989135
14459,4,1,1,2412,-79,-91,12,54:e4:3a:ec:fb:64,94045778,2160,54483,94043618,94045778
14460,6,6,1,2412,-70,-91,21,e6:aa:ea:c9:ea:33,94068419,408,22233,94068011,94068419
14461,4,1,1,2412,-79,-91,12,b8:3a:5a:88:e6:e0,94073901,2360,3122,94071541,94073901
14462,4,1,1,2412,-78,-91,13,b8:3a:5a:88:e6:e1,94076289,2376,12,94073913,94076289
14463,6,12,1,2412,-60,-91,31,40:e3:d6:da:ba:20,94090034,160,13585,94089874,94090034
14464,6,6,1,2412,-60,-91,31,40:e3:d6:da:ba:21,94090235,368,-167,94089867,94090235
14465,6,12,1,2412,-60,-91,31,40:e3:d6:da:ba:22,94090649,180,234,94090469,94090649
14466,6,12,1,2412,-60,-91,31,40:e3:d6:da:ba:23,94090854,184,21,94090670,94090854
14467,6,12,1,2412,-60,-91,31,40:e3:d6:da:ba:24,94091082,176,52,94090906,94091082
14468,4,1,1,2412,-87,-91,4,f8:59:71:19:eb:dc,94094511,784,2645,94093727,94094511
14469,6,6,1,2412,-85,-91,6,,94095821,44,1266,94095777,94095821
14470,4,1,1,2412,-79,-91,12,b8:3a:5a:88:e6:e1,94098828,2256,751,94096572,94098828
14471,4,1,1,2412,-87,-91,4,,94101095,304,1963,94100791,94101095
14472,6,6,1,2412,-70,-91,21,e6:aa:ea:c9:ea:33,94104761,408,3258,94104353,94104761
14473,6,6,1,2412,-70,-91,21,e6:aa:ea:c9:ea:33,94116902,408,11733,94116494,94116902
14474,6,6,1,2412,-85,-91,6,f8:59:71:19:eb:dc,94155786,124,38760,94155662,94155786
14475,4,1,1,2412,-90,-91,1,a6:e5:7c:28:b1:d3,94189171,944,32441,94188227,94189171
14476,6,12,1,2412,-61,-91,30,40:e3:d6:da:ba:20,94194681,160,5350,94194521,94194681
14477,6,6,1,2412,-61,-91,30,40:e3:d6:da:ba:21,94194874,368,-175,94194506,94194874
14478,6,12,1,2412,-61,-91,30,40:e3:d6:da:ba:22,94195269,180,215,94195089,94195269
14479,6,12,1,2412,-61,-91,30,40:e3:d6:da:ba:23,94195493,184,40,94195309,94195493
14480,6,12,1,2412,-61,-91,30,40:e3:d6:da:ba:24,94195729,176,60,94195553,94195729
14481,6,12,1,2412,-60,-91,31,40:e3:d6:da:ba:25,94195949,160,60,94195789,94195949
14482,6,6,1,2412,-60,-91,31,40:e3:d6:da:ba:26,94196159,380,-170,94195779,94196159
14483,4,1,1,2412,-76,-91,15,b8:3a:5a:88:e6:e0,94278633,2360,80114,94276273,94278633
14484,6,12,1,2412,-62,-91,29,40:e3:d6:da:ba:20,94294827,160,16034,94294667,94294827
14485,6,6,1,2412,-62,-91,29,40:e3:d6:da:ba:21,94295028,368,-167,94294660,94295028
14486,6,12,1,2412,-62,-91,29,40:e3:d6:da:ba:22,94295424,180,216,94295244,94295424
14487,6,12,1,2412,-62,-91,29,40:e3:d6:da:ba:23,94295656,184,48,94295472,94295656
14488,6,12,1,2412,-62,-91,29,40:e3:d6:da:ba:24,94295893,176,61,94295717,94295893
14489,6,12,1,2412,-61,-91,30,40:e3:d6:da:ba:25,94296121,160,68,94295961,94296121
14490,6,6,1,2412,-62,-91,29,40:e3:d6:da:ba:26,94296322,380,-179,94295942,94296322
14491,4,1,1,2412,-77,-91,14,b8:3a:5a:88:e6:e0,94381048,2360,82366,94378688,94381048
14492,6,12,1,2412,-67,-91,24,40:e3:d6:da:ba:20,94397722,160,16514,94397562,94397722
14493,6,12,1,2412,-67,-91,24,40:e3:d6:da:ba:23,94398552,184,646,94398368,94398552
14494,6,12,1,2412,-67,-91,24,40:e3:d6:da:ba:24,94398770,176,42,94398594,94398770
14495,6,12,1,2412,-67,-91,24,40:e3:d6:da:ba:25,94398981,160,51,94398821,94398981
14496,6,6,1,2412,-67,-91,24,40:e3:d6:da:ba:26,94399200,380,-161,94398820,94399200
14497,4,1,1,2412,-90,-91,1,c0:c9:e3:4d:6e:bf,94418110,872,18038,94417238,94418110
14498,6,6,1,2412,-79,-91,12,e6:aa:ea:b7:4a:dd,94482345,408,63827,94481937,94482345
14499,4,1,1,2412,-77,-91,14,b8:3a:5a:88:e6:e0,94483427,2360,-1278,94481067,94483427
14500,4,1,1,2412,-76,-91,15,b8:3a:5a:88:e6:e1,94485825,2376,22,94483449,94485825
14501,6,6,1,2412,-78,-91,13,e6:aa:ea:b7:4a:dd,94494464,408,8231,94494056,94494464
14502,6,6,1,2412,-68,-91,23,e6:aa:ea:c9:ea:33,94498074,408,3202,94497666,94498074
14503,6,12,1,2412,-63,-91,28,40:e3:d6:da:ba:20,94499634,160,1400,94499474,94499634
14504,6,6,1,2412,-62,-91,29,40:e3:d6:da:ba:21,94499844,368,-158,94499476,94499844
14505,6,6,1,2412,-78,-91,13,e6:aa:ea:b7:4a:dd,94506592,408,6340,94506184,94506592
14506,6,6,1,2412,-68,-91,23,e6:aa:ea:c9:ea:33,94510328,408,3328,94509920,94510328
14507,6,6,1,2412,-73,-91,18,e6:aa:ea:c9:ea:33,94522334,408,11598,94521926,94522334
14508,6,6,1,2412,-73,-91,18,e6:aa:ea:c9:ea:33,94534757,408,12015,94534349,94534757
14509,4,1,1,2412,-77,-91,14,54:e4:3a:ec:fb:64,94557786,2160,20869,94555626,94557786
14510,4,1,1,2412,-76,-91,15,b8:3a:5a:88:e6:e1,94588216,2376,28054,94585840,94588216
14511,6,12,1,2412,-62,-91,29,40:e3:d6:da:ba:20,94602035,160,13659,94601875,94602035
14512,6,6,1,2412,-63,-91,28,40:e3:d6:da:ba:21,94602338,368,-65,94601970,94602338
14513,6,12,1,2412,-62,-91,29,40:e3:d6:da:ba:22,94602743,180,225,94602563,94602743
14514,6,12,1,2412,-62,-91,29,40:e3:d6:da:ba:23,94602975,184,48,94602791,94602975
14515,6,12,1,2412,-68,-91,23,40:e3:d6:da:ba:24,94603185,176,34,94603009,94603185
14516,6,12,1,2412,-68,-91,23,40:e3:d6:da:ba:25,94603404,160,59,94603244,94603404
14517,6,6,1,2412,-68,-91,23,40:e3:d6:da:ba:26,94603596,380,-188,94603216,94603596
14518,4,1,1,2412,-82,-91,9,54:e4:3a:ec:fb:64,94660171,2160,54415,94658011,94660171
14519,4,1,1,2412,-75,-91,16,b8:3a:5a:88:e6:e1,94692731,2376,30184,94690355,94692731
14520,6,12,1,2412,-63,-91,28,40:e3:d6:da:ba:20,94704422,160,11531,94704262,94704422
14521,6,6,1,2412,-63,-91,28,40:e3:d6:da:ba:21,94704641,368,-149,94704273,94704641
14522,6,12,1,2412,-62,-91,29,40:e3:d6:da:ba:22,94705046,180,225,94704866,94705046
14523,6,12,1,2412,-63,-91,28,40:e3:d6:da:ba:23,94705252,184,22,94705068,94705252
14524,6,12,1,2412,-60,-91,31,40:e3:d6:da:ba:24,94705487,176,59,94705311,94705487
14525,6,6,1,2412,-63,-91,28,40:e3:d6:da:ba:26,94705908,380,41,94705528,94705908
14526,4,1,1,2412,-79,-91,12,54:e4:3a:ec:fb:64,94762569,2160,54501,94760409,94762569
14527,6,6,1,2412,-78,-91,13,e6:aa:ea:b7:4a:dd,94774245,408,11268,94773837,94774245
14528,6,6,1,2412,-77,-91,14,e6:aa:ea:b7:4a:dd,94798567,408,23914,94798159,94798567
14529,6,6,1,2412,-69,-91,22,e6:aa:ea:c9:ea:33,94801301,408,2326,94800893,94801301
14530,6,12,1,2412,-63,-91,28,40:e3:d6:da:ba:20,94807289,160,5828,94807129,94807289
14531,6,6,1,2412,-62,-91,29,40:e3:d6:da:ba:21,94807508,368,-149,94807140,94807508
14532,6,12,1,2412,-62,-91,29,40:e3:d6:da:ba:22,94807922,180,234,94807742,94807922
14533,6,12,1,2412,-62,-91,29,40:e3:d6:da:ba:23,94808136,184,30,94807952,94808136
14534,6,12,1,2412,-62,-91,29,40:e3:d6:da:ba:24,94808364,176,52,94808188,94808364
14535,6,12,1,2412,-62,-91,29,40:e3:d6:da:ba:25,94808592,160,68,94808432,94808592
14536,6,6,1,2412,-62,-91,29,40:e3:d6:da:ba:26,94808793,380,-179,94808413,94808793
14537,6,6,1,2412,-76,-91,15,e6:aa:ea:b7:4a:dd,94810609,408,1408,94810201,94810609
14538,6,6,1,2412,-76,-91,15,e6:aa:ea:b7:4a:dd,94822713,408,11696,94822305,94822713
14539,4,1,1,2412,-80,-91,11,54:e4:3a:ec:fb:64,94864965,2160,40092,94862805,94864965
14540,4,1,1,2412,-75,-91,16,b8:3a:5a:88:e6:e0,94895163,2360,27838,94892803,94895163
14541,6,12,1,2412,-63,-91,28,40:e3:d6:da:ba:20,94909230,160,13907,94909070,94909230
14542,6,6,1,2412,-63,-91,28,40:e3:d6:da:ba:21,94909431,368,-167,94909063,94909431
14543,6,12,1,2412,-63,-91,28,40:e3:d6:da:ba:23,94910518,184,903,94910334,94910518
14544,6,12,1,2412,-63,-91,28,40:e3:d6:da:ba:24,94910728,176,34,94910552,94910728
14545,6,12,1,2412,-63,-91,28,40:e3:d6:da:ba:25,94910929,160,41,94910769,94910929
14546,6,6,1,2412,-63,-91,28,40:e3:d6:da:ba:26,94911121,380,-188,94910741,94911121
14547,4,1,1,2412,-77,-91,14,54:e4:3a:ec:fb:64,94967378,2160,54097,94965218,94967378
14548,4,1,1,2412,-80,-91,11,b8:3a:5a:88:e6:e0,94995428,2360,25690,94993068,94995428
14549,4,1,1,2412,-81,-91,10,b8:3a:5a:88:e6:e1,94997835,2376,31,94995459,94997835
14550,6,12,1,2412,-63,-91,28,40:e3:d6:da:ba:25,95012855,160,14860,95012695,95012855
14551,6,6,1,2412,-63,-91,28,40:e3:d6:da:ba:26,95013056,380,-179,95012676,95013056
14552,4,1,1,2412,-82,-91,9,54:e4:3a:ec:fb:64,95069770,2160,54554,95067610,95069770
14553,4,1,1,2412,-75,-91,16,b8:3a:5a:88:e6:e0,95097824,2360,25694,95095464,95097824
14554,6,6,1,2412,-81,-91,10,e6:aa:ea:b7:4a:dd,95101721,408,3489,95101313,95101721
14555,6,12,1,2412,-67,-91,24,40:e3:d6:da:ba:20,95114285,160,12404,95114125,95114285
14556,6,6,1,2412,-67,-91,24,40:e3:d6:da:ba:21,95114495,368,-158,95114127,95114495
14557,6,12,1,2412,-67,-91,24,40:e3:d6:da:ba:22,95114909,180,234,95114729,95114909
14558,6,12,1,2412,-67,-91,24,40:e3:d6:da:ba:23,95115114,184,21,95114930,95115114
14559,6,12,1,2412,-67,-91,24,40:e3:d6:da:ba:24,95115333,176,43,95115157,95115333
14560,6,12,1,2412,-67,-91,24,40:e3:d6:da:ba:25,95115535,160,42,95115375,95115535
14561,6,6,1,2412,-67,-91,24,40:e3:d6:da:ba:26,95115744,380,-171,95115364,95115744
14562,6,6,1,2412,-81,-91,10,e6:aa:ea:b7:4a:dd,95125944,408,9792,95125536,95125944
14563,6,6,1,2412,-84,-91,7,e6:aa:ea:b7:4a:dd,95138063,408,11711,95137655,95138063
14564,4,1,1,2412,-82,-91,9,54:e4:3a:ec:fb:64,95172172,2160,31949,95170012,95172172
14565,4,1,1,2412,-75,-91,16,b8:3a:5a:88:e6:e1,95202617,2376,28069,95200241,95202617
14566,6,12,1,2412,-66,-91,25,40:e3:d6:da:ba:20,95216426,160,13649,95216266,95216426
14567,6,6,1,2412,-66,-91,25,40:e3:d6:da:ba:21,95216636,368,-158,95216268,95216636
14568,6,12,1,2412,-66,-91,25,40:e3:d6:da:ba:22,95217023,180,207,95216843,95217023
14569,6,12,1,2412,-66,-91,25,40:e3:d6:da:ba:23,95217238,184,31,95217054,95217238
14570,6,12,1,2412,-66,-91,25,40:e3:d6:da:ba:24,95217456,176,42,95217280,95217456
14571,6,12,1,2412,-66,-91,25,40:e3:d6:da:ba:25,95217676,160,60,95217516,95217676
14572,4,1,1,2412,-79,-91,12,54:e4:3a:ec:fb:64,95274599,2160,54763,95272439,95274599
14573,4,1,1,2412,-72,-91,19,b8:3a:5a:88:e6:e0,95302639,2360,25680,95300279,95302639
14574,4,1,1,2412,-71,-91,20,b8:3a:5a:88:e6:e1,95305037,2376,22,95302661,95305037
14575,6,12,1,2412,-67,-91,24,40:e3:d6:da:ba:20,95318832,160,13635,95318672,95318832
14576,6,6,1,2412,-67,-91,24,40:e3:d6:da:ba:21,95319033,368,-167,95318665,95319033
14577,6,12,1,2412,-66,-91,25,40:e3:d6:da:ba:22,95319447,180,234,95319267,95319447
14578,6,12,1,2412,-67,-91,24,40:e3:d6:da:ba:23,95319661,184,30,95319477,95319661
14579,6,12,1,2412,-66,-91,25,40:e3:d6:da:ba:24,95319880,176,43,95319704,95319880
14580,6,12,1,2412,-67,-91,24,40:e3:d6:da:ba:25,95320115,160,75,95319955,95320115
14581,6,6,1,2412,-67,-91,24,40:e3:d6:da:ba:26,95320325,380,-170,95319945,95320325
14582,6,6,1,2412,-67,-91,24,e6:aa:ea:c9:ea:33,95321086,408,353,95320678,95321086
14583,6,6,1,2412,-67,-91,24,e6:aa:ea:c9:ea:33,95333091,408,11597,95332683,95333091
14584,6,6,1,2412,-67,-91,24,e6:aa:ea:c9:ea:33,95345212,408,11713,95344804,95345212
14585,6,6,1,2412,-67,-91,24,e6:aa:ea:c9:ea:33,95357320,408,11700,95356912,95357320
14586,4,1,1,2412,-91,-91,0,a6:e5:7c:28:b1:d3,95364926,992,6614,95363934,95364926
14587,6,6,1,2412,-67,-91,24,e6:aa:ea:c9:ea:33,95369425,408,4091,95369017,95369425
14588,4,1,1,2412,-87,-91,4,c0:c9:e3:4d:6e:bf,95402276,872,31979,95401404,95402276
14589,4,1,1,2412,-70,-91,21,b8:3a:5a:88:e6:e1,95407810,2376,3158,95405434,95407810
14590,6,12,1,2412,-82,-91,9,40:e3:d6:da:c6:e0,95414379,960,5609,95413419,95414379
14591,6,6,1,2412,-85,-91,6,e6:aa:ea:b7:4a:dd,95417049,408,2262,95416641,95417049
14592,6,12,1,2412,-64,-91,27,40:e3:d6:da:ba:20,95421250,160,4041,95421090,95421250
14593,6,6,1,2412,-64,-91,27,40:e3:d6:da:ba:21,95421460,368,-158,95421092,95421460
14594,6,12,1,2412,-64,-91,27,40:e3:d6:da:ba:22,95421847,180,207,95421667,95421847
14595,6,12,1,2412,-64,-91,27,40:e3:d6:da:ba:23,95422071,184,40,95421887,95422071
14596,6,12,1,2412,-64,-91,27,40:e3:d6:da:ba:24,95422289,176,42,95422113,95422289
14597,6,12,1,2412,-64,-91,27,40:e3:d6:da:ba:25,95422509,160,60,95422349,95422509
14598,6,6,1,2412,-64,-91,27,40:e3:d6:da:ba:26,95422728,380,-161,95422348,95422728
14599,6,6,1,2412,-84,-91,7,e6:aa:ea:b7:4a:dd,95429166,408,6030,95428758,95429166
14600,6,6,1,2412,-84,-91,7,e6:aa:ea:b7:4a:dd,95441280,408,11706,95440872,95441280
14601,4,1,1,2412,-81,-91,10,54:e4:3a:ec:fb:64,95479429,2160,35989,95477269,95479429
14602,4,1,1,2412,-80,-91,11,b8:3a:5a:88:e6:e1,95509830,2376,28025,95507454,95509830
14603,4,1,1,2412,-87,-91,4,,95581170,304,71036,95580866,95581170
14604,4,1,1,2412,-80,-91,11,54:e4:3a:ec:fb:64,95581789,2160,-1541,95579629,95581789
14605,4,1,1,2412,-84,-91,7,b8:3a:5a:88:e6:e0,95610043,2360,25894,95607683,95610043
14606,4,1,1,2412,-83,-91,8,b8:3a:5a:88:e6:e0,95617004,2240,4721,95614764,95617004
14607,6,12,1,2412,-65,-91,26,40:e3:d6:da:ba:20,95626027,160,8863,95625867,95626027
14608,6,6,1,2412,-65,-91,26,40:e3:d6:da:ba:21,95626237,368,-158,95625869,95626237
14609,6,12,1,2412,-65,-91,26,40:e3:d6:da:ba:22,95626651,180,234,95626471,95626651
14610,6,12,1,2412,-65,-91,26,40:e3:d6:da:ba:23,95626875,184,40,95626691,95626875
14611,6,12,1,2412,-65,-91,26,40:e3:d6:da:ba:24,95627084,176,33,95626908,95627084
14612,6,12,1,2412,-65,-91,26,40:e3:d6:da:ba:25,95627286,160,42,95627126,95627286
14613,6,6,1,2412,-65,-91,26,40:e3:d6:da:ba:26,95627478,380,-188,95627098,95627478
14614,4,1,1,2412,-83,-91,8,b8:3a:5a:88:e6:e0,95672192,2240,42474,95669952,95672192
14615,4,1,1,2412,-79,-91,12,54:e4:3a:ec:fb:64,95684191,2160,9839,95682031,95684191
14616,4,1,1,2412,-82,-91,9,b8:3a:5a:88:e6:e1,95714715,2376,28148,95712339,95714715
14617,6,6,1,2412,-80,-91,11,e6:aa:ea:b7:4a:dd,95719498,408,4375,95719090,95719498
14618,6,12,1,2412,-65,-91,26,40:e3:d6:da:ba:20,95728444,160,8786,95728284,95728444
14619,6,12,1,2412,-65,-91,26,40:e3:d6:da:ba:22,95729050,180,426,95728870,95729050
14620,6,12,1,2412,-65,-91,26,40:e3:d6:da:ba:23,95729264,184,30,95729080,95729264
14621,6,12,1,2412,-65,-91,26,40:e3:d6:da:ba:24,95729492,176,52,95729316,95729492
14622,6,12,1,2412,-65,-91,26,40:e3:d6:da:ba:25,95729711,160,59,95729551,95729711
14623,6,6,1,2412,-79,-91,12,e6:aa:ea:b7:4a:dd,95767973,408,37854,95767565,95767973
14624,4,1,1,2412,-91,-91,0,a6:e5:7c:28:b1:d3,95774289,992,5324,95773297,95774289
14625,4,1,1,2412,-81,-91,10,54:e4:3a:ec:fb:64,95786590,2160,10141,95784430,95786590
14626,6,12,1,2412,-67,-91,24,40:e3:d6:da:ba:20,95830834,160,44084,95830674,95830834
14627,6,6,1,2412,-67,-91,24,40:e3:d6:da:ba:21,95831044,368,-158,95830676,95831044
14628,6,12,1,2412,-67,-91,24,40:e3:d6:da:ba:22,95831440,180,216,95831260,95831440
14629,6,12,1,2412,-67,-91,24,40:e3:d6:da:ba:23,95831646,184,22,95831462,95831646
14630,6,12,1,2412,-67,-91,24,40:e3:d6:da:ba:24,95831855,176,33,95831679,95831855
14631,6,12,1,2412,-66,-91,25,40:e3:d6:da:ba:25,95832066,160,51,95831906,95832066
14632,6,6,1,2412,-67,-91,24,40:e3:d6:da:ba:26,95832258,380,-188,95831878,95832258
14633,6,6,1,2412,-67,-91,24,e6:aa:ea:c9:ea:33,95841170,408,8504,95840762,95841170
14634,6,6,1,2412,-65,-91,26,e6:aa:ea:c9:ea:33,95853278,408,11700,95852870,95853278
14635,6,6,1,2412,-64,-91,27,e6:aa:ea:c9:ea:33,95877725,408,24039,95877317,95877725
14636,4,1,1,2412,-89,-91,2,c0:c9:e3:4d:6e:bf,95894490,872,15893,95893618,95894490
14637,4,1,1,2412,-91,-91,0,,95895379,304,585,95895075,95895379
14638,4,1,1,2412,-81,-91,10,b8:3a:5a:88:e6:e0,95917042,2360,19303,95914682,95917042
14639,6,12,1,2412,-66,-91,25,40:e3:d6:da:ba:20,95933228,160,16026,95933068,95933228
14640,6,12,1,2412,-66,-91,25,40:e3:d6:da:ba:22,95933842,180,434,95933662,95933842
14641,6,12,1,2412,-66,-91,25,40:e3:d6:da:ba:24,95934302,176,284,95934126,95934302
14642,6,12,1,2412,-66,-91,25,40:e3:d6:da:ba:25,95934522,160,60,95934362,95934522
14643,6,6,1,2412,-66,-91,25,40:e3:d6:da:ba:26,95934714,380,-188,95934334,95934714
14644,4,1,1,2412,-82,-91,9,b8:3a:5a:88:e6:e1,96021829,2376,84739,96019453,96021829
14645,6,12,1,2412,-66,-91,25,40:e3:d6:da:ba:22,96036234,180,14225,96036054,96036234
14646,6,12,1,2412,-66,-91,25,40:e3:d6:da:ba:25,96036922,160,528,96036762,96036922
14647,6,6,1,2412,-66,-91,25,40:e3:d6:da:ba:26,96037114,380,-188,96036734,96037114
14648,4,1,1,2412,-48,-91,43,b8:3a:5a:88:e6:e0,96121848,2360,82374,96119488,96121848
14649,6,12,1,2412,-66,-91,25,40:e3:d6:da:ba:20,96138048,160,16040,96137888,96138048
14650,6,12,1,2412,-65,-91,26,40:e3:d6:da:ba:22,96138654,180,426,96138474,96138654
14651,6,12,1,2412,-66,-91,25,40:e3:d6:da:ba:23,96138869,184,31,96138685,96138869
14652,6,12,1,2412,-66,-91,25,40:e3:d6:da:ba:24,96139105,176,60,96138929,96139105
14653,6,12,1,2412,-65,-91,26,40:e3:d6:da:ba:25,96139316,160,51,96139156,96139316
14654,6,6,1,2412,-79,-91,12,e6:aa:ea:b7:4a:dd,96173073,408,33349,96172665,96173073
14655,6,6,1,2412,-89,-91,2,40:e3:d6:da:c0:21,96212327,368,38886,96211959,96212327
14656,4,1,1,2412,-61,-91,30,b8:3a:5a:88:e6:e0,96224244,2360,9557,96221884,96224244
14657,4,1,1,2412,-74,-91,17,b8:3a:5a:88:e6:e1,96226624,2376,4,96224248,96226624
14658,6,12,1,2412,-66,-91,25,40:e3:d6:da:ba:20,96240431,160,13647,96240271,96240431
14659,6,6,1,2412,-66,-91,25,40:e3:d6:da:ba:21,96240632,368,-167,96240264,96240632
14660,6,12,1,2412,-65,-91,26,40:e3:d6:da:ba:22,96241037,180,225,96240857,96241037
14661,6,12,1,2412,-65,-91,26,40:e3:d6:da:ba:23,96241261,184,40,96241077,96241261
14662,6,12,1,2412,-65,-91,26,40:e3:d6:da:ba:24,96241470,176,33,96241294,96241470
14663,6,12,1,2412,-65,-91,26,40:e3:d6:da:ba:25,96241671,160,41,96241511,96241671
14664,6,6,1,2412,-65,-91,26,40:e3:d6:da:ba:26,96241873,380,-178,96241493,96241873
14665,6,6,1,2412,-68,-91,23,e6:aa:ea:c9:ea:33,96259046,408,16765,96258638,96259046
14666,6,6,1,2412,-67,-91,24,e6:aa:ea:c9:ea:33,96271171,408,11717,96270763,96271171
14667,6,6,1,2412,-67,-91,24,e6:aa:ea:c9:ea:33,96295408,408,23829,96295000,96295408
14668,6,6,1,2412,-68,-91,23,e6:aa:ea:c9:ea:33,96307528,408,11712,96307120,96307528
14669,6,12,1,2412,-67,-91,24,40:e3:d6:da:ba:20,96342830,160,35142,96342670,96342830
14670,6,6,1,2412,-67,-91,24,40:e3:d6:da:ba:21,96343022,368,-176,96342654,96343022
14671,6,12,1,2412,-67,-91,24,40:e3:d6:da:ba:22,96343418,180,216,96343238,96343418
14672,6,12,1,2412,-67,-91,24,40:e3:d6:da:ba:23,96343632,184,30,96343448,96343632
14673,6,12,1,2412,-67,-91,24,40:e3:d6:da:ba:24,96343869,176,61,96343693,96343869
14674,6,6,1,2412,-67,-91,24,40:e3:d6:da:ba:26,96344289,380,40,96343909,96344289
14675,4,1,1,2412,-92,-91,-1,c0:c9:e3:4d:6e:bf,96391169,872,46008,96390297,96391169
14676,4,1,1,2412,-88,-91,3,,96392058,304,585,96391754,96392058
14677,4,1,1,2412,-83,-91,8,54:e4:3a:ec:fb:64,96400993,2160,6775,96398833,96400993
14678,4,1,1,2412,-77,-91,14,b8:3a:5a:88:e6:e0,96429031,2360,25678,96426671,96429031
14679,4,1,1,2412,-79,-91,12,b8:3a:5a:88:e6:e1,96432013,2376,606,96429637,96432013
14680,6,6,1,2412,-66,-91,25,40:e3:d6:da:ba:21,96445458,368,13077,96445090,96445458
14681,6,12,1,2412,-66,-91,25,40:e3:d6:da:ba:22,96445854,180,216,96445674,96445854
14682,6,12,1,2412,-65,-91,26,40:e3:d6:da:ba:25,96446498,160,484,96446338,96446498
14683,6,6,1,2412,-66,-91,25,40:e3:d6:da:ba:26,96446733,380,-145,96446353,96446733
14684,6,6,1,2412,-83,-91,8,e6:aa:ea:b7:4a:dd,96452717,408,5576,96452309,96452717
14685,6,6,1,2412,-83,-91,8,e6:aa:ea:b7:4a:dd,96464843,408,11718,96464435,96464843
14686,6,6,1,2412,-82,-91,9,e6:aa:ea:b7:4a:dd,96489076,408,23825,96488668,96489076
14687,6,6,1,2412,-82,-91,9,e6:aa:ea:b7:4a:dd,96501197,408,11713,96500789,96501197
14688,6,12,1,2412,-86,-91,5,40:e3:d6:da:c0:20,96519331,156,17978,96519175,96519331
14689,6,6,1,2412,-86,-91,5,40:e3:d6:da:c0:21,96519536,368,-163,96519168,96519536
14690,6,12,1,2412,-86,-91,5,40:e3:d6:da:c0:22,96519986,176,274,96519810,96519986
14691,6,12,1,2412,-86,-91,5,40:e3:d6:da:c0:23,96520187,180,21,96520007,96520187
14692,6,12,1,2412,-87,-91,4,40:e3:d6:da:c0:24,96520411,172,52,96520239,96520411
14693,6,12,1,2412,-86,-91,5,40:e3:d6:da:c0:25,96520627,156,60,96520471,96520627
14694,6,6,1,2412,-87,-91,4,40:e3:d6:da:c0:26,96520815,380,-192,96520435,96520815
14695,6,12,1,2412,-68,-91,23,40:e3:d6:da:ba:20,96547631,160,26656,96547471,96547631
14696,6,12,1,2412,-68,-91,23,40:e3:d6:da:ba:23,96548516,184,701,96548332,96548516
14697,6,12,1,2412,-68,-91,23,40:e3:d6:da:ba:24,96548725,176,33,96548549,96548725
14698,6,12,1,2412,-68,-91,23,40:e3:d6:da:ba:25,96548954,160,69,96548794,96548954
14699,6,6,1,2412,-68,-91,23,40:e3:d6:da:ba:26,96549145,380,-189,96548765,96549145
14700,6,6,1,2412,-71,-91,20,e6:aa:ea:c9:ea:33,96573824,408,24271,96573416,96573824
14701,6,6,1,2412,-71,-91,20,e6:aa:ea:c9:ea:33,96585955,408,11723,96585547,96585955
14702,6,6,1,2412,-70,-91,21,e6:aa:ea:c9:ea:33,96610177,408,23814,96609769,96610177
14703,6,6,1,2412,-71,-91,20,e6:aa:ea:c9:ea:33,96622306,408,11721,96621898,96622306
14704,4,1,1,2412,-76,-91,15,b8:3a:5a:88:e6:e0,96633830,2360,9164,96631470,96633830
14705,6,12,1,2412,-68,-91,23,40:e3:d6:da:ba:20,96650043,160,16053,96649883,96650043
14706,6,6,1,2412,-67,-91,24,40:e3:d6:da:ba:21,96650262,368,-149,96649894,96650262
14707,6,12,1,2412,-68,-91,23,40:e3:d6:da:ba:22,96650658,180,216,96650478,96650658
14708,6,12,1,2412,-67,-91,24,40:e3:d6:da:ba:23,96650872,184,30,96650688,96650872
14709,6,12,1,2412,-67,-91,24,40:e3:d6:da:ba:24,96651082,176,34,96650906,96651082
14710,6,12,1,2412,-67,-91,24,40:e3:d6:da:ba:25,96651283,160,41,96651123,96651283
14711,6,6,1,2412,-67,-91,24,40:e3:d6:da:ba:26,96651493,380,-170,96651113,96651493
14712,4,1,1,2412,-91,-91,0,a6:e5:7c:28:b1:d3,96695195,992,42710,96694203,96695195
14713,4,1,1,2412,-82,-91,9,54:e4:3a:ec:fb:64,96708211,2160,10856,96706051,96708211
14714,4,1,1,2412,-77,-91,14,b8:3a:5a:88:e6:e0,96736254,2360,25683,96733894,96736254
14715,6,12,1,2412,-68,-91,23,40:e3:d6:da:ba:20,96752432,160,16018,96752272,96752432
14716,6,6,1,2412,-67,-91,24,40:e3:d6:da:ba:21,96752651,368,-149,96752283,96752651
14717,6,12,1,2412,-70,-91,21,40:e3:d6:da:ba:22,96753056,180,225,96752876,96753056
14718,6,12,1,2412,-70,-91,21,40:e3:d6:da:ba:25,96753727,160,511,96753567,96753727
14719,6,6,1,2412,-80,-91,11,e6:aa:ea:b7:4a:dd,96768236,408,14101,96767828,96768236
14720,4,1,1,2412,-86,-91,5,a6:e5:7c:28:b1:d3,96798363,992,29135,96797371,96798363
14721,6,6,1,2412,-79,-91,12,e6:aa:ea:b7:4a:dd,96804602,408,5831,96804194,96804602
14722,4,1,1,2412,-84,-91,7,54:e4:3a:ec:fb:64,96810591,2160,3829,96808431,96810591
14723,4,1,1,2412,-89,-91,2,b6:66:a0:31:40:be,96813296,1152,1553,96812144,96813296
14724,6,12,1,2412,-68,-91,23,40:e3:d6:da:ba:20,96814434,136,1002,96814298,96814434
14725,6,6,1,2412,-68,-91,23,40:e3:d6:da:ba:21,96814629,348,-153,96814281,96814629
14726,6,12,1,2412,-68,-91,23,40:e3:d6:da:ba:22,96815014,156,229,96814858,96815014
14727,6,12,1,2412,-68,-91,23,40:e3:d6:da:ba:23,96815214,156,44,96815058,96815214
14728,6,12,1,2412,-68,-91,23,40:e3:d6:da:ba:25,96815422,136,72,96815286,96815422
14729,6,6,1,2412,-76,-91,15,e6:aa:ea:b7:4a:dd,96816728,408,898,96816320,96816728
14730,4,1,1,2412,-88,-91,3,b6:66:a0:31:40:be,96834485,1152,16605,96833333,96834485
14731,4,1,1,2412,-85,-91,6,54:e4:3a:ec:fb:64,96835756,2112,-841,96833644,96835756
14732,4,1,1,2412,-84,-91,7,54:e4:3a:ec:fb:64,96837942,2112,74,96835830,96837942
14733,6,12,1,2412,-67,-91,24,40:e3:d6:da:ba:20,96840228,136,2150,96840092,96840228
14734,6,12,1,2412,-67,-91,24,40:e3:d6:da:ba:23,96842681,156,2297,96842525,96842681
14735,6,12,1,2412,-67,-91,24,40:e3:d6:da:ba:25,96842872,136,55,96842736,96842872
14736,4,1,1,2412,-84,-91,7,54:e4:3a:ec:fb:64,96843313,2112,-1671,96841201,96843313
14737,4,1,1,2412,-90,-91,1,,96845437,304,1820,96845133,96845437
14738,6,12,1,2412,-67,-91,24,40:e3:d6:da:ba:20,96854844,160,9247,96854684,96854844
14739,6,6,1,2412,-67,-91,24,40:e3:d6:da:ba:21,96855054,368,-158,96854686,96855054
14740,6,12,1,2412,-67,-91,24,40:e3:d6:da:ba:23,96855673,184,435,96855489,96855673
14741,6,12,1,2412,-67,-91,24,40:e3:d6:da:ba:24,96855892,176,43,96855716,96855892
14742,6,12,1,2412,-66,-91,25,40:e3:d6:da:ba:25,96856102,160,50,96855942,96856102
14743,6,6,1,2412,-67,-91,24,40:e3:d6:da:ba:26,96856303,380,-179,96855923,96856303
14744,4,1,1,2412,-89,-91,2,,96881777,304,25170,96881473,96881777
14745,6,6,1,2412,-70,-91,21,e6:aa:ea:c9:ea:33,96888823,408,6638,96888415,96888823
14746,6,6,1,2412,-70,-91,21,e6:aa:ea:c9:ea:33,96900944,408,11713,96900536,96900944
14747,6,6,1,2412,-68,-91,23,e6:aa:ea:c9:ea:33,96925185,408,23833,96924777,96925185
14748,6,12,1,2412,-86,-91,5,40:e3:d6:da:c0:25,96930380,156,5039,96930224,96930380
14749,6,6,1,2412,-67,-91,24,e6:aa:ea:c9:ea:33,96937314,408,6526,96936906,96937314
14750,4,1,1,2412,-75,-91,16,b8:3a:5a:88:e6:e0,96941789,2360,2115,96939429,96941789
14751,6,12,1,2412,-67,-91,24,40:e3:d6:da:ba:20,96957238,160,15289,96957078,96957238
14752,6,6,1,2412,-66,-91,25,40:e3:d6:da:ba:21,96957430,368,-176,96957062,96957430
14753,6,12,1,2412,-67,-91,24,40:e3:d6:da:ba:24,96958277,176,671,96958101,96958277
14754,4,1,1,2412,-81,-91,10,aa:a3:b2:12:db:98,97051536,1128,92131,97050408,97051536
14755,6,12,1,2412,-67,-91,24,40:e3:d6:da:ba:20,97052636,136,964,97052500,97052636
14756,6,6,1,2412,-67,-91,24,40:e3:d6:da:ba:21,97057478,348,4494,97057130,97057478
14757,6,12,1,2412,-67,-91,24,40:e3:d6:da:ba:22,97057862,156,228,97057706,97057862
14758,6,12,1,2412,-67,-91,24,40:e3:d6:da:ba:23,97058080,156,62,97057924,97058080
14759,6,12,1,2412,-84,-91,7,,97058252,32,140,97058220,97058252
14760,6,12,1,2412,-67,-91,24,40:e3:d6:da:ba:25,97058288,136,-100,97058152,97058288
14761,4,1,1,2412,-79,-91,12,54:e4:3a:ec:fb:64,97058933,2112,-1467,97056821,97058933
14762,4,1,1,2412,-81,-91,10,54:e4:3a:ec:fb:64,97061200,2112,155,97059088,97061200
14763,6,12,1,2412,-66,-91,25,40:e3:d6:da:ba:22,97064110,180,2730,97063930,97064110
14764,6,12,1,2412,-67,-91,24,40:e3:d6:da:ba:23,97064316,184,22,97064132,97064316
14765,6,12,1,2412,-67,-91,24,40:e3:d6:da:ba:24,97064534,176,42,97064358,97064534
14766,6,12,1,2412,-67,-91,24,40:e3:d6:da:ba:25,97064745,160,51,97064585,97064745
14767,6,6,1,2412,-67,-91,24,40:e3:d6:da:ba:26,97064946,380,-179,97064566,97064946
14768,4,1,1,2412,-80,-91,11,aa:a3:b2:12:db:98,97072735,1128,6661,97071607,97072735
14769,4,1,1,2412,-79,-91,12,54:e4:3a:ec:fb:64,97073982,2112,-865,97071870,97073982
14770,4,1,1,2412,-80,-91,11,54:e4:3a:ec:fb:64,97083362,2112,7268,97081250,97083362
14771,6,6,1,2412,-81,-91,10,e6:aa:ea:b7:4a:dd,97095914,408,12144,97095506,97095914
14772,6,6,1,2412,-81,-91,10,e6:aa:ea:b7:4a:dd,97108182,408,11860,97107774,97108182
14773,4,1,1,2412,-80,-91,11,54:e4:3a:ec:fb:64,97117656,2160,7314,97115496,97117656
14774,6,6,1,2412,-82,-91,9,e6:aa:ea:b7:4a:dd,97120180,408,2116,97119772,97120180
14775,6,6,1,2412,-81,-91,10,e6:aa:ea:b7:4a:dd,97132279,408,11691,97131871,97132279
14776,4,1,1,2412,-76,-91,15,b8:3a:5a:88:e6:e0,97145827,2360,11188,97143467,97145827
14777,4,1,1,2412,-79,-91,12,b8:3a:5a:88:e6:e1,97148234,2376,31,97145858,97148234
14778,6,12,1,2412,-68,-91,23,40:e3:d6:da:ba:20,97162053,160,13659,97161893,97162053
14779,6,6,1,2412,-68,-91,23,40:e3:d6:da:ba:21,97162245,368,-176,97161877,97162245
14780,6,12,1,2412,-68,-91,23,40:e3:d6:da:ba:22,97162650,180,225,97162470,97162650
14781,6,12,1,2412,-68,-91,23,40:e3:d6:da:ba:23,97162882,184,48,97162698,97162882
14782,6,12,1,2412,-68,-91,23,40:e3:d6:da:ba:24,97163119,176,61,97162943,97163119
14783,6,12,1,2412,-68,-91,23,40:e3:d6:da:ba:25,97163329,160,50,97163169,97163329
14784,6,6,1,2412,-68,-91,23,40:e3:d6:da:ba:26,97163521,380,-188,97163141,97163521
14785,4,1,1,2412,-83,-91,8,54:e4:3a:ec:fb:64,97220624,2160,54943,97218464,97220624
14786,4,1,1,2412,-77,-91,14,b8:3a:5a:88:e6:e0,97248236,2360,25252,97245876,97248236
14787,6,12,1,2412,-67,-91,24,40:e3:d6:da:ba:22,97265047,180,16631,97264867,97265047
14788,6,12,1,2412,-67,-91,24,40:e3:d6:da:ba:23,97265253,184,22,97265069,97265253
14789,6,6,1,2412,-68,-91,23,e6:aa:ea:c9:ea:33,97306216,408,40555,97305808,97306216
14790,6,6,1,2412,-69,-91,22,e6:aa:ea:c9:ea:33,97330466,408,23842,97330058,97330466
14791,6,6,1,2412,-69,-91,22,e6:aa:ea:c9:ea:33,97342572,408,11698,97342164,97342572
14792,4,1,1,2412,-74,-91,17,b8:3a:5a:88:e6:e0,97350895,2360,5963,97348535,97350895
14793,6,12,1,2412,-67,-91,24,40:e3:d6:da:ba:20,97366834,160,15779,97366674,97366834
14794,6,6,1,2412,-67,-91,24,40:e3:d6:da:ba:21,97367026,368,-176,97366658,97367026
14795,6,12,1,2412,-67,-91,24,40:e3:d6:da:ba:22,97367422,180,216,97367242,97367422
14796,6,12,1,2412,-67,-91,24,40:e3:d6:da:ba:23,97367655,184,49,97367471,97367655
14797,6,12,1,2412,-67,-91,24,40:e3:d6:da:ba:24,97367891,176,60,97367715,97367891
14798,6,12,1,2412,-68,-91,23,40:e3:d6:da:ba:25,97368102,160,51,97367942,97368102
14799,4,1,1,2412,-90,-91,1,c0:c9:e3:4d:6e:bf,97383681,872,14707,97382809,97383681
14800,4,1,1,2412,-82,-91,9,54:e4:3a:ec:fb:64,97425005,2160,39164,97422845,97425005
14801,4,1,1,2412,-78,-91,13,b8:3a:5a:88:e6:e0,97453179,2360,25814,97450819,97453179
14802,6,12,1,2412,-67,-91,24,40:e3:d6:da:ba:20,97469262,160,15923,97469102,97469262
14803,6,6,1,2412,-67,-91,24,40:e3:d6:da:ba:21,97469472,368,-158,97469104,97469472
14804,6,12,1,2412,-66,-91,25,40:e3:d6:da:ba:22,97469877,180,225,97469697,97469877
14805,6,12,1,2412,-67,-91,24,40:e3:d6:da:ba:23,97470109,184,48,97469925,97470109
14806,6,12,1,2412,-67,-91,24,40:e3:d6:da:ba:24,97470328,176,43,97470152,97470328
14807,6,12,1,2412,-66,-91,25,40:e3:d6:da:ba:25,97470556,160,68,97470396,97470556
14808,6,6,1,2412,-67,-91,24,40:e3:d6:da:ba:26,97470748,380,-188,97470368,97470748
14809,6,6,1,2412,-81,-91,10,e6:aa:ea:b7:4a:dd,97502156,408,31000,97501748,97502156
14810,6,6,1,2412,-82,-91,9,e6:aa:ea:b7:4a:dd,97514273,408,11709,97513865,97514273
14811,6,6,1,2412,-81,-91,10,e6:aa:ea:b7:4a:dd,97526433,408,11752,97526025,97526433
14812,4,1,1,2412,-79,-91,12,54:e4:3a:ec:fb:64,97527246,2160,-1347,97525086,97527246
14813,6,6,1,2412,-81,-91,10,e6:aa:ea:b7:4a:dd,97538506,408,10852,97538098,97538506
14814,4,1,1,2412,-57,-91,34,b8:3a:5a:88:e6:e1,97557848,2376,16966,97555472,97557848
14815,6,12,1,2412,-67,-91,24,40:e3:d6:da:ba:20,97571636,160,13628,97571476,97571636
14816,6,6,1,2412,-68,-91,23,40:e3:d6:da:ba:21,97571855,368,-149,97571487,97571855
14817,6,12,1,2412,-67,-91,24,40:e3:d6:da:ba:22,97572242,180,207,97572062,97572242
14818,6,12,1,2412,-67,-91,24,40:e3:d6:da:ba:23,97572474,184,48,97572290,97572474
14819,6,12,1,2412,-67,-91,24,40:e3:d6:da:ba:24,97572693,176,43,97572517,97572693
14820,6,12,1,2412,-67,-91,24,40:e3:d6:da:ba:25,97572948,160,95,97572788,97572948
14821,6,6,1,2412,-66,-91,25,40:e3:d6:da:ba:26,97573174,380,-154,97572794,97573174
14822,4,1,1,2412,-80,-91,11,54:e4:3a:ec:fb:64,97629811,2160,54477,97627651,97629811
14823,4,1,1,2412,-79,-91,12,b8:3a:5a:88:e6:e0,97660489,2360,28318,97658129,97660489
14824,4,1,1,2412,-79,-91,12,b8:3a:5a:88:e6:e1,97663885,2376,1020,97661509,97663885
14825,6,12,1,2412,-65,-91,26,40:e3:d6:da:ba:20,97674036,160,9991,97673876,97674036
14826,6,6,1,2412,-65,-91,26,40:e3:d6:da:ba:21,97674228,368,-176,97673860,97674228
14827,6,12,1,2412,-64,-91,27,40:e3:d6:da:ba:22,97674624,180,216,97674444,97674624
14828,6,12,1,2412,-65,-91,26,40:e3:d6:da:ba:23,97674829,184,21,97674645,97674829
14829,6,12,1,2412,-64,-91,27,40:e3:d6:da:ba:24,97675048,176,43,97674872,97675048
14830,6,12,1,2412,-64,-91,27,40:e3:d6:da:ba:25,97675267,160,59,97675107,97675267
14831,6,6,1,2412,-64,-91,27,40:e3:d6:da:ba:26,97675486,380,-161,97675106,97675486
14832,6,6,1,2412,-69,-91,22,e6:aa:ea:c9:ea:33,97723740,408,47846,97723332,97723740
14833,6,6,1,2412,-69,-91,22,e6:aa:ea:c9:ea:33,97735858,408,11710,97735450,97735858
14834,6,6,1,2412,-67,-91,24,e6:aa:ea:c9:ea:33,97747985,408,11719,97747577,97747985
14835,6,6,1,2412,-69,-91,22,e6:aa:ea:c9:ea:33,97772233,408,23840,97771825,97772233
14836,6,12,1,2412,-63,-91,28,40:e3:d6:da:ba:20,97776437,160,4044,97776277,97776437
14837,6,6,1,2412,-64,-91,27,40:e3:d6:da:ba:21,97776638,368,-167,97776270,97776638
14838,6,12,1,2412,-64,-91,27,40:e3:d6:da:ba:24,97777458,176,644,97777282,97777458
14839,6,12,1,2412,-64,-91,27,40:e3:d6:da:ba:25,97777668,160,50,97777508,97777668
14840,4,1,1,2412,-81,-91,10,b8:3a:5a:88:e6:e0,97862859,2360,82831,97860499,97862859
14841,6,12,1,2412,-64,-91,27,40:e3:d6:da:ba:20,97878837,160,15818,97878677,97878837
14842,6,6,1,2412,-64,-91,27,40:e3:d6:da:ba:21,97879029,368,-176,97878661,97879029
14843,6,12,1,2412,-64,-91,27,40:e3:d6:da:ba:22,97879443,180,234,97879263,97879443
14844,6,12,1,2412,-64,-91,27,40:e3:d6:da:ba:23,97879675,184,48,97879491,97879675
14845,6,12,1,2412,-64,-91,27,40:e3:d6:da:ba:24,97879885,176,34,97879709,97879885
14846,6,12,1,2412,-64,-91,27,40:e3:d6:da:ba:25,97880095,160,50,97879935,97880095
14847,6,6,1,2412,-64,-91,27,40:e3:d6:da:ba:26,97880287,380,-188,97879907,97880287
14848,6,6,1,2412,-81,-91,10,e6:aa:ea:b7:4a:dd,97932407,408,51712,97931999,97932407
14849,4,1,1,2412,-80,-91,11,54:e4:3a:ec:fb:64,97936842,2160,2275,97934682,97936842
14850,6,6,1,2412,-82,-91,9,e6:aa:ea:b7:4a:dd,97944514,408,7264,97944106,97944514
14851,6,6,1,2412,-82,-91,9,e6:aa:ea:b7:4a:dd,97956635,408,11713,97956227,97956635
14852,6,12,1,2412,-64,-91,27,40:e3:d6:da:ba:20,97981238,160,24443,97981078,97981238
14853,6,6,1,2412,-64,-91,27,40:e3:d6:da:ba:21,97981447,368,-159,97981079,97981447
14854,6,12,1,2412,-64,-91,27,40:e3:d6:da:ba:22,97981852,180,225,97981672,97981852
14855,6,12,1,2412,-64,-91,27,40:e3:d6:da:ba:23,97982085,184,49,97981901,97982085
14856,6,12,1,2412,-64,-91,27,40:e3:d6:da:ba:24,97982321,176,60,97982145,97982321
14857,6,12,1,2412,-64,-91,27,40:e3:d6:da:ba:25,97982550,160,69,97982390,97982550
14858,6,6,1,2412,-64,-91,27,40:e3:d6:da:ba:26,97982742,380,-188,97982362,97982742
14859,6,6,1,2412,-68,-91,23,e6:aa:ea:c9:ea:33,98038492,408,55342,98038084,98038492
14860,6,6,1,2412,-68,-91,23,e6:aa:ea:c9:ea:33,98050614,408,11714,98050206,98050614
14861,6,6,1,2412,-68,-91,23,e6:aa:ea:c9:ea:33,98062746,408,11724,98062338,98062746
14862,6,6,1,2412,-68,-91,23,e6:aa:ea:c9:ea:33,98074987,408,11833,98074579,98074987
14863,6,12,1,2412,-64,-91,27,40:e3:d6:da:ba:22,98084289,180,9122,98084109,98084289
14864,6,12,1,2412,-64,-91,27,40:e3:d6:da:ba:23,98084521,184,48,98084337,98084521
14865,6,12,1,2412,-64,-91,27,40:e3:d6:da:ba:24,98084740,176,43,98084564,98084740
14866,6,12,1,2412,-64,-91,27,40:e3:d6:da:ba:25,98084959,160,59,98084799,98084959
14867,6,6,1,2412,-64,-91,27,40:e3:d6:da:ba:26,98085169,380,-170,98084789,98085169
14868,6,6,1,2412,-68,-91,23,e6:aa:ea:c9:ea:33,98086955,408,1378,98086547,98086955
14869,4,1,1,2412,-80,-91,11,54:e4:3a:ec:fb:64,98141806,2160,52691,98139646,98141806
14870,4,1,1,2412,-75,-91,16,b8:3a:5a:88:e6:e0,98169854,2360,25688,98167494,98169854
14871,6,12,1,2412,-65,-91,26,40:e3:d6:da:ba:20,98186038,160,16024,98185878,98186038
14872,6,6,1,2412,-65,-91,26,40:e3:d6:da:ba:21,98186239,368,-167,98185871,98186239
14873,6,12,1,2412,-65,-91,26,40:e3:d6:da:ba:22,98186682,180,263,98186502,98186682
14874,6,12,1,2412,-65,-91,26,40:e3:d6:da:ba:25,98187326,160,484,98187166,98187326
14875,4,1,1,2412,-85,-91,6,b8:3a:5a:88:e6:e0,98272473,2360,82787,98270113,98272473
14876,4,1,1,2412,-81,-91,10,b8:3a:5a:88:e6:e1,98274871,2376,22,98272495,98274871
14877,6,12,1,2412,-67,-91,24,40:e3:d6:da:ba:20,98288439,160,13408,98288279,98288439
14878,6,6,1,2412,-67,-91,24,40:e3:d6:da:ba:21,98288649,368,-158,98288281,98288649
14879,6,12,1,2412,-66,-91,25,40:e3:d6:da:ba:22,98289054,180,225,98288874,98289054
14880,6,12,1,2412,-66,-91,25,40:e3:d6:da:ba:23,98289268,184,30,98289084,98289268
14881,6,12,1,2412,-66,-91,25,40:e3:d6:da:ba:24,98289478,176,34,98289302,98289478
14882,6,12,1,2412,-65,-91,26,40:e3:d6:da:ba:25,98289697,160,59,98289537,98289697
14883,6,6,1,2412,-66,-91,25,40:e3:d6:da:ba:26,98289898,380,-179,98289518,98289898
14884,6,12,1,2412,-66,-91,25,40:e3:d6:da:ba:20,98390840,160,100782,98390680,98390840
14885,6,6,1,2412,-66,-91,25,40:e3:d6:da:ba:21,98391041,368,-167,98390673,98391041
14886,6,12,1,2412,-66,-91,25,40:e3:d6:da:ba:22,98391437,180,216,98391257,98391437
14887,6,12,1,2412,-66,-91,25,40:e3:d6:da:ba:23,98391652,184,31,98391468,98391652
14888,6,12,1,2412,-66,-91,25,40:e3:d6:da:ba:24,98391870,176,42,98391694,98391870
14889,6,12,1,2412,-66,-91,25,40:e3:d6:da:ba:25,98392098,160,68,98391938,98392098
14890,6,6,1,2412,-65,-91,26,40:e3:d6:da:ba:26,98392318,380,-160,98391938,98392318
14891,4,1,1,2412,-89,-91,2,a6:e5:7c:28:b1:d3,98436617,992,43307,98435625,98436617
14892,6,6,1,2412,-88,-91,3,e6:aa:ea:b7:4a:dd,98440764,408,3739,98440356,98440764
14893,4,1,1,2412,-89,-91,2,,98446597,304,5529,98446293,98446597
14894,4,1,1,2412,-74,-91,17,b8:3a:5a:88:e6:e0,98477032,2360,28075,98474672,98477032
14895,4,1,1,2412,-75,-91,16,b8:3a:5a:88:e6:e1,98479420,2376,12,98477044,98479420
14896,6,6,1,2412,-86,-91,5,e6:aa:ea:b7:4a:dd,98489243,408,9415,98488835,98489243
14897,6,12,1,2412,-64,-91,27,40:e3:d6:da:ba:20,98493257,160,3854,98493097,98493257
14898,6,6,1,2412,-64,-91,27,40:e3:d6:da:ba:21,98493449,368,-176,98493081,98493449
14899,6,12,1,2412,-64,-91,27,40:e3:d6:da:ba:22,98493845,180,216,98493665,98493845
14900,6,12,1,2412,-64,-91,27,40:e3:d6:da:ba:23,98494078,184,49,98493894,98494078
14901,6,12,1,2412,-66,-91,25,40:e3:d6:da:ba:24,98494296,176,42,98494120,98494296
14902,4,1,1,2412,-89,-91,2,,98537041,304,42441,98536737,98537041
14903,4,1,1,2412,-89,-91,2,a6:e5:7c:28:b1:d3,98538901,992,868,98537909,98538901
14904,4,1,1,2412,-86,-91,5,54:e4:3a:ec:fb:64,98551237,2160,10176,98549077,98551237
14905,4,1,1,2412,-91,-91,0,,98557351,304,5810,98557047,98557351
14906,6,6,1,2412,-63,-91,28,e6:aa:ea:c9:ea:33,98570220,408,12461,98569812,98570220
14907,4,1,1,2412,-64,-91,27,b8:3a:5a:88:e6:e0,98579431,2360,6851,98577071,98579431
14908,6,6,1,2412,-63,-91,28,e6:aa:ea:c9:ea:33,98582343,408,2504,98581935,98582343
14909,4,1,1,2412,-71,-91,20,b8:3a:5a:88:e6:e1,98583326,2376,-1393,98580950,98583326
14910,6,6,1,2412,-63,-91,28,e6:aa:ea:c9:ea:33,98594878,408,11144,98594470,98594878
14911,6,12,1,2412,-67,-91,24,40:e3:d6:da:ba:20,98597784,160,2746,98597624,98597784
14912,6,6,1,2412,-67,-91,24,40:e3:d6:da:ba:21,98597985,368,-167,98597617,98597985
14913,6,12,1,2412,-65,-91,26,40:e3:d6:da:ba:22,98598372,180,207,98598192,98598372
14914,6,12,1,2412,-65,-91,26,40:e3:d6:da:ba:23,98598596,184,40,98598412,98598596
14915,6,12,1,2412,-65,-91,26,40:e3:d6:da:ba:24,98598823,176,51,98598647,98598823
14916,6,12,1,2412,-65,-91,26,40:e3:d6:da:ba:25,98599052,160,69,98598892,98599052
14917,6,6,1,2412,-66,-91,25,40:e3:d6:da:ba:26,98599244,380,-188,98598864,98599244
14918,6,6,1,2412,-63,-91,28,e6:aa:ea:c9:ea:33,98606650,408,6998,98606242,98606650
14919,6,12,1,2412,-67,-91,24,40:e3:d6:da:ba:20,98698041,160,91231,98697881,98698041
14920,6,6,1,2412,-67,-91,24,40:e3:d6:da:ba:21,98698242,368,-167,98697874,98698242
14921,6,12,1,2412,-67,-91,24,40:e3:d6:da:ba:22,98698629,180,207,98698449,98698629
14922,6,12,1,2412,-67,-91,24,40:e3:d6:da:ba:23,98698861,184,48,98698677,98698861
14923,6,12,1,2412,-67,-91,24,40:e3:d6:da:ba:24,98699080,176,43,98698904,98699080
14924,6,12,1,2412,-67,-91,24,40:e3:d6:da:ba:25,98699308,160,68,98699148,98699308
14925,6,6,1,2412,-67,-91,24,40:e3:d6:da:ba:26,98699509,380,-179,98699129,98699509
14926,4,1,1,2412,-79,-91,12,b8:3a:5a:88:e6:e0,98784240,2360,82371,98781880,98784240
14927,4,1,1,2412,-77,-91,14,b8:3a:5a:88:e6:e1,98786647,2376,31,98784271,98786647
14928,6,12,1,2412,-63,-91,28,40:e3:d6:da:ba:20,98800445,160,13638,98800285,98800445
14929,6,6,1,2412,-63,-91,28,40:e3:d6:da:ba:21,98800646,368,-167,98800278,98800646
14930,6,12,1,2412,-63,-91,28,40:e3:d6:da:ba:22,98801060,180,234,98800880,98801060
14931,6,12,1,2412,-63,-91,28,40:e3:d6:da:ba:23,98801275,184,31,98801091,98801275
14932,6,12,1,2412,-63,-91,28,40:e3:d6:da:ba:24,98801511,176,60,98801335,98801511
14933,6,12,1,2412,-63,-91,28,40:e3:d6:da:ba:25,98801740,160,69,98801580,98801740
14934,6,6,1,2412,-63,-91,28,40:e3:d6:da:ba:26,98801949,380,-171,98801569,98801949
14935,6,6,1,2412,-83,-91,8,e6:aa:ea:b7:4a:dd,98858688,408,56331,98858280,98858688
14936,4,1,1,2412,-84,-91,7,54:e4:3a:ec:fb:64,98859286,2160,-1562,98857126,98859286
14937,6,6,1,2412,-85,-91,6,e6:aa:ea:b7:4a:dd,98870808,408,11114,98870400,98870808
14938,6,6,1,2412,-74,-91,17,e6:aa:ea:c9:ea:33,98873666,408,2450,98873258,98873666
14939,4,1,1,2412,-81,-91,10,b8:3a:5a:88:e6:e0,98882717,2240,6811,98880477,98882717
14940,4,1,1,2412,-80,-91,11,b8:3a:5a:88:e6:e0,98888274,2360,3197,98885914,98888274
14941,4,1,1,2412,-80,-91,11,b8:3a:5a:88:e6:e1,98891731,2376,1081,98889355,98891731
14942,6,6,1,2412,-68,-91,23,e6:aa:ea:c9:ea:33,98898215,408,6076,98897807,98898215
14943,6,12,1,2412,-65,-91,26,40:e3:d6:da:ba:20,98902842,160,4467,98902682,98902842
14944,6,6,1,2412,-65,-91,26,40:e3:d6:da:ba:21,98903043,368,-167,98902675,98903043
14945,6,12,1,2412,-64,-91,27,40:e3:d6:da:ba:22,98903430,180,207,98903250,98903430
14946,6,12,1,2412,-64,-91,27,40:e3:d6:da:ba:23,98903644,184,30,98903460,98903644
14947,6,12,1,2412,-65,-91,26,40:e3:d6:da:ba:24,98903863,176,43,98903687,98903863
14948,6,12,1,2412,-65,-91,26,40:e3:d6:da:ba:25,98904083,160,60,98903923,98904083
14949,6,6,1,2412,-83,-91,8,e6:aa:ea:b7:4a:dd,98907167,408,2676,98906759,98907167
14950,6,6,1,2412,-70,-91,21,e6:aa:ea:c9:ea:33,98910003,408,2428,98909595,98910003
14951,6,6,1,2412,-69,-91,22,e6:aa:ea:c9:ea:33,98922120,408,11709,98921712,98922120
14952,4,1,1,2412,-78,-91,13,b8:3a:5a:88:e6:e0,98989056,2360,64576,98986696,98989056
14953,4,1,1,2412,-78,-91,13,b8:3a:5a:88:e6:e1,98991463,2376,31,98989087,98991463
14954,6,12,1,2412,-63,-91,28,40:e3:d6:da:ba:20,99005264,160,13641,99005104,99005264
14955,6,12,1,2412,-63,-91,28,40:e3:d6:da:ba:23,99006093,184,645,99005909,99006093
14956,6,12,1,2412,-63,-91,28,40:e3:d6:da:ba:24,99006330,176,61,99006154,99006330
14957,6,12,1,2412,-63,-91,28,40:e3:d6:da:ba:25,99006540,160,50,99006380,99006540
14958,4,1,1,2412,-77,-91,14,b8:3a:5a:88:e6:e0,99091432,2360,82532,99089072,99091432
14959,4,1,1,2412,-77,-91,14,b8:3a:5a:88:e6:e1,99093812,2376,4,99091436,99093812
14960,6,12,1,2412,-62,-91,29,40:e3:d6:da:ba:20,99107650,160,13678,99107490,99107650
14961,6,6,1,2412,-63,-91,28,40:e3:d6:da:ba:21,99107842,368,-176,99107474,99107842
14962,6,12,1,2412,-63,-91,28,40:e3:d6:da:ba:22,99108256,180,234,99108076,99108256
14963,6,12,1,2412,-63,-91,28,40:e3:d6:da:ba:23,99108470,184,30,99108286,99108470
14964,6,12,1,2412,-62,-91,29,40:e3:d6:da:ba:24,99108707,176,61,99108531,99108707
14965,6,12,1,2412,-63,-91,28,40:e3:d6:da:ba:25,99108917,160,50,99108757,99108917
14966,6,6,1,2412,-63,-91,28,40:e3:d6:da:ba:26,99109127,380,-170,99108747,99109127
14967,6,12,1,2412,-62,-91,29,40:e3:d6:da:ba:20,99210050,160,100763,99209890,99210050
14968,6,6,1,2412,-62,-91,29,40:e3:d6:da:ba:21,99210242,368,-176,99209874,99210242
14969,6,12,1,2412,-62,-91,29,40:e3:d6:da:ba:22,99210647,180,225,99210467,99210647
14970,6,12,1,2412,-62,-91,29,40:e3:d6:da:ba:23,99210862,184,31,99210678,99210862
14971,6,12,1,2412,-62,-91,29,40:e3:d6:da:ba:24,99211071,176,33,99210895,99211071
14972,6,12,1,2412,-62,-91,29,40:e3:d6:da:ba:25,99211291,160,60,99211131,99211291
14973,6,6,1,2412,-62,-91,29,40:e3:d6:da:ba:26,99211500,380,-171,99211120,99211500
14974,4,1,1,2412,-82,-91,9,54:e4:3a:ec:fb:64,99268029,2160,54369,99265869,99268029
14975,6,6,1,2412,-82,-91,9,e6:aa:ea:b7:4a:dd,99275897,408,7460,99275489,99275897
14976,6,6,1,2412,-80,-91,11,e6:aa:ea:b7:4a:dd,99288015,408,11710,99287607,99288015
14977,4,1,1,2412,-79,-91,12,b8:3a:5a:88:e6:e1,99298637,2376,8246,99296261,99298637
14978,6,12,1,2412,-63,-91,28,40:e3:d6:da:ba:20,99312675,160,13878,99312515,99312675
14979,6,12,1,2412,-63,-91,28,40:e3:d6:da:ba:22,99313281,180,426,99313101,99313281
14980,6,12,1,2412,-64,-91,27,40:e3:d6:da:ba:23,99313504,184,39,99313320,99313504
14981,6,12,1,2412,-63,-91,28,40:e3:d6:da:ba:24,99313732,176,52,99313556,99313732
14982,6,12,1,2412,-88,-91,3,40:e3:d6:da:ba:25,99313942,160,50,99313782,99313942
14983,6,6,1,2412,-80,-91,11,e6:aa:ea:b7:4a:dd,99324381,408,10031,99323973,99324381
14984,6,12,1,2412,-87,-91,4,40:e3:d6:da:c0:23,99339100,156,14563,99338944,99339100
14985,4,1,1,2412,-90,-91,1,c0:c9:e3:4d:6e:bf,99348909,872,8937,99348037,99348909
14986,6,6,1,2412,-72,-91,19,e6:aa:ea:c9:ea:33,99405932,408,56615,99405524,99405932
14987,6,12,1,2412,-62,-91,29,40:e3:d6:da:ba:20,99414844,160,8752,99414684,99414844
14988,6,6,1,2412,-62,-91,29,40:e3:d6:da:ba:21,99415036,368,-176,99414668,99415036
14989,6,12,1,2412,-62,-91,29,40:e3:d6:da:ba:22,99415450,180,234,99415270,99415450
14990,6,12,1,2412,-61,-91,30,40:e3:d6:da:ba:23,99415655,184,21,99415471,99415655
14991,6,12,1,2412,-62,-91,29,40:e3:d6:da:ba:24,99415864,176,33,99415688,99415864
14992,6,12,1,2412,-62,-91,29,40:e3:d6:da:ba:25,99416093,160,69,99415933,99416093
14993,6,6,1,2412,-62,-91,29,40:e3:d6:da:ba:26,99416312,380,-161,99415932,99416312
14994,6,6,1,2412,-70,-91,21,e6:aa:ea:c9:ea:33,99430276,408,13556,99429868,99430276
14995,6,6,1,2412,-70,-91,21,e6:aa:ea:c9:ea:33,99442246,408,11562,99441838,99442246
14996,6,12,1,2412,-63,-91,28,40:e3:d6:da:ba:20,99517266,160,74860,99517106,99517266
14997,6,6,1,2412,-63,-91,28,40:e3:d6:da:ba:21,99517476,368,-158,99517108,99517476
14998,6,12,1,2412,-63,-91,28,40:e3:d6:da:ba:22,99517890,180,234,99517710,99517890
14999,6,12,1,2412,-63,-91,28,40:e3:d6:da:ba:23,99518123,184,49,99517939,99518123
15000,6,12,1,2412,-63,-91,28,40:e3:d6:da:ba:24,99518350,176,51,99518174,99518350
15001,6,12,1,2412,-63,-91,28,40:e3:d6:da:ba:25,99518561,160,51,99518401,99518561
15002,6,6,1,2412,-63,-91,28,40:e3:d6:da:ba:26,99518780,380,-161,99518400,99518780
15003,4,1,1,2412,-81,-91,10,54:e4:3a:ec:fb:64,99575227,2160,54287,99573067,99575227
15004,6,6,1,2412,-79,-91,12,e6:aa:ea:b7:4a:dd,99590550,408,14915,99590142,99590550
15005,4,1,1,2412,-79,-91,12,b8:3a:5a:88:e6:e0,99603604,2360,10694,99601244,99603604
15006,6,6,1,2412,-78,-91,13,e6:aa:ea:b7:4a:dd,99614892,408,10880,99614484,99614892
15007,6,12,1,2412,-63,-91,28,40:e3:d6:da:ba:20,99619653,160,4601,99619493,99619653
15008,6,12,1,2412,-62,-91,29,40:e3:d6:da:ba:25,99620912,160,1099,99620752,99620912
15009,6,6,1,2412,-78,-91,13,e6:aa:ea:b7:4a:dd,99626904,408,5584,99626496,99626904
15010,6,6,1,2412,-79,-91,12,e6:aa:ea:b7:4a:dd,99639028,408,11716,99638620,99639028
15011,4,1,1,2412,-80,-91,11,54:e4:3a:ec:fb:64,99677626,2160,36438,99675466,99677626
15012,4,1,1,2412,-83,-91,8,b8:3a:5a:88:e6:e0,99705856,2360,25870,99703496,99705856
15013,6,12,1,2412,-63,-91,28,40:e3:d6:da:ba:22,99722666,180,16630,99722486,99722666
15014,6,12,1,2412,-64,-91,27,40:e3:d6:da:ba:23,99722881,184,31,99722697,99722881
15015,6,12,1,2412,-63,-91,28,40:e3:d6:da:ba:24,99723090,176,33,99722914,99723090
15016,4,1,1,2412,-76,-91,15,b8:3a:5a:88:e6:e0,99774025,2240,48695,99771785,99774025
15017,4,1,1,2412,-75,-91,16,b8:3a:5a:88:e6:e1,99778393,2256,2112,99776137,99778393
15018,4,1,1,2412,-74,-91,17,b8:3a:5a:88:e6:e1,99795996,2256,15347,99793740,99795996
15019,4,1,1,2412,-75,-91,16,b8:3a:5a:88:e6:e0,99808233,2360,9877,99805873,99808233
15020,4,1,1,2412,-73,-91,18,b8:3a:5a:88:e6:e1,99810613,2376,4,99808237,99810613
15021,6,12,1,2412,-64,-91,27,40:e3:d6:da:ba:20,99824455,160,13682,99824295,99824455
15022,6,6,1,2412,-64,-91,27,40:e3:d6:da:ba:21,99824647,368,-176,99824279,99824647
15023,6,12,1,2412,-65,-91,26,40:e3:d6:da:ba:22,99825034,180,207,99824854,99825034
15024,6,12,1,2412,-63,-91,28,40:e3:d6:da:ba:23,99825266,184,48,99825082,99825266
15025,6,12,1,2412,-64,-91,27,40:e3:d6:da:ba:24,99825503,176,61,99825327,99825503
15026,6,12,1,2412,-64,-91,27,40:e3:d6:da:ba:25,99825704,160,41,99825544,99825704
15027,6,6,1,2412,-64,-91,27,40:e3:d6:da:ba:26,99825923,380,-161,99825543,99825923
15028,4,1,1,2412,-79,-91,12,c0:c9:e3:4d:6e:bf,99840535,872,13740,99839663,99840535
15029,6,6,1,2412,-79,-91,12,e6:aa:ea:b7:4a:dd,99906604,408,65661,99906196,99906604
15030,4,1,1,2412,-61,-91,30,b8:3a:5a:88:e6:e0,99910635,2360,1671,99908275,99910635
15031,6,6,1,2412,-71,-91,20,e6:aa:ea:c9:ea:33,99913621,408,2578,99913213,99913621
15032,6,6,1,2412,-78,-91,13,e6:aa:ea:b7:4a:dd,99918723,408,4694,99918315,99918723
15033,6,12,1,2412,-67,-91,24,40:e3:d6:da:ba:20,99926870,160,7987,99926710,99926870
15034,6,12,1,2412,-67,-91,24,40:e3:d6:da:ba:22,99927476,180,426,99927296,99927476
15035,6,12,1,2412,-67,-91,24,40:e3:d6:da:ba:25,99928119,160,483,99927959,99928119
15036,6,6,1,2412,-67,-91,24,40:e3:d6:da:ba:26,99928329,380,-170,99927949,99928329
15037,6,6,1,2412,-79,-91,12,e6:aa:ea:b7:4a:dd,99930845,408,2108,99930437,99930845
15038,6,6,1,2412,-70,-91,21,e6:aa:ea:c9:ea:33,99937872,408,6619,99937464,99937872
15039,6,6,1,2412,-69,-91,22,e6:aa:ea:c9:ea:33,99950032,408,11752,99949624,99950032
15040,6,6,1,2412,-83,-91,8,e6:aa:ea:b7:4a:dd,99955095,408,4655,99954687,99955095
15041,4,1,1,2412,-80,-91,11,54:e4:3a:ec:fb:64,99984823,2160,27568,99982663,99984823
15042,4,1,1,2412,-75,-91,16,b8:3a:5a:88:e6:e1,100015423,2376,28224,100013047,100015423
15043,6,12,1,2412,-67,-91,24,40:e3:d6:da:ba:20,100029246,160,13663,100029086,100029246
15044,6,6,1,2412,-67,-91,24,40:e3:d6:da:ba:21,100029438,368,-176,100029070,100029438
15045,6,12,1,2412,-66,-91,25,40:e3:d6:da:ba:22,100029833,180,215,100029653,100029833
15046,6,12,1,2412,-67,-91,24,40:e3:d6:da:ba:23,100030057,184,40,100029873,100030057
15047,6,12,1,2412,-66,-91,25,40:e3:d6:da:ba:24,100030276,176,43,100030100,100030276
15048,6,12,1,2412,-67,-91,24,40:e3:d6:da:ba:25,100030486,160,50,100030326,100030486
15049,6,6,1,2412,-67,-91,24,40:e3:d6:da:ba:26,100030678,380,-188,100030298,100030678
15050,6,12,1,2412,-66,-91,25,40:e3:d6:da:ba:20,100131667,160,100829,100131507,100131667
15051,6,6,1,2412,-66,-91,25,40:e3:d6:da:ba:21,100131886,368,-149,100131518,100131886
15052,6,12,1,2412,-65,-91,26,40:e3:d6:da:ba:22,100132282,180,216,100132102,100132282
15053,6,12,1,2412,-66,-91,25,40:e3:d6:da:ba:23,100132487,184,21,100132303,100132487
15054,6,12,1,2412,-66,-91,25,40:e3:d6:da:ba:24,100134874,176,2211,100134698,100134874
15055,6,12,1,2412,-65,-91,26,40:e3:d6:da:ba:25,100135076,160,42,100134916,100135076
15056,6,6,1,2412,-64,-91,27,40:e3:d6:da:ba:26,100135316,380,-140,100134936,100135316
15057,6,6,1,2412,-80,-91,11,e6:aa:ea:b7:4a:dd,100233918,408,98194,100233510,100233918
15058,6,12,1,2412,-61,-91,30,40:e3:d6:da:ba:20,100234341,160,263,100234181,100234341
15059,6,6,1,2412,-61,-91,30,40:e3:d6:da:ba:21,100234551,368,-158,100234183,100234551
15060,6,12,1,2412,-62,-91,29,40:e3:d6:da:ba:22,100234947,180,216,100234767,100234947
15061,6,12,1,2412,-62,-91,29,40:e3:d6:da:ba:23,100235180,184,49,100234996,100235180
15062,6,6,1,2412,-61,-91,30,40:e3:d6:da:ba:26,100235828,380,268,100235448,100235828
15063,6,6,1,2412,-80,-91,11,e6:aa:ea:b7:4a:dd,100246042,408,9806,100245634,100246042
15064,4,1,1,2412,-83,-91,8,54:e4:3a:ec:fb:64,100292020,2160,43818,100289860,100292020
15065,4,1,1,2412,-90,-91,1,c0:c9:e3:4d:6e:bf,100334265,872,41373,100333393,100334265
15066,6,6,1,2412,-83,-91,8,84:1b:5e:df:1b:99,100335587,80,1242,100335507,100335587
15067,6,12,1,2412,-61,-91,30,40:e3:d6:da:ba:20,100336521,160,774,100336361,100336521
15068,6,6,1,2412,-61,-91,30,40:e3:d6:da:ba:21,100336722,368,-167,100336354,100336722
15069,6,12,1,2412,-61,-91,30,40:e3:d6:da:ba:22,100337118,180,216,100336938,100337118
15070,6,12,1,2412,-61,-91,30,40:e3:d6:da:ba:23,100337323,184,21,100337139,100337323
15071,6,12,1,2412,-61,-91,30,40:e3:d6:da:ba:24,100337533,176,34,100337357,100337533
15072,6,12,1,2412,-61,-91,30,40:e3:d6:da:ba:25,100337743,160,50,100337583,100337743
15073,6,6,1,2412,-61,-91,30,40:e3:d6:da:ba:26,100337944,380,-179,100337564,100337944
15074,4,1,1,2412,-81,-91,10,b8:3a:5a:88:e6:e0,100397873,2240,57689,100395633,100397873
15075,4,1,1,2412,-82,-91,9,b8:3a:5a:88:e6:e1,100400190,2256,61,100397934,100400190
15076,6,6,1,2412,-67,-91,24,e6:aa:ea:c9:ea:33,100436003,408,35405,100435595,100436003
15077,6,12,1,2412,-61,-91,30,40:e3:d6:da:ba:20,100438869,160,2706,100438709,100438869
15078,6,6,1,2412,-61,-91,30,40:e3:d6:da:ba:21,100439070,368,-167,100438702,100439070
15079,6,12,1,2412,-61,-91,30,40:e3:d6:da:ba:22,100439457,180,207,100439277,100439457
15080,6,12,1,2412,-61,-91,30,40:e3:d6:da:ba:23,100439672,184,31,100439488,100439672
15081,6,12,1,2412,-61,-91,30,40:e3:d6:da:ba:24,100439899,176,51,100439723,100439899
15082,6,12,1,2412,-61,-91,30,40:e3:d6:da:ba:25,100440119,160,60,100439959,100440119
15083,6,6,1,2412,-61,-91,30,40:e3:d6:da:ba:26,100440320,380,-179,100439940,100440320
15084,4,1,1,2412,-92,-91,-1,,100461380,304,20756,100461076,100461380
15085,4,1,1,2412,-80,-91,11,54:e4:3a:ec:fb:64,100462820,2112,-672,100460708,100462820
15086,4,1,1,2412,-90,-91,1,,100476564,304,13440,100476260,100476564
15087,4,1,1,2412,-90,-91,1,a4:e5:7c:28:b1:d3,100477247,688,-5,100476559,100477247
15088,4,1,1,2412,-85,-91,6,,100481865,304,4314,100481561,100481865
15089,4,1,1,2412,-86,-91,5,,100483622,304,1453,100483318,100483622
15090,6,6,1,2412,-68,-91,23,e6:aa:ea:c9:ea:33,100484466,408,436,100484058,100484466
15091,4,1,1,2412,-69,-91,22,,100485803,304,1033,100485499,100485803
15092,4,1,1,2412,-90,-91,1,a6:e5:7c:28:b1:d3,100486705,992,-90,100485713,100486705
15093,4,1,1,2412,-85,-91,6,a6:e5:7c:28:b1:d3,100488162,944,513,100487218,100488162
15094,4,1,1,2412,-92,-91,-1,a6:e5:7c:28:b1:d3,100489254,944,148,100488310,100489254
15095,4,1,1,2412,-90,-91,1,a6:e5:7c:28:b1:d3,100495047,944,4849,100494103,100495047
15096,4,1,1,2412,-80,-91,11,b8:3a:5a:88:e6:e0,100525061,2360,27654,100522701,100525061
15097,4,1,1,2412,-79,-91,12,b8:3a:5a:88:e6:e1,100527450,2376,13,100525074,100527450
15098,6,6,1,2412,-80,-91,11,e6:aa:ea:b7:4a:dd,100537199,408,9341,100536791,100537199
15099,6,12,1,2412,-60,-91,31,40:e3:d6:da:ba:20,100541253,160,3894,100541093,100541253
15100,6,6,1,2412,-60,-91,31,40:e3:d6:da:ba:21,100541454,368,-167,100541086,100541454
15101,6,12,1,2412,-60,-91,31,40:e3:d6:da:ba:22,100541868,180,234,100541688,100541868
15102,6,12,1,2412,-60,-91,31,40:e3:d6:da:ba:23,100542083,184,31,100541899,100542083
15103,6,12,1,2412,-60,-91,31,40:e3:d6:da:ba:25,100542521,160,278,100542361,100542521
15104,6,6,1,2412,-60,-91,31,40:e3:d6:da:ba:26,100542722,380,-179,100542342,100542722
15105,6,6,1,2412,-80,-91,11,e6:aa:ea:b7:4a:dd,100549325,408,6195,100548917,100549325
15106,6,6,1,2412,-77,-91,14,e6:aa:ea:b7:4a:dd,100561444,408,11711,100561036,100561444
15107,6,6,1,2412,-80,-91,11,e6:aa:ea:b7:4a:dd,100585734,408,23882,100585326,100585734
15108,4,1,1,2412,-78,-91,13,b8:3a:5a:88:e6:e0,100627573,2360,39479,100625213,100627573
15109,4,1,1,2412,-79,-91,12,b8:3a:5a:88:e6:e1,100629962,2376,13,100627586,100629962
15110,6,12,1,2412,-62,-91,29,40:e3:d6:da:ba:20,100643665,160,13543,100643505,100643665
15111,6,6,1,2412,-62,-91,29,40:e3:d6:da:ba:21,100643875,368,-158,100643507,100643875
15112,6,12,1,2412,-62,-91,29,40:e3:d6:da:ba:22,100644289,180,234,100644109,100644289
15113,6,12,1,2412,-62,-91,29,40:e3:d6:da:ba:23,100644494,184,21,100644310,100644494
15114,6,12,1,2412,-62,-91,29,40:e3:d6:da:ba:24,100644722,176,52,100644546,100644722
15115,6,12,1,2412,-62,-91,29,40:e3:d6:da:ba:25,100644932,160,50,100644772,100644932
15116,4,1,1,2412,-79,-91,12,54:e4:3a:ec:fb:64,100701616,2160,54524,100699456,100701616
15117,4,1,1,2412,-80,-91,11,b8:3a:5a:88:e6:e1,100732501,2376,28509,100730125,100732501
15118,4,1,1,2412,-90,-91,1,a6:e5:7c:28:b1:d3,100737208,944,3763,100736264,100737208
15119,4,1,1,2412,-90,-91,1,a6:e5:7c:28:b1:d3,100739461,944,1309,100738517,100739461
15120,4,1,1,2412,-92,-91,-1,a6:e5:7c:28:b1:d3,100740647,944,242,100739703,100740647
15121,4,1,1,2412,-89,-91,2,a6:e5:7c:28:b1:d3,100741707,944,116,100740763,100741707
15122,4,1,1,2412,-88,-91,3,a6:e5:7c:28:b1:d3,100742767,944,116,100741823,100742767
15123,4,1,1,2412,-90,-91,1,,100744947,304,1876,100744643,100744947
15124,6,12,1,2412,-66,-91,25,40:e3:d6:da:ba:20,100746430,160,1323,100746270,100746430
15125,6,6,1,2412,-66,-91,25,40:e3:d6:da:ba:21,100746622,368,-176,100746254,100746622
15126,6,12,1,2412,-66,-91,25,40:e3:d6:da:ba:22,100747018,180,216,100746838,100747018
15127,6,12,1,2412,-65,-91,26,40:e3:d6:da:ba:23,100747250,184,48,100747066,100747250
15128,6,6,1,2412,-66,-91,25,40:e3:d6:da:ba:26,100748714,380,1084,100748334,100748714
15129,4,1,1,2412,-89,-91,2,a6:e5:7c:28:b1:d3,100749974,944,316,100749030,100749974
15130,4,1,1,2412,-91,-91,0,a6:e5:7c:28:b1:d3,100751175,944,257,100750231,100751175
15131,4,1,1,2412,-86,-91,5,a6:e5:7c:28:b1:d3,100752235,944,116,100751291,100752235
15132,4,1,1,2412,-83,-91,8,a6:e5:7c:28:b1:d3,100753317,944,138,100752373,100753317
15133,4,1,1,2412,-90,-91,1,a6:e5:7c:28:b1:d3,100754377,944,116,100753433,100754377
15134,4,1,1,2412,-92,-91,-1,a6:e5:7c:28:b1:d3,100755545,944,224,100754601,100755545
15135,4,1,1,2412,-92,-91,-1,a6:e5:7c:28:b1:d3,100756614,944,125,100755670,100756614
15136,4,1,1,2412,-80,-91,11,54:e4:3a:ec:fb:64,100804016,2160,45242,100801856,100804016
15137,4,1,1,2412,-92,-91,-1,c0:c9:e3:4d:6e:bf,100822716,872,17828,100821844,100822716
15138,4,1,1,2412,-89,-91,2,,100823605,304,585,100823301,100823605
15139,4,1,1,2412,-92,-91,-1,a6:e5:7c:28:b1:d3,100827140,944,2591,100826196,100827140
15140,4,1,1,2412,-91,-91,0,a6:e5:7c:28:b1:d3,100828218,944,134,100827274,100828218
15141,4,1,1,2412,-89,-91,2,a6:e5:7c:28:b1:d3,100829262,944,100,100828318,100829262
15142,4,1,1,2412,-89,-91,2,a6:e5:7c:28:b1:d3,100836880,944,6674,100835936,100836880
15143,4,1,1,2412,-90,-91,1,a6:e5:7c:28:b1:d3,100838056,944,232,100837112,100838056
15144,4,1,1,2412,-90,-91,1,a6:e5:7c:28:b1:d3,100839296,944,296,100838352,100839296
15145,4,1,1,2412,-77,-91,14,b8:3a:5a:88:e6:e1,100843617,2376,1945,100841241,100843617
15146,4,1,1,2412,-91,-91,0,a6:e5:7c:28:b1:d3,100846145,944,1584,100845201,100846145
15147,4,1,1,2412,-91,-91,0,a6:e5:7c:28:b1:d3,100847223,944,134,100846279,100847223
15148,4,1,1,2412,-91,-91,0,a6:e5:7c:28:b1:d3,100848283,944,116,100847339,100848283
15149,6,12,1,2412,-67,-91,24,40:e3:d6:da:ba:20,100850453,160,2010,100850293,100850453
15150,6,6,1,2412,-67,-91,24,40:e3:d6:da:ba:21,100850663,368,-158,100850295,100850663
15151,6,12,1,2412,-67,-91,24,40:e3:d6:da:ba:22,100851059,180,216,100850879,100851059
15152,6,12,1,2412,-67,-91,24,40:e3:d6:da:ba:23,100851291,184,48,100851107,100851291
15153,6,12,1,2412,-67,-91,24,40:e3:d6:da:ba:24,100851544,176,77,100851368,100851544
15154,6,12,1,2412,-67,-91,24,40:e3:d6:da:ba:25,100851763,160,59,100851603,100851763
15155,6,6,1,2412,-67,-91,24,40:e3:d6:da:ba:26,100851973,380,-170,100851593,100851973
15156,6,6,1,2412,-70,-91,21,e6:aa:ea:c9:ea:33,100866197,408,13816,100865789,100866197
15157,6,6,1,2412,-70,-91,21,e6:aa:ea:c9:ea:33,100878323,408,11718,100877915,100878323
15158,6,6,1,2412,-70,-91,21,e6:aa:ea:c9:ea:33,100890433,408,11702,100890025,100890433
15159,6,6,1,2412,-70,-91,21,e6:aa:ea:c9:ea:33,100902558,408,11717,100902150,100902558
15160,4,1,1,2412,-89,-91,2,a6:e5:7c:28:b1:d3,100913036,944,9534,100912092,100913036
15161,4,1,1,2412,-89,-91,2,a6:e5:7c:28:b1:d3,100914132,944,152,100913188,100914132
15162,4,1,1,2412,-91,-91,0,a6:e5:7c:28:b1:d3,100916380,944,1304,100915436,100916380
15163,4,1,1,2412,-89,-91,2,a6:e5:7c:28:b1:d3,100917431,944,107,100916487,100917431
15164,4,1,1,2412,-91,-91,0,a6:e5:7c:28:b1:d3,100918527,944,152,100917583,100918527
15165,4,1,1,2412,-90,-91,1,a6:e5:7c:28:b1:d3,100921338,944,1867,100920394,100921338
15166,4,1,1,2412,-92,-91,-1,a6:e5:7c:28:b1:d3,100922443,944,161,100921499,100922443
15167,4,1,1,2412,-90,-91,1,a6:e5:7c:28:b1:d3,100929112,944,5725,100928168,100929112
15168,4,1,1,2412,-91,-91,0,a6:e5:7c:28:b1:d3,100930163,944,107,100929219,100930163
15169,4,1,1,2412,-88,-91,3,a6:e5:7c:28:b1:d3,100931223,944,116,100930279,100931223
15170,4,1,1,2412,-91,-91,0,a6:e5:7c:28:b1:d3,100934430,944,2263,100933486,100934430
15171,4,1,1,2412,-76,-91,15,b8:3a:5a:88:e6:e0,100935470,2360,-1320,100933110,100935470
15172,6,12,1,2412,-68,-91,23,40:e3:d6:da:ba:20,100950875,160,15245,100950715,100950875
15173,6,6,1,2412,-68,-91,23,40:e3:d6:da:ba:21,100951076,368,-167,100950708,100951076
15174,6,12,1,2412,-67,-91,24,40:e3:d6:da:ba:22,100951490,180,234,100951310,100951490
15175,6,12,1,2412,-68,-91,23,40:e3:d6:da:ba:24,100951913,176,247,100951737,100951913
15176,6,12,1,2412,-68,-91,23,40:e3:d6:da:ba:25,100952124,160,51,100951964,100952124
15177,6,6,1,2412,-68,-91,23,40:e3:d6:da:ba:26,100952316,380,-188,100951936,100952316
15178,4,1,1,2412,-75,-91,16,b8:3a:5a:88:e6:e0,101037059,2360,82383,101034699,101037059
15179,6,12,1,2412,-67,-91,24,40:e3:d6:da:ba:20,101053264,160,16045,101053104,101053264
15180,6,6,1,2412,-67,-91,24,40:e3:d6:da:ba:21,101053456,368,-176,101053088,101053456
15181,6,12,1,2412,-67,-91,24,40:e3:d6:da:ba:22,101053861,180,225,101053681,101053861
15182,6,12,1,2412,-67,-91,24,40:e3:d6:da:ba:23,101054076,184,31,101053892,101054076
15183,6,12,1,2412,-67,-91,24,40:e3:d6:da:ba:24,101054303,176,51,101054127,101054303
15184,6,12,1,2412,-67,-91,24,40:e3:d6:da:ba:25,101054532,160,69,101054372,101054532
15185,6,6,1,2412,-67,-91,24,40:e3:d6:da:ba:26,101054724,380,-188,101054344,101054724
15186,6,6,1,2412,-82,-91,9,e6:aa:ea:b7:4a:dd,101069494,408,14362,101069086,101069494
15187,6,6,1,2412,-83,-91,8,e6:aa:ea:b7:4a:dd,101081634,408,11732,101081226,101081634
15188,4,1,1,2412,-76,-91,15,b8:3a:5a:88:e6:e0,101139441,2360,55447,101137081,101139441
15189,4,1,1,2412,-75,-91,16,b8:3a:5a:88:e6:e1,101141820,2376,3,101139444,101141820
15190,6,12,1,2412,-67,-91,24,40:e3:d6:da:ba:20,101155665,160,13685,101155505,101155665
15191,6,6,1,2412,-67,-91,24,40:e3:d6:da:ba:21,101155884,368,-149,101155516,101155884
15192,6,12,1,2412,-67,-91,24,40:e3:d6:da:ba:22,101156298,180,234,101156118,101156298
15193,6,12,1,2412,-67,-91,24,40:e3:d6:da:ba:23,101156504,184,22,101156320,101156504
15194,6,12,1,2412,-67,-91,24,40:e3:d6:da:ba:24,101156713,176,33,101156537,101156713
15195,6,12,1,2412,-67,-91,24,40:e3:d6:da:ba:25,101156949,160,76,101156789,101156949
15196,6,6,1,2412,-67,-91,24,40:e3:d6:da:ba:26,101157150,380,-179,101156770,101157150
15197,4,1,1,2412,-66,-91,25,b8:3a:5a:88:e6:e0,101241852,2360,82342,101239492,101241852
15198,4,1,1,2412,-76,-91,15,b8:3a:5a:88:e6:e1,101244232,2376,4,101241856,101244232
15199,6,12,1,2412,-67,-91,24,40:e3:d6:da:ba:23,101258882,184,14466,101258698,101258882
15200,6,12,1,2412,-67,-91,24,40:e3:d6:da:ba:24,101259100,176,42,101258924,101259100
15201,4,1,1,2412,-91,-91,0,c0:c9:e3:4d:6e:bf,101313973,872,54001,101313101,101313973
15202,4,1,1,2412,-91,-91,0,,101314862,304,585,101314558,101314862
15203,4,1,1,2412,-82,-91,9,54:e4:3a:ec:fb:64,101316011,2160,-1011,101313851,101316011
15204,4,1,1,2412,-78,-91,13,b8:3a:5a:88:e6:e0,101341587,2240,23336,101339347,101341587
15205,4,1,1,2412,-74,-91,17,b8:3a:5a:88:e6:e1,101343864,2256,21,101341608,101343864
15206,4,1,1,2412,-74,-91,17,b8:3a:5a:88:e6:e0,101347261,2360,1037,101344901,101347261
15207,4,1,1,2412,-78,-91,13,b8:3a:5a:88:e6:e1,101350017,2376,380,101347641,101350017
15208,6,12,1,2412,-66,-91,25,40:e3:d6:da:ba:20,101360487,160,10310,101360327,101360487
15209,6,6,1,2412,-67,-91,24,40:e3:d6:da:ba:21,101360688,368,-167,101360320,101360688
15210,6,12,1,2412,-67,-91,24,40:e3:d6:da:ba:22,101361075,180,207,101360895,101361075
15211,6,12,1,2412,-67,-91,24,40:e3:d6:da:ba:23,101361290,184,31,101361106,101361290
15212,6,12,1,2412,-67,-91,24,40:e3:d6:da:ba:24,101361526,176,60,101361350,101361526
15213,4,1,1,2412,-78,-91,13,b8:3a:5a:88:e6:e1,101364187,2256,405,101361931,101364187
15214,6,6,1,2412,-82,-91,9,e6:aa:ea:b7:4a:dd,101386335,408,21740,101385927,101386335
15215,6,6,1,2412,-71,-91,20,e6:aa:ea:c9:ea:33,101389528,408,2785,101389120,101389528
15216,6,6,1,2412,-83,-91,8,e6:aa:ea:b7:4a:dd,101398441,408,8505,101398033,101398441
15217,6,6,1,2412,-71,-91,20,e6:aa:ea:c9:ea:33,101399035,408,186,101398627,101399035
15218,6,6,1,2412,-82,-91,9,e6:aa:ea:b7:4a:dd,101410560,408,11117,101410152,101410560
15219,6,6,1,2412,-71,-91,20,e6:aa:ea:c9:ea:33,101413134,408,2166,101412726,101413134
15220,6,6,1,2412,-82,-91,9,e6:aa:ea:b7:4a:dd,101422684,408,9142,101422276,101422684
15221,6,6,1,2412,-71,-91,20,e6:aa:ea:c9:ea:33,101423831,408,739,101423423,101423831
15222,4,1,1,2412,-79,-91,12,b8:3a:5a:88:e6:e0,101446651,2360,20460,101444291,101446651
15223,4,1,1,2412,-79,-91,12,b8:3a:5a:88:e6:e1,101449057,2376,30,101446681,101449057
15224,6,12,1,2412,-67,-91,24,40:e3:d6:da:ba:20,101462878,160,13661,101462718,101462878
15225,6,6,1,2412,-67,-91,24,40:e3:d6:da:ba:21,101463070,368,-176,101462702,101463070
15226,6,12,1,2412,-66,-91,25,40:e3:d6:da:ba:22,101463485,180,235,101463305,101463485
15227,6,12,1,2412,-66,-91,25,40:e3:d6:da:ba:23,101463725,184,56,101463541,101463725
15228,6,12,1,2412,-67,-91,24,40:e3:d6:da:ba:24,101463934,176,33,101463758,101463934
15229,6,12,1,2412,-67,-91,24,40:e3:d6:da:ba:25,101464136,160,42,101463976,101464136
15230,6,6,1,2412,-66,-91,25,40:e3:d6:da:ba:26,101464344,380,-172,101463964,101464344
15231,4,1,1,2412,-91,-91,0,a6:e5:7c:28:b1:d3,101508001,992,42665,101507009,101508001
15232,4,1,1,2412,-80,-91,11,b8:3a:5a:88:e6:e0,101549048,2360,38687,101546688,101549048
15233,4,1,1,2412,-80,-91,11,b8:3a:5a:88:e6:e1,101551454,2376,30,101549078,101551454
15234,6,12,1,2412,-67,-91,24,40:e3:d6:da:ba:20,101565264,160,13650,101565104,101565264
15235,6,6,1,2412,-67,-91,24,40:e3:d6:da:ba:21,101565456,368,-176,101565088,101565456
15236,6,12,1,2412,-67,-91,24,40:e3:d6:da:ba:22,101565843,180,207,101565663,101565843
15237,6,12,1,2412,-67,-91,24,40:e3:d6:da:ba:23,101566076,184,49,101565892,101566076
15238,6,12,1,2412,-67,-91,24,40:e3:d6:da:ba:24,101566285,176,33,101566109,101566285
15239,6,12,1,2412,-67,-91,24,40:e3:d6:da:ba:25,101566521,160,76,101566361,101566521
15240,6,6,1,2412,-67,-91,24,40:e3:d6:da:ba:26,101566713,380,-188,101566333,101566713
15241,4,1,1,2412,-81,-91,10,54:e4:3a:ec:fb:64,101623208,2160,54335,101621048,101623208
15242,4,1,1,2412,-76,-91,15,b8:3a:5a:88:e6:e0,101651456,2360,25888,101649096,101651456
15243,4,1,1,2412,-81,-91,10,b8:3a:5a:88:e6:e1,101653844,2376,12,101651468,101653844
15244,6,12,1,2412,-68,-91,23,40:e3:d6:da:ba:20,101667660,160,13656,101667500,101667660
15245,6,6,1,2412,-67,-91,24,40:e3:d6:da:ba:21,101667879,368,-149,101667511,101667879
15246,6,12,1,2412,-67,-91,24,40:e3:d6:da:ba:22,101668284,180,225,101668104,101668284
15247,6,12,1,2412,-67,-91,24,40:e3:d6:da:ba:23,101668517,184,49,101668333,101668517
15248,6,12,1,2412,-67,-91,24,40:e3:d6:da:ba:24,101668744,176,51,101668568,101668744
15249,6,12,1,2412,-67,-91,24,40:e3:d6:da:ba:25,101668972,160,68,101668812,101668972
15250,6,6,1,2412,-71,-91,20,e6:aa:ea:c9:ea:33,101689509,408,20129,101689101,101689509
15251,6,6,1,2412,-70,-91,21,e6:aa:ea:c9:ea:33,101701578,408,11661,101701170,101701578
15252,6,6,1,2412,-71,-91,20,e6:aa:ea:c9:ea:33,101725811,408,23825,101725403,101725811
15253,6,6,1,2412,-70,-91,21,e6:aa:ea:c9:ea:33,101738055,408,11836,101737647,101738055
15254,6,12,1,2412,-68,-91,23,40:e3:d6:da:ba:22,101770685,180,32450,101770505,101770685
15255,6,12,1,2412,-68,-91,23,40:e3:d6:da:ba:23,101770933,184,64,101770749,101770933
15256,6,12,1,2412,-68,-91,23,40:e3:d6:da:ba:24,101771161,176,52,101770985,101771161
15257,6,6,1,2412,-82,-91,9,e6:aa:ea:b7:4a:dd,101792113,408,20544,101791705,101792113
15258,6,6,1,2412,-82,-91,9,e6:aa:ea:b7:4a:dd,101804240,408,11719,101803832,101804240
15259,4,1,1,2412,-91,-91,0,34:f6:4b:95:fe:d4,101826993,784,21969,101826209,101826993
15260,6,12,1,2412,-68,-91,23,40:e3:d6:da:ba:20,101827767,136,638,101827631,101827767
15261,6,6,1,2412,-67,-91,24,40:e3:d6:da:ba:21,101827962,348,-153,101827614,101827962
15262,6,12,1,2412,-67,-91,24,40:e3:d6:da:ba:22,101828356,156,238,101828200,101828356
15263,6,12,1,2412,-67,-91,24,40:e3:d6:da:ba:23,101828546,156,34,101828390,101828546
15264,6,12,1,2412,-68,-91,23,40:e3:d6:da:ba:25,101828754,136,72,101828618,101828754
15265,4,1,1,2412,-85,-91,6,54:e4:3a:ec:fb:64,101829286,2160,-1628,101827126,101829286
15266,6,6,1,2412,-81,-91,10,e6:aa:ea:b7:4a:dd,101831310,408,1616,101830902,101831310
15267,6,6,1,2412,-82,-91,9,e6:aa:ea:b7:4a:dd,101840592,408,8874,101840184,101840592
15268,4,1,1,2412,-82,-91,9,b8:3a:5a:88:e6:e0,101857730,2360,14778,101855370,101857730
15269,4,1,1,2412,-81,-91,10,b8:3a:5a:88:e6:e1,101860118,2376,12,101857742,101860118
15270,6,12,1,2412,-67,-91,24,40:e3:d6:da:ba:20,101872473,160,12195,101872313,101872473
15271,6,6,1,2412,-67,-91,24,40:e3:d6:da:ba:21,101872692,368,-149,101872324,101872692
15272,6,12,1,2412,-67,-91,24,40:e3:d6:da:ba:22,101873079,180,207,101872899,101873079
15273,6,12,1,2412,-67,-91,24,40:e3:d6:da:ba:23,101873293,184,30,101873109,101873293
15274,6,12,1,2412,-67,-91,24,40:e3:d6:da:ba:24,101873530,176,61,101873354,101873530
15275,6,12,1,2412,-67,-91,24,40:e3:d6:da:ba:25,101873749,160,59,101873589,101873749
15276,6,6,1,2412,-67,-91,24,40:e3:d6:da:ba:26,101873941,380,-188,101873561,101873941
15277,4,1,1,2412,-85,-91,6,54:e4:3a:ec:fb:64,101900135,2112,24082,101898023,101900135
15278,6,12,1,2412,-67,-91,24,40:e3:d6:da:ba:20,101902424,136,2153,101902288,101902424
15279,6,6,1,2412,-67,-91,24,40:e3:d6:da:ba:21,101902628,348,-144,101902280,101902628
15280,6,12,1,2412,-67,-91,24,40:e3:d6:da:ba:22,101903013,156,229,101902857,101903013
15281,6,12,1,2412,-66,-91,25,40:e3:d6:da:ba:23,101903230,156,61,101903074,101903230
15282,6,12,1,2412,-66,-91,25,40:e3:d6:da:ba:25,101903430,136,64,101903294,101903430
15283,4,1,1,2412,-82,-91,9,b8:3a:5a:88:e6:e0,101958643,2360,52853,101956283,101958643
15284,4,1,1,2412,-81,-91,10,b8:3a:5a:88:e6:e1,101961041,2376,22,101958665,101961041
15285,6,12,1,2412,-65,-91,26,40:e3:d6:da:ba:20,101974860,160,13659,101974700,101974860
15286,6,6,1,2412,-65,-91,26,40:e3:d6:da:ba:21,101975070,368,-158,101974702,101975070
15287,6,12,1,2412,-65,-91,26,40:e3:d6:da:ba:22,101975484,180,234,101975304,101975484
15288,6,12,1,2412,-65,-91,26,40:e3:d6:da:ba:23,101975708,184,40,101975524,101975708
15289,6,12,1,2412,-65,-91,26,40:e3:d6:da:ba:24,101975944,176,60,101975768,101975944
15290,6,12,1,2412,-65,-91,26,40:e3:d6:da:ba:25,101976164,160,60,101976004,101976164
15291,4,1,1,2412,-85,-91,6,54:e4:3a:ec:fb:64,102032805,2160,54481,102030645,102032805
15292,4,1,1,2412,-78,-91,13,b8:3a:5a:88:e6:e0,102061135,2360,25970,102058775,102061135
15293,4,1,1,2412,-79,-91,12,b8:3a:5a:88:e6:e1,102063514,2376,3,102061138,102063514
15294,6,12,1,2412,-63,-91,28,40:e3:d6:da:ba:20,102077280,160,13606,102077120,102077280
15295,6,6,1,2412,-63,-91,28,40:e3:d6:da:ba:21,102077481,368,-167,102077113,102077481
15296,6,12,1,2412,-63,-91,28,40:e3:d6:da:ba:22,102077877,180,216,102077697,102077877
15297,6,12,1,2412,-63,-91,28,40:e3:d6:da:ba:23,102078082,184,21,102077898,102078082
15298,6,12,1,2412,-63,-91,28,40:e3:d6:da:ba:24,102078319,176,61,102078143,102078319
15299,6,12,1,2412,-62,-91,29,40:e3:d6:da:ba:25,102078520,160,41,102078360,102078520
15300,6,6,1,2412,-63,-91,28,40:e3:d6:da:ba:26,102078712,380,-188,102078332,102078712
15301,4,1,1,2412,-82,-91,9,54:e4:3a:ec:fb:64,102135205,2160,54333,102133045,102135205
15302,4,1,1,2412,-78,-91,13,b8:3a:5a:88:e6:e0,102163620,2360,26055,102161260,102163620
15303,6,12,1,2412,-63,-91,28,40:e3:d6:da:ba:20,102179677,160,15897,102179517,102179677
15304,6,6,1,2412,-63,-91,28,40:e3:d6:da:ba:21,102179886,368,-159,102179518,102179886
15305,6,12,1,2412,-63,-91,28,40:e3:d6:da:ba:22,102180282,180,216,102180102,102180282
15306,6,12,1,2412,-63,-91,28,40:e3:d6:da:ba:23,102180497,184,31,102180313,102180497
15307,6,12,1,2412,-63,-91,28,40:e3:d6:da:ba:24,102180715,176,42,102180539,102180715
15308,6,12,1,2412,-62,-91,29,40:e3:d6:da:ba:25,102180935,160,60,102180775,102180935
15309,6,6,1,2412,-63,-91,28,40:e3:d6:da:ba:26,102181136,380,-179,102180756,102181136
15310,6,6,1,2412,-68,-91,23,e6:aa:ea:c9:ea:33,102209068,408,27524,102208660,102209068
15311,6,6,1,2412,-82,-91,9,e6:aa:ea:b7:4a:dd,102209931,408,455,102209523,102209931
15312,6,6,1,2412,-69,-91,22,e6:aa:ea:c9:ea:33,102221017,408,10678,102220609,102221017
15313,6,6,1,2412,-82,-91,9,e6:aa:ea:b7:4a:dd,102222056,408,631,102221648,102222056
15314,6,6,1,2412,-68,-91,23,e6:aa:ea:c9:ea:33,102245236,408,22772,102244828,102245236
15315,6,6,1,2412,-84,-91,7,e6:aa:ea:b7:4a:dd,102246285,408,641,102245877,102246285
15316,6,6,1,2412,-71,-91,20,e6:aa:ea:c9:ea:33,102257335,408,10642,102256927,102257335
15317,6,6,1,2412,-83,-91,8,e6:aa:ea:b7:4a:dd,102258410,408,667,102258002,102258410
15318,4,1,1,2412,-74,-91,17,b8:3a:5a:88:e6:e0,102267498,2360,6728,102265138,102267498
15319,4,1,1,2412,-79,-91,12,b8:3a:5a:88:e6:e1,102269896,2376,22,102267520,102269896
15320,6,6,1,2412,-64,-91,27,40:e3:d6:da:ba:21,102282281,368,12017,102281913,102282281
15321,6,12,1,2412,-63,-91,28,40:e3:d6:da:ba:22,102282695,180,234,102282515,102282695
15322,6,12,1,2412,-63,-91,28,40:e3:d6:da:ba:23,102282917,184,38,102282733,102282917
15323,6,12,1,2412,-63,-91,28,40:e3:d6:da:ba:24,102283145,176,52,102282969,102283145
15324,6,12,1,2412,-63,-91,28,40:e3:d6:da:ba:25,102283374,160,69,102283214,102283374
15325,6,6,1,2412,-63,-91,28,40:e3:d6:da:ba:26,102283566,380,-188,102283186,102283566
15326,4,1,1,2412,-90,-91,1,a0:59:50:b4:3a:a2,102307115,1176,22373,102305939,102307115
15327,6,12,1,2412,-63,-91,28,40:e3:d6:da:ba:20,102308473,136,1222,102308337,102308473
15328,6,6,1,2412,-63,-91,28,40:e3:d6:da:ba:21,102308649,348,-172,102308301,102308649
15329,4,1,1,2412,-82,-91,9,b8:3a:5a:88:e6:e0,102335939,2240,25050,102333699,102335939
15330,4,1,1,2412,-82,-91,9,b8:3a:5a:88:e6:e1,102338270,2256,75,102336014,102338270
15331,4,1,1,2412,-79,-91,12,54:e4:3a:ec:fb:64,102340665,2160,235,102338505,102340665
15332,4,1,1,2412,-82,-91,9,b8:3a:5a:88:e6:e0,102369901,2360,26876,102367541,102369901
15333,4,1,1,2412,-81,-91,10,b8:3a:5a:88:e6:e1,102372290,2376,13,102369914,102372290
15334,6,12,1,2412,-64,-91,27,40:e3:d6:da:ba:20,102384457,160,12007,102384297,102384457
15335,6,6,1,2412,-63,-91,28,40:e3:d6:da:ba:21,102384658,368,-167,102384290,102384658
15336,6,12,1,2412,-63,-91,28,40:e3:d6:da:ba:22,102385072,180,234,102384892,102385072
15337,6,12,1,2412,-63,-91,28,40:e3:d6:da:ba:23,102385295,184,39,102385111,102385295
15338,6,12,1,2412,-63,-91,28,40:e3:d6:da:ba:24,102385523,176,52,102385347,102385523
15339,6,12,1,2412,-63,-91,28,40:e3:d6:da:ba:25,102385733,160,50,102385573,102385733
15340,6,6,1,2412,-63,-91,28,40:e3:d6:da:ba:26,102385925,380,-188,102385545,102385925
15341,4,1,1,2412,-86,-91,5,b8:3a:5a:88:e6:e1,102390400,2256,2219,102388144,102390400
15342,4,1,1,2412,-78,-91,13,b8:3a:5a:88:e6:e0,102470657,2360,77897,102468297,102470657
15343,4,1,1,2412,-79,-91,12,b8:3a:5a:88:e6:e1,102473055,2376,22,102470679,102473055
15344,6,12,1,2412,-63,-91,28,40:e3:d6:da:ba:20,102486872,160,13657,102486712,102486872
15345,6,12,1,2412,-63,-91,28,40:e3:d6:da:ba:24,102487956,176,908,102487780,102487956
15346,6,12,1,2412,-64,-91,27,40:e3:d6:da:ba:25,102488166,160,50,102488006,102488166
15347,6,6,1,2412,-63,-91,28,40:e3:d6:da:ba:26,102488358,380,-188,102487978,102488358
15348,4,1,1,2412,-79,-91,12,54:e4:3a:ec:fb:64,102544800,2160,54282,102542640,102544800
15349,4,1,1,2412,-78,-91,13,b8:3a:5a:88:e6:e0,102573063,2360,25903,102570703,102573063
15350,6,12,1,2412,-63,-91,28,40:e3:d6:da:ba:20,102589264,160,16041,102589104,102589264
15351,6,6,1,2412,-63,-91,28,40:e3:d6:da:ba:21,102589474,368,-158,102589106,102589474
15352,6,12,1,2412,-63,-91,28,40:e3:d6:da:ba:22,102589879,180,225,102589699,102589879
15353,6,12,1,2412,-63,-91,28,40:e3:d6:da:ba:23,102590085,184,22,102589901,102590085
15354,6,12,1,2412,-63,-91,28,40:e3:d6:da:ba:24,102590294,176,33,102590118,102590294
15355,6,6,1,2412,-68,-91,23,e6:aa:ea:c9:ea:33,102625957,408,35255,102625549,102625957
15356,6,6,1,2412,-79,-91,12,e6:aa:ea:b7:4a:dd,102628076,408,1711,102627668,102628076
15357,6,6,1,2412,-67,-91,24,e6:aa:ea:c9:ea:33,102638077,408,9593,102637669,102638077
15358,6,6,1,2412,-80,-91,11,e6:aa:ea:b7:4a:dd,102640165,408,1680,102639757,102640165
15359,4,1,1,2412,-79,-91,12,54:e4:3a:ec:fb:64,102647239,2160,4914,102645079,102647239
15360,6,6,1,2412,-68,-91,23,e6:aa:ea:c9:ea:33,102650360,408,2713,102649952,102650360
15361,6,6,1,2412,-80,-91,11,e6:aa:ea:b7:4a:dd,102652288,408,1520,102651880,102652288
15362,6,6,1,2412,-68,-91,23,e6:aa:ea:c9:ea:33,102662525,408,9829,102662117,102662525
15363,6,6,1,2412,-78,-91,13,e6:aa:ea:b7:4a:dd,102664400,408,1467,102663992,102664400
15364,6,6,1,2412,-68,-91,23,e6:aa:ea:c9:ea:33,102674486,408,9678,102674078,102674486
15365,4,1,1,2412,-77,-91,14,b8:3a:5a:88:e6:e0,102675460,2360,-1386,102673100,102675460
15366,4,1,1,2412,-78,-91,13,b8:3a:5a:88:e6:e1,102677867,2376,31,102675491,102677867
15367,6,12,1,2412,-64,-91,27,40:e3:d6:da:ba:20,102691658,160,13631,102691498,102691658
15368,6,6,1,2412,-65,-91,26,40:e3:d6:da:ba:21,102691869,368,-157,102691501,102691869
15369,6,12,1,2412,-64,-91,27,40:e3:d6:da:ba:22,102692273,180,224,102692093,102692273
15370,6,12,1,2412,-65,-91,26,40:e3:d6:da:ba:23,102692506,184,49,102692322,102692506
15371,6,12,1,2412,-64,-91,27,40:e3:d6:da:ba:24,102692725,176,43,102692549,102692725
15372,6,12,1,2412,-64,-91,27,40:e3:d6:da:ba:25,102692969,160,84,102692809,102692969
15373,6,6,1,2412,-65,-91,26,40:e3:d6:da:ba:26,102693170,380,-179,102692790,102693170
15374,4,1,1,2412,-92,-91,-1,a6:e5:7c:28:b1:d3,102737073,992,42911,102736081,102737073
15375,4,1,1,2412,-79,-91,12,54:e4:3a:ec:fb:64,102749599,2160,10366,102747439,102749599
15376,6,12,1,2412,-64,-91,27,40:e3:d6:da:ba:20,102794080,160,44321,102793920,102794080
15377,6,6,1,2412,-64,-91,27,40:e3:d6:da:ba:21,102794290,368,-158,102793922,102794290
15378,6,12,1,2412,-64,-91,27,40:e3:d6:da:ba:22,102794686,180,216,102794506,102794686
15379,6,12,1,2412,-64,-91,27,40:e3:d6:da:ba:23,102794910,184,40,102794726,102794910
15380,6,12,1,2412,-64,-91,27,40:e3:d6:da:ba:24,102795128,176,42,102794952,102795128
15381,6,12,1,2412,-64,-91,27,40:e3:d6:da:ba:25,102795348,160,60,102795188,102795348
15382,6,6,1,2412,-64,-91,27,40:e3:d6:da:ba:26,102795540,380,-188,102795160,102795540
15383,4,1,1,2412,-82,-91,9,54:e4:3a:ec:fb:64,102851998,2160,54298,102849838,102851998
15384,4,1,1,2412,-78,-91,13,b8:3a:5a:88:e6:e0,102880250,2360,25892,102877890,102880250
15385,6,12,1,2412,-65,-91,26,40:e3:d6:da:ba:20,102896469,160,16059,102896309,102896469
15386,6,6,1,2412,-65,-91,26,40:e3:d6:da:ba:21,102896688,368,-149,102896320,102896688
15387,6,12,1,2412,-65,-91,26,40:e3:d6:da:ba:22,102897093,180,225,102896913,102897093
15388,6,12,1,2412,-65,-91,26,40:e3:d6:da:ba:23,102897326,184,49,102897142,102897326
15389,6,12,1,2412,-65,-91,26,40:e3:d6:da:ba:24,102897535,176,33,102897359,102897535
15390,6,12,1,2412,-65,-91,26,40:e3:d6:da:ba:25,102897755,160,60,102897595,102897755
15391,4,1,1,2412,-86,-91,5,aa:af:7c:0c:82:0b,102928507,1152,29600,102927355,102928507
15392,4,1,1,2412,-82,-91,9,54:e4:3a:ec:fb:64,102929783,2112,-836,102927671,102929783
15393,4,1,1,2412,-85,-91,6,,102931907,304,1820,102931603,102931907
15394,6,12,1,2412,-67,-91,24,40:e3:d6:da:ba:20,102932071,136,28,102931935,102932071
15395,6,6,1,2412,-67,-91,24,40:e3:d6:da:ba:21,102932275,348,-144,102931927,102932275
15396,6,12,1,2412,-66,-91,25,40:e3:d6:da:ba:22,102932660,156,229,102932504,102932660
15397,6,12,1,2412,-66,-91,25,40:e3:d6:da:ba:23,102932894,156,78,102932738,102932894
15398,4,1,1,2412,-41,-91,50,aa:af:7c:0c:82:0b,102948750,1152,14704,102947598,102948750
15399,6,12,1,2412,-67,-91,24,40:e3:d6:da:ba:20,102949875,136,989,102949739,102949875
15400,6,6,1,2412,-67,-91,24,40:e3:d6:da:ba:21,102950052,348,-171,102949704,102950052
15401,6,12,1,2412,-67,-91,24,40:e3:d6:da:ba:22,102950437,156,229,102950281,102950437
15402,6,12,1,2412,-67,-91,24,40:e3:d6:da:ba:23,102950645,156,52,102950489,102950645
15403,6,12,1,2412,-67,-91,24,40:e3:d6:da:ba:25,102950836,136,55,102950700,102950836
15404,6,12,1,2412,-86,-91,5,,102950988,32,120,102950956,102950988
15405,4,1,1,2412,-80,-91,11,54:e4:3a:ec:fb:64,102951403,2112,-1697,102949291,102951403
15406,4,1,1,2412,-81,-91,10,54:e4:3a:ec:fb:64,102954396,2160,833,102952236,102954396
15407,4,1,1,2412,-81,-91,10,b8:3a:5a:88:e6:e0,102982646,2360,25890,102980286,102982646
15408,4,1,1,2412,-82,-91,9,b8:3a:5a:88:e6:e1,102985053,2376,31,102982677,102985053
15409,6,12,1,2412,-67,-91,24,40:e3:d6:da:ba:20,102998860,160,13647,102998700,102998860
15410,6,6,1,2412,-66,-91,25,40:e3:d6:da:ba:21,102999061,368,-167,102998693,102999061
15411,6,12,1,2412,-66,-91,25,40:e3:d6:da:ba:22,102999475,180,234,102999295,102999475
15412,6,12,1,2412,-66,-91,25,40:e3:d6:da:ba:23,102999681,184,22,102999497,102999681
15413,6,12,1,2412,-66,-91,25,40:e3:d6:da:ba:24,102999890,176,33,102999714,102999890
15414,6,12,1,2412,-66,-91,25,40:e3:d6:da:ba:25,103000101,160,51,102999941,103000101
15415,6,6,1,2412,-66,-91,25,40:e3:d6:da:ba:26,103000320,380,-161,102999940,103000320
15416,6,6,1,2412,-72,-91,19,e6:aa:ea:c9:ea:33,103043652,408,42924,103043244,103043652
15417,4,1,1,2412,-92,-91,-1,a6:e5:7c:28:b1:d3,103044293,992,-351,103043301,103044293
15418,6,6,1,2412,-71,-91,20,e6:aa:ea:c9:ea:33,103055867,408,11166,103055459,103055867
15419,4,1,1,2412,-79,-91,12,54:e4:3a:ec:fb:64,103056796,2160,-1231,103054636,103056796
15420,6,6,1,2412,-72,-91,19,e6:aa:ea:c9:ea:33,103067901,408,10697,103067493,103067901
15421,6,6,1,2412,-72,-91,19,e6:aa:ea:c9:ea:33,103079980,408,11671,103079572,103079980
15422,6,6,1,2412,-72,-91,19,e6:aa:ea:c9:ea:33,103094820,408,14432,103094412,103094820
15423,6,12,1,2412,-65,-91,26,40:e3:d6:da:ba:20,103101273,160,6293,103101113,103101273
15424,6,6,1,2412,-64,-91,27,40:e3:d6:da:ba:21,103101465,368,-176,103101097,103101465
15425,6,12,1,2412,-64,-91,27,40:e3:d6:da:ba:22,103101852,180,207,103101672,103101852
15426,6,12,1,2412,-64,-91,27,40:e3:d6:da:ba:23,103102076,184,40,103101892,103102076
15427,6,12,1,2412,-64,-91,27,40:e3:d6:da:ba:24,103102312,176,60,103102136,103102312
15428,6,12,1,2412,-64,-91,27,40:e3:d6:da:ba:25,103102541,160,69,103102381,103102541
15429,6,6,1,2412,-64,-91,27,40:e3:d6:da:ba:26,103102760,380,-161,103102380,103102760
15430,4,1,1,2412,-93,-91,-2,a6:e5:7c:28:b1:d3,103151447,992,47695,103150455,103151447
15431,4,1,1,2412,-80,-91,11,54:e4:3a:ec:fb:64,103159196,2160,5589,103157036,103159196
15432,4,1,1,2412,-77,-91,14,b8:3a:5a:88:e6:e0,103187449,2360,25893,103185089,103187449
15433,6,12,1,2412,-61,-91,30,40:e3:d6:da:ba:20,103203683,160,16074,103203523,103203683
15434,6,6,1,2412,-61,-91,30,40:e3:d6:da:ba:21,103203885,368,-166,103203517,103203885
15435,6,12,1,2412,-61,-91,30,40:e3:d6:da:ba:22,103204314,180,249,103204134,103204314
15436,6,12,1,2412,-61,-91,30,40:e3:d6:da:ba:23,103204547,184,49,103204363,103204547
15437,6,12,1,2412,-61,-91,30,40:e3:d6:da:ba:24,103204803,176,80,103204627,103204803
15438,6,12,1,2412,-61,-91,30,40:e3:d6:da:ba:25,103205014,160,51,103204854,103205014
15439,6,6,1,2412,-61,-91,30,40:e3:d6:da:ba:26,103205233,380,-161,103204853,103205233
15440,4,1,1,2412,-90,-91,1,a6:e5:7c:28:b1:d3,103249732,992,43507,103248740,103249732
15441,6,6,1,2412,-83,-91,8,84:1b:5e:df:1b:99,103255563,80,5751,103255483,103255563
15442,4,1,1,2412,-77,-91,14,54:e4:3a:ec:fb:64,103261594,2160,3871,103259434,103261594
15443,4,1,1,2412,-90,-91,1,c0:c9:e3:4d:6e:bf,103285256,872,22790,103284384,103285256
15444,4,1,1,2412,-72,-91,19,b8:3a:5a:88:e6:e0,103289868,2360,2252,103287508,103289868
15445,6,12,1,2412,-62,-91,29,40:e3:d6:da:ba:20,103306069,160,16041,103305909,103306069
15446,6,6,1,2412,-62,-91,29,40:e3:d6:da:ba:21,103306261,368,-176,103305893,103306261
15447,6,12,1,2412,-62,-91,29,40:e3:d6:da:ba:22,103306666,180,225,103306486,103306666
15448,6,12,1,2412,-61,-91,30,40:e3:d6:da:ba:23,103306915,184,65,103306731,103306915
15449,6,12,1,2412,-62,-91,29,40:e3:d6:da:ba:24,103307133,176,42,103306957,103307133
15450,6,12,1,2412,-61,-91,30,40:e3:d6:da:ba:25,103307344,160,51,103307184,103307344
15451,4,1,1,2412,-93,-91,-2,,103330386,304,22738,103330082,103330386
15452,6,6,1,2412,-78,-91,13,e6:aa:ea:b7:4a:dd,103362195,408,31401,103361787,103362195
15453,6,6,1,2412,-79,-91,12,e6:aa:ea:b7:4a:dd,103374261,408,11658,103373853,103374261
15454,4,1,1,2412,-87,-91,4,,103375320,304,755,103375016,103375320
15455,6,12,1,2412,-66,-91,25,40:e3:d6:da:ba:20,103408487,160,33007,103408327,103408487
15456,6,6,1,2412,-66,-91,25,40:e3:d6:da:ba:21,103408688,368,-167,103408320,103408688
15457,6,12,1,2412,-66,-91,25,40:e3:d6:da:ba:22,103409084,180,216,103408904,103409084
15458,6,12,1,2412,-67,-91,24,40:e3:d6:da:ba:23,103409289,184,21,103409105,103409289
15459,6,12,1,2412,-66,-91,25,40:e3:d6:da:ba:24,103409499,176,34,103409323,103409499
15460,6,12,1,2412,-66,-91,25,40:e3:d6:da:ba:25,103409709,160,50,103409549,103409709
15461,6,6,1,2412,-66,-91,25,40:e3:d6:da:ba:26,103409910,380,-179,103409530,103409910
15462,6,6,1,2412,-83,-91,8,e6:aa:ea:b7:4a:dd,103410688,408,370,103410280,103410688
15463,6,6,1,2412,-70,-91,21,e6:aa:ea:c9:ea:33,103461046,408,49950,103460638,103461046
15464,4,1,1,2412,-81,-91,10,54:e4:3a:ec:fb:64,103466393,2160,3187,103464233,103466393
15465,4,1,1,2412,-80,-91,11,b8:3a:5a:88:e6:e0,103494659,2360,25906,103492299,103494659
15466,6,6,1,2412,-69,-91,22,e6:aa:ea:c9:ea:33,103509514,408,14447,103509106,103509514
15467,6,12,1,2412,-66,-91,25,40:e3:d6:da:ba:20,103510863,160,1189,103510703,103510863
15468,6,6,1,2412,-66,-91,25,40:e3:d6:da:ba:21,103511082,368,-149,103510714,103511082
15469,6,12,1,2412,-66,-91,25,40:e3:d6:da:ba:22,103511496,180,234,103511316,103511496
15470,6,12,1,2412,-65,-91,26,40:e3:d6:da:ba:23,103511710,184,30,103511526,103511710
15471,6,12,1,2412,-66,-91,25,40:e3:d6:da:ba:24,103511920,176,34,103511744,103511920
15472,4,1,1,2412,-79,-91,12,54:e4:3a:ec:fb:64,103568791,2160,54711,103566631,103568791
15473,4,1,1,2412,-83,-91,8,b8:3a:5a:88:e6:e0,103597068,2360,25917,103594708,103597068
15474,4,1,1,2412,-83,-91,8,b8:3a:5a:88:e6:e1,103599593,2376,149,103597217,103599593
15475,6,12,1,2412,-67,-91,24,40:e3:d6:da:ba:20,103613287,160,13534,103613127,103613287
15476,6,6,1,2412,-67,-91,24,40:e3:d6:da:ba:21,103613506,368,-149,103613138,103613506
15477,6,12,1,2412,-68,-91,23,40:e3:d6:da:ba:22,103613902,180,216,103613722,103613902
15478,6,12,1,2412,-68,-91,23,40:e3:d6:da:ba:23,103614126,184,40,103613942,103614126
15479,6,12,1,2412,-67,-91,24,40:e3:d6:da:ba:24,103614344,176,42,103614168,103614344
15480,6,12,1,2412,-67,-91,24,40:e3:d6:da:ba:25,103614546,160,42,103614386,103614546
15481,6,6,1,2412,-67,-91,24,40:e3:d6:da:ba:26,103614747,380,-179,103614367,103614747
15482,4,1,1,2412,-83,-91,8,54:e4:3a:ec:fb:64,103671190,2160,54283,103669030,103671190
15483,4,1,1,2412,-81,-91,10,b8:3a:5a:88:e6:e0,103699567,2360,26017,103697207,103699567
15484,4,1,1,2412,-81,-91,10,b8:3a:5a:88:e6:e1,103702030,2376,87,103699654,103702030
15485,6,12,1,2412,-64,-91,27,40:e3:d6:da:ba:20,103715664,160,13474,103715504,103715664
15486,6,6,1,2412,-64,-91,27,40:e3:d6:da:ba:21,103715856,368,-176,103715488,103715856
15487,6,12,1,2412,-63,-91,28,40:e3:d6:da:ba:22,103716243,180,207,103716063,103716243
15488,6,12,1,2412,-63,-91,28,40:e3:d6:da:ba:23,103716466,184,39,103716282,103716466
15489,6,12,1,2412,-63,-91,28,40:e3:d6:da:ba:25,103716886,160,260,103716726,103716886
15490,6,6,1,2412,-64,-91,27,40:e3:d6:da:ba:26,103717078,380,-188,103716698,103717078
15491,4,1,1,2412,-84,-91,7,54:e4:3a:ec:fb:64,103773590,2160,54352,103771430,103773590
15492,6,6,1,2412,-70,-91,21,e6:aa:ea:c9:ea:33,103775737,408,1739,103775329,103775737
15493,6,6,1,2412,-80,-91,11,e6:aa:ea:b7:4a:dd,103780042,408,3897,103779634,103780042
15494,4,1,1,2412,-91,-91,0,c0:c9:e3:4d:6e:bf,103780737,872,-177,103779865,103780737
15495,6,6,1,2412,-80,-91,11,e6:aa:ea:b7:4a:dd,103792152,408,11007,103791744,103792152
15496,6,6,1,2412,-70,-91,21,e6:aa:ea:c9:ea:33,103799966,408,7406,103799558,103799966
15497,4,1,1,2412,-78,-91,13,b8:3a:5a:88:e6:e0,103801868,2360,-458,103799508,103801868
15498,4,1,1,2412,-79,-91,12,b8:3a:5a:88:e6:e1,103804256,2376,12,103801880,103804256
15499,6,6,1,2412,-70,-91,21,e6:aa:ea:c9:ea:33,103812085,408,7421,103811677,103812085
15500,6,6,1,2412,-81,-91,10,e6:aa:ea:b7:4a:dd,103816392,408,3899,103815984,103816392
15501,6,12,1,2412,-63,-91,28,40:e3:d6:da:ba:20,103818104,160,1552,103817944,103818104
15502,6,6,1,2412,-63,-91,28,40:e3:d6:da:ba:21,103818305,368,-167,103817937,103818305
15503,6,12,1,2412,-63,-91,28,40:e3:d6:da:ba:22,103818719,180,234,103818539,103818719
15504,6,12,1,2412,-62,-91,29,40:e3:d6:da:ba:24,103819143,176,248,103818967,103819143
15505,6,12,1,2412,-63,-91,28,40:e3:d6:da:ba:25,103819344,160,41,103819184,103819344
15506,6,6,1,2412,-62,-91,29,40:e3:d6:da:ba:26,103819545,380,-179,103819165,103819545
15507,6,6,1,2412,-70,-91,21,e6:aa:ea:c9:ea:33,103824298,408,4345,103823890,103824298
15508,6,6,1,2412,-80,-91,11,e6:aa:ea:b7:4a:dd,103828517,408,3811,103828109,103828517
15509,4,1,1,2412,-81,-91,10,54:e4:3a:ec:fb:64,103875988,2160,45311,103873828,103875988
15510,4,1,1,2412,-77,-91,14,b8:3a:5a:88:e6:e1,103908990,2376,30626,103906614,103908990
15511,6,12,1,2412,-63,-91,28,40:e3:d6:da:ba:20,103920464,160,11314,103920304,103920464
15512,6,6,1,2412,-63,-91,28,40:e3:d6:da:ba:21,103920674,368,-158,103920306,103920674
15513,6,12,1,2412,-63,-91,28,40:e3:d6:da:ba:22,103921079,180,225,103920899,103921079
15514,6,12,1,2412,-63,-91,28,40:e3:d6:da:ba:23,103921285,184,22,103921101,103921285
15515,6,12,1,2412,-62,-91,29,40:e3:d6:da:ba:24,103921503,176,42,103921327,103921503
15516,6,12,1,2412,-63,-91,28,40:e3:d6:da:ba:25,103921713,160,50,103921553,103921713
15517,6,6,1,2412,-63,-91,28,40:e3:d6:da:ba:26,103921932,380,-161,103921552,103921932
15518,4,1,1,2412,-64,-91,27,b8:3a:5a:88:e6:e0,104008472,2360,84180,104006112,104008472
15519,4,1,1,2412,-75,-91,16,b8:3a:5a:88:e6:e1,104010878,2376,30,104008502,104010878
15520,6,12,1,2412,-62,-91,29,40:e3:d6:da:ba:20,104022865,160,11827,104022705,104022865
15521,6,12,1,2412,-63,-91,28,40:e3:d6:da:ba:22,104023471,180,426,104023291,104023471
15522,6,12,1,2412,-63,-91,28,40:e3:d6:da:ba:23,104023685,184,30,104023501,104023685
15523,6,12,1,2412,-63,-91,28,40:e3:d6:da:ba:24,104023904,176,43,104023728,104023904
15524,6,6,1,2412,-63,-91,28,40:e3:d6:da:ba:26,104024324,380,40,104023944,104024324
15525,4,1,1,2412,-83,-91,8,54:e4:3a:ec:fb:64,104080787,2160,54303,104078627,104080787
15526,6,6,1,2412,-80,-91,11,e6:aa:ea:b7:4a:dd,104094358,408,13163,104093950,104094358
15527,4,1,1,2412,-72,-91,19,b8:3a:5a:88:e6:e0,104109043,2360,12325,104106683,104109043
15528,4,1,1,2412,-72,-91,19,b8:3a:5a:88:e6:e1,104111450,2376,31,104109074,104111450
15529,6,6,1,2412,-80,-91,11,e6:aa:ea:b7:4a:dd,104118963,408,7105,104118555,104118963
15530,6,12,1,2412,-63,-91,28,40:e3:d6:da:ba:22,104125896,180,6753,104125716,104125896
15531,6,12,1,2412,-62,-91,29,40:e3:d6:da:ba:23,104126129,184,49,104125945,104126129
15532,6,12,1,2412,-63,-91,28,40:e3:d6:da:ba:24,104126347,176,42,104126171,104126347
15533,6,12,1,2412,-62,-91,29,40:e3:d6:da:ba:25,104126558,160,51,104126398,104126558
15534,6,6,1,2412,-62,-91,29,40:e3:d6:da:ba:26,104126813,380,-125,104126433,104126813
15535,4,1,1,2412,-82,-91,9,54:e4:3a:ec:fb:64,104183186,2160,54213,104181026,104183186
15536,4,1,1,2412,-71,-91,20,b8:3a:5a:88:e6:e0,104211457,2360,25911,104209097,104211457
15537,4,1,1,2412,-74,-91,17,b8:3a:5a:88:e6:e1,104213837,2376,4,104211461,104213837
15538,6,12,1,2412,-63,-91,28,40:e3:d6:da:ba:20,104227679,160,13682,104227519,104227679
15539,6,6,1,2412,-64,-91,27,40:e3:d6:da:ba:21,104227871,368,-176,104227503,104227871
15540,6,12,1,2412,-64,-91,27,40:e3:d6:da:ba:22,104228267,180,216,104228087,104228267
15541,6,12,1,2412,-63,-91,28,40:e3:d6:da:ba:23,104228472,184,21,104228288,104228472
15542,6,12,1,2412,-64,-91,27,40:e3:d6:da:ba:24,104228682,176,34,104228506,104228682
15543,6,12,1,2412,-63,-91,28,40:e3:d6:da:ba:25,104228910,160,68,104228750,104228910
15544,6,6,1,2412,-64,-91,27,40:e3:d6:da:ba:26,104229120,380,-170,104228740,104229120
15545,4,1,1,2412,-88,-91,3,c0:c9:e3:4d:6e:bf,104272291,872,42299,104271419,104272291
15546,6,6,1,2412,-73,-91,18,e6:aa:ea:c9:ea:33,104295921,408,23222,104295513,104295921
15547,4,1,1,2412,-75,-91,16,b8:3a:5a:88:e6:e0,104314848,2360,16567,104312488,104314848
15548,4,1,1,2412,-76,-91,15,b8:3a:5a:88:e6:e1,104317237,2376,13,104314861,104317237
15549,6,12,1,2412,-67,-91,24,40:e3:d6:da:ba:20,104330093,160,12696,104329933,104330093
15550,6,6,1,2412,-66,-91,25,40:e3:d6:da:ba:21,104330312,368,-149,104329944,104330312
15551,6,12,1,2412,-66,-91,25,40:e3:d6:da:ba:22,104330699,180,207,104330519,104330699
15552,6,12,1,2412,-66,-91,25,40:e3:d6:da:ba:23,104330931,184,48,104330747,104330931
15553,6,12,1,2412,-67,-91,24,40:e3:d6:da:ba:24,104331141,176,34,104330965,104331141
15554,6,6,1,2412,-66,-91,25,40:e3:d6:da:ba:26,104331570,380,49,104331190,104331570
15555,6,6,1,2412,-75,-91,16,e6:aa:ea:c9:ea:33,104332309,408,331,104331901,104332309
15556,6,6,1,2412,-75,-91,16,e6:aa:ea:c9:ea:33,104344431,408,11714,104344023,104344431
15557,4,1,1,2412,-82,-91,9,,104364337,304,19602,104364033,104364337
15558,4,1,1,2412,-81,-91,10,54:e4:3a:ec:fb:64,104387985,2160,21488,104385825,104387985
15559,6,6,1,2412,-80,-91,11,e6:aa:ea:b7:4a:dd,104409880,408,21487,104409472,104409880
15560,4,1,1,2412,-75,-91,16,b8:3a:5a:88:e6:e0,104416253,2360,4013,104413893,104416253
15561,4,1,1,2412,-78,-91,13,b8:3a:5a:88:e6:e1,104418633,2376,4,104416257,104418633
15562,6,6,1,2412,-80,-91,11,e6:aa:ea:b7:4a:dd,104422009,408,2968,104421601,104422009
15563,6,12,1,2412,-67,-91,24,40:e3:d6:da:ba:20,104432473,160,10304,104432313,104432473
15564,6,6,1,2412,-67,-91,24,40:e3:d6:da:ba:21,104432665,368,-176,104432297,104432665
15565,6,12,1,2412,-67,-91,24,40:e3:d6:da:ba:22,104433070,180,225,104432890,104433070
15566,6,12,1,2412,-67,-91,24,40:e3:d6:da:ba:23,104433293,184,39,104433109,104433293
15567,6,12,1,2412,-67,-91,24,40:e3:d6:da:ba:24,104433512,176,43,104433336,104433512
15568,6,12,1,2412,-67,-91,24,40:e3:d6:da:ba:25,104433741,160,69,104433581,104433741
15569,6,6,1,2412,-67,-91,24,40:e3:d6:da:ba:26,104433951,380,-170,104433571,104433951
15570,6,6,1,2412,-81,-91,10,e6:aa:ea:b7:4a:dd,104434719,408,360,104434311,104434719
15571,6,6,1,2412,-81,-91,10,e6:aa:ea:b7:4a:dd,104446241,408,11114,104445833,104446241
15572,6,6,1,2412,-80,-91,11,e6:aa:ea:b7:4a:dd,104458361,408,11712,104457953,104458361
15573,4,1,1,2412,-82,-91,9,54:e4:3a:ec:fb:64,104490384,2160,29863,104488224,104490384
15574,4,1,1,2412,-77,-91,14,b8:3a:5a:88:e6:e0,104519335,2360,26591,104516975,104519335
15575,4,1,1,2412,-76,-91,15,b8:3a:5a:88:e6:e1,104521746,2376,35,104519370,104521746
15576,6,12,1,2412,-65,-91,26,40:e3:d6:da:ba:20,104534890,160,12984,104534730,104534890
15577,6,6,1,2412,-65,-91,26,40:e3:d6:da:ba:21,104535109,368,-149,104534741,104535109
15578,6,12,1,2412,-65,-91,26,40:e3:d6:da:ba:22,104535505,180,216,104535325,104535505
15579,6,12,1,2412,-65,-91,26,40:e3:d6:da:ba:23,104535729,184,40,104535545,104535729
15580,6,12,1,2412,-65,-91,26,40:e3:d6:da:ba:24,104535938,176,33,104535762,104535938
15581,6,12,1,2412,-65,-91,26,40:e3:d6:da:ba:25,104536148,160,50,104535988,104536148
15582,6,6,1,2412,-65,-91,26,40:e3:d6:da:ba:26,104536349,380,-179,104535969,104536349
15583,4,1,1,2412,-81,-91,10,54:e4:3a:ec:fb:64,104592782,2160,54273,104590622,104592782
15584,6,12,1,2412,-83,-91,8,40:e3:d6:da:c0:22,104609518,176,16560,104609342,104609518
15585,6,12,1,2412,-85,-91,6,40:e3:d6:da:c0:24,104609942,172,252,104609770,104609942
15586,6,12,1,2412,-87,-91,4,40:e3:d6:da:c0:25,104610167,156,69,104610011,104610167
15587,4,1,1,2412,-78,-91,13,b8:3a:5a:88:e6:e0,104621060,2360,8533,104618700,104621060
15588,6,12,1,2412,-67,-91,24,40:e3:d6:da:ba:20,104637275,160,16055,104637115,104637275
15589,6,6,1,2412,-67,-91,24,40:e3:d6:da:ba:21,104637476,368,-167,104637108,104637476
15590,6,12,1,2412,-67,-91,24,40:e3:d6:da:ba:22,104637863,180,207,104637683,104637863
15591,6,12,1,2412,-67,-91,24,40:e3:d6:da:ba:23,104638078,184,31,104637894,104638078
15592,6,12,1,2412,-67,-91,24,40:e3:d6:da:ba:24,104638296,176,42,104638120,104638296
15593,4,1,1,2412,-80,-91,11,54:e4:3a:ec:fb:64,104695182,2160,54726,104693022,104695182
15594,6,6,1,2412,-87,-91,4,40:e3:d6:da:c0:21,104711550,368,16000,104711182,104711550
15595,6,12,1,2412,-87,-91,4,40:e3:d6:da:c0:22,104711956,176,230,104711780,104711956
15596,6,6,1,2412,-68,-91,23,e6:aa:ea:c9:ea:33,104714198,408,1834,104713790,104714198
15597,4,1,1,2412,-77,-91,14,b8:3a:5a:88:e6:e0,104723771,2360,7213,104721411,104723771
15598,6,6,1,2412,-68,-91,23,e6:aa:ea:c9:ea:33,104726350,408,2171,104725942,104726350
15599,6,6,1,2412,-68,-91,23,e6:aa:ea:c9:ea:33,104738476,408,11718,104738068,104738476
15600,6,12,1,2412,-67,-91,24,40:e3:d6:da:ba:20,104739677,160,1041,104739517,104739677
15601,6,6,1,2412,-66,-91,25,40:e3:d6:da:ba:21,104739896,368,-149,104739528,104739896
15602,6,12,1,2412,-66,-91,25,40:e3:d6:da:ba:22,104740283,180,207,104740103,104740283
15603,6,12,1,2412,-66,-91,25,40:e3:d6:da:ba:23,104740531,184,64,104740347,104740531
15604,6,12,1,2412,-66,-91,25,40:e3:d6:da:ba:24,104740741,176,34,104740565,104740741
15605,6,12,1,2412,-66,-91,25,40:e3:d6:da:ba:25,104740952,160,51,104740792,104740952
15606,6,6,1,2412,-67,-91,24,40:e3:d6:da:ba:26,104741153,380,-179,104740773,104741153
15607,6,6,1,2412,-69,-91,22,e6:aa:ea:c9:ea:33,104762669,408,21108,104762261,104762669
15608,4,1,1,2412,-91,-91,0,c0:c9:e3:4d:6e:bf,104767653,872,4112,104766781,104767653
15609,4,1,1,2412,-84,-91,7,54:e4:3a:ec:fb:64,104797581,2160,27768,104795421,104797581
15610,6,6,1,2412,-84,-91,7,40:e3:d6:da:c0:26,104815178,380,17217,104814798,104815178
15611,4,1,1,2412,-78,-91,13,b8:3a:5a:88:e6:e0,104825845,2360,8307,104823485,104825845
15612,4,1,1,2412,-80,-91,11,b8:3a:5a:88:e6:e1,104828304,2376,83,104825928,104828304
15613,6,12,1,2412,-67,-91,24,40:e3:d6:da:ba:20,104842088,160,13624,104841928,104842088
15614,6,6,1,2412,-67,-91,24,40:e3:d6:da:ba:21,104842280,368,-176,104841912,104842280
15615,6,12,1,2412,-67,-91,24,40:e3:d6:da:ba:22,104842667,180,207,104842487,104842667
15616,6,12,1,2412,-67,-91,24,40:e3:d6:da:ba:23,104842891,184,40,104842707,104842891
15617,6,12,1,2412,-67,-91,24,40:e3:d6:da:ba:24,104843100,176,33,104842924,104843100
15618,6,12,1,2412,-67,-91,24,40:e3:d6:da:ba:25,104843310,160,50,104843150,104843310
15619,6,6,1,2412,-67,-91,24,40:e3:d6:da:ba:26,104843502,380,-188,104843122,104843502
15620,4,1,1,2412,-79,-91,12,b8:3a:5a:88:e6:e0,104928246,2360,82384,104925886,104928246
15621,4,1,1,2412,-78,-91,13,b8:3a:5a:88:e6:e1,104930643,2376,21,104928267,104930643
15622,6,6,1,2412,-79,-91,12,e6:aa:ea:b7:4a:dd,104942341,408,11290,104941933,104942341
15623,6,12,1,2412,-66,-91,25,40:e3:d6:da:ba:20,104944492,160,1991,104944332,104944492
15624,6,6,1,2412,-66,-91,25,40:e3:d6:da:ba:21,104944702,368,-158,104944334,104944702
15625,6,12,1,2412,-66,-91,25,40:e3:d6:da:ba:22,104945107,180,225,104944927,104945107
15626,6,12,1,2412,-66,-91,25,40:e3:d6:da:ba:23,104945330,184,39,104945146,104945330
15627,6,12,1,2412,-66,-91,25,40:e3:d6:da:ba:24,104945567,176,61,104945391,104945567
15628,6,12,1,2412,-66,-91,25,40:e3:d6:da:ba:25,104945777,160,50,104945617,104945777
15629,6,6,1,2412,-66,-91,25,40:e3:d6:da:ba:26,104945987,380,-170,104945607,104945987
15630,6,6,1,2412,-79,-91,12,e6:aa:ea:b7:4a:dd,104966577,408,20182,104966169,104966577
15631,6,6,1,2412,-78,-91,13,e6:aa:ea:b7:4a:dd,104978697,408,11712,104978289,104978697
15632,4,1,1,2412,-89,-91,2,a6:e5:7c:28:b1:d3,104990154,992,10465,104989162,104990154
15633,4,1,1,2412,-79,-91,12,54:e4:3a:ec:fb:64,105002378,2160,10064,105000218,105002378
15634,4,1,1,2412,-76,-91,15,b8:3a:5a:88:e6:e0,105030645,2360,25907,105028285,105030645
15635,6,12,1,2412,-70,-91,21,40:e3:d6:da:ba:20,105046870,160,16065,105046710,105046870
15636,6,12,1,2412,-71,-91,20,40:e3:d6:da:ba:24,105047927,176,881,105047751,105047927
15637,6,12,1,2412,-67,-91,24,40:e3:d6:da:ba:25,105048146,160,59,105047986,105048146
15638,6,6,1,2412,-67,-91,24,40:e3:d6:da:ba:26,105048365,380,-161,105047985,105048365
15639,4,1,1,2412,-93,-91,-2,a6:e5:7c:28:b1:d3,105092288,992,42931,105091296,105092288
15640,4,1,1,2412,-58,-91,33,54:e4:3a:ec:fb:64,105104778,2160,10330,105102618,105104778
15641,6,12,1,2412,-67,-91,24,40:e3:d6:da:ba:20,105149282,160,44344,105149122,105149282
15642,6,6,1,2412,-67,-91,24,40:e3:d6:da:ba:21,105149483,368,-167,105149115,105149483
15643,6,12,1,2412,-66,-91,25,40:e3:d6:da:ba:22,105149870,180,207,105149690,105149870
15644,6,12,1,2412,-66,-91,25,40:e3:d6:da:ba:23,105150085,184,31,105149901,105150085
15645,6,12,1,2412,-67,-91,24,40:e3:d6:da:ba:24,105150312,176,51,105150136,105150312
15646,6,12,1,2412,-67,-91,24,40:e3:d6:da:ba:25,105150523,160,51,105150363,105150523
15647,6,6,1,2412,-66,-91,25,40:e3:d6:da:ba:26,105150742,380,-161,105150362,105150742
15648,6,6,1,2412,-70,-91,21,e6:aa:ea:c9:ea:33,105234461,408,83311,105234053,105234461
15649,6,6,1,2412,-70,-91,21,e6:aa:ea:c9:ea:33,105246587,408,11718,105246179,105246587
15650,6,12,1,2412,-64,-91,27,40:e3:d6:da:ba:20,105252001,160,5254,105251841,105252001
15651,6,6,1,2412,-64,-91,27,40:e3:d6:da:ba:21,105252192,368,-177,105251824,105252192
15652,6,12,1,2412,-64,-91,27,40:e3:d6:da:ba:22,105252588,180,216,105252408,105252588
15653,6,12,1,2412,-64,-91,27,40:e3:d6:da:ba:23,105252794,184,22,105252610,105252794
15654,6,12,1,2412,-64,-91,27,40:e3:d6:da:ba:24,105253012,176,42,105252836,105253012
15655,6,12,1,2412,-64,-91,27,40:e3:d6:da:ba:25,105253232,160,60,105253072,105253232
15656,6,6,1,2412,-64,-91,27,40:e3:d6:da:ba:26,105253433,380,-179,105253053,105253433
15657,6,6,1,2412,-70,-91,21,e6:aa:ea:c9:ea:33,105270995,408,17154,105270587,105270995
15658,4,1,1,2412,-81,-91,10,54:e4:3a:ec:fb:64,105309576,2160,36421,105307416,105309576
15659,4,1,1,2412,-71,-91,20,9e:dc:b8:1e:26:16,105312157,1128,1453,105311029,105312157
15660,4,1,1,2412,-80,-91,11,54:e4:3a:ec:fb:64,105313598,2112,-671,105311486,105313598
15661,4,1,1,2412,-72,-91,19,,105315722,304,1820,105315418,105315722
15662,6,12,1,2412,-70,-91,21,,105316038,32,284,105316006,105316038
15663,6,6,1,2412,-70,-91,21,,105316444,44,362,105316400,105316444
15664,6,12,1,2412,-69,-91,22,,105317260,32,784,105317228,105317260
15665,6,12,1,2412,-69,-91,22,,105317620,32,328,105317588,105317620
15666,6,12,1,2412,-87,-91,4,40:e3:d6:da:c0:24,105326801,172,9009,105326629,105326801
15667,4,1,1,2412,-72,-91,19,,105337034,304,9929,105336730,105337034
15668,6,12,1,2412,-62,-91,29,40:e3:d6:da:ba:20,105337197,136,27,105337061,105337197
15669,6,12,1,2412,-70,-91,21,,105337350,32,121,105337318,105337350
15670,6,6,1,2412,-64,-91,27,40:e3:d6:da:ba:21,105337384,348,-314,105337036,105337384
15671,6,12,1,2412,-62,-91,29,40:e3:d6:da:ba:22,105337778,156,238,105337622,105337778
15672,6,12,1,2412,-62,-91,29,40:e3:d6:da:ba:25,105338176,136,262,105338040,105338176
15673,6,12,1,2412,-70,-91,21,,105338329,32,121,105338297,105338329
15674,4,1,1,2412,-79,-91,12,b8:3a:5a:88:e6:e0,105338560,2360,-2129,105336200,105338560
15675,6,12,1,2412,-85,-91,6,40:e3:d6:da:c0:22,105428727,176,89991,105428551,105428727
15676,6,12,1,2412,-86,-91,5,40:e3:d6:da:c0:23,105428937,180,30,105428757,105428937
15677,6,6,1,2412,-85,-91,6,40:e3:d6:da:c0:26,105429555,380,238,105429175,105429555
15678,4,1,1,2412,-79,-91,12,b8:3a:5a:88:e6:e1,105442698,2376,10767,105440322,105442698
15679,6,6,1,2412,-80,-91,11,e6:aa:ea:b7:4a:dd,105450089,408,6983,105449681,105450089
15680,6,12,1,2412,-86,-91,5,40:e3:d6:da:c0:23,105453226,156,2981,105453070,105453226
15681,6,12,1,2412,-62,-91,29,40:e3:d6:da:ba:20,105456472,160,3086,105456312,105456472
15682,6,12,1,2412,-62,-91,29,40:e3:d6:da:ba:22,105457095,180,443,105456915,105457095
15683,6,12,1,2412,-62,-91,29,40:e3:d6:da:ba:23,105457328,184,49,105457144,105457328
15684,6,12,1,2412,-62,-91,29,40:e3:d6:da:ba:24,105457565,176,61,105457389,105457565
15685,6,12,1,2412,-62,-91,29,40:e3:d6:da:ba:25,105457766,160,41,105457606,105457766
15686,6,6,1,2412,-62,-91,29,40:e3:d6:da:ba:26,105457958,380,-188,105457578,105457958
15687,6,6,1,2412,-79,-91,12,e6:aa:ea:b7:4a:dd,105474328,408,15962,105473920,105474328
15688,6,6,1,2412,-80,-91,11,e6:aa:ea:b7:4a:dd,105498562,408,23826,105498154,105498562
15689,4,1,1,2412,-83,-91,8,54:e4:3a:ec:fb:64,105514374,2160,13652,105512214,105514374
15690,6,12,1,2412,-86,-91,5,40:e3:d6:da:c0:20,105530633,156,16103,105530477,105530633
15691,6,6,1,2412,-86,-91,5,40:e3:d6:da:c0:21,105530839,368,-162,105530471,105530839
15692,6,12,1,2412,-86,-91,5,40:e3:d6:da:c0:23,105531464,180,445,105531284,105531464
15693,6,12,1,2412,-86,-91,5,40:e3:d6:da:c0:24,105531696,172,60,105531524,105531696
15694,6,12,1,2412,-86,-91,5,40:e3:d6:da:c0:25,105532331,156,479,105532175,105532331
15695,4,1,1,2412,-78,-91,13,b8:3a:5a:88:e6:e0,105542664,2360,7973,105540304,105542664
15696,6,12,1,2412,-62,-91,29,40:e3:d6:da:ba:20,105558884,160,16060,105558724,105558884
15697,6,6,1,2412,-62,-91,29,40:e3:d6:da:ba:21,105559085,368,-167,105558717,105559085
15698,6,12,1,2412,-62,-91,29,40:e3:d6:da:ba:22,105559481,180,216,105559301,105559481
15699,6,12,1,2412,-62,-91,29,40:e3:d6:da:ba:23,105559704,184,39,105559520,105559704
15700,6,12,1,2412,-62,-91,29,40:e3:d6:da:ba:24,105559923,176,43,105559747,105559923
15701,6,12,1,2412,-62,-91,29,40:e3:d6:da:ba:25,105560142,160,59,105559982,105560142
15702,6,6,1,2412,-62,-91,29,40:e3:d6:da:ba:26,105560361,380,-161,105559981,105560361
15703,6,6,1,2412,-85,-91,6,40:e3:d6:da:c0:21,105633161,368,72432,105632793,105633161
15704,6,12,1,2412,-85,-91,6,40:e3:d6:da:c0:22,105633566,176,229,105633390,105633566
15705,6,12,1,2412,-61,-91,30,40:e3:d6:da:ba:23,105651489,156,17767,105651333,105651489
15706,4,1,1,2412,-72,-91,19,96:f5:b5:1d:e8:82,105653264,1128,647,105652136,105653264
15707,4,1,1,2412,-82,-91,9,54:e4:3a:ec:fb:64,105654507,2112,-869,105652395,105654507
15708,4,1,1,2412,-75,-91,16,,105656631,304,1820,105656327,105656631
15709,6,12,1,2412,-63,-91,28,40:e3:d6:da:ba:20,105656795,136,28,105656659,105656795
15710,6,12,1,2412,-71,-91,20,,105656947,32,120,105656915,105656947
15711,6,6,1,2412,-62,-91,29,40:e3:d6:da:ba:21,105657021,348,-274,105656673,105657021
15712,6,6,1,2412,-71,-91,20,,105657386,44,321,105657342,105657386
15713,6,12,1,2412,-62,-91,29,40:e3:d6:da:ba:22,105657477,156,-65,105657321,105657477
15714,6,12,1,2412,-72,-91,19,,105657649,32,140,105657617,105657649
15715,6,12,1,2412,-62,-91,29,40:e3:d6:da:ba:23,105657725,156,-80,105657569,105657725
15716,6,12,1,2412,-72,-91,19,,105657898,32,141,105657866,105657898
15717,6,12,1,2412,-62,-91,29,40:e3:d6:da:ba:25,105657974,136,-60,105657838,105657974
15718,6,12,1,2412,-73,-91,18,,105658127,32,121,105658095,105658127
15719,6,12,1,2412,-62,-91,29,40:e3:d6:da:ba:20,105661457,160,3170,105661297,105661457
15720,6,6,1,2412,-62,-91,29,40:e3:d6:da:ba:21,105661676,368,-149,105661308,105661676
15721,6,12,1,2412,-62,-91,29,40:e3:d6:da:ba:22,105662081,180,225,105661901,105662081
15722,6,12,1,2412,-62,-91,29,40:e3:d6:da:ba:23,105662314,184,49,105662130,105662314
15723,6,12,1,2412,-62,-91,29,40:e3:d6:da:ba:24,105662532,176,42,105662356,105662532
15724,6,12,1,2412,-62,-91,29,40:e3:d6:da:ba:25,105662743,160,51,105662583,105662743
15725,6,6,1,2412,-62,-91,29,40:e3:d6:da:ba:26,105662953,380,-170,105662573,105662953
15726,4,1,1,2412,-76,-91,15,8a:71:4c:c7:db:61,105670264,1360,5951,105668904,105670264
15727,6,6,1,2412,-87,-91,4,40:e3:d6:da:c0:21,105735542,368,64910,105735174,105735542
15728,6,12,1,2412,-87,-91,4,40:e3:d6:da:c0:25,105736596,156,898,105736440,105736596
15729,6,6,1,2412,-84,-91,7,40:e3:d6:da:c0:26,105736793,380,-183,105736413,105736793
15730,4,1,1,2412,-91,-91,0,c0:c9:e3:4d:6e:bf,105744295,872,6630,105743423,105744295
15731,4,1,1,2412,-77,-91,14,b8:3a:5a:88:e6:e0,105747446,2360,791,105745086,105747446
15732,4,1,1,2412,-77,-91,14,b8:3a:5a:88:e6:e1,105749844,2376,22,105747468,105749844
15733,6,6,1,2412,-70,-91,21,e6:aa:ea:c9:ea:33,105754383,408,4131,105753975,105754383
15734,6,12,1,2412,-63,-91,28,40:e3:d6:da:ba:20,105763673,160,9130,105763513,105763673
15735,6,6,1,2412,-62,-91,29,40:e3:d6:da:ba:21,105763864,368,-177,105763496,105763864
15736,6,12,1,2412,-63,-91,28,40:e3:d6:da:ba:22,105764270,180,226,105764090,105764270
15737,6,12,1,2412,-63,-91,28,40:e3:d6:da:ba:23,105764493,184,39,105764309,105764493
15738,6,12,1,2412,-63,-91,28,40:e3:d6:da:ba:24,105764721,176,52,105764545,105764721
15739,6,12,1,2412,-62,-91,29,40:e3:d6:da:ba:25,105764940,160,59,105764780,105764940
15740,6,6,1,2412,-63,-91,28,40:e3:d6:da:ba:26,105765150,380,-170,105764770,105765150
15741,6,6,1,2412,-70,-91,21,e6:aa:ea:c9:ea:33,105766248,408,690,105765840,105766248
15742,6,6,1,2412,-70,-91,21,e6:aa:ea:c9:ea:33,105778351,408,11695,105777943,105778351
15743,4,1,1,2412,-91,-91,0,c0:c9:e3:4d:6e:bf,105788902,872,9679,105788030,105788902
15744,6,6,1,2412,-70,-91,21,e6:aa:ea:c9:ea:33,105790475,408,1165,105790067,105790475
15745,6,6,1,2412,-69,-91,22,e6:aa:ea:c9:ea:33,105802588,408,11705,105802180,105802588
15746,4,1,1,2412,-76,-91,15,b8:3a:5a:88:e6:e0,105849873,2360,44925,105847513,105849873
15747,4,1,1,2412,-76,-91,15,b8:3a:5a:88:e6:e1,105852280,2376,31,105849904,105852280
15748,6,12,1,2412,-63,-91,28,40:e3:d6:da:ba:20,105866079,160,13639,105865919,105866079
15749,6,6,1,2412,-63,-91,28,40:e3:d6:da:ba:21,105866280,368,-167,105865912,105866280
15750,6,12,1,2412,-63,-91,28,40:e3:d6:da:ba:22,105866685,180,225,105866505,105866685
15751,6,12,1,2412,-63,-91,28,40:e3:d6:da:ba:23,105866909,184,40,105866725,105866909
15752,6,12,1,2412,-63,-91,28,40:e3:d6:da:ba:24,105867145,176,60,105866969,105867145
15753,6,12,1,2412,-63,-91,28,40:e3:d6:da:ba:25,105867356,160,51,105867196,105867356
15754,6,12,1,2412,-63,-91,28,40:e3:d6:da:ba:20,105886259,136,18767,105886123,105886259
15755,6,6,1,2412,-63,-91,28,40:e3:d6:da:ba:21,105886454,348,-153,105886106,105886454
15756,6,12,1,2412,-63,-91,28,40:e3:d6:da:ba:22,105886830,156,220,105886674,105886830
15757,6,12,1,2412,-63,-91,28,40:e3:d6:da:ba:23,105887038,156,52,105886882,105887038
15758,6,12,1,2412,-63,-91,28,40:e3:d6:da:ba:25,105887229,136,55,105887093,105887229
15759,6,6,1,2412,-79,-91,12,e6:aa:ea:b7:4a:dd,105891728,408,4091,105891320,105891728
15760,6,6,1,2412,-79,-91,12,e6:aa:ea:b7:4a:dd,105903872,408,11736,105903464,105903872
15761,6,6,1,2412,-78,-91,13,e6:aa:ea:b7:4a:dd,105916010,408,11730,105915602,105916010
15762,4,1,1,2412,-70,-91,21,1e:75:6e:7b:10:6a,105923579,1360,6209,105922219,105923579
15763,6,12,1,2412,-63,-91,28,40:e3:d6:da:ba:20,105924798,136,1083,105924662,105924798
15764,6,6,1,2412,-63,-91,28,40:e3:d6:da:ba:21,105925002,348,-144,105924654,105925002
15765,4,1,1,2412,-71,-91,20,f2:c1:ed:2f:0d:04,105925545,1208,-665,105924337,105925545
15766,6,12,1,2412,-63,-91,28,40:e3:d6:da:ba:23,105927760,156,2059,105927604,105927760
15767,6,12,1,2412,-63,-91,28,40:e3:d6:da:ba:25,105927968,136,72,105927832,105927968
15768,6,12,1,2412,-63,-91,28,40:e3:d6:da:ba:23,105928166,156,42,105928010,105928166
15769,6,6,1,2412,-85,-91,6,40:e3:d6:da:c0:21,105940330,368,11796,105939962,105940330
15770,6,12,1,2412,-85,-91,6,40:e3:d6:da:c0:25,105941375,156,889,105941219,105941375
15771,6,6,1,2412,-85,-91,6,40:e3:d6:da:c0:26,105941581,380,-174,105941201,105941581
15772,6,12,1,2412,-63,-91,28,40:e3:d6:da:ba:23,105949197,156,7460,105949041,105949197
15773,6,12,1,2412,-64,-91,27,40:e3:d6:da:ba:20,105968496,160,19139,105968336,105968496
15774,6,6,1,2412,-63,-91,28,40:e3:d6:da:ba:21,105968715,368,-149,105968347,105968715
15775,6,12,1,2412,-63,-91,28,40:e3:d6:da:ba:22,105969129,180,234,105968949,105969129
15776,6,12,1,2412,-63,-91,28,40:e3:d6:da:ba:23,105969378,184,65,105969194,105969378
15777,6,12,1,2412,-64,-91,27,40:e3:d6:da:ba:24,105969587,176,33,105969411,105969587
15778,6,12,1,2412,-63,-91,28,40:e3:d6:da:ba:25,105969806,160,59,105969646,105969806
15779,6,6,1,2412,-63,-91,28,40:e3:d6:da:ba:26,105970007,380,-179,105969627,105970007
15780,4,1,1,2412,-82,-91,9,54:e4:3a:ec:fb:64,106026370,2160,54203,106024210,106026370
15781,6,12,1,2412,-87,-91,4,40:e3:d6:da:c0:20,106032343,136,5837,106032207,106032343
15782,6,6,1,2412,-86,-91,5,40:e3:d6:da:c0:21,106032695,348,4,106032347,106032695
15783,6,12,1,2412,-87,-91,4,40:e3:d6:da:c0:23,106034687,156,1836,106034531,106034687
15784,6,12,1,2412,-87,-91,4,40:e3:d6:da:c0:25,106034878,136,55,106034742,106034878
15785,6,12,1,2412,-85,-91,6,40:e3:d6:da:c0:25,106043765,156,8731,106043609,106043765
15786,6,6,1,2412,-87,-91,4,40:e3:d6:da:c0:26,106043962,380,-183,106043582,106043962
15787,4,1,1,2412,-75,-91,16,b8:3a:5a:88:e6:e0,106054667,2360,8345,106052307,106054667
15788,4,1,1,2412,-76,-91,15,b8:3a:5a:88:e6:e1,106057074,2376,31,106054698,106057074
15789,6,12,1,2412,-64,-91,27,40:e3:d6:da:ba:20,106070893,160,13659,106070733,106070893
15790,6,6,1,2412,-64,-91,27,40:e3:d6:da:ba:21,106071103,368,-158,106070735,106071103
15791,6,12,1,2412,-64,-91,27,40:e3:d6:da:ba:22,106071508,180,225,106071328,106071508
15792,6,12,1,2412,-64,-91,27,40:e3:d6:da:ba:23,106071740,184,48,106071556,106071740
15793,6,12,1,2412,-64,-91,27,40:e3:d6:da:ba:24,106071977,176,61,106071801,106071977
15794,6,12,1,2412,-64,-91,27,40:e3:d6:da:ba:25,106072205,160,68,106072045,106072205
15795,6,6,1,2412,-64,-91,27,40:e3:d6:da:ba:26,106072397,380,-188,106072017,106072397
15796,4,1,1,2412,-75,-91,16,b8:3a:5a:88:e6:e0,106084944,2240,10307,106082704,106084944
15797,4,1,1,2412,-76,-91,15,b8:3a:5a:88:e6:e1,106087222,2256,22,106084966,106087222
15798,6,6,1,2412,-86,-91,5,40:e3:d6:da:c0:21,106089353,348,1783,106089005,106089353
15799,6,12,1,2412,-88,-91,3,40:e3:d6:da:c0:22,106089738,156,229,106089582,106089738
15800,6,12,1,2412,-87,-91,4,40:e3:d6:da:c0:23,106089929,156,35,106089773,106089929
15801,6,12,1,2412,-89,-91,2,40:e3:d6:da:c0:25,106090880,136,815,106090744,106090880
15802,6,12,1,2412,-86,-91,5,40:e3:d6:da:c0:20,106116740,136,25724,106116604,106116740
15803,6,6,1,2412,-87,-91,4,40:e3:d6:da:c0:21,106116944,348,-144,106116596,106116944
15804,6,12,1,2412,-85,-91,6,40:e3:d6:da:c0:22,106117347,156,247,106117191,106117347
15805,6,12,1,2412,-86,-91,5,40:e3:d6:da:c0:23,106117600,156,97,106117444,106117600
15806,6,12,1,2412,-85,-91,6,40:e3:d6:da:c0:25,106117825,136,89,106117689,106117825
15807,4,1,1,2412,-81,-91,10,54:e4:3a:ec:fb:64,106128769,2160,8784,106126609,106128769
15808,6,12,1,2412,-85,-91,6,40:e3:d6:da:c0:25,106146259,156,17334,106146103,106146259
15809,6,6,1,2412,-86,-91,5,40:e3:d6:da:c0:26,106146474,380,-165,106146094,106146474
15810,6,12,1,2412,-64,-91,27,40:e3:d6:da:ba:20,106173275,160,26641,106173115,106173275
15811,6,6,1,2412,-65,-91,26,40:e3:d6:da:ba:21,106173494,368,-149,106173126,106173494
15812,6,12,1,2412,-64,-91,27,40:e3:d6:da:ba:22,106173908,180,234,106173728,106173908
15813,6,12,1,2412,-64,-91,27,40:e3:d6:da:ba:23,106174131,184,39,106173947,106174131
15814,6,12,1,2412,-64,-91,27,40:e3:d6:da:ba:24,106174368,176,61,106174192,106174368
15815,6,12,1,2412,-64,-91,27,40:e3:d6:da:ba:25,106174578,160,50,106174418,106174578
15816,6,6,1,2412,-64,-91,27,40:e3:d6:da:ba:26,106174788,380,-170,106174408,106174788
15817,6,6,1,2412,-81,-91,10,84:1b:5e:df:1b:99,106178171,80,3303,106178091,106178171
15818,6,6,1,2412,-78,-91,13,e6:aa:ea:b7:4a:dd,106183995,408,5416,106183587,106183995
15819,6,6,1,2412,-78,-91,13,e6:aa:ea:b7:4a:dd,106196282,408,11879,106195874,106196282
15820,6,6,1,2412,-78,-91,13,e6:aa:ea:b7:4a:dd,106220343,408,23653,106219935,106220343
15821,4,1,1,2412,-81,-91,10,54:e4:3a:ec:fb:64,106231167,2160,8664,106229007,106231167
15822,4,1,1,2412,-91,-91,0,c0:c9:e3:4d:6e:bf,106237186,872,5147,106236314,106237186
15823,6,12,1,2412,-85,-91,6,40:e3:d6:da:c0:20,106247345,156,10003,106247189,106247345
15824,6,6,1,2412,-86,-91,5,40:e3:d6:da:c0:21,106247542,368,-171,106247174,106247542
15825,6,12,1,2412,-87,-91,4,40:e3:d6:da:c0:23,106248149,180,427,106247969,106248149
15826,6,12,1,2412,-87,-91,4,40:e3:d6:da:c0:25,106248587,156,282,106248431,106248587
15827,6,6,1,2412,-64,-91,27,40:e3:d6:da:ba:21,106275993,368,27038,106275625,106275993
15828,6,12,1,2412,-63,-91,28,40:e3:d6:da:ba:22,106276407,180,234,106276227,106276407
15829,6,12,1,2412,-64,-91,27,40:e3:d6:da:ba:23,106276631,184,40,106276447,106276631
15830,6,12,1,2412,-63,-91,28,40:e3:d6:da:ba:24,106276858,176,51,106276682,106276858
15831,6,12,1,2412,-64,-91,27,40:e3:d6:da:ba:25,106277060,160,42,106276900,106277060
15832,6,6,1,2412,-64,-91,27,40:e3:d6:da:ba:26,106277270,380,-170,106276890,106277270
15833,6,6,1,2412,-71,-91,20,e6:aa:ea:c9:ea:33,106286898,408,9220,106286490,106286898
15834,6,6,1,2412,-71,-91,20,e6:aa:ea:c9:ea:33,106311127,408,23821,106310719,106311127
15835,6,6,1,2412,-71,-91,20,e6:aa:ea:c9:ea:33,106323242,408,11707,106322834,106323242
15836,4,1,1,2412,-91,-91,0,ba:f3:ae:c6:5a:17,106344037,1152,19643,106342885,106344037
15837,6,12,1,2412,-64,-91,27,40:e3:d6:da:ba:20,106345166,136,993,106345030,106345166
15838,6,6,1,2412,-63,-91,28,40:e3:d6:da:ba:21,106345369,348,-145,106345021,106345369
15839,6,12,1,2412,-63,-91,28,40:e3:d6:da:ba:22,106345754,156,229,106345598,106345754
15840,6,12,1,2412,-63,-91,28,40:e3:d6:da:ba:23,106345954,156,44,106345798,106345954
15841,6,12,1,2412,-64,-91,27,40:e3:d6:da:ba:25,106346162,136,72,106346026,106346162
15842,6,12,1,2412,-87,-91,4,40:e3:d6:da:c0:20,106349758,156,3440,106349602,106349758
15843,6,6,1,2412,-86,-91,5,40:e3:d6:da:c0:21,106349955,368,-171,106349587,106349955
15844,6,12,1,2412,-86,-91,5,40:e3:d6:da:c0:22,106350360,176,229,106350184,106350360
15845,6,12,1,2412,-87,-91,4,40:e3:d6:da:c0:25,106351009,156,493,106350853,106351009
15846,6,6,1,2412,-86,-91,5,40:e3:d6:da:c0:26,106351253,380,-136,106350873,106351253
15847,6,6,1,2412,-63,-91,28,40:e3:d6:da:ba:21,106378305,368,26684,106377937,106378305
15848,6,12,1,2412,-63,-91,28,40:e3:d6:da:ba:23,106378916,184,427,106378732,106378916
15849,6,12,1,2412,-63,-91,28,40:e3:d6:da:ba:24,106379152,176,60,106378976,106379152
15850,6,12,1,2412,-63,-91,28,40:e3:d6:da:ba:25,106379363,160,51,106379203,106379363
15851,6,6,1,2412,-63,-91,28,40:e3:d6:da:ba:26,106379582,380,-161,106379202,106379582
15852,6,12,1,2412,-87,-91,4,40:e3:d6:da:c0:23,106443199,156,63461,106443043,106443199
15853,6,6,1,2412,-85,-91,6,40:e3:d6:da:c0:21,106452321,368,8754,106451953,106452321
15854,4,1,1,2412,-79,-91,12,b8:3a:5a:88:e6:e0,106464266,2360,9585,106461906,106464266
15855,4,1,1,2412,-79,-91,12,b8:3a:5a:88:e6:e1,106466672,2376,30,106464296,106466672
15856,6,12,1,2412,-63,-91,28,40:e3:d6:da:ba:20,106480476,160,13644,106480316,106480476
15857,6,6,1,2412,-63,-91,28,40:e3:d6:da:ba:21,106480677,368,-167,106480309,106480677
15858,6,12,1,2412,-63,-91,28,40:e3:d6:da:ba:22,106481082,180,225,106480902,106481082
15859,6,12,1,2412,-63,-91,28,40:e3:d6:da:ba:23,106481306,184,40,106481122,106481306
15860,6,12,1,2412,-63,-91,28,40:e3:d6:da:ba:24,106481524,176,42,106481348,106481524
15861,6,12,1,2412,-63,-91,28,40:e3:d6:da:ba:25,106481726,160,42,106481566,106481726
15862,6,6,1,2412,-63,-91,28,40:e3:d6:da:ba:26,106481926,380,-180,106481546,106481926
15863,4,1,1,2412,-80,-91,11,54:e4:3a:ec:fb:64,106538364,2160,54278,106536204,106538364
15864,6,12,1,2412,-86,-91,5,40:e3:d6:da:c0:20,106554549,156,16029,106554393,106554549
15865,6,6,1,2412,-86,-91,5,40:e3:d6:da:c0:21,106554755,368,-162,106554387,106554755
15866,4,1,1,2412,-80,-91,11,b8:3a:5a:88:e6:e0,106566649,2360,9534,106564289,106566649
15867,6,12,1,2412,-63,-91,28,40:e3:d6:da:ba:20,106582897,160,16088,106582737,106582897
15868,6,6,1,2412,-63,-91,28,40:e3:d6:da:ba:21,106583089,368,-176,106582721,106583089
15869,6,12,1,2412,-63,-91,28,40:e3:d6:da:ba:22,106583485,180,216,106583305,106583485
15870,6,12,1,2412,-63,-91,28,40:e3:d6:da:ba:23,106583691,184,22,106583507,106583691
15871,6,12,1,2412,-63,-91,28,40:e3:d6:da:ba:24,106583900,176,33,106583724,106583900
15872,6,12,1,2412,-63,-91,28,40:e3:d6:da:ba:25,106584111,160,51,106583951,106584111
15873,6,6,1,2412,-63,-91,28,40:e3:d6:da:ba:26,106584303,380,-188,106583923,106584303
15874,6,12,1,2412,-87,-91,4,40:e3:d6:da:c0:23,106586080,156,1621,106585924,106586080
15875,6,6,1,2412,-78,-91,13,e6:aa:ea:b7:4a:dd,106601038,408,14550,106600630,106601038
15876,6,6,1,2412,-77,-91,14,e6:aa:ea:b7:4a:dd,106613115,408,11669,106612707,106613115
15877,6,6,1,2412,-77,-91,14,e6:aa:ea:b7:4a:dd,106625276,408,11753,106624868,106625276
15878,6,6,1,2412,-77,-91,14,e6:aa:ea:b7:4a:dd,106649459,408,23775,106649051,106649459
15879,6,12,1,2412,-87,-91,4,40:e3:d6:da:c0:20,106656948,156,7333,106656792,106656948
15880,6,6,1,2412,-87,-91,4,40:e3:d6:da:c0:21,106657136,368,-180,106656768,106657136
15881,6,12,1,2412,-87,-91,4,40:e3:d6:da:c0:22,106657550,176,238,106657374,106657550
15882,6,12,1,2412,-87,-91,4,40:e3:d6:da:c0:23,106657751,180,21,106657571,106657751
15883,6,12,1,2412,-86,-91,5,40:e3:d6:da:c0:24,106657984,172,61,106657812,106657984
15884,6,12,1,2412,-86,-91,5,40:e3:d6:da:c0:25,106658208,156,68,106658052,106658208
15885,6,6,1,2412,-86,-91,5,40:e3:d6:da:c0:26,106658423,380,-165,106658043,106658423
15886,4,1,1,2412,-78,-91,13,24:f6:77:10:02:c8,106659405,1064,-82,106658341,106659405
15887,4,1,1,2412,-78,-91,13,24:f6:77:10:02:c8,106664468,1064,3999,106663404,106664468
15888,6,12,1,2412,-64,-91,27,40:e3:d6:da:ba:20,106685289,160,20661,106685129,106685289
15889,6,6,1,2412,-63,-91,28,40:e3:d6:da:ba:21,106685508,368,-149,106685140,106685508
15890,6,12,1,2412,-63,-91,28,40:e3:d6:da:ba:22,106685904,180,216,106685724,106685904
15891,6,12,1,2412,-63,-91,28,40:e3:d6:da:ba:24,106686346,176,266,106686170,106686346
15892,6,12,1,2412,-64,-91,27,40:e3:d6:da:ba:25,106686574,160,68,106686414,106686574
15893,6,6,1,2412,-63,-91,28,40:e3:d6:da:ba:26,106686775,380,-179,106686395,106686775
15894,6,6,1,2412,-72,-91,19,e6:aa:ea:c9:ea:33,106693128,408,5945,106692720,106693128
15895,6,6,1,2412,-72,-91,19,e6:aa:ea:c9:ea:33,106705062,408,11526,106704654,106705062
15896,6,6,1,2412,-72,-91,19,e6:aa:ea:c9:ea:33,106717231,408,11761,106716823,106717231
15897,6,6,1,2412,-72,-91,19,e6:aa:ea:c9:ea:33,106729292,408,11653,106728884,106729292
15898,6,6,1,2412,-72,-91,19,e6:aa:ea:c9:ea:33,106741414,408,11714,106741006,106741414
15899,4,1,1,2412,-80,-91,11,54:e4:3a:ec:fb:64,106743164,2160,-410,106741004,106743164
15900,4,1,1,2412,-78,-91,13,24:f6:77:10:02:c8,106750241,1064,6013,106749177,106750241
15901,6,12,1,2412,-87,-91,4,40:e3:d6:da:c0:20,106759361,156,8964,106759205,106759361
15902,6,6,1,2412,-87,-91,4,40:e3:d6:da:c0:21,106759567,368,-162,106759199,106759567
15903,6,12,1,2412,-87,-91,4,40:e3:d6:da:c0:22,106759963,176,220,106759787,106759963
15904,6,12,1,2412,-86,-91,5,40:e3:d6:da:c0:24,106760406,172,271,106760234,106760406
15905,4,1,1,2412,-80,-91,11,b8:3a:5a:88:e6:e0,106775544,2360,12778,106773184,106775544
15906,4,1,1,2412,-81,-91,10,b8:3a:5a:88:e6:e1,106777951,2376,31,106775575,106777951
15907,6,12,1,2412,-64,-91,27,40:e3:d6:da:ba:20,106787689,160,9578,106787529,106787689
15908,6,6,1,2412,-64,-91,27,40:e3:d6:da:ba:21,106787908,368,-149,106787540,106787908
15909,6,12,1,2412,-63,-91,28,40:e3:d6:da:ba:22,106788304,180,216,106788124,106788304
15910,6,12,1,2412,-64,-91,27,40:e3:d6:da:ba:23,106788510,184,22,106788326,106788510
15911,6,12,1,2412,-63,-91,28,40:e3:d6:da:ba:24,106788737,176,51,106788561,106788737
15912,6,12,1,2412,-64,-91,27,40:e3:d6:da:ba:25,106788948,160,51,106788788,106788948
15913,6,6,1,2412,-64,-91,27,40:e3:d6:da:ba:26,106789149,380,-179,106788769,106789149
15914,4,1,1,2412,-71,-91,20,54:e4:3a:ec:fb:64,106846761,2160,55452,106844601,106846761
15915,6,12,1,2412,-88,-91,3,40:e3:d6:da:c0:22,106862363,176,15426,106862187,106862363
15916,6,12,1,2412,-85,-91,6,40:e3:d6:da:c0:23,106862564,180,21,106862384,106862564
15917,6,12,1,2412,-87,-91,4,40:e3:d6:da:c0:25,106863003,156,283,106862847,106863003
15918,4,1,1,2412,-82,-91,9,b8:3a:5a:88:e6:e0,106873864,2360,8501,106871504,106873864
15919,6,12,1,2412,-63,-91,28,40:e3:d6:da:ba:20,106890101,160,16077,106889941,106890101
15920,6,6,1,2412,-64,-91,27,40:e3:d6:da:ba:21,106890293,368,-176,106889925,106890293
15921,6,12,1,2412,-64,-91,27,40:e3:d6:da:ba:22,106890707,180,234,106890527,106890707
15922,6,12,1,2412,-63,-91,28,40:e3:d6:da:ba:23,106890931,184,40,106890747,106890931
15923,6,12,1,2412,-63,-91,28,40:e3:d6:da:ba:24,106891140,176,33,106890964,106891140
15924,6,12,1,2412,-63,-91,28,40:e3:d6:da:ba:25,106891360,160,60,106891200,106891360
15925,6,6,1,2412,-63,-91,28,40:e3:d6:da:ba:26,106891570,380,-170,106891190,106891570
15926,6,12,1,2412,-88,-91,3,40:e3:d6:da:c0:22,106964746,176,73000,106964570,106964746
15927,4,1,1,2412,-81,-91,10,b8:3a:5a:88:e6:e0,106976249,2360,9143,106973889,106976249
15928,6,12,1,2412,-64,-91,27,40:e3:d6:da:ba:20,106992504,160,16095,106992344,106992504
15929,6,6,1,2412,-64,-91,27,40:e3:d6:da:ba:21,106992723,368,-149,106992355,106992723
15930,6,12,1,2412,-64,-91,27,40:e3:d6:da:ba:22,106993119,180,216,106992939,106993119
15931,6,12,1,2412,-63,-91,28,40:e3:d6:da:ba:23,106993351,184,48,106993167,106993351
15932,6,12,1,2412,-63,-91,28,40:e3:d6:da:ba:24,106993561,176,34,106993385,106993561
15933,6,12,1,2412,-64,-91,27,40:e3:d6:da:ba:25,106993762,160,41,106993602,106993762
15934,6,6,1,2412,-63,-91,28,40:e3:d6:da:ba:26,106993963,380,-179,106993583,106993963
15935,4,1,1,2412,-80,-91,11,b8:3a:5a:88:e6:e0,107078670,2360,82347,107076310,107078670
15936,6,12,1,2412,-64,-91,27,40:e3:d6:da:ba:20,107094892,160,16062,107094732,107094892
15937,6,6,1,2412,-64,-91,27,40:e3:d6:da:ba:21,107095111,368,-149,107094743,107095111
15938,6,12,1,2412,-64,-91,27,40:e3:d6:da:ba:22,107095498,180,207,107095318,107095498
15939,6,12,1,2412,-64,-91,27,40:e3:d6:da:ba:23,107095713,184,31,107095529,107095713
15940,6,12,1,2412,-64,-91,27,40:e3:d6:da:ba:24,107095922,176,33,107095746,107095922
15941,6,12,1,2412,-64,-91,27,40:e3:d6:da:ba:25,107096151,160,69,107095991,107096151
15942,6,6,1,2412,-64,-91,27,40:e3:d6:da:ba:26,107096361,380,-170,107095981,107096361
15943,6,6,1,2412,-77,-91,14,e6:aa:ea:b7:4a:dd,107120996,408,24227,107120588,107120996
15944,6,6,1,2412,-77,-91,14,e6:aa:ea:b7:4a:dd,107133108,408,11704,107132700,107133108
15945,6,6,1,2412,-77,-91,14,e6:aa:ea:b7:4a:dd,107145380,408,11864,107144972,107145380
15946,6,12,1,2412,-88,-91,3,40:e3:d6:da:c0:20,107168952,156,23416,107168796,107168952
15947,6,6,1,2412,-76,-91,15,e6:aa:ea:b7:4a:dd,107169455,408,95,107169047,107169455
15948,6,12,1,2412,-65,-91,26,40:e3:d6:da:ba:20,107197285,160,27670,107197125,107197285
15949,6,6,1,2412,-64,-91,27,40:e3:d6:da:ba:21,107197477,368,-176,107197109,107197477
15950,6,12,1,2412,-64,-91,27,40:e3:d6:da:ba:22,107197873,180,216,107197693,107197873
15951,6,12,1,2412,-64,-91,27,40:e3:d6:da:ba:23,107198088,184,31,107197904,107198088
15952,6,12,1,2412,-64,-91,27,40:e3:d6:da:ba:24,107198306,176,42,107198130,107198306
15953,6,12,1,2412,-64,-91,27,40:e3:d6:da:ba:25,107198508,160,42,107198348,107198508
15954,6,6,1,2412,-64,-91,27,40:e3:d6:da:ba:26,107198726,380,-162,107198346,107198726
15955,4,1,1,2412,-91,-91,0,c0:c9:e3:4d:6e:bf,107221012,872,21414,107220140,107221012
15956,6,6,1,2412,-71,-91,20,e6:aa:ea:c9:ea:33,107225508,408,4088,107225100,107225508
15957,6,6,1,2412,-71,-91,20,e6:aa:ea:c9:ea:33,107237958,408,12042,107237550,107237958
15958,6,6,1,2412,-71,-91,20,e6:aa:ea:c9:ea:33,107249736,408,11370,107249328,107249736
15959,4,1,1,2412,-83,-91,8,54:e4:3a:ec:fb:64,107255158,2160,3262,107252998,107255158
15960,6,6,1,2412,-71,-91,20,e6:aa:ea:c9:ea:33,107262271,408,6705,107261863,107262271
15961,4,1,1,2412,-92,-91,-1,,107269279,304,6704,107268975,107269279
15962,4,1,1,2412,-78,-91,13,b8:3a:5a:88:e6:e1,107285899,2376,14244,107283523,107285899
15963,6,12,1,2412,-65,-91,26,40:e3:d6:da:ba:20,107299707,160,13648,107299547,107299707
15964,6,6,1,2412,-65,-91,26,40:e3:d6:da:ba:21,107299917,368,-158,107299549,107299917
15965,6,12,1,2412,-65,-91,26,40:e3:d6:da:ba:22,107300304,180,207,107300124,107300304
15966,6,12,1,2412,-65,-91,26,40:e3:d6:da:ba:23,107300527,184,39,107300343,107300527
15967,6,12,1,2412,-65,-91,26,40:e3:d6:da:ba:24,107300745,176,42,107300569,107300745
15968,6,12,1,2412,-65,-91,26,40:e3:d6:da:ba:25,107300965,160,60,107300805,107300965
15969,6,6,1,2412,-65,-91,26,40:e3:d6:da:ba:26,107301157,380,-188,107300777,107301157
15970,4,1,1,2412,-81,-91,10,54:e4:3a:ec:fb:64,107357558,2160,54241,107355398,107357558
15971,4,1,1,2412,-77,-91,14,b8:3a:5a:88:e6:e0,107385873,2360,25955,107383513,107385873
15972,4,1,1,2412,-91,-91,0,a4:e5:7c:28:b1:d3,107397146,688,10585,107396458,107397146
15973,6,12,1,2412,-65,-91,26,40:e3:d6:da:ba:22,107402713,180,5387,107402533,107402713
15974,6,12,1,2412,-65,-91,26,40:e3:d6:da:ba:23,107402927,184,30,107402743,107402927
15975,6,6,1,2412,-66,-91,25,40:e3:d6:da:ba:26,107403566,380,259,107403186,107403566
15976,4,1,1,2412,-78,-91,13,a6:e5:7c:28:b1:d3,107447370,992,42812,107446378,107447370
15977,6,6,1,2412,-77,-91,14,e6:aa:ea:b7:4a:dd,107448340,408,562,107447932,107448340
15978,4,1,1,2412,-82,-91,9,54:e4:3a:ec:fb:64,107459957,2160,9457,107457797,107459957
15979,6,6,1,2412,-77,-91,14,e6:aa:ea:b7:4a:dd,107462344,408,1979,107461936,107462344
15980,6,6,1,2412,-77,-91,14,e6:aa:ea:b7:4a:dd,107484694,408,21942,107484286,107484694
15981,4,1,1,2412,-76,-91,15,b8:3a:5a:88:e6:e0,107488252,2360,1198,107485892,107488252
15982,4,1,1,2412,-77,-91,14,b8:3a:5a:88:e6:e1,107490659,2376,31,107488283,107490659
15983,6,12,1,2412,-57,-91,34,40:e3:d6:da:ba:22,107505119,180,14280,107504939,107505119
15984,6,12,1,2412,-66,-91,25,40:e3:d6:da:ba:23,107505324,184,21,107505140,107505324
15985,6,6,1,2412,-67,-91,24,40:e3:d6:da:ba:26,107505963,380,259,107505583,107505963
15986,6,6,1,2412,-70,-91,21,e6:aa:ea:c9:ea:33,107528698,408,22327,107528290,107528698
15987,6,6,1,2412,-70,-91,21,e6:aa:ea:c9:ea:33,107541104,408,11998,107540696,107541104
15988,4,1,1,2412,-91,-91,0,a6:e5:7c:28:b1:d3,107549838,992,7742,107548846,107549838
15989,6,6,1,2412,-70,-91,21,e6:aa:ea:c9:ea:33,107552927,408,2681,107552519,107552927
15990,6,6,1,2412,-70,-91,21,e6:aa:ea:c9:ea:33,107565052,408,11717,107564644,107565052
15991,6,6,1,2412,-70,-91,21,e6:aa:ea:c9:ea:33,107577164,408,11704,107576756,107577164
15992,4,1,1,2412,-78,-91,13,b8:3a:5a:88:e6:e0,107590650,2360,11126,107588290,107590650
15993,4,1,1,2412,-76,-91,15,b8:3a:5a:88:e6:e1,107593039,2376,13,107590663,107593039
15994,6,12,1,2412,-67,-91,24,40:e3:d6:da:ba:20,107606898,160,13699,107606738,107606898
15995,6,6,1,2412,-67,-91,24,40:e3:d6:da:ba:21,107607090,368,-176,107606722,107607090
15996,6,12,1,2412,-67,-91,24,40:e3:d6:da:ba:22,107607477,180,207,107607297,107607477
15997,6,12,1,2412,-67,-91,24,40:e3:d6:da:ba:23,107607682,184,21,107607498,107607682
15998,6,12,1,2412,-67,-91,24,40:e3:d6:da:ba:24,107607918,176,60,107607742,107607918
15999,6,12,1,2412,-67,-91,24,40:e3:d6:da:ba:25,107608129,160,51,107607969,107608129
16000,6,6,1,2412,-67,-91,24,40:e3:d6:da:ba:26,107608321,380,-188,107607941,107608321
16001,4,1,1,2412,-88,-91,3,a6:e5:7c:28:b1:d3,107652014,992,42701,107651022,107652014
16002,4,1,1,2412,-83,-91,8,54:e4:3a:ec:fb:64,107664755,2160,10581,107662595,107664755
16003,4,1,1,2412,-78,-91,13,b8:3a:5a:88:e6:e1,107695461,2376,28330,107693085,107695461
16004,6,12,1,2412,-68,-91,23,40:e3:d6:da:ba:20,107709287,160,13666,107709127,107709287
16005,6,6,1,2412,-68,-91,23,40:e3:d6:da:ba:21,107709506,368,-149,107709138,107709506
16006,6,12,1,2412,-68,-91,23,40:e3:d6:da:ba:22,107709892,180,206,107709712,107709892
16007,6,12,1,2412,-68,-91,23,40:e3:d6:da:ba:23,107710125,184,49,107709941,107710125
16008,6,12,1,2412,-68,-91,23,40:e3:d6:da:ba:24,107710344,176,43,107710168,107710344
16009,6,12,1,2412,-67,-91,24,40:e3:d6:da:ba:25,107710545,160,41,107710385,107710545
16010,6,6,1,2412,-67,-91,24,40:e3:d6:da:ba:26,107710755,380,-170,107710375,107710755
16011,6,6,1,2412,-75,-91,16,e6:aa:ea:b7:4a:dd,107751925,408,40762,107751517,107751925
16012,4,1,1,2412,-93,-91,-2,a6:e5:7c:28:b1:d3,107758070,992,5153,107757078,107758070
16013,6,6,1,2412,-76,-91,15,e6:aa:ea:b7:4a:dd,107764218,408,5740,107763810,107764218
16014,4,1,1,2412,-83,-91,8,54:e4:3a:ec:fb:64,107767155,2160,777,107764995,107767155
16015,6,6,1,2412,-77,-91,14,e6:aa:ea:b7:4a:dd,107776175,408,8612,107775767,107776175
16016,6,6,1,2412,-76,-91,15,e6:aa:ea:b7:4a:dd,107788279,408,11696,107787871,107788279
16017,4,1,1,2412,-80,-91,11,b8:3a:5a:88:e6:e0,107795456,2360,4817,107793096,107795456
16018,4,1,1,2412,-78,-91,13,b8:3a:5a:88:e6:e1,107797854,2376,22,107795478,107797854
16019,6,6,1,2412,-76,-91,15,e6:aa:ea:b7:4a:dd,107800403,408,2141,107799995,107800403
16020,6,12,1,2412,-68,-91,23,40:e3:d6:da:ba:20,107811690,160,11127,107811530,107811690
16021,6,12,1,2412,-68,-91,23,40:e3:d6:da:ba:23,107812501,184,627,107812317,107812501
16022,6,6,1,2412,-68,-91,23,40:e3:d6:da:ba:26,107813176,380,295,107812796,107813176
16023,4,1,1,2412,-80,-91,11,b8:3a:5a:88:e6:e0,107897853,2360,82317,107895493,107897853
16024,6,12,1,2412,-68,-91,23,40:e3:d6:da:ba:20,107914085,160,16072,107913925,107914085
16025,6,6,1,2412,-68,-91,23,40:e3:d6:da:ba:21,107914295,368,-158,107913927,107914295
16026,6,12,1,2412,-68,-91,23,40:e3:d6:da:ba:22,107914682,180,207,107914502,107914682
16027,6,12,1,2412,-68,-91,23,40:e3:d6:da:ba:23,107914907,184,41,107914723,107914907
16028,6,12,1,2412,-68,-91,23,40:e3:d6:da:ba:24,107915125,176,42,107914949,107915125
16029,6,12,1,2412,-68,-91,23,40:e3:d6:da:ba:25,107915327,160,42,107915167,107915327
16030,6,6,1,2412,-72,-91,19,e6:aa:ea:c9:ea:33,107958135,408,42400,107957727,107958135
16031,6,6,1,2412,-72,-91,19,e6:aa:ea:c9:ea:33,107970274,408,11731,107969866,107970274
16032,6,6,1,2412,-72,-91,19,e6:aa:ea:c9:ea:33,107982365,408,11683,107981957,107982365
16033,6,6,1,2412,-73,-91,18,e6:aa:ea:c9:ea:33,107994487,408,11714,107994079,107994487
16034,6,12,1,2412,-66,-91,25,40:e3:d6:da:ba:20,108016500,160,21853,108016340,108016500
16035,6,12,1,2412,-66,-91,25,40:e3:d6:da:ba:22,108017106,180,426,108016926,108017106
16036,6,12,1,2412,-66,-91,25,40:e3:d6:da:ba:24,108017573,176,291,108017397,108017573
16037,6,12,1,2412,-66,-91,25,40:e3:d6:da:ba:25,108017775,160,42,108017615,108017775
16038,6,6,1,2412,-66,-91,25,40:e3:d6:da:ba:26,108017975,380,-180,108017595,108017975
16039,6,6,1,2412,-79,-91,12,e6:aa:ea:b7:4a:dd,108079306,408,60923,108078898,108079306
16040,6,6,1,2412,-78,-91,13,e6:aa:ea:b7:4a:dd,108091357,408,11643,108090949,108091357
16041,4,1,1,2412,-83,-91,8,b8:3a:5a:88:e6:e0,108102664,2360,8947,108100304,108102664
16042,6,6,1,2412,-78,-91,13,e6:aa:ea:b7:4a:dd,108115587,408,12515,108115179,108115587
16043,6,12,1,2412,-66,-91,25,40:e3:d6:da:ba:20,108118892,160,3145,108118732,108118892
16044,6,6,1,2412,-65,-91,26,40:e3:d6:da:ba:21,108119102,368,-158,108118734,108119102
16045,6,12,1,2412,-65,-91,26,40:e3:d6:da:ba:22,108119516,180,234,108119336,108119516
16046,6,12,1,2412,-64,-91,27,40:e3:d6:da:ba:23,108119721,184,21,108119537,108119721
16047,6,12,1,2412,-65,-91,26,40:e3:d6:da:ba:24,108119958,176,61,108119782,108119958
16048,6,12,1,2412,-65,-91,26,40:e3:d6:da:ba:25,108120159,160,41,108119999,108120159
16049,6,6,1,2412,-64,-91,27,40:e3:d6:da:ba:26,108120351,380,-188,108119971,108120351
16050,4,1,1,2412,-81,-91,10,54:e4:3a:ec:fb:64,108176750,2160,54239,108174590,108176750
16051,6,6,1,2412,-89,-91,2,40:e3:d6:da:c0:26,108194414,380,17284,108194034,108194414
16052,4,1,1,2412,-82,-91,9,b8:3a:5a:88:e6:e0,108205100,2360,8326,108202740,108205100
16053,6,12,1,2412,-64,-91,27,40:e3:d6:da:ba:20,108221323,160,16063,108221163,108221323
16054,6,6,1,2412,-64,-91,27,40:e3:d6:da:ba:21,108221515,368,-176,108221147,108221515
16055,6,12,1,2412,-64,-91,27,40:e3:d6:da:ba:22,108221911,180,216,108221731,108221911
16056,6,12,1,2412,-64,-91,27,40:e3:d6:da:ba:23,108222125,184,30,108221941,108222125
16057,6,12,1,2412,-64,-91,27,40:e3:d6:da:ba:24,108222353,176,52,108222177,108222353
16058,6,12,1,2412,-64,-91,27,40:e3:d6:da:ba:25,108222564,160,51,108222404,108222564
16059,4,1,1,2412,-81,-91,10,54:e4:3a:ec:fb:64,108279149,2160,54425,108276989,108279149
16060,6,6,1,2412,-87,-91,4,40:e3:d6:da:c0:26,108296800,380,17271,108296420,108296800
16061,4,1,1,2412,-81,-91,10,b8:3a:5a:88:e6:e0,108307453,2360,8293,108305093,108307453
16062,4,1,1,2412,-80,-91,11,b8:3a:5a:88:e6:e1,108309842,2376,13,108307466,108309842
16063,6,12,1,2412,-63,-91,28,40:e3:d6:da:ba:20,108323685,160,13683,108323525,108323685
16064,6,6,1,2412,-63,-91,28,40:e3:d6:da:ba:21,108323920,368,-133,108323552,108323920
16065,6,12,1,2412,-63,-91,28,40:e3:d6:da:ba:22,108324307,180,207,108324127,108324307
16066,6,12,1,2412,-63,-91,28,40:e3:d6:da:ba:23,108324513,184,22,108324329,108324513
16067,6,12,1,2412,-62,-91,29,40:e3:d6:da:ba:24,108324740,176,51,108324564,108324740
16068,6,12,1,2412,-62,-91,29,40:e3:d6:da:ba:25,108324968,160,68,108324808,108324968
16069,6,6,1,2412,-63,-91,28,40:e3:d6:da:ba:26,108325187,380,-161,108324807,108325187
16070,6,6,1,2412,-72,-91,19,e6:aa:ea:c9:ea:33,108363266,408,37671,108362858,108363266
16071,6,6,1,2412,-72,-91,19,e6:aa:ea:c9:ea:33,108375568,408,11894,108375160,108375568
16072,4,1,1,2412,-78,-91,13,54:e4:3a:ec:fb:64,108381701,2160,3973,108379541,108381701
16073,6,6,1,2412,-72,-91,19,e6:aa:ea:c9:ea:33,108387578,408,5469,108387170,108387578
16074,6,6,1,2412,-88,-91,3,40:e3:d6:da:c0:21,108397934,368,9988,108397566,108397934
16075,6,6,1,2412,-86,-91,5,40:e3:d6:da:c0:26,108399186,380,872,108398806,108399186
16076,6,6,1,2412,-72,-91,19,e6:aa:ea:c9:ea:33,108399619,408,25,108399211,108399619
16077,6,12,1,2412,-66,-91,25,40:e3:d6:da:ba:20,108426090,160,26311,108425930,108426090
16078,6,6,1,2412,-66,-91,25,40:e3:d6:da:ba:21,108426309,368,-149,108425941,108426309
16079,6,12,1,2412,-66,-91,25,40:e3:d6:da:ba:22,108426705,180,216,108426525,108426705
16080,6,12,1,2412,-66,-91,25,40:e3:d6:da:ba:23,108426929,184,40,108426745,108426929
16081,6,12,1,2412,-66,-91,25,40:e3:d6:da:ba:24,108427165,176,60,108426989,108427165
16082,6,12,1,2412,-66,-91,25,40:e3:d6:da:ba:25,108427385,160,60,108427225,108427385
16083,6,6,1,2412,-66,-91,25,40:e3:d6:da:ba:26,108427586,380,-179,108427206,108427586
16084,6,6,1,2412,-77,-91,14,e6:aa:ea:b7:4a:dd,108495963,408,67969,108495555,108495963
16085,4,1,1,2412,-77,-91,14,b8:3a:5a:88:e6:e1,108514632,2376,16293,108512256,108514632
16086,6,12,1,2412,-67,-91,24,40:e3:d6:da:ba:20,108528486,160,13694,108528326,108528486
16087,6,6,1,2412,-67,-91,24,40:e3:d6:da:ba:21,108528678,368,-176,108528310,108528678
16088,6,12,1,2412,-66,-91,25,40:e3:d6:da:ba:22,108529092,180,234,108528912,108529092
16089,6,12,1,2412,-66,-91,25,40:e3:d6:da:ba:23,108529306,184,30,108529122,108529306
16090,6,12,1,2412,-67,-91,24,40:e3:d6:da:ba:24,108529516,176,34,108529340,108529516
16091,6,12,1,2412,-67,-91,24,40:e3:d6:da:ba:25,108529726,160,50,108529566,108529726
16092,6,6,1,2412,-66,-91,25,40:e3:d6:da:ba:26,108529936,380,-170,108529556,108529936
16093,6,6,1,2412,-77,-91,14,e6:aa:ea:b7:4a:dd,108532498,408,2154,108532090,108532498
16094,4,1,1,2412,-77,-91,14,b8:3a:5a:88:e6:e0,108568743,2240,34005,108566503,108568743
16095,4,1,1,2412,-77,-91,14,b8:3a:5a:88:e6:e1,108571332,2256,333,108569076,108571332
16096,4,1,1,2412,-79,-91,12,54:e4:3a:ec:fb:64,108586346,2160,12854,108584186,108586346
16097,4,1,1,2412,-77,-91,14,b8:3a:5a:88:e6:e0,108588619,2240,33,108586379,108588619
16098,4,1,1,2412,-77,-91,14,b8:3a:5a:88:e6:e1,108591208,2256,333,108588952,108591208
16099,4,1,1,2412,-76,-91,15,b8:3a:5a:88:e6:e0,108614706,2360,21138,108612346,108614706
16100,4,1,1,2412,-77,-91,14,b8:3a:5a:88:e6:e1,108617113,2376,31,108614737,108617113
16101,6,12,1,2412,-65,-91,26,40:e3:d6:da:ba:20,108630887,160,13614,108630727,108630887
16102,6,6,1,2412,-64,-91,27,40:e3:d6:da:ba:21,108631097,368,-158,108630729,108631097
16103,6,12,1,2412,-65,-91,26,40:e3:d6:da:ba:23,108631707,184,426,108631523,108631707
16104,6,12,1,2412,-64,-91,27,40:e3:d6:da:ba:24,108631916,176,33,108631740,108631916
16105,6,12,1,2412,-64,-91,27,40:e3:d6:da:ba:25,108632189,160,113,108632029,108632189
16106,6,6,1,2412,-65,-91,26,40:e3:d6:da:ba:26,108632381,380,-188,108632001,108632381
16107,4,1,1,2412,-77,-91,14,54:e4:3a:ec:fb:64,108688748,2160,54207,108686588,108688748
16108,4,1,1,2412,-90,-91,1,c0:c9:e3:4d:6e:bf,108698796,872,9176,108697924,108698796
16109,4,1,1,2412,-92,-91,-1,,108699685,304,585,108699381,108699685
16110,6,6,1,2412,-86,-91,5,40:e3:d6:da:c0:26,108706401,380,6336,108706021,108706401
16111,4,1,1,2412,-79,-91,12,b8:3a:5a:88:e6:e1,108719473,2376,10696,108717097,108719473
16112,6,12,1,2412,-65,-91,26,40:e3:d6:da:ba:20,108733287,160,13654,108733127,108733287
16113,4,1,1,2412,-94,-91,-3,,108745146,304,11555,108744842,108745146
16114,6,6,1,2412,-73,-91,18,e6:aa:ea:c9:ea:33,108804775,408,59221,108804367,108804775
16115,6,6,1,2412,-74,-91,17,e6:aa:ea:c9:ea:33,108817071,408,11888,108816663,108817071
16116,4,1,1,2412,-80,-91,11,b8:3a:5a:88:e6:e0,108819640,2360,209,108817280,108819640
16117,4,1,1,2412,-80,-91,11,b8:3a:5a:88:e6:e1,108822330,2376,314,108819954,108822330
16118,6,6,1,2412,-74,-91,17,e6:aa:ea:c9:ea:33,108829278,408,6540,108828870,108829278
16119,6,12,1,2412,-67,-91,24,40:e3:d6:da:ba:20,108835687,160,6249,108835527,108835687
16120,6,12,1,2412,-67,-91,24,40:e3:d6:da:ba:22,108836320,180,453,108836140,108836320
16121,6,12,1,2412,-68,-91,23,40:e3:d6:da:ba:23,108836543,184,39,108836359,108836543
16122,6,12,1,2412,-67,-91,24,40:e3:d6:da:ba:24,108836753,176,34,108836577,108836753
16123,6,12,1,2412,-67,-91,24,40:e3:d6:da:ba:25,108836981,160,68,108836821,108836981
16124,6,6,1,2412,-68,-91,23,40:e3:d6:da:ba:26,108837200,380,-161,108836820,108837200
16125,4,1,1,2412,-84,-91,7,54:e4:3a:ec:fb:64,108893544,2160,54184,108891384,108893544
16126,6,12,1,2412,-67,-91,24,40:e3:d6:da:ba:20,108938099,160,44395,108937939,108938099
16127,6,6,1,2412,-66,-91,25,40:e3:d6:da:ba:21,108938291,368,-176,108937923,108938291
16128,6,12,1,2412,-67,-91,24,40:e3:d6:da:ba:22,108938696,180,225,108938516,108938696
16129,6,12,1,2412,-66,-91,25,40:e3:d6:da:ba:23,108938911,184,31,108938727,108938911
16130,6,12,1,2412,-66,-91,25,40:e3:d6:da:ba:24,108939120,176,33,108938944,108939120
16131,6,12,1,2412,-66,-91,25,40:e3:d6:da:ba:25,108939340,160,60,108939180,108939340
16132,6,6,1,2412,-66,-91,25,40:e3:d6:da:ba:26,108939541,380,-179,108939161,108939541
16133,4,1,1,2412,-80,-91,11,54:e4:3a:ec:fb:64,108995944,2160,54243,108993784,108995944
16134,6,6,1,2412,-79,-91,12,e6:aa:ea:b7:4a:dd,109004345,408,7993,109003937,109004345
16135,4,1,1,2412,-77,-91,14,b8:3a:5a:88:e6:e0,109024278,2360,17573,109021918,109024278
16136,4,1,1,2412,-78,-91,13,b8:3a:5a:88:e6:e1,109026658,2376,4,109024282,109026658
16137,6,6,1,2412,-79,-91,12,e6:aa:ea:b7:4a:dd,109040701,408,13635,109040293,109040701
16138,6,12,1,2412,-63,-91,28,40:e3:d6:da:ba:20,109041132,160,271,109040972,109041132
16139,6,6,1,2412,-63,-91,28,40:e3:d6:da:ba:21,109041333,368,-167,109040965,109041333
16140,6,12,1,2412,-63,-91,28,40:e3:d6:da:ba:23,109041962,184,445,109041778,109041962
16141,6,12,1,2412,-63,-91,28,40:e3:d6:da:ba:24,109042189,176,51,109042013,109042189
16142,6,12,1,2412,-63,-91,28,40:e3:d6:da:ba:25,109042418,160,69,109042258,109042418
16143,6,6,1,2412,-63,-91,28,40:e3:d6:da:ba:26,109042610,380,-188,109042230,109042610
16144,6,6,1,2412,-79,-91,12,e6:aa:ea:b7:4a:dd,109052822,408,9804,109052414,109052822
16145,4,1,1,2412,-81,-91,10,54:e4:3a:ec:fb:64,109098343,2160,43361,109096183,109098343
16146,4,1,1,2412,-77,-91,14,b8:3a:5a:88:e6:e0,109126668,2360,25965,109124308,109126668
16147,4,1,1,2412,-77,-91,14,b8:3a:5a:88:e6:e1,109129066,2376,22,109126690,109129066
16148,6,12,1,2412,-63,-91,28,40:e3:d6:da:ba:20,109142888,160,13662,109142728,109142888
16149,6,6,1,2412,-63,-91,28,40:e3:d6:da:ba:21,109143107,368,-149,109142739,109143107
16150,6,12,1,2412,-63,-91,28,40:e3:d6:da:ba:22,109143512,180,225,109143332,109143512
16151,6,12,1,2412,-63,-91,28,40:e3:d6:da:ba:23,109143761,184,65,109143577,109143761
16152,6,12,1,2412,-63,-91,28,40:e3:d6:da:ba:24,109143979,176,42,109143803,109143979
16153,6,12,1,2412,-63,-91,28,40:e3:d6:da:ba:25,109144190,160,51,109144030,109144190
16154,6,6,1,2412,-63,-91,28,40:e3:d6:da:ba:26,109144391,380,-179,109144011,109144391
16155,4,1,1,2412,-76,-91,15,b8:3a:5a:88:e6:e0,109150212,2240,3581,109147972,109150212
16156,4,1,1,2412,-76,-91,15,b8:3a:5a:88:e6:e1,109154927,2256,2459,109152671,109154927
16157,4,1,1,2412,-68,-91,23,b8:3a:5a:88:e6:e0,109161777,2240,4610,109159537,109161777
16158,4,1,1,2412,-77,-91,14,b8:3a:5a:88:e6:e1,109165366,2256,1333,109163110,109165366
16159,4,1,1,2412,-80,-91,11,54:e4:3a:ec:fb:64,109176163,2112,8685,109174051,109176163
16160,4,1,1,2412,-80,-91,11,54:e4:3a:ec:fb:64,109179327,2112,1052,109177215,109179327
16161,4,1,1,2412,-79,-91,12,54:e4:3a:ec:fb:64,109182034,2112,595,109179922,109182034
16162,4,1,1,2412,-91,-91,0,,109192528,304,10190,109192224,109192528
16163,4,1,1,2412,-81,-91,10,b8:3a:5a:88:e6:e0,109229081,2360,34193,109226721,109229081
16164,4,1,1,2412,-82,-91,9,b8:3a:5a:88:e6:e1,109231470,2376,13,109229094,109231470
16165,6,12,1,2412,-60,-91,31,40:e3:d6:da:ba:22,109245894,180,14244,109245714,109245894
16166,6,12,1,2412,-60,-91,31,40:e3:d6:da:ba:23,109246109,184,31,109245925,109246109
16167,6,12,1,2412,-61,-91,30,40:e3:d6:da:ba:25,109248722,160,2453,109248562,109248722
16168,6,6,1,2412,-60,-91,31,40:e3:d6:da:ba:26,109248941,380,-161,109248561,109248941
16169,6,6,1,2412,-72,-91,19,e6:aa:ea:c9:ea:33,109300666,408,51317,109300258,109300666
16170,6,6,1,2412,-71,-91,20,e6:aa:ea:c9:ea:33,109325306,408,24232,109324898,109325306
16171,6,6,1,2412,-71,-91,20,e6:aa:ea:c9:ea:33,109337141,408,11427,109336733,109337141
16172,6,12,1,2412,-62,-91,29,40:e3:d6:da:ba:20,109347690,160,10389,109347530,109347690
16173,6,6,1,2412,-62,-91,29,40:e3:d6:da:ba:21,109347882,368,-176,109347514,109347882
16174,6,12,1,2412,-61,-91,30,40:e3:d6:da:ba:22,109348269,180,207,109348089,109348269
16175,6,12,1,2412,-61,-91,30,40:e3:d6:da:ba:23,109348501,184,48,109348317,109348501
16176,6,12,1,2412,-61,-91,30,40:e3:d6:da:ba:24,109348720,176,43,109348544,109348720
16177,6,12,1,2412,-61,-91,30,40:e3:d6:da:ba:25,109348930,160,50,109348770,109348930
16178,6,6,1,2412,-62,-91,29,40:e3:d6:da:ba:26,109349131,380,-179,109348751,109349131
16179,4,1,1,2412,-83,-91,8,54:e4:3a:ec:fb:64,109405540,2160,54249,109403380,109405540
16180,6,6,1,2412,-77,-91,14,e6:aa:ea:b7:4a:dd,109422004,408,16056,109421596,109422004
16181,4,1,1,2412,-79,-91,12,b8:3a:5a:88:e6:e0,109433856,2360,9492,109431496,109433856
16182,6,12,1,2412,-62,-91,29,40:e3:d6:da:ba:20,109450105,160,16089,109449945,109450105
16183,6,6,1,2412,-62,-91,29,40:e3:d6:da:ba:21,109450297,368,-176,109449929,109450297
16184,6,12,1,2412,-62,-91,29,40:e3:d6:da:ba:22,109450730,180,253,109450550,109450730
16185,6,12,1,2412,-62,-91,29,40:e3:d6:da:ba:23,109450963,184,49,109450779,109450963
16186,6,12,1,2412,-62,-91,29,40:e3:d6:da:ba:24,109451181,176,42,109451005,109451181
16187,6,12,1,2412,-62,-91,29,40:e3:d6:da:ba:25,109451410,160,69,109451250,109451410
16188,6,6,1,2412,-62,-91,29,40:e3:d6:da:ba:26,109451602,380,-188,109451222,109451602
16189,6,6,1,2412,-78,-91,13,e6:aa:ea:b7:4a:dd,109458361,408,6351,109457953,109458361
16190,6,6,1,2412,-78,-91,13,e6:aa:ea:b7:4a:dd,109470476,408,11707,109470068,109470476
16191,6,12,1,2412,-62,-91,29,40:e3:d6:da:ba:23,109493955,156,23323,109493799,109493955
16192,6,12,1,2412,-72,-91,19,,109494127,32,140,109494095,109494127
16193,4,1,1,2412,-80,-91,11,54:e4:3a:ec:fb:64,109507938,2160,11651,109505778,109507938
16194,4,1,1,2412,-66,-91,25,c4:35:d9:b5:f6:e5,109513984,1480,4566,109512504,109513984
16195,6,12,1,2412,-62,-91,29,40:e3:d6:da:ba:23,109515436,156,1296,109515280,109515436
16196,4,1,1,2412,-73,-91,18,b8:3a:5a:88:e6:e0,109536306,2360,18510,109533946,109536306
16197,4,1,1,2412,-84,-91,7,b8:3a:5a:88:e6:e1,109538686,2376,4,109536310,109538686
16198,4,1,1,2412,-74,-91,17,c4:35:d9:b5:f6:e5,109541412,1480,1246,109539932,109541412
16199,6,12,1,2412,-61,-91,30,40:e3:d6:da:ba:23,109542884,156,1316,109542728,109542884
16200,6,12,1,2412,-68,-91,23,40:e3:d6:da:ba:20,109552491,160,9447,109552331,109552491
16201,6,6,1,2412,-68,-91,23,40:e3:d6:da:ba:21,109552683,368,-176,109552315,109552683
16202,6,12,1,2412,-68,-91,23,40:e3:d6:da:ba:22,109553078,180,215,109552898,109553078
16203,6,12,1,2412,-67,-91,24,40:e3:d6:da:ba:23,109553311,184,49,109553127,109553311
16204,6,12,1,2412,-68,-91,23,40:e3:d6:da:ba:25,109553722,160,251,109553562,109553722
16205,6,6,1,2412,-68,-91,23,40:e3:d6:da:ba:26,109553923,380,-179,109553543,109553923
16206,4,1,1,2412,-74,-91,17,c4:35:d9:b5:f6:e5,109561691,1480,6288,109560211,109561691
16207,6,12,1,2412,-62,-91,29,40:e3:d6:da:ba:23,109563149,156,1302,109562993,109563149
16208,4,1,1,2412,-80,-91,11,54:e4:3a:ec:fb:64,109610337,2160,45028,109608177,109610337
16209,6,12,1,2412,-62,-91,29,40:e3:d6:da:ba:20,109654892,160,44395,109654732,109654892
16210,6,6,1,2412,-62,-91,29,40:e3:d6:da:ba:21,109655093,368,-167,109654725,109655093
16211,6,12,1,2412,-62,-91,29,40:e3:d6:da:ba:22,109655480,180,207,109655300,109655480
16212,6,12,1,2412,-62,-91,29,40:e3:d6:da:ba:23,109655694,184,30,109655510,109655694
16213,6,12,1,2412,-62,-91,29,40:e3:d6:da:ba:24,109655904,176,34,109655728,109655904
16214,6,12,1,2412,-62,-91,29,40:e3:d6:da:ba:25,109656114,160,50,109655954,109656114
16215,6,6,1,2412,-62,-91,29,40:e3:d6:da:ba:26,109656333,380,-161,109655953,109656333
16216,4,1,1,2412,-92,-91,-1,,109685083,304,28446,109684779,109685083
16217,4,1,1,2412,-92,-91,-1,a6:e5:7c:28:b1:d3,109700155,992,14080,109699163,109700155
16218,4,1,1,2412,-80,-91,11,54:e4:3a:ec:fb:64,109712737,2160,10422,109710577,109712737
16219,4,1,1,2412,-91,-91,0,,109728032,304,14991,109727728,109728032
16220,4,1,1,2412,-84,-91,7,b8:3a:5a:88:e6:e0,109741185,2360,10793,109738825,109741185
16221,4,1,1,2412,-82,-91,9,b8:3a:5a:88:e6:e1,109743592,2376,31,109741216,109743592
16222,6,6,1,2412,-64,-91,27,40:e3:d6:da:ba:21,109757526,368,13566,109757158,109757526
16223,6,12,1,2412,-64,-91,27,40:e3:d6:da:ba:22,109757931,180,225,109757751,109757931
16224,6,12,1,2412,-64,-91,27,40:e3:d6:da:ba:25,109758566,160,475,109758406,109758566
16225,6,6,1,2412,-64,-91,27,40:e3:d6:da:ba:26,109758767,380,-179,109758387,109758767
16226,4,1,1,2412,-91,-91,0,,109788940,304,29869,109788636,109788940
16227,4,1,1,2412,-81,-91,10,54:e4:3a:ec:fb:64,109815136,2160,24036,109812976,109815136
16228,6,6,1,2412,-68,-91,23,e6:aa:ea:c9:ea:33,109821140,408,5596,109820732,109821140
16229,6,6,1,2412,-69,-91,22,e6:aa:ea:c9:ea:33,109833250,408,11702,109832842,109833250
16230,4,1,1,2412,-82,-91,9,b8:3a:5a:88:e6:e1,109845836,2376,10210,109843460,109845836
16231,6,6,1,2412,-77,-91,14,e6:aa:ea:b7:4a:dd,109852648,408,6404,109852240,109852648
16232,6,6,1,2412,-69,-91,22,e6:aa:ea:c9:ea:33,109857541,408,4485,109857133,109857541
16233,6,6,1,2412,-77,-91,14,e6:aa:ea:b7:4a:dd,109864764,408,6815,109864356,109864764
16234,6,6,1,2412,-69,-91,22,e6:aa:ea:c9:ea:33,109870829,408,5657,109870421,109870829
16235,4,1,1,2412,-93,-91,-2,a6:e5:7c:28:b1:d3,109875077,944,3304,109874133,109875077
16236,4,1,1,2412,-93,-91,-2,a6:e5:7c:28:b1:d3,109880521,944,4500,109879577,109880521
16237,4,1,1,2412,-91,-91,0,a6:e5:7c:28:b1:d3,109881752,944,287,109880808,109881752
16238,4,1,1,2412,-93,-91,-2,a6:e5:7c:28:b1:d3,109885356,944,2660,109884412,109885356
16239,4,1,1,2412,-88,-91,3,a6:e5:7c:28:b1:d3,109887476,944,1176,109886532,109887476
16240,6,6,1,2412,-77,-91,14,e6:aa:ea:b7:4a:dd,109888996,408,1112,109888588,109888996
16241,4,1,1,2412,-91,-91,0,a6:e5:7c:28:b1:d3,109890656,944,716,109889712,109890656
16242,4,1,1,2412,-92,-91,-1,a6:e5:7c:28:b1:d3,109891769,944,169,109890825,109891769
16243,4,1,1,2412,-86,-91,5,5e:2a:79:5d:c9:ee,109935085,992,42324,109934093,109935085
16244,4,1,1,2412,-81,-91,10,54:e4:3a:ec:fb:64,109936195,2112,-1002,109934083,109936195
16245,4,1,1,2412,-80,-91,11,,109938323,304,1824,109938019,109938323
16246,6,12,1,2412,-67,-91,24,40:e3:d6:da:ba:20,109938487,136,28,109938351,109938487
16247,6,12,1,2412,-78,-91,13,,109938641,32,122,109938609,109938641
16248,6,6,1,2412,-67,-91,24,40:e3:d6:da:ba:21,109938737,348,-252,109938389,109938737
16249,6,12,1,2412,-67,-91,24,40:e3:d6:da:ba:22,109939113,156,220,109938957,109939113
16250,6,12,1,2412,-78,-91,13,,109939287,32,142,109939255,109939287
16251,6,12,1,2412,-67,-91,24,40:e3:d6:da:ba:23,109939367,156,-76,109939211,109939367
16252,6,12,1,2412,-78,-91,13,,109939541,32,142,109939509,109939541
16253,6,12,1,2412,-67,-91,24,40:e3:d6:da:ba:25,109939621,136,-56,109939485,109939621
16254,6,12,1,2412,-78,-91,13,,109939775,32,122,109939743,109939775
16255,6,12,1,2412,-78,-91,13,,109940408,32,601,109940376,109940408
16256,4,1,1,2412,-84,-91,7,b8:3a:5a:88:e6:e0,109945871,2360,3103,109943511,109945871
16257,6,12,1,2412,-67,-91,24,40:e3:d6:da:ba:20,109962115,160,16084,109961955,109962115
16258,6,6,1,2412,-66,-91,25,40:e3:d6:da:ba:21,109962307,368,-176,109961939,109962307
16259,6,12,1,2412,-66,-91,25,40:e3:d6:da:ba:22,109962712,180,225,109962532,109962712
16260,6,12,1,2412,-66,-91,25,40:e3:d6:da:ba:23,109962944,184,48,109962760,109962944
16261,6,12,1,2412,-66,-91,25,40:e3:d6:da:ba:24,109963172,176,52,109962996,109963172
16262,6,12,1,2412,-66,-91,25,40:e3:d6:da:ba:25,109963373,160,41,109963213,109963373
16263,4,1,1,2412,-91,-91,0,a6:e5:7c:28:b1:d3,109969502,944,5185,109968558,109969502
16264,4,1,1,2412,-81,-91,10,54:e4:3a:ec:fb:64,110019935,2160,48273,110017775,110019935
16265,6,12,1,2412,-66,-91,25,40:e3:d6:da:ba:20,110064512,160,44417,110064352,110064512
16266,6,6,1,2412,-66,-91,25,40:e3:d6:da:ba:21,110064722,368,-158,110064354,110064722
16267,6,12,1,2412,-66,-91,25,40:e3:d6:da:ba:22,110065127,180,225,110064947,110065127
16268,6,12,1,2412,-66,-91,25,40:e3:d6:da:ba:23,110065332,184,21,110065148,110065332
16269,6,12,1,2412,-64,-91,27,40:e3:d6:da:ba:24,110065541,176,33,110065365,110065541
16270,6,12,1,2412,-66,-91,25,40:e3:d6:da:ba:25,110065770,160,69,110065610,110065770
16271,6,6,1,2412,-66,-91,25,40:e3:d6:da:ba:26,110065980,380,-170,110065600,110065980
16272,6,12,1,2412,-67,-91,24,40:e3:d6:da:ba:20,110166919,160,100779,110166759,110166919
16273,6,6,1,2412,-66,-91,25,40:e3:d6:da:ba:21,110167138,368,-149,110166770,110167138
16274,6,12,1,2412,-66,-91,25,40:e3:d6:da:ba:22,110167543,180,225,110167363,110167543
16275,6,12,1,2412,-67,-91,24,40:e3:d6:da:ba:23,110167758,184,31,110167574,110167758
16276,6,12,1,2412,-65,-91,26,40:e3:d6:da:ba:24,110167985,176,51,110167809,110167985
16277,6,12,1,2412,-66,-91,25,40:e3:d6:da:ba:25,110168205,160,60,110168045,110168205
16278,6,6,1,2412,-66,-91,25,40:e3:d6:da:ba:26,110168397,380,-188,110168017,110168397
16279,4,1,1,2412,-90,-91,1,,110170912,304,2211,110170608,110170912
16280,4,1,1,2412,-83,-91,8,b8:3a:5a:88:e6:e0,110255787,2360,82515,110253427,110255787
16281,4,1,1,2412,-83,-91,8,b8:3a:5a:88:e6:e1,110258184,2376,21,110255808,110258184
16282,6,12,1,2412,-64,-91,27,40:e3:d6:da:ba:20,110269315,160,10971,110269155,110269315
16283,6,6,1,2412,-65,-91,26,40:e3:d6:da:ba:21,110269525,368,-158,110269157,110269525
16284,6,12,1,2412,-65,-91,26,40:e3:d6:da:ba:22,110269930,180,225,110269750,110269930
16285,6,12,1,2412,-64,-91,27,40:e3:d6:da:ba:24,110270783,176,677,110270607,110270783
16286,6,6,1,2412,-81,-91,10,e6:aa:ea:b7:4a:dd,110282230,408,11039,110281822,110282230
16287,6,6,1,2412,-77,-91,14,e6:aa:ea:b7:4a:dd,110294355,408,11717,110293947,110294355
16288,6,6,1,2412,-82,-91,9,e6:aa:ea:b7:4a:dd,110306474,408,11711,110306066,110306474
16289,6,6,1,2412,-71,-91,20,e6:aa:ea:c9:ea:33,110345854,408,38972,110345446,110345854
16290,6,12,1,2412,-66,-91,25,40:e3:d6:da:ba:20,110371694,160,25680,110371534,110371694
16291,6,6,1,2412,-66,-91,25,40:e3:d6:da:ba:21,110371904,368,-158,110371536,110371904
16292,6,12,1,2412,-66,-91,25,40:e3:d6:da:ba:22,110372291,180,207,110372111,110372291
16293,6,12,1,2412,-65,-91,26,40:e3:d6:da:ba:23,110372515,184,40,110372331,110372515
16294,6,12,1,2412,-65,-91,26,40:e3:d6:da:ba:24,110372742,176,51,110372566,110372742
16295,6,6,1,2412,-65,-91,26,40:e3:d6:da:ba:26,110373181,380,59,110372801,110373181
16296,6,6,1,2412,-70,-91,21,e6:aa:ea:c9:ea:33,110382200,408,8611,110381792,110382200
16297,6,6,1,2412,-70,-91,21,e6:aa:ea:c9:ea:33,110394309,408,11701,110393901,110394309
16298,4,1,1,2412,-82,-91,9,54:e4:3a:ec:fb:64,110429531,2160,33062,110427371,110429531
16299,4,1,1,2412,-77,-91,14,5e:2a:79:5d:c9:ee,110438540,992,8017,110437548,110438540
16300,4,1,1,2412,-82,-91,9,54:e4:3a:ec:fb:64,110439649,2112,-1003,110437537,110439649
16301,4,1,1,2412,-77,-91,14,,110441777,304,1824,110441473,110441777
16302,6,12,1,2412,-67,-91,24,40:e3:d6:da:ba:20,110441941,136,28,110441805,110441941
16303,6,6,1,2412,-67,-91,24,40:e3:d6:da:ba:21,110442145,348,-144,110441797,110442145
16304,6,12,1,2412,-67,-91,24,40:e3:d6:da:ba:22,110442548,156,247,110442392,110442548
16305,6,12,1,2412,-67,-91,24,40:e3:d6:da:ba:23,110442756,156,52,110442600,110442756
16306,6,12,1,2412,-67,-91,24,40:e3:d6:da:ba:25,110442964,136,72,110442828,110442964
16307,4,1,1,2412,-75,-91,16,5e:2a:79:5d:c9:ee,110464423,992,20467,110463431,110464423
16308,6,12,1,2412,-68,-91,23,40:e3:d6:da:ba:20,110474101,160,9518,110473941,110474101
16309,6,6,1,2412,-69,-91,22,40:e3:d6:da:ba:21,110474293,368,-176,110473925,110474293
16310,6,12,1,2412,-68,-91,23,40:e3:d6:da:ba:22,110474707,180,234,110474527,110474707
16311,6,12,1,2412,-68,-91,23,40:e3:d6:da:ba:23,110474912,184,21,110474728,110474912
16312,6,12,1,2412,-68,-91,23,40:e3:d6:da:ba:24,110475148,176,60,110474972,110475148
16313,6,12,1,2412,-68,-91,23,40:e3:d6:da:ba:25,110475359,160,51,110475199,110475359
16314,6,6,1,2412,-68,-91,23,40:e3:d6:da:ba:26,110475560,380,-179,110475180,110475560
16315,4,1,1,2412,-80,-91,11,b8:3a:5a:88:e6:e0,110545967,2240,68167,110543727,110545967
16316,4,1,1,2412,-82,-91,9,b8:3a:5a:88:e6:e1,110562863,2376,14520,110560487,110562863
16317,6,12,1,2412,-68,-91,23,40:e3:d6:da:ba:20,110577985,160,14962,110577825,110577985
16318,6,6,1,2412,-67,-91,24,40:e3:d6:da:ba:21,110578177,368,-176,110577809,110578177
16319,6,12,1,2412,-67,-91,24,40:e3:d6:da:ba:22,110578564,180,207,110578384,110578564
16320,6,12,1,2412,-68,-91,23,40:e3:d6:da:ba:24,110581258,176,2518,110581082,110581258
16321,6,12,1,2412,-67,-91,24,40:e3:d6:da:ba:25,110581459,160,41,110581299,110581459
16322,4,1,1,2412,-80,-91,11,54:e4:3a:ec:fb:64,110634763,2160,51144,110632603,110634763
16323,4,1,1,2412,-80,-91,11,b8:3a:5a:88:e6:e1,110665144,2376,28005,110662768,110665144
16324,6,6,1,2412,-68,-91,23,e6:aa:ea:c9:ea:33,110673911,408,8359,110673503,110673911
16325,6,12,1,2412,-66,-91,25,40:e3:d6:da:ba:20,110678902,160,4831,110678742,110678902
16326,6,6,1,2412,-65,-91,26,40:e3:d6:da:ba:21,110679094,368,-176,110678726,110679094
16327,6,12,1,2412,-66,-91,25,40:e3:d6:da:ba:22,110679508,180,234,110679328,110679508
16328,6,12,1,2412,-66,-91,25,40:e3:d6:da:ba:23,110679731,184,39,110679547,110679731
16329,6,12,1,2412,-65,-91,26,40:e3:d6:da:ba:24,110679950,176,43,110679774,110679950
16330,6,12,1,2412,-65,-91,26,40:e3:d6:da:ba:25,110680160,160,50,110680000,110680160
16331,6,6,1,2412,-65,-91,26,40:e3:d6:da:ba:26,110680370,380,-170,110679990,110680370
16332,6,6,1,2412,-68,-91,23,e6:aa:ea:c9:ea:33,110686115,408,5337,110685707,110686115
16333,4,1,1,2412,-80,-91,11,54:e4:3a:ec:fb:64,110687513,2112,-714,110685401,110687513
16334,4,1,1,2412,-80,-91,11,54:e4:3a:ec:fb:64,110691572,2112,1947,110689460,110691572
16335,6,6,1,2412,-68,-91,23,e6:aa:ea:c9:ea:33,110698731,408,6751,110698323,110698731
16336,6,6,1,2412,-68,-91,23,e6:aa:ea:c9:ea:33,110710117,408,10978,110709709,110710117
16337,4,1,1,2412,-82,-91,9,54:e4:3a:ec:fb:64,110736728,2160,24451,110734568,110736728
16338,4,1,1,2412,-80,-91,11,b8:3a:5a:88:e6:e0,110765081,2360,25993,110762721,110765081
16339,4,1,1,2412,-79,-91,12,b8:3a:5a:88:e6:e1,110767479,2376,22,110765103,110767479
16340,6,6,1,2412,-81,-91,10,e6:aa:ea:b7:4a:dd,110779130,408,11243,110778722,110779130
16341,6,12,1,2412,-64,-91,27,40:e3:d6:da:ba:20,110781317,160,2027,110781157,110781317
16342,6,6,1,2412,-64,-91,27,40:e3:d6:da:ba:21,110781518,368,-167,110781150,110781518
16343,6,12,1,2412,-64,-91,27,40:e3:d6:da:ba:23,110782147,184,445,110781963,110782147
16344,6,6,1,2412,-64,-91,27,40:e3:d6:da:ba:26,110782822,380,295,110782442,110782822
16345,6,6,1,2412,-81,-91,10,e6:aa:ea:b7:4a:dd,110791253,408,8023,110790845,110791253
16346,6,6,1,2412,-80,-91,11,e6:aa:ea:b7:4a:dd,110803406,408,11745,110802998,110803406
16347,6,6,1,2412,-80,-91,11,e6:aa:ea:b7:4a:dd,110815959,408,12145,110815551,110815959
16348,4,1,1,2412,-81,-91,10,54:e4:3a:ec:fb:64,110817818,2112,-253,110815706,110817818
16349,6,6,1,2412,-80,-91,11,e6:aa:ea:b7:4a:dd,110827596,408,9370,110827188,110827596
16350,4,1,1,2412,-82,-91,9,54:e4:3a:ec:fb:64,110833618,2112,3910,110831506,110833618
16351,4,1,1,2412,-82,-91,9,54:e4:3a:ec:fb:64,110835866,2112,136,110833754,110835866
16352,4,1,1,2412,-82,-91,9,54:e4:3a:ec:fb:64,110839348,2160,1322,110837188,110839348
16353,4,1,1,2412,-81,-91,10,54:e4:3a:ec:fb:64,110842214,2112,754,110840102,110842214
16354,6,6,1,2412,-85,-91,6,78:8a:20:fa:27:f9,110861932,88,19630,110861844,110861932
16355,4,1,1,2412,-79,-91,12,b8:3a:5a:88:e6:e1,110864726,2256,538,110862470,110864726
16356,4,1,1,2412,-79,-91,12,b8:3a:5a:88:e6:e0,110867470,2360,384,110865110,110867470
16357,6,12,1,2412,-64,-91,27,40:e3:d6:da:ba:20,110883714,160,16084,110883554,110883714
16358,6,6,1,2412,-64,-91,27,40:e3:d6:da:ba:21,110883915,368,-167,110883547,110883915
16359,6,12,1,2412,-64,-91,27,40:e3:d6:da:ba:22,110884319,180,224,110884139,110884319
16360,6,12,1,2412,-64,-91,27,40:e3:d6:da:ba:23,110884543,184,40,110884359,110884543
16361,6,12,1,2412,-64,-91,27,40:e3:d6:da:ba:24,110884752,176,33,110884576,110884752
16362,6,12,1,2412,-64,-91,27,40:e3:d6:da:ba:25,110884981,160,69,110884821,110884981
16363,6,6,1,2412,-64,-91,27,40:e3:d6:da:ba:26,110885173,380,-188,110884793,110885173
16364,6,6,1,2412,-85,-91,6,78:8a:20:fa:27:f9,110912010,88,26749,110911922,110912010
16365,4,1,1,2412,-79,-91,12,b8:3a:5a:88:e6:e0,110912516,2240,-1734,110910276,110912516
16366,4,1,1,2412,-83,-91,8,54:e4:3a:ec:fb:64,110941527,2160,26851,110939367,110941527
16367,4,1,1,2412,-79,-91,12,b8:3a:5a:88:e6:e0,110969868,2360,25981,110967508,110969868
16368,4,1,1,2412,-79,-91,12,b8:3a:5a:88:e6:e1,110972256,2376,12,110969880,110972256
16369,6,12,1,2412,-64,-91,27,40:e3:d6:da:ba:20,110986103,160,13687,110985943,110986103
16370,6,6,1,2412,-65,-91,26,40:e3:d6:da:ba:21,110986312,368,-159,110985944,110986312
16371,6,12,1,2412,-65,-91,26,40:e3:d6:da:ba:22,110986727,180,235,110986547,110986727
16372,6,12,1,2412,-64,-91,27,40:e3:d6:da:ba:23,110986950,184,39,110986766,110986950
16373,6,12,1,2412,-65,-91,26,40:e3:d6:da:ba:24,110987160,176,34,110986984,110987160
16374,6,12,1,2412,-64,-91,27,40:e3:d6:da:ba:25,110987379,160,59,110987219,110987379
16375,6,6,1,2412,-71,-91,20,40:e3:d6:da:ba:26,110987598,380,-161,110987218,110987598
16376,4,1,1,2412,-78,-91,13,b8:3a:5a:88:e6:e1,111074680,2376,84706,111072304,111074680
16377,6,6,1,2412,-70,-91,21,e6:aa:ea:c9:ea:33,111079647,408,4559,111079239,111079647
16378,6,12,1,2412,-66,-91,25,40:e3:d6:da:ba:22,111089105,180,9278,111088925,111089105
16379,6,12,1,2412,-66,-91,25,40:e3:d6:da:ba:23,111089311,184,22,111089127,111089311
16380,6,12,1,2412,-65,-91,26,40:e3:d6:da:ba:24,111089547,176,60,111089371,111089547
16381,6,12,1,2412,-66,-91,25,40:e3:d6:da:ba:25,111089776,160,69,111089616,111089776
16382,6,6,1,2412,-65,-91,26,40:e3:d6:da:ba:26,111089968,380,-188,111089588,111089968
16383,6,6,1,2412,-71,-91,20,e6:aa:ea:c9:ea:33,111091756,408,1380,111091348,111091756
16384,6,6,1,2412,-70,-91,21,e6:aa:ea:c9:ea:33,111103880,408,11716,111103472,111103880
16385,4,1,1,2412,-88,-91,3,a6:e5:7c:28:b1:d3,111112881,944,8057,111111937,111112881
16386,4,1,1,2412,-90,-91,1,a6:e5:7c:28:b1:d3,111113977,944,152,111113033,111113977
16387,4,1,1,2412,-90,-91,1,a6:e5:7c:28:b1:d3,111121235,944,6314,111120291,111121235
16388,4,1,1,2412,-91,-91,0,a6:e5:7c:28:b1:d3,111122286,944,107,111121342,111122286
16389,4,1,1,2412,-90,-91,1,a6:e5:7c:28:b1:d3,111123400,944,170,111122456,111123400
16390,6,6,1,2412,-70,-91,21,e6:aa:ea:c9:ea:33,111128119,408,4311,111127711,111128119
16391,4,1,1,2412,-81,-91,10,54:e4:3a:ec:fb:64,111138257,2160,7978,111136097,111138257
16392,4,1,1,2412,-75,-91,16,b8:3a:5a:88:e6:e0,111175013,2360,34396,111172653,111175013
16393,4,1,1,2412,-77,-91,14,b8:3a:5a:88:e6:e1,111177393,2376,4,111175017,111177393
16394,6,12,1,2412,-67,-91,24,40:e3:d6:da:ba:20,111190919,160,13366,111190759,111190919
16395,6,6,1,2412,-66,-91,25,40:e3:d6:da:ba:21,111191138,368,-149,111190770,111191138
16396,6,12,1,2412,-66,-91,25,40:e3:d6:da:ba:22,111191525,180,207,111191345,111191525
16397,6,12,1,2412,-67,-91,24,40:e3:d6:da:ba:24,111191958,176,257,111191782,111191958
16398,6,12,1,2412,-66,-91,25,40:e3:d6:da:ba:25,111192187,160,69,111192027,111192187
16399,6,6,1,2412,-66,-91,25,40:e3:d6:da:ba:26,111192406,380,-161,111192026,111192406
16400,4,1,1,2412,-80,-91,11,54:e4:3a:ec:fb:64,111248723,2160,54157,111246563,111248723
16401,4,1,1,2412,-78,-91,13,b8:3a:5a:88:e6:e0,111277062,2360,25979,111274702,111277062
16402,4,1,1,2412,-77,-91,14,b8:3a:5a:88:e6:e0,111287216,11424,-1270,111275792,111287216
16403,6,12,1,2412,-65,-91,26,40:e3:d6:da:ba:20,111303487,160,16111,111303327,111303487
16404,6,6,1,2412,-66,-91,25,40:e3:d6:da:ba:21,111303688,368,-167,111303320,111303688
16405,6,12,1,2412,-65,-91,26,40:e3:d6:da:ba:22,111304084,180,216,111303904,111304084
16406,6,12,1,2412,-65,-91,26,40:e3:d6:da:ba:23,111304299,184,31,111304115,111304299
16407,6,12,1,2412,-66,-91,25,40:e3:d6:da:ba:24,111304587,176,112,111304411,111304587
16408,6,12,1,2412,-66,-91,25,40:e3:d6:da:ba:25,111304806,160,59,111304646,111304806
16409,6,6,1,2412,-65,-91,26,40:e3:d6:da:ba:26,111305016,380,-170,111304636,111305016
16410,6,6,1,2412,-80,-91,11,e6:aa:ea:b7:4a:dd,111312079,408,6655,111311671,111312079
16411,6,6,1,2412,-80,-91,11,e6:aa:ea:b7:4a:dd,111324190,408,11703,111323782,111324190
16412,6,6,1,2412,-80,-91,11,e6:aa:ea:b7:4a:dd,111336417,408,11819,111336009,111336417
16413,4,1,1,2412,-81,-91,10,54:e4:3a:ec:fb:64,111352023,2160,13446,111349863,111352023
16414,6,6,1,2412,-71,-91,20,e6:aa:ea:c9:ea:33,111394458,408,42027,111394050,111394458
16415,6,6,1,2412,-63,-91,28,40:e3:d6:da:ba:21,111395902,368,1076,111395534,111395902
16416,6,12,1,2412,-63,-91,28,40:e3:d6:da:ba:23,111396513,184,427,111396329,111396513
16417,6,12,1,2412,-63,-91,28,40:e3:d6:da:ba:24,111396731,176,42,111396555,111396731
16418,6,6,1,2412,-64,-91,27,40:e3:d6:da:ba:26,111397161,380,50,111396781,111397161
16419,6,6,1,2412,-71,-91,20,e6:aa:ea:c9:ea:33,111406584,408,9015,111406176,111406584
16420,6,6,1,2412,-70,-91,21,e6:aa:ea:c9:ea:33,111418697,408,11705,111418289,111418697
16421,6,6,1,2412,-71,-91,20,e6:aa:ea:c9:ea:33,111442931,408,23826,111442523,111442931
16422,4,1,1,2412,-77,-91,14,b8:3a:5a:88:e6:e0,111481868,2360,36577,111479508,111481868
16423,4,1,1,2412,-78,-91,13,b8:3a:5a:88:e6:e1,111484266,2376,22,111481890,111484266
16424,6,12,1,2412,-63,-91,28,40:e3:d6:da:ba:20,111498103,160,13677,111497943,111498103
16425,6,6,1,2412,-63,-91,28,40:e3:d6:da:ba:21,111498295,368,-176,111497927,111498295
16426,6,12,1,2412,-63,-91,28,40:e3:d6:da:ba:23,111498914,184,435,111498730,111498914
16427,6,12,1,2412,-63,-91,28,40:e3:d6:da:ba:24,111499124,176,34,111498948,111499124
16428,6,12,1,2412,-63,-91,28,40:e3:d6:da:ba:25,111499343,160,59,111499183,111499343
16429,6,6,1,2412,-63,-91,28,40:e3:d6:da:ba:26,111499544,380,-179,111499164,111499544
16430,4,1,1,2412,-81,-91,10,54:e4:3a:ec:fb:64,111555920,2160,54216,111553760,111555920
16431,4,1,1,2412,-68,-91,23,b8:3a:5a:88:e6:e0,111584276,2360,25996,111581916,111584276
16432,4,1,1,2412,-75,-91,16,b8:3a:5a:88:e6:e1,111586674,2376,22,111584298,111586674
16433,6,6,1,2412,-84,-91,7,e6:aa:ea:b7:4a:dd,111627175,408,40093,111626767,111627175
16434,6,6,1,2412,-81,-91,10,e6:aa:ea:b7:4a:dd,111651417,408,23834,111651009,111651417
16435,4,1,1,2412,-81,-91,10,54:e4:3a:ec:fb:64,111658320,2160,4743,111656160,111658320
16436,6,6,1,2412,-82,-91,9,e6:aa:ea:b7:4a:dd,111663523,408,4795,111663115,111663523
16437,4,1,1,2412,-76,-91,15,b8:3a:5a:88:e6:e1,111689237,2376,23338,111686861,111689237
16438,6,12,1,2412,-64,-91,27,40:e3:d6:da:ba:20,111702925,160,13528,111702765,111702925
16439,6,6,1,2412,-64,-91,27,40:e3:d6:da:ba:21,111703135,368,-158,111702767,111703135
16440,6,12,1,2412,-64,-91,27,40:e3:d6:da:ba:22,111703531,180,216,111703351,111703531
16441,6,12,1,2412,-64,-91,27,40:e3:d6:da:ba:23,111703745,184,30,111703561,111703745
16442,6,12,1,2412,-63,-91,28,40:e3:d6:da:ba:25,111704211,160,306,111704051,111704211
16443,6,6,1,2412,-64,-91,27,40:e3:d6:da:ba:26,111704412,380,-179,111704032,111704412
16444,6,6,1,2412,-69,-91,22,e6:aa:ea:c9:ea:33,111710697,408,5877,111710289,111710697
16445,6,6,1,2412,-69,-91,22,e6:aa:ea:c9:ea:33,111722829,408,11724,111722421,111722829
16446,6,6,1,2412,-69,-91,22,e6:aa:ea:c9:ea:33,111734955,408,11718,111734547,111734955
16447,6,12,1,2412,-64,-91,27,40:e3:d6:da:ba:20,111751243,136,16152,111751107,111751243
16448,6,6,1,2412,-64,-91,27,40:e3:d6:da:ba:21,111751420,348,-171,111751072,111751420
16449,6,12,1,2412,-64,-91,27,40:e3:d6:da:ba:22,111751814,156,238,111751658,111751814
16450,6,12,1,2412,-64,-91,27,40:e3:d6:da:ba:23,111752023,156,53,111751867,111752023
16451,6,12,1,2412,-64,-91,27,40:e3:d6:da:ba:25,111752240,136,81,111752104,111752240
16452,6,6,1,2412,-69,-91,22,e6:aa:ea:c9:ea:33,111759187,408,6539,111758779,111759187
16453,4,1,1,2412,-82,-91,9,54:e4:3a:ec:fb:64,111760725,2160,-622,111758565,111760725
16454,4,1,1,2412,-77,-91,14,b8:3a:5a:88:e6:e0,111789127,2360,26042,111786767,111789127
16455,4,1,1,2412,-76,-91,15,b8:3a:5a:88:e6:e1,111791525,2376,22,111789149,111791525
16456,6,6,1,2412,-64,-91,27,40:e3:d6:da:ba:21,111805536,368,13643,111805168,111805536
16457,6,12,1,2412,-64,-91,27,40:e3:d6:da:ba:22,111805923,180,207,111805743,111805923
16458,6,12,1,2412,-64,-91,27,40:e3:d6:da:ba:23,111806147,184,40,111805963,111806147
16459,6,12,1,2412,-64,-91,27,40:e3:d6:da:ba:24,111806374,176,51,111806198,111806374
16460,4,1,1,2412,-81,-91,10,54:e4:3a:ec:fb:64,111863117,2160,54583,111860957,111863117
16461,4,1,1,2412,-75,-91,16,b8:3a:5a:88:e6:e0,111891482,2360,26005,111889122,111891482
16462,4,1,1,2412,-75,-91,16,b8:3a:5a:88:e6:e1,111893871,2376,13,111891495,111893871
16463,6,12,1,2412,-64,-91,27,40:e3:d6:da:ba:20,111907721,160,13690,111907561,111907721
16464,6,6,1,2412,-64,-91,27,40:e3:d6:da:ba:21,111907913,368,-176,111907545,111907913
16465,6,12,1,2412,-64,-91,27,40:e3:d6:da:ba:22,111908318,180,225,111908138,111908318
16466,6,12,1,2412,-64,-91,27,40:e3:d6:da:ba:23,111908541,184,39,111908357,111908541
16467,6,12,1,2412,-64,-91,27,40:e3:d6:da:ba:24,111908760,176,43,111908584,111908760
16468,6,12,1,2412,-64,-91,27,40:e3:d6:da:ba:25,111908970,160,50,111908810,111908970
16469,6,6,1,2412,-64,-91,27,40:e3:d6:da:ba:26,111909180,380,-170,111908800,111909180
16470,4,1,1,2412,-81,-91,10,54:e4:3a:ec:fb:64,111965518,2160,54178,111963358,111965518
16471,6,12,1,2412,-64,-91,27,40:e3:d6:da:ba:20,112010125,160,44447,112009965,112010125
16472,6,12,1,2412,-65,-91,26,40:e3:d6:da:ba:23,112010955,184,646,112010771,112010955
16473,6,12,1,2412,-64,-91,27,40:e3:d6:da:ba:24,112011164,176,33,112010988,112011164
16474,6,12,1,2412,-64,-91,27,40:e3:d6:da:ba:25,112011375,160,51,112011215,112011375
16475,6,6,1,2412,-64,-91,27,40:e3:d6:da:ba:26,112011585,380,-170,112011205,112011585
16476,6,6,1,2412,-79,-91,12,84:1b:5e:df:1b:99,112015550,80,3885,112015470,112015550
16477,6,6,1,2412,-68,-91,23,e6:aa:ea:c9:ea:33,112025784,408,9826,112025376,112025784
16478,4,1,1,2412,-90,-91,1,a4:e5:7c:28:b1:d3,112028167,688,1695,112027479,112028167
16479,6,6,1,2412,-83,-91,8,e6:aa:ea:b7:4a:dd,112033348,408,4773,112032940,112033348
16480,6,6,1,2412,-68,-91,23,e6:aa:ea:c9:ea:33,112037971,408,4215,112037563,112037971
16481,6,6,1,2412,-85,-91,6,e6:aa:ea:b7:4a:dd,112045470,408,7091,112045062,112045470
16482,6,6,1,2412,-68,-91,23,e6:aa:ea:c9:ea:33,112050015,408,4137,112049607,112050015
16483,4,1,1,2412,-83,-91,8,a6:e5:7c:28:b1:d3,112055602,992,4595,112054610,112055602
16484,6,6,1,2412,-84,-91,7,e6:aa:ea:b7:4a:dd,112057587,408,1577,112057179,112057587
16485,6,6,1,2412,-68,-91,23,e6:aa:ea:c9:ea:33,112062146,408,4151,112061738,112062146
16486,4,1,1,2412,-82,-91,9,54:e4:3a:ec:fb:64,112067917,2160,3611,112065757,112067917
16487,6,6,1,2412,-68,-91,23,e6:aa:ea:c9:ea:33,112074248,408,5923,112073840,112074248
16488,6,6,1,2412,-84,-91,7,e6:aa:ea:b7:4a:dd,112081818,408,7162,112081410,112081818
16489,4,1,1,2412,-76,-91,15,b8:3a:5a:88:e6:e0,112096261,2360,12083,112093901,112096261
16490,4,1,1,2412,-75,-91,16,b8:3a:5a:88:e6:e1,112098659,2376,22,112096283,112098659
16491,6,12,1,2412,-65,-91,26,40:e3:d6:da:ba:20,112112508,160,13689,112112348,112112508
16492,6,6,1,2412,-64,-91,27,40:e3:d6:da:ba:21,112112734,368,-142,112112366,112112734
16493,6,12,1,2412,-64,-91,27,40:e3:d6:da:ba:22,112113130,180,216,112112950,112113130
16494,6,12,1,2412,-64,-91,27,40:e3:d6:da:ba:23,112113362,184,48,112113178,112113362
16495,6,12,1,2412,-64,-91,27,40:e3:d6:da:ba:24,112113581,176,43,112113405,112113581
16496,6,12,1,2412,-64,-91,27,40:e3:d6:da:ba:25,112113800,160,59,112113640,112113800
16497,6,6,1,2412,-64,-91,27,40:e3:d6:da:ba:26,112114019,380,-161,112113639,112114019
16498,4,1,1,2412,-91,-91,0,c0:c9:e3:4d:6e:bf,112148450,872,33559,112147578,112148450
16499,4,1,1,2412,-90,-91,1,,112192348,304,43594,112192044,112192348
16500,4,1,1,2412,-62,-91,29,b8:3a:5a:88:e6:e0,112198661,2360,3953,112196301,112198661
16501,6,12,1,2412,-64,-91,27,40:e3:d6:da:ba:22,112215517,180,16676,112215337,112215517
16502,6,12,1,2412,-64,-91,27,40:e3:d6:da:ba:24,112215968,176,275,112215792,112215968
16503,6,12,1,2412,-63,-91,28,40:e3:d6:da:ba:25,112216178,160,50,112216018,112216178
16504,4,1,1,2412,-81,-91,10,54:e4:3a:ec:fb:64,112272805,2160,54467,112270645,112272805
16505,4,1,1,2412,-79,-91,12,00:c0:ca:b0:52:aa,112286677,696,13176,112285981,112286677
16506,4,1,1,2412,-83,-91,8,b8:3a:5a:88:e6:e0,112301209,2360,12172,112298849,112301209
16507,6,12,1,2412,-64,-91,27,40:e3:d6:da:ba:20,112317323,160,15954,112317163,112317323
16508,6,6,1,2412,-64,-91,27,40:e3:d6:da:ba:21,112317542,368,-149,112317174,112317542
16509,6,12,1,2412,-64,-91,27,40:e3:d6:da:ba:24,112318380,176,662,112318204,112318380
16510,6,12,1,2412,-65,-91,26,40:e3:d6:da:ba:20,112419724,160,101184,112419564,112419724
16511,6,6,1,2412,-65,-91,26,40:e3:d6:da:ba:21,112419943,368,-149,112419575,112419943
16512,6,12,1,2412,-65,-91,26,40:e3:d6:da:ba:23,112420562,184,435,112420378,112420562
16513,6,12,1,2412,-65,-91,26,40:e3:d6:da:ba:24,112420790,176,52,112420614,112420790
16514,6,12,1,2412,-65,-91,26,40:e3:d6:da:ba:25,112420991,160,41,112420831,112420991
16515,6,6,1,2412,-65,-91,26,40:e3:d6:da:ba:26,112421297,380,-74,112420917,112421297
16516,4,1,1,2412,-76,-91,15,b8:3a:5a:88:e6:e0,112505875,2360,82218,112503515,112505875
16517,4,1,1,2412,-78,-91,13,b8:3a:5a:88:e6:e1,112508255,2376,4,112505879,112508255
16518,6,6,1,2412,-72,-91,19,e6:aa:ea:c9:ea:33,112545851,408,37188,112545443,112545851
16519,6,6,1,2412,-83,-91,8,e6:aa:ea:b7:4a:dd,112554392,408,8133,112553984,112554392
16520,6,6,1,2412,-73,-91,18,e6:aa:ea:c9:ea:33,112557972,408,3172,112557564,112557972
16521,6,6,1,2412,-84,-91,7,e6:aa:ea:b7:4a:dd,112566516,408,8136,112566108,112566516
16522,6,6,1,2412,-84,-91,7,e6:aa:ea:b7:4a:dd,112578632,408,11708,112578224,112578632
16523,4,1,1,2412,-83,-91,8,54:e4:3a:ec:fb:64,112579912,2160,-880,112577752,112579912
16524,6,6,1,2412,-73,-91,18,e6:aa:ea:c9:ea:33,112582204,408,1884,112581796,112582204
16525,6,6,1,2412,-84,-91,7,e6:aa:ea:b7:4a:dd,112590753,408,8141,112590345,112590753
16526,6,6,1,2412,-73,-91,18,e6:aa:ea:c9:ea:33,112594326,408,3165,112593918,112594326
16527,4,1,1,2412,-75,-91,16,b8:3a:5a:88:e6:e0,112608275,2360,11589,112605915,112608275
16528,4,1,1,2412,-76,-91,15,b8:3a:5a:88:e6:e1,112610682,2376,31,112608306,112610682
16529,6,12,1,2412,-67,-91,24,40:e3:d6:da:ba:20,112624526,160,13684,112624366,112624526
16530,6,6,1,2412,-66,-91,25,40:e3:d6:da:ba:21,112624718,368,-176,112624350,112624718
16531,6,12,1,2412,-66,-91,25,40:e3:d6:da:ba:22,112625123,180,225,112624943,112625123
16532,6,12,1,2412,-66,-91,25,40:e3:d6:da:ba:23,112625371,184,64,112625187,112625371
16533,6,12,1,2412,-66,-91,25,40:e3:d6:da:ba:24,112625608,176,61,112625432,112625608
16534,6,12,1,2412,-67,-91,24,40:e3:d6:da:ba:25,112625837,160,69,112625677,112625837
16535,6,6,1,2412,-67,-91,24,40:e3:d6:da:ba:26,112626055,380,-162,112625675,112626055
16536,4,1,1,2412,-85,-91,6,c0:c9:e3:4d:6e:bf,112636627,872,9700,112635755,112636627
16537,4,1,1,2412,-82,-91,9,54:e4:3a:ec:fb:64,112682311,2160,43524,112680151,112682311
16538,4,1,1,2412,-76,-91,15,b8:3a:5a:88:e6:e0,112712138,2360,27467,112709778,112712138
16539,4,1,1,2412,-76,-91,15,b8:3a:5a:88:e6:e1,112714517,2376,3,112712141,112714517
16540,6,12,1,2412,-64,-91,27,40:e3:d6:da:ba:20,112726906,160,12229,112726746,112726906
16541,6,6,1,2412,-64,-91,27,40:e3:d6:da:ba:21,112727098,368,-176,112726730,112727098
16542,6,12,1,2412,-64,-91,27,40:e3:d6:da:ba:22,112727494,180,216,112727314,112727494
16543,4,1,1,2412,-77,-91,14,b8:3a:5a:88:e6:e0,112813115,2360,83261,112810755,112813115
16544,4,1,1,2412,-77,-91,14,b8:3a:5a:88:e6:e1,112815495,2376,4,112813119,112815495
16545,6,6,1,2412,-62,-91,29,40:e3:d6:da:ba:21,112829516,368,13653,112829148,112829516
16546,6,12,1,2412,-62,-91,29,40:e3:d6:da:ba:22,112829912,180,216,112829732,112829912
16547,6,12,1,2412,-62,-91,29,40:e3:d6:da:ba:23,112830117,184,21,112829933,112830117
16548,6,12,1,2412,-62,-91,29,40:e3:d6:da:ba:24,112830326,176,33,112830150,112830326
16549,6,12,1,2412,-62,-91,29,40:e3:d6:da:ba:25,112830537,160,51,112830377,112830537
16550,6,6,1,2412,-62,-91,29,40:e3:d6:da:ba:26,112830738,380,-179,112830358,112830738
16551,4,1,1,2412,-80,-91,11,54:e4:3a:ec:fb:64,112887108,2160,54210,112884948,112887108
16552,6,6,1,2412,-82,-91,9,e6:aa:ea:b7:4a:dd,112894930,408,7414,112894522,112894930
16553,4,1,1,2412,-73,-91,18,b8:3a:5a:88:e6:e1,112917911,2376,20605,112915535,112917911
16554,6,12,1,2412,-62,-91,29,40:e3:d6:da:ba:20,112931726,160,13655,112931566,112931726
16555,6,6,1,2412,-62,-91,29,40:e3:d6:da:ba:21,112931918,368,-176,112931550,112931918
16556,6,12,1,2412,-62,-91,29,40:e3:d6:da:ba:22,112932305,180,207,112932125,112932305
16557,6,12,1,2412,-61,-91,30,40:e3:d6:da:ba:23,112932511,184,22,112932327,112932511
16558,6,12,1,2412,-62,-91,29,40:e3:d6:da:ba:24,112932738,176,51,112932562,112932738
16559,6,12,1,2412,-62,-91,29,40:e3:d6:da:ba:25,112932939,160,41,112932779,112932939
16560,6,6,1,2412,-62,-91,29,40:e3:d6:da:ba:26,112933140,380,-179,112932760,112933140
16561,4,1,1,2412,-73,-91,18,54:e4:3a:ec:fb:64,112989509,2160,54209,112987349,112989509
16562,4,1,1,2412,-75,-91,16,b8:3a:5a:88:e6:e0,113017889,2360,26020,113015529,113017889
16563,6,12,1,2412,-63,-91,28,40:e3:d6:da:ba:20,113034107,160,16058,113033947,113034107
16564,6,6,1,2412,-62,-91,29,40:e3:d6:da:ba:21,113034326,368,-149,113033958,113034326
16565,6,12,1,2412,-62,-91,29,40:e3:d6:da:ba:22,113034777,180,271,113034597,113034777
16566,6,12,1,2412,-62,-91,29,40:e3:d6:da:ba:23,113034991,184,30,113034807,113034991
16567,6,12,1,2412,-62,-91,29,40:e3:d6:da:ba:24,113035219,176,52,113035043,113035219
16568,6,12,1,2412,-62,-91,29,40:e3:d6:da:ba:25,113035429,160,50,113035269,113035429
16569,6,6,1,2412,-62,-91,29,40:e3:d6:da:ba:26,113035648,380,-161,113035268,113035648
16570,6,6,1,2412,-73,-91,18,e6:aa:ea:c9:ea:33,113066322,408,30266,113065914,113066322
16571,6,6,1,2412,-72,-91,19,e6:aa:ea:c9:ea:33,113078775,408,12045,113078367,113078775
16572,6,6,1,2412,-73,-91,18,e6:aa:ea:c9:ea:33,113090559,408,11376,113090151,113090559
16573,4,1,1,2412,-79,-91,12,54:e4:3a:ec:fb:64,113091936,2160,-783,113089776,113091936
16574,6,6,1,2412,-73,-91,18,e6:aa:ea:c9:ea:33,113102662,408,10318,113102254,113102662
16575,6,6,1,2412,-72,-91,19,e6:aa:ea:c9:ea:33,113114775,408,11705,113114367,113114775
16576,4,1,1,2412,-76,-91,15,b8:3a:5a:88:e6:e0,113120284,2360,3149,113117924,113120284
16577,6,12,1,2412,-65,-91,26,40:e3:d6:da:ba:20,113136534,160,16090,113136374,113136534
16578,6,6,1,2412,-66,-91,25,40:e3:d6:da:ba:21,113136735,368,-167,113136367,113136735
16579,6,12,1,2412,-65,-91,26,40:e3:d6:da:ba:22,113137122,180,207,113136942,113137122
16580,6,12,1,2412,-65,-91,26,40:e3:d6:da:ba:23,113137328,184,22,113137144,113137328
16581,6,12,1,2412,-64,-91,27,40:e3:d6:da:ba:24,113137546,176,42,113137370,113137546
16582,6,6,1,2412,-65,-91,26,40:e3:d6:da:ba:26,113137985,380,59,113137605,113137985
16583,6,6,1,2412,-80,-91,11,e6:aa:ea:b7:4a:dd,113198872,408,60479,113198464,113198872
16584,6,12,1,2412,-68,-91,23,40:e3:d6:da:ba:20,113238925,160,39893,113238765,113238925
16585,6,6,1,2412,-68,-91,23,40:e3:d6:da:ba:21,113239135,368,-158,113238767,113239135
16586,6,12,1,2412,-68,-91,23,40:e3:d6:da:ba:22,113239531,180,216,113239351,113239531
16587,6,12,1,2412,-68,-91,23,40:e3:d6:da:ba:23,113239737,184,22,113239553,113239737
16588,6,12,1,2412,-68,-91,23,40:e3:d6:da:ba:24,113239955,176,42,113239779,113239955
16589,6,12,1,2412,-68,-91,23,40:e3:d6:da:ba:25,113240175,160,60,113240015,113240175
16590,4,1,1,2412,-80,-91,11,b8:3a:5a:88:e6:e1,113285107,2256,42676,113282851,113285107
16591,4,1,1,2412,-77,-91,14,54:e4:3a:ec:fb:64,113296706,2160,9439,113294546,113296706
16592,6,12,1,2412,-67,-91,24,40:e3:d6:da:ba:20,113341310,160,44444,113341150,113341310
16593,6,6,1,2412,-67,-91,24,40:e3:d6:da:ba:21,113341511,368,-167,113341143,113341511
16594,6,12,1,2412,-67,-91,24,40:e3:d6:da:ba:22,113341897,180,206,113341717,113341897
16595,6,12,1,2412,-67,-91,24,40:e3:d6:da:ba:23,113342121,184,40,113341937,113342121
16596,6,12,1,2412,-67,-91,24,40:e3:d6:da:ba:24,113342331,176,34,113342155,113342331
16597,6,12,1,2412,-67,-91,24,40:e3:d6:da:ba:25,113342532,160,41,113342372,113342532
16598,6,6,1,2412,-67,-91,24,40:e3:d6:da:ba:26,113342724,380,-188,113342344,113342724
16599,6,12,1,2412,-61,-91,30,40:e3:d6:da:ba:20,113443708,160,100824,113443548,113443708
16600,6,6,1,2412,-62,-91,29,40:e3:d6:da:ba:21,113443918,368,-158,113443550,113443918
16601,6,12,1,2412,-61,-91,30,40:e3:d6:da:ba:23,113444547,184,445,113444363,113444547
16602,6,12,1,2412,-61,-91,30,40:e3:d6:da:ba:24,113444765,176,42,113444589,113444765
16603,6,12,1,2412,-62,-91,29,40:e3:d6:da:ba:25,113444994,160,69,113444834,113444994
16604,6,6,1,2412,-61,-91,30,40:e3:d6:da:ba:26,113445186,380,-188,113444806,113445186
16605,6,6,1,2412,-73,-91,18,e6:aa:ea:c9:ea:33,113483678,408,38084,113483270,113483678
16606,6,6,1,2412,-73,-91,18,e6:aa:ea:c9:ea:33,113495966,408,11880,113495558,113495966
16607,6,6,1,2412,-74,-91,17,e6:aa:ea:c9:ea:33,113507957,408,11583,113507549,113507957
16608,6,6,1,2412,-74,-91,17,e6:aa:ea:c9:ea:33,113520039,408,11674,113519631,113520039
16609,6,6,1,2412,-80,-91,11,e6:aa:ea:b7:4a:dd,113526188,408,5741,113525780,113526188
16610,4,1,1,2412,-79,-91,12,b8:3a:5a:88:e6:e0,113529865,2360,1317,113527505,113529865
16611,6,6,1,2412,-81,-91,10,e6:aa:ea:b7:4a:dd,113538306,408,8033,113537898,113538306
16612,6,12,1,2412,-66,-91,25,40:e3:d6:da:ba:20,113546114,160,7648,113545954,113546114
16613,6,6,1,2412,-66,-91,25,40:e3:d6:da:ba:21,113546306,368,-176,113545938,113546306
16614,6,12,1,2412,-65,-91,26,40:e3:d6:da:ba:22,113546702,180,216,113546522,113546702
16615,6,12,1,2412,-66,-91,25,40:e3:d6:da:ba:23,113547028,184,142,113546844,113547028
16616,6,12,1,2412,-66,-91,25,40:e3:d6:da:ba:24,113547255,176,51,113547079,113547255
16617,6,12,1,2412,-66,-91,25,40:e3:d6:da:ba:25,113547475,160,60,113547315,113547475
16618,6,6,1,2412,-66,-91,25,40:e3:d6:da:ba:26,113547676,380,-179,113547296,113547676
16619,6,6,1,2412,-82,-91,9,e6:aa:ea:b7:4a:dd,113550432,408,2348,113550024,113550432
16620,4,1,1,2412,-92,-91,-1,,113558511,304,7775,113558207,113558511
16621,4,1,1,2412,-78,-91,13,54:e4:3a:ec:fb:64,113604194,2160,43523,113602034,113604194
16622,4,1,1,2412,-77,-91,14,54:e4:3a:ec:fb:64,113606383,2112,77,113604271,113606383
16623,4,1,1,2412,-77,-91,14,54:e4:3a:ec:fb:64,113613606,2112,5111,113611494,113613606
16624,4,1,1,2412,-77,-91,14,54:e4:3a:ec:fb:64,113615810,2112,92,113613698,113615810
16625,4,1,1,2412,-78,-91,13,b8:3a:5a:88:e6:e0,113632280,2360,14110,113629920,113632280
16626,6,12,1,2412,-61,-91,30,40:e3:d6:da:ba:20,113648527,160,16087,113648367,113648527
16627,6,6,1,2412,-61,-91,30,40:e3:d6:da:ba:21,113648728,368,-167,113648360,113648728
16628,6,12,1,2412,-61,-91,30,40:e3:d6:da:ba:22,113649142,180,234,113648962,113649142
16629,6,12,1,2412,-61,-91,30,40:e3:d6:da:ba:23,113649375,184,49,113649191,113649375
16630,6,12,1,2412,-61,-91,30,40:e3:d6:da:ba:24,113649584,176,33,113649408,113649584
16631,6,12,1,2412,-61,-91,30,40:e3:d6:da:ba:25,113649813,160,69,113649653,113649813
16632,6,6,1,2412,-61,-91,30,40:e3:d6:da:ba:26,113650005,380,-188,113649625,113650005
16633,4,1,1,2412,-77,-91,14,54:e4:3a:ec:fb:64,113706302,2160,54137,113704142,113706302
16634,4,1,1,2412,-80,-91,11,b8:3a:5a:88:e6:e1,113737053,2376,28375,113734677,113737053
16635,6,12,1,2412,-60,-91,31,40:e3:d6:da:ba:20,113750932,160,13719,113750772,113750932
16636,6,6,1,2412,-60,-91,31,40:e3:d6:da:ba:21,113751151,368,-149,113750783,113751151
16637,6,12,1,2412,-60,-91,31,40:e3:d6:da:ba:22,113751566,180,235,113751386,113751566
16638,6,12,1,2412,-60,-91,31,40:e3:d6:da:ba:23,113751789,184,39,113751605,113751789
16639,6,12,1,2412,-60,-91,31,40:e3:d6:da:ba:25,113752353,160,404,113752193,113752353
16640,4,1,1,2412,-81,-91,10,54:e4:3a:ec:fb:64,113808700,2160,54187,113806540,113808700
16641,6,6,1,2412,-83,-91,8,e6:aa:ea:b7:4a:dd,113816187,408,7079,113815779,113816187
16642,6,6,1,2412,-83,-91,8,e6:aa:ea:b7:4a:dd,113828306,408,11711,113827898,113828306
16643,4,1,1,2412,-80,-91,11,b8:3a:5a:88:e6:e0,113837078,2360,6412,113834718,113837078
16644,4,1,1,2412,-80,-91,11,b8:3a:5a:88:e6:e1,113839558,2376,104,113837182,113839558
16645,6,6,1,2412,-83,-91,8,e6:aa:ea:b7:4a:dd,113852540,408,12574,113852132,113852540
16646,6,12,1,2412,-61,-91,30,40:e3:d6:da:ba:20,113853310,160,610,113853150,113853310
16647,6,6,1,2412,-60,-91,31,40:e3:d6:da:ba:21,113853502,368,-176,113853134,113853502
16648,6,12,1,2412,-60,-91,31,40:e3:d6:da:ba:22,113853907,180,225,113853727,113853907
16649,6,12,1,2412,-61,-91,30,40:e3:d6:da:ba:23,113854130,184,39,113853946,113854130
16650,6,12,1,2412,-60,-91,31,40:e3:d6:da:ba:24,113854340,176,34,113854164,113854340
16651,6,12,1,2412,-60,-91,31,40:e3:d6:da:ba:25,113854568,160,68,113854408,113854568
16652,6,6,1,2412,-60,-91,31,40:e3:d6:da:ba:26,113854769,380,-179,113854389,113854769
16653,4,1,1,2412,-76,-91,15,b8:3a:5a:88:e6:e0,113939564,2360,82435,113937204,113939564
16654,4,1,1,2412,-75,-91,16,b8:3a:5a:88:e6:e1,113941953,2376,13,113939577,113941953
16655,6,12,1,2412,-60,-91,31,40:e3:d6:da:ba:20,113955731,160,13618,113955571,113955731
16656,6,6,1,2412,-60,-91,31,40:e3:d6:da:ba:21,113955950,368,-149,113955582,113955950
16657,6,12,1,2412,-60,-91,31,40:e3:d6:da:ba:22,113956364,180,234,113956184,113956364
16658,6,12,1,2412,-60,-91,31,40:e3:d6:da:ba:23,113956579,184,31,113956395,113956579
16659,6,12,1,2412,-60,-91,31,40:e3:d6:da:ba:24,113956797,176,42,113956621,113956797
16660,6,12,1,2412,-60,-91,31,40:e3:d6:da:ba:25,113957026,160,69,113956866,113957026
16661,6,6,1,2412,-60,-91,31,40:e3:d6:da:ba:26,113957244,380,-162,113956864,113957244
16662,6,6,1,2412,-72,-91,19,e6:aa:ea:c9:ea:33,114003586,408,45934,114003178,114003586
16663,6,6,1,2412,-71,-91,20,e6:aa:ea:c9:ea:33,114015698,408,11704,114015290,114015698
16664,6,6,1,2412,-71,-91,20,e6:aa:ea:c9:ea:33,114039932,408,23826,114039524,114039932
16665,4,1,1,2412,-78,-91,13,b8:3a:5a:88:e6:e0,114041866,2360,-426,114039506,114041866
16666,6,6,1,2412,-60,-91,31,40:e3:d6:da:ba:21,114058309,368,16075,114057941,114058309
16667,6,12,1,2412,-54,-91,37,40:e3:d6:da:ba:23,114058928,184,435,114058744,114058928
16668,6,12,1,2412,-53,-91,38,40:e3:d6:da:ba:24,114059176,176,72,114059000,114059176
16669,6,12,1,2412,-51,-91,40,40:e3:d6:da:ba:25,114059388,160,52,114059228,114059388
16670,6,6,1,2412,-52,-91,39,40:e3:d6:da:ba:26,114059600,380,-168,114059220,114059600
16671,4,1,1,2412,-81,-91,10,54:e4:3a:ec:fb:64,114115898,2160,54138,114113738,114115898
16672,6,12,1,2412,-60,-91,31,40:e3:d6:da:ba:20,114160524,160,44466,114160364,114160524
16673,6,6,1,2412,-60,-91,31,40:e3:d6:da:ba:21,114160716,368,-176,114160348,114160716
16674,6,12,1,2412,-60,-91,31,40:e3:d6:da:ba:22,114161130,180,234,114160950,114161130
16675,6,12,1,2412,-60,-91,31,40:e3:d6:da:ba:23,114161353,184,39,114161169,114161353
16676,6,12,1,2412,-60,-91,31,40:e3:d6:da:ba:24,114161563,176,34,114161387,114161563
16677,6,12,1,2412,-60,-91,31,40:e3:d6:da:ba:25,114161764,160,41,114161604,114161764
16678,6,6,1,2412,-60,-91,31,40:e3:d6:da:ba:26,114161956,380,-188,114161576,114161956
16679,4,1,1,2412,-80,-91,11,54:e4:3a:ec:fb:64,114218297,2160,54181,114216137,114218297
16680,4,1,1,2412,-91,-91,0,,114236168,304,17567,114235864,114236168
16681,4,1,1,2412,-79,-91,12,b8:3a:5a:88:e6:e0,114246668,2360,8140,114244308,114246668
16682,4,1,1,2412,-78,-91,13,b8:3a:5a:88:e6:e1,114249056,2376,12,114246680,114249056
16683,6,12,1,2412,-60,-91,31,40:e3:d6:da:ba:20,114262912,160,13696,114262752,114262912
16684,6,6,1,2412,-60,-91,31,40:e3:d6:da:ba:21,114263131,368,-149,114262763,114263131
16685,6,12,1,2412,-60,-91,31,40:e3:d6:da:ba:22,114263518,180,207,114263338,114263518
16686,6,12,1,2412,-60,-91,31,40:e3:d6:da:ba:23,114263751,184,49,114263567,114263751
16687,6,12,1,2412,-60,-91,31,40:e3:d6:da:ba:24,114263969,176,42,114263793,114263969
16688,6,12,1,2412,-60,-91,31,40:e3:d6:da:ba:25,114264171,160,42,114264011,114264171
16689,6,6,1,2412,-60,-91,31,40:e3:d6:da:ba:26,114264390,380,-161,114264010,114264390
16690,4,1,1,2412,-92,-91,-1,a6:e5:7c:28:b1:d3,114308334,992,42952,114307342,114308334
16691,6,6,1,2412,-71,-91,20,e6:aa:ea:c9:ea:33,114319165,408,10423,114318757,114319165
16692,4,1,1,2412,-80,-91,11,54:e4:3a:ec:fb:64,114320697,2160,-628,114318537,114320697
16693,6,6,1,2412,-71,-91,20,e6:aa:ea:c9:ea:33,114343404,408,22299,114342996,114343404
16694,6,6,1,2412,-83,-91,8,e6:aa:ea:b7:4a:dd,114348239,408,4427,114347831,114348239
16695,4,1,1,2412,-78,-91,13,b8:3a:5a:88:e6:e0,114349240,2360,-1359,114346880,114349240
16696,4,1,1,2412,-78,-91,13,b8:3a:5a:88:e6:e0,114356309,2240,4829,114354069,114356309
16697,4,1,1,2412,-78,-91,13,b8:3a:5a:88:e6:e1,114358604,2256,39,114356348,114358604
16698,6,12,1,2412,-60,-91,31,40:e3:d6:da:ba:22,114366305,180,7521,114366125,114366305
16699,6,12,1,2412,-61,-91,30,40:e3:d6:da:ba:23,114366520,184,31,114366336,114366520
16700,6,12,1,2412,-61,-91,30,40:e3:d6:da:ba:24,114366730,176,34,114366554,114366730
16701,6,12,1,2412,-61,-91,30,40:e3:d6:da:ba:25,114366931,160,41,114366771,114366931
16702,6,6,1,2412,-61,-91,30,40:e3:d6:da:ba:26,114367123,380,-188,114366743,114367123
16703,6,6,1,2412,-84,-91,7,e6:aa:ea:b7:4a:dd,114372480,408,4949,114372072,114372480
16704,6,6,1,2412,-85,-91,6,e6:aa:ea:b7:4a:dd,114384601,408,11713,114384193,114384601
16705,4,1,1,2412,-92,-91,-1,a6:e5:7c:28:b1:d3,114410533,992,24940,114409541,114410533
16706,4,1,1,2412,-78,-91,13,b8:3a:5a:88:e6:e0,114451481,2360,38588,114449121,114451481
16707,6,12,1,2412,-63,-91,28,40:e3:d6:da:ba:20,114467943,160,16302,114467783,114467943
16708,6,6,1,2412,-63,-91,28,40:e3:d6:da:ba:21,114468153,368,-158,114467785,114468153
16709,6,12,1,2412,-63,-91,28,40:e3:d6:da:ba:22,114468549,180,216,114468369,114468549
16710,6,12,1,2412,-63,-91,28,40:e3:d6:da:ba:23,114468755,184,22,114468571,114468755
16711,6,12,1,2412,-63,-91,28,40:e3:d6:da:ba:24,114468964,176,33,114468788,114468964
16712,6,12,1,2412,-64,-91,27,40:e3:d6:da:ba:25,114469175,160,51,114469015,114469175
16713,6,6,1,2412,-63,-91,28,40:e3:d6:da:ba:26,114469393,380,-162,114469013,114469393
16714,4,1,1,2412,-75,-91,16,b8:3a:5a:88:e6:e0,114553868,2360,82115,114551508,114553868
16715,6,12,1,2412,-66,-91,25,40:e3:d6:da:ba:20,114570114,160,16086,114569954,114570114
16716,6,6,1,2412,-66,-91,25,40:e3:d6:da:ba:21,114570333,368,-149,114569965,114570333
16717,6,12,1,2412,-65,-91,26,40:e3:d6:da:ba:22,114570729,180,216,114570549,114570729
16718,6,12,1,2412,-65,-91,26,40:e3:d6:da:ba:23,114570962,184,49,114570778,114570962
16719,6,12,1,2412,-65,-91,26,40:e3:d6:da:ba:24,114571198,176,60,114571022,114571198
16720,6,12,1,2412,-66,-91,25,40:e3:d6:da:ba:25,114571400,160,42,114571240,114571400
16721,6,6,1,2412,-66,-91,25,40:e3:d6:da:ba:26,114571610,380,-170,114571230,114571610
16722,4,1,1,2412,-91,-91,0,a6:e5:7c:28:b1:d3,114615889,992,43287,114614897,114615889
16723,6,6,1,2412,-82,-91,9,e6:aa:ea:b7:4a:dd,114651893,408,35596,114651485,114651893
16724,4,1,1,2412,-47,-91,44,b8:3a:5a:88:e6:e1,114659167,2376,4898,114656791,114659167
16725,6,12,1,2412,-66,-91,25,40:e3:d6:da:ba:23,114673353,184,14002,114673169,114673353
16726,6,6,1,2412,-66,-91,25,40:e3:d6:da:ba:26,114673992,380,259,114673612,114673992
16727,6,6,1,2412,-82,-91,9,e6:aa:ea:b7:4a:dd,114676122,408,1722,114675714,114676122
16728,6,6,1,2412,-82,-91,9,e6:aa:ea:b7:4a:dd,114688176,408,11646,114687768,114688176
16729,6,6,1,2412,-83,-91,8,e6:aa:ea:b7:4a:dd,114700300,408,11716,114699892,114700300
16730,4,1,1,2412,-82,-91,9,b8:3a:5a:88:e6:e0,114759075,2360,56415,114756715,114759075
16731,4,1,1,2412,-82,-91,9,b8:3a:5a:88:e6:e1,114761528,2376,77,114759152,114761528
16732,6,12,1,2412,-66,-91,25,40:e3:d6:da:ba:20,114774915,160,13227,114774755,114774915
16733,6,6,1,2412,-66,-91,25,40:e3:d6:da:ba:21,114775116,368,-167,114774748,114775116
16734,6,12,1,2412,-66,-91,25,40:e3:d6:da:ba:22,114775503,180,207,114775323,114775503
16735,6,12,1,2412,-65,-91,26,40:e3:d6:da:ba:23,114775709,184,22,114775525,114775709
16736,6,12,1,2412,-66,-91,25,40:e3:d6:da:ba:24,114775927,176,42,114775751,114775927
16737,6,12,1,2412,-66,-91,25,40:e3:d6:da:ba:25,114776129,160,42,114775969,114776129
16738,6,6,1,2412,-65,-91,26,40:e3:d6:da:ba:26,114776339,380,-170,114775959,114776339
16739,6,6,1,2412,-69,-91,22,e6:aa:ea:c9:ea:33,114839849,408,63102,114839441,114839849
16740,6,6,1,2412,-69,-91,22,e6:aa:ea:c9:ea:33,114854368,408,14111,114853960,114854368
16741,4,1,1,2412,-82,-91,9,b8:3a:5a:88:e6:e0,114861076,2360,4348,114858716,114861076
16742,6,6,1,2412,-70,-91,21,e6:aa:ea:c9:ea:33,114876264,408,14780,114875856,114876264
16743,6,12,1,2412,-66,-91,25,40:e3:d6:da:ba:20,114877340,160,916,114877180,114877340
16744,6,6,1,2412,-66,-91,25,40:e3:d6:da:ba:21,114877559,368,-149,114877191,114877559
16745,6,12,1,2412,-65,-91,26,40:e3:d6:da:ba:22,114877973,180,234,114877793,114877973
16746,6,12,1,2412,-65,-91,26,40:e3:d6:da:ba:23,114878206,184,49,114878022,114878206
16747,6,12,1,2412,-66,-91,25,40:e3:d6:da:ba:24,114878415,176,33,114878239,114878415
16748,6,12,1,2412,-65,-91,26,40:e3:d6:da:ba:25,114878616,160,41,114878456,114878616
16749,6,6,1,2412,-65,-91,26,40:e3:d6:da:ba:26,114878835,380,-161,114878455,114878835
16750,6,6,1,2412,-80,-91,11,84:1b:5e:df:1b:99,114937326,80,58411,114937246,114937326
16751,4,1,1,2412,-84,-91,7,b8:3a:5a:88:e6:e1,114965949,2376,26247,114963573,114965949
16752,6,12,1,2412,-67,-91,24,40:e3:d6:da:ba:20,114979715,160,13606,114979555,114979715
16753,6,6,1,2412,-67,-91,24,40:e3:d6:da:ba:21,114979907,368,-176,114979539,114979907
16754,6,12,1,2412,-66,-91,25,40:e3:d6:da:ba:22,114980294,180,207,114980114,114980294
16755,6,12,1,2412,-67,-91,24,40:e3:d6:da:ba:25,114980947,160,493,114980787,114980947
16756,6,6,1,2412,-67,-91,24,40:e3:d6:da:ba:26,114981148,380,-179,114980768,114981148
16757,4,1,1,2412,-85,-91,6,54:e4:3a:ec:fb:64,115037489,2160,54181,115035329,115037489
16758,4,1,1,2412,-82,-91,9,b8:3a:5a:88:e6:e0,115065895,2360,26046,115063535,115065895
16759,6,12,1,2412,-69,-91,22,40:e3:d6:da:ba:20,115082131,160,16076,115081971,115082131
16760,6,6,1,2412,-69,-91,22,40:e3:d6:da:ba:21,115082341,368,-158,115081973,115082341
16761,6,12,1,2412,-68,-91,23,40:e3:d6:da:ba:23,115082943,184,418,115082759,115082943
16762,6,12,1,2412,-68,-91,23,40:e3:d6:da:ba:24,115083161,176,42,115082985,115083161
16763,6,12,1,2412,-69,-91,22,40:e3:d6:da:ba:25,115083380,160,59,115083220,115083380
16764,6,6,1,2412,-68,-91,23,40:e3:d6:da:ba:26,115083590,380,-170,115083210,115083590
16765,4,1,1,2412,-82,-91,9,54:e4:3a:ec:fb:64,115139888,2160,54138,115137728,115139888
16766,6,6,1,2412,-68,-91,23,e6:aa:ea:c9:ea:33,115154819,408,14523,115154411,115154819
16767,6,6,1,2412,-68,-91,23,e6:aa:ea:c9:ea:33,115166968,408,11741,115166560,115166968
16768,4,1,1,2412,-91,-91,0,c0:c9:e3:4d:6e:bf,115168297,872,457,115167425,115168297
16769,4,1,1,2412,-92,-91,-1,,115169186,304,585,115168882,115169186
16770,4,1,1,2412,-78,-91,13,b8:3a:5a:88:e6:e0,115169535,2360,-2011,115167175,115169535
16771,4,1,1,2412,-78,-91,13,b8:3a:5a:88:e6:e1,115171914,2376,3,115169538,115171914
16772,6,6,1,2412,-68,-91,23,e6:aa:ea:c9:ea:33,115179045,408,6723,115178637,115179045
16773,6,12,1,2412,-68,-91,23,40:e3:d6:da:ba:20,115184674,160,5469,115184514,115184674
16774,6,6,1,2412,-68,-91,23,40:e3:d6:da:ba:21,115184866,368,-176,115184498,115184866
16775,6,12,1,2412,-68,-91,23,40:e3:d6:da:ba:22,115185271,180,225,115185091,115185271
16776,6,12,1,2412,-68,-91,23,40:e3:d6:da:ba:23,115185494,184,39,115185310,115185494
16777,6,12,1,2412,-68,-91,23,40:e3:d6:da:ba:24,115185722,176,52,115185546,115185722
16778,6,12,1,2412,-68,-91,23,40:e3:d6:da:ba:25,115185950,160,68,115185790,115185950
16779,6,6,1,2412,-68,-91,23,40:e3:d6:da:ba:26,115186160,380,-170,115185780,115186160
16780,6,6,1,2412,-68,-91,23,e6:aa:ea:c9:ea:33,115191154,408,4586,115190746,115191154
16781,6,6,1,2412,-68,-91,23,e6:aa:ea:c9:ea:33,115203260,408,11698,115202852,115203260
16782,6,6,1,2412,-80,-91,11,e6:aa:ea:b7:4a:dd,115208472,408,4804,115208064,115208472
16783,4,1,1,2412,-85,-91,6,54:e4:3a:ec:fb:64,115242289,2160,31657,115240129,115242289
16784,6,12,1,2412,-66,-91,25,40:e3:d6:da:ba:20,115286925,160,44476,115286765,115286925
16785,6,6,1,2412,-66,-91,25,40:e3:d6:da:ba:21,115287117,368,-176,115286749,115287117
16786,6,12,1,2412,-66,-91,25,40:e3:d6:da:ba:22,115287513,180,216,115287333,115287513
16787,6,12,1,2412,-66,-91,25,40:e3:d6:da:ba:23,115287718,184,21,115287534,115287718
16788,4,1,1,2412,-79,-91,12,b8:3a:5a:88:e6:e1,115375463,2376,85369,115373087,115375463
16789,6,12,1,2412,-65,-91,26,40:e3:d6:da:ba:20,115389318,160,13695,115389158,115389318
16790,6,6,1,2412,-65,-91,26,40:e3:d6:da:ba:21,115389537,368,-149,115389169,115389537
16791,6,12,1,2412,-65,-91,26,40:e3:d6:da:ba:22,115389951,180,234,115389771,115389951
16792,6,12,1,2412,-66,-91,25,40:e3:d6:da:ba:23,115390174,184,39,115389990,115390174
16793,6,12,1,2412,-65,-91,26,40:e3:d6:da:ba:24,115390384,176,34,115390208,115390384
16794,6,12,1,2412,-65,-91,26,40:e3:d6:da:ba:25,115390585,160,41,115390425,115390585
16795,6,6,1,2412,-65,-91,26,40:e3:d6:da:ba:26,115390795,380,-170,115390415,115390795
16796,4,1,1,2412,-81,-91,10,b8:3a:5a:88:e6:e1,115477875,2376,84704,115475499,115477875
16797,6,12,1,2412,-68,-91,23,40:e3:d6:da:ba:23,115492547,184,14488,115492363,115492547
16798,6,6,1,2412,-68,-91,23,40:e3:d6:da:ba:26,115493168,380,241,115492788,115493168
16799,4,1,1,2412,-83,-91,8,54:e4:3a:ec:fb:64,115549486,2160,54158,115547326,115549486
16800,4,1,1,2412,-82,-91,9,b8:3a:5a:88:e6:e0,115577878,2360,26032,115575518,115577878
16801,4,1,1,2412,-82,-91,9,b8:3a:5a:88:e6:e1,115580531,2376,277,115578155,115580531
16802,6,6,1,2412,-82,-91,9,e6:aa:ea:b7:4a:dd,115589928,408,8989,115589520,115589928
16803,6,12,1,2412,-69,-91,22,40:e3:d6:da:ba:20,115594121,160,4033,115593961,115594121
16804,6,6,1,2412,-68,-91,23,40:e3:d6:da:ba:21,115594340,368,-149,115593972,115594340
16805,6,12,1,2412,-68,-91,23,40:e3:d6:da:ba:22,115594727,180,207,115594547,115594727
16806,6,12,1,2412,-68,-91,23,40:e3:d6:da:ba:23,115594960,184,49,115594776,115594960
16807,6,12,1,2412,-68,-91,23,40:e3:d6:da:ba:24,115595196,176,60,115595020,115595196
16808,6,12,1,2412,-68,-91,23,40:e3:d6:da:ba:25,115595398,160,42,115595238,115595398
16809,6,6,1,2412,-68,-91,23,40:e3:d6:da:ba:26,115595589,380,-189,115595209,115595589
16810,6,6,1,2412,-82,-91,9,e6:aa:ea:b7:4a:dd,115602042,408,6045,115601634,115602042
16811,6,6,1,2412,-80,-91,11,e6:aa:ea:b7:4a:dd,115614153,408,11703,115613745,115614153
16812,4,1,1,2412,-88,-91,3,8e:90:05:32:71:00,115627316,1128,12035,115626188,115627316
16813,4,1,1,2412,-83,-91,8,b8:3a:5a:88:e6:e0,115630023,2240,467,115627783,115630023
16814,6,6,1,2412,-81,-91,10,e6:aa:ea:b7:4a:dd,115638419,408,7988,115638011,115638419
16815,4,1,1,2412,-82,-91,9,b8:3a:5a:88:e6:e0,115648609,2240,7950,115646369,115648609
16816,4,1,1,2412,-83,-91,8,b8:3a:5a:88:e6:e1,115650886,2256,21,115648630,115650886
16817,6,6,1,2412,-70,-91,21,e6:aa:ea:c9:ea:33,115674760,408,23466,115674352,115674760
16818,4,1,1,2412,-83,-91,8,b8:3a:5a:88:e6:e0,115680533,2360,3413,115678173,115680533
16819,6,6,1,2412,-70,-91,21,e6:aa:ea:c9:ea:33,115686904,408,5963,115686496,115686904
16820,6,12,1,2412,-68,-91,23,40:e3:d6:da:ba:20,115696533,160,9469,115696373,115696533
16821,6,6,1,2412,-68,-91,23,40:e3:d6:da:ba:21,115696743,368,-158,115696375,115696743
16822,6,12,1,2412,-68,-91,23,40:e3:d6:da:ba:22,115697130,180,207,115696950,115697130
16823,6,12,1,2412,-68,-91,23,40:e3:d6:da:ba:23,115697353,184,39,115697169,115697353
16824,6,12,1,2412,-68,-91,23,40:e3:d6:da:ba:24,115697590,176,61,115697414,115697590
16825,6,12,1,2412,-68,-91,23,40:e3:d6:da:ba:25,115697818,160,68,115697658,115697818
16826,6,6,1,2412,-68,-91,23,40:e3:d6:da:ba:26,115698019,380,-179,115697639,115698019
16827,6,6,1,2412,-70,-91,21,e6:aa:ea:c9:ea:33,115698991,408,564,115698583,115698991
16828,6,6,1,2412,-70,-91,21,e6:aa:ea:c9:ea:33,115711130,408,11731,115710722,115711130
16829,6,6,1,2412,-70,-91,21,e6:aa:ea:c9:ea:33,115723230,408,11692,115722822,115723230
16830,4,1,1,2412,-90,-91,1,a6:e5:7c:28:b1:d3,115742396,992,18174,115741404,115742396
16831,4,1,1,2412,-81,-91,10,54:e4:3a:ec:fb:64,115754283,2160,9727,115752123,115754283
16832,4,1,1,2412,-76,-91,15,b8:3a:5a:88:e6:e1,115785078,2376,28419,115782702,115785078
16833,6,12,1,2412,-67,-91,24,40:e3:d6:da:ba:20,115798943,160,13705,115798783,115798943
16834,6,6,1,2412,-68,-91,23,40:e3:d6:da:ba:21,115799162,368,-149,115798794,115799162
16835,6,12,1,2412,-67,-91,24,40:e3:d6:da:ba:22,115799549,180,207,115799369,115799549
16836,6,12,1,2412,-67,-91,24,40:e3:d6:da:ba:23,115799755,184,22,115799571,115799755
16837,6,12,1,2412,-67,-91,24,40:e3:d6:da:ba:24,115799973,176,42,115799797,115799973
16838,6,12,1,2412,-67,-91,24,40:e3:d6:da:ba:25,115800175,160,42,115800015,115800175
16839,6,6,1,2412,-67,-91,24,40:e3:d6:da:ba:26,115800366,380,-189,115799986,115800366
16840,4,1,1,2412,-81,-91,10,b8:3a:5a:88:e6:e0,115885171,2360,82445,115882811,115885171
16841,6,12,1,2412,-67,-91,24,40:e3:d6:da:ba:20,115901337,160,16006,115901177,115901337
16842,6,6,1,2412,-67,-91,24,40:e3:d6:da:ba:21,115901528,368,-177,115901160,115901528
16843,6,12,1,2412,-67,-91,24,40:e3:d6:da:ba:22,115901916,180,208,115901736,115901916
16844,6,12,1,2412,-67,-91,24,40:e3:d6:da:ba:23,115902130,184,30,115901946,115902130
16845,6,12,1,2412,-67,-91,24,40:e3:d6:da:ba:24,115902357,176,51,115902181,115902357
16846,6,12,1,2412,-66,-91,25,40:e3:d6:da:ba:25,115902577,160,60,115902417,115902577
16847,6,6,1,2412,-67,-91,24,40:e3:d6:da:ba:26,115902796,380,-161,115902416,115902796
16848,4,1,1,2412,-51,-91,40,b8:3a:5a:88:e6:e0,115926451,2240,21415,115924211,115926451
16849,4,1,1,2412,-79,-91,12,b8:3a:5a:88:e6:e1,115928728,2256,21,115926472,115928728
16850,4,1,1,2412,-83,-91,8,54:e4:3a:ec:fb:64,115959082,2160,28194,115956922,115959082
16851,4,1,1,2412,-82,-91,9,b8:3a:5a:88:e6:e0,115987491,2360,26049,115985131,115987491
16852,6,12,1,2412,-66,-91,25,40:e3:d6:da:ba:20,116003745,160,16094,116003585,116003745
16853,6,6,1,2412,-66,-91,25,40:e3:d6:da:ba:21,116003955,368,-158,116003587,116003955
16854,6,12,1,2412,-66,-91,25,40:e3:d6:da:ba:22,116004342,180,207,116004162,116004342
16855,6,12,1,2412,-66,-91,25,40:e3:d6:da:ba:23,116004548,184,22,116004364,116004548
16856,6,12,1,2412,-66,-91,25,40:e3:d6:da:ba:24,116004757,176,33,116004581,116004757
16857,6,12,1,2412,-66,-91,25,40:e3:d6:da:ba:25,116004976,160,59,116004816,116004976
16858,6,6,1,2412,-66,-91,25,40:e3:d6:da:ba:26,116005168,380,-188,116004788,116005168
16859,6,6,1,2412,-69,-91,22,e6:aa:ea:c9:ea:33,116014945,408,9369,116014537,116014945
16860,6,6,1,2412,-69,-91,22,e6:aa:ea:c9:ea:33,116027057,408,11704,116026649,116027057
16861,6,6,1,2412,-69,-91,22,e6:aa:ea:c9:ea:33,116039170,408,11705,116038762,116039170
16862,4,1,1,2412,-74,-91,17,54:e4:3a:ec:fb:64,116061480,2160,20150,116059320,116061480
16863,4,1,1,2412,-80,-91,11,b8:3a:5a:88:e6:e0,116089875,2360,26035,116087515,116089875
16864,6,12,1,2412,-66,-91,25,40:e3:d6:da:ba:20,116106141,160,16106,116105981,116106141
16865,6,6,1,2412,-65,-91,26,40:e3:d6:da:ba:21,116106351,368,-158,116105983,116106351
16866,6,12,1,2412,-65,-91,26,40:e3:d6:da:ba:23,116106943,184,408,116106759,116106943
16867,6,12,1,2412,-65,-91,26,40:e3:d6:da:ba:24,116107171,176,52,116106995,116107171
16868,6,12,1,2412,-65,-91,26,40:e3:d6:da:ba:25,116107372,160,41,116107212,116107372
16869,6,6,1,2412,-65,-91,26,40:e3:d6:da:ba:26,116107573,380,-179,116107193,116107573
16870,6,6,1,2412,-84,-91,7,e6:aa:ea:b7:4a:dd,116110622,408,2641,116110214,116110622
16871,6,6,1,2412,-83,-91,8,e6:aa:ea:b7:4a:dd,116122737,408,11707,116122329,116122737
16872,6,6,1,2412,-79,-91,12,e6:aa:ea:b7:4a:dd,116134852,408,11707,116134444,116134852
16873,6,6,1,2412,-83,-91,8,e6:aa:ea:b7:4a:dd,116146966,408,11706,116146558,116146966
16874,4,1,1,2412,-83,-91,8,a6:e5:7c:28:b1:d3,116151757,992,3799,116150765,116151757
16875,6,6,1,2412,-83,-91,8,e6:aa:ea:b7:4a:dd,116159090,408,6925,116158682,116159090
16876,6,6,1,2412,-65,-91,26,40:e3:d6:da:ba:21,116208731,368,49273,116208363,116208731
16877,6,12,1,2412,-65,-91,26,40:e3:d6:da:ba:22,116209145,180,234,116208965,116209145
16878,6,12,1,2412,-66,-91,25,40:e3:d6:da:ba:23,116209368,184,39,116209184,116209368
16879,6,12,1,2412,-65,-91,26,40:e3:d6:da:ba:24,116209578,176,34,116209402,116209578
16880,6,12,1,2412,-65,-91,26,40:e3:d6:da:ba:25,116209788,160,50,116209628,116209788
16881,4,1,1,2412,-84,-91,7,54:e4:3a:ec:fb:64,116266280,2160,54332,116264120,116266280
16882,4,1,1,2412,-83,-91,8,b8:3a:5a:88:e6:e0,116294696,2360,26056,116292336,116294696
16883,6,12,1,2412,-65,-91,26,40:e3:d6:da:ba:20,116311093,160,16237,116310933,116311093
16884,6,6,1,2412,-65,-91,26,40:e3:d6:da:ba:21,116311303,368,-158,116310935,116311303
16885,6,12,1,2412,-64,-91,27,40:e3:d6:da:ba:22,116311708,180,225,116311528,116311708
16886,6,12,1,2412,-64,-91,27,40:e3:d6:da:ba:23,116311941,184,49,116311757,116311941
16887,6,12,1,2412,-64,-91,27,40:e3:d6:da:ba:24,116312159,176,42,116311983,116312159
16888,6,12,1,2412,-65,-91,26,40:e3:d6:da:ba:25,116312388,160,69,116312228,116312388
16889,6,6,1,2412,-64,-91,27,40:e3:d6:da:ba:26,116312607,380,-161,116312227,116312607
16890,6,6,1,2412,-69,-91,22,e6:aa:ea:c9:ea:33,116317787,408,4772,116317379,116317787
16891,6,6,1,2412,-69,-91,22,e6:aa:ea:c9:ea:33,116329901,408,11706,116329493,116329901
16892,6,6,1,2412,-69,-91,22,e6:aa:ea:c9:ea:33,116342026,408,11717,116341618,116342026
16893,6,6,1,2412,-68,-91,23,e6:aa:ea:c9:ea:33,116354147,408,11713,116353739,116354147
16894,6,12,1,2412,-64,-91,27,40:e3:d6:da:ba:20,116413332,160,59025,116413172,116413332
16895,6,6,1,2412,-64,-91,27,40:e3:d6:da:ba:21,116413542,368,-158,116413174,116413542
16896,6,12,1,2412,-64,-91,27,40:e3:d6:da:ba:22,116413929,180,207,116413749,116413929
16897,6,12,1,2412,-63,-91,28,40:e3:d6:da:ba:24,116414380,176,275,116414204,116414380
16898,6,12,1,2412,-64,-91,27,40:e3:d6:da:ba:25,116414609,160,69,116414449,116414609
16899,6,6,1,2412,-64,-91,27,40:e3:d6:da:ba:26,116414819,380,-170,116414439,116414819
16900,6,6,1,2412,-83,-91,8,e6:aa:ea:b7:4a:dd,116426295,408,11068,116425887,116426295
16901,6,6,1,2412,-83,-91,8,e6:aa:ea:b7:4a:dd,116438409,408,11706,116438001,116438409
16902,6,6,1,2412,-84,-91,7,e6:aa:ea:b7:4a:dd,116450525,408,11708,116450117,116450525
16903,6,6,1,2412,-83,-91,8,e6:aa:ea:b7:4a:dd,116462636,408,11703,116462228,116462636
16904,6,6,1,2412,-85,-91,6,e6:aa:ea:b7:4a:dd,116474754,408,11710,116474346,116474754
16905,4,1,1,2412,-83,-91,8,b8:3a:5a:88:e6:e0,116499535,2360,22421,116497175,116499535
16906,6,12,1,2412,-64,-91,27,40:e3:d6:da:ba:20,116515723,160,16028,116515563,116515723
16907,6,6,1,2412,-64,-91,27,40:e3:d6:da:ba:21,116515914,368,-177,116515546,116515914
16908,6,12,1,2412,-64,-91,27,40:e3:d6:da:ba:22,116516310,180,216,116516130,116516310
16909,6,12,1,2412,-64,-91,27,40:e3:d6:da:ba:23,116516516,184,22,116516332,116516516
16910,6,12,1,2412,-64,-91,27,40:e3:d6:da:ba:25,116516979,160,303,116516819,116516979
16911,6,6,1,2412,-64,-91,27,40:e3:d6:da:ba:26,116517171,380,-188,116516791,116517171
16912,4,1,1,2412,-78,-91,13,b8:3a:5a:88:e6:e0,116601896,2360,82365,116599536,116601896
16913,6,12,1,2412,-65,-91,26,40:e3:d6:da:ba:20,116618157,160,16101,116617997,116618157
16914,6,6,1,2412,-64,-91,27,40:e3:d6:da:ba:21,116618358,368,-167,116617990,116618358
16915,6,12,1,2412,-64,-91,27,40:e3:d6:da:ba:22,116618763,180,225,116618583,116618763
16916,6,12,1,2412,-64,-91,27,40:e3:d6:da:ba:23,116618996,184,49,116618812,116618996
16917,6,12,1,2412,-64,-91,27,40:e3:d6:da:ba:24,116619214,176,42,116619038,116619214
16918,6,12,1,2412,-64,-91,27,40:e3:d6:da:ba:25,116619443,160,69,116619283,116619443
16919,6,6,1,2412,-64,-91,27,40:e3:d6:da:ba:26,116619644,380,-179,116619264,116619644
16920,4,1,1,2412,-91,-91,0,a4:e5:7c:28:b1:d3,116661320,688,40988,116660632,116661320
16921,4,1,1,2412,-89,-91,2,a6:e5:7c:28:b1:d3,116663751,992,1439,116662759,116663751
16922,4,1,1,2412,-84,-91,7,54:e4:3a:ec:fb:64,116675876,2160,9965,116673716,116675876
16923,4,1,1,2412,-84,-91,7,b8:3a:5a:88:e6:e0,116705227,2360,26991,116702867,116705227
16924,6,12,1,2412,-61,-91,30,40:e3:d6:da:ba:20,116720542,160,15155,116720382,116720542
16925,6,12,1,2412,-63,-91,28,40:e3:d6:da:ba:20,116822947,160,102245,116822787,116822947
16926,6,6,1,2412,-63,-91,28,40:e3:d6:da:ba:21,116823157,368,-158,116822789,116823157
16927,6,12,1,2412,-63,-91,28,40:e3:d6:da:ba:22,116823562,180,225,116823382,116823562
16928,6,12,1,2412,-63,-91,28,40:e3:d6:da:ba:23,116823776,184,30,116823592,116823776
16929,4,1,1,2412,-89,-91,2,,116825229,304,1149,116824925,116825229
16930,6,6,1,2412,-63,-91,28,40:e3:d6:da:ba:26,116825795,380,186,116825415,116825795
16931,6,6,1,2412,-63,-91,28,40:e3:d6:da:ba:21,116826407,348,264,116826059,116826407
16932,6,12,1,2412,-63,-91,28,40:e3:d6:da:ba:22,116826783,156,220,116826627,116826783
16933,6,6,1,2412,-70,-91,21,e6:aa:ea:c9:ea:33,116838003,408,10812,116837595,116838003
16934,6,6,1,2412,-70,-91,21,e6:aa:ea:c9:ea:33,116849972,408,11561,116849564,116849972
16935,6,6,1,2412,-87,-91,4,e6:aa:ea:b7:4a:dd,116856090,408,5710,116855682,116856090
16936,6,6,1,2412,-70,-91,21,e6:aa:ea:c9:ea:33,116874213,408,17715,116873805,116874213
16937,6,6,1,2412,-85,-91,6,e6:aa:ea:b7:4a:dd,116880308,408,5687,116879900,116880308
16938,4,1,1,2412,-82,-91,9,54:e4:3a:ec:fb:64,116880907,2160,-1561,116878747,116880907
16939,4,1,1,2412,-79,-91,12,b8:3a:5a:88:e6:e0,116909073,2360,25806,116906713,116909073
16940,4,1,1,2412,-79,-91,12,b8:3a:5a:88:e6:e1,116911452,2376,3,116909076,116911452
16941,6,12,1,2412,-64,-91,27,40:e3:d6:da:ba:20,116925692,160,14080,116925532,116925692
16942,6,6,1,2412,-64,-91,27,40:e3:d6:da:ba:21,116925902,368,-158,116925534,116925902
16943,6,12,1,2412,-64,-91,27,40:e3:d6:da:ba:22,116926298,180,216,116926118,116926298
16944,6,12,1,2412,-64,-91,27,40:e3:d6:da:ba:23,116926522,184,40,116926338,116926522
16945,6,12,1,2412,-64,-91,27,40:e3:d6:da:ba:25,116927003,160,321,116926843,116927003
16946,6,6,1,2412,-64,-91,27,40:e3:d6:da:ba:26,116927204,380,-179,116926824,116927204
16947,4,1,1,2412,-89,-91,2,a6:e5:7c:28:b1:d3,116928476,944,328,116927532,116928476
16948,4,1,1,2412,-88,-91,3,a6:e5:7c:28:b1:d3,116929590,944,170,116928646,116929590
16949,4,1,1,2412,-89,-91,2,a6:e5:7c:28:b1:d3,116930686,944,152,116929742,116930686
16950,4,1,1,2412,-90,-91,1,a6:e5:7c:28:b1:d3,116931963,944,333,116931019,116931963
16951,4,1,1,2412,-90,-91,1,a6:e5:7c:28:b1:d3,116938458,944,5551,116937514,116938458
16952,4,1,1,2412,-82,-91,9,54:e4:3a:ec:fb:64,116983073,2160,42455,116980913,116983073
16953,4,1,1,2412,-79,-91,12,b8:3a:5a:88:e6:e0,117011473,2360,26040,117009113,117011473
16954,6,12,1,2412,-67,-91,24,40:e3:d6:da:ba:20,117027727,160,16094,117027567,117027727
16955,6,6,1,2412,-66,-91,25,40:e3:d6:da:ba:21,117027919,368,-176,117027551,117027919
16956,6,12,1,2412,-66,-91,25,40:e3:d6:da:ba:22,117028315,180,216,117028135,117028315
16957,6,12,1,2412,-66,-91,25,40:e3:d6:da:ba:23,117028539,184,40,117028355,117028539
16958,6,12,1,2412,-66,-91,25,40:e3:d6:da:ba:24,117028748,176,33,117028572,117028748
16959,6,12,1,2412,-66,-91,25,40:e3:d6:da:ba:25,117028959,160,51,117028799,117028959
16960,6,6,1,2412,-66,-91,25,40:e3:d6:da:ba:26,117029178,380,-161,117028798,117029178
16961,4,1,1,2412,-86,-91,5,f2:fe:44:92:02:fb,117089952,1152,59622,117088800,117089952
16962,6,12,1,2412,-67,-91,24,40:e3:d6:da:ba:22,117094770,156,4662,117094614,117094770
16963,6,12,1,2412,-67,-91,24,40:e3:d6:da:ba:23,117094978,156,52,117094822,117094978
16964,6,12,1,2412,-67,-91,24,40:e3:d6:da:ba:25,117095169,136,55,117095033,117095169
16965,4,1,1,2412,-84,-91,7,f2:fe:44:92:02:fb,117110491,1152,14170,117109339,117110491
16966,6,12,1,2412,-67,-91,24,40:e3:d6:da:ba:20,117111617,136,990,117111481,117111617
16967,6,6,1,2412,-67,-91,24,40:e3:d6:da:ba:21,117111812,348,-153,117111464,117111812
16968,6,12,1,2412,-85,-91,6,,117112378,32,534,117112346,117112378
16969,6,12,1,2412,-67,-91,24,40:e3:d6:da:ba:23,117112423,156,-111,117112267,117112423
16970,6,12,1,2412,-67,-91,24,40:e3:d6:da:ba:25,117112614,136,55,117112478,117112614
16971,4,1,1,2412,-46,-91,45,54:e4:3a:ec:fb:64,117113073,2112,-1653,117110961,117113073
16972,4,1,1,2412,-87,-91,4,,117122423,304,9046,117122119,117122423
16973,6,12,1,2412,-68,-91,23,40:e3:d6:da:ba:20,117130125,160,7542,117129965,117130125
16974,6,6,1,2412,-68,-91,23,40:e3:d6:da:ba:21,117130344,368,-149,117129976,117130344
16975,6,12,1,2412,-68,-91,23,40:e3:d6:da:ba:22,117130731,180,207,117130551,117130731
16976,6,12,1,2412,-67,-91,24,40:e3:d6:da:ba:23,117130946,184,31,117130762,117130946
16977,6,12,1,2412,-68,-91,23,40:e3:d6:da:ba:24,117131155,176,33,117130979,117131155
16978,6,12,1,2412,-68,-91,23,40:e3:d6:da:ba:25,117131356,160,41,117131196,117131356
16979,6,6,1,2412,-68,-91,23,40:e3:d6:da:ba:26,117131575,380,-161,117131195,117131575
16980,4,1,1,2412,-92,-91,-1,c0:c9:e3:4d:6e:bf,117149094,872,16647,117148222,117149094
16981,4,1,1,2412,-82,-91,9,54:e4:3a:ec:fb:64,117187872,2160,36618,117185712,117187872
16982,4,1,1,2412,-75,-91,16,,117193777,304,5601,117193473,117193777
16983,4,1,1,2412,-80,-91,11,b8:3a:5a:88:e6:e1,117218688,2376,22535,117216312,117218688
16984,6,6,1,2412,-84,-91,7,e6:aa:ea:b7:4a:dd,117261432,408,42336,117261024,117261432
16985,6,6,1,2412,-84,-91,7,e6:aa:ea:b7:4a:dd,117273548,408,11708,117273140,117273548
16986,6,6,1,2412,-84,-91,7,e6:aa:ea:b7:4a:dd,117285664,408,11708,117285256,117285664
16987,4,1,1,2412,-86,-91,5,a0:59:50:b4:3a:a2,117328185,1176,41345,117327009,117328185
16988,6,12,1,2412,-69,-91,22,40:e3:d6:da:ba:20,117329344,136,1023,117329208,117329344
16989,6,6,1,2412,-69,-91,22,40:e3:d6:da:ba:21,117329547,348,-145,117329199,117329547
16990,4,1,1,2412,-82,-91,9,b8:3a:5a:88:e6:e1,117332002,2256,199,117329746,117332002
16991,6,12,1,2412,-69,-91,22,40:e3:d6:da:ba:20,117334991,160,2829,117334831,117334991
16992,6,6,1,2412,-69,-91,22,40:e3:d6:da:ba:21,117335182,368,-177,117334814,117335182
16993,6,6,1,2412,-74,-91,17,e6:aa:ea:c9:ea:33,117345763,408,10173,117345355,117345763
16994,6,6,1,2412,-74,-91,17,e6:aa:ea:c9:ea:33,117370001,408,23830,117369593,117370001
16995,6,6,1,2412,-74,-91,17,e6:aa:ea:c9:ea:33,117382125,408,11716,117381717,117382125
16996,4,1,1,2412,-82,-91,9,b8:3a:5a:88:e6:e0,117421074,2360,36589,117418714,117421074
16997,6,12,1,2412,-69,-91,22,40:e3:d6:da:ba:20,117437327,160,16093,117437167,117437327
16998,6,6,1,2412,-69,-91,22,40:e3:d6:da:ba:21,117437546,368,-149,117437178,117437546
16999,6,12,1,2412,-69,-91,22,40:e3:d6:da:ba:22,117437942,180,216,117437762,117437942
17000,6,12,1,2412,-69,-91,22,40:e3:d6:da:ba:23,117438157,184,31,117437973,117438157
17001,6,12,1,2412,-69,-91,22,40:e3:d6:da:ba:24,117438384,176,51,117438208,117438384
17002,6,12,1,2412,-69,-91,22,40:e3:d6:da:ba:25,117438613,160,69,117438453,117438613
17003,6,6,1,2412,-69,-91,22,40:e3:d6:da:ba:26,117438814,380,-179,117438434,117438814
17004,4,1,1,2412,-82,-91,9,b8:3a:5a:88:e6:e0,117523747,2360,82573,117521387,117523747
17005,4,1,1,2412,-84,-91,7,b8:3a:5a:88:e6:e1,117526212,2376,89,117523836,117526212
17006,6,12,1,2412,-68,-91,23,40:e3:d6:da:ba:20,117539752,160,13380,117539592,117539752
17007,6,6,1,2412,-68,-91,23,40:e3:d6:da:ba:21,117539971,368,-149,117539603,117539971
17008,6,12,1,2412,-68,-91,23,40:e3:d6:da:ba:22,117540376,180,225,117540196,117540376
17009,6,12,1,2412,-68,-91,23,40:e3:d6:da:ba:23,117540609,184,49,117540425,117540609
17010,6,12,1,2412,-68,-91,23,40:e3:d6:da:ba:24,117540818,176,33,117540642,117540818
17011,6,12,1,2412,-68,-91,23,40:e3:d6:da:ba:25,117541037,160,59,117540877,117541037
17012,6,6,1,2412,-68,-91,23,40:e3:d6:da:ba:26,117541229,380,-188,117540849,117541229
17013,4,1,1,2412,-88,-91,3,a6:e5:7c:28:b1:d3,117585173,992,42952,117584181,117585173
17014,6,6,1,2412,-87,-91,4,e6:aa:ea:b7:4a:dd,117588293,408,2712,117587885,117588293
17015,4,1,1,2412,-87,-91,4,54:e4:3a:ec:fb:64,117597468,2160,7015,117595308,117597468
17016,6,6,1,2412,-86,-91,5,e6:aa:ea:b7:4a:dd,117624656,408,26780,117624248,117624656
17017,4,1,1,2412,-80,-91,11,b8:3a:5a:88:e6:e0,117625885,2360,-1131,117623525,117625885
17018,4,1,1,2412,-81,-91,10,b8:3a:5a:88:e6:e1,117628274,2376,13,117625898,117628274
17019,6,12,1,2412,-68,-91,23,40:e3:d6:da:ba:20,117642137,160,13703,117641977,117642137
17020,6,12,1,2412,-68,-91,23,40:e3:d6:da:ba:22,117642770,180,453,117642590,117642770
17021,6,12,1,2412,-68,-91,23,40:e3:d6:da:ba:23,117643002,184,48,117642818,117643002
17022,6,12,1,2412,-68,-91,23,40:e3:d6:da:ba:24,117643212,176,34,117643036,117643212
17023,6,12,1,2412,-68,-91,23,40:e3:d6:da:ba:25,117643431,160,59,117643271,117643431
17024,6,6,1,2412,-67,-91,24,40:e3:d6:da:ba:21,117744747,368,100948,117744379,117744747
17025,6,12,1,2412,-67,-91,24,40:e3:d6:da:ba:22,117745143,180,216,117744963,117745143
17026,6,12,1,2412,-67,-91,24,40:e3:d6:da:ba:23,117745376,184,49,117745192,117745376
17027,6,12,1,2412,-67,-91,24,40:e3:d6:da:ba:24,117745594,176,42,117745418,117745594
17028,6,12,1,2412,-67,-91,24,40:e3:d6:da:ba:25,117745814,160,60,117745654,117745814
17029,6,6,1,2412,-67,-91,24,40:e3:d6:da:ba:26,117746032,380,-162,117745652,117746032
17030,6,6,1,2412,-71,-91,20,e6:aa:ea:c9:ea:33,117764222,408,17782,117763814,117764222
17031,6,6,1,2412,-71,-91,20,e6:aa:ea:c9:ea:33,117788466,408,23836,117788058,117788466
17032,6,6,1,2412,-71,-91,20,e6:aa:ea:c9:ea:33,117800699,408,11825,117800291,117800699
17033,4,1,1,2412,-86,-91,5,54:e4:3a:ec:fb:64,117802265,2160,-594,117800105,117802265
17034,6,6,1,2412,-70,-91,21,e6:aa:ea:c9:ea:33,117812706,408,10033,117812298,117812706
17035,4,1,1,2412,-79,-91,12,b8:3a:5a:88:e6:e0,117830679,2360,15613,117828319,117830679
17036,4,1,1,2412,-81,-91,10,b8:3a:5a:88:e6:e1,117833068,2376,13,117830692,117833068
17037,6,12,1,2412,-65,-91,26,40:e3:d6:da:ba:20,117846941,160,13713,117846781,117846941
17038,6,6,1,2412,-65,-91,26,40:e3:d6:da:ba:21,117847160,368,-149,117846792,117847160
17039,6,12,1,2412,-65,-91,26,40:e3:d6:da:ba:22,117847574,180,234,117847394,117847574
17040,6,12,1,2412,-65,-91,26,40:e3:d6:da:ba:23,117847806,184,48,117847622,117847806
17041,6,12,1,2412,-65,-91,26,40:e3:d6:da:ba:24,117848025,176,43,117847849,117848025
17042,6,12,1,2412,-65,-91,26,40:e3:d6:da:ba:25,117848226,160,41,117848066,117848226
17043,6,6,1,2412,-65,-91,26,40:e3:d6:da:ba:26,117848436,380,-170,117848056,117848436
17044,6,6,1,2412,-77,-91,14,84:1b:5e:df:1b:99,117855540,80,7024,117855460,117855540
17045,4,1,1,2412,-82,-91,9,b8:3a:5a:88:e6:e0,117933094,2360,75194,117930734,117933094
17046,6,12,1,2412,-64,-91,27,40:e3:d6:da:ba:20,117949356,160,16102,117949196,117949356
17047,6,6,1,2412,-64,-91,27,40:e3:d6:da:ba:21,117949557,368,-167,117949189,117949557
17048,6,12,1,2412,-64,-91,27,40:e3:d6:da:ba:22,117949944,180,207,117949764,117949944
17049,6,12,1,2412,-64,-91,27,40:e3:d6:da:ba:23,117950167,184,39,117949983,117950167
17050,6,12,1,2412,-64,-91,27,40:e3:d6:da:ba:24,117950404,176,61,117950228,117950404
17051,6,12,1,2412,-64,-91,27,40:e3:d6:da:ba:25,117950614,160,50,117950454,117950614
17052,6,6,1,2412,-64,-91,27,40:e3:d6:da:ba:26,117950833,380,-161,117950453,117950833
17053,4,1,1,2412,-83,-91,8,54:e4:3a:ec:fb:64,118007063,2160,54070,118004903,118007063
17054,4,1,1,2412,-84,-91,7,b8:3a:5a:88:e6:e0,118035489,2360,26066,118033129,118035489
17055,6,12,1,2412,-67,-91,24,40:e3:d6:da:ba:20,118054949,160,19300,118054789,118054949
17056,6,6,1,2412,-67,-91,24,40:e3:d6:da:ba:21,118055366,368,49,118054998,118055366
17057,6,12,1,2412,-67,-91,24,40:e3:d6:da:ba:23,118056128,184,578,118055944,118056128
17058,6,12,1,2412,-67,-91,24,40:e3:d6:da:ba:24,118056365,176,61,118056189,118056365
17059,6,12,1,2412,-67,-91,24,40:e3:d6:da:ba:25,118056787,160,262,118056627,118056787
17060,6,6,1,2412,-67,-91,24,40:e3:d6:da:ba:26,118056979,380,-188,118056599,118056979
17061,6,6,1,2412,-85,-91,6,e6:aa:ea:b7:4a:dd,118095984,408,38597,118095576,118095984
17062,6,6,1,2412,-69,-91,22,e6:aa:ea:c9:ea:33,118103881,408,7489,118103473,118103881
17063,6,6,1,2412,-83,-91,8,e6:aa:ea:b7:4a:dd,118108112,408,3823,118107704,118108112
17064,4,1,1,2412,-81,-91,10,54:e4:3a:ec:fb:64,118109462,2160,-810,118107302,118109462
17065,6,6,1,2412,-69,-91,22,e6:aa:ea:c9:ea:33,118128105,408,18235,118127697,118128105
17066,6,6,1,2412,-86,-91,5,e6:aa:ea:b7:4a:dd,118132343,408,3830,118131935,118132343
17067,4,1,1,2412,-76,-91,15,c0:c9:e3:4d:6e:bf,118134448,872,1233,118133576,118134448
17068,6,6,1,2412,-86,-91,5,e6:aa:ea:b7:4a:dd,118144465,408,9609,118144057,118144465
17069,6,12,1,2412,-68,-91,23,40:e3:d6:da:ba:20,118154129,160,9504,118153969,118154129
17070,6,6,1,2412,-68,-91,23,40:e3:d6:da:ba:21,118154321,368,-176,118153953,118154321
17071,6,12,1,2412,-68,-91,23,40:e3:d6:da:ba:22,118154717,180,216,118154537,118154717
17072,6,12,1,2412,-68,-91,23,40:e3:d6:da:ba:23,118154932,184,31,118154748,118154932
17073,6,12,1,2412,-67,-91,24,40:e3:d6:da:ba:24,118155184,176,76,118155008,118155184
17074,4,1,1,2412,-82,-91,9,b8:3a:5a:88:e6:e0,118240281,2360,82737,118237921,118240281
17075,6,12,1,2412,-67,-91,24,40:e3:d6:da:ba:20,118256543,160,16102,118256383,118256543
17076,6,12,1,2412,-67,-91,24,40:e3:d6:da:ba:22,118257158,180,435,118256978,118257158
17077,6,12,1,2412,-67,-91,24,40:e3:d6:da:ba:24,118257591,176,257,118257415,118257591
17078,6,12,1,2412,-67,-91,24,40:e3:d6:da:ba:25,118257819,160,68,118257659,118257819
17079,6,6,1,2412,-67,-91,24,40:e3:d6:da:ba:26,118258011,380,-188,118257631,118258011
17080,4,1,1,2412,-83,-91,8,54:e4:3a:ec:fb:64,118314262,2160,54091,118312102,118314262
17081,4,1,1,2412,-84,-91,7,b8:3a:5a:88:e6:e0,118343070,2360,26448,118340710,118343070
17082,6,12,1,2412,-64,-91,27,40:e3:d6:da:ba:20,118358957,160,15727,118358797,118358957
17083,6,6,1,2412,-64,-91,27,40:e3:d6:da:ba:21,118359167,368,-158,118358799,118359167
17084,6,12,1,2412,-64,-91,27,40:e3:d6:da:ba:22,118359563,180,216,118359383,118359563
17085,6,12,1,2412,-64,-91,27,40:e3:d6:da:ba:23,118359777,184,30,118359593,118359777
17086,6,12,1,2412,-64,-91,27,40:e3:d6:da:ba:24,118360014,176,61,118359838,118360014
17087,6,12,1,2412,-64,-91,27,40:e3:d6:da:ba:25,118360242,160,68,118360082,118360242
17088,6,6,1,2412,-64,-91,27,40:e3:d6:da:ba:26,118360452,380,-170,118360072,118360452
17089,6,6,1,2412,-82,-91,9,e6:aa:ea:b7:4a:dd,118410774,408,49914,118410366,118410774
17090,4,1,1,2412,-83,-91,8,54:e4:3a:ec:fb:64,118416660,2160,3726,118414500,118416660
17091,6,6,1,2412,-82,-91,9,e6:aa:ea:b7:4a:dd,118422878,408,5810,118422470,118422878
17092,6,6,1,2412,-82,-91,9,e6:aa:ea:b7:4a:dd,118435012,408,11726,118434604,118435012
17093,4,1,1,2412,-84,-91,7,b8:3a:5a:88:e6:e0,118445099,2360,7727,118442739,118445099
17094,4,1,1,2412,-80,-91,11,b8:3a:5a:88:e6:e1,118447488,2376,13,118445112,118447488
17095,6,6,1,2412,-82,-91,9,e6:aa:ea:b7:4a:dd,118459241,408,11345,118458833,118459241
17096,6,12,1,2412,-65,-91,26,40:e3:d6:da:ba:20,118461345,160,1944,118461185,118461345
17097,6,6,1,2412,-65,-91,26,40:e3:d6:da:ba:21,118461554,368,-159,118461186,118461554
17098,6,12,1,2412,-65,-91,26,40:e3:d6:da:ba:22,118461941,180,207,118461761,118461941
17099,6,12,1,2412,-65,-91,26,40:e3:d6:da:ba:23,118462174,184,49,118461990,118462174
17100,6,12,1,2412,-65,-91,26,40:e3:d6:da:ba:24,118462401,176,51,118462225,118462401
17101,6,12,1,2412,-65,-91,26,40:e3:d6:da:ba:25,118462621,160,60,118462461,118462621
17102,6,6,1,2412,-65,-91,26,40:e3:d6:da:ba:26,118462812,380,-189,118462432,118462812
17103,4,1,1,2412,-83,-91,8,54:e4:3a:ec:fb:64,118520482,2160,55510,118518322,118520482
17104,4,1,1,2412,-84,-91,7,b8:3a:5a:88:e6:e1,118549895,2376,27037,118547519,118549895
17105,6,12,1,2412,-64,-91,27,40:e3:d6:da:ba:20,118563742,160,13687,118563582,118563742
17106,6,6,1,2412,-64,-91,27,40:e3:d6:da:ba:21,118563934,368,-176,118563566,118563934
17107,6,12,1,2412,-63,-91,28,40:e3:d6:da:ba:22,118564348,180,234,118564168,118564348
17108,6,12,1,2412,-63,-91,28,40:e3:d6:da:ba:23,118564562,184,30,118564378,118564562
17109,6,12,1,2412,-64,-91,27,40:e3:d6:da:ba:24,118564799,176,61,118564623,118564799
17110,6,12,1,2412,-64,-91,27,40:e3:d6:da:ba:25,118565000,160,41,118564840,118565000
17111,6,6,1,2412,-64,-91,27,40:e3:d6:da:ba:26,118565192,380,-188,118564812,118565192
17112,6,6,1,2412,-68,-91,23,e6:aa:ea:c9:ea:33,118599407,408,33807,118598999,118599407
17113,6,6,1,2412,-68,-91,23,e6:aa:ea:c9:ea:33,118611532,408,11717,118611124,118611532
17114,4,1,1,2412,-84,-91,7,54:e4:3a:ec:fb:64,118621459,2160,7767,118619299,118621459
17115,6,6,1,2412,-68,-91,23,e6:aa:ea:c9:ea:33,118623651,408,1784,118623243,118623651
17116,6,6,1,2412,-69,-91,22,e6:aa:ea:c9:ea:33,118635767,408,11708,118635359,118635767
17117,6,6,1,2412,-69,-91,22,e6:aa:ea:c9:ea:33,118647875,408,11700,118647467,118647875
17118,4,1,1,2412,-80,-91,11,b8:3a:5a:88:e6:e1,118652548,2376,2297,118650172,118652548
17119,6,12,1,2412,-65,-91,26,40:e3:d6:da:ba:20,118666150,160,13442,118665990,118666150
17120,6,6,1,2412,-65,-91,26,40:e3:d6:da:ba:21,118666360,368,-158,118665992,118666360
17121,6,12,1,2412,-65,-91,26,40:e3:d6:da:ba:22,118666756,180,216,118666576,118666756
17122,6,12,1,2412,-64,-91,27,40:e3:d6:da:ba:23,118666989,184,49,118666805,118666989
17123,6,12,1,2412,-65,-91,26,40:e3:d6:da:ba:24,118667225,176,60,118667049,118667225
17124,6,12,1,2412,-65,-91,26,40:e3:d6:da:ba:25,118667454,160,69,118667294,118667454
17125,6,6,1,2412,-65,-91,26,40:e3:d6:da:ba:26,118667645,380,-189,118667265,118667645
17126,4,1,1,2412,-85,-91,6,54:e4:3a:ec:fb:64,118723857,2160,54052,118721697,118723857
17127,6,12,1,2412,-78,-91,13,40:e3:d6:da:c6:e0,118751771,960,26954,118750811,118751771
17128,4,1,1,2412,-77,-91,14,b8:3a:5a:88:e6:e0,118752949,2360,-1182,118750589,118752949
17129,6,6,1,2412,-64,-91,27,40:e3:d6:da:ba:21,118768734,368,15417,118768366,118768734
17130,6,12,1,2412,-64,-91,27,40:e3:d6:da:ba:23,118769413,184,495,118769229,118769413
17131,6,12,1,2412,-64,-91,27,40:e3:d6:da:ba:24,118769631,176,42,118769455,118769631
17132,6,12,1,2412,-64,-91,27,40:e3:d6:da:ba:25,118769833,160,42,118769673,118769833
17133,4,1,1,2412,-84,-91,7,54:e4:3a:ec:fb:64,118826262,2160,54269,118824102,118826262
17134,6,6,1,2412,-80,-91,11,e6:aa:ea:b7:4a:dd,118828302,408,1632,118827894,118828302
17135,6,6,1,2412,-80,-91,11,e6:aa:ea:b7:4a:dd,118840307,408,11597,118839899,118840307
17136,6,6,1,2412,-80,-91,11,e6:aa:ea:b7:4a:dd,118852417,408,11702,118852009,118852417
17137,4,1,1,2412,-81,-91,10,b8:3a:5a:88:e6:e0,118854699,2360,-78,118852339,118854699
17138,6,6,1,2412,-80,-91,11,e6:aa:ea:b7:4a:dd,118864548,408,9441,118864140,118864548
17139,6,12,1,2412,-67,-91,24,40:e3:d6:da:ba:20,118870933,160,6225,118870773,118870933
17140,6,6,1,2412,-67,-91,24,40:e3:d6:da:ba:21,118871152,368,-149,118870784,118871152
17141,6,12,1,2412,-66,-91,25,40:e3:d6:da:ba:22,118871566,180,234,118871386,118871566
17142,6,12,1,2412,-66,-91,25,40:e3:d6:da:ba:23,118871772,184,22,118871588,118871772
17143,6,12,1,2412,-66,-91,25,40:e3:d6:da:ba:24,118871981,176,33,118871805,118871981
17144,6,12,1,2412,-66,-91,25,40:e3:d6:da:ba:25,118872192,160,51,118872032,118872192
17145,6,6,1,2412,-67,-91,24,40:e3:d6:da:ba:26,118872411,380,-161,118872031,118872411
17146,4,1,1,2412,-92,-91,-1,,118899499,304,26784,118899195,118899499
17147,4,1,1,2412,-81,-91,10,b8:3a:5a:88:e6:e0,118907134,2240,5395,118904894,118907134
17148,4,1,1,2412,-80,-91,11,b8:3a:5a:88:e6:e1,118909411,2256,21,118907155,118909411
17149,4,1,1,2412,-84,-91,7,54:e4:3a:ec:fb:64,118928656,2160,17085,118926496,118928656
17150,4,1,1,2412,-93,-91,-2,a4:e5:7c:28:b1:d3,118965664,688,36320,118964976,118965664
17151,6,12,1,2412,-65,-91,26,40:e3:d6:da:ba:20,118973356,160,7532,118973196,118973356
17152,6,6,1,2412,-68,-91,23,e6:aa:ea:c9:ea:33,119016502,408,42738,119016094,119016502
17153,6,6,1,2412,-69,-91,22,e6:aa:ea:c9:ea:33,119028621,408,11711,119028213,119028621
17154,4,1,1,2412,-73,-91,18,54:e4:3a:ec:fb:64,119031054,2160,273,119028894,119031054
17155,6,6,1,2412,-69,-91,22,e6:aa:ea:c9:ea:33,119040740,408,9278,119040332,119040740
17156,6,6,1,2412,-68,-91,23,e6:aa:ea:c9:ea:33,119052905,408,11757,119052497,119052905
17157,4,1,1,2412,-85,-91,6,b8:3a:5a:88:e6:e1,119061870,2376,6589,119059494,119061870
17158,6,6,1,2412,-69,-91,22,e6:aa:ea:c9:ea:33,119064993,408,2715,119064585,119064993
17159,6,6,1,2412,-63,-91,28,40:e3:d6:da:ba:21,119075967,368,10606,119075599,119075967
17160,6,12,1,2412,-63,-91,28,40:e3:d6:da:ba:23,119076605,184,454,119076421,119076605
17161,6,12,1,2412,-63,-91,28,40:e3:d6:da:ba:24,119076841,176,60,119076665,119076841
17162,6,12,1,2412,-63,-91,28,40:e3:d6:da:ba:25,119077052,160,51,119076892,119077052
17163,6,6,1,2412,-63,-91,28,40:e3:d6:da:ba:26,119077262,380,-170,119076882,119077262
17164,4,1,1,2412,-88,-91,3,,119123930,304,46364,119123626,119123930
17165,4,1,1,2412,-84,-91,7,54:e4:3a:ec:fb:64,119133453,2160,7363,119131293,119133453
17166,6,12,1,2412,-63,-91,28,40:e3:d6:da:ba:20,119178159,160,44546,119177999,119178159
17167,6,6,1,2412,-62,-91,29,40:e3:d6:da:ba:21,119178351,368,-176,119177983,119178351
17168,6,12,1,2412,-62,-91,29,40:e3:d6:da:ba:22,119178746,180,215,119178566,119178746
17169,6,12,1,2412,-62,-91,29,40:e3:d6:da:ba:23,119178961,184,31,119178777,119178961
17170,6,12,1,2412,-62,-91,29,40:e3:d6:da:ba:24,119179197,176,60,119179021,119179197
17171,6,12,1,2412,-62,-91,29,40:e3:d6:da:ba:25,119179399,160,42,119179239,119179399
17172,6,6,1,2412,-62,-91,29,40:e3:d6:da:ba:26,119179591,380,-188,119179211,119179591
17173,4,1,1,2412,-90,-91,1,a6:e5:7c:28:b1:d3,119227568,992,46985,119226576,119227568
17174,4,1,1,2412,-84,-91,7,54:e4:3a:ec:fb:64,119235853,2160,6125,119233693,119235853
17175,6,6,1,2412,-84,-91,7,e6:aa:ea:b7:4a:dd,119246289,408,10028,119245881,119246289
17176,6,6,1,2412,-82,-91,9,e6:aa:ea:b7:4a:dd,119270525,408,23828,119270117,119270525
17177,6,12,1,2412,-62,-91,29,40:e3:d6:da:ba:20,119281269,160,10584,119281109,119281269
17178,6,6,1,2412,-62,-91,29,40:e3:d6:da:ba:21,119281461,368,-176,119281093,119281461
17179,6,12,1,2412,-62,-91,29,40:e3:d6:da:ba:23,119282062,184,417,119281878,119282062
17180,6,12,1,2412,-61,-91,30,40:e3:d6:da:ba:24,119282281,176,43,119282105,119282281
17181,6,12,1,2412,-62,-91,29,40:e3:d6:da:ba:25,119282491,160,50,119282331,119282491
17182,6,6,1,2412,-85,-91,6,e6:aa:ea:b7:4a:dd,119283116,408,217,119282708,119283116
17183,6,6,1,2412,-84,-91,7,e6:aa:ea:b7:4a:dd,119294750,408,11226,119294342,119294750
17184,6,6,1,2412,-67,-91,24,e6:aa:ea:c9:ea:33,119331192,408,36034,119330784,119331192
17185,4,1,1,2412,-81,-91,10,54:e4:3a:ec:fb:64,119338262,2160,4910,119336102,119338262
17186,6,6,1,2412,-68,-91,23,e6:aa:ea:c9:ea:33,119343257,408,4587,119342849,119343257
17187,6,6,1,2412,-68,-91,23,e6:aa:ea:c9:ea:33,119379591,408,35926,119379183,119379591
17188,6,12,1,2412,-61,-91,30,40:e3:d6:da:ba:20,119382936,160,3185,119382776,119382936
17189,6,6,1,2412,-61,-91,30,40:e3:d6:da:ba:21,119383155,368,-149,119382787,119383155
17190,6,12,1,2412,-61,-91,30,40:e3:d6:da:ba:22,119383542,180,207,119383362,119383542
17191,6,12,1,2412,-61,-91,30,40:e3:d6:da:ba:23,119383756,184,30,119383572,119383756
17192,6,12,1,2412,-61,-91,30,40:e3:d6:da:ba:24,119383975,176,43,119383799,119383975
17193,6,12,1,2412,-61,-91,30,40:e3:d6:da:ba:25,119384185,160,50,119384025,119384185
17194,6,6,1,2412,-61,-91,30,40:e3:d6:da:ba:26,119384377,380,-188,119383997,119384377
17195,6,6,1,2412,-86,-91,5,78:8a:20:fa:27:f9,119385239,88,774,119385151,119385239
17196,6,6,1,2412,-86,-91,5,,119386023,44,740,119385979,119386023
17197,6,6,1,2412,-86,-91,5,,119386466,44,399,119386422,119386466
17198,6,12,1,2412,-85,-91,6,,119386715,32,217,119386683,119386715
17199,4,1,1,2412,-81,-91,10,54:e4:3a:ec:fb:64,119387853,2112,-974,119385741,119387853
17200,4,1,1,2412,-79,-91,12,54:e4:3a:ec:fb:64,119407948,2112,17983,119405836,119407948
17201,6,6,1,2412,-86,-91,5,78:8a:20:fa:27:f9,119435306,88,27270,119435218,119435306
17202,6,12,1,2412,-84,-91,7,,119436294,32,956,119436262,119436294
17203,6,12,1,2412,-85,-91,6,,119437201,32,875,119437169,119437201
17204,4,1,1,2412,-81,-91,10,54:e4:3a:ec:fb:64,119440651,2160,1290,119438491,119440651
17205,4,1,1,2412,-84,-91,7,b8:3a:5a:88:e6:e0,119469083,2360,26072,119466723,119469083
17206,4,1,1,2412,-81,-91,10,54:e4:3a:ec:fb:64,119476942,2112,5747,119474830,119476942
17207,6,12,1,2412,-62,-91,29,40:e3:d6:da:ba:20,119479230,136,2152,119479094,119479230
17208,6,6,1,2412,-62,-91,29,40:e3:d6:da:ba:21,119479434,348,-144,119479086,119479434
17209,6,12,1,2412,-62,-91,29,40:e3:d6:da:ba:22,119479810,156,220,119479654,119479810
17210,6,12,1,2412,-62,-91,29,40:e3:d6:da:ba:23,119480019,156,53,119479863,119480019
17211,6,12,1,2412,-62,-91,29,40:e3:d6:da:ba:25,119480227,136,72,119480091,119480227
17212,6,12,1,2412,-62,-91,29,40:e3:d6:da:ba:20,119485364,160,4977,119485204,119485364
17213,6,6,1,2412,-62,-91,29,40:e3:d6:da:ba:21,119485583,368,-149,119485215,119485583
17214,6,12,1,2412,-62,-91,29,40:e3:d6:da:ba:22,119485988,180,225,119485808,119485988
17215,6,12,1,2412,-62,-91,29,40:e3:d6:da:ba:23,119486202,184,30,119486018,119486202
17216,6,12,1,2412,-62,-91,29,40:e3:d6:da:ba:24,119486421,176,43,119486245,119486421
17217,6,12,1,2412,-62,-91,29,40:e3:d6:da:ba:25,119486640,160,59,119486480,119486640
17218,6,6,1,2412,-62,-91,29,40:e3:d6:da:ba:26,119486841,380,-179,119486461,119486841
17219,4,1,1,2412,-92,-91,-1,a6:e5:7c:28:b1:d3,119489383,944,1598,119488439,119489383
17220,4,1,1,2412,-92,-91,-1,a6:e5:7c:28:b1:d3,119490497,944,170,119489553,119490497
17221,4,1,1,2412,-89,-91,2,a6:e5:7c:28:b1:d3,119491557,944,116,119490613,119491557
17222,4,1,1,2412,-92,-91,-1,a6:e5:7c:28:b1:d3,119492608,944,107,119491664,119492608
17223,4,1,1,2412,-92,-91,-1,a6:e5:7c:28:b1:d3,119500181,944,6629,119499237,119500181
17224,4,1,1,2412,-82,-91,9,54:e4:3a:ec:fb:64,119543051,2160,40710,119540891,119543051
17225,6,6,1,2412,-89,-91,2,40:e3:d6:de:1e:61,119558992,368,15573,119558624,119558992
17226,4,1,1,2412,-83,-91,8,b8:3a:5a:88:e6:e1,119573880,2376,12512,119571504,119573880
17227,6,12,1,2412,-65,-91,26,40:e3:d6:da:ba:20,119587756,160,13716,119587596,119587756
17228,6,6,1,2412,-65,-91,26,40:e3:d6:da:ba:21,119587966,368,-158,119587598,119587966
17229,6,12,1,2412,-65,-91,26,40:e3:d6:da:ba:22,119588353,180,207,119588173,119588353
17230,6,12,1,2412,-64,-91,27,40:e3:d6:da:ba:23,119588577,184,40,119588393,119588577
17231,6,12,1,2412,-64,-91,27,40:e3:d6:da:ba:24,119588804,176,51,119588628,119588804
17232,6,12,1,2412,-65,-91,26,40:e3:d6:da:ba:25,119589014,160,50,119588854,119589014
17233,6,6,1,2412,-65,-91,26,40:e3:d6:da:ba:26,119589224,380,-170,119588844,119589224
17234,4,1,1,2412,-86,-91,5,4c:34:88:0f:e5:c4,119604843,784,14835,119604059,119604843
17235,4,1,1,2412,-82,-91,9,b8:3a:5a:88:e6:e0,119605980,2240,-1103,119603740,119605980
17236,4,1,1,2412,-82,-91,9,b8:3a:5a:88:e6:e1,119608267,2256,31,119606011,119608267
17237,4,1,1,2412,-81,-91,10,,119610534,304,1963,119610230,119610534
17238,6,6,1,2412,-87,-91,4,,119611070,44,492,119611026,119611070
17239,4,1,1,2412,-91,-91,0,c0:c9:e3:4d:6e:bf,119616120,872,4178,119615248,119616120
17240,4,1,1,2412,-83,-91,8,54:e4:3a:ec:fb:64,119635149,2112,16917,119633037,119635149
17241,4,1,1,2412,-82,-91,9,54:e4:3a:ec:fb:64,119637495,2112,234,119635383,119637495
17242,4,1,1,2412,-57,-91,34,54:e4:3a:ec:fb:64,119642388,2112,2781,119640276,119642388
17243,6,6,1,2412,-70,-91,21,e6:aa:ea:c9:ea:33,119659438,408,16642,119659030,119659438
17244,6,6,1,2412,-84,-91,7,e6:aa:ea:b7:4a:dd,119663405,408,3559,119662997,119663405
17245,6,6,1,2412,-70,-91,21,e6:aa:ea:c9:ea:33,119683681,408,19868,119683273,119683681
17246,6,6,1,2412,-84,-91,7,e6:aa:ea:b7:4a:dd,119687649,408,3560,119687241,119687649
17247,6,6,1,2412,-67,-91,24,40:e3:d6:da:ba:26,119691560,380,3531,119691180,119691560
17248,6,6,1,2412,-70,-91,21,e6:aa:ea:c9:ea:33,119695800,408,3832,119695392,119695800
17249,6,6,1,2412,-82,-91,9,e6:aa:ea:b7:4a:dd,119711871,408,15663,119711463,119711871
17250,4,1,1,2412,-83,-91,8,54:e4:3a:ec:fb:64,119748033,2160,34002,119745873,119748033
17251,4,1,1,2412,-80,-91,11,b8:3a:5a:88:e6:e0,119776280,2360,25887,119773920,119776280
17252,4,1,1,2412,-83,-91,8,b8:3a:5a:88:e6:e1,119778660,2376,4,119776284,119778660
17253,6,12,1,2412,-68,-91,23,40:e3:d6:da:ba:20,119792539,160,13719,119792379,119792539
17254,6,6,1,2412,-68,-91,23,40:e3:d6:da:ba:21,119792749,368,-158,119792381,119792749
17255,6,12,1,2412,-68,-91,23,40:e3:d6:da:ba:22,119793145,180,216,119792965,119793145
17256,6,12,1,2412,-68,-91,23,40:e3:d6:da:ba:23,119793369,184,40,119793185,119793369
17257,6,12,1,2412,-68,-91,23,40:e3:d6:da:ba:24,119793587,176,42,119793411,119793587
17258,6,12,1,2412,-68,-91,23,40:e3:d6:da:ba:25,119793822,160,75,119793662,119793822
17259,6,6,1,2412,-68,-91,23,40:e3:d6:da:ba:26,119794041,380,-161,119793661,119794041
17260,4,1,1,2412,-83,-91,8,54:e4:3a:ec:fb:64,119850248,2160,54047,119848088,119850248
17261,4,1,1,2412,-81,-91,10,b8:3a:5a:88:e6:e0,119878704,2360,26096,119876344,119878704
17262,4,1,1,2412,-82,-91,9,b8:3a:5a:88:e6:e1,119881083,2376,3,119878707,119881083
17263,6,12,1,2412,-68,-91,23,40:e3:d6:da:ba:20,119894965,160,13722,119894805,119894965
17264,6,12,1,2412,-68,-91,23,40:e3:d6:da:ba:22,119898031,180,2886,119897851,119898031
17265,6,12,1,2412,-68,-91,23,40:e3:d6:da:ba:23,119898237,184,22,119898053,119898237
17266,6,12,1,2412,-68,-91,23,40:e3:d6:da:ba:24,119898464,176,51,119898288,119898464
17267,6,12,1,2412,-68,-91,23,40:e3:d6:da:ba:25,119898675,160,51,119898515,119898675
17268,6,6,1,2412,-68,-91,23,40:e3:d6:da:ba:26,119898866,380,-189,119898486,119898866
17269,4,1,1,2412,-81,-91,10,b8:3a:5a:88:e6:e0,119949328,2240,48222,119947088,119949328
17270,4,1,1,2412,-81,-91,10,b8:3a:5a:88:e6:e1,119952654,2256,1070,119950398,119952654
17271,4,1,1,2412,-83,-91,8,b8:3a:5a:88:e6:e1,119973168,2256,18258,119970912,119973168
17272,6,6,1,2412,-69,-91,22,e6:aa:ea:c9:ea:33,119979501,408,5925,119979093,119979501
17273,4,1,1,2412,-82,-91,9,b8:3a:5a:88:e6:e0,119981159,2360,-702,119978799,119981159
17274,4,1,1,2412,-77,-91,14,1e:92:4f:db:52:5d,119987851,1448,5244,119986403,119987851
17275,6,12,1,2412,-67,-91,24,40:e3:d6:da:ba:20,119989273,136,1286,119989137,119989273
17276,6,6,1,2412,-67,-91,24,40:e3:d6:da:ba:21,119989468,348,-153,119989120,119989468
17277,6,6,1,2412,-69,-91,22,e6:aa:ea:c9:ea:33,119991608,408,1732,119991200,119991608
17278,6,6,1,2412,-69,-91,22,e6:aa:ea:c9:ea:33,120003729,408,11713,120003321,120003729
17279,4,1,1,2412,-81,-91,10,b8:3a:5a:88:e6:e1,120011478,2256,5493,120009222,120011478
17280,6,6,1,2412,-69,-91,22,e6:aa:ea:c9:ea:33,120015861,408,3975,120015453,120015861
17281,4,1,1,2412,-82,-91,9,b8:3a:5a:88:e6:e0,120062306,2240,44205,120060066,120062306
17282,4,1,1,2412,-82,-91,9,b8:3a:5a:88:e6:e0,120082750,2240,18204,120080510,120082750
17283,4,1,1,2412,-71,-91,20,,120085002,304,1948,120084698,120085002
17284,4,1,1,2412,-83,-91,8,b8:3a:5a:88:e6:e0,120085339,2360,-2023,120082979,120085339
17285,4,1,1,2412,-83,-91,8,b8:3a:5a:88:e6:e1,120090150,2256,2555,120087894,120090150
17286,6,12,1,2412,-66,-91,25,40:e3:d6:da:ba:20,120099763,160,9453,120099603,120099763
17287,6,6,1,2412,-66,-91,25,40:e3:d6:da:ba:21,120099955,368,-176,120099587,120099955
17288,6,12,1,2412,-66,-91,25,40:e3:d6:da:ba:22,120100369,180,234,120100189,120100369
17289,6,12,1,2412,-66,-91,25,40:e3:d6:da:ba:23,120100602,184,49,120100418,120100602
17290,6,12,1,2412,-66,-91,25,40:e3:d6:da:ba:24,120100811,176,33,120100635,120100811
17291,6,12,1,2412,-66,-91,25,40:e3:d6:da:ba:25,120101012,160,41,120100852,120101012
17292,6,6,1,2412,-66,-91,25,40:e3:d6:da:ba:26,120101232,380,-160,120100852,120101232
17293,4,1,1,2412,-87,-91,4,54:e4:3a:ec:fb:64,120157445,2160,54053,120155285,120157445
17294,6,6,1,2412,-82,-91,9,e6:aa:ea:b7:4a:dd,120183757,408,25904,120183349,120183757
17295,4,1,1,2412,-83,-91,8,b8:3a:5a:88:e6:e0,120185902,2360,-215,120183542,120185902
17296,4,1,1,2412,-81,-91,10,b8:3a:5a:88:e6:e1,120188309,2376,31,120185933,120188309
17297,6,6,1,2412,-83,-91,8,e6:aa:ea:b7:4a:dd,120195877,408,7160,120195469,120195877
17298,6,12,1,2412,-67,-91,24,40:e3:d6:da:ba:20,120202146,160,6109,120201986,120202146
17299,6,6,1,2412,-67,-91,24,40:e3:d6:da:ba:21,120202356,368,-158,120201988,120202356
17300,6,12,1,2412,-67,-91,24,40:e3:d6:da:ba:22,120202761,180,225,120202581,120202761
17301,6,12,1,2412,-67,-91,24,40:e3:d6:da:ba:23,120202976,184,31,120202792,120202976
17302,6,12,1,2412,-67,-91,24,40:e3:d6:da:ba:24,120203185,176,33,120203009,120203185
17303,6,12,1,2412,-66,-91,25,40:e3:d6:da:ba:25,120203405,160,60,120203245,120203405
17304,6,6,1,2412,-67,-91,24,40:e3:d6:da:ba:26,120203606,380,-179,120203226,120203606
17305,6,6,1,2412,-82,-91,9,e6:aa:ea:b7:4a:dd,120208012,408,3998,120207604,120208012
17306,6,6,1,2412,-82,-91,9,e6:aa:ea:b7:4a:dd,120220108,408,11688,120219700,120220108
17307,6,6,1,2412,-69,-91,22,e6:aa:ea:c9:ea:33,120282526,408,62010,120282118,120282526
17308,6,6,1,2412,-69,-91,22,e6:aa:ea:c9:ea:33,120294648,408,11714,120294240,120294648
17309,6,6,1,2412,-69,-91,22,40:e3:d6:da:ba:21,120304753,368,9737,120304385,120304753
17310,6,12,1,2412,-69,-91,22,40:e3:d6:da:ba:22,120305158,180,225,120304978,120305158
17311,6,12,1,2412,-69,-91,22,40:e3:d6:da:ba:23,120305381,184,39,120305197,120305381
17312,6,12,1,2412,-69,-91,22,40:e3:d6:da:ba:24,120305675,176,118,120305499,120305675
17313,6,6,1,2412,-69,-91,22,e6:aa:ea:c9:ea:33,120318888,408,12805,120318480,120318888
17314,6,6,1,2412,-69,-91,22,e6:aa:ea:c9:ea:33,120331000,408,11704,120330592,120331000
17315,4,1,1,2412,-91,-91,0,a6:e5:7c:28:b1:d3,120343452,944,11508,120342508,120343452
17316,4,1,1,2412,-90,-91,1,a6:e5:7c:28:b1:d3,120345589,944,1193,120344645,120345589
17317,4,1,1,2412,-90,-91,1,a6:e5:7c:28:b1:d3,120346658,944,125,120345714,120346658
17318,4,1,1,2412,-90,-91,1,a6:e5:7c:28:b1:d3,120347754,944,152,120346810,120347754
17319,4,1,1,2412,-92,-91,-1,a6:e5:7c:28:b1:d3,120348832,944,134,120347888,120348832
17320,4,1,1,2412,-92,-91,-1,a6:e5:7c:28:b1:d3,120351053,944,1277,120350109,120351053
17321,4,1,1,2412,-90,-91,1,a6:e5:7c:28:b1:d3,120353236,944,1239,120352292,120353236
17322,4,1,1,2412,-88,-91,3,a6:e5:7c:28:b1:d3,120354350,944,170,120353406,120354350
17323,4,1,1,2412,-91,-91,0,a6:e5:7c:28:b1:d3,120366713,944,11419,120365769,120366713
17324,4,1,1,2412,-91,-91,0,a6:e5:7c:28:b1:d3,120368869,944,1212,120367925,120368869
17325,4,1,1,2412,-91,-91,0,a6:e5:7c:28:b1:d3,120369947,944,134,120369003,120369947
17326,6,12,1,2412,-68,-91,23,40:e3:d6:da:ba:20,120416624,160,46517,120416464,120416624
17327,6,6,1,2412,-68,-91,23,40:e3:d6:da:ba:21,120416825,368,-167,120416457,120416825
17328,6,12,1,2412,-68,-91,23,40:e3:d6:da:ba:22,120417212,180,207,120417032,120417212
17329,6,12,1,2412,-68,-91,23,40:e3:d6:da:ba:23,120417426,184,30,120417242,120417426
17330,6,12,1,2412,-67,-91,24,40:e3:d6:da:ba:24,120417636,176,34,120417460,120417636
17331,6,12,1,2412,-68,-91,23,40:e3:d6:da:ba:25,120417864,160,68,120417704,120417864
17332,6,6,1,2412,-68,-91,23,40:e3:d6:da:ba:26,120418056,380,-188,120417676,120418056
17333,4,1,1,2412,-87,-91,4,54:e4:3a:ec:fb:64,120464642,2160,44426,120462482,120464642
17334,6,6,1,2412,-77,-91,14,40:e3:d6:de:1e:66,120481818,380,16796,120481438,120481818
17335,4,1,1,2412,-79,-91,12,b8:3a:5a:88:e6:e1,120495588,2376,11394,120493212,120495588
17336,6,6,1,2412,-85,-91,6,e6:aa:ea:b7:4a:dd,120498544,408,2548,120498136,120498544
17337,6,12,1,2412,-67,-91,24,40:e3:d6:da:ba:20,120509342,160,10638,120509182,120509342
17338,6,6,1,2412,-67,-91,24,40:e3:d6:da:ba:21,120509561,368,-149,120509193,120509561
17339,6,12,1,2412,-66,-91,25,40:e3:d6:da:ba:22,120509966,180,225,120509786,120509966
17340,6,12,1,2412,-66,-91,25,40:e3:d6:da:ba:23,120510172,184,22,120509988,120510172
17341,6,12,1,2412,-66,-91,25,40:e3:d6:da:ba:24,120510390,176,42,120510214,120510390
17342,6,12,1,2412,-66,-91,25,40:e3:d6:da:ba:25,120510619,160,69,120510459,120510619
17343,6,6,1,2412,-66,-91,25,40:e3:d6:da:ba:26,120510810,380,-189,120510430,120510810
17344,6,6,1,2412,-82,-91,9,e6:aa:ea:b7:4a:dd,120511596,408,378,120511188,120511596
17345,6,6,1,2412,-85,-91,6,e6:aa:ea:b7:4a:dd,120547073,408,35069,120546665,120547073
17346,4,1,1,2412,-92,-91,-1,c0:c9:e3:4d:6e:bf,120603982,872,56037,120603110,120603982
17347,6,12,1,2412,-66,-91,25,40:e3:d6:da:ba:20,120611753,160,7611,120611593,120611753
17348,6,6,1,2412,-67,-91,24,40:e3:d6:da:ba:21,120611954,368,-167,120611586,120611954
17349,6,12,1,2412,-66,-91,25,40:e3:d6:da:ba:22,120612341,180,207,120612161,120612341
17350,6,12,1,2412,-66,-91,25,40:e3:d6:da:ba:23,120612555,184,30,120612371,120612555
17351,6,12,1,2412,-66,-91,25,40:e3:d6:da:ba:24,120612783,176,52,120612607,120612783
17352,6,12,1,2412,-66,-91,25,40:e3:d6:da:ba:25,120612984,160,41,120612824,120612984
17353,6,6,1,2412,-66,-91,25,40:e3:d6:da:ba:26,120613194,380,-170,120612814,120613194
17354,6,12,1,2412,-67,-91,24,40:e3:d6:da:ba:20,120624258,960,10104,120623298,120624258
17355,4,1,1,2412,-51,-91,40,54:e4:3a:ec:fb:64,120669440,2160,43022,120667280,120669440
17356,4,1,1,2412,-80,-91,11,b8:3a:5a:88:e6:e0,120697900,2360,26100,120695540,120697900
17357,6,6,1,2412,-71,-91,20,e6:aa:ea:c9:ea:33,120712379,408,14071,120711971,120712379
17358,6,12,1,2412,-67,-91,24,40:e3:d6:da:ba:20,120714166,160,1627,120714006,120714166
17359,6,6,1,2412,-67,-91,24,40:e3:d6:da:ba:21,120714367,368,-167,120713999,120714367
17360,6,12,1,2412,-67,-91,24,40:e3:d6:da:ba:22,120714781,180,234,120714601,120714781
17361,6,6,1,2412,-71,-91,20,e6:aa:ea:c9:ea:33,120724439,408,9250,120724031,120724439
17362,6,6,1,2412,-71,-91,20,e6:aa:ea:c9:ea:33,120736581,408,11734,120736173,120736581
17363,4,1,1,2412,-90,-91,1,a6:e5:7c:28:b1:d3,120759685,992,22112,120758693,120759685
17364,4,1,1,2412,-78,-91,13,b8:3a:5a:88:e6:e0,120763730,2240,1805,120761490,120763730
17365,4,1,1,2412,-81,-91,10,b8:3a:5a:88:e6:e1,120766026,2256,40,120763770,120766026
17366,4,1,1,2412,-84,-91,7,54:e4:3a:ec:fb:64,120771839,2160,3653,120769679,120771839
17367,6,6,1,2412,-80,-91,11,84:1b:5e:df:1b:99,120775561,80,3642,120775481,120775561
17368,4,1,1,2412,-81,-91,10,b8:3a:5a:88:e6:e1,120802695,2376,24758,120800319,120802695
17369,6,12,1,2412,-66,-91,25,40:e3:d6:da:ba:20,120816564,160,13709,120816404,120816564
17370,6,6,1,2412,-65,-91,26,40:e3:d6:da:ba:21,120816783,368,-149,120816415,120816783
17371,6,12,1,2412,-66,-91,25,40:e3:d6:da:ba:22,120817179,180,216,120816999,120817179
17372,6,12,1,2412,-66,-91,25,40:e3:d6:da:ba:23,120817402,184,39,120817218,120817402
17373,6,12,1,2412,-66,-91,25,40:e3:d6:da:ba:25,120817840,160,278,120817680,120817840
17374,6,6,1,2412,-65,-91,26,40:e3:d6:da:ba:26,120818032,380,-188,120817652,120818032
17375,4,1,1,2412,-81,-91,10,b8:3a:5a:88:e6:e0,120903193,2360,82801,120900833,120903193
17376,4,1,1,2412,-81,-91,10,b8:3a:5a:88:e6:e1,120906313,2376,744,120903937,120906313
17377,4,1,1,2412,-82,-91,9,b8:3a:5a:88:e6:e1,120913705,2256,5136,120911449,120913705
17378,6,12,1,2412,-67,-91,24,40:e3:d6:da:ba:20,120920816,160,6951,120920656,120920816
17379,6,6,1,2412,-67,-91,24,40:e3:d6:da:ba:21,120921017,368,-167,120920649,120921017
17380,6,12,1,2412,-66,-91,25,40:e3:d6:da:ba:22,120921413,180,216,120921233,120921413
17381,6,12,1,2412,-67,-91,24,40:e3:d6:da:ba:23,120921619,184,22,120921435,120921619
17382,6,12,1,2412,-67,-91,24,40:e3:d6:da:ba:24,120921846,176,51,120921670,120921846
17383,6,12,1,2412,-67,-91,24,40:e3:d6:da:ba:25,120922048,160,42,120921888,120922048
17384,6,6,1,2412,-67,-91,24,40:e3:d6:da:ba:26,120922240,380,-188,120921860,120922240
17385,6,12,1,2412,-67,-91,24,40:e3:d6:da:ba:20,120952196,136,29820,120952060,120952196
17386,6,6,1,2412,-87,-91,4,40:e3:d6:de:1e:61,120954502,348,1958,120954154,120954502
17387,4,1,1,2412,-61,-91,30,b8:3a:5a:88:e6:e0,120963687,2240,6945,120961447,120963687
17388,4,1,1,2412,-83,-91,8,b8:3a:5a:88:e6:e1,120976168,2256,10225,120973912,120976168
17389,6,12,1,2412,-86,-91,5,40:e3:d6:de:1e:62,120992998,176,16654,120992822,120992998
17390,6,6,1,2412,-86,-91,5,40:e3:d6:de:1e:66,120993817,380,439,120993437,120993817
17391,4,1,1,2412,-82,-91,9,b8:3a:5a:88:e6:e0,121005090,2360,8913,121002730,121005090
17392,6,6,1,2412,-81,-91,10,e6:aa:ea:b7:4a:dd,121018522,408,13024,121018114,121018522
17393,6,12,1,2412,-68,-91,23,40:e3:d6:da:ba:20,121021357,160,2675,121021197,121021357
17394,6,6,1,2412,-68,-91,23,40:e3:d6:da:ba:21,121021576,368,-149,121021208,121021576
17395,6,12,1,2412,-68,-91,23,40:e3:d6:da:ba:22,121021990,180,234,121021810,121021990
17396,6,12,1,2412,-68,-91,23,40:e3:d6:da:ba:23,121022213,184,39,121022029,121022213
17397,6,12,1,2412,-67,-91,24,40:e3:d6:da:ba:24,121022450,176,61,121022274,121022450
17398,6,12,1,2412,-68,-91,23,40:e3:d6:da:ba:25,121022669,160,59,121022509,121022669
17399,6,6,1,2412,-67,-91,24,40:e3:d6:da:ba:26,121022861,380,-188,121022481,121022861
17400,6,6,1,2412,-83,-91,8,e6:aa:ea:b7:4a:dd,121042756,408,19487,121042348,121042756
17401,6,6,1,2412,-84,-91,7,e6:aa:ea:b7:4a:dd,121066995,408,23831,121066587,121066995
17402,4,1,1,2412,-84,-91,7,54:e4:3a:ec:fb:64,121080511,2160,11356,121078351,121080511
17403,6,6,1,2412,-87,-91,4,40:e3:d6:de:1e:61,121095637,368,14758,121095269,121095637
17404,6,12,1,2412,-85,-91,6,40:e3:d6:de:1e:62,121096051,176,238,121095875,121096051
17405,6,12,1,2412,-88,-91,3,40:e3:d6:de:1e:63,121096252,180,21,121096072,121096252
17406,6,12,1,2412,-86,-91,5,40:e3:d6:de:1e:64,121096475,172,51,121096303,121096475
17407,4,1,1,2412,-81,-91,10,b8:3a:5a:88:e6:e0,121107632,2360,8797,121105272,121107632
17408,6,12,1,2412,-68,-91,23,40:e3:d6:da:ba:20,121123753,160,15961,121123593,121123753
17409,6,6,1,2412,-68,-91,23,40:e3:d6:da:ba:21,121123972,368,-149,121123604,121123972
17410,6,12,1,2412,-68,-91,23,40:e3:d6:da:ba:22,121124359,180,207,121124179,121124359
17411,6,12,1,2412,-68,-91,23,40:e3:d6:da:ba:23,121124573,184,30,121124389,121124573
17412,6,12,1,2412,-67,-91,24,40:e3:d6:da:ba:24,121124792,176,43,121124616,121124792
17413,6,12,1,2412,-68,-91,23,40:e3:d6:da:ba:25,121125020,160,68,121124860,121125020
17414,6,6,1,2412,-68,-91,23,40:e3:d6:da:ba:26,121125239,380,-161,121124859,121125239
17415,4,1,1,2412,-90,-91,1,,121139835,304,14292,121139531,121139835
17416,4,1,1,2412,-89,-91,2,a6:e5:7c:28:b1:d3,121169174,992,28347,121168182,121169174
17417,4,5.5,1,2412,-89,-91,2,ae:6a:50:8c:bb:bd,121190539,302,21063,121190237,121190539
17418,4,5.5,1,2412,-90,-91,1,,121190858,213,106,121190645,121190858
17419,6,12,1,2412,-68,-91,23,40:e3:d6:da:ba:20,121190930,136,-64,121190794,121190930
17420,6,6,1,2412,-68,-91,23,40:e3:d6:da:ba:21,121191134,348,-144,121190786,121191134
17421,6,12,1,2412,-68,-91,23,40:e3:d6:da:ba:22,121191510,156,220,121191354,121191510
17422,6,12,1,2412,-68,-91,23,40:e3:d6:da:ba:23,121191727,156,61,121191571,121191727
17423,6,12,1,2412,-68,-91,23,40:e3:d6:da:ba:25,121191936,136,73,121191800,121191936
17424,6,12,1,2412,-86,-91,5,40:e3:d6:de:1e:64,121198255,172,6147,121198083,121198255
17425,6,12,1,2412,-85,-91,6,40:e3:d6:de:1e:65,121198452,156,41,121198296,121198452
17426,6,6,1,2412,-86,-91,5,40:e3:d6:de:1e:66,121198667,380,-165,121198287,121198667
17427,4,1,1,2412,-88,-91,3,a6:e5:7c:28:b1:d3,121201795,944,2184,121200851,121201795
17428,4,1,1,2412,-66,-91,25,,121202753,304,654,121202449,121202753
17429,4,1,1,2412,-89,-91,2,,121216713,304,13656,121216409,121216713
17430,6,6,1,2412,-74,-91,17,e6:aa:ea:c9:ea:33,121221487,408,4366,121221079,121221487
17431,6,12,1,2412,-68,-91,23,40:e3:d6:da:ba:20,121226163,160,4516,121226003,121226163
17432,6,6,1,2412,-74,-91,17,e6:aa:ea:c9:ea:33,121233298,408,6727,121232890,121233298
17433,6,6,1,2412,-74,-91,17,e6:aa:ea:c9:ea:33,121245410,408,11704,121245002,121245410
17434,6,6,1,2412,-74,-91,17,e6:aa:ea:c9:ea:33,121257535,408,11717,121257127,121257535
17435,4,1,1,2412,-91,-91,0,a4:e5:7c:28:b1:d3,121258564,688,341,121257876,121258564
17436,6,6,1,2412,-74,-91,17,e6:aa:ea:c9:ea:33,121269658,408,10686,121269250,121269658
17437,4,1,1,2412,-90,-91,1,a6:e5:7c:28:b1:d3,121288817,944,18215,121287873,121288817
17438,4,1,1,2412,-81,-91,10,a6:e5:7c:28:b1:d3,121289877,944,116,121288933,121289877
17439,4,1,1,2412,-92,-91,-1,a6:e5:7c:28:b1:d3,121293111,944,2290,121292167,121293111
17440,4,1,1,2412,-91,-91,0,a6:e5:7c:28:b1:d3,121296408,944,2353,121295464,121296408
17441,4,1,1,2412,-89,-91,2,a6:e5:7c:28:b1:d3,121299880,992,2480,121298888,121299880
17442,6,12,1,2412,-86,-91,5,40:e3:d6:de:1e:60,121300750,156,714,121300594,121300750
17443,6,6,1,2412,-86,-91,5,40:e3:d6:de:1e:61,121300947,368,-171,121300579,121300947
17444,6,12,1,2412,-85,-91,6,40:e3:d6:de:1e:65,121302010,156,907,121301854,121302010
17445,6,6,1,2412,-86,-91,5,40:e3:d6:de:1e:66,121302216,380,-174,121301836,121302216
17446,4,1,1,2412,-80,-91,11,b8:3a:5a:88:e6:e1,121314676,2376,10084,121312300,121314676
17447,6,12,1,2412,-69,-91,22,40:e3:d6:da:ba:20,121328546,160,13710,121328386,121328546
17448,6,6,1,2412,-69,-91,22,40:e3:d6:da:ba:21,121328747,368,-167,121328379,121328747
17449,6,12,1,2412,-69,-91,22,40:e3:d6:da:ba:22,121329152,180,225,121328972,121329152
17450,6,12,1,2412,-69,-91,22,40:e3:d6:da:ba:23,121329367,184,31,121329183,121329367
17451,6,12,1,2412,-69,-91,22,40:e3:d6:da:ba:24,121329585,176,42,121329409,121329585
17452,6,12,1,2412,-69,-91,22,40:e3:d6:da:ba:25,121329787,160,42,121329627,121329787
17453,6,6,1,2412,-69,-91,22,40:e3:d6:da:ba:26,121329979,380,-188,121329599,121329979
17454,6,12,1,2412,-88,-91,3,40:e3:d6:de:1e:60,121402028,156,71893,121401872,121402028
17455,6,6,1,2412,-87,-91,4,40:e3:d6:de:1e:61,121402234,368,-162,121401866,121402234
17456,6,6,1,2412,-87,-91,4,40:e3:d6:de:1e:66,121403476,380,862,121403096,121403476
17457,4,1,1,2412,-91,-91,0,a6:e5:7c:28:b1:d3,121411209,944,6789,121410265,121411209
17458,4,1,1,2412,-80,-91,11,b8:3a:5a:88:e6:e0,121414684,2360,1115,121412324,121414684
17459,4,1,1,2412,-81,-91,10,b8:3a:5a:88:e6:e1,121417063,2376,3,121414687,121417063
17460,6,12,1,2412,-68,-91,23,40:e3:d6:da:ba:20,121430945,160,13722,121430785,121430945
17461,6,6,1,2412,-66,-91,25,40:e3:d6:da:ba:21,121431156,368,-157,121430788,121431156
17462,6,12,1,2412,-68,-91,23,40:e3:d6:da:ba:22,121431570,180,234,121431390,121431570
17463,6,12,1,2412,-68,-91,23,40:e3:d6:da:ba:23,121431775,184,21,121431591,121431775
17464,6,12,1,2412,-68,-91,23,40:e3:d6:da:ba:24,121432003,176,52,121431827,121432003
17465,6,6,1,2412,-68,-91,23,40:e3:d6:da:ba:26,121432441,380,58,121432061,121432441
17466,6,12,1,2412,-86,-91,5,40:e3:d6:de:1e:62,121496632,156,64035,121496476,121496632
17467,6,12,1,2412,-87,-91,4,40:e3:d6:de:1e:63,121496822,156,34,121496666,121496822
17468,6,6,1,2412,-86,-91,5,40:e3:d6:de:1e:61,121507929,368,10739,121507561,121507929
17469,4,1,1,2412,-86,-91,5,a6:e5:7c:28:b1:d3,121509296,944,423,121508352,121509296
17470,4,1,1,2412,-92,-91,-1,a6:e5:7c:28:b1:d3,121510410,944,170,121509466,121510410
17471,6,12,1,2412,-88,-91,3,40:e3:d6:de:1e:64,121511546,172,964,121511374,121511546
17472,6,12,1,2412,-87,-91,4,40:e3:d6:de:1e:65,121511744,156,42,121511588,121511744
17473,6,6,1,2412,-85,-91,6,40:e3:d6:de:1e:66,121511941,380,-183,121511561,121511941
17474,4,1,1,2412,-79,-91,12,b8:3a:5a:88:e6:e0,121517216,2360,2915,121514856,121517216
17475,6,12,1,2412,-67,-91,24,40:e3:d6:da:ba:20,121533352,160,15976,121533192,121533352
17476,6,6,1,2412,-66,-91,25,40:e3:d6:da:ba:21,121533553,368,-167,121533185,121533553
17477,6,12,1,2412,-66,-91,25,40:e3:d6:da:ba:22,121533940,180,207,121533760,121533940
17478,6,12,1,2412,-66,-91,25,40:e3:d6:da:ba:23,121534154,184,30,121533970,121534154
17479,6,12,1,2412,-66,-91,25,40:e3:d6:da:ba:24,121534391,176,61,121534215,121534391
17480,6,12,1,2412,-66,-91,25,40:e3:d6:da:ba:25,121534601,160,50,121534441,121534601
17481,6,6,1,2412,-66,-91,25,40:e3:d6:da:ba:26,121534793,380,-188,121534413,121534793
17482,6,6,1,2412,-72,-91,19,e6:aa:ea:c9:ea:33,121536936,408,1735,121536528,121536936
17483,6,6,1,2412,-80,-91,11,e6:aa:ea:b7:4a:dd,121538733,408,1389,121538325,121538733
17484,6,6,1,2412,-72,-91,19,e6:aa:ea:c9:ea:33,121549050,408,9909,121548642,121549050
17485,6,6,1,2412,-80,-91,11,e6:aa:ea:b7:4a:dd,121550849,408,1391,121550441,121550849
17486,6,6,1,2412,-72,-91,19,e6:aa:ea:c9:ea:33,121561164,408,9907,121560756,121561164
17487,6,6,1,2412,-80,-91,11,e6:aa:ea:b7:4a:dd,121562968,408,1396,121562560,121562968
17488,6,6,1,2412,-72,-91,19,e6:aa:ea:c9:ea:33,121585406,408,22030,121584998,121585406
17489,6,6,1,2412,-80,-91,11,e6:aa:ea:b7:4a:dd,121587195,408,1381,121586787,121587195
17490,4,1,1,2412,-90,-91,1,a6:e5:7c:28:b1:d3,121595919,944,7780,121594975,121595919
17491,4,1,1,2412,-82,-91,9,a6:e5:7c:28:b1:d3,121599323,944,2460,121598379,121599323
17492,4,1,1,2412,-90,-91,1,a6:e5:7c:28:b1:d3,121600392,944,125,121599448,121600392
17493,4,1,1,2412,-78,-91,13,a6:e5:7c:28:b1:d3,121605058,944,3722,121604114,121605058
17494,4,1,1,2412,-90,-91,1,a6:e5:7c:28:b1:d3,121606136,944,134,121605192,121606136
17495,6,12,1,2412,-88,-91,3,40:e3:d6:de:1e:60,121608314,156,2022,121608158,121608314
17496,6,6,1,2412,-88,-91,3,40:e3:d6:de:1e:61,121608529,368,-153,121608161,121608529
17497,6,12,1,2412,-88,-91,3,40:e3:d6:de:1e:62,121608943,176,238,121608767,121608943
17498,6,12,1,2412,-88,-91,3,40:e3:d6:de:1e:63,121609171,180,48,121608991,121609171
17499,6,12,1,2412,-88,-91,3,40:e3:d6:de:1e:64,121609377,172,34,121609205,121609377
17500,6,12,1,2412,-87,-91,4,40:e3:d6:de:1e:65,121609584,156,51,121609428,121609584
17501,6,6,1,2412,-88,-91,3,40:e3:d6:de:1e:66,121609771,380,-193,121609391,121609771
17502,4,1,1,2412,-79,-91,12,b8:3a:5a:88:e6:e0,121619501,2360,7370,121617141,121619501
17503,4,1,1,2412,-80,-91,11,b8:3a:5a:88:e6:e1,121621881,2376,4,121619505,121621881
17504,6,12,1,2412,-66,-91,25,40:e3:d6:da:ba:20,121635767,160,13726,121635607,121635767
17505,6,6,1,2412,-66,-91,25,40:e3:d6:da:ba:21,121635959,368,-176,121635591,121635959
17506,6,12,1,2412,-66,-91,25,40:e3:d6:da:ba:22,121636364,180,225,121636184,121636364
17507,6,12,1,2412,-65,-91,26,40:e3:d6:da:ba:23,121636613,184,65,121636429,121636613
17508,6,12,1,2412,-66,-91,25,40:e3:d6:da:ba:24,121636849,176,60,121636673,121636849
17509,6,12,1,2412,-66,-91,25,40:e3:d6:da:ba:25,121637051,160,42,121636891,121637051
17510,6,6,1,2412,-66,-91,25,40:e3:d6:da:ba:26,121637270,380,-161,121636890,121637270
17511,4,1,1,2412,-91,-91,0,a6:e5:7c:28:b1:d3,121698220,944,60006,121697276,121698220
17512,4,1,1,2412,-91,-91,0,a6:e5:7c:28:b1:d3,121699298,944,134,121698354,121699298
17513,4,1,1,2412,-92,-91,-1,a6:e5:7c:28:b1:d3,121700403,944,161,121699459,121700403
17514,4,1,1,2412,-79,-91,12,b8:3a:5a:88:e6:e0,121722390,2360,19627,121720030,121722390
17515,4,1,1,2412,-82,-91,9,b8:3a:5a:88:e6:e1,121724797,2376,31,121722421,121724797
17516,6,12,1,2412,-65,-91,26,40:e3:d6:da:ba:20,121738166,160,13209,121738006,121738166
17517,6,6,1,2412,-65,-91,26,40:e3:d6:da:ba:21,121738358,368,-176,121737990,121738358
17518,6,12,1,2412,-65,-91,26,40:e3:d6:da:ba:22,121738745,180,207,121738565,121738745
17519,6,12,1,2412,-65,-91,26,40:e3:d6:da:ba:23,121738959,184,30,121738775,121738959
17520,6,12,1,2412,-65,-91,26,40:e3:d6:da:ba:25,121739388,160,269,121739228,121739388
17521,6,6,1,2412,-65,-91,26,40:e3:d6:da:ba:26,121739580,380,-188,121739200,121739580
17522,6,12,1,2412,-86,-91,5,40:e3:d6:de:1e:65,121762809,136,23093,121762673,121762809
17523,4,1,1,2412,-86,-91,5,54:e4:3a:ec:fb:64,121795831,2160,30862,121793671,121795831
17524,4,1,1,2412,-80,-91,11,b8:3a:5a:88:e6:e0,121824953,2360,26762,121822593,121824953
17525,4,1,1,2412,-81,-91,10,b8:3a:5a:88:e6:e1,121827350,2376,21,121824974,121827350
17526,6,12,1,2412,-64,-91,27,40:e3:d6:da:ba:20,121840562,160,13052,121840402,121840562
17527,6,6,1,2412,-64,-91,27,40:e3:d6:da:ba:21,121840754,368,-176,121840386,121840754
17528,6,12,1,2412,-64,-91,27,40:e3:d6:da:ba:22,121841159,180,225,121840979,121841159
17529,6,12,1,2412,-64,-91,27,40:e3:d6:da:ba:23,121841392,184,49,121841208,121841392
17530,6,12,1,2412,-64,-91,27,40:e3:d6:da:ba:24,121841619,176,51,121841443,121841619
17531,6,12,1,2412,-64,-91,27,40:e3:d6:da:ba:25,121841830,160,51,121841670,121841830
17532,4,1,1,2412,-75,-91,16,24:f6:77:10:02:c8,121842189,656,-297,121841533,121842189
17533,6,6,1,2412,-63,-91,28,40:e3:d6:da:ba:26,121842720,380,151,121842340,121842720
17534,6,12,1,2412,-64,-91,27,40:e3:d6:da:ba:23,121844221,156,1345,121844065,121844221
17535,4,1,1,2412,-76,-91,15,24:f6:77:10:02:c8,121862136,656,17259,121861480,121862136
17536,4,1,1,2412,-76,-91,15,24:f6:77:10:02:c8,121862803,704,-37,121862099,121862803
17537,4,1,1,2412,-75,-91,16,24:f6:77:10:02:c8,121863517,664,50,121862853,121863517
17538,6,12,1,2412,-64,-91,27,40:e3:d6:da:ba:23,121864137,156,464,121863981,121864137
17539,4,1,1,2412,-85,-91,6,54:e4:3a:ec:fb:64,121898271,2160,31974,121896111,121898271
17540,4,1,1,2412,-55,-91,36,b8:3a:5a:88:e6:e0,121926685,2360,26054,121924325,121926685
17541,6,12,1,2412,-64,-91,27,40:e3:d6:da:ba:20,121942955,160,16110,121942795,121942955
17542,6,6,1,2412,-64,-91,27,40:e3:d6:da:ba:21,121943165,368,-158,121942797,121943165
17543,6,12,1,2412,-64,-91,27,40:e3:d6:da:ba:22,121943579,180,234,121943399,121943579
17544,6,12,1,2412,-63,-91,28,40:e3:d6:da:ba:23,121943802,184,39,121943618,121943802
17545,6,12,1,2412,-64,-91,27,40:e3:d6:da:ba:24,121944030,176,52,121943854,121944030
17546,6,12,1,2412,-64,-91,27,40:e3:d6:da:ba:25,121944240,160,50,121944080,121944240
17547,6,6,1,2412,-65,-91,26,40:e3:d6:da:ba:26,121944459,380,-161,121944079,121944459
17548,6,6,1,2412,-72,-91,19,e6:aa:ea:c9:ea:33,121953966,408,9099,121953558,121953966
17549,6,6,1,2412,-72,-91,19,e6:aa:ea:c9:ea:33,121966090,408,11716,121965682,121966090
17550,6,6,1,2412,-72,-91,19,e6:aa:ea:c9:ea:33,121978207,408,11709,121977799,121978207
17551,4,1,1,2412,-91,-91,0,a6:e5:7c:28:b1:d3,121988901,992,9702,121987909,121988901
17552,6,6,1,2412,-72,-91,19,e6:aa:ea:c9:ea:33,121990330,408,1021,121989922,121990330
17553,4,1,1,2412,-80,-91,11,72:89:dc:38:d5:9f,121998780,1208,7242,121997572,121998780
17554,4,1,1,2412,-75,-91,16,1e:6f:d2:49:3c:80,122000478,1128,570,121999350,122000478
17555,4,1,1,2412,-83,-91,8,,122007075,304,6293,122006771,122007075
17556,6,12,1,2412,-82,-91,9,,122007411,32,304,122007379,122007411
17557,6,12,1,2412,-81,-91,10,,122008190,32,747,122008158,122008190
17558,6,12,1,2412,-83,-91,8,,122008429,32,207,122008397,122008429
17559,4,1,1,2412,-81,-91,10,1e:6f:d2:49:3c:80,122021341,1128,11784,122020213,122021341
17560,6,6,1,2412,-80,-91,11,,122028052,44,6667,122028008,122028052
17561,6,12,1,2412,-83,-91,8,,122028551,32,467,122028519,122028551
17562,4,1,1,2412,-79,-91,12,b8:3a:5a:88:e6:e0,122029088,2360,-1823,122026728,122029088
17563,6,12,1,2412,-64,-91,27,40:e3:d6:da:ba:22,122045952,180,16684,122045772,122045952
17564,6,12,1,2412,-64,-91,27,40:e3:d6:da:ba:24,122046394,176,266,122046218,122046394
17565,6,12,1,2412,-65,-91,26,40:e3:d6:da:ba:25,122046604,160,50,122046444,122046604
17566,6,6,1,2412,-64,-91,27,40:e3:d6:da:ba:26,122046805,380,-179,122046425,122046805
17567,6,6,1,2412,-77,-91,14,e6:aa:ea:b7:4a:dd,122070452,408,23239,122070044,122070452
17568,4,1,1,2412,-92,-91,-1,c0:c9:e3:4d:6e:bf,122074171,872,2847,122073299,122074171
17569,6,6,1,2412,-80,-91,11,e6:aa:ea:b7:4a:dd,122094690,408,20111,122094282,122094690
17570,4,1,1,2412,-86,-91,5,54:e4:3a:ec:fb:64,122106584,2160,9734,122104424,122106584
17571,6,6,1,2412,-87,-91,4,40:e3:d6:de:1e:61,122119027,368,12075,122118659,122119027
17572,6,12,1,2412,-65,-91,26,40:e3:d6:da:ba:20,122147765,160,28578,122147605,122147765
17573,6,6,1,2412,-64,-91,27,40:e3:d6:da:ba:21,122147966,368,-167,122147598,122147966
17574,6,12,1,2412,-64,-91,27,40:e3:d6:da:ba:22,122148371,180,225,122148191,122148371
17575,6,12,1,2412,-64,-91,27,40:e3:d6:da:ba:23,122148594,184,39,122148410,122148594
17576,6,12,1,2412,-63,-91,28,40:e3:d6:da:ba:24,122148831,176,61,122148655,122148831
17577,6,12,1,2412,-64,-91,27,40:e3:d6:da:ba:25,122149032,160,41,122148872,122149032
17578,6,6,1,2412,-64,-91,27,40:e3:d6:da:ba:26,122149251,380,-161,122148871,122149251
17579,4,1,1,2412,-83,-91,8,b8:3a:5a:88:e6:e0,122233889,2360,82278,122231529,122233889
17580,4,1,1,2412,-82,-91,9,b8:3a:5a:88:e6:e1,122236268,2376,3,122233892,122236268
17581,6,12,1,2412,-65,-91,26,40:e3:d6:da:ba:20,122250149,160,13721,122249989,122250149
17582,6,6,1,2412,-65,-91,26,40:e3:d6:da:ba:21,122250350,368,-167,122249982,122250350
17583,6,12,1,2412,-64,-91,27,40:e3:d6:da:ba:22,122250764,180,234,122250584,122250764
17584,6,12,1,2412,-65,-91,26,40:e3:d6:da:ba:23,122250978,184,30,122250794,122250978
17585,6,12,1,2412,-64,-91,27,40:e3:d6:da:ba:24,122251215,176,61,122251039,122251215
17586,6,12,1,2412,-64,-91,27,40:e3:d6:da:ba:25,122251434,160,59,122251274,122251434
17587,6,6,1,2412,-65,-91,26,40:e3:d6:da:ba:26,122251660,380,-154,122251280,122251660
17588,6,6,1,2412,-74,-91,17,e6:aa:ea:c9:ea:33,122269842,408,17774,122269434,122269842
17589,6,6,1,2412,-75,-91,16,e6:aa:ea:c9:ea:33,122281983,408,11733,122281575,122281983
17590,4,1,1,2412,-85,-91,6,54:e4:3a:ec:fb:64,122288186,2160,4043,122286026,122288186
17591,6,6,1,2412,-75,-91,16,e6:aa:ea:c9:ea:33,122294102,408,5508,122293694,122294102
17592,6,6,1,2412,-75,-91,16,e6:aa:ea:c9:ea:33,122306192,408,11682,122305784,122306192
17593,6,6,1,2412,-76,-91,15,e6:aa:ea:c9:ea:33,122318387,408,11787,122317979,122318387
17594,4,1,1,2412,-82,-91,9,b8:3a:5a:88:e6:e0,122336291,2360,15544,122333931,122336291
17595,6,12,1,2412,-65,-91,26,40:e3:d6:da:ba:20,122352558,160,16107,122352398,122352558
17596,6,6,1,2412,-64,-91,27,40:e3:d6:da:ba:21,122352750,368,-176,122352382,122352750
17597,6,12,1,2412,-64,-91,27,40:e3:d6:da:ba:22,122353164,180,234,122352984,122353164
17598,6,12,1,2412,-65,-91,26,40:e3:d6:da:ba:23,122353397,184,49,122353213,122353397
17599,6,12,1,2412,-64,-91,27,40:e3:d6:da:ba:24,122353633,176,60,122353457,122353633
17600,6,12,1,2412,-65,-91,26,40:e3:d6:da:ba:25,122353862,160,69,122353702,122353862
17601,6,6,1,2412,-64,-91,27,40:e3:d6:da:ba:26,122354063,380,-179,122353683,122354063
17602,6,6,1,2412,-89,-91,2,40:e3:d6:de:1e:61,122426192,368,71761,122425824,122426192
17603,4,1,1,2412,-80,-91,11,b8:3a:5a:88:e6:e0,122438703,2360,10151,122436343,122438703
17604,4,1,1,2412,-81,-91,10,b8:3a:5a:88:e6:e1,122441110,2376,31,122438734,122441110
17605,6,12,1,2412,-65,-91,26,40:e3:d6:da:ba:20,122454950,160,13680,122454790,122454950
17606,6,6,1,2412,-64,-91,27,40:e3:d6:da:ba:21,122455151,368,-167,122454783,122455151
17607,6,12,1,2412,-64,-91,27,40:e3:d6:da:ba:22,122455556,180,225,122455376,122455556
17608,6,12,1,2412,-64,-91,27,40:e3:d6:da:ba:23,122455771,184,31,122455587,122455771
17609,6,12,1,2412,-64,-91,27,40:e3:d6:da:ba:24,122455980,176,33,122455804,122455980
17610,6,12,1,2412,-64,-91,27,40:e3:d6:da:ba:25,122456191,160,51,122456031,122456191
17611,6,6,1,2412,-64,-91,27,40:e3:d6:da:ba:26,122456383,380,-188,122456003,122456383
17612,6,12,1,2412,-86,-91,5,40:e3:d6:de:1e:60,122528422,156,71883,122528266,122528422
17613,6,6,1,2412,-85,-91,6,40:e3:d6:de:1e:61,122528628,368,-162,122528260,122528628
17614,4,1,1,2412,-82,-91,9,b8:3a:5a:88:e6:e1,122543589,2376,12585,122541213,122543589
17615,6,12,1,2412,-64,-91,27,40:e3:d6:da:ba:20,122557369,160,13620,122557209,122557369
17616,6,12,1,2412,-64,-91,27,40:e3:d6:da:ba:22,122558018,180,469,122557838,122558018
17617,6,12,1,2412,-64,-91,27,40:e3:d6:da:ba:23,122558251,184,49,122558067,122558251
17618,6,12,1,2412,-64,-91,27,40:e3:d6:da:ba:24,122558460,176,33,122558284,122558460
17619,6,12,1,2412,-64,-91,27,40:e3:d6:da:ba:25,122558689,160,69,122558529,122558689
17620,6,6,1,2412,-64,-91,27,40:e3:d6:da:ba:26,122558881,380,-188,122558501,122558881
17621,6,6,1,2412,-81,-91,10,e6:aa:ea:b7:4a:dd,122579452,408,20163,122579044,122579452
17622,6,6,1,2412,-81,-91,10,e6:aa:ea:b7:4a:dd,122591562,408,11702,122591154,122591562
17623,4,1,1,2412,-86,-91,5,54:e4:3a:ec:fb:64,122615023,2160,21301,122612863,122615023
17624,6,6,1,2412,-81,-91,10,e6:aa:ea:b7:4a:dd,122627933,408,12502,122627525,122627933
17625,6,12,1,2412,-86,-91,5,40:e3:d6:de:1e:60,122630808,156,2719,122630652,122630808
17626,6,12,1,2412,-64,-91,27,40:e3:d6:da:ba:20,122659769,160,28801,122659609,122659769
17627,6,12,1,2412,-64,-91,27,40:e3:d6:da:ba:22,122660357,180,408,122660177,122660357
17628,6,12,1,2412,-64,-91,27,40:e3:d6:da:ba:23,122660580,184,39,122660396,122660580
17629,6,12,1,2412,-64,-91,27,40:e3:d6:da:ba:24,122660799,176,43,122660623,122660799
17630,6,12,1,2412,-64,-91,27,40:e3:d6:da:ba:25,122661027,160,68,122660867,122661027
17631,6,6,1,2412,-64,-91,27,40:e3:d6:da:ba:26,122661220,380,-187,122660840,122661220
17632,4,1,1,2412,-86,-91,5,54:e4:3a:ec:fb:64,122717422,2160,54042,122715262,122717422
17633,6,12,1,2412,-85,-91,6,40:e3:d6:de:1e:60,122733213,156,15635,122733057,122733213
17634,6,6,1,2412,-85,-91,6,40:e3:d6:de:1e:61,122733429,368,-152,122733061,122733429
17635,6,12,1,2412,-65,-91,26,40:e3:d6:da:ba:20,122762179,160,28590,122762019,122762179
17636,6,6,1,2412,-64,-91,27,40:e3:d6:da:ba:21,122762398,368,-149,122762030,122762398
17637,6,12,1,2412,-65,-91,26,40:e3:d6:da:ba:22,122762785,180,207,122762605,122762785
17638,6,12,1,2412,-65,-91,26,40:e3:d6:da:ba:23,122762990,184,21,122762806,122762990
17639,6,12,1,2412,-64,-91,27,40:e3:d6:da:ba:24,122763200,176,34,122763024,122763200
17640,6,12,1,2412,-64,-91,27,40:e3:d6:da:ba:25,122763428,160,68,122763268,122763428
17641,6,6,1,2412,-64,-91,27,40:e3:d6:da:ba:26,122763629,380,-179,122763249,122763629
17642,6,6,1,2412,-74,-91,17,e6:aa:ea:c9:ea:33,122789781,408,25744,122789373,122789781
17643,6,6,1,2412,-74,-91,17,e6:aa:ea:c9:ea:33,122801901,408,11712,122801493,122801901
17644,6,12,1,2412,-85,-91,6,40:e3:d6:de:1e:60,122835623,156,33566,122835467,122835623
17645,6,6,1,2412,-84,-91,7,40:e3:d6:de:1e:61,122835838,368,-153,122835470,122835838
17646,6,6,1,2412,-86,-91,5,40:e3:d6:de:1e:66,122837072,380,854,122836692,122837072
17647,6,12,1,2412,-66,-91,25,40:e3:d6:da:ba:20,122864553,160,27321,122864393,122864553
17648,6,6,1,2412,-65,-91,26,40:e3:d6:da:ba:21,122864745,368,-176,122864377,122864745
17649,6,12,1,2412,-65,-91,26,40:e3:d6:da:ba:22,122865151,180,226,122864971,122865151
17650,6,12,1,2412,-65,-91,26,40:e3:d6:da:ba:23,122865357,184,22,122865173,122865357
17651,6,12,1,2412,-65,-91,26,40:e3:d6:da:ba:24,122865584,176,51,122865408,122865584
17652,6,12,1,2412,-65,-91,26,40:e3:d6:da:ba:25,122865795,160,51,122865635,122865795
17653,6,6,1,2412,-65,-91,26,40:e3:d6:da:ba:26,122865996,380,-179,122865616,122865996
17654,4,1,1,2412,-82,-91,9,b8:3a:5a:88:e6:e0,122885192,2240,16956,122882952,122885192
17655,4,1,1,2412,-82,-91,9,b8:3a:5a:88:e6:e1,122887461,2256,13,122885205,122887461
17656,6,6,1,2412,-84,-91,7,e6:aa:ea:b7:4a:dd,122909504,408,21635,122909096,122909504
17657,6,12,1,2412,-85,-91,6,40:e3:d6:de:1e:60,122938029,156,28369,122937873,122938029
17658,6,6,1,2412,-85,-91,6,40:e3:d6:de:1e:61,122938245,368,-152,122937877,122938245
17659,4,1,1,2412,-81,-91,10,b8:3a:5a:88:e6:e0,122950687,2360,10082,122948327,122950687
17660,4,1,1,2412,-83,-91,8,b8:3a:5a:88:e6:e1,122953085,2376,22,122950709,122953085
17661,6,12,1,2412,-65,-91,26,40:e3:d6:da:ba:20,122966976,160,13731,122966816,122966976
17662,6,6,1,2412,-65,-91,26,40:e3:d6:da:ba:21,122967168,368,-176,122966800,122967168
17663,4,1,1,2412,-86,-91,5,54:e4:3a:ec:fb:64,123024619,2160,55291,123022459,123024619
17664,6,12,1,2412,-87,-91,4,40:e3:d6:de:1e:60,123040422,156,15647,123040266,123040422
17665,4,1,1,2412,-82,-91,9,b8:3a:5a:88:e6:e0,123053087,2360,10305,123050727,123053087
17666,4,1,1,2412,-81,-91,10,b8:3a:5a:88:e6:e1,123055466,2376,3,123053090,123055466
17667,6,12,1,2412,-65,-91,26,40:e3:d6:da:ba:20,123069362,160,13736,123069202,123069362
17668,6,6,1,2412,-65,-91,26,40:e3:d6:da:ba:21,123069581,368,-149,123069213,123069581
17669,6,12,1,2412,-65,-91,26,40:e3:d6:da:ba:22,123069986,180,225,123069806,123069986
17670,6,12,1,2412,-65,-91,26,40:e3:d6:da:ba:23,123070219,184,49,123070035,123070219
17671,6,12,1,2412,-65,-91,26,40:e3:d6:da:ba:24,123070428,176,33,123070252,123070428
17672,6,12,1,2412,-65,-91,26,40:e3:d6:da:ba:25,123070647,160,59,123070487,123070647
17673,6,6,1,2412,-65,-91,26,40:e3:d6:da:ba:26,123070839,380,-188,123070459,123070839
17674,4,1,1,2412,-82,-91,9,b8:3a:5a:88:e6:e1,123107408,2256,34313,123105152,123107408
17675,6,6,1,2412,-73,-91,18,e6:aa:ea:c9:ea:33,123117447,408,9631,123117039,123117447
17676,6,6,1,2412,-86,-91,5,40:e3:d6:de:1e:61,123143004,368,25189,123142636,123143004
17677,6,12,1,2412,-86,-91,5,40:e3:d6:de:1e:62,123143400,176,220,123143224,123143400
17678,6,12,1,2412,-86,-91,5,40:e3:d6:de:1e:63,123143610,180,30,123143430,123143610
17679,6,6,1,2412,-85,-91,6,40:e3:d6:de:1e:66,123144274,380,284,123143894,123144274
17680,6,12,1,2412,-65,-91,26,40:e3:d6:da:ba:20,123171754,160,27320,123171594,123171754
17681,6,12,1,2412,-64,-91,27,40:e3:d6:da:ba:22,123172351,180,417,123172171,123172351
17682,6,12,1,2412,-64,-91,27,40:e3:d6:da:ba:25,123173012,160,501,123172852,123173012
17683,6,6,1,2412,-64,-91,27,40:e3:d6:da:ba:26,123173204,380,-188,123172824,123173204
17684,4,1,1,2412,-86,-91,5,54:e4:3a:ec:fb:64,123229418,2160,54054,123227258,123229418
17685,6,12,1,2412,-88,-91,3,40:e3:d6:de:1e:60,123245216,156,15642,123245060,123245216
17686,6,6,1,2412,-86,-91,5,40:e3:d6:de:1e:61,123245432,368,-152,123245064,123245432
17687,4,1,1,2412,-80,-91,11,b8:3a:5a:88:e6:e0,123257888,2360,10096,123255528,123257888
17688,4,1,1,2412,-81,-91,10,b8:3a:5a:88:e6:e1,123260295,2376,31,123257919,123260295
17689,6,12,1,2412,-64,-91,27,40:e3:d6:da:ba:20,123274164,160,13709,123274004,123274164
17690,6,12,1,2412,-64,-91,27,40:e3:d6:da:ba:22,123274752,180,408,123274572,123274752
17691,6,12,1,2412,-64,-91,27,40:e3:d6:da:ba:23,123274957,184,21,123274773,123274957
17692,6,12,1,2412,-64,-91,27,40:e3:d6:da:ba:24,123275167,176,34,123274991,123275167
17693,6,12,1,2412,-64,-91,27,40:e3:d6:da:ba:25,123275368,160,41,123275208,123275368
17694,6,6,1,2412,-63,-91,28,40:e3:d6:da:ba:26,123275587,380,-161,123275207,123275587
17695,6,6,1,2412,-82,-91,9,e6:aa:ea:b7:4a:dd,123314870,408,38875,123314462,123314870
17696,4,1,1,2412,-86,-91,5,54:e4:3a:ec:fb:64,123331983,2160,14953,123329823,123331983
17697,6,6,1,2412,-83,-91,8,e6:aa:ea:b7:4a:dd,123339107,408,6716,123338699,123339107
17698,6,6,1,2412,-83,-91,8,e6:aa:ea:b7:4a:dd,123351356,408,11841,123350948,123351356
17699,4,1,1,2412,-80,-91,11,b8:3a:5a:88:e6:e0,123360427,2360,6711,123358067,123360427
17700,4,1,1,2412,-81,-91,10,b8:3a:5a:88:e6:e1,123362847,2376,44,123360471,123362847
17701,6,12,1,2412,-64,-91,27,40:e3:d6:da:ba:20,123376579,160,13572,123376419,123376579
17702,6,6,1,2412,-64,-91,27,40:e3:d6:da:ba:21,123376771,368,-176,123376403,123376771
17703,6,12,1,2412,-64,-91,27,40:e3:d6:da:ba:22,123377158,180,207,123376978,123377158
17704,6,12,1,2412,-64,-91,27,40:e3:d6:da:ba:23,123377390,184,48,123377206,123377390
17705,6,12,1,2412,-64,-91,27,40:e3:d6:da:ba:24,123377627,176,61,123377451,123377627
17706,6,12,1,2412,-64,-91,27,40:e3:d6:da:ba:25,123377837,160,50,123377677,123377837
17707,6,6,1,2412,-64,-91,27,40:e3:d6:da:ba:26,123378038,380,-179,123377658,123378038
17708,4,1,1,2412,-85,-91,6,54:e4:3a:ec:fb:64,123434217,2160,54019,123432057,123434217
17709,6,6,1,2412,-87,-91,4,40:e3:d6:da:c0:21,123450774,368,16189,123450406,123450774
17710,6,12,1,2412,-86,-91,5,40:e3:d6:da:c0:25,123451846,156,916,123451690,123451846
17711,6,6,1,2412,-87,-91,4,40:e3:d6:da:c0:26,123452043,380,-183,123451663,123452043
17712,4,1,1,2412,-81,-91,10,b8:3a:5a:88:e6:e0,123462706,2360,8303,123460346,123462706
17713,4,1,1,2412,-81,-91,10,b8:3a:5a:88:e6:e1,123465186,2376,104,123462810,123465186
17714,6,12,1,2412,-59,-91,32,40:e3:d6:da:ba:20,123478955,160,13609,123478795,123478955
17715,6,6,1,2412,-58,-91,33,40:e3:d6:da:ba:21,123479155,368,-168,123478787,123479155
17716,6,12,1,2412,-58,-91,33,40:e3:d6:da:ba:22,123479561,180,226,123479381,123479561
17717,6,12,1,2412,-57,-91,34,40:e3:d6:da:ba:23,123479775,184,30,123479591,123479775
17718,6,12,1,2412,-57,-91,34,40:e3:d6:da:ba:24,123480012,176,61,123479836,123480012
17719,6,12,1,2412,-62,-91,29,40:e3:d6:da:ba:25,123480231,160,59,123480071,123480231
17720,6,6,1,2412,-57,-91,34,40:e3:d6:da:ba:26,123480450,380,-161,123480070,123480450
17721,6,6,1,2412,-86,-91,5,40:e3:d6:da:c0:26,123554421,380,73591,123554041,123554421
17722,6,6,1,2412,-88,-91,3,40:e3:d6:de:1e:66,123554861,380,60,123554481,123554861
17723,4,1,1,2412,-90,-91,1,a4:e5:7c:28:b1:d3,123564432,688,8883,123563744,123564432
17724,6,12,1,2412,-65,-91,26,40:e3:d6:da:ba:20,123581360,160,16768,123581200,123581360
17725,6,6,1,2412,-65,-91,26,40:e3:d6:da:ba:21,123581570,368,-158,123581202,123581570
17726,6,12,1,2412,-64,-91,27,40:e3:d6:da:ba:22,123581984,180,234,123581804,123581984
17727,6,12,1,2412,-64,-91,27,40:e3:d6:da:ba:23,123582208,184,40,123582024,123582208
17728,6,12,1,2412,-64,-91,27,40:e3:d6:da:ba:24,123582444,176,60,123582268,123582444
17729,6,12,1,2412,-65,-91,26,40:e3:d6:da:ba:25,123582664,160,60,123582504,123582664
17730,6,6,1,2412,-65,-91,26,40:e3:d6:da:ba:26,123582874,380,-170,123582494,123582874
17731,4,1,1,2412,-89,-91,2,,123599383,304,16205,123599079,123599383
17732,6,6,1,2412,-70,-91,21,e6:aa:ea:c9:ea:33,123625191,408,25400,123624783,123625191
17733,6,6,1,2412,-70,-91,21,e6:aa:ea:c9:ea:33,123637312,408,11713,123636904,123637312
17734,4,1,1,2412,-82,-91,9,54:e4:3a:ec:fb:64,123639014,2160,-458,123636854,123639014
17735,6,6,1,2412,-70,-91,21,e6:aa:ea:c9:ea:33,123649429,408,10007,123649021,123649429
17736,6,12,1,2412,-87,-91,4,40:e3:d6:de:1e:60,123654824,156,5239,123654668,123654824
17737,6,6,1,2412,-86,-91,5,40:e3:d6:de:1e:61,123655021,368,-171,123654653,123655021
17738,6,6,1,2412,-87,-91,4,40:e3:d6:da:c0:26,123656746,380,1345,123656366,123656746
17739,4,1,1,2412,-82,-91,9,b8:3a:5a:88:e6:e0,123667510,2360,8404,123665150,123667510
17740,6,6,1,2412,-70,-91,21,e6:aa:ea:c9:ea:33,123673656,408,5738,123673248,123673656
17741,6,12,1,2412,-65,-91,26,40:e3:d6:da:ba:20,123683756,160,9940,123683596,123683756
17742,6,6,1,2412,-65,-91,26,40:e3:d6:da:ba:21,123683957,368,-167,123683589,123683957
17743,6,12,1,2412,-65,-91,26,40:e3:d6:da:ba:22,123684371,180,234,123684191,123684371
17744,6,12,1,2412,-65,-91,26,40:e3:d6:da:ba:23,123684595,184,40,123684411,123684595
17745,6,12,1,2412,-65,-91,26,40:e3:d6:da:ba:24,123684822,176,51,123684646,123684822
17746,6,12,1,2412,-65,-91,26,40:e3:d6:da:ba:25,123685042,160,60,123684882,123685042
17747,6,6,1,2412,-65,-91,26,40:e3:d6:da:ba:26,123685261,380,-161,123684881,123685261
17748,6,6,1,2412,-78,-91,13,84:1b:5e:df:1b:99,123695544,80,10203,123695464,123695544
17749,4,1,1,2412,-82,-91,9,54:e4:3a:ec:fb:64,123741413,2160,43709,123739253,123741413
17750,6,12,1,2412,-85,-91,6,40:e3:d6:de:1e:60,123757229,156,15660,123757073,123757229
17751,6,6,1,2412,-85,-91,6,40:e3:d6:de:1e:61,123757417,368,-180,123757049,123757417
17752,6,6,1,2412,-84,-91,7,40:e3:d6:de:1e:66,123758677,380,880,123758297,123758677
17753,4,1,1,2412,-80,-91,11,b8:3a:5a:88:e6:e0,123771415,2360,10378,123769055,123771415
17754,4,1,1,2412,-80,-91,11,b8:3a:5a:88:e6:e1,123773804,2376,13,123771428,123773804
17755,6,6,1,2412,-65,-91,26,40:e3:d6:da:ba:21,123786367,368,12195,123785999,123786367
17756,6,12,1,2412,-65,-91,26,40:e3:d6:da:ba:22,123786754,180,207,123786574,123786754
17757,6,12,1,2412,-65,-91,26,40:e3:d6:da:ba:23,123786978,184,40,123786794,123786978
17758,6,12,1,2412,-65,-91,26,40:e3:d6:da:ba:24,123787187,176,33,123787011,123787187
17759,6,12,1,2412,-65,-91,26,40:e3:d6:da:ba:25,123787416,160,69,123787256,123787416
17760,6,6,1,2412,-65,-91,26,40:e3:d6:da:ba:26,123787635,380,-161,123787255,123787635
17761,6,6,1,2412,-83,-91,8,e6:aa:ea:b7:4a:dd,123835836,408,47793,123835428,123835836
17762,4,1,1,2412,-82,-91,9,54:e4:3a:ec:fb:64,123843813,2160,5817,123841653,123843813
17763,6,12,1,2412,-85,-91,6,40:e3:d6:de:1e:60,123859614,156,15645,123859458,123859614
17764,6,6,1,2412,-85,-91,6,40:e3:d6:de:1e:61,123859829,368,-153,123859461,123859829
17765,6,12,1,2412,-84,-91,7,40:e3:d6:de:1e:64,123860668,172,667,123860496,123860668
17766,6,12,1,2412,-85,-91,6,40:e3:d6:de:1e:65,123860893,156,69,123860737,123860893
17767,6,6,1,2412,-85,-91,6,40:e3:d6:de:1e:66,123861108,380,-165,123860728,123861108
17768,6,6,1,2412,-83,-91,8,e6:aa:ea:b7:4a:dd,123884317,408,22801,123883909,123884317
17769,6,12,1,2412,-66,-91,25,40:e3:d6:da:ba:20,123888561,160,4084,123888401,123888561
17770,6,6,1,2412,-67,-91,24,40:e3:d6:da:ba:21,123888780,368,-149,123888412,123888780
17771,6,12,1,2412,-66,-91,25,40:e3:d6:da:ba:22,123889185,180,225,123889005,123889185
17772,6,12,1,2412,-66,-91,25,40:e3:d6:da:ba:23,123889400,184,31,123889216,123889400
17773,6,12,1,2412,-66,-91,25,40:e3:d6:da:ba:24,123889609,176,33,123889433,123889609
17774,6,12,1,2412,-67,-91,24,40:e3:d6:da:ba:25,123889819,160,50,123889659,123889819
17775,6,6,1,2412,-67,-91,24,40:e3:d6:da:ba:26,123890011,380,-188,123889631,123890011
17776,6,6,1,2412,-69,-91,22,e6:aa:ea:c9:ea:33,123939825,408,49406,123939417,123939825
17777,4,1,1,2412,-80,-91,11,54:e4:3a:ec:fb:64,123946211,2160,4226,123944051,123946211
17778,6,6,1,2412,-69,-91,22,e6:aa:ea:c9:ea:33,123951952,408,5333,123951544,123951952
17779,6,12,1,2412,-86,-91,5,40:e3:d6:de:1e:60,123962021,156,9913,123961865,123962021
17780,6,6,1,2412,-88,-91,3,40:e3:d6:de:1e:61,123962208,368,-181,123961840,123962208
17781,6,12,1,2412,-86,-91,5,40:e3:d6:de:1e:63,123962833,180,445,123962653,123962833
17782,6,6,1,2412,-69,-91,22,e6:aa:ea:c9:ea:33,123988314,408,25073,123987906,123988314
17783,6,12,1,2412,-65,-91,26,40:e3:d6:da:ba:20,123990965,160,2491,123990805,123990965
17784,6,6,1,2412,-67,-91,24,40:e3:d6:da:ba:21,123991157,368,-176,123990789,123991157
17785,6,12,1,2412,-66,-91,25,40:e3:d6:da:ba:22,123991553,180,216,123991373,123991553
17786,6,12,1,2412,-68,-91,23,40:e3:d6:da:ba:23,123991767,184,30,123991583,123991767
17787,6,12,1,2412,-68,-91,23,40:e3:d6:da:ba:24,123992004,176,61,123991828,123992004
17788,6,12,1,2412,-68,-91,23,40:e3:d6:da:ba:25,123992223,160,59,123992063,123992223
17789,6,6,1,2412,-68,-91,23,40:e3:d6:da:ba:26,123992442,380,-161,123992062,123992442
17790,4,1,1,2412,-81,-91,10,54:e4:3a:ec:fb:64,124048610,2160,54008,124046450,124048610
17791,4,1,1,2412,-82,-91,9,c0:c9:e3:4d:6e:bf,124051187,872,1705,124050315,124051187
17792,6,12,1,2412,-88,-91,3,40:e3:d6:de:1e:60,124064433,156,13090,124064277,124064433
17793,6,6,1,2412,-85,-91,6,40:e3:d6:de:1e:66,124065863,380,1050,124065483,124065863
17794,4,1,1,2412,-78,-91,13,b8:3a:5a:88:e6:e0,124077093,2360,8870,124074733,124077093
17795,6,12,1,2412,-68,-91,23,40:e3:d6:da:ba:20,124093378,160,16125,124093218,124093378
17796,6,6,1,2412,-68,-91,23,40:e3:d6:da:ba:21,124093696,368,-50,124093328,124093696
17797,6,12,1,2412,-68,-91,23,40:e3:d6:da:ba:22,124094110,180,234,124093930,124094110
17798,6,12,1,2412,-68,-91,23,40:e3:d6:da:ba:23,124094549,184,255,124094365,124094549
17799,6,12,1,2412,-68,-91,23,40:e3:d6:da:ba:24,124094777,176,52,124094601,124094777
17800,6,12,1,2412,-68,-91,23,40:e3:d6:da:ba:25,124095005,160,68,124094845,124095005
17801,6,6,1,2412,-68,-91,23,40:e3:d6:da:ba:26,124095224,380,-161,124094844,124095224
17802,4,1,1,2412,-82,-91,9,54:e4:3a:ec:fb:64,124163853,2112,66517,124161741,124163853
17803,4,1,1,2412,-82,-91,9,54:e4:3a:ec:fb:64,124166503,2112,538,124164391,124166503
17804,4,1,1,2412,-83,-91,8,54:e4:3a:ec:fb:64,124168967,2112,352,124166855,124168967
17805,6,12,1,2412,-70,-91,21,40:e3:d6:da:ba:22,124196398,180,27251,124196218,124196398
17806,6,12,1,2412,-71,-91,20,40:e3:d6:da:ba:24,124196849,176,275,124196673,124196849
17807,6,12,1,2412,-71,-91,20,40:e3:d6:da:ba:25,124197051,160,42,124196891,124197051
17808,6,6,1,2412,-71,-91,20,40:e3:d6:da:ba:26,124197266,380,-165,124196886,124197266
17809,6,12,1,2412,-69,-91,22,40:e3:d6:da:ba:20,124230235,136,32833,124230099,124230235
17810,6,6,1,2412,-69,-91,22,40:e3:d6:da:ba:21,124230430,348,-153,124230082,124230430
17811,6,12,1,2412,-68,-91,23,40:e3:d6:da:ba:22,124230824,156,238,124230668,124230824
17812,6,12,1,2412,-69,-91,22,40:e3:d6:da:ba:23,124231014,156,34,124230858,124231014
17813,6,12,1,2412,-68,-91,23,40:e3:d6:da:ba:25,124231214,136,64,124231078,124231214
17814,4,1,1,2412,-78,-91,13,54:e4:3a:ec:fb:64,124253409,2160,20035,124251249,124253409
17815,4,1,1,2412,-74,-91,17,b8:3a:5a:88:e6:e0,124282734,2360,26965,124280374,124282734
17816,4,1,1,2412,-79,-91,12,b8:3a:5a:88:e6:e1,124285122,2376,12,124282746,124285122
17817,6,12,1,2412,-69,-91,22,40:e3:d6:da:ba:20,124298160,160,12878,124298000,124298160
17818,6,6,1,2412,-69,-91,22,40:e3:d6:da:ba:21,124298369,368,-159,124298001,124298369
17819,6,12,1,2412,-69,-91,22,40:e3:d6:da:ba:22,124298783,180,234,124298603,124298783
17820,6,12,1,2412,-69,-91,22,40:e3:d6:da:ba:23,124299007,184,40,124298823,124299007
17821,6,12,1,2412,-67,-91,24,40:e3:d6:da:ba:25,124299462,160,295,124299302,124299462
17822,6,6,1,2412,-69,-91,22,40:e3:d6:da:ba:26,124299673,380,-169,124299293,124299673
17823,4,1,1,2412,-83,-91,8,54:e4:3a:ec:fb:64,124356572,2160,54739,124354412,124356572
17824,4,1,1,2412,-80,-91,11,b8:3a:5a:88:e6:e0,124384294,2360,25362,124381934,124384294
17825,4,1,1,2412,-80,-91,11,b8:3a:5a:88:e6:e1,124386701,2376,31,124384325,124386701
17826,6,12,1,2412,-65,-91,26,40:e3:d6:da:ba:20,124400560,160,13699,124400400,124400560
17827,6,12,1,2412,-67,-91,24,40:e3:d6:da:ba:22,124401166,180,426,124400986,124401166
17828,6,6,1,2412,-87,-91,4,e6:aa:ea:b7:4a:dd,124404281,408,2707,124403873,124404281
17829,4,1,1,2412,-81,-91,10,b8:3a:5a:88:e6:e0,124425654,2240,19133,124423414,124425654
17830,4,1,1,2412,-79,-91,12,b8:3a:5a:88:e6:e1,124427923,2256,13,124425667,124427923
17831,6,6,1,2412,-72,-91,19,e6:aa:ea:c9:ea:33,124471748,408,43417,124471340,124471748
17832,6,12,1,2412,-87,-91,4,40:e3:d6:de:1e:60,124474022,156,2118,124473866,124474022
17833,6,6,1,2412,-88,-91,3,40:e3:d6:de:1e:61,124474238,368,-152,124473870,124474238
17834,6,6,1,2412,-72,-91,19,e6:aa:ea:c9:ea:33,124483868,408,9222,124483460,124483868
17835,4,1,1,2412,-79,-91,12,b8:3a:5a:88:e6:e0,124489883,2360,3655,124487523,124489883
17836,4,1,1,2412,-72,-91,19,b8:3a:5a:88:e6:e1,124493304,2376,1045,124490928,124493304
17837,6,6,1,2412,-71,-91,20,e6:aa:ea:c9:ea:33,124495961,408,2249,124495553,124495961
17838,6,12,1,2412,-63,-91,28,40:e3:d6:da:ba:22,124503593,180,7452,124503413,124503593
17839,6,12,1,2412,-63,-91,28,40:e3:d6:da:ba:23,124503825,184,48,124503641,124503825
17840,6,12,1,2412,-63,-91,28,40:e3:d6:da:ba:24,124504035,176,34,124503859,124504035
17841,6,12,1,2412,-60,-91,31,40:e3:d6:da:ba:25,124504262,160,67,124504102,124504262
17842,6,6,1,2412,-71,-91,20,e6:aa:ea:c9:ea:33,124508242,408,3572,124507834,124508242
17843,4,1,1,2412,-67,-91,24,54:e4:3a:ec:fb:64,124560607,2160,50205,124558447,124560607
17844,4,1,1,2412,-81,-91,10,b8:3a:5a:88:e6:e1,124591578,2376,28595,124589202,124591578
17845,6,12,1,2412,-63,-91,28,40:e3:d6:da:ba:20,124605384,160,13646,124605224,124605384
17846,6,6,1,2412,-63,-91,28,40:e3:d6:da:ba:21,124605585,368,-167,124605217,124605585
17847,6,12,1,2412,-63,-91,28,40:e3:d6:da:ba:22,124605999,180,234,124605819,124605999
17848,6,12,1,2412,-63,-91,28,40:e3:d6:da:ba:23,124606214,184,31,124606030,124606214
17849,6,12,1,2412,-63,-91,28,40:e3:d6:da:ba:24,124606423,176,33,124606247,124606423
17850,6,12,1,2412,-63,-91,28,40:e3:d6:da:ba:25,124606625,160,42,124606465,124606625
17851,6,6,1,2412,-63,-91,28,40:e3:d6:da:ba:26,124606844,380,-161,124606464,124606844
17852,6,6,1,2412,-81,-91,10,e6:aa:ea:b7:4a:dd,124683003,408,75751,124682595,124683003
17853,4,1,1,2412,-83,-91,8,b8:3a:5a:88:e6:e0,124691491,2360,6128,124689131,124691491
17854,6,6,1,2412,-81,-91,10,e6:aa:ea:b7:4a:dd,124707232,408,15333,124706824,124707232
17855,6,12,1,2412,-66,-91,25,40:e3:d6:da:ba:20,124707763,160,371,124707603,124707763
17856,6,6,1,2412,-66,-91,25,40:e3:d6:da:ba:21,124707973,368,-158,124707605,124707973
17857,6,12,1,2412,-66,-91,25,40:e3:d6:da:ba:22,124708369,180,216,124708189,124708369
17858,6,12,1,2412,-66,-91,25,40:e3:d6:da:ba:23,124708583,184,30,124708399,124708583
17859,6,12,1,2412,-66,-91,25,40:e3:d6:da:ba:24,124708820,176,61,124708644,124708820
17860,6,12,1,2412,-66,-91,25,40:e3:d6:da:ba:25,124709039,160,59,124708879,124709039
17861,6,6,1,2412,-66,-91,25,40:e3:d6:da:ba:26,124709240,380,-179,124708860,124709240
17862,6,6,1,2412,-82,-91,9,e6:aa:ea:b7:4a:dd,124719340,408,9692,124718932,124719340
17863,4,1,1,2412,-77,-91,14,52:d7:6e:bd:eb:aa,124728009,1128,7541,124726881,124728009
17864,6,12,1,2412,-66,-91,25,40:e3:d6:da:ba:20,124729132,136,987,124728996,124729132
17865,6,12,1,2412,-78,-91,13,,124729284,32,120,124729252,124729284
17866,6,6,1,2412,-66,-91,25,40:e3:d6:da:ba:21,124729373,348,-259,124729025,124729373
17867,6,6,1,2412,-78,-91,13,,124729737,44,320,124729693,124729737
17868,6,12,1,2412,-66,-91,25,40:e3:d6:da:ba:22,124729806,156,-87,124729650,124729806
17869,6,12,1,2412,-78,-91,13,,124729978,32,140,124729946,124729978
17870,4,1,1,2412,-85,-91,6,54:e4:3a:ec:fb:64,124730216,2112,-1874,124728104,124730216
17871,4,1,1,2412,-78,-91,13,,124732341,304,1821,124732037,124732341
17872,6,12,1,2412,-66,-91,25,40:e3:d6:da:ba:23,124732505,156,8,124732349,124732505
17873,6,12,1,2412,-78,-91,13,,124732677,32,140,124732645,124732677
17874,6,12,1,2412,-66,-91,25,40:e3:d6:da:ba:25,124732759,136,-54,124732623,124732759
17875,6,12,1,2412,-79,-91,12,,124732911,32,120,124732879,124732911
17876,4,1,1,2412,-86,-91,5,54:e4:3a:ec:fb:64,124765405,2160,30334,124763245,124765405
17877,4,1,1,2412,-83,-91,8,b8:3a:5a:88:e6:e1,124797349,2376,29568,124794973,124797349
17878,6,12,1,2412,-65,-91,26,40:e3:d6:da:ba:20,124810163,160,12654,124810003,124810163
17879,6,6,1,2412,-64,-91,27,40:e3:d6:da:ba:21,124810364,368,-167,124809996,124810364
17880,6,12,1,2412,-64,-91,27,40:e3:d6:da:ba:22,124810751,180,207,124810571,124810751
17881,6,12,1,2412,-65,-91,26,40:e3:d6:da:ba:23,124810990,184,55,124810806,124810990
17882,6,12,1,2412,-64,-91,27,40:e3:d6:da:ba:24,124811211,176,45,124811035,124811211
17883,6,12,1,2412,-64,-91,27,40:e3:d6:da:ba:25,124811422,160,51,124811262,124811422
17884,4,1,1,2412,-83,-91,8,54:e4:3a:ec:fb:64,124867804,2160,54222,124865644,124867804
17885,6,12,1,2412,-62,-91,29,40:e3:d6:da:ba:20,124912563,160,44599,124912403,124912563
17886,6,6,1,2412,-62,-91,29,40:e3:d6:da:ba:21,124912764,368,-167,124912396,124912764
17887,6,12,1,2412,-62,-91,29,40:e3:d6:da:ba:22,124913169,180,225,124912989,124913169
17888,6,12,1,2412,-62,-91,29,40:e3:d6:da:ba:23,124913402,184,49,124913218,124913402
17889,6,12,1,2412,-62,-91,29,40:e3:d6:da:ba:24,124913638,176,60,124913462,124913638
17890,6,12,1,2412,-62,-91,29,40:e3:d6:da:ba:25,124913840,160,42,124913680,124913840
17891,6,6,1,2412,-62,-91,29,40:e3:d6:da:ba:26,124914041,380,-179,124913661,124914041
17892,4,1,1,2412,-90,-91,1,a6:e5:7c:28:b1:d3,124958938,992,43905,124957946,124958938
17893,6,6,1,2412,-68,-91,23,e6:aa:ea:c9:ea:33,124980166,408,20820,124979758,124980166
17894,6,12,1,2412,-89,-91,2,40:e3:d6:de:1e:60,124986072,156,5750,124985916,124986072
17895,6,6,1,2412,-69,-91,22,e6:aa:ea:c9:ea:33,124992289,408,5809,124991881,124992289
17896,6,12,1,2412,-67,-91,24,40:e3:d6:da:ba:20,125014962,160,22513,125014802,125014962
17897,6,6,1,2412,-67,-91,24,40:e3:d6:da:ba:21,125015181,368,-149,125014813,125015181
17898,6,12,1,2412,-67,-91,24,40:e3:d6:da:ba:23,125015800,184,435,125015616,125015800
17899,6,6,1,2412,-67,-91,24,40:e3:d6:da:ba:26,125016430,380,250,125016050,125016430
17900,6,6,1,2412,-69,-91,22,e6:aa:ea:c9:ea:33,125016872,408,34,125016464,125016872
17901,6,6,1,2412,-69,-91,22,e6:aa:ea:c9:ea:33,125028698,408,11418,125028290,125028698
17902,4,1,1,2412,-83,-91,8,54:e4:3a:ec:fb:64,125072602,2160,41744,125070442,125072602
17903,6,6,1,2412,-81,-91,10,e6:aa:ea:b7:4a:dd,125088334,408,15324,125087926,125088334
17904,6,6,1,2412,-89,-91,2,40:e3:d6:da:c0:26,125090449,380,1735,125090069,125090449
17905,6,6,1,2412,-80,-91,11,e6:aa:ea:b7:4a:dd,125100452,408,9595,125100044,125100452
17906,4,1,1,2412,-80,-91,11,b8:3a:5a:88:e6:e1,125103501,2376,673,125101125,125103501
17907,6,6,1,2412,-79,-91,12,e6:aa:ea:b7:4a:dd,125112568,408,8659,125112160,125112568
17908,6,12,1,2412,-63,-91,28,40:e3:d6:da:ba:20,125117376,160,4648,125117216,125117376
17909,6,6,1,2412,-63,-91,28,40:e3:d6:da:ba:21,125117577,368,-167,125117209,125117577
17910,6,12,1,2412,-62,-91,29,40:e3:d6:da:ba:22,125117964,180,207,125117784,125117964
17911,6,12,1,2412,-63,-91,28,40:e3:d6:da:ba:23,125118187,184,39,125118003,125118187
17912,6,12,1,2412,-63,-91,28,40:e3:d6:da:ba:24,125118415,176,52,125118239,125118415
17913,6,12,1,2412,-63,-91,28,40:e3:d6:da:ba:25,125118625,160,50,125118465,125118625
17914,6,6,1,2412,-63,-91,28,40:e3:d6:da:ba:26,125118845,380,-160,125118465,125118845
17915,6,6,1,2412,-81,-91,10,e6:aa:ea:b7:4a:dd,125124693,408,5440,125124285,125124693
17916,6,6,1,2412,-81,-91,10,e6:aa:ea:b7:4a:dd,125136806,408,11705,125136398,125136806
17917,4,1,1,2412,-83,-91,8,54:e4:3a:ec:fb:64,125175001,2160,36035,125172841,125175001
17918,6,12,1,2412,-89,-91,2,40:e3:d6:de:1e:60,125190826,156,15669,125190670,125190826
17919,6,6,1,2412,-89,-91,2,40:e3:d6:de:1e:61,125191014,368,-180,125190646,125191014
17920,4,1,1,2412,-78,-91,13,b8:3a:5a:88:e6:e0,125203504,2360,10130,125201144,125203504
17921,4,1,1,2412,-77,-91,14,b8:3a:5a:88:e6:e1,125205893,2376,13,125203517,125205893
17922,6,12,1,2412,-65,-91,26,40:e3:d6:da:ba:20,125219775,160,13722,125219615,125219775
17923,6,6,1,2412,-64,-91,27,40:e3:d6:da:ba:21,125220000,368,-143,125219632,125220000
17924,6,12,1,2412,-64,-91,27,40:e3:d6:da:ba:23,125220620,184,436,125220436,125220620
17925,6,12,1,2412,-64,-91,27,40:e3:d6:da:ba:24,125220829,176,33,125220653,125220829
17926,4,1,1,2412,-86,-91,5,54:e4:3a:ec:fb:64,125277399,2160,54410,125275239,125277399
17927,6,12,1,2412,-83,-91,8,40:e3:d6:de:1e:62,125293821,176,16246,125293645,125293821
17928,6,12,1,2412,-85,-91,6,40:e3:d6:de:1e:63,125294041,180,40,125293861,125294041
17929,6,12,1,2412,-85,-91,6,40:e3:d6:de:1e:64,125294265,172,52,125294093,125294265
17930,6,12,1,2412,-63,-91,28,40:e3:d6:da:ba:20,125322168,160,27743,125322008,125322168
17931,6,6,1,2412,-63,-91,28,40:e3:d6:da:ba:21,125322387,368,-149,125322019,125322387
17932,6,12,1,2412,-63,-91,28,40:e3:d6:da:ba:22,125322801,180,234,125322621,125322801
17933,6,12,1,2412,-62,-91,29,40:e3:d6:da:ba:25,125323481,160,520,125323321,125323481
17934,6,6,1,2412,-63,-91,28,40:e3:d6:da:ba:26,125323700,380,-161,125323320,125323700
17935,4,1,1,2412,-75,-91,16,22:a3:7f:87:e5:4e,125332645,1480,7465,125331165,125332645
17936,6,12,1,2412,-73,-91,18,,125334265,32,1588,125334233,125334265
17937,6,12,1,2412,-62,-91,29,40:e3:d6:da:ba:23,125336240,156,1819,125336084,125336240
17938,4,1,1,2412,-82,-91,9,54:e4:3a:ec:fb:64,125379799,2160,41399,125377639,125379799
17939,6,12,1,2412,-86,-91,5,40:e3:d6:de:1e:60,125395629,156,15674,125395473,125395629
17940,6,6,1,2412,-83,-91,8,e6:aa:ea:b7:4a:dd,125403954,408,7917,125403546,125403954
17941,4,1,1,2412,-81,-91,10,b8:3a:5a:88:e6:e0,125408300,2360,1986,125405940,125408300
17942,4,1,1,2412,-82,-91,9,b8:3a:5a:88:e6:e1,125410679,2376,3,125408303,125410679
17943,6,6,1,2412,-84,-91,7,e6:aa:ea:b7:4a:dd,125415789,408,4702,125415381,125415789
17944,6,12,1,2412,-61,-91,30,40:e3:d6:da:ba:20,125424584,160,8635,125424424,125424584
17945,6,6,1,2412,-61,-91,30,40:e3:d6:da:ba:21,125424785,368,-167,125424417,125424785
17946,6,12,1,2412,-61,-91,30,40:e3:d6:da:ba:22,125425190,180,225,125425010,125425190
17947,6,12,1,2412,-61,-91,30,40:e3:d6:da:ba:23,125425405,184,31,125425221,125425405
17948,6,12,1,2412,-61,-91,30,40:e3:d6:da:ba:24,125425632,176,51,125425456,125425632
17949,6,12,1,2412,-61,-91,30,40:e3:d6:da:ba:25,125425834,160,42,125425674,125425834
17950,6,6,1,2412,-61,-91,30,40:e3:d6:da:ba:26,125426044,380,-170,125425664,125426044
17951,6,6,1,2412,-84,-91,7,e6:aa:ea:b7:4a:dd,125427881,408,1429,125427473,125427881
17952,6,6,1,2412,-83,-91,8,e6:aa:ea:b7:4a:dd,125439998,408,11709,125439590,125439998
17953,6,6,1,2412,-84,-91,7,e6:aa:ea:b7:4a:dd,125452112,408,11706,125451704,125452112
17954,4,1,1,2412,-84,-91,7,54:e4:3a:ec:fb:64,125482199,2160,27927,125480039,125482199
17955,6,6,1,2412,-85,-91,6,40:e3:d6:de:1e:61,125498235,368,15668,125497867,125498235
17956,6,12,1,2412,-62,-91,29,40:e3:d6:da:ba:20,125527118,160,28723,125526958,125527118
17957,6,6,1,2412,-62,-91,29,40:e3:d6:da:ba:21,125527318,368,-168,125526950,125527318
17958,6,12,1,2412,-62,-91,29,40:e3:d6:da:ba:22,125527714,180,216,125527534,125527714
17959,6,12,1,2412,-62,-91,29,40:e3:d6:da:ba:23,125527929,184,31,125527745,125527929
17960,6,12,1,2412,-62,-91,29,40:e3:d6:da:ba:24,125528156,176,51,125527980,125528156
17961,6,12,1,2412,-62,-91,29,40:e3:d6:da:ba:25,125528367,160,51,125528207,125528367
17962,6,6,1,2412,-62,-91,29,40:e3:d6:da:ba:26,125528586,380,-161,125528206,125528586
17963,6,6,1,2412,-70,-91,21,e6:aa:ea:c9:ea:33,125536969,408,7975,125536561,125536969
17964,6,12,1,2412,-86,-91,5,40:e3:d6:de:1e:63,125554981,156,17856,125554825,125554981
17965,4,1,1,2412,-84,-91,7,54:e4:3a:ec:fb:64,125584597,2160,27456,125582437,125584597
17966,6,6,1,2412,-86,-91,5,40:e3:d6:de:1e:66,125601880,380,16903,125601500,125601880
17967,4,1,1,2412,-78,-91,13,b8:3a:5a:88:e6:e0,125613117,2360,8877,125610757,125613117
17968,6,12,1,2412,-63,-91,28,40:e3:d6:da:ba:20,125629412,160,16135,125629252,125629412
17969,6,6,1,2412,-62,-91,29,40:e3:d6:da:ba:21,125629604,368,-176,125629236,125629604
17970,6,12,1,2412,-62,-91,29,40:e3:d6:da:ba:22,125629991,180,207,125629811,125629991
17971,6,12,1,2412,-63,-91,28,40:e3:d6:da:ba:23,125630196,184,21,125630012,125630196
17972,6,12,1,2412,-62,-91,29,40:e3:d6:da:ba:24,125630415,176,43,125630239,125630415
17973,6,12,1,2412,-63,-91,28,40:e3:d6:da:ba:25,125630625,160,50,125630465,125630625
17974,6,6,1,2412,-62,-91,29,40:e3:d6:da:ba:26,125630835,380,-170,125630455,125630835
17975,6,12,1,2412,-87,-91,4,40:e3:d6:de:1e:65,125704051,156,73060,125703895,125704051
17976,4,1,1,2412,-80,-91,11,b8:3a:5a:88:e6:e0,125715497,2360,9086,125713137,125715497
17977,6,12,1,2412,-87,-91,4,40:e3:d6:de:1e:63,125721378,156,5725,125721222,125721378
17978,6,12,1,2412,-82,-91,9,,125721734,32,324,125721702,125721734
17979,6,12,1,2412,-63,-91,28,40:e3:d6:da:ba:20,125731776,160,9882,125731616,125731776
17980,6,6,1,2412,-64,-91,27,40:e3:d6:da:ba:21,125731968,368,-176,125731600,125731968
17981,6,12,1,2412,-63,-91,28,40:e3:d6:da:ba:22,125732372,180,224,125732192,125732372
17982,6,12,1,2412,-63,-91,28,40:e3:d6:da:ba:23,125732587,184,31,125732403,125732587
17983,6,12,1,2412,-63,-91,28,40:e3:d6:da:ba:24,125732805,176,42,125732629,125732805
17984,6,12,1,2412,-63,-91,28,40:e3:d6:da:ba:25,125733016,160,51,125732856,125733016
17985,6,6,1,2412,-63,-91,28,40:e3:d6:da:ba:26,125733208,380,-188,125732828,125733208
17986,4,1,1,2412,-82,-91,9,74:a6:cd:e2:ea:89,125740221,1480,5533,125738741,125740221
17987,6,12,1,2412,-82,-91,9,,125741838,32,1585,125741806,125741838
17988,6,12,1,2412,-84,-91,7,,125742095,32,225,125742063,125742095
17989,4,1,1,2412,-86,-91,5,54:e4:3a:ec:fb:64,125789396,2160,45141,125787236,125789396
17990,6,12,1,2412,-87,-91,4,40:e3:d6:de:1e:60,125805222,156,15670,125805066,125805222
17991,6,6,1,2412,-82,-91,9,40:e3:d6:de:1e:61,125805427,368,-163,125805059,125805427
17992,6,6,1,2412,-86,-91,5,40:e3:d6:de:1e:66,125806680,380,873,125806300,125806680
17993,6,6,1,2412,-69,-91,22,e6:aa:ea:c9:ea:33,125815710,408,8622,125815302,125815710
17994,4,1,1,2412,-49,-91,42,b8:3a:5a:88:e6:e1,125820305,2376,2219,125817929,125820305
17995,6,6,1,2412,-69,-91,22,e6:aa:ea:c9:ea:33,125827853,408,7140,125827445,125827853
17996,6,12,1,2412,-63,-91,28,40:e3:d6:da:ba:20,125834176,160,6163,125834016,125834176
17997,6,6,1,2412,-63,-91,28,40:e3:d6:da:ba:21,125834368,368,-176,125834000,125834368
17998,6,12,1,2412,-63,-91,28,40:e3:d6:da:ba:22,125834782,180,234,125834602,125834782
17999,6,12,1,2412,-63,-91,28,40:e3:d6:da:ba:23,125834988,184,22,125834804,125834988
18000,6,12,1,2412,-63,-91,28,40:e3:d6:da:ba:24,125835197,176,33,125835021,125835197
18001,6,6,1,2412,-63,-91,28,40:e3:d6:da:ba:26,125835645,380,68,125835265,125835645
18002,6,6,1,2412,-69,-91,22,e6:aa:ea:c9:ea:33,125839959,408,3906,125839551,125839959
18003,6,6,1,2412,-69,-91,22,e6:aa:ea:c9:ea:33,125852068,408,11701,125851660,125852068
18004,4,1,1,2412,-92,-91,-1,a6:e5:7c:28:b1:d3,125879904,992,26844,125878912,125879904
18005,4,1,1,2412,-88,-91,3,54:e4:3a:ec:fb:64,125891794,2160,9730,125889634,125891794
18006,6,12,1,2412,-85,-91,6,40:e3:d6:de:1e:60,125907905,156,15955,125907749,125907905
18007,6,6,1,2412,-84,-91,7,40:e3:d6:de:1e:66,125909353,380,1068,125908973,125909353
18008,4,1,1,2412,-80,-91,11,b8:3a:5a:88:e6:e0,125920304,2360,8591,125917944,125920304
18009,6,6,1,2412,-82,-91,9,e6:aa:ea:b7:4a:dd,125934738,408,14026,125934330,125934738
18010,6,12,1,2412,-63,-91,28,40:e3:d6:da:ba:20,125936566,160,1668,125936406,125936566
18011,6,6,1,2412,-63,-91,28,40:e3:d6:da:ba:21,125936758,368,-176,125936390,125936758
18012,6,12,1,2412,-63,-91,28,40:e3:d6:da:ba:22,125937145,180,207,125936965,125937145
18013,6,12,1,2412,-63,-91,28,40:e3:d6:da:ba:23,125937393,184,64,125937209,125937393
18014,6,12,1,2412,-63,-91,28,40:e3:d6:da:ba:24,125937612,176,43,125937436,125937612
18015,6,12,1,2412,-63,-91,28,40:e3:d6:da:ba:25,125937822,160,50,125937662,125937822
18016,6,6,1,2412,-63,-91,28,40:e3:d6:da:ba:26,125938023,380,-179,125937643,125938023
18017,6,6,1,2412,-82,-91,9,e6:aa:ea:b7:4a:dd,125946848,408,8417,125946440,125946848
18018,6,6,1,2412,-82,-91,9,e6:aa:ea:b7:4a:dd,125958971,408,11715,125958563,125958971
18019,6,6,1,2412,-82,-91,9,e6:aa:ea:b7:4a:dd,125971089,408,11710,125970681,125971089
18020,6,12,1,2412,-86,-91,5,40:e3:d6:de:1e:60,126010027,156,38782,126009871,126010027
18021,6,6,1,2412,-84,-91,7,40:e3:d6:de:1e:61,126010224,368,-171,126009856,126010224
18022,6,6,1,2412,-84,-91,7,40:e3:d6:de:1e:66,126011457,380,853,126011077,126011457
18023,6,12,1,2412,-62,-91,29,40:e3:d6:da:ba:20,126038973,160,27356,126038813,126038973
18024,6,6,1,2412,-62,-91,29,40:e3:d6:da:ba:21,126039192,368,-149,126038824,126039192
18025,6,12,1,2412,-62,-91,29,40:e3:d6:da:ba:22,126039606,180,234,126039426,126039606
18026,6,12,1,2412,-63,-91,28,40:e3:d6:da:ba:23,126039839,184,49,126039655,126039839
18027,6,12,1,2412,-62,-91,29,40:e3:d6:da:ba:24,126040075,176,60,126039899,126040075
18028,6,12,1,2412,-62,-91,29,40:e3:d6:da:ba:25,126040286,160,51,126040126,126040286
18029,6,6,1,2412,-62,-91,29,40:e3:d6:da:ba:26,126040505,380,-161,126040125,126040505
18030,6,6,1,2412,-85,-91,6,40:e3:d6:de:1e:66,126115033,380,74148,126114653,126115033
18031,4,1,1,2412,-81,-91,10,b8:3a:5a:88:e6:e1,126127501,2376,10092,126125125,126127501
18032,6,6,1,2412,-68,-91,23,e6:aa:ea:c9:ea:33,126131153,408,3244,126130745,126131153
18033,6,6,1,2412,-62,-91,29,40:e3:d6:da:ba:21,126141581,368,10060,126141213,126141581
18034,6,12,1,2412,-62,-91,29,40:e3:d6:da:ba:22,126141986,180,225,126141806,126141986
18035,6,12,1,2412,-62,-91,29,40:e3:d6:da:ba:23,126142218,184,48,126142034,126142218
18036,6,12,1,2412,-61,-91,30,40:e3:d6:da:ba:24,126142445,176,51,126142269,126142445
18037,6,12,1,2412,-62,-91,29,40:e3:d6:da:ba:25,126142646,160,41,126142486,126142646
18038,6,6,1,2412,-62,-91,29,40:e3:d6:da:ba:26,126142848,380,-178,126142468,126142848
18039,6,6,1,2412,-68,-91,23,e6:aa:ea:c9:ea:33,126143354,408,98,126142946,126143354
18040,6,6,1,2412,-67,-91,24,e6:aa:ea:c9:ea:33,126155308,408,11546,126154900,126155308
18041,6,6,1,2412,-68,-91,23,e6:aa:ea:c9:ea:33,126167330,408,11614,126166922,126167330
18042,6,6,1,2412,-68,-91,23,e6:aa:ea:c9:ea:33,126179456,408,11718,126179048,126179456
18043,6,12,1,2412,-62,-91,29,40:e3:d6:da:ba:23,126214398,156,34786,126214242,126214398
18044,6,12,1,2412,-85,-91,6,40:e3:d6:de:1e:60,126214818,156,264,126214662,126214818
18045,6,6,1,2412,-84,-91,7,40:e3:d6:de:1e:61,126215033,368,-153,126214665,126215033
18046,4,1,1,2412,-81,-91,10,b8:3a:5a:88:e6:e0,126227504,2360,10111,126225144,126227504
18047,4,1,1,2412,-82,-91,9,b8:3a:5a:88:e6:e1,126229901,2376,21,126227525,126229901
18048,6,12,1,2412,-62,-91,29,40:e3:d6:da:ba:20,126243794,160,13733,126243634,126243794
18049,6,6,1,2412,-61,-91,30,40:e3:d6:da:ba:21,126244004,368,-158,126243636,126244004
18050,6,12,1,2412,-61,-91,30,40:e3:d6:da:ba:22,126244409,180,225,126244229,126244409
18051,6,12,1,2412,-62,-91,29,40:e3:d6:da:ba:23,126244633,184,40,126244449,126244633
18052,6,12,1,2412,-61,-91,30,40:e3:d6:da:ba:24,126244869,176,60,126244693,126244869
18053,6,12,1,2412,-62,-91,29,40:e3:d6:da:ba:25,126245098,160,69,126244938,126245098
18054,6,6,1,2412,-61,-91,30,40:e3:d6:da:ba:26,126245299,380,-179,126244919,126245299
18055,6,12,1,2412,-84,-91,7,40:e3:d6:de:1e:60,126317219,156,71764,126317063,126317219
18056,6,6,1,2412,-85,-91,6,40:e3:d6:de:1e:61,126317425,368,-162,126317057,126317425
18057,6,12,1,2412,-83,-91,8,40:e3:d6:de:1e:65,126318524,156,943,126318368,126318524
18058,6,6,1,2412,-79,-91,12,40:e3:d6:de:1e:66,126318712,380,-192,126318332,126318712
18059,4,1,1,2412,-82,-91,9,b8:3a:5a:88:e6:e0,126329896,2360,8824,126327536,126329896
18060,4,1,1,2412,-80,-91,11,b8:3a:5a:88:e6:e1,126332303,2376,31,126329927,126332303
18061,6,12,1,2412,-61,-91,30,40:e3:d6:da:ba:20,126346174,160,13711,126346014,126346174
18062,6,6,1,2412,-61,-91,30,40:e3:d6:da:ba:21,126346375,368,-167,126346007,126346375
18063,6,12,1,2412,-60,-91,31,40:e3:d6:da:ba:22,126346762,180,207,126346582,126346762
18064,6,12,1,2412,-60,-91,31,40:e3:d6:da:ba:23,126346977,184,31,126346793,126346977
18065,6,12,1,2412,-60,-91,31,40:e3:d6:da:ba:24,126347186,176,33,126347010,126347186
18066,6,12,1,2412,-60,-91,31,40:e3:d6:da:ba:25,126347388,160,42,126347228,126347388
18067,6,6,1,2412,-60,-91,31,40:e3:d6:da:ba:26,126347589,380,-179,126347209,126347589
18068,6,12,1,2412,-84,-91,7,40:e3:d6:de:1e:60,126419623,156,71878,126419467,126419623
18069,6,6,1,2412,-83,-91,8,40:e3:d6:de:1e:61,126419810,368,-181,126419442,126419810
18070,6,12,1,2412,-84,-91,7,40:e3:d6:de:1e:62,126420206,176,220,126420030,126420206
18071,6,12,1,2412,-85,-91,6,40:e3:d6:de:1e:63,126420408,180,22,126420228,126420408
18072,6,12,1,2412,-83,-91,8,40:e3:d6:de:1e:64,126420640,172,60,126420468,126420640
18073,6,12,1,2412,-84,-91,7,40:e3:d6:de:1e:65,126420865,156,69,126420709,126420865
18074,6,6,1,2412,-84,-91,7,40:e3:d6:de:1e:66,126421080,380,-165,126420700,126421080
18075,6,6,1,2412,-80,-91,11,e6:aa:ea:b7:4a:dd,126442442,408,20954,126442034,126442442
18076,6,12,1,2412,-60,-91,31,40:e3:d6:da:ba:20,126448573,160,5971,126448413,126448573
18077,6,6,1,2412,-60,-91,31,40:e3:d6:da:ba:21,126448792,368,-149,126448424,126448792
18078,6,12,1,2412,-60,-91,31,40:e3:d6:da:ba:22,126449206,180,234,126449026,126449206
18079,6,12,1,2412,-61,-91,30,40:e3:d6:da:ba:24,126449714,176,332,126449538,126449714
18080,6,12,1,2412,-61,-91,30,40:e3:d6:da:ba:25,126449916,160,42,126449756,126449916
18081,6,6,1,2412,-61,-91,30,40:e3:d6:da:ba:26,126450125,380,-171,126449745,126450125
18082,6,6,1,2412,-80,-91,11,e6:aa:ea:b7:4a:dd,126454556,408,4023,126454148,126454556
18083,6,6,1,2412,-80,-91,11,e6:aa:ea:b7:4a:dd,126466676,408,11712,126466268,126466676
18084,6,12,1,2412,-85,-91,6,40:e3:d6:de:1e:60,126469540,136,2728,126469404,126469540
18085,6,6,1,2412,-84,-91,7,40:e3:d6:de:1e:61,126469725,348,-163,126469377,126469725
18086,6,12,1,2412,-84,-91,7,40:e3:d6:de:1e:65,126470528,136,667,126470392,126470528
18087,6,6,1,2412,-81,-91,10,e6:aa:ea:b7:4a:dd,126478915,408,7979,126478507,126478915
18088,6,6,1,2412,-74,-91,17,e6:aa:ea:b7:4a:dd,126490924,408,11601,126490516,126490924
18089,4,1,1,2412,-79,-91,12,a6:e5:7c:28:b1:d3,126494399,992,2483,126493407,126494399
18090,4,1,1,2412,-78,-91,13,54:e4:3a:ec:fb:64,126506190,2160,9631,126504030,126506190
18091,4,1,1,2412,-93,-91,-2,c0:c9:e3:4d:6e:bf,126517365,872,10303,126516493,126517365
18092,4,1,1,2412,-88,-91,3,,126518254,304,585,126517950,126518254
18093,6,12,1,2412,-84,-91,7,40:e3:d6:de:1e:60,126522044,156,3634,126521888,126522044
18094,6,6,1,2412,-84,-91,7,40:e3:d6:de:1e:61,126522233,368,-179,126521865,126522233
18095,6,12,1,2412,-83,-91,8,40:e3:d6:de:1e:62,126522647,176,238,126522471,126522647
18096,6,12,1,2412,-82,-91,9,40:e3:d6:de:1e:63,126522875,180,48,126522695,126522875
18097,6,12,1,2412,-84,-91,7,40:e3:d6:de:1e:64,126523098,172,51,126522926,126523098
18098,6,12,1,2412,-84,-91,7,40:e3:d6:de:1e:65,126523314,156,60,126523158,126523314
18099,6,6,1,2412,-82,-91,9,40:e3:d6:de:1e:66,126523511,380,-183,126523131,126523511
18100,4,1,1,2412,-82,-91,9,b8:3a:5a:88:e6:e0,126534712,2360,8841,126532352,126534712
18101,6,12,1,2412,-61,-91,30,40:e3:d6:da:ba:20,126550974,160,16102,126550814,126550974
18102,6,6,1,2412,-61,-91,30,40:e3:d6:da:ba:21,126551184,368,-158,126550816,126551184
18103,6,12,1,2412,-61,-91,30,40:e3:d6:da:ba:22,126551571,180,207,126551391,126551571
18104,6,12,1,2412,-61,-91,30,40:e3:d6:da:ba:23,126551795,184,40,126551611,126551795
18105,6,12,1,2412,-61,-91,30,40:e3:d6:da:ba:24,126552031,176,60,126551855,126552031
18106,6,12,1,2412,-61,-91,30,40:e3:d6:da:ba:25,126552251,160,60,126552091,126552251
18107,6,6,1,2412,-61,-91,30,40:e3:d6:da:ba:26,126552452,380,-179,126552072,126552452
18108,4,1,1,2412,-86,-91,5,54:e4:3a:ec:fb:64,126608588,2160,53976,126606428,126608588
18109,6,6,1,2412,-83,-91,8,84:1b:5e:df:1b:99,126615531,80,6863,126615451,126615531
18110,6,12,1,2412,-86,-91,5,40:e3:d6:de:1e:60,126624426,156,8739,126624270,126624426
18111,6,6,1,2412,-85,-91,6,40:e3:d6:de:1e:61,126624640,368,-154,126624272,126624640
18112,6,12,1,2412,-82,-91,9,40:e3:d6:de:1e:62,126625027,176,211,126624851,126625027
18113,6,12,1,2412,-84,-91,7,40:e3:d6:de:1e:63,126625247,180,40,126625067,126625247
18114,6,12,1,2412,-83,-91,8,40:e3:d6:de:1e:64,126625470,172,51,126625298,126625470
18115,6,12,1,2412,-84,-91,7,40:e3:d6:de:1e:65,126625686,156,60,126625530,126625686
18116,6,6,1,2412,-84,-91,7,40:e3:d6:de:1e:66,126625873,380,-193,126625493,126625873
18117,4,1,1,2412,-79,-91,12,b8:3a:5a:88:e6:e0,126637095,2360,8862,126634735,126637095
18118,4,1,1,2412,-81,-91,10,b8:3a:5a:88:e6:e1,126639502,2376,31,126637126,126639502
18119,6,6,1,2412,-69,-91,22,e6:aa:ea:c9:ea:33,126650601,408,10691,126650193,126650601
18120,6,6,1,2412,-61,-91,30,40:e3:d6:da:ba:21,126653575,368,2606,126653207,126653575
18121,6,12,1,2412,-61,-91,30,40:e3:d6:da:ba:23,126654194,184,435,126654010,126654194
18122,6,12,1,2412,-61,-91,30,40:e3:d6:da:ba:24,126654413,176,43,126654237,126654413
18123,6,12,1,2412,-61,-91,30,40:e3:d6:da:ba:25,126654641,160,68,126654481,126654641
18124,6,6,1,2412,-61,-91,30,40:e3:d6:da:ba:26,126654842,380,-179,126654462,126654842
18125,6,12,1,2412,-83,-91,8,40:e3:d6:da:c4:00,126656144,960,342,126655184,126656144
18126,6,6,1,2412,-69,-91,22,e6:aa:ea:c9:ea:33,126686947,408,30395,126686539,126686947
18127,4,1,1,2412,-79,-91,12,b8:3a:5a:88:e6:e0,126722753,2240,33566,126720513,126722753
18128,6,6,1,2412,-84,-91,7,40:e3:d6:de:1e:61,126727353,368,4232,126726985,126727353
18129,6,12,1,2412,-85,-91,6,40:e3:d6:de:1e:62,126727758,176,229,126727582,126727758
18130,6,12,1,2412,-84,-91,7,40:e3:d6:de:1e:63,126727960,180,22,126727780,126727960
18131,6,12,1,2412,-85,-91,6,40:e3:d6:de:1e:64,126728192,172,60,126728020,126728192
18132,6,12,1,2412,-85,-91,6,40:e3:d6:de:1e:65,126728389,156,41,126728233,126728389
18133,6,6,1,2412,-86,-91,5,40:e3:d6:de:1e:66,126728605,380,-164,126728225,126728605
18134,4,1,1,2412,-80,-91,11,b8:3a:5a:88:e6:e0,126739505,2360,8540,126737145,126739505
18135,4,1,1,2412,-79,-91,12,b8:3a:5a:88:e6:e1,126741950,2376,69,126739574,126741950
18136,4,1,1,2412,-81,-91,10,b8:3a:5a:88:e6:e1,126749808,2256,5602,126747552,126749808
18137,6,12,1,2412,-61,-91,30,40:e3:d6:da:ba:20,126776609,160,26641,126776449,126776609
18138,6,6,1,2412,-61,-91,30,40:e3:d6:da:ba:21,126776844,368,-133,126776476,126776844
18139,6,12,1,2412,-60,-91,31,40:e3:d6:da:ba:22,126777258,180,234,126777078,126777258
18140,6,12,1,2412,-61,-91,30,40:e3:d6:da:ba:23,126777491,184,49,126777307,126777491
18141,6,12,1,2412,-60,-91,31,40:e3:d6:da:ba:24,126777709,176,42,126777533,126777709
18142,4,1,1,2412,-85,-91,6,54:e4:3a:ec:fb:64,126813387,2160,33518,126811227,126813387
18143,6,12,1,2412,-85,-91,6,40:e3:d6:de:1e:60,126829220,156,15677,126829064,126829220
18144,6,6,1,2412,-85,-91,6,40:e3:d6:de:1e:61,126829408,368,-180,126829040,126829408
18145,6,12,1,2412,-85,-91,6,40:e3:d6:de:1e:63,126830023,180,435,126829843,126830023
18146,6,12,1,2412,-85,-91,6,40:e3:d6:de:1e:65,126830472,156,293,126830316,126830472
18147,6,6,1,2412,-84,-91,7,40:e3:d6:de:1e:66,126830678,380,-174,126830298,126830678
18148,4,1,1,2412,-80,-91,11,b8:3a:5a:88:e6:e0,126841897,2360,8859,126839537,126841897
18149,4,1,1,2412,-81,-91,10,b8:3a:5a:88:e6:e1,126844276,2376,3,126841900,126844276
18150,6,6,1,2412,-61,-91,30,40:e3:d6:da:ba:21,126858363,368,13719,126857995,126858363
18151,6,12,1,2412,-60,-91,31,40:e3:d6:da:ba:22,126858768,180,225,126858588,126858768
18152,6,12,1,2412,-60,-91,31,40:e3:d6:da:ba:23,126859001,184,49,126858817,126859001
18153,6,12,1,2412,-60,-91,31,40:e3:d6:da:ba:24,126859228,176,51,126859052,126859228
18154,6,12,1,2412,-61,-91,30,40:e3:d6:da:ba:25,126859439,160,51,126859279,126859439
18155,6,6,1,2412,-61,-91,30,40:e3:d6:da:ba:26,126859631,380,-188,126859251,126859631
18156,4,1,1,2412,-82,-91,9,b8:3a:5a:88:e6:e1,126920945,2256,59058,126918689,126920945
18157,6,6,1,2412,-85,-91,6,40:e3:d6:de:1e:61,126931853,368,10540,126931485,126931853
18158,6,12,1,2412,-83,-91,8,40:e3:d6:de:1e:64,126932692,172,667,126932520,126932692
18159,4,1,1,2412,-82,-91,9,b8:3a:5a:88:e6:e0,126937288,2240,2356,126935048,126937288
18160,4,1,1,2412,-82,-91,9,b8:3a:5a:88:e6:e1,126939938,2256,394,126937682,126939938
18161,6,12,1,2412,-62,-91,29,40:e3:d6:da:ba:20,126960597,160,20499,126960437,126960597
18162,6,6,1,2412,-62,-91,29,40:e3:d6:da:ba:21,126960807,368,-158,126960439,126960807
18163,6,12,1,2412,-62,-91,29,40:e3:d6:da:ba:22,126961203,180,216,126961023,126961203
18164,6,12,1,2412,-62,-91,29,40:e3:d6:da:ba:23,126961417,184,30,126961233,126961417
18165,6,12,1,2412,-62,-91,29,40:e3:d6:da:ba:24,126961645,176,52,126961469,126961645
18166,6,12,1,2412,-62,-91,29,40:e3:d6:da:ba:25,126961873,160,68,126961713,126961873
18167,6,6,1,2412,-62,-91,29,40:e3:d6:da:ba:26,126962083,380,-170,126961703,126962083
18168,6,6,1,2412,-79,-91,12,e6:aa:ea:b7:4a:dd,126962638,408,147,126962230,126962638
18169,6,6,1,2412,-80,-91,11,e6:aa:ea:b7:4a:dd,127011109,408,48063,127010701,127011109
18170,6,12,1,2412,-86,-91,5,40:e3:d6:de:1e:60,127034029,156,22764,127033873,127034029
18171,6,6,1,2412,-84,-91,7,40:e3:d6:de:1e:61,127034216,368,-181,127033848,127034216
18172,4,1,1,2412,-80,-91,11,b8:3a:5a:88:e6:e0,127046717,2360,10141,127044357,127046717
18173,4,1,1,2412,-82,-91,9,b8:3a:5a:88:e6:e1,127049115,2376,22,127046739,127049115
18174,6,12,1,2412,-68,-91,23,40:e3:d6:da:ba:22,127063586,180,14291,127063406,127063586
18175,6,12,1,2412,-63,-91,28,40:e3:d6:da:ba:24,127064029,176,267,127063853,127064029
18176,6,12,1,2412,-63,-91,28,40:e3:d6:da:ba:25,127064239,160,50,127064079,127064239
18177,6,6,1,2412,-63,-91,28,40:e3:d6:da:ba:26,127064431,380,-188,127064051,127064431
18178,6,6,1,2412,-70,-91,21,e6:aa:ea:c9:ea:33,127068649,408,3810,127068241,127068649
18179,6,6,1,2412,-69,-91,22,e6:aa:ea:c9:ea:33,127080761,408,11704,127080353,127080761
18180,6,6,1,2412,-69,-91,22,e6:aa:ea:c9:ea:33,127105001,408,23832,127104593,127105001
18181,6,6,1,2412,-70,-91,21,e6:aa:ea:c9:ea:33,127117134,408,11725,127116726,127117134
18182,4,1,1,2412,-86,-91,5,54:e4:3a:ec:fb:64,127120584,2160,1290,127118424,127120584
18183,6,6,1,2412,-85,-91,6,40:e3:d6:de:1e:66,127137884,380,16920,127137504,127137884
18184,4,1,1,2412,-82,-91,9,b8:3a:5a:88:e6:e0,127149111,2360,8867,127146751,127149111
18185,4,1,1,2412,-81,-91,10,b8:3a:5a:88:e6:e1,127151499,2376,12,127149123,127151499
18186,6,12,1,2412,-64,-91,27,40:e3:d6:da:ba:20,127165398,160,13739,127165238,127165398
18187,6,6,1,2412,-64,-91,27,40:e3:d6:da:ba:21,127165617,368,-149,127165249,127165617
18188,6,12,1,2412,-64,-91,27,40:e3:d6:da:ba:22,127166022,180,225,127165842,127166022
18189,6,12,1,2412,-64,-91,27,40:e3:d6:da:ba:23,127166227,184,21,127166043,127166227
18190,6,12,1,2412,-64,-91,27,40:e3:d6:da:ba:24,127166454,176,51,127166278,127166454
18191,6,12,1,2412,-63,-91,28,40:e3:d6:da:ba:25,127166682,160,68,127166522,127166682
18192,6,6,1,2412,-64,-91,27,40:e3:d6:da:ba:26,127166893,380,-169,127166513,127166893
18193,6,12,1,2412,-64,-91,27,40:e3:d6:da:ba:20,127184152,136,17123,127184016,127184152
18194,6,6,1,2412,-64,-91,27,40:e3:d6:da:ba:21,127184329,348,-171,127183981,127184329
18195,6,12,1,2412,-64,-91,27,40:e3:d6:da:ba:22,127184705,156,220,127184549,127184705
18196,6,12,1,2412,-63,-91,28,40:e3:d6:da:ba:23,127184895,156,34,127184739,127184895
18197,6,12,1,2412,-63,-91,28,40:e3:d6:da:ba:25,127185085,136,54,127184949,127185085
18198,4,1,1,2412,-88,-91,3,be:70:98:52:68:f0,127203782,1128,17569,127202654,127203782
18199,6,12,1,2412,-63,-91,28,40:e3:d6:da:ba:20,127204893,136,975,127204757,127204893
18200,6,6,1,2412,-63,-91,28,40:e3:d6:da:ba:21,127205088,348,-153,127204740,127205088
18201,6,12,1,2412,-62,-91,29,40:e3:d6:da:ba:22,127205481,156,237,127205325,127205481
18202,6,12,1,2412,-62,-91,29,40:e3:d6:da:ba:23,127205681,156,44,127205525,127205681
18203,6,12,1,2412,-63,-91,28,40:e3:d6:da:ba:25,127205881,136,64,127205745,127205881
18204,6,12,1,2412,-90,-91,1,40:e3:d6:da:c0:20,127222624,136,16607,127222488,127222624
18205,6,12,1,2412,-84,-91,7,40:e3:d6:de:1e:60,127238845,156,16065,127238689,127238845
18206,6,6,1,2412,-85,-91,6,40:e3:d6:de:1e:61,127239060,368,-153,127238692,127239060
18207,6,12,1,2412,-85,-91,6,40:e3:d6:de:1e:62,127239456,176,220,127239280,127239456
18208,4,1,1,2412,-81,-91,10,b8:3a:5a:88:e6:e0,127252301,2360,10485,127249941,127252301
18209,4,1,1,2412,-83,-91,8,b8:3a:5a:88:e6:e1,127254699,2376,22,127252323,127254699
18210,6,12,1,2412,-63,-91,28,40:e3:d6:da:ba:20,127267790,160,12931,127267630,127267790
18211,6,6,1,2412,-63,-91,28,40:e3:d6:da:ba:21,127267991,368,-167,127267623,127267991
18212,6,12,1,2412,-63,-91,28,40:e3:d6:da:ba:22,127268387,180,216,127268207,127268387
18213,6,12,1,2412,-63,-91,28,40:e3:d6:da:ba:23,127268610,184,39,127268426,127268610
18214,6,12,1,2412,-64,-91,27,40:e3:d6:da:ba:24,127268847,176,61,127268671,127268847
18215,6,12,1,2412,-63,-91,28,40:e3:d6:da:ba:25,127269066,160,59,127268906,127269066
18216,6,6,1,2412,-63,-91,28,40:e3:d6:da:ba:26,127269258,380,-188,127268878,127269258
18217,6,6,1,2412,-85,-91,6,40:e3:d6:de:1e:61,127341428,368,71802,127341060,127341428
18218,6,12,1,2412,-83,-91,8,40:e3:d6:de:1e:62,127341824,176,220,127341648,127341824
18219,6,12,1,2412,-83,-91,8,40:e3:d6:de:1e:63,127342052,180,48,127341872,127342052
18220,6,12,1,2412,-85,-91,6,40:e3:d6:de:1e:64,127342258,172,34,127342086,127342258
18221,6,6,1,2412,-83,-91,8,40:e3:d6:de:1e:66,127342688,380,50,127342308,127342688
18222,4,1,1,2412,-83,-91,8,b8:3a:5a:88:e6:e0,127353897,2360,8849,127351537,127353897
18223,4,1,1,2412,-84,-91,7,b8:3a:5a:88:e6:e1,127356295,2376,22,127353919,127356295
18224,6,12,1,2412,-61,-91,30,40:e3:d6:da:ba:22,127370765,180,14290,127370585,127370765
18225,6,12,1,2412,-63,-91,28,40:e3:d6:da:ba:23,127370997,184,48,127370813,127370997
18226,6,12,1,2412,-63,-91,28,40:e3:d6:da:ba:24,127371216,176,43,127371040,127371216
18227,6,12,1,2412,-63,-91,28,40:e3:d6:da:ba:25,127371444,160,68,127371284,127371444
18228,6,6,1,2412,-63,-91,28,40:e3:d6:da:ba:26,127371654,380,-170,127371274,127371654
18229,6,6,1,2412,-84,-91,7,e6:aa:ea:b7:4a:dd,127391839,408,19777,127391431,127391839
18230,6,6,1,2412,-81,-91,10,e6:aa:ea:b7:4a:dd,127403964,408,11717,127403556,127403964
18231,6,6,1,2412,-82,-91,9,e6:aa:ea:b7:4a:dd,127416078,408,11706,127415670,127416078
18232,4,1,1,2412,-83,-91,8,54:e4:3a:ec:fb:64,127427782,2160,9544,127425622,127427782
18233,6,12,1,2412,-83,-91,8,40:e3:d6:de:1e:65,127444884,156,16946,127444728,127444884
18234,4,1,1,2412,-83,-91,8,b8:3a:5a:88:e6:e0,127456297,2360,9053,127453937,127456297
18235,6,6,1,2412,-65,-91,26,40:e3:d6:da:ba:21,127472766,368,16101,127472398,127472766
18236,6,12,1,2412,-65,-91,26,40:e3:d6:da:ba:23,127473412,184,462,127473228,127473412
18237,6,12,1,2412,-65,-91,26,40:e3:d6:da:ba:24,127473640,176,52,127473464,127473640
18238,6,12,1,2412,-65,-91,26,40:e3:d6:da:ba:25,127473868,160,68,127473708,127473868
18239,6,6,1,2412,-66,-91,25,40:e3:d6:da:ba:26,127474069,380,-179,127473689,127474069
18240,6,6,1,2412,-71,-91,20,e6:aa:ea:c9:ea:33,127486364,408,11887,127485956,127486364
18241,6,6,1,2412,-70,-91,21,e6:aa:ea:c9:ea:33,127498318,408,11546,127497910,127498318
18242,6,6,1,2412,-69,-91,22,e6:aa:ea:c9:ea:33,127510429,408,11703,127510021,127510429
18243,4,1,1,2412,-84,-91,7,54:e4:3a:ec:fb:64,127530181,2160,17592,127528021,127530181
18244,6,6,1,2412,-70,-91,21,e6:aa:ea:c9:ea:33,127534661,408,4072,127534253,127534661
18245,6,12,1,2412,-83,-91,8,40:e3:d6:de:1e:60,127546037,156,11220,127545881,127546037
18246,6,12,1,2412,-82,-91,9,40:e3:d6:de:1e:62,127546667,176,454,127546491,127546667
18247,6,12,1,2412,-83,-91,8,40:e3:d6:de:1e:63,127546886,180,39,127546706,127546886
18248,6,12,1,2412,-81,-91,10,40:e3:d6:de:1e:64,127547092,172,34,127546920,127547092
18249,6,12,1,2412,-85,-91,6,40:e3:d6:de:1e:65,127547306,156,58,127547150,127547306
18250,6,6,1,2412,-83,-91,8,40:e3:d6:de:1e:66,127547512,380,-174,127547132,127547512
18251,6,6,1,2412,-87,-91,4,40:e3:d6:da:c0:26,127547958,380,66,127547578,127547958
18252,4,1,1,2412,-80,-91,11,b8:3a:5a:88:e6:e1,127561407,2376,11073,127559031,127561407
18253,6,12,1,2412,-65,-91,26,40:e3:d6:da:ba:20,127574988,160,13421,127574828,127574988
18254,6,6,1,2412,-65,-91,26,40:e3:d6:da:ba:21,127575198,368,-158,127574830,127575198
18255,6,12,1,2412,-65,-91,26,40:e3:d6:da:ba:22,127575585,180,207,127575405,127575585
18256,6,12,1,2412,-65,-91,26,40:e3:d6:da:ba:23,127575817,184,48,127575633,127575817
18257,6,12,1,2412,-64,-91,27,40:e3:d6:da:ba:24,127576027,176,34,127575851,127576027
18258,6,12,1,2412,-64,-91,27,40:e3:d6:da:ba:25,127576247,160,60,127576087,127576247
18259,6,6,1,2412,-65,-91,26,40:e3:d6:da:ba:26,127576448,380,-179,127576068,127576448
18260,4,1,1,2412,-82,-91,9,54:e4:3a:ec:fb:64,127632579,2160,53971,127630419,127632579
18261,6,12,1,2412,-84,-91,7,40:e3:d6:de:1e:60,127648423,156,15688,127648267,127648423
18262,6,6,1,2412,-84,-91,7,40:e3:d6:de:1e:61,127648630,368,-161,127648262,127648630
18263,6,12,1,2412,-83,-91,8,40:e3:d6:de:1e:64,127649450,172,648,127649278,127649450
18264,6,12,1,2412,-83,-91,8,40:e3:d6:de:1e:65,127649665,156,59,127649509,127649665
18265,4,1,1,2412,-80,-91,11,b8:3a:5a:88:e6:e0,127661178,2360,9153,127658818,127661178
18266,4,1,1,2412,-79,-91,12,b8:3a:5a:88:e6:e1,127663576,2376,22,127661200,127663576
18267,6,12,1,2412,-65,-91,26,40:e3:d6:da:ba:20,127677375,160,13639,127677215,127677375
18268,6,6,1,2412,-65,-91,26,40:e3:d6:da:ba:21,127677576,368,-167,127677208,127677576
18269,6,12,1,2412,-64,-91,27,40:e3:d6:da:ba:22,127677990,180,234,127677810,127677990
18270,6,12,1,2412,-65,-91,26,40:e3:d6:da:ba:23,127678195,184,21,127678011,127678195
18271,6,12,1,2412,-65,-91,26,40:e3:d6:da:ba:24,127678414,176,43,127678238,127678414
18272,6,12,1,2412,-65,-91,26,40:e3:d6:da:ba:25,127678615,160,41,127678455,127678615
18273,6,6,1,2412,-65,-91,26,40:e3:d6:da:ba:26,127678845,380,-150,127678465,127678845
18274,4,1,1,2412,-84,-91,7,54:e4:3a:ec:fb:64,127734979,2160,53974,127732819,127734979
18275,4,1,1,2412,-82,-91,9,b8:3a:5a:88:e6:e0,127763673,2360,26334,127761313,127763673
18276,4,1,1,2412,-81,-91,10,b8:3a:5a:88:e6:e1,127766387,2376,338,127764011,127766387
18277,6,12,1,2412,-65,-91,26,40:e3:d6:da:ba:20,127779857,160,13310,127779697,127779857
18278,6,6,1,2412,-64,-91,27,40:e3:d6:da:ba:21,127780083,368,-142,127779715,127780083
18279,6,12,1,2412,-65,-91,26,40:e3:d6:da:ba:22,127780488,180,225,127780308,127780488
18280,6,12,1,2412,-64,-91,27,40:e3:d6:da:ba:23,127780711,184,39,127780527,127780711
18281,6,12,1,2412,-66,-91,25,40:e3:d6:da:ba:24,127780921,176,34,127780745,127780921
18282,6,12,1,2412,-65,-91,26,40:e3:d6:da:ba:25,127781122,160,41,127780962,127781122
18283,6,6,1,2412,-64,-91,27,40:e3:d6:da:ba:26,127781323,380,-179,127780943,127781323
18284,6,6,1,2412,-71,-91,20,e6:aa:ea:c9:ea:33,127812649,408,30918,127812241,127812649
18285,6,6,1,2412,-71,-91,20,e6:aa:ea:c9:ea:33,127824767,408,11710,127824359,127824767
18286,6,6,1,2412,-71,-91,20,e6:aa:ea:c9:ea:33,127836892,408,11717,127836484,127836892
18287,4,1,1,2412,-86,-91,5,54:e4:3a:ec:fb:64,127837490,2160,-1562,127835330,127837490
18288,6,6,1,2412,-71,-91,20,e6:aa:ea:c9:ea:33,127849223,408,11325,127848815,127849223
18289,6,12,1,2412,-85,-91,6,40:e3:d6:de:1e:60,127853228,156,3849,127853072,127853228
18290,6,12,1,2412,-84,-91,7,40:e3:d6:de:1e:62,127853812,176,408,127853636,127853812
18291,6,12,1,2412,-84,-91,7,40:e3:d6:de:1e:65,127854497,156,529,127854341,127854497
18292,6,6,1,2412,-84,-91,7,40:e3:d6:de:1e:66,127854712,380,-165,127854332,127854712
18293,6,6,1,2412,-89,-91,2,40:e3:d6:da:c0:26,127855220,380,128,127854840,127855220
18294,6,12,1,2412,-65,-91,26,40:e3:d6:da:ba:20,127882187,160,26807,127882027,127882187
18295,6,6,1,2412,-65,-91,26,40:e3:d6:da:ba:21,127882406,368,-149,127882038,127882406
18296,6,12,1,2412,-65,-91,26,40:e3:d6:da:ba:22,127882820,180,234,127882640,127882820
18297,6,12,1,2412,-65,-91,26,40:e3:d6:da:ba:25,127883491,160,511,127883331,127883491
18298,6,6,1,2412,-65,-91,26,40:e3:d6:da:ba:26,127883710,380,-161,127883330,127883710
18299,6,6,1,2412,-84,-91,7,e6:aa:ea:b7:4a:dd,127899676,408,15558,127899268,127899676
18300,6,6,1,2412,-88,-91,3,78:8a:20:fa:27:f9,127910010,88,10246,127909922,127910010
18301,4,1,1,2412,-81,-91,10,b8:3a:5a:88:e6:e0,127910516,2240,-1734,127908276,127910516
18302,4,1,1,2412,-83,-91,8,b8:3a:5a:88:e6:e1,127912803,2256,31,127910547,127912803
18303,6,6,1,2412,-85,-91,6,e6:aa:ea:b7:4a:dd,127923916,408,10705,127923508,127923916
18304,6,6,1,2412,-84,-91,7,e6:aa:ea:b7:4a:dd,127936030,408,11706,127935622,127936030
18305,4,1,1,2412,-85,-91,6,54:e4:3a:ec:fb:64,127939776,2160,1586,127937616,127939776
18306,6,6,1,2412,-83,-91,8,e6:aa:ea:b7:4a:dd,127948140,408,7956,127947732,127948140
18307,6,12,1,2412,-84,-91,7,40:e3:d6:de:1e:63,127956452,180,8132,127956272,127956452
18308,6,12,1,2412,-84,-91,7,40:e3:d6:de:1e:64,127956685,172,61,127956513,127956685
18309,6,12,1,2412,-84,-91,7,40:e3:d6:de:1e:65,127956901,156,60,127956745,127956901
18310,6,6,1,2412,-82,-91,9,40:e3:d6:de:1e:66,127957088,380,-193,127956708,127957088
18311,6,6,1,2412,-86,-91,5,40:e3:d6:da:c0:26,127957584,380,116,127957204,127957584
18312,6,12,1,2412,-88,-91,3,,127962863,32,5247,127962831,127962863
18313,6,12,1,2412,-88,-91,3,,127963104,32,209,127963072,127963104
18314,6,12,1,2412,-66,-91,25,40:e3:d6:da:ba:22,127985193,180,21909,127985013,127985193
18315,6,12,1,2412,-66,-91,25,40:e3:d6:da:ba:23,127985408,184,31,127985224,127985408
18316,6,6,1,2412,-66,-91,25,40:e3:d6:da:ba:26,127986083,380,295,127985703,127986083
18317,4,1,1,2412,-90,-91,1,c0:c9:e3:4d:6e:bf,128003481,872,16526,128002609,128003481
18318,4,1,1,2412,-82,-91,9,54:e4:3a:ec:fb:64,128042176,2160,36535,128040016,128042176
18319,6,12,1,2412,-85,-91,6,40:e3:d6:de:1e:60,128058025,156,15693,128057869,128058025
18320,6,6,1,2412,-86,-91,5,40:e3:d6:de:1e:61,128058240,368,-153,128057872,128058240
18321,6,12,1,2412,-85,-91,6,40:e3:d6:de:1e:64,128059079,172,667,128058907,128059079
18322,6,6,1,2412,-85,-91,6,40:e3:d6:de:1e:66,128059510,380,51,128059130,128059510
18323,4,1,1,2412,-84,-91,7,b8:3a:5a:88:e6:e0,128070725,2360,8855,128068365,128070725
18324,4,1,1,2412,-85,-91,6,b8:3a:5a:88:e6:e1,128073105,2376,4,128070729,128073105
18325,6,12,1,2412,-65,-91,26,40:e3:d6:da:ba:20,128086980,160,13715,128086820,128086980
18326,6,6,1,2412,-64,-91,27,40:e3:d6:da:ba:21,128087190,368,-158,128086822,128087190
18327,6,12,1,2412,-64,-91,27,40:e3:d6:da:ba:22,128087586,180,216,128087406,128087586
18328,6,12,1,2412,-65,-91,26,40:e3:d6:da:ba:23,128087818,184,48,128087634,128087818
18329,6,12,1,2412,-64,-91,27,40:e3:d6:da:ba:24,128088054,176,60,128087878,128088054
18330,6,12,1,2412,-64,-91,27,40:e3:d6:da:ba:25,128088265,160,51,128088105,128088265
18331,6,6,1,2412,-64,-91,27,40:e3:d6:da:ba:26,128088466,380,-179,128088086,128088466
18332,4,1,1,2412,-80,-91,11,54:e4:3a:ec:fb:64,128108409,2112,17831,128106297,128108409
18333,6,12,1,2412,-64,-91,27,40:e3:d6:da:ba:20,128110698,136,2153,128110562,128110698
18334,6,6,1,2412,-64,-91,27,40:e3:d6:da:ba:21,128110875,348,-171,128110527,128110875
18335,6,12,1,2412,-64,-91,27,40:e3:d6:da:ba:22,128111250,156,219,128111094,128111250
18336,6,12,1,2412,-64,-91,27,40:e3:d6:da:ba:23,128111441,156,35,128111285,128111441
18337,6,12,1,2412,-65,-91,26,40:e3:d6:da:ba:25,128111641,136,64,128111505,128111641
18338,6,12,1,2412,-64,-91,27,40:e3:d6:da:ba:20,128128355,136,16578,128128219,128128355
18339,6,12,1,2412,-64,-91,27,40:e3:d6:da:ba:22,128128935,156,424,128128779,128128935
18340,6,12,1,2412,-64,-91,27,40:e3:d6:da:ba:23,128129135,156,44,128128979,128129135
18341,6,12,1,2412,-64,-91,27,40:e3:d6:da:ba:25,128129352,136,81,128129216,128129352
18342,4,1,1,2412,-80,-91,11,54:e4:3a:ec:fb:64,128130147,2112,-1317,128128035,128130147
18343,4,1,1,2412,-90,-91,1,a6:e5:7c:28:b1:d3,128132915,992,1776,128131923,128132915
18344,4,1,1,2412,-73,-91,18,96:f7:34:9d:bc:af,128136005,1128,1962,128134877,128136005
18345,6,12,1,2412,-64,-91,27,40:e3:d6:da:ba:20,128137102,136,961,128136966,128137102
18346,6,12,1,2412,-64,-91,27,40:e3:d6:da:ba:22,128140536,156,3278,128140380,128140536
18347,6,12,1,2412,-74,-91,17,,128140709,32,141,128140677,128140709
18348,6,12,1,2412,-64,-91,27,40:e3:d6:da:ba:23,128141913,156,1048,128141757,128141913
18349,6,12,1,2412,-74,-91,17,,128142085,32,140,128142053,128142085
18350,6,12,1,2412,-64,-91,27,40:e3:d6:da:ba:25,128142180,136,-41,128142044,128142180
18351,6,12,1,2412,-74,-91,17,,128142332,32,120,128142300,128142332
18352,4,1,1,2412,-73,-91,18,,128144915,304,2279,128144611,128144915
18353,4,1,1,2412,-73,-91,18,96:f7:34:9d:bc:af,128156211,1128,10168,128155083,128156211
18354,4,1,1,2412,-79,-91,12,54:e4:3a:ec:fb:64,128157462,2112,-861,128155350,128157462
18355,4,1,1,2412,-74,-91,17,,128159587,304,1821,128159283,128159587
18356,6,12,1,2412,-65,-91,26,40:e3:d6:da:ba:20,128159751,136,28,128159615,128159751
18357,6,12,1,2412,-74,-91,17,,128159903,32,120,128159871,128159903
18358,6,6,1,2412,-64,-91,27,40:e3:d6:da:ba:21,128159986,348,-265,128159638,128159986
18359,6,6,1,2412,-74,-91,17,,128160350,44,320,128160306,128160350
18360,6,12,1,2412,-74,-91,17,,128160604,32,222,128160572,128160604
18361,6,12,1,2412,-64,-91,27,40:e3:d6:da:ba:23,128160689,156,-71,128160533,128160689
18362,6,12,1,2412,-73,-91,18,,128160862,32,141,128160830,128160862
18363,6,12,1,2412,-74,-91,17,,128161611,32,717,128161579,128161611
18364,4,1,1,2412,-85,-91,6,b8:3a:5a:88:e6:e1,128163176,2256,-691,128160920,128163176
18365,6,12,1,2412,-82,-91,9,40:e3:d6:de:1e:63,128165537,180,2181,128165357,128165537
18366,6,12,1,2412,-86,-91,5,40:e3:d6:de:1e:65,128165967,156,274,128165811,128165967
18367,6,6,1,2412,-83,-91,8,40:e3:d6:de:1e:66,128166182,380,-165,128165802,128166182
18368,4,1,1,2412,-91,-91,0,a4:e5:7c:28:b1:d3,128187035,688,20165,128186347,128187035
18369,6,12,1,2412,-65,-91,26,40:e3:d6:da:ba:20,128189395,160,2200,128189235,128189395
18370,6,6,1,2412,-65,-91,26,40:e3:d6:da:ba:21,128189596,368,-167,128189228,128189596
18371,6,12,1,2412,-64,-91,27,40:e3:d6:da:ba:22,128189992,180,216,128189812,128189992
18372,6,12,1,2412,-65,-91,26,40:e3:d6:da:ba:23,128190197,184,21,128190013,128190197
18373,6,12,1,2412,-64,-91,27,40:e3:d6:da:ba:24,128190433,176,60,128190257,128190433
18374,6,12,1,2412,-64,-91,27,40:e3:d6:da:ba:25,128190644,160,51,128190484,128190644
18375,6,6,1,2412,-65,-91,26,40:e3:d6:da:ba:26,128190836,380,-188,128190456,128190836
18376,6,6,1,2412,-85,-91,6,e6:aa:ea:b7:4a:dd,128214773,408,23529,128214365,128214773
18377,6,6,1,2412,-84,-91,7,e6:aa:ea:b7:4a:dd,128226900,408,11719,128226492,128226900
18378,6,6,1,2412,-87,-91,4,40:e3:d6:de:1e:61,128228810,348,1562,128228462,128228810
18379,6,6,1,2412,-87,-91,4,40:e3:d6:de:1e:61,128231551,348,2393,128231203,128231551
18380,6,6,1,2412,-86,-91,5,40:e3:d6:de:1e:61,128233035,348,1136,128232687,128233035
18381,6,12,1,2412,-87,-91,4,40:e3:d6:de:1e:63,128233646,156,455,128233490,128233646
18382,6,12,1,2412,-87,-91,4,40:e3:d6:de:1e:65,128233863,136,81,128233727,128233863
18383,4,1,1,2412,-91,-91,0,a6:e5:7c:28:b1:d3,128235107,992,252,128234115,128235107
18384,6,6,1,2412,-83,-91,8,e6:aa:ea:b7:4a:dd,128239299,408,3784,128238891,128239299
18385,4,1,1,2412,-79,-91,12,54:e4:3a:ec:fb:64,128246973,2160,5514,128244813,128246973
18386,6,6,1,2412,-83,-91,8,e6:aa:ea:b7:4a:dd,128251139,408,3758,128250731,128251139
18387,6,12,1,2412,-86,-91,5,40:e3:d6:de:1e:60,128254687,136,3412,128254551,128254687
18388,6,6,1,2412,-86,-91,5,40:e3:d6:de:1e:61,128254864,348,-171,128254516,128254864
18389,6,12,1,2412,-87,-91,4,40:e3:d6:de:1e:62,128255258,156,238,128255102,128255258
18390,6,12,1,2412,-86,-91,5,40:e3:d6:de:1e:63,128255449,156,35,128255293,128255449
18391,6,12,1,2412,-85,-91,6,40:e3:d6:de:1e:65,128255657,136,72,128255521,128255657
18392,6,6,1,2412,-82,-91,9,e6:aa:ea:b7:4a:dd,128263357,408,7292,128262949,128263357
18393,6,12,1,2412,-85,-91,6,40:e3:d6:de:1e:65,128264081,156,568,128263925,128264081
18394,6,6,1,2412,-85,-91,6,40:e3:d6:de:1e:66,128264287,380,-174,128263907,128264287
18395,4,1,1,2412,-83,-91,8,b8:3a:5a:88:e6:e0,128275520,2360,8873,128273160,128275520
18396,4,1,1,2412,-83,-91,8,b8:3a:5a:88:e6:e1,128277917,2376,21,128275541,128277917
18397,6,12,1,2412,-86,-91,5,40:e3:d6:de:1e:60,128280858,136,2805,128280722,128280858
18398,6,12,1,2412,-66,-91,25,40:e3:d6:da:ba:20,128282046,136,1052,128281910,128282046
18399,6,6,1,2412,-66,-91,25,40:e3:d6:da:ba:21,128282232,348,-162,128281884,128282232
18400,6,12,1,2412,-66,-91,25,40:e3:d6:da:ba:22,128282617,156,229,128282461,128282617
18401,6,12,1,2412,-66,-91,25,40:e3:d6:da:ba:23,128282835,156,62,128282679,128282835
18402,6,12,1,2412,-66,-91,25,40:e3:d6:da:ba:25,128283034,136,63,128282898,128283034
18403,4,1,1,2412,-80,-91,11,54:e4:3a:ec:fb:64,128283734,2112,-1412,128281622,128283734
18404,6,12,1,2412,-66,-91,25,40:e3:d6:da:ba:22,128294211,180,10297,128294031,128294211
18405,6,12,1,2412,-66,-91,25,40:e3:d6:da:ba:23,128294444,184,49,128294260,128294444
18406,6,12,1,2412,-66,-91,25,40:e3:d6:da:ba:24,128294653,176,33,128294477,128294653
18407,4,1,1,2412,-82,-91,9,54:e4:3a:ec:fb:64,128302277,2112,5512,128300165,128302277
18408,6,12,1,2412,-67,-91,24,40:e3:d6:da:ba:20,128304641,136,2228,128304505,128304641
18409,6,6,1,2412,-67,-91,24,40:e3:d6:da:ba:21,128304836,348,-153,128304488,128304836
18410,6,12,1,2412,-67,-91,24,40:e3:d6:da:ba:22,128305230,156,238,128305074,128305230
18411,6,12,1,2412,-66,-91,25,40:e3:d6:da:ba:23,128305420,156,34,128305264,128305420
18412,6,12,1,2412,-67,-91,24,40:e3:d6:da:ba:25,128305638,136,82,128305502,128305638
18413,6,6,1,2412,-68,-91,23,e6:aa:ea:c9:ea:33,128320556,408,14510,128320148,128320556
18414,4,1,1,2412,-83,-91,8,54:e4:3a:ec:fb:64,128349373,2160,26657,128347213,128349373
18415,6,6,1,2412,-68,-91,23,e6:aa:ea:c9:ea:33,128356921,408,7140,128356513,128356921
18416,6,12,1,2412,-87,-91,4,40:e3:d6:de:1e:60,128365227,156,8150,128365071,128365227
18417,6,6,1,2412,-86,-91,5,40:e3:d6:de:1e:61,128365433,368,-162,128365065,128365433
18418,6,12,1,2412,-86,-91,5,40:e3:d6:de:1e:62,128365820,176,211,128365644,128365820
18419,6,12,1,2412,-85,-91,6,40:e3:d6:de:1e:63,128366030,180,30,128365850,128366030
18420,6,12,1,2412,-86,-91,5,40:e3:d6:de:1e:64,128366254,172,52,128366082,128366254
18421,6,12,1,2412,-87,-91,4,40:e3:d6:de:1e:65,128366478,156,68,128366322,128366478
18422,6,6,1,2412,-85,-91,6,40:e3:d6:de:1e:66,128366684,380,-174,128366304,128366684
18423,6,6,1,2412,-68,-91,23,e6:aa:ea:c9:ea:33,128369452,408,2360,128369044,128369452
18424,4,1,1,2412,-80,-91,11,b8:3a:5a:88:e6:e1,128380314,2376,8486,128377938,128380314
18425,6,12,1,2412,-67,-91,24,40:e3:d6:da:ba:20,128394197,160,13723,128394037,128394197
18426,6,6,1,2412,-67,-91,24,40:e3:d6:da:ba:21,128394398,368,-167,128394030,128394398
18427,6,12,1,2412,-67,-91,24,40:e3:d6:da:ba:22,128394785,180,207,128394605,128394785
18428,6,12,1,2412,-67,-91,24,40:e3:d6:da:ba:25,128395428,160,483,128395268,128395428
18429,6,6,1,2412,-67,-91,24,40:e3:d6:da:ba:26,128395620,380,-188,128395240,128395620
18430,6,12,1,2412,-86,-91,5,40:e3:d6:de:1e:60,128410199,136,14443,128410063,128410199
18431,6,6,1,2412,-87,-91,4,40:e3:d6:de:1e:61,128410403,348,-144,128410055,128410403
18432,6,12,1,2412,-86,-91,5,40:e3:d6:de:1e:62,128410788,156,229,128410632,128410788
18433,6,12,1,2412,-86,-91,5,40:e3:d6:de:1e:63,128410978,156,34,128410822,128410978
18434,6,12,1,2412,-86,-91,5,40:e3:d6:de:1e:65,128411169,136,55,128411033,128411169
18435,6,12,1,2412,-86,-91,5,40:e3:d6:de:1e:60,128430577,136,19272,128430441,128430577
18436,6,6,1,2412,-83,-91,8,40:e3:d6:de:1e:61,128430763,348,-162,128430415,128430763
18437,6,12,1,2412,-86,-91,5,40:e3:d6:de:1e:62,128431166,156,247,128431010,128431166
18438,6,12,1,2412,-81,-91,10,40:e3:d6:de:1e:65,128431592,136,290,128431456,128431592
18439,6,12,1,2412,-85,-91,6,40:e3:d6:de:1e:60,128467639,156,35891,128467483,128467639
18440,6,6,1,2412,-86,-91,5,40:e3:d6:de:1e:61,128467826,368,-181,128467458,128467826
18441,6,12,1,2412,-85,-91,6,40:e3:d6:de:1e:62,128468231,176,229,128468055,128468231
18442,6,12,1,2412,-85,-91,6,40:e3:d6:de:1e:65,128468844,156,457,128468688,128468844
18443,6,6,1,2412,-86,-91,5,40:e3:d6:de:1e:66,128469060,380,-164,128468680,128469060
18444,4,1,1,2412,-84,-91,7,b8:3a:5a:88:e6:e0,128482030,2360,10610,128479670,128482030
18445,4,1,1,2412,-83,-91,8,b8:3a:5a:88:e6:e1,128484419,2376,13,128482043,128484419
18446,6,12,1,2412,-67,-91,24,40:e3:d6:da:ba:20,128496578,160,11999,128496418,128496578
18447,6,6,1,2412,-67,-91,24,40:e3:d6:da:ba:21,128496788,368,-158,128496420,128496788
18448,6,12,1,2412,-67,-91,24,40:e3:d6:da:ba:22,128497175,180,207,128496995,128497175
18449,6,12,1,2412,-67,-91,24,40:e3:d6:da:ba:23,128497390,184,31,128497206,128497390
18450,6,12,1,2412,-67,-91,24,40:e3:d6:da:ba:24,128497617,176,51,128497441,128497617
18451,6,12,1,2412,-67,-91,24,40:e3:d6:da:ba:25,128497846,160,69,128497686,128497846
18452,6,6,1,2412,-67,-91,24,40:e3:d6:da:ba:26,128498065,380,-161,128497685,128498065
18453,6,6,1,2412,-80,-91,11,e6:aa:ea:b7:4a:dd,128530276,408,31803,128529868,128530276
18454,4,1,1,2412,-83,-91,8,54:e4:3a:ec:fb:64,128554171,2160,21735,128552011,128554171
18455,6,6,1,2412,-80,-91,11,e6:aa:ea:b7:4a:dd,128566623,408,12044,128566215,128566623
18456,4,1,1,2412,-80,-91,11,b8:3a:5a:88:e6:e0,128582700,2360,13717,128580340,128582700
18457,6,12,1,2412,-67,-91,24,40:e3:d6:da:ba:20,128599001,160,16141,128598841,128599001
18458,6,6,1,2412,-67,-91,24,40:e3:d6:da:ba:21,128599211,368,-158,128598843,128599211
18459,6,12,1,2412,-67,-91,24,40:e3:d6:da:ba:22,128599625,180,234,128599445,128599625
18460,6,12,1,2412,-67,-91,24,40:e3:d6:da:ba:23,128599857,184,48,128599673,128599857
18461,6,12,1,2412,-67,-91,24,40:e3:d6:da:ba:24,128600085,176,52,128599909,128600085
18462,6,12,1,2412,-67,-91,24,40:e3:d6:da:ba:25,128600304,160,59,128600144,128600304
18463,6,6,1,2412,-67,-91,24,40:e3:d6:da:ba:26,128600514,380,-170,128600134,128600514
18464,6,12,1,2412,-85,-91,6,40:e3:d6:de:1e:60,128672428,156,71758,128672272,128672428
18465,6,6,1,2412,-85,-91,6,40:e3:d6:de:1e:61,128672624,368,-172,128672256,128672624
18466,6,12,1,2412,-85,-91,6,40:e3:d6:de:1e:62,128673029,176,229,128672853,128673029
18467,6,12,1,2412,-84,-91,7,40:e3:d6:de:1e:63,128673249,180,40,128673069,128673249
18468,6,12,1,2412,-85,-91,6,40:e3:d6:de:1e:64,128673482,172,61,128673310,128673482
18469,6,12,1,2412,-86,-91,5,40:e3:d6:de:1e:65,128673706,156,68,128673550,128673706
18470,6,6,1,2412,-84,-91,7,40:e3:d6:de:1e:66,128673921,380,-165,128673541,128673921
18471,4,1,1,2412,-80,-91,11,b8:3a:5a:88:e6:e0,128685113,2360,8832,128682753,128685113
18472,6,12,1,2412,-66,-91,25,40:e3:d6:da:ba:20,128701391,160,16118,128701231,128701391
18473,6,6,1,2412,-66,-91,25,40:e3:d6:da:ba:21,128701610,368,-149,128701242,128701610
18474,6,12,1,2412,-66,-91,25,40:e3:d6:da:ba:22,128702053,180,263,128701873,128702053
18475,6,12,1,2412,-66,-91,25,40:e3:d6:da:ba:23,128702286,184,49,128702102,128702286
18476,6,12,1,2412,-66,-91,25,40:e3:d6:da:ba:24,128702495,176,33,128702319,128702495
18477,6,12,1,2412,-66,-91,25,40:e3:d6:da:ba:25,128702723,160,68,128702563,128702723
18478,6,6,1,2412,-67,-91,24,40:e3:d6:da:ba:26,128702916,380,-187,128702536,128702916
18479,4,1,1,2412,-93,-91,-2,a6:e5:7c:28:b1:d3,128740012,944,36152,128739068,128740012
18480,6,12,1,2412,-85,-91,6,40:e3:d6:de:1e:60,128774846,156,34678,128774690,128774846
18481,6,12,1,2412,-85,-91,6,40:e3:d6:de:1e:62,128775448,176,426,128775272,128775448
18482,6,12,1,2412,-86,-91,5,40:e3:d6:de:1e:63,128775676,180,48,128775496,128775676
18483,6,12,1,2412,-85,-91,6,40:e3:d6:de:1e:64,128775908,172,60,128775736,128775908
18484,6,12,1,2412,-85,-91,6,40:e3:d6:de:1e:65,128776125,156,61,128775969,128776125
18485,6,6,1,2412,-85,-91,6,40:e3:d6:de:1e:66,128776339,380,-166,128775959,128776339
18486,4,1,1,2412,-80,-91,11,b8:3a:5a:88:e6:e0,128787521,2360,8822,128785161,128787521
18487,6,12,1,2412,-67,-91,24,40:e3:d6:da:ba:20,128803791,160,16110,128803631,128803791
18488,6,6,1,2412,-67,-91,24,40:e3:d6:da:ba:21,128804001,368,-158,128803633,128804001
18489,6,12,1,2412,-67,-91,24,40:e3:d6:da:ba:22,128804406,180,225,128804226,128804406
18490,6,12,1,2412,-67,-91,24,40:e3:d6:da:ba:23,128804612,184,22,128804428,128804612
18491,6,6,1,2412,-67,-91,24,40:e3:d6:da:ba:26,128805224,380,232,128804844,128805224
18492,6,6,1,2412,-71,-91,20,e6:aa:ea:c9:ea:33,128840959,408,35327,128840551,128840959
18493,6,6,1,2412,-71,-91,20,e6:aa:ea:c9:ea:33,128852886,408,11519,128852478,128852886
18494,4,1,1,2412,-81,-91,10,54:e4:3a:ec:fb:64,128861368,2160,6322,128859208,128861368
18495,6,6,1,2412,-72,-91,19,e6:aa:ea:c9:ea:33,128877132,408,15356,128876724,128877132
18496,6,12,1,2412,-85,-91,6,40:e3:d6:de:1e:62,128877857,176,549,128877681,128877857
18497,6,12,1,2412,-83,-91,8,40:e3:d6:de:1e:63,128878086,180,49,128877906,128878086
18498,6,12,1,2412,-85,-91,6,40:e3:d6:de:1e:64,128878309,172,51,128878137,128878309
18499,6,12,1,2412,-84,-91,7,40:e3:d6:de:1e:65,128878525,156,60,128878369,128878525
18500,6,6,1,2412,-85,-91,6,40:e3:d6:de:1e:66,128878731,380,-174,128878351,128878731
18501,6,6,1,2412,-72,-91,19,e6:aa:ea:c9:ea:33,128889250,408,10111,128888842,128889250
18502,4,1,1,2412,-80,-91,11,b8:3a:5a:88:e6:e0,128889909,2360,-1701,128887549,128889909
18503,4,1,1,2412,-79,-91,12,b8:3a:5a:88:e6:e1,128892306,2376,21,128889930,128892306
18504,6,12,1,2412,-67,-91,24,40:e3:d6:da:ba:20,128906191,160,13725,128906031,128906191
18505,6,6,1,2412,-67,-91,24,40:e3:d6:da:ba:21,128906410,368,-149,128906042,128906410
18506,6,12,1,2412,-67,-91,24,40:e3:d6:da:ba:22,128906815,180,225,128906635,128906815
18507,6,12,1,2412,-67,-91,24,40:e3:d6:da:ba:23,128907021,184,22,128906837,128907021
18508,6,12,1,2412,-67,-91,24,40:e3:d6:da:ba:24,128907239,176,42,128907063,128907239
18509,6,12,1,2412,-67,-91,24,40:e3:d6:da:ba:25,128907467,160,68,128907307,128907467
18510,6,6,1,2412,-66,-91,25,40:e3:d6:da:ba:26,128907686,380,-161,128907306,128907686
18511,4,1,1,2412,-82,-91,9,54:e4:3a:ec:fb:64,128963767,2160,53921,128961607,128963767
18512,6,12,1,2412,-85,-91,6,40:e3:d6:de:1e:60,128979645,156,15722,128979489,128979645
18513,6,6,1,2412,-86,-91,5,40:e3:d6:de:1e:61,128979851,368,-162,128979483,128979851
18514,6,12,1,2412,-84,-91,7,40:e3:d6:de:1e:64,128980690,172,667,128980518,128980690
18515,6,12,1,2412,-84,-91,7,40:e3:d6:de:1e:65,128980887,156,41,128980731,128980887
18516,4,1,1,2412,-83,-91,8,b8:3a:5a:88:e6:e0,128992303,2360,9056,128989943,128992303
18517,6,12,1,2412,-66,-91,25,40:e3:d6:da:ba:20,129008590,160,16127,129008430,129008590
18518,6,6,1,2412,-65,-91,26,40:e3:d6:da:ba:21,129008790,368,-168,129008422,129008790
18519,6,12,1,2412,-66,-91,25,40:e3:d6:da:ba:22,129009205,180,235,129009025,129009205
18520,6,12,1,2412,-65,-91,26,40:e3:d6:da:ba:23,129009410,184,21,129009226,129009410
18521,6,12,1,2412,-65,-91,26,40:e3:d6:da:ba:24,129009620,176,34,129009444,129009620
18522,6,12,1,2412,-66,-91,25,40:e3:d6:da:ba:25,129009830,160,50,129009670,129009830
18523,6,6,1,2412,-65,-91,26,40:e3:d6:da:ba:26,129010031,380,-179,129009651,129010031
18524,6,6,1,2412,-80,-91,11,e6:aa:ea:b7:4a:dd,129049701,408,39262,129049293,129049701
18525,4,1,1,2412,-82,-91,9,54:e4:3a:ec:fb:64,129066167,2160,14306,129064007,129066167
18526,6,6,1,2412,-81,-91,10,e6:aa:ea:b7:4a:dd,129073933,408,7358,129073525,129073933
18527,6,12,1,2412,-84,-91,7,40:e3:d6:de:1e:60,129082029,156,7940,129081873,129082029
18528,6,6,1,2412,-84,-91,7,40:e3:d6:de:1e:61,129082244,368,-153,129081876,129082244
18529,6,12,1,2412,-85,-91,6,40:e3:d6:de:1e:62,129082650,176,230,129082474,129082650
18530,6,12,1,2412,-81,-91,10,40:e3:d6:de:1e:63,129082877,180,47,129082697,129082877
18531,6,12,1,2412,-83,-91,8,40:e3:d6:de:1e:64,129083092,172,43,129082920,129083092
18532,6,12,1,2412,-83,-91,8,40:e3:d6:de:1e:65,129083289,156,41,129083133,129083289
18533,6,6,1,2412,-83,-91,8,40:e3:d6:de:1e:66,129083495,380,-174,129083115,129083495
18534,6,6,1,2412,-81,-91,10,e6:aa:ea:b7:4a:dd,129086053,408,2150,129085645,129086053
18535,4,1,1,2412,-83,-91,8,b8:3a:5a:88:e6:e0,129094702,2360,6289,129092342,129094702
18536,6,12,1,2412,-65,-91,26,40:e3:d6:da:ba:20,129110997,160,16135,129110837,129110997
18537,6,6,1,2412,-65,-91,26,40:e3:d6:da:ba:21,129111207,368,-158,129110839,129111207
18538,6,12,1,2412,-65,-91,26,40:e3:d6:da:ba:22,129111612,180,225,129111432,129111612
18539,6,12,1,2412,-65,-91,26,40:e3:d6:da:ba:23,129111836,184,40,129111652,129111836
18540,6,12,1,2412,-65,-91,26,40:e3:d6:da:ba:24,129112045,176,33,129111869,129112045
18541,6,12,1,2412,-56,-91,35,40:e3:d6:da:ba:25,129112256,160,51,129112096,129112256
18542,6,6,1,2412,-66,-91,25,40:e3:d6:da:ba:26,129112448,380,-188,129112068,129112448
18543,6,12,1,2412,-86,-91,5,40:e3:d6:de:1e:60,129120130,136,7546,129119994,129120130
18544,6,6,1,2412,-85,-91,6,40:e3:d6:de:1e:61,129120325,348,-153,129119977,129120325
18545,6,12,1,2412,-84,-91,7,40:e3:d6:de:1e:62,129120700,156,219,129120544,129120700
18546,6,12,1,2412,-85,-91,6,40:e3:d6:de:1e:63,129120918,156,62,129120762,129120918
18547,6,12,1,2412,-85,-91,6,40:e3:d6:de:1e:60,129131297,136,10243,129131161,129131297
18548,6,6,1,2412,-86,-91,5,40:e3:d6:de:1e:61,129131474,348,-171,129131126,129131474
18549,6,12,1,2412,-85,-91,6,40:e3:d6:de:1e:62,129131850,156,220,129131694,129131850
18550,6,12,1,2412,-85,-91,6,40:e3:d6:de:1e:63,129132058,156,52,129131902,129132058
18551,6,12,1,2412,-85,-91,6,40:e3:d6:de:1e:65,129132248,136,54,129132112,129132248
18552,4,5.5,1,2412,-85,-91,6,04:e8:b9:9d:cf:6f,129152416,395,19773,129152021,129152416
18553,6,12,1,2412,-85,-91,6,40:e3:d6:de:1e:60,129152771,136,219,129152635,129152771
18554,6,6,1,2412,-85,-91,6,40:e3:d6:de:1e:61,129152948,348,-171,129152600,129152948
18555,6,12,1,2412,-85,-91,6,40:e3:d6:de:1e:62,129153351,156,247,129153195,129153351
18556,6,12,1,2412,-83,-91,8,,129153538,32,155,129153506,129153538
18557,4,1,1,2412,-78,-91,13,b8:3a:5a:88:e6:e0,129153778,2240,-2000,129151538,129153778
18558,6,12,1,2412,-82,-91,9,,129156289,32,2479,129156257,129156289
18559,6,12,1,2412,-82,-91,9,,129156517,32,196,129156485,129156517
18560,4,1,1,2412,-85,-91,6,b8:3a:5a:88:e6:e1,129157239,2256,-1534,129154983,129157239
18561,4,1,1,2412,-87,-91,4,,129159506,304,1963,129159202,129159506
18562,4,1,1,2412,-82,-91,9,54:e4:3a:ec:fb:64,129168566,2160,6900,129166406,129168566
18563,6,6,1,2412,-86,-91,5,40:e3:d6:de:1e:61,129184630,368,15696,129184262,129184630
18564,6,12,1,2412,-84,-91,7,40:e3:d6:de:1e:62,129185036,176,230,129184860,129185036
18565,4,1,1,2412,-84,-91,7,b8:3a:5a:88:e6:e0,129197195,2360,9799,129194835,129197195
18566,6,12,1,2412,-66,-91,25,40:e3:d6:da:ba:20,129213385,160,16030,129213225,129213385
18567,6,6,1,2412,-65,-91,26,40:e3:d6:da:ba:21,129213577,368,-176,129213209,129213577
18568,6,12,1,2412,-65,-91,26,40:e3:d6:da:ba:22,129213973,180,216,129213793,129213973
18569,6,12,1,2412,-65,-91,26,40:e3:d6:da:ba:23,129214196,184,39,129214012,129214196
18570,6,12,1,2412,-66,-91,25,40:e3:d6:da:ba:24,129214433,176,61,129214257,129214433
18571,6,12,1,2412,-65,-91,26,40:e3:d6:da:ba:25,129214643,160,50,129214483,129214643
18572,6,6,1,2412,-65,-91,26,40:e3:d6:da:ba:26,129214862,380,-161,129214482,129214862
18573,6,12,1,2412,-82,-91,9,,129216242,32,1348,129216210,129216242
18574,4,1,1,2412,-86,-91,5,,129218732,304,2186,129218428,129218732
18575,6,6,1,2412,-71,-91,20,e6:aa:ea:c9:ea:33,129258571,408,39431,129258163,129258571
18576,6,6,1,2412,-71,-91,20,e6:aa:ea:c9:ea:33,129270693,408,11714,129270285,129270693
18577,4,1,1,2412,-82,-91,9,54:e4:3a:ec:fb:64,129271291,2160,-1562,129269131,129271291
18578,6,12,1,2412,-85,-91,6,40:e3:d6:de:1e:60,129286845,156,15398,129286689,129286845
18579,6,12,1,2412,-85,-91,6,40:e3:d6:de:1e:62,129287447,176,426,129287271,129287447
18580,6,12,1,2412,-86,-91,5,40:e3:d6:de:1e:63,129287657,180,30,129287477,129287657
18581,6,12,1,2412,-84,-91,7,40:e3:d6:de:1e:64,129287872,172,43,129287700,129287872
18582,6,12,1,2412,-85,-91,6,40:e3:d6:de:1e:65,129288069,156,41,129287913,129288069
18583,6,6,1,2412,-85,-91,6,40:e3:d6:de:1e:66,129288258,380,-191,129287878,129288258
18584,4,1,1,2412,-86,-91,5,b8:3a:5a:88:e6:e0,129299503,2360,8885,129297143,129299503
18585,4,1,1,2412,-86,-91,5,b8:3a:5a:88:e6:e1,129301900,2376,21,129299524,129301900
18586,6,12,1,2412,-67,-91,24,40:e3:d6:da:ba:20,129315786,160,13726,129315626,129315786
18587,6,6,1,2412,-66,-91,25,40:e3:d6:da:ba:21,129316021,368,-133,129315653,129316021
18588,6,12,1,2412,-66,-91,25,40:e3:d6:da:ba:22,129316435,180,234,129316255,129316435
18589,6,12,1,2412,-66,-91,25,40:e3:d6:da:ba:23,129316649,184,30,129316465,129316649
18590,6,12,1,2412,-66,-91,25,40:e3:d6:da:ba:24,129316859,176,34,129316683,129316859
18591,6,12,1,2412,-66,-91,25,40:e3:d6:da:ba:25,129317087,160,68,129316927,129317087
18592,6,6,1,2412,-66,-91,25,40:e3:d6:da:ba:26,129317279,380,-188,129316899,129317279
18593,6,12,1,2412,-86,-91,5,40:e3:d6:de:1e:60,129389248,156,71813,129389092,129389248
18594,6,6,1,2412,-87,-91,4,40:e3:d6:de:1e:61,129389436,368,-180,129389068,129389436
18595,6,12,1,2412,-86,-91,5,40:e3:d6:de:1e:62,129389841,176,229,129389665,129389841
18596,6,12,1,2412,-85,-91,6,40:e3:d6:de:1e:65,129390508,156,511,129390352,129390508
18597,6,6,1,2412,-85,-91,6,40:e3:d6:de:1e:66,129390697,380,-191,129390317,129390697
18598,4,1,1,2412,-86,-91,5,b8:3a:5a:88:e6:e1,129404333,2376,11260,129401957,129404333
18599,6,12,1,2412,-68,-91,23,40:e3:d6:da:ba:20,129418194,160,13701,129418034,129418194
18600,6,6,1,2412,-68,-91,23,40:e3:d6:da:ba:21,129418386,368,-176,129418018,129418386
18601,6,12,1,2412,-67,-91,24,40:e3:d6:da:ba:22,129418782,180,216,129418602,129418782
18602,6,12,1,2412,-68,-91,23,40:e3:d6:da:ba:23,129419015,184,49,129418831,129419015
18603,6,12,1,2412,-67,-91,24,40:e3:d6:da:ba:25,129419444,160,269,129419284,129419444
18604,6,6,1,2412,-67,-91,24,40:e3:d6:da:ba:26,129419636,380,-188,129419256,129419636
18605,4,1,1,2412,-86,-91,5,b8:3a:5a:88:e6:e0,129447051,2240,25175,129444811,129447051
18606,4,1,1,2412,-92,-91,-1,,129459759,304,12404,129459455,129459759
18607,6,6,1,2412,-81,-91,10,e6:aa:ea:b7:4a:dd,129467926,408,7759,129467518,129467926
18608,4,1,1,2412,-86,-91,5,54:e4:3a:ec:fb:64,129473551,2112,3513,129471439,129473551
18609,6,12,1,2412,-88,-91,3,40:e3:d6:de:1e:60,129491641,156,17934,129491485,129491641
18610,6,6,1,2412,-86,-91,5,40:e3:d6:de:1e:61,129491838,368,-171,129491470,129491838
18611,4,1,1,2412,-84,-91,7,b8:3a:5a:88:e6:e0,129501428,2240,7350,129499188,129501428
18612,6,6,1,2412,-80,-91,11,e6:aa:ea:b7:4a:dd,129504077,408,2241,129503669,129504077
18613,4,1,1,2412,-84,-91,7,b8:3a:5a:88:e6:e0,129504872,2360,-1565,129502512,129504872
18614,4,1,1,2412,-84,-91,7,b8:3a:5a:88:e6:e1,129507270,2376,22,129504894,129507270
18615,4,1,1,2412,-84,-91,7,b8:3a:5a:88:e6:e1,129509683,2256,157,129507427,129509683
18616,6,12,1,2412,-67,-91,24,40:e3:d6:da:ba:20,129520609,160,10766,129520449,129520609
18617,6,6,1,2412,-67,-91,24,40:e3:d6:da:ba:21,129520819,368,-158,129520451,129520819
18618,6,12,1,2412,-67,-91,24,40:e3:d6:da:ba:22,129521224,180,225,129521044,129521224
18619,6,12,1,2412,-67,-91,24,40:e3:d6:da:ba:25,129521921,160,537,129521761,129521921
18620,6,6,1,2412,-67,-91,24,40:e3:d6:da:ba:26,129522122,380,-179,129521742,129522122
18621,6,6,1,2412,-84,-91,7,84:1b:5e:df:1b:99,129535571,80,13369,129535491,129535571
18622,6,6,1,2412,-70,-91,21,e6:aa:ea:c9:ea:33,129573789,408,37810,129573381,129573789
18623,6,6,1,2412,-70,-91,21,e6:aa:ea:c9:ea:33,129585905,408,11708,129585497,129585905
18624,6,12,1,2412,-87,-91,4,40:e3:d6:de:1e:60,129594058,156,7997,129593902,129594058
18625,6,6,1,2412,-88,-91,3,40:e3:d6:de:1e:61,129594264,368,-162,129593896,129594264
18626,6,6,1,2412,-87,-91,4,40:e3:d6:de:1e:66,129595524,380,880,129595144,129595524
18627,4,1,1,2412,-82,-91,9,b8:3a:5a:88:e6:e0,129606794,2360,8910,129604434,129606794
18628,6,6,1,2412,-70,-91,21,e6:aa:ea:c9:ea:33,129611735,408,4533,129611327,129611735
18629,4,1,1,2412,-82,-91,9,b8:3a:5a:88:e6:e1,129616717,2256,2726,129614461,129616717
18630,6,6,1,2412,-70,-91,21,e6:aa:ea:c9:ea:33,129622257,408,5132,129621849,129622257
18631,6,12,1,2412,-66,-91,25,40:e3:d6:da:ba:20,129623812,160,1395,129623652,129623812
18632,6,6,1,2412,-66,-91,25,40:e3:d6:da:ba:21,129624004,368,-176,129623636,129624004
18633,6,12,1,2412,-66,-91,25,40:e3:d6:da:ba:22,129624400,180,216,129624220,129624400
18634,6,12,1,2412,-66,-91,25,40:e3:d6:da:ba:23,129624605,184,21,129624421,129624605
18635,6,12,1,2412,-66,-91,25,40:e3:d6:da:ba:24,129624841,176,60,129624665,129624841
18636,6,12,1,2412,-65,-91,26,40:e3:d6:da:ba:25,129625069,160,68,129624909,129625069
18637,6,6,1,2412,-66,-91,25,40:e3:d6:da:ba:26,129625280,380,-169,129624900,129625280
18638,6,6,1,2412,-86,-91,5,40:e3:d6:de:1e:61,129633315,348,7687,129632967,129633315
18639,6,12,1,2412,-86,-91,5,40:e3:d6:de:1e:60,129696456,156,62985,129696300,129696456
18640,6,6,1,2412,-86,-91,5,40:e3:d6:de:1e:61,129696661,368,-163,129696293,129696661
18641,6,12,1,2412,-86,-91,5,40:e3:d6:de:1e:62,129697058,176,221,129696882,129697058
18642,6,12,1,2412,-84,-91,7,40:e3:d6:de:1e:65,129697725,156,511,129697569,129697725
18643,6,6,1,2412,-85,-91,6,40:e3:d6:de:1e:66,129697939,380,-166,129697559,129697939
18644,6,12,1,2412,-86,-91,5,40:e3:d6:de:1e:60,129705109,136,7034,129704973,129705109
18645,6,6,1,2412,-86,-91,5,40:e3:d6:de:1e:61,129705286,348,-171,129704938,129705286
18646,6,12,1,2412,-86,-91,5,40:e3:d6:de:1e:62,129705662,156,220,129705506,129705662
18647,6,12,1,2412,-86,-91,5,40:e3:d6:de:1e:63,129705880,156,62,129705724,129705880
18648,4,1,1,2412,-83,-91,8,b8:3a:5a:88:e6:e1,129713249,2376,4993,129710873,129713249
18649,6,12,1,2412,-66,-91,25,40:e3:d6:da:ba:20,129725391,160,11982,129725231,129725391
18650,6,6,1,2412,-65,-91,26,40:e3:d6:da:ba:21,129725601,368,-158,129725233,129725601
18651,6,12,1,2412,-65,-91,26,40:e3:d6:da:ba:22,129725997,180,216,129725817,129725997
18652,6,12,1,2412,-65,-91,26,40:e3:d6:da:ba:23,129726221,184,40,129726037,129726221
18653,6,12,1,2412,-66,-91,25,40:e3:d6:da:ba:24,129726439,176,42,129726263,129726439
18654,6,12,1,2412,-66,-91,25,40:e3:d6:da:ba:25,129726650,160,51,129726490,129726650
18655,6,6,1,2412,-65,-91,26,40:e3:d6:da:ba:26,129726841,380,-189,129726461,129726841
18656,4,1,1,2412,-86,-91,5,54:e4:3a:ec:fb:64,129782961,2160,53960,129780801,129782961
18657,4,1,1,2412,-91,-91,0,32:42:5e:8e:95:4c,129789556,1128,5467,129788428,129789556
18658,4,1,1,2412,-77,-91,14,b8:3a:5a:88:e6:e0,129791038,2240,-758,129788798,129791038
18659,6,12,1,2412,-85,-91,6,40:e3:d6:de:1e:60,129798844,156,7650,129798688,129798844
18660,6,6,1,2412,-85,-91,6,40:e3:d6:de:1e:61,129799050,368,-162,129798682,129799050
18661,6,12,1,2412,-85,-91,6,40:e3:d6:de:1e:62,129799446,176,220,129799270,129799446
18662,6,12,1,2412,-86,-91,5,40:e3:d6:de:1e:63,129799666,180,40,129799486,129799666
18663,6,12,1,2412,-85,-91,6,40:e3:d6:de:1e:64,129799880,172,42,129799708,129799880
18664,6,12,1,2412,-84,-91,7,40:e3:d6:de:1e:65,129800078,156,42,129799922,129800078
18665,6,6,1,2412,-85,-91,6,40:e3:d6:de:1e:66,129800266,380,-192,129799886,129800266
18666,4,1,1,2412,-78,-91,13,b8:3a:5a:88:e6:e0,129811525,2360,8899,129809165,129811525
18667,4,1,1,2412,-77,-91,14,b8:3a:5a:88:e6:e1,129813914,2376,13,129811538,129813914
18668,6,12,1,2412,-65,-91,26,40:e3:d6:da:ba:20,129827797,160,13723,129827637,129827797
18669,6,6,1,2412,-65,-91,26,40:e3:d6:da:ba:21,129828023,368,-142,129827655,129828023
18670,6,12,1,2412,-65,-91,26,40:e3:d6:da:ba:22,129828419,180,216,129828239,129828419
18671,6,12,1,2412,-65,-91,26,40:e3:d6:da:ba:23,129828659,184,56,129828475,129828659
18672,6,12,1,2412,-65,-91,26,40:e3:d6:da:ba:24,129828877,176,42,129828701,129828877
18673,6,12,1,2412,-65,-91,26,40:e3:d6:da:ba:25,129829088,160,51,129828928,129829088
18674,6,6,1,2412,-79,-91,12,e6:aa:ea:b7:4a:dd,129898007,408,68511,129897599,129898007
18675,6,12,1,2412,-86,-91,5,40:e3:d6:de:1e:60,129901247,156,3084,129901091,129901247
18676,6,6,1,2412,-87,-91,4,40:e3:d6:de:1e:61,129901453,368,-162,129901085,129901453
18677,6,12,1,2412,-85,-91,6,40:e3:d6:de:1e:65,129902490,156,881,129902334,129902490
18678,6,6,1,2412,-86,-91,5,40:e3:d6:de:1e:66,129902677,380,-193,129902297,129902677
18679,6,6,1,2412,-79,-91,12,e6:aa:ea:b7:4a:dd,129922243,408,19158,129921835,129922243
18680,6,12,1,2412,-64,-91,27,40:e3:d6:da:ba:20,129930189,160,7786,129930029,129930189
18681,6,6,1,2412,-63,-91,28,40:e3:d6:da:ba:21,129930408,368,-149,129930040,129930408
18682,6,12,1,2412,-64,-91,27,40:e3:d6:da:ba:22,129930813,180,225,129930633,129930813
18683,6,12,1,2412,-63,-91,28,40:e3:d6:da:ba:23,129931037,184,40,129930853,129931037
18684,6,12,1,2412,-63,-91,28,40:e3:d6:da:ba:24,129931289,176,76,129931113,129931289
18685,6,12,1,2412,-63,-91,28,40:e3:d6:da:ba:25,129931524,160,75,129931364,129931524
18686,6,6,1,2412,-64,-91,27,40:e3:d6:da:ba:26,129931743,380,-161,129931363,129931743
18687,6,6,1,2412,-79,-91,12,e6:aa:ea:b7:4a:dd,129934356,408,2205,129933948,129934356
18688,4,1,1,2412,-79,-91,12,54:e4:3a:ec:fb:64,129987758,2160,51242,129985598,129987758
18689,4,1,1,2412,-77,-91,14,b8:3a:5a:88:e6:e0,130016326,2360,26208,130013966,130016326
18690,4,1,1,2412,-78,-91,13,b8:3a:5a:88:e6:e1,130018724,2376,22,130016348,130018724
18691,6,12,1,2412,-64,-91,27,40:e3:d6:da:ba:20,130032592,160,13708,130032432,130032592
18692,6,6,1,2412,-64,-91,27,40:e3:d6:da:ba:21,130032802,368,-158,130032434,130032802
18693,6,12,1,2412,-64,-91,27,40:e3:d6:da:ba:22,130033189,180,207,130033009,130033189
18694,6,12,1,2412,-63,-91,28,40:e3:d6:da:ba:23,130033395,184,22,130033211,130033395
18695,6,12,1,2412,-63,-91,28,40:e3:d6:da:ba:24,130033604,176,33,130033428,130033604
18696,6,12,1,2412,-63,-91,28,40:e3:d6:da:ba:25,130033833,160,69,130033673,130033833
18697,6,6,1,2412,-64,-91,27,40:e3:d6:da:ba:26,130034052,380,-161,130033672,130034052
18698,6,6,1,2412,-70,-91,21,e6:aa:ea:c9:ea:33,130094897,408,60437,130094489,130094897
18699,6,12,1,2412,-86,-91,5,40:e3:d6:de:1e:60,130106051,156,10998,130105895,130106051
18700,6,6,1,2412,-88,-91,3,40:e3:d6:de:1e:61,130106239,368,-180,130105871,130106239
18701,6,6,1,2412,-70,-91,21,e6:aa:ea:c9:ea:33,130107019,408,372,130106611,130107019
18702,6,12,1,2412,-63,-91,28,40:e3:d6:da:ba:20,130134986,160,27807,130134826,130134986
18703,6,6,1,2412,-63,-91,28,40:e3:d6:da:ba:21,130135205,368,-149,130134837,130135205
18704,6,12,1,2412,-63,-91,28,40:e3:d6:da:ba:22,130135610,180,225,130135430,130135610
18705,6,12,1,2412,-63,-91,28,40:e3:d6:da:ba:23,130135834,184,40,130135650,130135834
18706,6,12,1,2412,-63,-91,28,40:e3:d6:da:ba:24,130136061,176,51,130135885,130136061
18707,6,12,1,2412,-63,-91,28,40:e3:d6:da:ba:25,130136281,160,60,130136121,130136281
18708,6,6,1,2412,-63,-91,28,40:e3:d6:da:ba:26,130136490,380,-171,130136110,130136490
18709,6,12,1,2412,-88,-91,3,40:e3:d6:de:1e:60,130208452,156,71806,130208296,130208452
18710,6,6,1,2412,-87,-91,4,40:e3:d6:de:1e:61,130208667,368,-153,130208299,130208667
18711,6,12,1,2412,-86,-91,5,40:e3:d6:de:1e:62,130209072,176,229,130208896,130209072
18712,6,12,1,2412,-86,-91,5,40:e3:d6:de:1e:63,130209300,180,48,130209120,130209300
18713,6,12,1,2412,-87,-91,4,40:e3:d6:de:1e:64,130209506,172,34,130209334,130209506
18714,6,12,1,2412,-86,-91,5,40:e3:d6:de:1e:65,130209721,156,59,130209565,130209721
18715,6,6,1,2412,-85,-91,6,40:e3:d6:de:1e:66,130209909,380,-192,130209529,130209909
18716,4,1,1,2412,-79,-91,12,b8:3a:5a:88:e6:e1,130223506,2376,11221,130221130,130223506
18717,6,12,1,2412,-63,-91,28,40:e3:d6:da:ba:20,130237387,160,13721,130237227,130237387
18718,6,6,1,2412,-63,-91,28,40:e3:d6:da:ba:21,130237606,368,-149,130237238,130237606
18719,6,12,1,2412,-63,-91,28,40:e3:d6:da:ba:22,130238002,180,216,130237822,130238002
18720,6,12,1,2412,-63,-91,28,40:e3:d6:da:ba:23,130238235,184,49,130238051,130238235
18721,6,12,1,2412,-63,-91,28,40:e3:d6:da:ba:24,130238453,176,42,130238277,130238453
18722,6,12,1,2412,-63,-91,28,40:e3:d6:da:ba:25,130238673,160,60,130238513,130238673
18723,6,6,1,2412,-63,-91,28,40:e3:d6:da:ba:26,130238883,380,-170,130238503,130238883
18724,6,12,1,2412,-84,-91,7,40:e3:d6:de:1e:64,130311986,172,72931,130311814,130311986
18725,6,6,1,2412,-85,-91,6,40:e3:d6:de:1e:66,130312390,380,24,130312010,130312390
18726,4,1,1,2412,-79,-91,12,b8:3a:5a:88:e6:e0,130323522,2360,8772,130321162,130323522
18727,4,1,1,2412,-79,-91,12,b8:3a:5a:88:e6:e1,130325911,2376,13,130323535,130325911
18728,6,12,1,2412,-64,-91,27,40:e3:d6:da:ba:20,130339799,160,13728,130339639,130339799
18729,6,6,1,2412,-64,-91,27,40:e3:d6:da:ba:21,130340009,368,-158,130339641,130340009
18730,6,12,1,2412,-64,-91,27,40:e3:d6:da:ba:22,130340414,180,225,130340234,130340414
18731,6,12,1,2412,-63,-91,28,40:e3:d6:da:ba:23,130340629,184,31,130340445,130340629
18732,6,12,1,2412,-64,-91,27,40:e3:d6:da:ba:24,130340865,176,60,130340689,130340865
18733,6,12,1,2412,-64,-91,27,40:e3:d6:da:ba:25,130341076,160,51,130340916,130341076
18734,6,6,1,2412,-64,-91,27,40:e3:d6:da:ba:26,130341286,380,-170,130340906,130341286
18735,4,1,1,2412,-84,-91,7,a6:e5:7c:28:b1:d3,130385677,992,43399,130384685,130385677
18736,4,1,1,2412,-86,-91,5,54:e4:3a:ec:fb:64,130397356,2160,9519,130395196,130397356
18737,6,6,1,2412,-88,-91,3,e6:aa:ea:b7:4a:dd,130405393,408,7629,130404985,130405393
18738,6,12,1,2412,-86,-91,5,40:e3:d6:de:1e:60,130413260,156,7711,130413104,130413260
18739,6,6,1,2412,-84,-91,7,40:e3:d6:de:1e:61,130413475,368,-153,130413107,130413475
18740,6,12,1,2412,-84,-91,7,40:e3:d6:de:1e:62,130413862,176,211,130413686,130413862
18741,6,12,1,2412,-85,-91,6,40:e3:d6:de:1e:63,130414072,180,30,130413892,130414072
18742,6,12,1,2412,-84,-91,7,40:e3:d6:de:1e:64,130414305,172,61,130414133,130414305
18743,6,12,1,2412,-84,-91,7,40:e3:d6:de:1e:65,130414521,156,60,130414365,130414521
18744,6,6,1,2412,-85,-91,6,40:e3:d6:de:1e:66,130414727,380,-174,130414347,130414727
18745,6,6,1,2412,-87,-91,4,e6:aa:ea:b7:4a:dd,130417519,408,2384,130417111,130417519
18746,4,1,1,2412,-78,-91,13,b8:3a:5a:88:e6:e0,130426004,2360,6125,130423644,130426004
18747,6,6,1,2412,-80,-91,11,e6:aa:ea:b7:4a:dd,130429630,408,3218,130429222,130429630
18748,6,12,1,2412,-64,-91,27,40:e3:d6:da:ba:20,130442189,160,12399,130442029,130442189
18749,6,6,1,2412,-64,-91,27,40:e3:d6:da:ba:21,130442381,368,-176,130442013,130442381
18750,6,12,1,2412,-64,-91,27,40:e3:d6:da:ba:22,130442795,180,234,130442615,130442795
18751,6,12,1,2412,-64,-91,27,40:e3:d6:da:ba:23,130443009,184,30,130442825,130443009
18752,6,12,1,2412,-64,-91,27,40:e3:d6:da:ba:24,130443219,176,34,130443043,130443219
18753,6,12,1,2412,-64,-91,27,40:e3:d6:da:ba:25,130443447,160,68,130443287,130443447
18754,4,1,1,2412,-94,-91,-3,c0:c9:e3:4d:6e:bf,130462626,872,18307,130461754,130462626
18755,4,1,1,2412,-92,-91,-1,,130463514,304,584,130463210,130463514
18756,4,1,1,2412,-89,-91,2,a6:e5:7c:28:b1:d3,130487849,992,23343,130486857,130487849
18757,4,1,1,2412,-86,-91,5,54:e4:3a:ec:fb:64,130499754,2160,9745,130497594,130499754
18758,4,1,1,2412,-70,-91,21,a4:e5:7c:28:b1:d3,130504480,688,4038,130503792,130504480
18759,4,1,1,2412,-81,-91,10,,130506123,304,1339,130505819,130506123
18760,6,6,1,2412,-71,-91,20,e6:aa:ea:c9:ea:33,130511999,408,5468,130511591,130511999
18761,6,6,1,2412,-71,-91,20,e6:aa:ea:c9:ea:33,130524112,408,11705,130523704,130524112
18762,4,1,1,2412,-76,-91,15,b8:3a:5a:88:e6:e0,130528305,2360,1833,130525945,130528305
18763,4,1,1,2412,-76,-91,15,b8:3a:5a:88:e6:e1,130530712,2376,31,130528336,130530712
18764,6,6,1,2412,-71,-91,20,e6:aa:ea:c9:ea:33,130536356,408,5236,130535948,130536356
18765,6,6,1,2412,-63,-91,28,40:e3:d6:da:ba:21,130545631,368,8907,130545263,130545631
18766,6,12,1,2412,-63,-91,28,40:e3:d6:da:ba:22,130546036,180,225,130545856,130546036
18767,6,12,1,2412,-63,-91,28,40:e3:d6:da:ba:23,130546268,184,48,130546084,130546268
18768,6,12,1,2412,-63,-91,28,40:e3:d6:da:ba:24,130546487,176,43,130546311,130546487
18769,6,12,1,2412,-63,-91,28,40:e3:d6:da:ba:25,130546706,160,59,130546546,130546706
18770,6,6,1,2412,-63,-91,28,40:e3:d6:da:ba:26,130546898,380,-188,130546518,130546898
18771,6,6,1,2412,-71,-91,20,e6:aa:ea:c9:ea:33,130548522,408,1216,130548114,130548522
18772,4,1,1,2412,-86,-91,5,54:e4:3a:ec:fb:64,130603353,2160,52671,130601193,130603353
18773,6,12,1,2412,-86,-91,5,40:e3:d6:de:1e:60,130618039,156,14530,130617883,130618039
18774,6,6,1,2412,-87,-91,4,40:e3:d6:de:1e:61,130618254,368,-153,130617886,130618254
18775,6,12,1,2412,-85,-91,6,40:e3:d6:de:1e:63,130618888,180,454,130618708,130618888
18776,6,12,1,2412,-85,-91,6,40:e3:d6:de:1e:65,130619327,156,283,130619171,130619327
18777,6,6,1,2412,-87,-91,4,40:e3:d6:de:1e:66,130619515,380,-192,130619135,130619515
18778,4,1,1,2412,-78,-91,13,b8:3a:5a:88:e6:e0,130630705,2360,8830,130628345,130630705
18779,4,1,1,2412,-77,-91,14,b8:3a:5a:88:e6:e1,130633442,2376,361,130631066,130633442
18780,6,12,1,2412,-63,-91,28,40:e3:d6:da:ba:20,130647002,160,13400,130646842,130647002
18781,6,6,1,2412,-63,-91,28,40:e3:d6:da:ba:21,130647203,368,-167,130646835,130647203
18782,6,12,1,2412,-63,-91,28,40:e3:d6:da:ba:22,130647608,180,225,130647428,130647608
18783,6,12,1,2412,-63,-91,28,40:e3:d6:da:ba:23,130647822,184,30,130647638,130647822
18784,6,6,1,2412,-62,-91,29,40:e3:d6:da:ba:26,130648452,380,250,130648072,130648452
18785,6,12,1,2412,-85,-91,6,40:e3:d6:de:1e:60,130720442,156,71834,130720286,130720442
18786,6,6,1,2412,-85,-91,6,40:e3:d6:de:1e:61,130720648,368,-162,130720280,130720648
18787,6,12,1,2412,-84,-91,7,40:e3:d6:de:1e:62,130721062,176,238,130720886,130721062
18788,6,12,1,2412,-82,-91,9,40:e3:d6:de:1e:63,130721291,180,49,130721111,130721291
18789,6,12,1,2412,-84,-91,7,40:e3:d6:de:1e:64,130721505,172,42,130721333,130721505
18790,6,12,1,2412,-83,-91,8,40:e3:d6:de:1e:65,130721720,156,59,130721564,130721720
18791,6,6,1,2412,-83,-91,8,40:e3:d6:de:1e:66,130721936,380,-164,130721556,130721936
18792,6,12,1,2412,-63,-91,28,40:e3:d6:da:ba:20,130749408,160,27312,130749248,130749408
18793,6,6,1,2412,-63,-91,28,40:e3:d6:da:ba:21,130749600,368,-176,130749232,130749600
18794,6,12,1,2412,-63,-91,28,40:e3:d6:da:ba:22,130750005,180,225,130749825,130750005
18795,6,12,1,2412,-62,-91,29,40:e3:d6:da:ba:23,130750228,184,39,130750044,130750228
18796,6,12,1,2412,-62,-91,29,40:e3:d6:da:ba:24,130750447,176,43,130750271,130750447
18797,6,12,1,2412,-62,-91,29,40:e3:d6:da:ba:25,130750666,160,59,130750506,130750666
18798,6,6,1,2412,-62,-91,29,40:e3:d6:da:ba:26,130750858,380,-188,130750478,130750858
18799,4,1,1,2412,-87,-91,4,54:e4:3a:ec:fb:64,130806952,2160,53934,130804792,130806952
18800,6,12,1,2412,-84,-91,7,40:e3:d6:de:1e:60,130822847,156,15739,130822691,130822847
18801,6,6,1,2412,-83,-91,8,40:e3:d6:de:1e:61,130823053,368,-162,130822685,130823053
18802,6,12,1,2412,-82,-91,9,40:e3:d6:de:1e:62,130823467,176,238,130823291,130823467
18803,6,12,1,2412,-84,-91,7,40:e3:d6:de:1e:63,130823677,180,30,130823497,130823677
18804,6,12,1,2412,-82,-91,9,40:e3:d6:de:1e:64,130823883,172,34,130823711,130823883
18805,6,12,1,2412,-82,-91,9,40:e3:d6:de:1e:65,130824089,156,50,130823933,130824089
18806,6,6,1,2412,-82,-91,9,40:e3:d6:de:1e:66,130824286,380,-183,130823906,130824286
18807,6,12,1,2412,-90,-91,1,40:e3:d6:da:c0:25,130824658,156,216,130824502,130824658
18808,4,1,1,2412,-82,-91,9,b8:3a:5a:88:e6:e0,130835519,2360,8501,130833159,130835519
18809,4,1,1,2412,-82,-91,9,b8:3a:5a:88:e6:e1,130837907,2376,12,130835531,130837907
18810,6,6,1,2412,-69,-91,22,e6:aa:ea:c9:ea:33,130840131,408,1816,130839723,130840131
18811,6,12,1,2412,-63,-91,28,40:e3:d6:da:ba:20,130851814,160,11523,130851654,130851814
18812,6,6,1,2412,-63,-91,28,40:e3:d6:da:ba:21,130852006,368,-176,130851638,130852006
18813,6,12,1,2412,-63,-91,28,40:e3:d6:da:ba:22,130852393,180,207,130852213,130852393
18814,6,12,1,2412,-63,-91,28,40:e3:d6:da:ba:23,130852598,184,21,130852414,130852598
18815,6,12,1,2412,-63,-91,28,40:e3:d6:da:ba:24,130852817,176,43,130852641,130852817
18816,6,6,1,2412,-68,-91,23,40:e3:d6:da:ba:26,130853228,380,31,130852848,130853228
18817,6,6,1,2412,-69,-91,22,e6:aa:ea:c9:ea:33,130864364,408,10728,130863956,130864364
18818,6,6,1,2412,-68,-91,23,e6:aa:ea:c9:ea:33,130876476,408,11704,130876068,130876476
18819,4,1,1,2412,-88,-91,3,54:e4:3a:ec:fb:64,130913733,2160,35097,130911573,130913733
18820,6,6,1,2412,-83,-91,8,e6:aa:ea:b7:4a:dd,130924112,408,9971,130923704,130924112
18821,6,12,1,2412,-85,-91,6,40:e3:d6:de:1e:60,130925247,156,979,130925091,130925247
18822,6,6,1,2412,-85,-91,6,40:e3:d6:de:1e:61,130925444,368,-171,130925076,130925444
18823,6,12,1,2412,-84,-91,7,40:e3:d6:de:1e:62,130925841,176,221,130925665,130925841
18824,6,12,1,2412,-85,-91,6,40:e3:d6:de:1e:63,130926042,180,21,130925862,130926042
18825,6,12,1,2412,-83,-91,8,40:e3:d6:de:1e:64,130926368,172,154,130926196,130926368
18826,6,12,1,2412,-84,-91,7,40:e3:d6:de:1e:65,130926574,156,50,130926418,130926574
18827,6,6,1,2412,-84,-91,7,40:e3:d6:de:1e:66,130926789,380,-165,130926409,130926789
18828,6,6,1,2412,-84,-91,7,e6:aa:ea:b7:4a:dd,130936238,408,9041,130935830,130936238
18829,4,1,1,2412,-80,-91,11,b8:3a:5a:88:e6:e0,130937907,2360,-691,130935547,130937907
18830,4,1,1,2412,-90,-91,1,a6:e5:7c:28:b1:d3,130951561,944,12710,130950617,130951561
18831,6,12,1,2412,-63,-91,28,40:e3:d6:da:ba:20,130954199,160,2478,130954039,130954199
18832,6,6,1,2412,-84,-91,7,e6:aa:ea:b7:4a:dd,130960469,408,5862,130960061,130960469
18833,6,6,1,2412,-85,-91,6,e6:aa:ea:b7:4a:dd,130972577,408,11700,130972169,130972577
18834,4,1,1,2412,-76,-91,15,42:87:f5:1d:04:84,130987912,1128,14207,130986784,130987912
18835,6,12,1,2412,-63,-91,28,40:e3:d6:da:ba:20,130989042,136,994,130988906,130989042
18836,6,6,1,2412,-63,-91,28,40:e3:d6:da:ba:21,130989228,348,-162,130988880,130989228
18837,6,12,1,2412,-63,-91,28,40:e3:d6:da:ba:22,130989631,156,247,130989475,130989631
18838,6,12,1,2412,-78,-91,13,,130989803,32,140,130989771,130989803
18839,6,12,1,2412,-63,-91,28,40:e3:d6:da:ba:23,130989887,156,-72,130989731,130989887
18840,6,12,1,2412,-78,-91,13,,130990059,32,140,130990027,130990059
18841,6,12,1,2412,-63,-91,28,40:e3:d6:da:ba:25,130990139,136,-56,130990003,130990139
18842,6,12,1,2412,-78,-91,13,,130990292,32,121,130990260,130990292
18843,6,6,1,2412,-78,-91,13,,130990762,44,426,130990718,130990762
18844,6,6,1,2412,-81,-91,10,,130991717,44,911,130991673,130991717
18845,6,12,1,2412,-81,-91,10,,130991966,32,217,130991934,130991966
18846,6,12,1,2412,-81,-91,10,,130992384,32,386,130992352,130992384
18847,6,12,1,2412,-81,-91,10,,130992645,32,229,130992613,130992645
18848,6,12,1,2412,-82,-91,9,,130992868,32,191,130992836,130992868
18849,4,1,1,2412,-86,-91,5,54:e4:3a:ec:fb:64,131011750,2160,16722,131009590,131011750
18850,4,1,1,2412,-78,-91,13,b8:3a:5a:88:e6:e0,131041762,2360,27652,131039402,131041762
18851,4,1,1,2412,-76,-91,15,b8:3a:5a:88:e6:e1,131044663,2376,525,131042287,131044663
18852,6,12,1,2412,-63,-91,28,40:e3:d6:da:ba:20,131056933,160,12110,131056773,131056933
18853,6,6,1,2412,-63,-91,28,40:e3:d6:da:ba:21,131057134,368,-167,131056766,131057134
18854,6,12,1,2412,-63,-91,28,40:e3:d6:da:ba:22,131057521,180,207,131057341,131057521
18855,6,12,1,2412,-63,-91,28,40:e3:d6:da:ba:23,131057735,184,30,131057551,131057735
18856,6,12,1,2412,-63,-91,28,40:e3:d6:da:ba:24,131057945,176,34,131057769,131057945
18857,6,12,1,2412,-63,-91,28,40:e3:d6:da:ba:25,131058173,160,68,131058013,131058173
18858,6,6,1,2412,-63,-91,28,40:e3:d6:da:ba:26,131058374,380,-179,131057994,131058374
18859,6,12,1,2412,-86,-91,5,40:e3:d6:de:1e:63,131080650,156,22120,131080494,131080650
18860,4,1,1,2412,-85,-91,6,54:e4:3a:ec:fb:64,131114149,2160,31339,131111989,131114149
18861,6,12,1,2412,-84,-91,7,40:e3:d6:de:1e:60,131130037,156,15732,131129881,131130037
18862,6,6,1,2412,-85,-91,6,40:e3:d6:de:1e:61,131130234,368,-171,131129866,131130234
18863,6,12,1,2412,-84,-91,7,40:e3:d6:de:1e:62,131130630,176,220,131130454,131130630
18864,6,12,1,2412,-84,-91,7,40:e3:d6:de:1e:63,131130840,180,30,131130660,131130840
18865,6,12,1,2412,-84,-91,7,40:e3:d6:de:1e:64,131131073,172,61,131130901,131131073
18866,6,12,1,2412,-83,-91,8,40:e3:d6:de:1e:65,131131289,156,60,131131133,131131289
18867,6,6,1,2412,-83,-91,8,40:e3:d6:de:1e:66,131131503,380,-166,131131123,131131503
18868,6,6,1,2412,-50,-91,41,40:e3:d6:da:ba:21,131159202,368,27331,131158834,131159202
18869,6,12,1,2412,-50,-91,41,40:e3:d6:da:ba:23,131159831,184,445,131159647,131159831
18870,6,12,1,2412,-52,-91,39,40:e3:d6:da:ba:24,131160049,176,42,131159873,131160049
18871,6,12,1,2412,-63,-91,28,40:e3:d6:da:ba:25,131160278,160,69,131160118,131160278
18872,6,6,1,2412,-63,-91,28,40:e3:d6:da:ba:26,131160479,380,-179,131160099,131160479
18873,4,1,1,2412,-86,-91,5,54:e4:3a:ec:fb:64,131216548,2160,53909,131214388,131216548
18874,6,12,1,2412,-79,-91,12,40:e3:d6:de:1e:60,131232439,156,15735,131232283,131232439
18875,6,6,1,2412,-83,-91,8,40:e3:d6:de:1e:61,131232645,368,-162,131232277,131232645
18876,6,12,1,2412,-82,-91,9,40:e3:d6:de:1e:62,131233041,176,220,131232865,131233041
18877,6,12,1,2412,-82,-91,9,40:e3:d6:de:1e:63,131233242,180,21,131233062,131233242
18878,6,6,1,2412,-81,-91,10,e6:aa:ea:b7:4a:dd,131238638,408,4988,131238230,131238638
18879,4,1,1,2412,-85,-91,6,b8:3a:5a:88:e6:e1,131247520,2376,6506,131245144,131247520
18880,6,6,1,2412,-84,-91,7,e6:aa:ea:b7:4a:dd,131250759,408,2831,131250351,131250759
18881,6,6,1,2412,-69,-91,22,e6:aa:ea:c9:ea:33,131257654,408,6487,131257246,131257654
18882,6,12,1,2412,-65,-91,26,40:e3:d6:da:ba:20,131261396,160,3582,131261236,131261396
18883,6,6,1,2412,-65,-91,26,40:e3:d6:da:ba:21,131261606,368,-158,131261238,131261606
18884,6,12,1,2412,-65,-91,26,40:e3:d6:da:ba:22,131261993,180,207,131261813,131261993
18885,6,12,1,2412,-65,-91,26,40:e3:d6:da:ba:25,131262655,160,502,131262495,131262655
18886,6,6,1,2412,-65,-91,26,40:e3:d6:da:ba:26,131262847,380,-188,131262467,131262847
18887,6,6,1,2412,-82,-91,9,e6:aa:ea:b7:4a:dd,131263280,408,25,131262872,131263280
18888,6,6,1,2412,-69,-91,22,e6:aa:ea:c9:ea:33,131269641,408,5953,131269233,131269641
18889,6,6,1,2412,-83,-91,8,e6:aa:ea:b7:4a:dd,131274983,408,4934,131274575,131274983
18890,6,6,1,2412,-69,-91,22,e6:aa:ea:c9:ea:33,131281752,408,6361,131281344,131281752
18891,6,6,1,2412,-82,-91,9,e6:aa:ea:b7:4a:dd,131287094,408,4934,131286686,131287094
18892,6,6,1,2412,-69,-91,22,e6:aa:ea:c9:ea:33,131293870,408,6368,131293462,131293870
18893,4,1,1,2412,-87,-91,4,54:e4:3a:ec:fb:64,131318948,2160,22918,131316788,131318948
18894,6,12,1,2412,-84,-91,7,40:e3:d6:de:1e:60,131334863,156,15759,131334707,131334863
18895,6,6,1,2412,-84,-91,7,40:e3:d6:de:1e:61,131335069,368,-162,131334701,131335069
18896,6,12,1,2412,-84,-91,7,40:e3:d6:de:1e:62,131335474,176,229,131335298,131335474
18897,6,12,1,2412,-84,-91,7,40:e3:d6:de:1e:63,131335675,180,21,131335495,131335675
18898,6,12,1,2412,-83,-91,8,40:e3:d6:de:1e:64,131335880,172,33,131335708,131335880
18899,6,12,1,2412,-84,-91,7,40:e3:d6:de:1e:65,131336087,156,51,131335931,131336087
18900,6,6,1,2412,-84,-91,7,40:e3:d6:de:1e:66,131336284,380,-183,131335904,131336284
18901,4,1,1,2412,-83,-91,8,b8:3a:5a:88:e6:e0,131347508,2360,8864,131345148,131347508
18902,6,12,1,2412,-64,-91,27,40:e3:d6:da:ba:20,131363817,160,16149,131363657,131363817
18903,6,6,1,2412,-64,-91,27,40:e3:d6:da:ba:21,131364009,368,-176,131363641,131364009
18904,6,12,1,2412,-64,-91,27,40:e3:d6:da:ba:22,131364396,180,207,131364216,131364396
18905,6,12,1,2412,-63,-91,28,40:e3:d6:da:ba:23,131364619,184,39,131364435,131364619
18906,6,12,1,2412,-64,-91,27,40:e3:d6:da:ba:24,131364847,176,52,131364671,131364847
18907,6,12,1,2412,-64,-91,27,40:e3:d6:da:ba:25,131365048,160,41,131364888,131365048
18908,4,1,1,2412,-79,-91,12,54:e4:3a:ec:fb:64,131421398,2160,54190,131419238,131421398
18909,6,12,1,2412,-84,-91,7,40:e3:d6:de:1e:60,131437262,156,15708,131437106,131437262
18910,6,6,1,2412,-84,-91,7,40:e3:d6:de:1e:61,131437477,368,-153,131437109,131437477
18911,6,12,1,2412,-81,-91,10,40:e3:d6:de:1e:63,131438101,180,444,131437921,131438101
18912,6,12,1,2412,-83,-91,8,40:e3:d6:de:1e:64,131438316,172,43,131438144,131438316
18913,6,12,1,2412,-83,-91,8,40:e3:d6:de:1e:65,131438513,156,41,131438357,131438513
18914,6,6,1,2412,-82,-91,9,40:e3:d6:de:1e:66,131438729,380,-164,131438349,131438729
18915,4,1,1,2412,-92,-91,-1,c0:c9:e3:4d:6e:bf,131440585,872,984,131439713,131440585
18916,6,12,1,2412,-63,-91,28,40:e3:d6:da:ba:20,131466193,160,25448,131466033,131466193
18917,6,12,1,2412,-63,-91,28,40:e3:d6:da:ba:22,131467671,180,1298,131467491,131467671
18918,6,12,1,2412,-63,-91,28,40:e3:d6:da:ba:23,131467903,184,48,131467719,131467903
18919,6,12,1,2412,-63,-91,28,40:e3:d6:da:ba:25,131468438,160,375,131468278,131468438
18920,6,6,1,2412,-63,-91,28,40:e3:d6:da:ba:26,131468657,380,-161,131468277,131468657
18921,4,1,1,2412,-92,-91,-1,a6:e5:7c:28:b1:d3,131516604,992,46955,131515612,131516604
18922,6,12,1,2412,-84,-91,7,40:e3:d6:de:1e:60,131539715,156,22955,131539559,131539715
18923,6,6,1,2412,-85,-91,6,40:e3:d6:de:1e:61,131539930,368,-153,131539562,131539930
18924,4,1,1,2412,-82,-91,9,b8:3a:5a:88:e6:e1,131554899,2376,12593,131552523,131554899
18925,6,12,1,2412,-64,-91,27,40:e3:d6:da:ba:20,131568598,160,13539,131568438,131568598
18926,6,6,1,2412,-64,-91,27,40:e3:d6:da:ba:21,131568867,368,-99,131568499,131568867
18927,6,12,1,2412,-64,-91,27,40:e3:d6:da:ba:22,131569254,180,207,131569074,131569254
18928,6,12,1,2412,-64,-91,27,40:e3:d6:da:ba:23,131569468,184,30,131569284,131569468
18929,6,12,1,2412,-64,-91,27,40:e3:d6:da:ba:24,131569686,176,42,131569510,131569686
18930,6,12,1,2412,-64,-91,27,40:e3:d6:da:ba:25,131569897,160,51,131569737,131569897
18931,6,6,1,2412,-64,-91,27,40:e3:d6:da:ba:26,131570098,380,-179,131569718,131570098
18932,6,6,1,2412,-72,-91,19,e6:aa:ea:c9:ea:33,131572696,408,2190,131572288,131572696
18933,6,12,1,2412,-64,-91,27,40:e3:d6:da:ba:20,131582832,136,10000,131582696,131582832
18934,6,6,1,2412,-64,-91,27,40:e3:d6:da:ba:21,131583009,348,-171,131582661,131583009
18935,6,12,1,2412,-64,-91,27,40:e3:d6:da:ba:22,131583385,156,220,131583229,131583385
18936,6,12,1,2412,-64,-91,27,40:e3:d6:da:ba:23,131583585,156,44,131583429,131583585
18937,6,12,1,2412,-64,-91,27,40:e3:d6:da:ba:25,131583775,136,54,131583639,131583775
18938,4,1,1,2412,-82,-91,9,54:e4:3a:ec:fb:64,131585263,2112,-624,131583151,131585263
18939,4,1,1,2412,-82,-91,9,54:e4:3a:ec:fb:64,131593845,2112,6470,131591733,131593845
18940,6,6,1,2412,-73,-91,18,e6:aa:ea:c9:ea:33,131596739,408,2486,131596331,131596739
18941,6,6,1,2412,-72,-91,19,e6:aa:ea:c9:ea:33,131608830,408,11683,131608422,131608830
18942,4,1,1,2412,-84,-91,7,54:e4:3a:ec:fb:64,131626388,2160,15398,131624228,131626388
18943,6,6,1,2412,-84,-91,7,40:e3:d6:de:1e:66,131643518,380,16750,131643138,131643518
18944,6,6,1,2412,-90,-91,1,40:e3:d6:da:c0:26,131644043,380,145,131643663,131644043
18945,4,1,1,2412,-78,-91,13,b8:3a:5a:88:e6:e0,131654708,2360,8305,131652348,131654708
18946,4,1,1,2412,-79,-91,12,b8:3a:5a:88:e6:e1,131657087,2376,3,131654711,131657087
18947,6,12,1,2412,-64,-91,27,40:e3:d6:da:ba:20,131670994,160,13747,131670834,131670994
18948,6,6,1,2412,-64,-91,27,40:e3:d6:da:ba:21,131671195,368,-167,131670827,131671195
18949,6,12,1,2412,-64,-91,27,40:e3:d6:da:ba:22,131671609,180,234,131671429,131671609
18950,6,12,1,2412,-64,-91,27,40:e3:d6:da:ba:23,131671841,184,48,131671657,131671841
18951,6,12,1,2412,-64,-91,27,40:e3:d6:da:ba:24,131672060,176,43,131671884,131672060
18952,6,12,1,2412,-64,-91,27,40:e3:d6:da:ba:25,131672279,160,59,131672119,131672279
18953,6,6,1,2412,-64,-91,27,40:e3:d6:da:ba:26,131672471,380,-188,131672091,131672471
18954,6,12,1,2412,-86,-91,5,40:e3:d6:de:1e:60,131744449,156,71822,131744293,131744449
18955,6,6,1,2412,-85,-91,6,40:e3:d6:de:1e:61,131744663,368,-154,131744295,131744663
18956,4,1,1,2412,-78,-91,13,b8:3a:5a:88:e6:e0,131757123,2360,10100,131754763,131757123
18957,4,1,1,2412,-57,-91,34,b8:3a:5a:88:e6:e1,131759503,2376,4,131757127,131759503
18958,6,6,1,2412,-79,-91,12,e6:aa:ea:b7:4a:dd,131770795,408,10884,131770387,131770795
18959,6,12,1,2412,-63,-91,28,40:e3:d6:da:ba:20,131773406,160,2451,131773246,131773406
18960,6,12,1,2412,-63,-91,28,40:e3:d6:da:ba:22,131775200,180,1614,131775020,131775200
18961,6,6,1,2412,-63,-91,28,40:e3:d6:da:ba:26,131776072,380,492,131775692,131776072
18962,6,6,1,2412,-80,-91,11,e6:aa:ea:b7:4a:dd,131782932,408,6452,131782524,131782932
18963,6,6,1,2412,-79,-91,12,e6:aa:ea:b7:4a:dd,131795033,408,11693,131794625,131795033
18964,6,6,1,2412,-79,-91,12,e6:aa:ea:b7:4a:dd,131807188,408,11747,131806780,131807188
18965,4,1,1,2412,-85,-91,6,54:e4:3a:ec:fb:64,131830942,2160,21594,131828782,131830942
18966,6,12,1,2412,-86,-91,5,40:e3:d6:de:1e:60,131846854,156,15756,131846698,131846854
18967,6,6,1,2412,-86,-91,5,40:e3:d6:de:1e:61,131847060,368,-162,131846692,131847060
18968,6,12,1,2412,-85,-91,6,40:e3:d6:de:1e:64,131847908,172,676,131847736,131847908
18969,6,6,1,2412,-90,-91,1,40:e3:d6:da:c0:26,131848779,380,491,131848399,131848779
18970,4,1,1,2412,-79,-91,12,b8:3a:5a:88:e6:e0,131860305,2360,9166,131857945,131860305
18971,4,1,1,2412,-81,-91,10,b8:3a:5a:88:e6:e1,131862685,2376,4,131860309,131862685
18972,6,12,1,2412,-63,-91,28,40:e3:d6:da:ba:20,131875814,160,12969,131875654,131875814
18973,6,6,1,2412,-63,-91,28,40:e3:d6:da:ba:21,131876033,368,-149,131875665,131876033
18974,6,12,1,2412,-63,-91,28,40:e3:d6:da:ba:22,131876438,180,225,131876258,131876438
18975,6,12,1,2412,-63,-91,28,40:e3:d6:da:ba:23,131876653,184,31,131876469,131876653
18976,6,12,1,2412,-63,-91,28,40:e3:d6:da:ba:24,131876862,176,33,131876686,131876862
18977,6,12,1,2412,-63,-91,28,40:e3:d6:da:ba:25,131877091,160,69,131876931,131877091
18978,6,6,1,2412,-63,-91,28,40:e3:d6:da:ba:26,131877283,380,-188,131876903,131877283
18979,6,12,1,2412,-83,-91,8,40:e3:d6:de:1e:60,131949241,156,71802,131949085,131949241
18980,6,6,1,2412,-86,-91,5,40:e3:d6:de:1e:61,131949429,368,-180,131949061,131949429
18981,6,6,1,2412,-79,-91,12,40:e3:d6:de:1e:66,131950672,380,863,131950292,131950672
18982,6,12,1,2412,-61,-91,30,40:e3:d6:da:ba:20,131978219,160,27387,131978059,131978219
18983,6,6,1,2412,-61,-91,30,40:e3:d6:da:ba:21,131978438,368,-149,131978070,131978438
18984,6,12,1,2412,-62,-91,29,40:e3:d6:da:ba:22,131978834,180,216,131978654,131978834
18985,6,12,1,2412,-62,-91,29,40:e3:d6:da:ba:23,131979265,184,247,131979081,131979265
18986,6,12,1,2412,-61,-91,30,40:e3:d6:da:ba:24,131979502,176,61,131979326,131979502
18987,6,12,1,2412,-61,-91,30,40:e3:d6:da:ba:25,131979721,160,59,131979561,131979721
18988,6,6,1,2412,-61,-91,30,40:e3:d6:da:ba:26,131979931,380,-170,131979551,131979931
18989,6,6,1,2412,-72,-91,19,e6:aa:ea:c9:ea:33,131990666,408,10327,131990258,131990666
18990,6,6,1,2412,-72,-91,19,e6:aa:ea:c9:ea:33,132014840,408,23766,132014432,132014840
18991,6,6,1,2412,-72,-91,19,e6:aa:ea:c9:ea:33,132026967,408,11719,132026559,132026967
18992,6,12,1,2412,-86,-91,5,40:e3:d6:de:1e:60,132051662,156,24539,132051506,132051662
18993,6,6,1,2412,-86,-91,5,40:e3:d6:de:1e:61,132051850,368,-180,132051482,132051850
18994,6,6,1,2412,-83,-91,8,40:e3:d6:de:1e:66,132053110,380,880,132052730,132053110
18995,4,1,1,2412,-82,-91,9,b8:3a:5a:88:e6:e0,132064310,2360,8840,132061950,132064310
18996,4,1,1,2412,-83,-91,8,b8:3a:5a:88:e6:e1,132066690,2376,4,132064314,132066690
18997,6,12,1,2412,-64,-91,27,40:e3:d6:da:ba:20,132080603,160,13753,132080443,132080603
18998,6,6,1,2412,-64,-91,27,40:e3:d6:da:ba:21,132080795,368,-176,132080427,132080795
18999,6,12,1,2412,-65,-91,26,40:e3:d6:da:ba:22,132081209,180,234,132081029,132081209
19000,6,12,1,2412,-64,-91,27,40:e3:d6:da:ba:23,132081441,184,48,132081257,132081441
19001,6,12,1,2412,-64,-91,27,40:e3:d6:da:ba:24,132081669,176,52,132081493,132081669
19002,6,12,1,2412,-64,-91,27,40:e3:d6:da:ba:25,132081888,160,59,132081728,132081888
19003,4,1,1,2412,-83,-91,8,54:e4:3a:ec:fb:64,132138140,2160,54092,132135980,132138140
19004,6,12,1,2412,-86,-91,5,40:e3:d6:de:1e:60,132154041,156,15745,132153885,132154041
19005,6,6,1,2412,-86,-91,5,40:e3:d6:de:1e:61,132154256,368,-153,132153888,132154256
19006,6,6,1,2412,-76,-91,15,40:e3:d6:de:1e:66,132155472,380,836,132155092,132155472
19007,4,1,1,2412,-81,-91,10,b8:3a:5a:88:e6:e0,132167667,2360,9835,132165307,132167667
19008,6,6,1,2412,-80,-91,11,e6:aa:ea:b7:4a:dd,132175635,408,7560,132175227,132175635
19009,6,12,1,2412,-65,-91,26,40:e3:d6:da:ba:20,132183013,160,7218,132182853,132183013
19010,6,6,1,2412,-65,-91,26,40:e3:d6:da:ba:21,132183214,368,-167,132182846,132183214
19011,6,12,1,2412,-65,-91,26,40:e3:d6:da:ba:22,132183699,180,305,132183519,132183699
19012,6,12,1,2412,-64,-91,27,40:e3:d6:da:ba:23,132183905,184,22,132183721,132183905
19013,6,6,1,2412,-79,-91,12,e6:aa:ea:b7:4a:dd,132199860,408,15547,132199452,132199860
19014,6,6,1,2412,-79,-91,12,e6:aa:ea:b7:4a:dd,132224093,408,23825,132223685,132224093
19015,6,12,1,2412,-86,-91,5,40:e3:d6:de:1e:60,132256448,156,32199,132256292,132256448
19016,6,6,1,2412,-85,-91,6,40:e3:d6:de:1e:66,132257878,380,1050,132257498,132257878
19017,4,1,1,2412,-81,-91,10,b8:3a:5a:88:e6:e0,132269109,2360,8871,132266749,132269109
19018,4,1,1,2412,-81,-91,10,b8:3a:5a:88:e6:e1,132271507,2376,22,132269131,132271507
19019,6,12,1,2412,-65,-91,26,40:e3:d6:da:ba:22,132286012,180,14325,132285832,132286012
19020,6,12,1,2412,-66,-91,25,40:e3:d6:da:ba:23,132286235,184,39,132286051,132286235
19021,6,12,1,2412,-65,-91,26,40:e3:d6:da:ba:24,132286445,176,34,132286269,132286445
19022,6,12,1,2412,-65,-91,26,40:e3:d6:da:ba:25,132286655,160,50,132286495,132286655
19023,6,12,1,2412,-77,-91,14,40:e3:d6:de:1e:60,132358854,156,72043,132358698,132358854
19024,6,6,1,2412,-88,-91,3,40:e3:d6:de:1e:61,132359061,368,-161,132358693,132359061
19025,6,6,1,2412,-85,-91,6,40:e3:d6:de:1e:66,132360285,380,844,132359905,132360285
19026,4,1,1,2412,-94,-91,-3,,132383292,304,22703,132382988,132383292
19027,6,12,1,2412,-65,-91,26,40:e3:d6:da:ba:20,132383590,136,162,132383454,132383590
19028,6,6,1,2412,-65,-91,26,40:e3:d6:da:ba:21,132383821,348,-117,132383473,132383821
19029,6,12,1,2412,-65,-91,26,40:e3:d6:da:ba:22,132384231,156,254,132384075,132384231
19030,6,12,1,2412,-65,-91,26,40:e3:d6:da:ba:23,132384448,156,61,132384292,132384448
19031,6,12,1,2412,-66,-91,25,40:e3:d6:da:ba:25,132384638,136,54,132384502,132384638
19032,6,12,1,2412,-66,-91,25,40:e3:d6:da:ba:20,132388130,160,3332,132387970,132388130
19033,6,6,1,2412,-65,-91,26,40:e3:d6:da:ba:21,132388340,368,-158,132387972,132388340
19034,6,12,1,2412,-65,-91,26,40:e3:d6:da:ba:22,132388745,180,225,132388565,132388745
19035,6,12,1,2412,-65,-91,26,40:e3:d6:da:ba:23,132388977,184,48,132388793,132388977
19036,6,12,1,2412,-65,-91,26,40:e3:d6:da:ba:24,132389214,176,61,132389038,132389214
19037,6,12,1,2412,-65,-91,26,40:e3:d6:da:ba:25,132389424,160,50,132389264,132389424
19038,6,6,1,2412,-65,-91,26,40:e3:d6:da:ba:26,132389643,380,-161,132389263,132389643
19039,6,6,1,2412,-75,-91,16,e6:aa:ea:c9:ea:33,132396848,408,6797,132396440,132396848
19040,6,6,1,2412,-75,-91,16,e6:aa:ea:c9:ea:33,132408721,408,11465,132408313,132408721
19041,6,6,1,2412,-74,-91,17,e6:aa:ea:c9:ea:33,132420846,408,11717,132420438,132420846
19042,6,6,1,2412,-74,-91,17,e6:aa:ea:c9:ea:33,132433046,408,11792,132432638,132433046
19043,6,6,1,2412,-73,-91,18,e6:aa:ea:c9:ea:33,132445092,408,11638,132444684,132445092
19044,4,1,1,2412,-83,-91,8,54:e4:3a:ec:fb:64,132445691,2160,-1561,132443531,132445691
19045,6,6,1,2412,-84,-91,7,84:1b:5e:df:1b:99,132455489,80,9718,132455409,132455489
19046,6,12,1,2412,-86,-91,5,40:e3:d6:de:1e:60,132461260,156,5615,132461104,132461260
19047,6,6,1,2412,-86,-91,5,40:e3:d6:de:1e:61,132461466,368,-162,132461098,132461466
19048,4,1,1,2412,-81,-91,10,b8:3a:5a:88:e6:e0,132473933,2360,10107,132471573,132473933
19049,6,12,1,2412,-65,-91,26,40:e3:d6:da:ba:20,132490197,160,16104,132490037,132490197
19050,6,6,1,2412,-65,-91,26,40:e3:d6:da:ba:21,132490398,368,-167,132490030,132490398
19051,6,6,1,2412,-78,-91,13,e6:aa:ea:b7:4a:dd,132490795,408,-11,132490387,132490795
19052,6,12,1,2412,-65,-91,26,40:e3:d6:da:ba:22,132491219,180,244,132491039,132491219
19053,6,12,1,2412,-65,-91,26,40:e3:d6:da:ba:23,132491424,184,21,132491240,132491424
19054,6,12,1,2412,-65,-91,26,40:e3:d6:da:ba:24,132491634,176,34,132491458,132491634
19055,6,12,1,2412,-65,-91,26,40:e3:d6:da:ba:25,132491835,160,41,132491675,132491835
19056,6,6,1,2412,-65,-91,26,40:e3:d6:da:ba:26,132492054,380,-161,132491674,132492054
19057,6,6,1,2412,-79,-91,12,e6:aa:ea:b7:4a:dd,132503395,408,10933,132502987,132503395
19058,6,6,1,2412,-79,-91,12,e6:aa:ea:b7:4a:dd,132514960,408,11157,132514552,132514960
19059,6,6,1,2412,-79,-91,12,e6:aa:ea:b7:4a:dd,132527083,408,11715,132526675,132527083
19060,6,6,1,2412,-86,-91,5,40:e3:d6:de:1e:61,132543461,348,16030,132543113,132543461
19061,6,12,1,2412,-84,-91,7,40:e3:d6:de:1e:60,132546220,136,2623,132546084,132546220
19062,6,12,1,2412,-87,-91,4,40:e3:d6:de:1e:60,132563643,156,17267,132563487,132563643
19063,6,6,1,2412,-86,-91,5,40:e3:d6:de:1e:61,132563840,368,-171,132563472,132563840
19064,6,12,1,2412,-87,-91,4,40:e3:d6:de:1e:62,132564236,176,220,132564060,132564236
19065,6,6,1,2412,-85,-91,6,40:e3:d6:de:1e:66,132565073,380,457,132564693,132565073
19066,4,1,1,2412,-81,-91,10,b8:3a:5a:88:e6:e0,132576321,2360,8888,132573961,132576321
19067,6,12,1,2412,-65,-91,26,40:e3:d6:da:ba:20,132592624,160,16143,132592464,132592624
19068,6,6,1,2412,-64,-91,27,40:e3:d6:da:ba:21,132592843,368,-149,132592475,132592843
19069,6,12,1,2412,-64,-91,27,40:e3:d6:da:ba:22,132593248,180,225,132593068,132593248
19070,6,12,1,2412,-64,-91,27,40:e3:d6:da:ba:23,132593454,184,22,132593270,132593454
19071,6,12,1,2412,-64,-91,27,40:e3:d6:da:ba:24,132593672,176,42,132593496,132593672
19072,6,12,1,2412,-64,-91,27,40:e3:d6:da:ba:25,132593883,160,51,132593723,132593883
19073,6,6,1,2412,-64,-91,27,40:e3:d6:da:ba:26,132594093,380,-170,132593713,132594093
19074,6,12,1,2412,-86,-91,5,40:e3:d6:de:1e:60,132666045,156,71796,132665889,132666045
19075,6,12,1,2412,-85,-91,6,40:e3:d6:de:1e:63,132666884,180,659,132666704,132666884
19076,6,12,1,2412,-85,-91,6,40:e3:d6:de:1e:64,132667117,172,61,132666945,132667117
19077,6,12,1,2412,-79,-91,12,40:e3:d6:de:1e:65,132667332,156,59,132667176,132667332
19078,6,12,1,2412,-86,-91,5,40:e3:d6:de:1e:60,132677498,136,10030,132677362,132677498
19079,6,6,1,2412,-87,-91,4,40:e3:d6:de:1e:61,132677683,348,-163,132677335,132677683
19080,6,12,1,2412,-82,-91,9,40:e3:d6:de:1e:62,132678086,156,247,132677930,132678086
19081,4,1,1,2412,-82,-91,9,b8:3a:5a:88:e6:e1,132682284,2376,1822,132679908,132682284
19082,6,12,1,2412,-64,-91,27,40:e3:d6:da:ba:20,132694999,160,12555,132694839,132694999
19083,6,6,1,2412,-64,-91,27,40:e3:d6:da:ba:21,132695218,368,-149,132694850,132695218
19084,6,12,1,2412,-63,-91,28,40:e3:d6:da:ba:22,132695623,180,225,132695443,132695623
19085,6,12,1,2412,-63,-91,28,40:e3:d6:da:ba:23,132695837,184,30,132695653,132695837
19086,6,12,1,2412,-64,-91,27,40:e3:d6:da:ba:24,132696065,176,52,132695889,132696065
19087,6,12,1,2412,-63,-91,28,40:e3:d6:da:ba:25,132696293,160,68,132696133,132696293
19088,6,6,1,2412,-64,-91,27,40:e3:d6:da:ba:26,132696485,380,-188,132696105,132696485
19089,6,12,1,2412,-85,-91,6,40:e3:d6:de:1e:60,132697674,136,1053,132697538,132697674
19090,6,6,1,2412,-88,-91,3,40:e3:d6:de:1e:61,132697860,348,-162,132697512,132697860
19091,6,12,1,2412,-86,-91,5,40:e3:d6:de:1e:62,132698262,156,246,132698106,132698262
19092,6,12,1,2412,-86,-91,5,40:e3:d6:de:1e:63,132698453,156,35,132698297,132698453
19093,6,12,1,2412,-87,-91,4,40:e3:d6:de:1e:65,132698643,136,54,132698507,132698643
19094,6,12,1,2412,-86,-91,5,40:e3:d6:de:1e:60,132704043,136,5264,132703907,132704043
19095,4,1,1,2412,-87,-91,4,54:e4:3a:ec:fb:64,132752535,2160,46332,132750375,132752535
19096,6,12,1,2412,-84,-91,7,40:e3:d6:de:1e:62,132769076,176,16365,132768900,132769076
19097,6,12,1,2412,-86,-91,5,40:e3:d6:de:1e:63,132769304,180,48,132769124,132769304
19098,6,12,1,2412,-86,-91,5,40:e3:d6:de:1e:64,132769528,172,52,132769356,132769528
19099,6,12,1,2412,-85,-91,6,40:e3:d6:de:1e:65,132769752,156,68,132769596,132769752
19100,6,6,1,2412,-85,-91,6,40:e3:d6:de:1e:66,132769940,380,-192,132769560,132769940
19101,6,12,1,2412,-63,-91,28,40:e3:d6:da:ba:20,132798303,160,28203,132798143,132798303
19102,6,6,1,2412,-63,-91,28,40:e3:d6:da:ba:21,132798522,368,-149,132798154,132798522
19103,6,12,1,2412,-63,-91,28,40:e3:d6:da:ba:22,132798909,180,207,132798729,132798909
19104,6,12,1,2412,-63,-91,28,40:e3:d6:da:ba:23,132799132,184,39,132798948,132799132
19105,6,12,1,2412,-63,-91,28,40:e3:d6:da:ba:24,132799342,176,34,132799166,132799342
19106,6,12,1,2412,-63,-91,28,40:e3:d6:da:ba:25,132799543,160,41,132799383,132799543
19107,6,6,1,2412,-63,-91,28,40:e3:d6:da:ba:26,132799762,380,-161,132799382,132799762
19108,6,6,1,2412,-79,-91,12,e6:aa:ea:b7:4a:dd,132817954,408,17784,132817546,132817954
19109,6,6,1,2412,-79,-91,12,e6:aa:ea:b7:4a:dd,132830072,408,11710,132829664,132830072
19110,6,6,1,2412,-79,-91,12,e6:aa:ea:b7:4a:dd,132842186,408,11706,132841778,132842186
19111,6,6,1,2412,-79,-91,12,e6:aa:ea:b7:4a:dd,132854308,408,11714,132853900,132854308
19112,4,1,1,2412,-86,-91,5,54:e4:3a:ec:fb:64,132854933,2160,-1535,132852773,132854933
19113,6,12,1,2412,-85,-91,6,40:e3:d6:de:1e:60,132870871,156,15782,132870715,132870871
19114,6,6,1,2412,-86,-91,5,40:e3:d6:de:1e:61,132871086,368,-153,132870718,132871086
19115,6,12,1,2412,-85,-91,6,40:e3:d6:de:1e:64,132871933,172,675,132871761,132871933
19116,6,12,1,2412,-85,-91,6,40:e3:d6:de:1e:65,132872149,156,60,132871993,132872149
19117,6,6,1,2412,-85,-91,6,40:e3:d6:de:1e:66,132872337,380,-192,132871957,132872337
19118,6,12,1,2412,-63,-91,28,40:e3:d6:da:ba:20,132899800,160,27303,132899640,132899800
19119,6,6,1,2412,-62,-91,29,40:e3:d6:da:ba:21,132900019,368,-149,132899651,132900019
19120,6,12,1,2412,-62,-91,29,40:e3:d6:da:ba:22,132900424,180,225,132900244,132900424
19121,6,12,1,2412,-62,-91,29,40:e3:d6:da:ba:23,132900639,184,31,132900455,132900639
19122,6,12,1,2412,-62,-91,29,40:e3:d6:da:ba:24,132900857,176,42,132900681,132900857
19123,6,12,1,2412,-62,-91,29,40:e3:d6:da:ba:25,132901068,160,51,132900908,132901068
19124,6,6,1,2412,-62,-91,29,40:e3:d6:da:ba:26,132901286,380,-162,132900906,132901286
19125,6,6,1,2412,-73,-91,18,e6:aa:ea:c9:ea:33,132917214,408,15520,132916806,132917214
19126,6,6,1,2412,-73,-91,18,e6:aa:ea:c9:ea:33,132929361,408,11739,132928953,132929361
19127,6,6,1,2412,-73,-91,18,e6:aa:ea:c9:ea:33,132941470,408,11701,132941062,132941470
19128,6,6,1,2412,-73,-91,18,e6:aa:ea:c9:ea:33,132953589,408,11711,132953181,132953589
19129,6,12,1,2412,-84,-91,7,40:e3:d6:de:1e:60,132973267,156,19522,132973111,132973267
19130,6,6,1,2412,-84,-91,7,40:e3:d6:de:1e:61,132973472,368,-163,132973104,132973472
19131,6,12,1,2412,-83,-91,8,40:e3:d6:de:1e:62,132973886,176,238,132973710,132973886
19132,6,12,1,2412,-83,-91,8,40:e3:d6:de:1e:63,132974115,180,49,132973935,132974115
19133,6,12,1,2412,-83,-91,8,40:e3:d6:de:1e:64,132974339,172,52,132974167,132974339
19134,6,12,1,2412,-84,-91,7,40:e3:d6:de:1e:65,132974545,156,50,132974389,132974545
19135,6,6,1,2412,-83,-91,8,40:e3:d6:de:1e:66,132974751,380,-174,132974371,132974751
19136,6,12,1,2412,-62,-91,29,40:e3:d6:da:ba:20,133002212,160,27301,133002052,133002212
19137,6,6,1,2412,-62,-91,29,40:e3:d6:da:ba:21,133002413,368,-167,133002045,133002413
19138,6,12,1,2412,-62,-91,29,40:e3:d6:da:ba:22,133002833,180,240,133002653,133002833
19139,6,12,1,2412,-62,-91,29,40:e3:d6:da:ba:23,133003039,184,22,133002855,133003039
19140,6,6,1,2412,-62,-91,29,40:e3:d6:da:ba:26,133003669,380,250,133003289,133003669
19141,4,1,1,2412,-83,-91,8,54:e4:3a:ec:fb:64,133059733,2160,53904,133057573,133059733
19142,6,12,1,2412,-85,-91,6,40:e3:d6:de:1e:60,133075645,156,15756,133075489,133075645
19143,6,6,1,2412,-86,-91,5,40:e3:d6:de:1e:61,133075851,368,-162,133075483,133075851
19144,6,12,1,2412,-85,-91,6,40:e3:d6:de:1e:63,133076448,180,417,133076268,133076448
19145,6,12,1,2412,-85,-91,6,40:e3:d6:de:1e:64,133076654,172,34,133076482,133076654
19146,6,12,1,2412,-83,-91,8,40:e3:d6:de:1e:65,133076860,156,50,133076704,133076860
19147,6,6,1,2412,-86,-91,5,40:e3:d6:de:1e:66,133077075,380,-165,133076695,133077075
19148,4,1,1,2412,-77,-91,14,b8:3a:5a:88:e6:e0,133088336,2360,8901,133085976,133088336
19149,6,12,1,2412,-62,-91,29,40:e3:d6:da:ba:20,133104625,160,16129,133104465,133104625
19150,6,6,1,2412,-62,-91,29,40:e3:d6:da:ba:21,133104817,368,-176,133104449,133104817
19151,6,12,1,2412,-62,-91,29,40:e3:d6:da:ba:22,133105231,180,234,133105051,133105231
19152,6,12,1,2412,-62,-91,29,40:e3:d6:da:ba:23,133105454,184,39,133105270,133105454
19153,6,12,1,2412,-62,-91,29,40:e3:d6:da:ba:24,133105664,176,34,133105488,133105664
19154,6,12,1,2412,-62,-91,29,40:e3:d6:da:ba:25,133105892,160,68,133105732,133105892
19155,6,6,1,2412,-62,-91,29,40:e3:d6:da:ba:26,133106084,380,-188,133105704,133106084
19156,6,12,1,2412,-86,-91,5,40:e3:d6:de:1e:60,133178045,156,71805,133177889,133178045
19157,6,12,1,2412,-86,-91,5,40:e3:d6:de:1e:62,133178657,176,436,133178481,133178657
19158,6,12,1,2412,-84,-91,7,40:e3:d6:de:1e:63,133178885,180,48,133178705,133178885
19159,6,12,1,2412,-85,-91,6,40:e3:d6:de:1e:64,133179090,172,33,133178918,133179090
19160,4,1,1,2412,-77,-91,14,b8:3a:5a:88:e6:e0,133190712,2360,9262,133188352,133190712
19161,4,1,1,2412,-78,-91,13,b8:3a:5a:88:e6:e1,133193092,2376,4,133190716,133193092
19162,6,12,1,2412,-64,-91,27,40:e3:d6:da:ba:20,133207011,160,13759,133206851,133207011
19163,6,6,1,2412,-64,-91,27,40:e3:d6:da:ba:21,133207221,368,-158,133206853,133207221
19164,6,12,1,2412,-63,-91,28,40:e3:d6:da:ba:22,133207626,180,225,133207446,133207626
19165,6,12,1,2412,-63,-91,28,40:e3:d6:da:ba:23,133207832,184,22,133207648,133207832
19166,6,12,1,2412,-63,-91,28,40:e3:d6:da:ba:24,133208068,176,60,133207892,133208068
19167,6,12,1,2412,-63,-91,28,40:e3:d6:da:ba:25,133208279,160,51,133208119,133208279
19168,6,6,1,2412,-63,-91,28,40:e3:d6:da:ba:26,133208497,380,-162,133208117,133208497
19169,6,6,1,2412,-80,-91,11,e6:aa:ea:b7:4a:dd,133225662,408,16757,133225254,133225662
19170,6,6,1,2412,-82,-91,9,e6:aa:ea:b7:4a:dd,133237879,408,11809,133237471,133237879
19171,6,6,1,2412,-81,-91,10,e6:aa:ea:b7:4a:dd,133249869,408,11582,133249461,133249869
19172,6,6,1,2412,-81,-91,10,e6:aa:ea:b7:4a:dd,133261948,408,11671,133261540,133261948
19173,6,12,1,2412,-86,-91,5,40:e3:d6:de:1e:64,133281529,172,19409,133281357,133281529
19174,6,12,1,2412,-87,-91,4,40:e3:d6:de:1e:65,133281746,156,61,133281590,133281746
19175,4,1,1,2412,-77,-91,14,b8:3a:5a:88:e6:e1,133295501,2376,11379,133293125,133295501
19176,6,12,1,2412,-66,-91,25,40:e3:d6:da:ba:20,133309405,160,13744,133309245,133309405
19177,6,6,1,2412,-66,-91,25,40:e3:d6:da:ba:21,133309615,368,-158,133309247,133309615
19178,6,12,1,2412,-65,-91,26,40:e3:d6:da:ba:22,133310002,180,207,133309822,133310002
19179,6,12,1,2412,-66,-91,25,40:e3:d6:da:ba:23,133310216,184,30,133310032,133310216
19180,6,12,1,2412,-66,-91,25,40:e3:d6:da:ba:24,133310435,176,43,133310259,133310435
19181,6,12,1,2412,-66,-91,25,40:e3:d6:da:ba:25,133310636,160,41,133310476,133310636
19182,6,6,1,2412,-66,-91,25,40:e3:d6:da:ba:26,133310828,380,-188,133310448,133310828
19183,6,6,1,2412,-74,-91,17,e6:aa:ea:c9:ea:33,133335150,408,23914,133334742,133335150
19184,6,6,1,2412,-76,-91,15,e6:aa:ea:c9:ea:33,133359389,408,23831,133358981,133359389
19185,6,12,1,2412,-85,-91,6,40:e3:d6:de:1e:60,133382846,156,23301,133382690,133382846
19186,6,6,1,2412,-85,-91,6,40:e3:d6:de:1e:61,133383034,368,-180,133382666,133383034
19187,6,6,1,2412,-76,-91,15,e6:aa:ea:c9:ea:33,133383616,408,174,133383208,133383616
19188,6,12,1,2412,-66,-91,25,40:e3:d6:da:ba:20,133411802,160,28026,133411642,133411802
19189,6,6,1,2412,-66,-91,25,40:e3:d6:da:ba:21,133411993,368,-177,133411625,133411993
19190,6,12,1,2412,-66,-91,25,40:e3:d6:da:ba:22,133412381,180,208,133412201,133412381
19191,6,12,1,2412,-66,-91,25,40:e3:d6:da:ba:23,133412613,184,48,133412429,133412613
19192,6,12,1,2412,-66,-91,25,40:e3:d6:da:ba:24,133412840,176,51,133412664,133412840
19193,6,12,1,2412,-67,-91,24,40:e3:d6:da:ba:25,133413042,160,42,133412882,133413042
19194,6,6,1,2412,-66,-91,25,40:e3:d6:da:ba:26,133413234,380,-188,133412854,133413234
19195,6,12,1,2412,-84,-91,7,40:e3:d6:de:1e:62,133468838,156,55448,133468682,133468838
19196,6,12,1,2412,-85,-91,6,40:e3:d6:de:1e:60,133485272,156,16278,133485116,133485272
19197,6,6,1,2412,-83,-91,8,40:e3:d6:de:1e:61,133485468,368,-172,133485100,133485468
19198,4,1,1,2412,-79,-91,12,b8:3a:5a:88:e6:e1,133500322,2376,12478,133497946,133500322
19199,6,6,1,2412,-63,-91,28,40:e3:d6:da:ba:21,133514397,368,13707,133514029,133514397
19200,6,12,1,2412,-64,-91,27,40:e3:d6:da:ba:22,133514793,180,216,133514613,133514793
19201,6,12,1,2412,-64,-91,27,40:e3:d6:da:ba:23,133515026,184,49,133514842,133515026
19202,6,12,1,2412,-64,-91,27,40:e3:d6:da:ba:24,133515253,176,51,133515077,133515253
19203,6,12,1,2412,-63,-91,28,40:e3:d6:da:ba:25,133515489,160,76,133515329,133515489
19204,6,6,1,2412,-63,-91,28,40:e3:d6:da:ba:26,133515698,380,-171,133515318,133515698
19205,4,1,1,2412,-87,-91,4,54:e4:3a:ec:fb:64,133571727,2160,53869,133569567,133571727
19206,6,12,1,2412,-85,-91,6,40:e3:d6:de:1e:60,133587646,156,15763,133587490,133587646
19207,6,6,1,2412,-85,-91,6,40:e3:d6:de:1e:61,133587843,368,-171,133587475,133587843
19208,6,12,1,2412,-87,-91,4,40:e3:d6:da:c0:25,133589493,156,1494,133589337,133589493
19209,6,6,1,2412,-89,-91,2,40:e3:d6:da:c0:26,133589699,380,-174,133589319,133589699
19210,4,1,1,2412,-78,-91,13,b8:3a:5a:88:e6:e0,133600320,2360,8261,133597960,133600320
19211,6,12,1,2412,-63,-91,28,40:e3:d6:da:ba:23,133617450,184,16946,133617266,133617450
19212,6,12,1,2412,-64,-91,27,40:e3:d6:da:ba:24,133617677,176,51,133617501,133617677
19213,6,12,1,2412,-63,-91,28,40:e3:d6:da:ba:25,133617896,160,59,133617736,133617896
19214,6,6,1,2412,-64,-91,27,40:e3:d6:da:ba:26,133618097,380,-179,133617717,133618097
19215,6,6,1,2412,-79,-91,12,e6:aa:ea:b7:4a:dd,133643161,408,24656,133642753,133643161
19216,6,6,1,2412,-80,-91,11,e6:aa:ea:b7:4a:dd,133655286,408,11717,133654878,133655286
19217,6,12,1,2412,-87,-91,4,40:e3:d6:de:1e:60,133690051,156,34609,133689895,133690051
19218,6,6,1,2412,-88,-91,3,40:e3:d6:de:1e:61,133690266,368,-153,133689898,133690266
19219,4,1,1,2412,-80,-91,11,b8:3a:5a:88:e6:e0,133702732,2360,10106,133700372,133702732
19220,4,1,1,2412,-82,-91,9,b8:3a:5a:88:e6:e1,133705121,2376,13,133702745,133705121
19221,6,12,1,2412,-67,-91,24,40:e3:d6:da:ba:20,133719016,160,13735,133718856,133719016
19222,6,6,1,2412,-67,-91,24,40:e3:d6:da:ba:21,133719226,368,-158,133718858,133719226
19223,6,12,1,2412,-67,-91,24,40:e3:d6:da:ba:22,133719640,180,234,133719460,133719640
19224,6,12,1,2412,-67,-91,24,40:e3:d6:da:ba:23,133719855,184,31,133719671,133719855
19225,6,12,1,2412,-66,-91,25,40:e3:d6:da:ba:24,133720073,176,42,133719897,133720073
19226,6,12,1,2412,-67,-91,24,40:e3:d6:da:ba:25,133720293,160,60,133720133,133720293
19227,6,6,1,2412,-67,-91,24,40:e3:d6:da:ba:26,133720503,380,-170,133720123,133720503
19228,4,1,1,2412,-85,-91,6,54:e4:3a:ec:fb:64,133776525,2160,53862,133774365,133776525
19229,6,12,1,2412,-87,-91,4,40:e3:d6:de:1e:60,133792452,156,15771,133792296,133792452
19230,6,12,1,2412,-65,-91,26,40:e3:d6:da:ba:20,133821404,160,28792,133821244,133821404
19231,6,6,1,2412,-65,-91,26,40:e3:d6:da:ba:21,133821622,368,-150,133821254,133821622
19232,6,12,1,2412,-65,-91,26,40:e3:d6:da:ba:22,133822027,180,225,133821847,133822027
19233,6,12,1,2412,-65,-91,26,40:e3:d6:da:ba:23,133822233,184,22,133822049,133822233
19234,6,12,1,2412,-64,-91,27,40:e3:d6:da:ba:24,133822460,176,51,133822284,133822460
19235,6,12,1,2412,-64,-91,27,40:e3:d6:da:ba:25,133822689,160,69,133822529,133822689
19236,6,6,1,2412,-65,-91,26,40:e3:d6:da:ba:26,133822908,380,-161,133822528,133822908
19237,6,6,1,2412,-76,-91,15,e6:aa:ea:c9:ea:33,133855006,408,31690,133854598,133855006
19238,6,6,1,2412,-76,-91,15,e6:aa:ea:c9:ea:33,133867123,408,11709,133866715,133867123
19239,6,6,1,2412,-77,-91,14,e6:aa:ea:c9:ea:33,133891354,408,23823,133890946,133891354
19240,6,12,1,2412,-89,-91,2,40:e3:d6:de:1e:60,133894865,156,3355,133894709,133894865
19241,6,6,1,2412,-88,-91,3,40:e3:d6:de:1e:61,133895071,368,-162,133894703,133895071
19242,6,12,1,2412,-87,-91,4,40:e3:d6:de:1e:64,133895928,172,685,133895756,133895928
19243,4,1,1,2412,-83,-91,8,b8:3a:5a:88:e6:e1,133912128,2376,13824,133909752,133912128
19244,6,12,1,2412,-67,-91,24,40:e3:d6:da:ba:20,133923825,160,11537,133923665,133923825
19245,6,6,1,2412,-66,-91,25,40:e3:d6:da:ba:21,133924035,368,-158,133923667,133924035
19246,6,12,1,2412,-67,-91,24,40:e3:d6:da:ba:22,133924422,180,207,133924242,133924422
19247,6,12,1,2412,-66,-91,25,40:e3:d6:da:ba:23,133924655,184,49,133924471,133924655
19248,6,12,1,2412,-67,-91,24,40:e3:d6:da:ba:24,133924864,176,33,133924688,133924864
19249,6,12,1,2412,-67,-91,24,40:e3:d6:da:ba:25,133925084,160,60,133924924,133925084
19250,6,6,1,2412,-67,-91,24,40:e3:d6:da:ba:26,133925303,380,-161,133924923,133925303
19251,4,1,1,2412,-87,-91,4,54:e4:3a:ec:fb:64,133981325,2160,53862,133979165,133981325
19252,4,1,1,2412,-84,-91,7,b8:3a:5a:88:e6:e0,134010137,2360,26452,134007777,134010137
19253,4,1,1,2412,-84,-91,7,b8:3a:5a:88:e6:e1,134012535,2376,22,134010159,134012535
19254,6,12,1,2412,-68,-91,23,40:e3:d6:da:ba:20,134026205,160,13510,134026045,134026205
19255,6,6,1,2412,-68,-91,23,40:e3:d6:da:ba:21,134026397,368,-176,134026029,134026397
19256,6,12,1,2412,-68,-91,23,40:e3:d6:da:ba:22,134026811,180,234,134026631,134026811
19257,6,12,1,2412,-68,-91,23,40:e3:d6:da:ba:23,134027025,184,30,134026841,134027025
19258,6,12,1,2412,-68,-91,23,40:e3:d6:da:ba:24,134027244,176,43,134027068,134027244
19259,6,12,1,2412,-68,-91,23,40:e3:d6:da:ba:25,134027547,160,143,134027387,134027547
19260,6,6,1,2412,-68,-91,23,40:e3:d6:da:ba:26,134027739,380,-188,134027359,134027739
19261,6,6,1,2412,-77,-91,14,e6:aa:ea:b7:4a:dd,134072662,408,44515,134072254,134072662
19262,4,1,1,2412,-84,-91,7,54:e4:3a:ec:fb:64,134083724,2160,8902,134081564,134083724
19263,6,6,1,2412,-77,-91,14,e6:aa:ea:b7:4a:dd,134085757,408,1625,134085349,134085757
19264,6,6,1,2412,-77,-91,14,e6:aa:ea:b7:4a:dd,134096893,408,10728,134096485,134096893
19265,6,12,1,2412,-87,-91,4,40:e3:d6:de:1e:60,134099649,156,2600,134099493,134099649
19266,6,6,1,2412,-88,-91,3,40:e3:d6:de:1e:61,134099846,368,-171,134099478,134099846
19267,6,6,1,2412,-85,-91,6,40:e3:d6:de:1e:66,134101125,380,899,134100745,134101125
19268,6,6,1,2412,-76,-91,15,e6:aa:ea:b7:4a:dd,134109014,408,7481,134108606,134109014
19269,6,12,1,2412,-88,-91,3,40:e3:d6:de:1e:63,134110907,156,1737,134110751,134110907
19270,6,12,1,2412,-87,-91,4,,134111076,32,137,134111044,134111076
19271,6,12,1,2412,-88,-91,3,,134111444,32,336,134111412,134111444
19272,6,6,1,2412,-67,-91,24,40:e3:d6:da:ba:21,134128877,368,17065,134128509,134128877
19273,6,12,1,2412,-67,-91,24,40:e3:d6:da:ba:22,134129282,180,225,134129102,134129282
19274,6,12,1,2412,-67,-91,24,40:e3:d6:da:ba:23,134129515,184,49,134129331,134129515
19275,6,12,1,2412,-67,-91,24,40:e3:d6:da:ba:24,134129892,176,201,134129716,134129892
19276,6,12,1,2412,-67,-91,24,40:e3:d6:da:ba:25,134130094,160,42,134129934,134130094
19277,4,1,1,2412,-82,-91,9,b8:3a:5a:88:e6:e0,134214713,2360,82259,134212353,134214713
19278,6,12,1,2412,-66,-91,25,40:e3:d6:da:ba:20,134231006,160,16133,134230846,134231006
19279,6,6,1,2412,-67,-91,24,40:e3:d6:da:ba:21,134231216,368,-158,134230848,134231216
19280,6,12,1,2412,-67,-91,24,40:e3:d6:da:ba:22,134231630,180,234,134231450,134231630
19281,6,12,1,2412,-68,-91,23,40:e3:d6:da:ba:23,134231853,184,39,134231669,134231853
19282,6,12,1,2412,-67,-91,24,40:e3:d6:da:ba:24,134232081,176,52,134231905,134232081
19283,6,12,1,2412,-67,-91,24,40:e3:d6:da:ba:25,134232310,160,69,134232150,134232310
19284,6,6,1,2412,-67,-91,24,40:e3:d6:da:ba:26,134232520,380,-170,134232140,134232520
19285,6,6,1,2412,-78,-91,13,e6:aa:ea:c9:ea:33,134296707,408,63779,134296299,134296707
19286,6,12,1,2412,-86,-91,5,40:e3:d6:de:1e:60,134304475,156,7612,134304319,134304475
19287,6,6,1,2412,-75,-91,16,e6:aa:ea:c9:ea:33,134308837,408,3954,134308429,134308837
19288,4,1,1,2412,-81,-91,10,b8:3a:5a:88:e6:e0,134317139,2360,5942,134314779,134317139
19289,6,12,1,2412,-67,-91,24,40:e3:d6:da:ba:20,134333421,160,16122,134333261,134333421
19290,6,6,1,2412,-67,-91,24,40:e3:d6:da:ba:21,134333613,368,-176,134333245,134333613
19291,6,12,1,2412,-67,-91,24,40:e3:d6:da:ba:22,134334000,180,207,134333820,134334000
19292,6,12,1,2412,-67,-91,24,40:e3:d6:da:ba:23,134334223,184,39,134334039,134334223
19293,4,1,1,2412,-79,-91,12,b8:3a:5a:88:e6:e0,134419515,2360,82932,134417155,134419515
19294,4,1,1,2412,-79,-91,12,b8:3a:5a:88:e6:e1,134422065,2376,174,134419689,134422065
19295,6,12,1,2412,-66,-91,25,40:e3:d6:da:ba:20,134435818,160,13593,134435658,134435818
19296,6,6,1,2412,-66,-91,25,40:e3:d6:da:ba:21,134436027,368,-159,134435659,134436027
19297,6,12,1,2412,-66,-91,25,40:e3:d6:da:ba:22,134436433,180,226,134436253,134436433
19298,6,12,1,2412,-66,-91,25,40:e3:d6:da:ba:25,134437103,160,510,134436943,134437103
19299,6,6,1,2412,-66,-91,25,40:e3:d6:da:ba:26,134437304,380,-179,134436924,134437304
19300,6,6,1,2412,-77,-91,14,e6:aa:ea:b7:4a:dd,134489922,408,52210,134489514,134489922
19301,6,6,1,2412,-77,-91,14,e6:aa:ea:b7:4a:dd,134502059,408,11729,134501651,134502059
19302,6,6,1,2412,-76,-91,15,e6:aa:ea:b7:4a:dd,134514160,408,11693,134513752,134514160
19303,4,1,1,2412,-78,-91,13,b8:3a:5a:88:e6:e0,134522320,2360,5800,134519960,134522320
19304,4,1,1,2412,-78,-91,13,b8:3a:5a:88:e6:e1,134524709,2376,13,134522333,134524709
19305,6,12,1,2412,-66,-91,25,40:e3:d6:da:ba:20,134538222,160,13353,134538062,134538222
19306,6,6,1,2412,-66,-91,25,40:e3:d6:da:ba:21,134538441,368,-149,134538073,134538441
19307,6,12,1,2412,-65,-91,26,40:e3:d6:da:ba:22,134538828,180,207,134538648,134538828
19308,6,12,1,2412,-65,-91,26,40:e3:d6:da:ba:23,134539060,184,48,134538876,134539060
19309,6,12,1,2412,-66,-91,25,40:e3:d6:da:ba:24,134539297,176,61,134539121,134539297
19310,6,12,1,2412,-66,-91,25,40:e3:d6:da:ba:25,134539507,160,50,134539347,134539507
19311,6,6,1,2412,-66,-91,25,40:e3:d6:da:ba:26,134539726,380,-161,134539346,134539726
19312,6,6,1,2412,-87,-91,4,40:e3:d6:da:c0:26,134613606,380,73500,134613226,134613606
19313,4,1,1,2412,-79,-91,12,b8:3a:5a:88:e6:e0,134624332,2360,8366,134621972,134624332
19314,4,1,1,2412,-78,-91,13,b8:3a:5a:88:e6:e1,134626721,2376,13,134624345,134626721
19315,6,12,1,2412,-65,-91,26,40:e3:d6:da:ba:20,134640635,160,13754,134640475,134640635
19316,6,6,1,2412,-65,-91,26,40:e3:d6:da:ba:21,134640845,368,-158,134640477,134640845
19317,6,12,1,2412,-65,-91,26,40:e3:d6:da:ba:22,134641250,180,225,134641070,134641250
19318,6,12,1,2412,-64,-91,27,40:e3:d6:da:ba:23,134641464,184,30,134641280,134641464
19319,6,12,1,2412,-65,-91,26,40:e3:d6:da:ba:24,134641683,176,43,134641507,134641683
19320,6,12,1,2412,-64,-91,27,40:e3:d6:da:ba:25,134641902,160,59,134641742,134641902
19321,6,6,1,2412,-64,-91,27,40:e3:d6:da:ba:26,134642185,380,-97,134641805,134642185
19322,4,1,1,2412,-79,-91,12,24:f6:77:10:02:c8,134644789,1064,1540,134643725,134644789
19323,4,1,1,2412,-78,-91,13,24:f6:77:10:02:c8,134655198,1064,9345,134654134,134655198
19324,6,12,1,2412,-65,-91,26,40:e3:d6:da:ba:20,134738395,136,83061,134738259,134738395
19325,6,6,1,2412,-73,-91,18,e6:aa:ea:c9:ea:33,134795348,408,56545,134794940,134795348
19326,4,1,1,2412,-83,-91,8,54:e4:3a:ec:fb:64,134801835,2160,4327,134799675,134801835
19327,6,6,1,2412,-73,-91,18,e6:aa:ea:c9:ea:33,134807471,408,5228,134807063,134807471
19328,6,12,1,2412,-88,-91,3,40:e3:d6:de:1e:60,134816473,156,8846,134816317,134816473
19329,6,6,1,2412,-88,-91,3,40:e3:d6:de:1e:61,134816661,368,-180,134816293,134816661
19330,4,1,1,2412,-79,-91,12,b8:3a:5a:88:e6:e0,134829119,2360,10098,134826759,134829119
19331,6,6,1,2412,-72,-91,19,e6:aa:ea:c9:ea:33,134843823,408,14296,134843415,134843823
19332,6,12,1,2412,-65,-91,26,40:e3:d6:da:ba:20,134845408,160,1425,134845248,134845408
19333,6,6,1,2412,-64,-91,27,40:e3:d6:da:ba:21,134845600,368,-176,134845232,134845600
19334,6,12,1,2412,-64,-91,27,40:e3:d6:da:ba:22,134845987,180,207,134845807,134845987
19335,6,12,1,2412,-65,-91,26,40:e3:d6:da:ba:23,134846193,184,22,134846009,134846193
19336,6,12,1,2412,-64,-91,27,40:e3:d6:da:ba:24,134846402,176,33,134846226,134846402
19337,6,12,1,2412,-64,-91,27,40:e3:d6:da:ba:25,134846622,160,60,134846462,134846622
19338,6,6,1,2412,-64,-91,27,40:e3:d6:da:ba:26,134846814,380,-188,134846434,134846814
19339,6,12,1,2412,-87,-91,4,40:e3:d6:de:1e:64,134919909,172,72923,134919737,134919909
19340,4,1,1,2412,-81,-91,10,b8:3a:5a:88:e6:e1,134933991,2376,11706,134931615,134933991
19341,6,12,1,2412,-65,-91,26,40:e3:d6:da:ba:20,134947835,160,13684,134947675,134947835
19342,6,6,1,2412,-65,-91,26,40:e3:d6:da:ba:21,134948045,368,-158,134947677,134948045
19343,6,12,1,2412,-65,-91,26,40:e3:d6:da:ba:22,134948450,180,225,134948270,134948450
19344,6,12,1,2412,-64,-91,27,40:e3:d6:da:ba:23,134948673,184,39,134948489,134948673
19345,4,1,1,2412,-82,-91,9,b8:3a:5a:88:e6:e0,135033916,2360,82883,135031556,135033916
19346,4,1,1,2412,-83,-91,8,b8:3a:5a:88:e6:e1,135036313,2376,21,135033937,135036313
19347,6,6,1,2412,-80,-91,11,e6:aa:ea:b7:4a:dd,135046662,408,9941,135046254,135046662
19348,6,12,1,2412,-66,-91,25,40:e3:d6:da:ba:20,135050216,160,3394,135050056,135050216
19349,6,6,1,2412,-66,-91,25,40:e3:d6:da:ba:21,135050426,368,-158,135050058,135050426
19350,6,12,1,2412,-66,-91,25,40:e3:d6:da:ba:22,135050840,180,234,135050660,135050840
19351,6,12,1,2412,-65,-91,26,40:e3:d6:da:ba:23,135051055,184,31,135050871,135051055
19352,6,12,1,2412,-66,-91,25,40:e3:d6:da:ba:24,135051264,176,33,135051088,135051264
19353,6,12,1,2412,-65,-91,26,40:e3:d6:da:ba:25,135051493,160,69,135051333,135051493
19354,6,6,1,2412,-65,-91,26,40:e3:d6:da:ba:26,135051712,380,-161,135051332,135051712
19355,6,12,1,2412,-85,-91,6,40:e3:d6:de:1e:60,135061487,136,9639,135061351,135061487
19356,6,6,1,2412,-83,-91,8,40:e3:d6:de:1e:61,135061663,348,-172,135061315,135061663
19357,6,12,1,2412,-87,-91,4,40:e3:d6:de:1e:63,135062275,156,456,135062119,135062275
19358,4,1,1,2412,-92,-91,-1,a6:e5:7c:28:b1:d3,135065555,944,2336,135064611,135065555
19359,4,1,1,2412,-91,-91,0,a6:e5:7c:28:b1:d3,135067837,944,1338,135066893,135067837
19360,4,1,1,2412,-89,-91,2,a4:e5:7c:28:b1:d3,135104918,688,36393,135104230,135104918
19361,4,1,1,2412,-84,-91,7,54:e4:3a:ec:fb:64,135107714,2160,636,135105554,135107714
19362,6,6,1,2412,-87,-91,4,40:e3:d6:de:1e:61,135123861,368,15779,135123493,135123861
19363,4,1,1,2412,-82,-91,9,b8:3a:5a:88:e6:e0,135136340,2360,10119,135133980,135136340
19364,4,1,1,2412,-84,-91,7,b8:3a:5a:88:e6:e1,135138934,2376,218,135136558,135138934
19365,4,1,1,2412,-90,-91,1,a6:e5:7c:28:b1:d3,135142244,944,2366,135141300,135142244
19366,6,12,1,2412,-67,-91,24,40:e3:d6:da:ba:20,135152610,160,10206,135152450,135152610
19367,6,6,1,2412,-67,-91,24,40:e3:d6:da:ba:21,135152820,368,-158,135152452,135152820
19368,6,12,1,2412,-67,-91,24,40:e3:d6:da:ba:22,135153216,180,216,135153036,135153216
19369,6,12,1,2412,-67,-91,24,40:e3:d6:da:ba:23,135153449,184,49,135153265,135153449
19370,6,12,1,2412,-67,-91,24,40:e3:d6:da:ba:24,135153676,176,51,135153500,135153676
19371,6,12,1,2412,-67,-91,24,40:e3:d6:da:ba:25,135153896,160,60,135153736,135153896
19372,6,6,1,2412,-67,-91,24,40:e3:d6:da:ba:26,135154087,380,-189,135153707,135154087
19373,4,1,1,2412,-82,-91,9,54:e4:3a:ec:fb:64,135210113,2160,53866,135207953,135210113
19374,6,6,1,2412,-71,-91,20,e6:aa:ea:c9:ea:33,135212632,408,2111,135212224,135212632
19375,6,6,1,2412,-71,-91,20,e6:aa:ea:c9:ea:33,135224747,408,11707,135224339,135224747
19376,6,12,1,2412,-87,-91,4,40:e3:d6:de:1e:60,135226075,156,1172,135225919,135226075
19377,6,6,1,2412,-87,-91,4,40:e3:d6:de:1e:61,135226263,368,-180,135225895,135226263
19378,6,6,1,2412,-71,-91,20,e6:aa:ea:c9:ea:33,135248993,408,22322,135248585,135248993
19379,6,12,1,2412,-68,-91,23,40:e3:d6:da:ba:20,135255020,160,5867,135254860,135255020
19380,6,6,1,2412,-67,-91,24,40:e3:d6:da:ba:21,135255239,368,-149,135254871,135255239
19381,6,12,1,2412,-67,-91,24,40:e3:d6:da:ba:22,135255644,180,225,135255464,135255644
19382,6,12,1,2412,-67,-91,24,40:e3:d6:da:ba:23,135255867,184,39,135255683,135255867
19383,6,12,1,2412,-67,-91,24,40:e3:d6:da:ba:24,135256077,176,34,135255901,135256077
19384,6,12,1,2412,-67,-91,24,40:e3:d6:da:ba:25,135256296,160,59,135256136,135256296
19385,6,6,1,2412,-67,-91,24,40:e3:d6:da:ba:26,135256497,380,-179,135256117,135256497
19386,6,6,1,2412,-71,-91,20,e6:aa:ea:c9:ea:33,135262661,408,5756,135262253,135262661
19387,6,12,1,2412,-86,-91,5,40:e3:d6:de:1e:64,135329561,172,66728,135329389,135329561
19388,6,12,1,2412,-86,-91,5,40:e3:d6:de:1e:65,135329767,156,50,135329611,135329767
19389,6,6,1,2412,-86,-91,5,40:e3:d6:de:1e:66,135329983,380,-164,135329603,135329983
19390,4,1,1,2412,-82,-91,9,b8:3a:5a:88:e6:e0,135341126,2360,8783,135338766,135341126
19391,6,12,1,2412,-68,-91,23,40:e3:d6:da:ba:20,135357425,160,16139,135357265,135357425
19392,6,6,1,2412,-67,-91,24,40:e3:d6:da:ba:21,135357617,368,-176,135357249,135357617
19393,6,12,1,2412,-67,-91,24,40:e3:d6:da:ba:22,135358004,180,207,135357824,135358004
19394,6,12,1,2412,-67,-91,24,40:e3:d6:da:ba:23,135358218,184,30,135358034,135358218
19395,6,12,1,2412,-67,-91,24,40:e3:d6:da:ba:24,135358428,176,34,135358252,135358428
19396,6,12,1,2412,-67,-91,24,40:e3:d6:da:ba:25,135358629,160,41,135358469,135358629
19397,6,6,1,2412,-67,-91,24,40:e3:d6:da:ba:26,135358848,380,-161,135358468,135358848
19398,6,6,1,2412,-84,-91,7,84:1b:5e:df:1b:99,135375473,80,16545,135375393,135375473
19399,6,12,1,2412,-87,-91,4,40:e3:d6:de:1e:60,135430869,156,55240,135430713,135430869
19400,6,6,1,2412,-87,-91,4,40:e3:d6:de:1e:61,135431057,368,-180,135430689,135431057
19401,6,12,1,2412,-86,-91,5,40:e3:d6:de:1e:64,135431904,172,675,135431732,135431904
19402,6,6,1,2412,-86,-91,5,40:e3:d6:de:1e:66,135432308,380,24,135431928,135432308
19403,4,1,1,2412,-88,-91,3,88:66:5a:28:ab:06,135444376,928,11140,135443448,135444376
19404,6,6,1,2412,-67,-91,24,40:e3:d6:da:ba:21,135452159,348,7435,135451811,135452159
19405,6,12,1,2412,-67,-91,24,40:e3:d6:da:ba:22,135452562,156,247,135452406,135452562
19406,6,12,1,2412,-67,-91,24,40:e3:d6:da:ba:23,135452779,156,61,135452623,135452779
19407,6,12,1,2412,-86,-91,5,,135452954,32,143,135452922,135452954
19408,6,12,1,2412,-67,-91,24,40:e3:d6:da:ba:25,135452997,136,-93,135452861,135452997
19409,6,12,1,2412,-86,-91,5,,135453151,32,122,135453119,135453151
19410,4,1,1,2412,-88,-91,3,88:66:5a:28:ab:06,135453777,928,-302,135452849,135453777
19411,6,12,1,2412,-67,-91,24,40:e3:d6:da:ba:20,135454666,136,753,135454530,135454666
19412,6,6,1,2412,-67,-91,24,40:e3:d6:da:ba:21,135454870,348,-144,135454522,135454870
19413,6,12,1,2412,-67,-91,24,40:e3:d6:da:ba:22,135455255,156,229,135455099,135455255
19414,6,12,1,2412,-67,-91,24,40:e3:d6:da:ba:25,135455672,136,281,135455536,135455672
19415,4,1,1,2412,-85,-91,6,54:e4:3a:ec:fb:64,135458560,2112,776,135456448,135458560
19416,6,6,1,2412,-67,-91,24,40:e3:d6:da:ba:21,135461065,368,2137,135460697,135461065
19417,6,12,1,2412,-67,-91,24,40:e3:d6:da:ba:22,135461452,180,207,135461272,135461452
19418,6,12,1,2412,-67,-91,24,40:e3:d6:da:ba:23,135461684,184,48,135461500,135461684
19419,6,12,1,2412,-66,-91,25,40:e3:d6:da:ba:25,135462131,160,287,135461971,135462131
19420,4,1,1,2412,-86,-91,5,54:e4:3a:ec:fb:64,135463056,2112,-1187,135460944,135463056
19421,4,1,1,2412,-83,-91,8,54:e4:3a:ec:fb:64,135465790,2112,622,135463678,135465790
19422,6,6,1,2412,-67,-91,24,40:e3:d6:da:ba:21,135475883,348,9745,135475535,135475883
19423,6,12,1,2412,-67,-91,24,40:e3:d6:da:ba:22,135476277,156,238,135476121,135476277
19424,6,12,1,2412,-67,-91,24,40:e3:d6:da:ba:23,135476476,156,43,135476320,135476476
19425,6,12,1,2412,-67,-91,24,40:e3:d6:da:ba:25,135476694,136,82,135476558,135476694
19426,6,12,1,2412,-67,-91,24,40:e3:d6:da:ba:20,135485197,136,8367,135485061,135485197
19427,6,6,1,2412,-67,-91,24,40:e3:d6:da:ba:21,135485392,348,-153,135485044,135485392
19428,6,12,1,2412,-67,-91,24,40:e3:d6:da:ba:23,135485977,156,429,135485821,135485977
19429,6,12,1,2412,-67,-91,24,40:e3:d6:da:ba:25,135486176,136,63,135486040,135486176
19430,6,6,1,2412,-73,-91,18,e6:aa:ea:c9:ea:33,135527589,408,41005,135527181,135527589
19431,6,12,1,2412,-86,-91,5,40:e3:d6:de:1e:60,135533255,156,5510,135533099,135533255
19432,6,6,1,2412,-87,-91,4,40:e3:d6:de:1e:61,135533442,368,-181,135533074,135533442
19433,6,6,1,2412,-86,-91,5,40:e3:d6:de:1e:66,135534684,380,862,135534304,135534684
19434,6,6,1,2412,-73,-91,18,e6:aa:ea:c9:ea:33,135539800,408,4708,135539392,135539800
19435,6,6,1,2412,-81,-91,10,e6:aa:ea:b7:4a:dd,135542044,408,1836,135541636,135542044
19436,6,6,1,2412,-73,-91,18,e6:aa:ea:c9:ea:33,135552400,408,9948,135551992,135552400
19437,6,12,1,2412,-67,-91,24,40:e3:d6:da:ba:20,135562226,160,9666,135562066,135562226
19438,6,6,1,2412,-67,-91,24,40:e3:d6:da:ba:21,135562427,368,-167,135562059,135562427
19439,6,12,1,2412,-67,-91,24,40:e3:d6:da:ba:22,135562823,180,216,135562643,135562823
19440,6,12,1,2412,-67,-91,24,40:e3:d6:da:ba:23,135563028,184,21,135562844,135563028
19441,6,12,1,2412,-67,-91,24,40:e3:d6:da:ba:24,135563256,176,52,135563080,135563256
19442,6,12,1,2412,-67,-91,24,40:e3:d6:da:ba:25,135563457,160,41,135563297,135563457
19443,6,6,1,2412,-67,-91,24,40:e3:d6:da:ba:26,135563649,380,-188,135563269,135563649
19444,6,6,1,2412,-73,-91,18,e6:aa:ea:c9:ea:33,135564138,408,81,135563730,135564138
19445,6,6,1,2412,-81,-91,10,e6:aa:ea:b7:4a:dd,135566277,408,1731,135565869,135566277
19446,4,1,1,2412,-92,-91,-1,a6:e5:7c:28:b1:d3,135627730,944,60509,135626786,135627730
19447,4,1,1,2412,-90,-91,1,a6:e5:7c:28:b1:d3,135628817,944,143,135627873,135628817
19448,4,1,1,2412,-93,-91,-2,a6:e5:7c:28:b1:d3,135629904,944,143,135628960,135629904
19449,4,1,1,2412,-93,-91,-2,a6:e5:7c:28:b1:d3,135630982,944,134,135630038,135630982
19450,4,1,1,2412,-91,-91,0,a6:e5:7c:28:b1:d3,135632087,944,161,135631143,135632087
19451,4,1,1,2412,-91,-91,0,a6:e5:7c:28:b1:d3,135633540,944,509,135632596,135633540
19452,4,1,1,2412,-89,-91,2,a6:e5:7c:28:b1:d3,135645614,944,11130,135644670,135645614
19453,6,12,1,2412,-86,-91,5,40:e3:d6:de:1e:60,135653203,156,7433,135653047,135653203
19454,6,12,1,2412,-87,-91,4,40:e3:d6:de:1e:62,135655221,176,1842,135655045,135655221
19455,6,12,1,2412,-87,-91,4,40:e3:d6:de:1e:63,135657667,180,2266,135657487,135657667
19456,6,12,1,2412,-87,-91,4,40:e3:d6:de:1e:64,135657882,172,43,135657710,135657882
19457,6,12,1,2412,-87,-91,4,40:e3:d6:de:1e:65,135658106,156,68,135657950,135658106
19458,6,6,1,2412,-87,-91,4,40:e3:d6:de:1e:66,135658321,380,-165,135657941,135658321
19459,6,12,1,2412,-66,-91,25,40:e3:d6:da:ba:20,135664612,160,6131,135664452,135664612
19460,6,6,1,2412,-66,-91,25,40:e3:d6:da:ba:21,135664804,368,-176,135664436,135664804
19461,6,12,1,2412,-66,-91,25,40:e3:d6:da:ba:22,135665218,180,234,135665038,135665218
19462,6,12,1,2412,-66,-91,25,40:e3:d6:da:ba:23,135665450,184,48,135665266,135665450
19463,6,12,1,2412,-66,-91,25,40:e3:d6:da:ba:24,135665660,176,34,135665484,135665660
19464,6,12,1,2412,-66,-91,25,40:e3:d6:da:ba:25,135665888,160,68,135665728,135665888
19465,6,6,1,2412,-66,-91,25,40:e3:d6:da:ba:26,135666107,380,-161,135665727,135666107
19466,4,1,1,2412,-85,-91,6,54:e4:3a:ec:fb:64,135722109,2160,53842,135719949,135722109
19467,6,12,1,2412,-86,-91,5,40:e3:d6:de:1e:63,135738893,180,16604,135738713,135738893
19468,6,12,1,2412,-87,-91,4,40:e3:d6:de:1e:64,135739108,172,43,135738936,135739108
19469,6,6,1,2412,-86,-91,5,40:e3:d6:de:1e:66,135739520,380,32,135739140,135739520
19470,4,1,1,2412,-79,-91,12,b8:3a:5a:88:e6:e0,135750718,2360,8838,135748358,135750718
19471,6,12,1,2412,-65,-91,26,40:e3:d6:da:ba:20,135767018,160,16140,135766858,135767018
19472,6,6,1,2412,-65,-91,26,40:e3:d6:da:ba:21,135767228,368,-158,135766860,135767228
19473,6,12,1,2412,-65,-91,26,40:e3:d6:da:ba:22,135767633,180,225,135767453,135767633
19474,6,12,1,2412,-64,-91,27,40:e3:d6:da:ba:23,135767848,184,31,135767664,135767848
19475,6,12,1,2412,-65,-91,26,40:e3:d6:da:ba:24,135768057,176,33,135767881,135768057
19476,6,12,1,2412,-65,-91,26,40:e3:d6:da:ba:25,135768259,160,42,135768099,135768259
19477,6,6,1,2412,-65,-91,26,40:e3:d6:da:ba:26,135768451,380,-188,135768071,135768451
19478,6,6,1,2412,-79,-91,12,e6:aa:ea:b7:4a:dd,135832383,408,63524,135831975,135832383
19479,6,12,1,2412,-87,-91,4,40:e3:d6:de:1e:60,135840480,156,7941,135840324,135840480
19480,6,6,1,2412,-87,-91,4,40:e3:d6:de:1e:61,135840678,368,-170,135840310,135840678
19481,6,12,1,2412,-85,-91,6,40:e3:d6:de:1e:64,135841551,172,701,135841379,135841551
19482,6,6,1,2412,-86,-91,5,40:e3:d6:de:1e:66,135841964,380,33,135841584,135841964
19483,6,6,1,2412,-79,-91,12,e6:aa:ea:b7:4a:dd,135844507,408,2135,135844099,135844507
19484,6,12,1,2412,-64,-91,27,40:e3:d6:da:ba:20,135869432,160,24765,135869272,135869432
19485,6,6,1,2412,-63,-91,28,40:e3:d6:da:ba:21,135869651,368,-149,135869283,135869651
19486,6,12,1,2412,-63,-91,28,40:e3:d6:da:ba:22,135870047,180,216,135869867,135870047
19487,6,12,1,2412,-64,-91,27,40:e3:d6:da:ba:23,135870280,184,49,135870096,135870280
19488,6,12,1,2412,-63,-91,28,40:e3:d6:da:ba:25,135870736,160,296,135870576,135870736
19489,6,6,1,2412,-63,-91,28,40:e3:d6:da:ba:26,135870946,380,-170,135870566,135870946
19490,4,1,1,2412,-91,-91,0,,135934077,304,62827,135933773,135934077
19491,6,6,1,2412,-87,-91,4,40:e3:d6:de:1e:66,135944338,380,9881,135943958,135944338
19492,4,1,1,2412,-79,-91,12,b8:3a:5a:88:e6:e0,135955540,2360,8842,135953180,135955540
19493,4,1,1,2412,-88,-91,3,f8:89:d2:65:d2:3b,136008141,1048,51553,136007093,136008141
19494,6,12,1,2412,-63,-91,28,40:e3:d6:da:ba:20,136011593,136,3316,136011457,136011593
19495,6,12,1,2412,-62,-91,29,40:e3:d6:da:ba:25,136012572,136,843,136012436,136012572
19496,4,1,1,2412,-85,-91,6,54:e4:3a:ec:fb:64,136015232,2112,548,136013120,136015232
19497,4,1,1,2412,-85,-91,6,54:e4:3a:ec:fb:64,136021034,2112,3690,136018922,136021034
19498,4,1,1,2412,-84,-91,7,54:e4:3a:ec:fb:64,136029307,2160,6113,136027147,136029307
19499,6,12,1,2412,-86,-91,5,40:e3:d6:de:1e:60,136045258,156,15795,136045102,136045258
19500,6,6,1,2412,-87,-91,4,40:e3:d6:de:1e:61,136045446,368,-180,136045078,136045446
19501,6,6,1,2412,-73,-91,18,e6:aa:ea:c9:ea:33,136047520,408,1666,136047112,136047520
19502,4,1,1,2412,-80,-91,11,b8:3a:5a:88:e6:e0,136058203,2360,8323,136055843,136058203
19503,4,1,1,2412,-78,-91,13,b8:3a:5a:88:e6:e1,136060754,2376,175,136058378,136060754
19504,6,6,1,2412,-73,-91,18,e6:aa:ea:c9:ea:33,136071973,408,10811,136071565,136071973
19505,6,12,1,2412,-62,-91,29,40:e3:d6:da:ba:20,136074218,160,2085,136074058,136074218
19506,6,6,1,2412,-62,-91,29,40:e3:d6:da:ba:21,136074410,368,-176,136074042,136074410
19507,6,12,1,2412,-62,-91,29,40:e3:d6:da:ba:22,136074797,180,207,136074617,136074797
19508,6,12,1,2412,-62,-91,29,40:e3:d6:da:ba:23,136075029,184,48,136074845,136075029
19509,6,12,1,2412,-62,-91,29,40:e3:d6:da:ba:24,136075239,176,34,136075063,136075239
19510,6,12,1,2412,-62,-91,29,40:e3:d6:da:ba:25,136075441,160,42,136075281,136075441
19511,6,6,1,2412,-62,-91,29,40:e3:d6:da:ba:26,136075659,380,-162,136075279,136075659
19512,6,12,1,2412,-88,-91,3,40:e3:d6:de:1e:60,136147668,156,71853,136147512,136147668
19513,6,6,1,2412,-87,-91,4,40:e3:d6:de:1e:61,136147873,368,-163,136147505,136147873
19514,6,6,1,2412,-62,-91,29,40:e3:d6:da:ba:21,136176845,368,28604,136176477,136176845
19515,6,12,1,2412,-62,-91,29,40:e3:d6:da:ba:22,136177232,180,207,136177052,136177232
19516,6,12,1,2412,-62,-91,29,40:e3:d6:da:ba:23,136177446,184,30,136177262,136177446
19517,6,12,1,2412,-62,-91,29,40:e3:d6:da:ba:24,136177665,176,43,136177489,136177665
19518,6,12,1,2412,-62,-91,29,40:e3:d6:da:ba:25,136177875,160,50,136177715,136177875
19519,6,6,1,2412,-62,-91,29,40:e3:d6:da:ba:26,136178094,380,-161,136177714,136178094
19520,4,1,1,2412,-82,-91,9,54:e4:3a:ec:fb:64,136234104,2160,53850,136231944,136234104
19521,4,1,1,2412,-79,-91,12,b8:3a:5a:88:e6:e0,136262719,2360,26255,136260359,136262719
19522,4,1,1,2412,-78,-91,13,b8:3a:5a:88:e6:e1,136265117,2376,22,136262741,136265117
19523,6,12,1,2412,-63,-91,28,40:e3:d6:da:ba:20,136279023,160,13746,136278863,136279023
19524,6,6,1,2412,-63,-91,28,40:e3:d6:da:ba:21,136279242,368,-149,136278874,136279242
19525,6,12,1,2412,-63,-91,28,40:e3:d6:da:ba:22,136279629,180,207,136279449,136279629
19526,6,12,1,2412,-63,-91,28,40:e3:d6:da:ba:23,136279852,184,39,136279668,136279852
19527,6,12,1,2412,-63,-91,28,40:e3:d6:da:ba:24,136280080,176,52,136279904,136280080
19528,6,12,1,2412,-63,-91,28,40:e3:d6:da:ba:25,136280290,160,50,136280130,136280290
19529,6,6,1,2412,-82,-91,9,e6:aa:ea:b7:4a:dd,136351385,408,70687,136350977,136351385
19530,6,12,1,2412,-87,-91,4,40:e3:d6:de:1e:60,136352459,156,918,136352303,136352459
19531,6,6,1,2412,-88,-91,3,40:e3:d6:de:1e:61,136352647,368,-180,136352279,136352647
19532,4,1,1,2412,-78,-91,13,b8:3a:5a:88:e6:e0,136365140,2360,10133,136362780,136365140
19533,4,1,1,2412,-78,-91,13,b8:3a:5a:88:e6:e1,136367529,2376,13,136365153,136367529
19534,6,6,1,2412,-81,-91,10,e6:aa:ea:b7:4a:dd,136375626,408,7689,136375218,136375626
19535,6,12,1,2412,-63,-91,28,40:e3:d6:da:ba:20,136381439,160,5653,136381279,136381439
19536,6,6,1,2412,-64,-91,27,40:e3:d6:da:ba:21,136381639,368,-168,136381271,136381639
19537,6,12,1,2412,-63,-91,28,40:e3:d6:da:ba:22,136382054,180,235,136381874,136382054
19538,6,12,1,2412,-63,-91,28,40:e3:d6:da:ba:23,136382268,184,30,136382084,136382268
19539,6,12,1,2412,-63,-91,28,40:e3:d6:da:ba:24,136382495,176,51,136382319,136382495
19540,6,12,1,2412,-63,-91,28,40:e3:d6:da:ba:25,136382715,160,60,136382555,136382715
19541,6,6,1,2412,-63,-91,28,40:e3:d6:da:ba:26,136382907,380,-188,136382527,136382907
19542,6,6,1,2412,-81,-91,10,e6:aa:ea:b7:4a:dd,136387848,408,4533,136387440,136387848
19543,6,6,1,2412,-81,-91,10,e6:aa:ea:b7:4a:dd,136399865,408,11609,136399457,136399865
19544,6,6,1,2412,-87,-91,4,78:8a:20:fa:27:f9,136434143,88,34190,136434055,136434143
19545,6,12,1,2412,-87,-91,4,,136434754,32,579,136434722,136434754
19546,4,1,1,2412,-84,-91,7,54:e4:3a:ec:fb:64,136441325,2160,4411,136439165,136441325
19547,6,12,1,2412,-86,-91,5,40:e3:d6:de:1e:60,136454870,156,13389,136454714,136454870
19548,6,6,1,2412,-87,-91,4,40:e3:d6:da:c0:26,136457001,380,1751,136456621,136457001
19549,4,1,1,2412,-79,-91,12,b8:3a:5a:88:e6:e0,136469088,2360,9727,136466728,136469088
19550,4,1,1,2412,-79,-91,12,b8:3a:5a:88:e6:e1,136471495,2376,31,136469119,136471495
19551,6,6,1,2412,-62,-91,29,40:e3:d6:da:ba:21,136484032,368,12169,136483664,136484032
19552,4,1,1,2412,-85,-91,6,54:e4:3a:ec:fb:64,136541399,2160,55207,136539239,136541399
19553,6,12,1,2412,-88,-91,3,40:e3:d6:de:1e:60,136557265,156,15710,136557109,136557265
19554,6,6,1,2412,-88,-91,3,40:e3:d6:de:1e:61,136557479,368,-154,136557111,136557479
19555,6,6,1,2412,-69,-91,22,e6:aa:ea:c9:ea:33,136568287,408,10400,136567879,136568287
19556,4,1,1,2412,-76,-91,15,b8:3a:5a:88:e6:e0,136569920,2360,-727,136567560,136569920
19557,6,6,1,2412,-69,-91,22,e6:aa:ea:c9:ea:33,136580403,408,10075,136579995,136580403
19558,6,12,1,2412,-61,-91,30,40:e3:d6:da:ba:20,136586241,160,5678,136586081,136586241
19559,6,6,1,2412,-61,-91,30,40:e3:d6:da:ba:21,136586451,368,-158,136586083,136586451
19560,6,12,1,2412,-60,-91,31,40:e3:d6:da:ba:22,136586838,180,207,136586658,136586838
19561,6,12,1,2412,-60,-91,31,40:e3:d6:da:ba:23,136587043,184,21,136586859,136587043
19562,6,12,1,2412,-60,-91,31,40:e3:d6:da:ba:24,136587280,176,61,136587104,136587280
19563,6,12,1,2412,-61,-91,30,40:e3:d6:da:ba:25,136587481,160,41,136587321,136587481
19564,6,6,1,2412,-60,-91,31,40:e3:d6:da:ba:26,136587716,380,-145,136587336,136587716
19565,6,6,1,2412,-69,-91,22,e6:aa:ea:c9:ea:33,136592532,408,4408,136592124,136592532
19566,6,6,1,2412,-69,-91,22,e6:aa:ea:c9:ea:33,136604656,408,11716,136604248,136604656
19567,6,6,1,2412,-69,-91,22,e6:aa:ea:c9:ea:33,136616791,408,11727,136616383,136616791
19568,6,12,1,2412,-84,-91,7,40:e3:d6:da:bb:60,136649879,960,32128,136648919,136649879
19569,6,12,1,2412,-90,-91,1,40:e3:d6:de:1e:60,136659668,156,9633,136659512,136659668
19570,6,12,1,2412,-62,-91,29,40:e3:d6:da:ba:20,136688644,160,28816,136688484,136688644
19571,6,6,1,2412,-62,-91,29,40:e3:d6:da:ba:21,136688854,368,-158,136688486,136688854
19572,6,12,1,2412,-62,-91,29,40:e3:d6:da:ba:22,136689250,180,216,136689070,136689250
19573,6,12,1,2412,-62,-91,29,40:e3:d6:da:ba:23,136689455,184,21,136689271,136689455
19574,6,12,1,2412,-62,-91,29,40:e3:d6:da:ba:24,136689674,176,43,136689498,136689674
19575,6,12,1,2412,-63,-91,28,40:e3:d6:da:ba:25,136689885,160,51,136689725,136689885
19576,6,6,1,2412,-62,-91,29,40:e3:d6:da:ba:26,136690094,380,-171,136689714,136690094
19577,6,12,1,2412,-64,-91,27,40:e3:d6:da:ba:20,136718070,136,27840,136717934,136718070
19578,6,6,1,2412,-64,-91,27,40:e3:d6:da:ba:21,136718247,348,-171,136717899,136718247
19579,6,12,1,2412,-64,-91,27,40:e3:d6:da:ba:23,136720629,156,2226,136720473,136720629
19580,6,12,1,2412,-64,-91,27,40:e3:d6:da:ba:25,136720829,136,64,136720693,136720829
19581,4,1,1,2412,-86,-91,5,54:e4:3a:ec:fb:64,136721512,2112,-1429,136719400,136721512
19582,4,1,1,2412,-78,-91,13,b8:3a:5a:88:e6:e0,136774730,2360,50858,136772370,136774730
19583,4,1,1,2412,-80,-91,11,b8:3a:5a:88:e6:e1,136777127,2376,21,136774751,136777127
19584,6,6,1,2412,-83,-91,8,e6:aa:ea:b7:4a:dd,136781083,408,3548,136780675,136781083
19585,6,12,1,2412,-62,-91,29,40:e3:d6:da:ba:20,136791043,160,9800,136790883,136791043
19586,6,6,1,2412,-62,-91,29,40:e3:d6:da:ba:21,136791244,368,-167,136790876,136791244
19587,6,12,1,2412,-62,-91,29,40:e3:d6:da:ba:22,136791658,180,234,136791478,136791658
19588,6,12,1,2412,-62,-91,29,40:e3:d6:da:ba:23,136791863,184,21,136791679,136791863
19589,6,6,1,2412,-84,-91,7,e6:aa:ea:b7:4a:dd,136793209,408,938,136792801,136793209
19590,6,12,1,2412,-86,-91,5,40:e3:d6:de:1e:60,136864466,156,71101,136864310,136864466
19591,6,6,1,2412,-86,-91,5,40:e3:d6:de:1e:61,136864672,368,-162,136864304,136864672
19592,6,12,1,2412,-65,-91,26,40:e3:d6:da:ba:20,136893418,160,28586,136893258,136893418
19593,6,6,1,2412,-65,-91,26,40:e3:d6:da:ba:21,136893628,368,-158,136893260,136893628
19594,6,12,1,2412,-65,-91,26,40:e3:d6:da:ba:22,136894033,180,225,136893853,136894033
19595,6,12,1,2412,-65,-91,26,40:e3:d6:da:ba:25,136894677,160,484,136894517,136894677
19596,6,6,1,2412,-65,-91,26,40:e3:d6:da:ba:26,136894887,380,-170,136894507,136894887
19597,4,1,1,2412,-89,-91,2,,136915745,304,20554,136915441,136915745
19598,4,1,1,2412,-84,-91,7,54:e4:3a:ec:fb:64,136950899,2160,32994,136948739,136950899
19599,6,12,1,2412,-63,-91,28,40:e3:d6:da:ba:20,136958665,136,7630,136958529,136958665
19600,6,6,1,2412,-63,-91,28,40:e3:d6:da:ba:21,136958876,348,-137,136958528,136958876
19601,6,12,1,2412,-63,-91,28,40:e3:d6:da:ba:22,136959252,156,220,136959096,136959252
19602,6,12,1,2412,-63,-91,28,40:e3:d6:da:ba:23,136959470,156,62,136959314,136959470
19603,6,12,1,2412,-63,-91,28,40:e3:d6:da:ba:25,136959660,136,54,136959524,136959660
19604,6,12,1,2412,-88,-91,3,40:e3:d6:de:1e:60,136966865,156,7049,136966709,136966865
19605,6,6,1,2412,-87,-91,4,40:e3:d6:de:1e:61,136967080,368,-153,136966712,136967080
19606,4,1,1,2412,-81,-91,10,b8:3a:5a:88:e6:e0,136979523,2360,10083,136977163,136979523
19607,4,1,1,2412,-80,-91,11,b8:3a:5a:88:e6:e1,136981929,2376,30,136979553,136981929
19608,6,12,1,2412,-62,-91,29,40:e3:d6:da:ba:20,136995820,160,13731,136995660,136995820
19609,6,6,1,2412,-74,-91,17,e6:aa:ea:c9:ea:33,137010153,408,13925,137009745,137010153
19610,6,6,1,2412,-74,-91,17,e6:aa:ea:c9:ea:33,137022268,408,11707,137021860,137022268
19611,6,6,1,2412,-88,-91,3,40:e3:d6:de:1e:61,137069463,368,46827,137069095,137069463
19612,6,6,1,2412,-88,-91,3,40:e3:d6:de:1e:66,137070723,380,880,137070343,137070723
19613,4,1,1,2412,-82,-91,9,b8:3a:5a:88:e6:e0,137081926,2360,8843,137079566,137081926
19614,6,12,1,2412,-66,-91,25,40:e3:d6:da:ba:20,137098233,160,16147,137098073,137098233
19615,6,6,1,2412,-66,-91,25,40:e3:d6:da:ba:21,137098425,368,-176,137098057,137098425
19616,6,12,1,2412,-66,-91,25,40:e3:d6:da:ba:22,137098812,180,207,137098632,137098812
19617,6,12,1,2412,-66,-91,25,40:e3:d6:da:ba:23,137099036,184,40,137098852,137099036
19618,6,12,1,2412,-66,-91,25,40:e3:d6:da:ba:24,137099272,176,60,137099096,137099272
19619,6,12,1,2412,-66,-91,25,40:e3:d6:da:ba:25,137099492,160,60,137099332,137099492
19620,6,6,1,2412,-66,-91,25,40:e3:d6:da:ba:26,137099684,380,-188,137099304,137099684
19621,4,1,1,2412,-85,-91,6,54:e4:3a:ec:fb:64,137155703,2160,53859,137153543,137155703
19622,6,12,1,2412,-90,-91,1,40:e3:d6:de:1e:60,137171665,156,15806,137171509,137171665
19623,4,1,1,2412,-81,-91,10,b8:3a:5a:88:e6:e0,137184337,2360,10312,137181977,137184337
19624,4,1,1,2412,-81,-91,10,b8:3a:5a:88:e6:e1,137186717,2376,4,137184341,137186717
19625,6,6,1,2412,-85,-91,6,e6:aa:ea:b7:4a:dd,137198779,408,11654,137198371,137198779
19626,6,12,1,2412,-66,-91,25,40:e3:d6:da:ba:20,137200626,160,1687,137200466,137200626
19627,6,6,1,2412,-65,-91,26,40:e3:d6:da:ba:21,137200836,368,-158,137200468,137200836
19628,6,12,1,2412,-66,-91,25,40:e3:d6:da:ba:22,137201250,180,234,137201070,137201250
19629,6,12,1,2412,-66,-91,25,40:e3:d6:da:ba:23,137201482,184,48,137201298,137201482
19630,6,12,1,2412,-65,-91,26,40:e3:d6:da:ba:24,137201710,176,52,137201534,137201710
19631,6,12,1,2412,-66,-91,25,40:e3:d6:da:ba:25,137201921,160,51,137201761,137201921
19632,6,6,1,2412,-65,-91,26,40:e3:d6:da:ba:26,137202140,380,-161,137201760,137202140
19633,4,1,1,2412,-51,-91,40,54:e4:3a:ec:fb:64,137206197,2112,1945,137204085,137206197
19634,6,12,1,2412,-66,-91,25,40:e3:d6:da:ba:20,137208486,136,2153,137208350,137208486
19635,6,6,1,2412,-66,-91,25,40:e3:d6:da:ba:21,137208690,348,-144,137208342,137208690
19636,6,12,1,2412,-66,-91,25,40:e3:d6:da:ba:22,137209084,156,238,137208928,137209084
19637,6,12,1,2412,-66,-91,25,40:e3:d6:da:ba:23,137209301,156,61,137209145,137209301
19638,6,12,1,2412,-66,-91,25,40:e3:d6:da:ba:25,137209501,136,64,137209365,137209501
19639,6,6,1,2412,-83,-91,8,e6:aa:ea:b7:4a:dd,137223006,408,13097,137222598,137223006
19640,4,1,1,2412,-81,-91,10,54:e4:3a:ec:fb:64,137229564,2112,4446,137227452,137229564
19641,6,6,1,2412,-89,-91,2,40:e3:d6:de:1e:61,137274257,368,44325,137273889,137274257
19642,6,12,1,2412,-87,-91,4,40:e3:d6:de:1e:64,137275106,172,677,137274934,137275106
19643,6,12,1,2412,-87,-91,4,40:e3:d6:de:1e:65,137275321,156,59,137275165,137275321
19644,6,6,1,2412,-86,-91,5,40:e3:d6:de:1e:66,137275509,380,-192,137275129,137275509
19645,4,1,1,2412,-93,-91,-2,42:a4:3c:1b:2e:81,137281491,1128,4854,137280363,137281491
19646,6,12,1,2412,-74,-91,17,40:e3:d6:da:c6:e0,137289871,960,7420,137288911,137289871
19647,6,12,1,2412,-61,-91,30,40:e3:d6:da:ba:20,137303019,160,12988,137302859,137303019
19648,6,12,1,2412,-61,-91,30,40:e3:d6:da:ba:22,137303757,180,558,137303577,137303757
19649,6,12,1,2412,-61,-91,30,40:e3:d6:da:ba:23,137304095,184,154,137303911,137304095
19650,6,12,1,2412,-61,-91,30,40:e3:d6:da:ba:24,137304615,176,344,137304439,137304615
19651,6,12,1,2412,-61,-91,30,40:e3:d6:da:ba:25,137304816,160,41,137304656,137304816
19652,4,1,1,2412,-90,-91,1,a6:e5:7c:28:b1:d3,137348879,992,43071,137347887,137348879
19653,4,1,1,2412,-87,-91,4,54:e4:3a:ec:fb:64,137373806,2112,22815,137371694,137373806
19654,6,12,1,2412,-86,-91,5,40:e3:d6:de:1e:60,137376487,156,2525,137376331,137376487
19655,6,6,1,2412,-87,-91,4,40:e3:d6:de:1e:61,137376684,368,-171,137376316,137376684
19656,6,12,1,2412,-86,-91,5,40:e3:d6:de:1e:65,137377694,156,854,137377538,137377694
19657,4,1,1,2412,-81,-91,10,b8:3a:5a:88:e6:e0,137390340,2360,10286,137387980,137390340
19658,4,1,1,2412,-81,-91,10,b8:3a:5a:88:e6:e1,137392719,2376,3,137390343,137392719
19659,6,6,1,2412,-79,-91,12,e6:aa:ea:c9:ea:33,137403542,408,10415,137403134,137403542
19660,6,12,1,2412,-62,-91,29,40:e3:d6:da:ba:20,137405420,160,1718,137405260,137405420
19661,6,6,1,2412,-63,-91,28,40:e3:d6:da:ba:21,137405612,368,-176,137405244,137405612
19662,6,12,1,2412,-63,-91,28,40:e3:d6:da:ba:22,137406017,180,225,137405837,137406017
19663,6,12,1,2412,-63,-91,28,40:e3:d6:da:ba:23,137406223,184,22,137406039,137406223
19664,6,12,1,2412,-63,-91,28,40:e3:d6:da:ba:24,137406450,176,51,137406274,137406450
19665,6,12,1,2412,-63,-91,28,40:e3:d6:da:ba:25,137406679,160,69,137406519,137406679
19666,6,6,1,2412,-63,-91,28,40:e3:d6:da:ba:26,137406889,380,-170,137406509,137406889
19667,6,6,1,2412,-78,-91,13,e6:aa:ea:c9:ea:33,137415572,408,8275,137415164,137415572
19668,4,1,1,2412,-93,-91,-2,,137420925,304,5049,137420621,137420925
19669,6,6,1,2412,-77,-91,14,e6:aa:ea:c9:ea:33,137451935,408,30602,137451527,137451935
19670,4,1,1,2412,-86,-91,5,54:e4:3a:ec:fb:64,137463026,2160,8931,137460866,137463026
19671,6,12,1,2412,-88,-91,3,40:e3:d6:de:1e:60,137478874,156,15692,137478718,137478874
19672,6,6,1,2412,-87,-91,4,40:e3:d6:de:1e:61,137479062,368,-180,137478694,137479062
19673,6,12,1,2412,-87,-91,4,40:e3:d6:de:1e:60,137489542,136,10344,137489406,137489542
19674,6,6,1,2412,-88,-91,3,40:e3:d6:de:1e:61,137489728,348,-162,137489380,137489728
19675,6,12,1,2412,-88,-91,3,40:e3:d6:de:1e:62,137490121,156,237,137489965,137490121
19676,6,12,1,2412,-87,-91,4,40:e3:d6:de:1e:63,137490312,156,35,137490156,137490312
19677,6,12,1,2412,-87,-91,4,40:e3:d6:de:1e:65,137490530,136,82,137490394,137490530
19678,4,1,1,2412,-82,-91,9,b8:3a:5a:88:e6:e0,137491560,2360,-1330,137489200,137491560
19679,4,1,1,2412,-83,-91,8,b8:3a:5a:88:e6:e1,137494510,2376,574,137492134,137494510
19680,6,6,1,2412,-82,-91,9,e6:aa:ea:b7:4a:dd,137501817,408,6899,137501409,137501817
19681,4,1,1,2412,-83,-91,8,54:e4:3a:ec:fb:64,137503640,2112,-289,137501528,137503640
19682,6,12,1,2412,-63,-91,28,40:e3:d6:da:ba:20,137508590,160,4790,137508430,137508590
19683,6,6,1,2412,-64,-91,27,40:e3:d6:da:ba:21,137508800,368,-158,137508432,137508800
19684,6,12,1,2412,-63,-91,28,40:e3:d6:da:ba:22,137509187,180,207,137509007,137509187
19685,6,12,1,2412,-63,-91,28,40:e3:d6:da:ba:23,137509410,184,39,137509226,137509410
19686,6,12,1,2412,-63,-91,28,40:e3:d6:da:ba:24,137509629,176,43,137509453,137509629
19687,6,12,1,2412,-63,-91,28,40:e3:d6:da:ba:25,137509849,160,60,137509689,137509849
19688,6,6,1,2412,-64,-91,27,40:e3:d6:da:ba:26,137510068,380,-161,137509688,137510068
19689,4,1,1,2412,-85,-91,6,54:e4:3a:ec:fb:64,137513229,2112,1049,137511117,137513229
19690,6,6,1,2412,-81,-91,10,e6:aa:ea:b7:4a:dd,137515774,408,2137,137515366,137515774
19691,6,6,1,2412,-84,-91,7,e6:aa:ea:b7:4a:dd,137538162,408,21980,137537754,137538162
19692,4,1,1,2412,-87,-91,4,54:e4:3a:ec:fb:64,137565293,2160,24971,137563133,137565293
19693,4,1,1,2412,-88,-91,3,b8:3a:5a:88:e6:e0,137596190,2360,28537,137593830,137596190
19694,4,1,1,2412,-88,-91,3,b8:3a:5a:88:e6:e1,137601842,2376,3276,137599466,137601842
19695,6,12,1,2412,-62,-91,29,40:e3:d6:da:ba:20,137610246,160,8244,137610086,137610246
19696,6,6,1,2412,-62,-91,29,40:e3:d6:da:ba:21,137610456,368,-158,137610088,137610456
19697,6,12,1,2412,-62,-91,29,40:e3:d6:da:ba:22,137610852,180,216,137610672,137610852
19698,6,12,1,2412,-62,-91,29,40:e3:d6:da:ba:23,137611057,184,21,137610873,137611057
19699,6,12,1,2412,-62,-91,29,40:e3:d6:da:ba:24,137611294,176,61,137611118,137611294
19700,6,12,1,2412,-62,-91,29,40:e3:d6:da:ba:25,137611522,160,68,137611362,137611522
19701,6,6,1,2412,-62,-91,29,40:e3:d6:da:ba:26,137611732,380,-170,137611352,137611732
19702,4,1,1,2412,-83,-91,8,b8:3a:5a:88:e6:e0,137696322,2360,82230,137693962,137696322
19703,4,1,1,2412,-86,-91,5,b8:3a:5a:88:e6:e1,137698720,2376,22,137696344,137698720
19704,6,12,1,2412,-60,-91,31,40:e3:d6:da:ba:20,137712622,160,13742,137712462,137712622
19705,6,6,1,2412,-59,-91,32,40:e3:d6:da:ba:21,137712832,368,-158,137712464,137712832
19706,6,12,1,2412,-60,-91,31,40:e3:d6:da:ba:22,137713246,180,234,137713066,137713246
19707,6,12,1,2412,-60,-91,31,40:e3:d6:da:ba:23,137713470,184,40,137713286,137713470
19708,6,12,1,2412,-59,-91,32,40:e3:d6:da:ba:24,137713706,176,60,137713530,137713706
19709,6,12,1,2412,-59,-91,32,40:e3:d6:da:ba:25,137713926,160,60,137713766,137713926
19710,6,6,1,2412,-59,-91,32,40:e3:d6:da:ba:26,137714127,380,-179,137713747,137714127
19711,4,1,1,2412,-86,-91,5,54:e4:3a:ec:fb:64,137770091,2160,53804,137767931,137770091
19712,6,6,1,2412,-88,-91,3,40:e3:d6:da:c0:26,137788044,380,17573,137787664,137788044
19713,4,1,1,2412,-84,-91,7,b8:3a:5a:88:e6:e0,137798733,2360,8329,137796373,137798733
19714,4,1,1,2412,-82,-91,9,b8:3a:5a:88:e6:e1,137801131,2376,22,137798755,137801131
19715,6,12,1,2412,-61,-91,30,40:e3:d6:da:ba:20,137815023,160,13732,137814863,137815023
19716,6,6,1,2412,-61,-91,30,40:e3:d6:da:ba:21,137815224,368,-167,137814856,137815224
19717,6,12,1,2412,-61,-91,30,40:e3:d6:da:ba:22,137815638,180,234,137815458,137815638
19718,6,12,1,2412,-60,-91,31,40:e3:d6:da:ba:23,137815861,184,39,137815677,137815861
19719,6,12,1,2412,-61,-91,30,40:e3:d6:da:ba:24,137816071,176,34,137815895,137816071
19720,6,12,1,2412,-61,-91,30,40:e3:d6:da:ba:25,137816299,160,68,137816139,137816299
19721,6,6,1,2412,-61,-91,30,40:e3:d6:da:ba:26,137816491,380,-188,137816111,137816491
19722,6,6,1,2412,-81,-91,10,e6:aa:ea:b7:4a:dd,137817287,408,388,137816879,137817287
19723,6,6,1,2412,-77,-91,14,e6:aa:ea:c9:ea:33,137821057,408,3362,137820649,137821057
19724,6,6,1,2412,-81,-91,10,e6:aa:ea:b7:4a:dd,137828835,408,7370,137828427,137828835
19725,6,6,1,2412,-76,-91,15,e6:aa:ea:c9:ea:33,137833208,408,3965,137832800,137833208
19726,6,6,1,2412,-81,-91,10,e6:aa:ea:b7:4a:dd,137840958,408,7342,137840550,137840958
19727,6,6,1,2412,-77,-91,14,e6:aa:ea:c9:ea:33,137845286,408,3920,137844878,137845286
19728,6,6,1,2412,-76,-91,15,e6:aa:ea:c9:ea:33,137857406,408,11712,137856998,137857406
19729,4,1,1,2412,-86,-91,5,,137858068,304,358,137857764,137858068
19730,6,6,1,2412,-81,-91,10,e6:aa:ea:b7:4a:dd,137865198,408,6722,137864790,137865198
19731,6,6,1,2412,-76,-91,15,e6:aa:ea:c9:ea:33,137869536,408,3930,137869128,137869536
19732,4,1,1,2412,-86,-91,5,54:e4:3a:ec:fb:64,137872490,2160,794,137870330,137872490
19733,6,12,1,2412,-62,-91,29,40:e3:d6:da:ba:20,137917440,160,44790,137917280,137917440
19734,6,6,1,2412,-63,-91,28,40:e3:d6:da:ba:21,137917650,368,-158,137917282,137917650
19735,6,12,1,2412,-62,-91,29,40:e3:d6:da:ba:22,137918046,180,216,137917866,137918046
19736,6,12,1,2412,-62,-91,29,40:e3:d6:da:ba:23,137918260,184,30,137918076,137918260
19737,6,12,1,2412,-62,-91,29,40:e3:d6:da:ba:24,137918470,176,34,137918294,137918470
19738,6,12,1,2412,-62,-91,29,40:e3:d6:da:ba:25,137918698,160,68,137918538,137918698
19739,6,6,1,2412,-62,-91,29,40:e3:d6:da:ba:26,137918890,380,-188,137918510,137918890
19740,4,1,1,2412,-85,-91,6,54:e4:3a:ec:fb:64,137974890,2160,53840,137972730,137974890
19741,6,12,1,2412,-87,-91,4,40:e3:d6:da:c0:20,137986840,136,11814,137986704,137986840
19742,6,6,1,2412,-88,-91,3,40:e3:d6:da:c0:21,137987035,348,-153,137986687,137987035
19743,6,12,1,2412,-88,-91,3,40:e3:d6:da:c0:22,137987438,156,247,137987282,137987438
19744,4,1,1,2412,-86,-91,5,b8:3a:5a:88:e6:e0,138003535,2360,13737,138001175,138003535
19745,4,1,1,2412,-87,-91,4,b8:3a:5a:88:e6:e1,138005942,2376,31,138003566,138005942
19746,6,12,1,2412,-64,-91,27,40:e3:d6:da:ba:20,138019842,160,13740,138019682,138019842
19747,6,12,1,2412,-63,-91,28,40:e3:d6:da:ba:24,138020908,176,890,138020732,138020908
19748,6,12,1,2412,-63,-91,28,40:e3:d6:da:ba:25,138021119,160,51,138020959,138021119
19749,6,6,1,2412,-88,-91,3,40:e3:d6:da:c0:21,138093991,368,72504,138093623,138093991
19750,4,1,1,2412,-90,-91,1,b8:3a:5a:88:e6:e0,138105934,2360,9583,138103574,138105934
19751,6,12,1,2412,-66,-91,25,40:e3:d6:da:ba:20,138122226,160,16132,138122066,138122226
19752,6,6,1,2412,-66,-91,25,40:e3:d6:da:ba:21,138122427,368,-167,138122059,138122427
19753,6,12,1,2412,-66,-91,25,40:e3:d6:da:ba:22,138122832,180,225,138122652,138122832
19754,6,12,1,2412,-66,-91,25,40:e3:d6:da:ba:23,138123065,184,49,138122881,138123065
19755,6,12,1,2412,-66,-91,25,40:e3:d6:da:ba:24,138123274,176,33,138123098,138123274
19756,6,12,1,2412,-66,-91,25,40:e3:d6:da:ba:25,138123485,160,51,138123325,138123485
19757,6,6,1,2412,-66,-91,25,40:e3:d6:da:ba:26,138123677,380,-188,138123297,138123677
19758,6,6,1,2412,-88,-91,3,40:e3:d6:da:c0:21,138129584,348,5559,138129236,138129584
19759,6,12,1,2412,-87,-91,4,40:e3:d6:da:c0:22,138129987,156,247,138129831,138129987
19760,6,12,1,2412,-88,-91,3,40:e3:d6:da:c0:23,138130178,156,35,138130022,138130178
19761,6,12,1,2412,-87,-91,4,40:e3:d6:da:c0:25,138130394,136,80,138130258,138130394
19762,4,1,1,2412,-85,-91,6,54:e4:3a:ec:fb:64,138179687,2160,47133,138177527,138179687
19763,6,6,1,2412,-88,-91,3,40:e3:d6:da:c0:26,138197595,380,17528,138197215,138197595
19764,6,12,1,2412,-68,-91,23,40:e3:d6:da:ba:22,138225216,180,27441,138225036,138225216
19765,6,12,1,2412,-68,-91,23,40:e3:d6:da:ba:23,138225431,184,31,138225247,138225431
19766,6,6,1,2412,-68,-91,23,40:e3:d6:da:ba:26,138226088,380,277,138225708,138226088
19767,6,6,1,2412,-80,-91,11,e6:aa:ea:b7:4a:dd,138234570,408,8074,138234162,138234570
19768,6,6,1,2412,-78,-91,13,e6:aa:ea:b7:4a:dd,138246697,408,11719,138246289,138246697
19769,6,6,1,2412,-80,-91,11,e6:aa:ea:b7:4a:dd,138258810,408,11705,138258402,138258810
19770,6,6,1,2412,-79,-91,12,e6:aa:ea:b7:4a:dd,138270929,408,11711,138270521,138270929
19771,6,6,1,2412,-87,-91,4,84:1b:5e:df:1b:99,138295445,80,24436,138295365,138295445
19772,6,12,1,2412,-86,-91,5,40:e3:d6:da:c0:20,138304594,156,8993,138304438,138304594
19773,6,12,1,2412,-88,-91,3,40:e3:d6:da:c0:22,138305187,176,417,138305011,138305187
19774,6,12,1,2412,-87,-91,4,40:e3:d6:da:c0:23,138305406,180,39,138305226,138305406
19775,6,12,1,2412,-88,-91,3,40:e3:d6:da:c0:25,138305845,156,283,138305689,138305845
19776,6,6,1,2412,-87,-91,4,40:e3:d6:da:c0:26,138306051,380,-174,138305671,138306051
19777,4,1,1,2412,-84,-91,7,b8:3a:5a:88:e6:e0,138310772,2360,2361,138308412,138310772
19778,4,1,1,2412,-83,-91,8,b8:3a:5a:88:e6:e1,138313151,2376,3,138310775,138313151
19779,6,6,1,2412,-71,-91,20,40:e3:d6:da:ba:21,138327228,368,13709,138326860,138327228
19780,6,12,1,2412,-72,-91,19,40:e3:d6:da:ba:22,138327624,180,216,138327444,138327624
19781,6,12,1,2412,-71,-91,20,40:e3:d6:da:ba:23,138327838,184,30,138327654,138327838
19782,6,12,1,2412,-70,-91,21,40:e3:d6:da:ba:24,138328075,176,61,138327899,138328075
19783,6,12,1,2412,-70,-91,21,40:e3:d6:da:ba:25,138328303,160,68,138328143,138328303
19784,6,6,1,2412,-70,-91,21,40:e3:d6:da:ba:26,138328495,380,-188,138328115,138328495
19785,6,6,1,2412,-73,-91,18,e6:aa:ea:c9:ea:33,138341334,408,12431,138340926,138341334
19786,6,6,1,2412,-73,-91,18,e6:aa:ea:c9:ea:33,138377575,408,35833,138377167,138377575
19787,4,1,1,2412,-87,-91,4,54:e4:3a:ec:fb:64,138384485,2160,4750,138382325,138384485
19788,6,6,1,2412,-86,-91,5,40:e3:d6:da:c0:21,138403110,368,18257,138402742,138403110
19789,6,12,1,2412,-86,-91,5,40:e3:d6:da:c0:22,138403497,176,211,138403321,138403497
19790,6,12,1,2412,-89,-91,2,40:e3:d6:da:c0:25,138404137,156,484,138403981,138404137
19791,6,6,1,2412,-87,-91,4,40:e3:d6:da:c0:26,138404335,380,-182,138403955,138404335
19792,4,1,1,2412,-56,-91,35,b8:3a:5a:88:e6:e0,138413133,2360,6438,138410773,138413133
19793,6,12,1,2412,-67,-91,24,40:e3:d6:da:ba:20,138429443,160,16150,138429283,138429443
19794,6,6,1,2412,-67,-91,24,40:e3:d6:da:ba:21,138429662,368,-149,138429294,138429662
19795,6,12,1,2412,-67,-91,24,40:e3:d6:da:ba:22,138430067,180,225,138429887,138430067
19796,6,12,1,2412,-67,-91,24,40:e3:d6:da:ba:23,138430272,184,21,138430088,138430272
19797,6,12,1,2412,-67,-91,24,40:e3:d6:da:ba:24,138430509,176,61,138430333,138430509
19798,6,12,1,2412,-67,-91,24,40:e3:d6:da:ba:25,138430729,160,60,138430569,138430729
19799,6,6,1,2412,-67,-91,24,40:e3:d6:da:ba:26,138430929,380,-180,138430549,138430929
19800,4,1,1,2412,-91,-91,0,54:e4:3a:ec:fb:64,138486884,2160,53795,138484724,138486884
19801,6,6,1,2412,-88,-91,3,40:e3:d6:de:1e:61,138489854,348,2622,138489506,138489854
19802,6,12,1,2412,-87,-91,4,40:e3:d6:de:1e:62,138490230,156,220,138490074,138490230
19803,6,12,1,2412,-88,-91,3,40:e3:d6:de:1e:60,138502867,156,12481,138502711,138502867
19804,6,6,1,2412,-88,-91,3,40:e3:d6:de:1e:61,138503082,368,-153,138502714,138503082
19805,6,6,1,2412,-87,-91,4,40:e3:d6:da:c0:26,138504823,380,1361,138504443,138504823
19806,4,1,1,2412,-81,-91,10,b8:3a:5a:88:e6:e0,138515553,2360,8370,138513193,138515553
19807,6,12,1,2412,-63,-91,28,40:e3:d6:da:ba:20,138531853,160,16140,138531693,138531853
19808,6,6,1,2412,-62,-91,29,40:e3:d6:da:ba:21,138532064,368,-157,138531696,138532064
19809,6,12,1,2412,-62,-91,29,40:e3:d6:da:ba:22,138532500,180,256,138532320,138532500
19810,6,12,1,2412,-62,-91,29,40:e3:d6:da:ba:23,138532723,184,39,138532539,138532723
19811,6,12,1,2412,-62,-91,29,40:e3:d6:da:ba:24,138532933,176,34,138532757,138532933
19812,6,12,1,2412,-63,-91,28,40:e3:d6:da:ba:25,138533162,160,69,138533002,138533162
19813,6,6,1,2412,-81,-91,10,e6:aa:ea:b7:4a:dd,138550098,408,16528,138549690,138550098
19814,6,6,1,2412,-81,-91,10,e6:aa:ea:b7:4a:dd,138562257,408,11751,138561849,138562257
19815,6,6,1,2412,-81,-91,10,e6:aa:ea:b7:4a:dd,138574327,408,11662,138573919,138574327
19816,6,12,1,2412,-88,-91,3,40:e3:d6:de:1e:60,138584589,136,10126,138584453,138584589
19817,6,6,1,2412,-87,-91,4,40:e3:d6:de:1e:61,138584784,348,-153,138584436,138584784
19818,6,12,1,2412,-89,-91,2,40:e3:d6:de:1e:62,138585186,156,246,138585030,138585186
19819,6,12,1,2412,-86,-91,5,40:e3:d6:de:1e:63,138585386,156,44,138585230,138585386
19820,6,6,1,2412,-82,-91,9,e6:aa:ea:b7:4a:dd,138586444,408,650,138586036,138586444
19821,4,1,1,2412,-85,-91,6,54:e4:3a:ec:fb:64,138589285,2160,681,138587125,138589285
19822,6,12,1,2412,-88,-91,3,40:e3:d6:de:1e:60,138605278,156,15837,138605122,138605278
19823,6,6,1,2412,-87,-91,4,40:e3:d6:de:1e:61,138605466,368,-180,138605098,138605466
19824,6,6,1,2412,-88,-91,3,40:e3:d6:de:1e:66,138606735,380,889,138606355,138606735
19825,6,6,1,2412,-87,-91,4,40:e3:d6:da:c0:26,138607173,380,58,138606793,138607173
19826,4,1,1,2412,-81,-91,10,b8:3a:5a:88:e6:e1,138620846,2376,11297,138618470,138620846
19827,6,12,1,2412,-65,-91,26,40:e3:d6:da:ba:20,138634227,160,13221,138634067,138634227
19828,6,6,1,2412,-64,-91,27,40:e3:d6:da:ba:21,138634446,368,-149,138634078,138634446
19829,6,12,1,2412,-65,-91,26,40:e3:d6:da:ba:22,138634842,180,216,138634662,138634842
19830,6,12,1,2412,-64,-91,27,40:e3:d6:da:ba:23,138635047,184,21,138634863,138635047
19831,6,12,1,2412,-64,-91,27,40:e3:d6:da:ba:24,138635266,176,43,138635090,138635266
19832,6,12,1,2412,-65,-91,26,40:e3:d6:da:ba:25,138635467,160,41,138635307,138635467
19833,6,6,1,2412,-65,-91,26,40:e3:d6:da:ba:26,138635659,380,-188,138635279,138635659
19834,6,6,1,2412,-88,-91,3,40:e3:d6:da:c0:26,138709604,380,73565,138709224,138709604
19835,4,1,1,2412,-81,-91,10,b8:3a:5a:88:e6:e1,138722742,2376,10762,138720366,138722742
19836,6,12,1,2412,-67,-91,24,40:e3:d6:da:ba:20,138736627,160,13725,138736467,138736627
19837,6,6,1,2412,-67,-91,24,40:e3:d6:da:ba:21,138736846,368,-149,138736478,138736846
19838,6,12,1,2412,-67,-91,24,40:e3:d6:da:ba:22,138737251,180,225,138737071,138737251
19839,6,12,1,2412,-67,-91,24,40:e3:d6:da:ba:23,138737475,184,40,138737291,138737475
19840,6,12,1,2412,-67,-91,24,40:e3:d6:da:ba:24,138737684,176,33,138737508,138737684
19841,6,12,1,2412,-67,-91,24,40:e3:d6:da:ba:25,138737913,160,69,138737753,138737913
19842,6,6,1,2412,-67,-91,24,40:e3:d6:da:ba:26,138738132,380,-161,138737752,138738132
19843,6,12,1,2412,-88,-91,3,40:e3:d6:de:1e:60,138767602,136,29334,138767466,138767602
19844,6,6,1,2412,-88,-91,3,40:e3:d6:de:1e:61,138767797,348,-153,138767449,138767797
19845,6,12,1,2412,-88,-91,3,40:e3:d6:de:1e:63,138768390,156,437,138768234,138768390
19846,6,6,1,2412,-74,-91,17,e6:aa:ea:c9:ea:33,138771542,408,2744,138771134,138771542
19847,6,6,1,2412,-74,-91,17,e6:aa:ea:c9:ea:33,138783711,408,11761,138783303,138783711
19848,6,12,1,2412,-87,-91,4,40:e3:d6:da:c0:20,138787727,136,3880,138787591,138787727
19849,6,6,1,2412,-88,-91,3,40:e3:d6:da:c0:21,138787921,348,-154,138787573,138787921
19850,6,12,1,2412,-87,-91,4,40:e3:d6:da:c0:22,138788316,156,239,138788160,138788316
19851,6,6,1,2412,-73,-91,18,e6:aa:ea:c9:ea:33,138807914,408,19190,138807506,138807914
19852,6,12,1,2412,-87,-91,4,40:e3:d6:de:1e:60,138810079,156,2009,138809923,138810079
19853,6,6,1,2412,-88,-91,3,40:e3:d6:de:1e:61,138810276,368,-171,138809908,138810276
19854,6,6,1,2412,-88,-91,3,40:e3:d6:da:c0:26,138811999,380,1343,138811619,138811999
19855,4,1,1,2412,-82,-91,9,b8:3a:5a:88:e6:e0,138823902,2360,9543,138821542,138823902
19856,6,12,1,2412,-87,-91,4,40:e3:d6:de:1e:65,138826149,136,2111,138826013,138826149
19857,6,12,1,2412,-66,-91,25,40:e3:d6:da:ba:20,138839048,160,12739,138838888,138839048
19858,6,6,1,2412,-66,-91,25,40:e3:d6:da:ba:21,138839240,368,-176,138838872,138839240
19859,6,12,1,2412,-66,-91,25,40:e3:d6:da:ba:22,138839670,180,250,138839490,138839670
19860,6,12,1,2412,-66,-91,25,40:e3:d6:da:ba:23,138839875,184,21,138839691,138839875
19861,6,12,1,2412,-66,-91,25,40:e3:d6:da:ba:24,138840094,176,43,138839918,138840094
19862,6,12,1,2412,-66,-91,25,40:e3:d6:da:ba:25,138840330,160,76,138840170,138840330
19863,6,6,1,2412,-66,-91,25,40:e3:d6:da:ba:26,138840531,380,-179,138840151,138840531
19864,6,6,1,2412,-87,-91,4,40:e3:d6:da:c0:21,138843828,348,2949,138843480,138843828
19865,6,6,1,2412,-81,-91,10,e6:aa:ea:b7:4a:dd,138864786,408,20550,138864378,138864786
19866,6,6,1,2412,-82,-91,9,e6:aa:ea:b7:4a:dd,138876907,408,11713,138876499,138876907
19867,6,6,1,2412,-82,-91,9,e6:aa:ea:b7:4a:dd,138889017,408,11702,138888609,138889017
19868,6,12,1,2412,-85,-91,6,40:e3:d6:da:bb:60,138903747,960,13770,138902787,138903747
19869,6,12,1,2412,-85,-91,6,40:e3:d6:de:1e:60,138912489,156,8586,138912333,138912489
19870,6,6,1,2412,-87,-91,4,40:e3:d6:de:1e:61,138912695,368,-162,138912327,138912695
19871,6,6,1,2412,-82,-91,9,e6:aa:ea:b7:4a:dd,138913281,408,178,138912873,138913281
19872,6,6,1,2412,-85,-91,6,40:e3:d6:de:1e:66,138913956,380,295,138913576,138913956
19873,4,1,1,2412,-86,-91,5,b8:3a:5a:88:e6:e0,138926637,2360,10321,138924277,138926637
19874,4,1,1,2412,-84,-91,7,b8:3a:5a:88:e6:e1,138929017,2376,4,138926641,138929017
19875,6,12,1,2412,-66,-91,25,40:e3:d6:da:ba:20,138941441,160,12264,138941281,138941441
19876,6,6,1,2412,-66,-91,25,40:e3:d6:da:ba:21,138941642,368,-167,138941274,138941642
19877,6,12,1,2412,-66,-91,25,40:e3:d6:da:ba:22,138942047,180,225,138941867,138942047
19878,6,12,1,2412,-66,-91,25,40:e3:d6:da:ba:23,138942270,184,39,138942086,138942270
19879,6,12,1,2412,-65,-91,26,40:e3:d6:da:ba:24,138942480,176,34,138942304,138942480
19880,6,6,1,2412,-87,-91,4,40:e3:d6:de:1e:61,138973234,348,30406,138972886,138973234
19881,6,12,1,2412,-87,-91,4,40:e3:d6:de:1e:63,138973837,156,447,138973681,138973837
19882,6,12,1,2412,-87,-91,4,40:e3:d6:de:1e:65,138974036,136,63,138973900,138974036
19883,6,12,1,2412,-87,-91,4,40:e3:d6:de:1e:62,138995004,156,20812,138994848,138995004
19884,6,12,1,2412,-88,-91,3,40:e3:d6:de:1e:63,138995213,156,53,138995057,138995213
19885,6,12,1,2412,-87,-91,4,40:e3:d6:de:1e:65,138995412,136,63,138995276,138995412
19886,4,1,1,2412,-83,-91,8,54:e4:3a:ec:fb:64,138999059,2160,1487,138996899,138999059
19887,6,6,1,2412,-87,-91,4,40:e3:d6:de:1e:66,139016304,380,16865,139015924,139016304
19888,4,1,1,2412,-81,-91,10,b8:3a:5a:88:e6:e0,139027533,2360,8869,139025173,139027533
19889,4,1,1,2412,-80,-91,11,b8:3a:5a:88:e6:e1,139029940,2376,31,139027564,139029940
19890,6,12,1,2412,-68,-91,23,40:e3:d6:da:ba:20,139043840,160,13740,139043680,139043840
19891,6,6,1,2412,-68,-91,23,40:e3:d6:da:ba:21,139044032,368,-176,139043664,139044032
19892,6,12,1,2412,-68,-91,23,40:e3:d6:da:ba:22,139044445,180,233,139044265,139044445
19893,6,12,1,2412,-68,-91,23,40:e3:d6:da:ba:23,139044669,184,40,139044485,139044669
19894,6,12,1,2412,-68,-91,23,40:e3:d6:da:ba:24,139044896,176,51,139044720,139044896
19895,6,6,1,2412,-68,-91,23,40:e3:d6:da:ba:26,139045299,380,23,139044919,139045299
19896,4,1,1,2412,-84,-91,7,54:e4:3a:ec:fb:64,139101279,2160,53820,139099119,139101279
19897,6,6,1,2412,-88,-91,3,40:e3:d6:de:1e:61,139117480,368,15833,139117112,139117480
19898,4,1,1,2412,-80,-91,11,b8:3a:5a:88:e6:e0,139129943,2360,10103,139127583,139129943
19899,4,1,1,2412,-80,-91,11,b8:3a:5a:88:e6:e1,139132323,2376,4,139129947,139132323
19900,6,12,1,2412,-82,-91,9,40:e3:d6:da:ba:20,139146249,160,13766,139146089,139146249
19901,6,6,1,2412,-67,-91,24,40:e3:d6:da:ba:21,139146459,368,-158,139146091,139146459
19902,6,12,1,2412,-67,-91,24,40:e3:d6:da:ba:22,139146864,180,225,139146684,139146864
19903,6,12,1,2412,-66,-91,25,40:e3:d6:da:ba:23,139147078,184,30,139146894,139147078
19904,6,12,1,2412,-66,-91,25,40:e3:d6:da:ba:24,139147315,176,61,139147139,139147315
19905,6,12,1,2412,-67,-91,24,40:e3:d6:da:ba:25,139147543,160,68,139147383,139147543
19906,6,6,1,2412,-67,-91,24,40:e3:d6:da:ba:26,139147753,380,-170,139147373,139147753
19907,4,1,1,2412,-78,-91,13,b8:3a:5a:88:e6:e0,139170237,2240,20244,139167997,139170237
19908,4,1,1,2412,-80,-91,11,b8:3a:5a:88:e6:e1,139172505,2256,12,139170249,139172505
19909,6,6,1,2412,-76,-91,15,e6:aa:ea:c9:ea:33,139176930,408,4017,139176522,139176930
19910,6,6,1,2412,-79,-91,12,e6:aa:ea:b7:4a:dd,139180442,408,3104,139180034,139180442
19911,4,1,1,2412,-78,-91,13,b8:3a:5a:88:e6:e0,139182832,2240,150,139180592,139182832
19912,4,1,1,2412,-78,-91,13,b8:3a:5a:88:e6:e1,139185281,2256,193,139183025,139185281
19913,4,1,1,2412,-91,-91,0,a6:e5:7c:28:b1:d3,139200371,944,14146,139199427,139200371
19914,6,6,1,2412,-76,-91,15,e6:aa:ea:c9:ea:33,139201158,408,379,139200750,139201158
19915,6,6,1,2412,-76,-91,15,e6:aa:ea:c9:ea:33,139213433,408,11867,139213025,139213433
19916,6,6,1,2412,-78,-91,13,e6:aa:ea:b7:4a:dd,139216796,408,2955,139216388,139216796
19917,4,1,1,2412,-79,-91,12,b8:3a:5a:88:e6:e0,139232330,2360,13174,139229970,139232330
19918,6,12,1,2412,-64,-91,27,40:e3:d6:da:ba:20,139248646,160,16156,139248486,139248646
19919,6,6,1,2412,-63,-91,28,40:e3:d6:da:ba:21,139248855,368,-159,139248487,139248855
19920,6,12,1,2412,-63,-91,28,40:e3:d6:da:ba:22,139249242,180,207,139249062,139249242
19921,6,12,1,2412,-63,-91,28,40:e3:d6:da:ba:23,139249466,184,40,139249282,139249466
19922,6,12,1,2412,-63,-91,28,40:e3:d6:da:ba:24,139249693,176,51,139249517,139249693
19923,6,12,1,2412,-63,-91,28,40:e3:d6:da:ba:25,139249904,160,51,139249744,139249904
19924,4,1,1,2412,-82,-91,9,54:e4:3a:ec:fb:64,139306078,2160,54014,139303918,139306078
19925,4,1,1,2412,-80,-91,11,b8:3a:5a:88:e6:e1,139337139,2376,28685,139334763,139337139
19926,6,12,1,2412,-62,-91,29,40:e3:d6:da:ba:20,139351056,160,13757,139350896,139351056
19927,6,6,1,2412,-62,-91,29,40:e3:d6:da:ba:21,139351275,368,-149,139350907,139351275
19928,6,12,1,2412,-62,-91,29,40:e3:d6:da:ba:22,139351689,180,234,139351509,139351689
19929,6,12,1,2412,-62,-91,29,40:e3:d6:da:ba:23,139351894,184,21,139351710,139351894
19930,6,12,1,2412,-62,-91,29,40:e3:d6:da:ba:24,139352131,176,61,139351955,139352131
19931,6,12,1,2412,-62,-91,29,40:e3:d6:da:ba:25,139352341,160,50,139352181,139352341
19932,6,6,1,2412,-62,-91,29,40:e3:d6:da:ba:26,139352560,380,-161,139352180,139352560
19933,6,12,1,2412,-63,-91,28,40:e3:d6:da:ba:20,139453440,160,100720,139453280,139453440
19934,6,12,1,2412,-63,-91,28,40:e3:d6:da:ba:22,139454037,180,417,139453857,139454037
19935,6,12,1,2412,-63,-91,28,40:e3:d6:da:ba:23,139454242,184,21,139454058,139454242
19936,6,12,1,2412,-63,-91,28,40:e3:d6:da:ba:24,139454478,176,60,139454302,139454478
19937,6,12,1,2412,-63,-91,28,40:e3:d6:da:ba:25,139454707,160,69,139454547,139454707
19938,6,6,1,2412,-63,-91,28,40:e3:d6:da:ba:26,139454899,380,-188,139454519,139454899
19939,6,6,1,2412,-72,-91,19,e6:aa:ea:c9:ea:33,139491865,408,36558,139491457,139491865
19940,6,6,1,2412,-78,-91,13,e6:aa:ea:b7:4a:dd,139494696,408,2423,139494288,139494696
19941,6,6,1,2412,-72,-91,19,e6:aa:ea:c9:ea:33,139503990,408,8886,139503582,139503990
19942,6,6,1,2412,-78,-91,13,e6:aa:ea:b7:4a:dd,139506803,408,2405,139506395,139506803
19943,4,1,1,2412,-82,-91,9,54:e4:3a:ec:fb:64,139510875,2160,1912,139508715,139510875
19944,6,6,1,2412,-72,-91,19,e6:aa:ea:c9:ea:33,139516095,408,4812,139515687,139516095
19945,6,6,1,2412,-78,-91,13,e6:aa:ea:b7:4a:dd,139518920,408,2417,139518512,139518920
19946,6,6,1,2412,-72,-91,19,e6:aa:ea:c9:ea:33,139528389,408,9061,139527981,139528389
19947,6,6,1,2412,-79,-91,12,e6:aa:ea:b7:4a:dd,139531039,408,2242,139530631,139531039
19948,6,12,1,2412,-64,-91,27,40:e3:d6:da:ba:20,139568413,960,36414,139567453,139568413
19949,4,1,1,2412,-90,-91,1,a6:e5:7c:28:b1:d3,139600842,992,31437,139599850,139600842
19950,4,1,1,2412,-79,-91,12,b8:3a:5a:88:e6:e0,139641944,2360,38742,139639584,139641944
19951,4,1,1,2412,-78,-91,13,b8:3a:5a:88:e6:e1,139644333,2376,13,139641957,139644333
19952,6,12,1,2412,-64,-91,27,40:e3:d6:da:ba:20,139658256,160,13763,139658096,139658256
19953,6,6,1,2412,-64,-91,27,40:e3:d6:da:ba:21,139658448,368,-176,139658080,139658448
19954,6,12,1,2412,-64,-91,27,40:e3:d6:da:ba:22,139658834,180,206,139658654,139658834
19955,6,12,1,2412,-64,-91,27,40:e3:d6:da:ba:23,139659058,184,40,139658874,139659058
19956,6,12,1,2412,-64,-91,27,40:e3:d6:da:ba:24,139659285,176,51,139659109,139659285
19957,6,12,1,2412,-64,-91,27,40:e3:d6:da:ba:25,139659496,160,51,139659336,139659496
19958,6,6,1,2412,-64,-91,27,40:e3:d6:da:ba:26,139659706,380,-170,139659326,139659706
19959,4,1,1,2412,-90,-91,1,a6:e5:7c:28:b1:d3,139704026,992,43328,139703034,139704026
19960,4,1,1,2412,-92,-91,-1,a4:e5:7c:28:b1:d3,139727689,688,22975,139727001,139727689
19961,4,1,1,2412,-79,-91,12,b8:3a:5a:88:e6:e0,139744341,2360,14292,139741981,139744341
19962,4,1,1,2412,-78,-91,13,b8:3a:5a:88:e6:e1,139746730,2376,13,139744354,139746730
19963,6,12,1,2412,-65,-91,26,40:e3:d6:da:ba:20,139760649,160,13759,139760489,139760649
19964,6,6,1,2412,-66,-91,25,40:e3:d6:da:ba:21,139760850,368,-167,139760482,139760850
19965,6,12,1,2412,-66,-91,25,40:e3:d6:da:ba:22,139761246,180,216,139761066,139761246
19966,6,12,1,2412,-65,-91,26,40:e3:d6:da:ba:23,139761461,184,31,139761277,139761461
19967,6,12,1,2412,-66,-91,25,40:e3:d6:da:ba:24,139761670,176,33,139761494,139761670
19968,6,12,1,2412,-66,-91,25,40:e3:d6:da:ba:25,139761881,160,51,139761721,139761881
19969,6,6,1,2412,-66,-91,25,40:e3:d6:da:ba:26,139762091,380,-170,139761711,139762091
19970,6,6,1,2412,-74,-91,17,e6:aa:ea:c9:ea:33,139831567,408,69068,139831159,139831567
19971,6,6,1,2412,-75,-91,16,e6:aa:ea:c9:ea:33,139855686,408,23711,139855278,139855686
19972,6,12,1,2412,-66,-91,25,40:e3:d6:da:ba:20,139863061,160,7215,139862901,139863061
19973,6,6,1,2412,-66,-91,25,40:e3:d6:da:ba:21,139863262,368,-167,139862894,139863262
19974,6,12,1,2412,-66,-91,25,40:e3:d6:da:ba:22,139863658,180,216,139863478,139863658
19975,6,12,1,2412,-66,-91,25,40:e3:d6:da:ba:23,139863882,184,40,139863698,139863882
19976,6,12,1,2412,-66,-91,25,40:e3:d6:da:ba:24,139864240,176,182,139864064,139864240
19977,6,12,1,2412,-66,-91,25,40:e3:d6:da:ba:25,139864441,160,41,139864281,139864441
19978,6,6,1,2412,-66,-91,25,40:e3:d6:da:ba:26,139864660,380,-161,139864280,139864660
19979,4,1,1,2412,-92,-91,-1,a6:e5:7c:28:b1:d3,139908020,992,42368,139907028,139908020
19980,6,6,1,2412,-81,-91,10,e6:aa:ea:b7:4a:dd,139912751,408,4323,139912343,139912751
19981,4,1,1,2412,-80,-91,11,54:e4:3a:ec:fb:64,139920473,2160,5562,139918313,139920473
19982,6,6,1,2412,-81,-91,10,e6:aa:ea:b7:4a:dd,139924882,408,4001,139924474,139924882
19983,6,6,1,2412,-80,-91,11,e6:aa:ea:b7:4a:dd,139937004,408,11714,139936596,139937004
19984,4,1,1,2412,-79,-91,12,b8:3a:5a:88:e6:e0,139949135,2360,9771,139946775,139949135
19985,4,1,1,2412,-79,-91,12,b8:3a:5a:88:e6:e1,139951515,2376,4,139949139,139951515
19986,6,6,1,2412,-82,-91,9,e6:aa:ea:b7:4a:dd,139961230,408,9307,139960822,139961230
19987,4,1,1,2412,-82,-91,9,54:e4:3a:ec:fb:64,140022871,2160,59481,140020711,140022871
19988,4,1,1,2412,-79,-91,12,b8:3a:5a:88:e6:e0,140051554,2360,26323,140049194,140051554
19989,6,12,1,2412,-63,-91,28,40:e3:d6:da:ba:20,140067836,160,16122,140067676,140067836
19990,6,6,1,2412,-63,-91,28,40:e3:d6:da:ba:21,140068027,368,-177,140067659,140068027
19991,6,12,1,2412,-62,-91,29,40:e3:d6:da:ba:22,140068414,180,207,140068234,140068414
19992,6,12,1,2412,-63,-91,28,40:e3:d6:da:ba:23,140068638,184,40,140068454,140068638
19993,6,12,1,2412,-62,-91,29,40:e3:d6:da:ba:24,140068874,176,60,140068698,140068874
19994,6,12,1,2412,-62,-91,29,40:e3:d6:da:ba:25,140069076,160,42,140068916,140069076
19995,6,6,1,2412,-63,-91,28,40:e3:d6:da:ba:26,140069277,380,-179,140068897,140069277
19996,6,6,1,2412,-77,-91,14,e6:aa:ea:c9:ea:33,140123095,408,53410,140122687,140123095
19997,4,1,1,2412,-76,-91,15,54:e4:3a:ec:fb:64,140125270,2160,15,140123110,140125270
19998,6,6,1,2412,-77,-91,14,e6:aa:ea:c9:ea:33,140135213,408,9535,140134805,140135213
19999,6,6,1,2412,-77,-91,14,e6:aa:ea:c9:ea:33,140147377,408,11756,140146969,140147377
20000,6,12,1,2412,-62,-91,29,40:e3:d6:da:ba:20,140170251,160,22714,140170091,140170251
20001,6,6,1,2412,-62,-91,29,40:e3:d6:da:ba:21,140170470,368,-149,140170102,140170470
20002,6,12,1,2412,-62,-91,29,40:e3:d6:da:ba:22,140170875,180,225,140170695,140170875
20003,6,12,1,2412,-62,-91,29,40:e3:d6:da:ba:23,140171107,184,48,140170923,140171107
20004,6,12,1,2412,-62,-91,29,40:e3:d6:da:ba:24,140171344,176,61,140171168,140171344
20005,6,12,1,2412,-61,-91,30,40:e3:d6:da:ba:25,140171563,160,59,140171403,140171563
20006,6,6,1,2412,-61,-91,30,40:e3:d6:da:ba:26,140172020,380,77,140171640,140172020
20007,4,1,1,2412,-81,-91,10,b8:3a:5a:88:e6:e1,140258930,2376,84534,140256554,140258930
20008,6,12,1,2412,-61,-91,30,40:e3:d6:da:ba:24,140273697,176,14591,140273521,140273697
20009,6,6,1,2412,-83,-91,8,e6:aa:ea:b7:4a:dd,140342401,408,68296,140341993,140342401
20010,6,6,1,2412,-84,-91,7,e6:aa:ea:b7:4a:dd,140354522,408,11713,140354114,140354522
20011,4,1,1,2412,-83,-91,8,b8:3a:5a:88:e6:e1,140363369,2376,6471,140360993,140363369
20012,4,1,1,2412,-91,-91,0,,140375177,304,11504,140374873,140375177
20013,6,12,1,2412,-61,-91,30,40:e3:d6:da:ba:20,140375359,160,22,140375199,140375359
20014,6,6,1,2412,-61,-91,30,40:e3:d6:da:ba:21,140375578,368,-149,140375210,140375578
20015,6,12,1,2412,-60,-91,31,40:e3:d6:da:ba:22,140375999,180,241,140375819,140375999
20016,6,12,1,2412,-60,-91,31,40:e3:d6:da:ba:23,140376223,184,40,140376039,140376223
20017,6,12,1,2412,-60,-91,31,40:e3:d6:da:ba:24,140376508,176,109,140376332,140376508
20018,6,12,1,2412,-61,-91,30,40:e3:d6:da:ba:25,140376718,160,50,140376558,140376718
20019,6,6,1,2412,-61,-91,30,40:e3:d6:da:ba:26,140376919,380,-179,140376539,140376919
20020,6,6,1,2412,-81,-91,10,e6:aa:ea:b7:4a:dd,140378765,408,1438,140378357,140378765
20021,4,1,1,2412,-83,-91,8,54:e4:3a:ec:fb:64,140432467,2160,51542,140430307,140432467
20022,4,1,1,2412,-84,-91,7,54:e4:3a:ec:fb:64,140447961,2112,13382,140445849,140447961
20023,4,1,1,2412,-81,-91,10,54:e4:3a:ec:fb:64,140450192,2112,119,140448080,140450192
20024,4,1,1,2412,-84,-91,7,54:e4:3a:ec:fb:64,140452684,2112,380,140450572,140452684
20025,4,1,1,2412,-85,-91,6,b8:3a:5a:88:e6:e0,140463093,2360,8049,140460733,140463093
20026,4,1,1,2412,-84,-91,7,b8:3a:5a:88:e6:e1,140465473,2376,4,140463097,140465473
20027,6,12,1,2412,-61,-91,30,40:e3:d6:da:ba:24,140478510,176,12861,140478334,140478510
20028,6,12,1,2412,-60,-91,31,40:e3:d6:da:ba:25,140478739,160,69,140478579,140478739
20029,6,6,1,2412,-61,-91,30,40:e3:d6:da:ba:26,140478931,380,-188,140478551,140478931
20030,4,1,1,2412,-85,-91,6,54:e4:3a:ec:fb:64,140534868,2160,53777,140532708,140534868
20031,6,6,1,2412,-76,-91,15,e6:aa:ea:c9:ea:33,140541569,408,6293,140541161,140541569
20032,6,6,1,2412,-76,-91,15,e6:aa:ea:c9:ea:33,140565753,408,23776,140565345,140565753
20033,6,6,1,2412,-77,-91,14,e6:aa:ea:c9:ea:33,140577862,408,11701,140577454,140577862
20034,6,6,1,2412,-76,-91,15,e6:aa:ea:c9:ea:33,140589980,408,11710,140589572,140589980
20035,6,12,1,2412,-62,-91,29,40:e3:d6:da:ba:20,140598924,136,8808,140598788,140598924
20036,6,6,1,2412,-62,-91,29,40:e3:d6:da:ba:21,140599128,348,-144,140598780,140599128
20037,6,12,1,2412,-62,-91,29,40:e3:d6:da:ba:22,140600398,156,1114,140600242,140600398
20038,6,12,1,2412,-62,-91,29,40:e3:d6:da:ba:23,140600616,156,62,140600460,140600616
20039,6,12,1,2412,-62,-91,29,40:e3:d6:da:ba:25,140600815,136,63,140600679,140600815
20040,4,1,1,2412,-84,-91,7,54:e4:3a:ec:fb:64,140637267,2160,34292,140635107,140637267
20041,4,1,1,2412,-83,-91,8,ae:52:20:27:74:05,140640723,904,2552,140639819,140640723
20042,6,12,1,2412,-69,-91,22,40:e3:d6:da:ba:20,140641618,136,759,140641482,140641618
20043,6,6,1,2412,-68,-91,23,40:e3:d6:da:ba:21,140641882,348,-84,140641534,140641882
20044,6,6,1,2412,-82,-91,9,,140642246,44,320,140642202,140642246
20045,6,12,1,2412,-68,-91,23,40:e3:d6:da:ba:22,140642328,156,-74,140642172,140642328
20046,6,12,1,2412,-82,-91,9,,140642501,32,141,140642469,140642501
20047,6,12,1,2412,-68,-91,23,40:e3:d6:da:ba:23,140642569,156,-88,140642413,140642569
20048,6,12,1,2412,-81,-91,10,,140642741,32,140,140642709,140642741
20049,6,12,1,2412,-68,-91,23,40:e3:d6:da:ba:25,140642809,136,-68,140642673,140642809
20050,4,1,1,2412,-86,-91,5,b8:3a:5a:88:e6:e0,140665946,2360,20777,140663586,140665946
20051,6,12,1,2412,-63,-91,28,40:e3:d6:da:ba:20,140682237,160,16131,140682077,140682237
20052,6,6,1,2412,-63,-91,28,40:e3:d6:da:ba:21,140682447,368,-158,140682079,140682447
20053,6,12,1,2412,-63,-91,28,40:e3:d6:da:ba:22,140682861,180,234,140682681,140682861
20054,6,12,1,2412,-63,-91,28,40:e3:d6:da:ba:23,140683094,184,49,140682910,140683094
20055,6,12,1,2412,-63,-91,28,40:e3:d6:da:ba:24,140683321,176,51,140683145,140683321
20056,6,12,1,2412,-63,-91,28,40:e3:d6:da:ba:25,140683541,160,60,140683381,140683541
20057,6,6,1,2412,-63,-91,28,40:e3:d6:da:ba:26,140683742,380,-179,140683362,140683742
20058,4,1,1,2412,-82,-91,9,ca:9e:54:03:47:5d,140691184,904,6538,140690280,140691184
20059,4,1,1,2412,-80,-91,11,,140694326,304,2838,140694022,140694326
20060,6,12,1,2412,-64,-91,27,40:e3:d6:da:ba:20,140694490,136,28,140694354,140694490
20061,6,6,1,2412,-81,-91,10,,140695794,44,1260,140695750,140695794
20062,6,12,1,2412,-63,-91,28,40:e3:d6:da:ba:22,140695894,156,-56,140695738,140695894
20063,6,12,1,2412,-81,-91,10,,140696066,32,140,140696034,140696066
20064,6,12,1,2412,-63,-91,28,40:e3:d6:da:ba:23,140696152,156,-70,140695996,140696152
20065,6,12,1,2412,-81,-91,10,,140696324,32,140,140696292,140696324
20066,6,12,1,2412,-63,-91,28,40:e3:d6:da:ba:25,140696401,136,-59,140696265,140696401
20067,6,12,1,2412,-81,-91,10,,140696554,32,121,140696522,140696554
20068,4,1,1,2412,-94,-91,-3,a6:e5:7c:28:b1:d3,140727810,992,30264,140726818,140727810
20069,4,1,1,2412,-60,-91,31,54:e4:3a:ec:fb:64,140739665,2160,9695,140737505,140739665
20070,4,1,1,2412,-86,-91,5,b8:3a:5a:88:e6:e0,140768356,2360,26331,140765996,140768356
20071,4,1,1,2412,-84,-91,7,b8:3a:5a:88:e6:e1,140770736,2376,4,140768360,140770736
20072,6,12,1,2412,-66,-91,25,40:e3:d6:da:ba:20,140784658,160,13762,140784498,140784658
20073,6,6,1,2412,-66,-91,25,40:e3:d6:da:ba:21,140784877,368,-149,140784509,140784877
20074,6,12,1,2412,-66,-91,25,40:e3:d6:da:ba:22,140785264,180,207,140785084,140785264
20075,6,12,1,2412,-66,-91,25,40:e3:d6:da:ba:23,140785470,184,22,140785286,140785470
20076,6,12,1,2412,-66,-91,25,40:e3:d6:da:ba:24,140785679,176,33,140785503,140785679
20077,6,12,1,2412,-66,-91,25,40:e3:d6:da:ba:25,140785890,160,51,140785730,140785890
20078,4,1,1,2412,-93,-91,-2,c0:c9:e3:4d:6e:bf,140820493,872,33731,140819621,140820493
20079,4,1,1,2412,-83,-91,8,54:e4:3a:ec:fb:64,140842098,2160,19445,140839938,140842098
20080,6,6,1,2412,-80,-91,11,e6:aa:ea:b7:4a:dd,140851044,408,8538,140850636,140851044
20081,6,6,1,2412,-77,-91,14,e6:aa:ea:c9:ea:33,140857102,408,5650,140856694,140857102
20082,6,6,1,2412,-89,-91,2,40:e3:d6:de:1e:61,140858279,368,809,140857911,140858279
20083,6,6,1,2412,-77,-91,14,e6:aa:ea:c9:ea:33,140869355,408,10668,140868947,140869355
20084,6,12,1,2412,-68,-91,23,40:e3:d6:da:ba:20,140887039,160,17524,140886879,140887039
20085,6,6,1,2412,-68,-91,23,40:e3:d6:da:ba:21,140887258,368,-149,140886890,140887258
20086,6,12,1,2412,-68,-91,23,40:e3:d6:da:ba:22,140887708,180,270,140887528,140887708
20087,6,12,1,2412,-68,-91,23,40:e3:d6:da:ba:23,140887940,184,48,140887756,140887940
20088,6,12,1,2412,-68,-91,23,40:e3:d6:da:ba:24,140888177,176,61,140888001,140888177
20089,6,12,1,2412,-68,-91,23,40:e3:d6:da:ba:25,140888388,160,51,140888228,140888388
20090,6,6,1,2412,-69,-91,22,40:e3:d6:da:ba:26,140888597,380,-171,140888217,140888597
20091,6,6,1,2412,-80,-91,11,e6:aa:ea:b7:4a:dd,140890472,408,1467,140890064,140890472
20092,6,6,1,2412,-77,-91,14,e6:aa:ea:c9:ea:33,140893881,408,3001,140893473,140893881
20093,6,6,1,2412,-85,-91,6,e6:aa:ea:b7:4a:dd,140899547,408,5258,140899139,140899547
20094,6,6,1,2412,-77,-91,14,e6:aa:ea:c9:ea:33,140905580,408,5625,140905172,140905580
20095,4,1,1,2412,-83,-91,8,54:e4:3a:ec:fb:64,140944464,2160,36724,140942304,140944464
20096,4,1,1,2412,-75,-91,16,b8:3a:5a:88:e6:e0,140973132,2360,26308,140970772,140973132
20097,6,12,1,2412,-68,-91,23,40:e3:d6:da:ba:22,140990050,180,16738,140989870,140990050
20098,6,12,1,2412,-68,-91,23,40:e3:d6:da:ba:23,140990264,184,30,140990080,140990264
20099,6,12,1,2412,-68,-91,23,40:e3:d6:da:ba:24,140990483,176,43,140990307,140990483
20100,6,12,1,2412,-68,-91,23,40:e3:d6:da:ba:25,140990684,160,41,140990524,140990684
20101,6,6,1,2412,-68,-91,23,40:e3:d6:da:ba:26,140990894,380,-170,140990514,140990894
20102,4,1,1,2412,-82,-91,9,54:e4:3a:ec:fb:64,141052109,2160,59055,141049949,141052109
20103,6,12,1,2412,-89,-91,2,40:e3:d6:de:1e:60,141062877,156,10612,141062721,141062877
20104,4,1,1,2412,-86,-91,5,b8:3a:5a:88:e6:e0,141075552,2360,10315,141073192,141075552
20105,6,12,1,2412,-69,-91,22,40:e3:d6:da:ba:20,141091859,160,16147,141091699,141091859
20106,6,6,1,2412,-69,-91,22,40:e3:d6:da:ba:21,141092069,368,-158,141091701,141092069
20107,6,12,1,2412,-68,-91,23,40:e3:d6:da:ba:22,141092483,180,234,141092303,141092483
20108,6,12,1,2412,-68,-91,23,40:e3:d6:da:ba:23,141092698,184,31,141092514,141092698
20109,6,12,1,2412,-69,-91,22,40:e3:d6:da:ba:24,141092916,176,42,141092740,141092916
20110,6,12,1,2412,-68,-91,23,40:e3:d6:da:ba:25,141093136,160,60,141092976,141093136
20111,6,6,1,2412,-69,-91,22,40:e3:d6:da:ba:26,141093328,380,-188,141092948,141093328
20112,4,1,1,2412,-90,-91,1,,141122534,304,28902,141122230,141122534
20113,4,1,1,2412,-90,-91,1,a6:e5:7c:28:b1:d3,141127112,944,3634,141126168,141127112
20114,6,6,1,2412,-74,-91,17,e6:aa:ea:c9:ea:33,141173173,408,45653,141172765,141173173
20115,6,6,1,2412,-74,-91,17,e6:aa:ea:c9:ea:33,141185342,408,11761,141184934,141185342
20116,6,6,1,2412,-79,-91,12,e6:aa:ea:b7:4a:dd,141190670,408,4920,141190262,141190670
20117,6,6,1,2412,-69,-91,22,40:e3:d6:da:ba:21,141194439,368,3401,141194071,141194439
20118,6,12,1,2412,-69,-91,22,40:e3:d6:da:ba:22,141194826,180,207,141194646,141194826
20119,6,12,1,2412,-68,-91,23,40:e3:d6:da:ba:23,141195041,184,31,141194857,141195041
20120,6,12,1,2412,-69,-91,22,40:e3:d6:da:ba:24,141195268,176,51,141195092,141195268
20121,6,12,1,2412,-68,-91,23,40:e3:d6:da:ba:25,141195497,160,69,141195337,141195497
20122,6,6,1,2412,-68,-91,23,40:e3:d6:da:ba:26,141195707,380,-170,141195327,141195707
20123,6,6,1,2412,-74,-91,17,e6:aa:ea:c9:ea:33,141197395,408,1280,141196987,141197395
20124,6,6,1,2412,-80,-91,11,e6:aa:ea:b7:4a:dd,141202887,408,5084,141202479,141202887
20125,6,6,1,2412,-74,-91,17,e6:aa:ea:c9:ea:33,141209506,408,6211,141209098,141209506
20126,6,6,1,2412,-81,-91,10,e6:aa:ea:b7:4a:dd,141214879,408,4965,141214471,141214879
20127,6,6,1,2412,-74,-91,17,e6:aa:ea:c9:ea:33,141221655,408,6368,141221247,141221655
20128,4,1,1,2412,-80,-91,11,54:e4:3a:ec:fb:64,141251661,2160,27846,141249501,141251661
20129,6,12,1,2412,-67,-91,24,40:e3:d6:da:ba:20,141296639,160,44818,141296479,141296639
20130,6,6,1,2412,-67,-91,24,40:e3:d6:da:ba:21,141296840,368,-167,141296472,141296840
20131,6,12,1,2412,-67,-91,24,40:e3:d6:da:ba:22,141297236,180,216,141297056,141297236
20132,6,12,1,2412,-67,-91,24,40:e3:d6:da:ba:23,141297469,184,49,141297285,141297469
20133,6,12,1,2412,-67,-91,24,40:e3:d6:da:ba:24,141297705,176,60,141297529,141297705
20134,6,12,1,2412,-67,-91,24,40:e3:d6:da:ba:25,141297934,160,69,141297774,141297934
20135,6,6,1,2412,-67,-91,24,40:e3:d6:da:ba:26,141298144,380,-170,141297764,141298144
20136,4,1,1,2412,-84,-91,7,54:e4:3a:ec:fb:64,141354059,2160,53755,141351899,141354059
20137,4,1,1,2412,-87,-91,4,b8:3a:5a:88:e6:e0,141384873,2360,28454,141382513,141384873
20138,4,1,1,2412,-88,-91,3,b8:3a:5a:88:e6:e1,141387271,2376,22,141384895,141387271
20139,6,12,1,2412,-65,-91,26,40:e3:d6:da:ba:20,141399065,160,11634,141398905,141399065
20140,6,6,1,2412,-65,-91,26,40:e3:d6:da:ba:21,141399275,368,-158,141398907,141399275
20141,6,12,1,2412,-64,-91,27,40:e3:d6:da:ba:22,141399689,180,234,141399509,141399689
20142,6,12,1,2412,-64,-91,27,40:e3:d6:da:ba:23,141399903,184,30,141399719,141399903
20143,6,12,1,2412,-64,-91,27,40:e3:d6:da:ba:24,141400131,176,52,141399955,141400131
20144,6,12,1,2412,-64,-91,27,40:e3:d6:da:ba:25,141400350,160,59,141400190,141400350
20145,6,6,1,2412,-64,-91,27,40:e3:d6:da:ba:26,141400551,380,-179,141400171,141400551
20146,4,1,1,2412,-85,-91,6,54:e4:3a:ec:fb:64,141456459,2160,53748,141454299,141456459
20147,6,6,1,2412,-88,-91,3,40:e3:d6:da:c0:26,141474444,380,17605,141474064,141474444
20148,4,1,1,2412,-88,-91,3,b8:3a:5a:88:e6:e0,141485158,2360,8354,141482798,141485158
20149,4,1,1,2412,-86,-91,5,54:e4:3a:ec:fb:64,141558859,2160,71541,141556699,141558859
20150,6,6,1,2412,-83,-91,8,e6:aa:ea:b7:4a:dd,141584122,408,24855,141583714,141584122
20151,6,6,1,2412,-83,-91,8,e6:aa:ea:b7:4a:dd,141596239,408,11709,141595831,141596239
20152,6,6,1,2412,-76,-91,15,e6:aa:ea:c9:ea:33,141603389,408,6742,141602981,141603389
20153,6,12,1,2412,-62,-91,29,40:e3:d6:da:ba:20,141603844,160,295,141603684,141603844
20154,6,6,1,2412,-62,-91,29,40:e3:d6:da:ba:21,141604054,368,-158,141603686,141604054
20155,6,12,1,2412,-62,-91,29,40:e3:d6:da:ba:22,141604468,180,234,141604288,141604468
20156,6,12,1,2412,-62,-91,29,40:e3:d6:da:ba:23,141604692,184,40,141604508,141604692
20157,6,12,1,2412,-62,-91,29,40:e3:d6:da:ba:24,141604910,176,42,141604734,141604910
20158,6,12,1,2412,-61,-91,30,40:e3:d6:da:ba:25,141605121,160,51,141604961,141605121
20159,6,6,1,2412,-62,-91,29,40:e3:d6:da:ba:26,141605340,380,-161,141604960,141605340
20160,6,6,1,2412,-83,-91,8,e6:aa:ea:b7:4a:dd,141608367,408,2619,141607959,141608367
20161,6,6,1,2412,-75,-91,16,e6:aa:ea:c9:ea:33,141627627,408,18852,141627219,141627627
20162,6,6,1,2412,-83,-91,8,e6:aa:ea:b7:4a:dd,141632600,408,4565,141632192,141632600
20163,6,6,1,2412,-75,-91,16,e6:aa:ea:c9:ea:33,141639750,408,6742,141639342,141639750
20164,4,1,1,2412,-85,-91,6,b8:3a:5a:88:e6:e0,141689933,2360,47823,141687573,141689933
20165,4,1,1,2412,-84,-91,7,b8:3a:5a:88:e6:e1,141692340,2376,31,141689964,141692340
20166,4,1,1,2412,-82,-91,9,b8:3a:5a:88:e6:e0,141735853,2240,41273,141733613,141735853
20167,4,1,1,2412,-84,-91,7,b8:3a:5a:88:e6:e1,141738122,2256,13,141735866,141738122
20168,4,1,1,2412,-83,-91,8,b8:3a:5a:88:e6:e1,141759579,2256,19201,141757323,141759579
20169,4,1,1,2412,-83,-91,8,54:e4:3a:ec:fb:64,141763656,2160,1917,141761496,141763656
20170,4,1,1,2412,-81,-91,10,b8:3a:5a:88:e6:e0,141792353,2360,26337,141789993,141792353
20171,4,1,1,2412,-83,-91,8,b8:3a:5a:88:e6:e1,141794793,2376,64,141792417,141794793
20172,6,12,1,2412,-66,-91,25,40:e3:d6:da:ba:22,141809221,180,14248,141809041,141809221
20173,6,12,1,2412,-66,-91,25,40:e3:d6:da:ba:23,141809930,184,525,141809746,141809930
20174,6,12,1,2412,-66,-91,25,40:e3:d6:da:ba:24,141810158,176,52,141809982,141810158
20175,6,12,1,2412,-66,-91,25,40:e3:d6:da:ba:25,141810386,160,68,141810226,141810386
20176,6,6,1,2412,-66,-91,25,40:e3:d6:da:ba:26,141810596,380,-170,141810216,141810596
20177,4,1,1,2412,-85,-91,6,54:e4:3a:ec:fb:64,141866056,2160,53300,141863896,141866056
20178,6,12,1,2412,-64,-91,27,40:e3:d6:da:ba:20,141911057,160,44841,141910897,141911057
20179,6,6,1,2412,-65,-91,26,40:e3:d6:da:ba:21,141911249,368,-176,141910881,141911249
20180,6,12,1,2412,-64,-91,27,40:e3:d6:da:ba:22,141911645,180,216,141911465,141911645
20181,6,12,1,2412,-64,-91,27,40:e3:d6:da:ba:23,141911859,184,30,141911675,141911859
20182,6,12,1,2412,-64,-91,27,40:e3:d6:da:ba:24,141912069,176,34,141911893,141912069
20183,6,12,1,2412,-64,-91,27,40:e3:d6:da:ba:25,141912270,160,41,141912110,141912270
20184,6,6,1,2412,-63,-91,28,40:e3:d6:da:ba:26,141912471,380,-179,141912091,141912471
20185,6,6,1,2412,-87,-91,4,e6:aa:ea:b7:4a:dd,141923189,408,10310,141922781,141923189
20186,6,6,1,2412,-87,-91,4,e6:aa:ea:b7:4a:dd,141935311,408,11714,141934903,141935311
20187,6,6,1,2412,-80,-91,11,e6:aa:ea:b7:4a:dd,141947434,408,11715,141947026,141947434
20188,4,1,1,2412,-84,-91,7,54:e4:3a:ec:fb:64,141968455,2160,18861,141966295,141968455
20189,4,1,1,2412,-84,-91,7,b8:3a:5a:88:e6:e0,141997138,2360,26323,141994778,141997138
20190,4,1,1,2412,-83,-91,8,b8:3a:5a:88:e6:e1,142000479,2376,965,141998103,142000479
20191,6,12,1,2412,-70,-91,21,40:e3:d6:da:ba:20,142013442,160,12803,142013282,142013442
20192,6,12,1,2412,-70,-91,21,40:e3:d6:da:ba:24,142014463,176,845,142014287,142014463
20193,6,6,1,2412,-68,-91,23,40:e3:d6:da:ba:26,142014893,380,50,142014513,142014893
20194,4,1,1,2412,-93,-91,-2,a6:e5:7c:28:b1:d3,142058932,992,43047,142057940,142058932
20195,6,12,1,2412,-89,-91,2,40:e3:d6:de:1e:60,142086888,156,27800,142086732,142086888
20196,6,12,1,2412,-88,-91,3,40:e3:d6:de:1e:64,142087934,172,874,142087762,142087934
20197,6,12,1,2412,-89,-91,2,40:e3:d6:de:1e:65,142088139,156,49,142087983,142088139
20198,6,6,1,2412,-89,-91,2,40:e3:d6:de:1e:66,142088355,380,-164,142087975,142088355
20199,6,6,1,2412,-77,-91,14,e6:aa:ea:c9:ea:33,142111336,408,22573,142110928,142111336
20200,6,12,1,2412,-69,-91,22,40:e3:d6:da:ba:20,142115843,160,4347,142115683,142115843
20201,6,6,1,2412,-69,-91,22,40:e3:d6:da:ba:21,142116035,368,-176,142115667,142116035
20202,6,12,1,2412,-69,-91,22,40:e3:d6:da:ba:22,142116431,180,216,142116251,142116431
20203,6,12,1,2412,-69,-91,22,40:e3:d6:da:ba:23,142116654,184,39,142116470,142116654
20204,6,12,1,2412,-69,-91,22,40:e3:d6:da:ba:24,142116864,176,34,142116688,142116864
20205,6,12,1,2412,-68,-91,23,40:e3:d6:da:ba:25,142117092,160,68,142116932,142117092
20206,6,6,1,2412,-68,-91,23,40:e3:d6:da:ba:26,142117311,380,-161,142116931,142117311
20207,6,6,1,2412,-77,-91,14,e6:aa:ea:c9:ea:33,142123477,408,5758,142123069,142123477
20208,6,6,1,2412,-76,-91,15,e6:aa:ea:c9:ea:33,142135585,408,11700,142135177,142135585
20209,6,6,1,2412,-76,-91,15,e6:aa:ea:c9:ea:33,142159817,408,23824,142159409,142159817
20210,4,1,1,2412,-50,-91,41,b8:3a:5a:88:e6:e0,142201933,2360,39756,142199573,142201933
20211,6,12,1,2412,-87,-91,4,40:e3:d6:de:1e:62,142207412,176,5303,142207236,142207412
20212,6,12,1,2412,-87,-91,4,40:e3:d6:de:1e:63,142207622,180,30,142207442,142207622
20213,6,12,1,2412,-88,-91,3,40:e3:d6:de:1e:64,142207828,172,34,142207656,142207828
20214,6,12,1,2412,-69,-91,22,40:e3:d6:da:ba:20,142218246,160,10258,142218086,142218246
20215,6,6,1,2412,-68,-91,23,40:e3:d6:da:ba:21,142218438,368,-176,142218070,142218438
20216,6,12,1,2412,-68,-91,23,40:e3:d6:da:ba:22,142218834,180,216,142218654,142218834
20217,6,12,1,2412,-68,-91,23,40:e3:d6:da:ba:23,142219066,184,48,142218882,142219066
20218,6,12,1,2412,-68,-91,23,40:e3:d6:da:ba:24,142219303,176,61,142219127,142219303
20219,6,12,1,2412,-68,-91,23,40:e3:d6:da:ba:25,142219504,160,41,142219344,142219504
20220,6,6,1,2412,-68,-91,23,40:e3:d6:da:ba:26,142219705,380,-179,142219325,142219705
20221,4,1,1,2412,-81,-91,10,54:e4:3a:ec:fb:64,142275652,2160,53787,142273492,142275652
20222,4,1,1,2412,-84,-91,7,b8:3a:5a:88:e6:e0,142304443,2360,26431,142302083,142304443
20223,4,1,1,2412,-83,-91,8,b8:3a:5a:88:e6:e1,142306832,2376,13,142304456,142306832
20224,6,6,1,2412,-79,-91,12,e6:aa:ea:b7:4a:dd,142316098,408,8858,142315690,142316098
20225,6,12,1,2412,-69,-91,22,40:e3:d6:da:ba:20,142320667,160,4409,142320507,142320667
20226,6,6,1,2412,-69,-91,22,40:e3:d6:da:ba:21,142320877,368,-158,142320509,142320877
20227,6,12,1,2412,-69,-91,22,40:e3:d6:da:ba:23,142323769,184,2708,142323585,142323769
20228,6,12,1,2412,-69,-91,22,40:e3:d6:da:ba:24,142323997,176,52,142323821,142323997
20229,6,6,1,2412,-78,-91,13,e6:aa:ea:b7:4a:dd,142340327,408,15922,142339919,142340327
20230,6,6,1,2412,-78,-91,13,e6:aa:ea:b7:4a:dd,142352448,408,11713,142352040,142352448
20231,6,6,1,2412,-77,-91,14,e6:aa:ea:b7:4a:dd,142364556,408,11700,142364148,142364556
20232,4,1,1,2412,-92,-91,-1,a6:e5:7c:28:b1:d3,142366237,992,689,142365245,142366237
20233,4,1,1,2412,-87,-91,4,b8:3a:5a:88:e6:e1,142409147,2376,40534,142406771,142409147
20234,6,12,1,2412,-68,-91,23,40:e3:d6:da:ba:20,142423051,160,13744,142422891,142423051
20235,6,6,1,2412,-68,-91,23,40:e3:d6:da:ba:21,142423270,368,-149,142422902,142423270
20236,6,12,1,2412,-68,-91,23,40:e3:d6:da:ba:22,142423684,180,234,142423504,142423684
20237,6,12,1,2412,-68,-91,23,40:e3:d6:da:ba:23,142423907,184,39,142423723,142423907
20238,6,12,1,2412,-68,-91,23,40:e3:d6:da:ba:24,142424117,176,34,142423941,142424117
20239,6,12,1,2412,-68,-91,23,40:e3:d6:da:ba:25,142424318,160,41,142424158,142424318
20240,6,6,1,2412,-68,-91,23,40:e3:d6:da:ba:26,142424528,380,-170,142424148,142424528
20241,4,1,1,2412,-84,-91,7,54:e4:3a:ec:fb:64,142480450,2160,53762,142478290,142480450
20242,4,1,1,2412,-83,-91,8,b8:3a:5a:88:e6:e0,142509144,2360,26334,142506784,142509144
20243,6,12,1,2412,-68,-91,23,40:e3:d6:da:ba:20,142525455,160,16151,142525295,142525455
20244,6,6,1,2412,-68,-91,23,40:e3:d6:da:ba:21,142525674,368,-149,142525306,142525674
20245,6,12,1,2412,-68,-91,23,40:e3:d6:da:ba:22,142526070,180,216,142525890,142526070
20246,6,12,1,2412,-68,-91,23,40:e3:d6:da:ba:23,142526293,184,39,142526109,142526293
20247,6,12,1,2412,-68,-91,23,40:e3:d6:da:ba:24,142526503,176,34,142526327,142526503
20248,6,12,1,2412,-68,-91,23,40:e3:d6:da:ba:25,142526722,160,59,142526562,142526722
20249,6,6,1,2412,-68,-91,23,40:e3:d6:da:ba:26,142526923,380,-179,142526543,142526923
20250,6,6,1,2412,-75,-91,16,e6:aa:ea:c9:ea:33,142529219,408,1888,142528811,142529219
20251,6,6,1,2412,-75,-91,16,e6:aa:ea:c9:ea:33,142541346,408,11719,142540938,142541346
20252,6,6,1,2412,-75,-91,16,e6:aa:ea:c9:ea:33,142553544,408,11790,142553136,142553544
20253,6,6,1,2412,-75,-91,16,e6:aa:ea:c9:ea:33,142577677,408,23725,142577269,142577677
20254,4,1,1,2412,-86,-91,5,54:e4:3a:ec:fb:64,142582997,2160,3160,142580837,142582997
20255,4,1,1,2412,-84,-91,7,b8:3a:5a:88:e6:e1,142613931,2376,28558,142611555,142613931
20256,6,12,1,2412,-69,-91,22,40:e3:d6:da:ba:20,142627854,160,13763,142627694,142627854
20257,6,6,1,2412,-69,-91,22,40:e3:d6:da:ba:21,142628064,368,-158,142627696,142628064
20258,6,12,1,2412,-69,-91,22,40:e3:d6:da:ba:22,142628478,180,234,142628298,142628478
20259,6,12,1,2412,-68,-91,23,40:e3:d6:da:ba:23,142628711,184,49,142628527,142628711
20260,6,12,1,2412,-68,-91,23,40:e3:d6:da:ba:24,142628947,176,60,142628771,142628947
20261,6,12,1,2412,-68,-91,23,40:e3:d6:da:ba:25,142629158,160,51,142628998,142629158
20262,6,6,1,2412,-68,-91,23,40:e3:d6:da:ba:26,142629368,380,-170,142628988,142629368
20263,6,6,1,2412,-80,-91,11,e6:aa:ea:b7:4a:dd,142631492,408,1716,142631084,142631492
20264,6,6,1,2412,-80,-91,11,e6:aa:ea:b7:4a:dd,142643677,408,11777,142643269,142643677
20265,6,6,1,2412,-79,-91,12,e6:aa:ea:b7:4a:dd,142655734,408,11649,142655326,142655734
20266,6,6,1,2412,-79,-91,12,e6:aa:ea:b7:4a:dd,142667857,408,11715,142667449,142667857
20267,6,6,1,2412,-79,-91,12,e6:aa:ea:b7:4a:dd,142679978,408,11713,142679570,142679978
20268,4,1,1,2412,-84,-91,7,b8:3a:5a:88:e6:e0,142713957,2360,31619,142711597,142713957
20269,6,12,1,2412,-70,-91,21,40:e3:d6:da:ba:20,142730246,160,16129,142730086,142730246
20270,6,6,1,2412,-70,-91,21,40:e3:d6:da:ba:21,142730438,368,-176,142730070,142730438
20271,6,12,1,2412,-69,-91,22,40:e3:d6:da:ba:22,142730825,180,207,142730645,142730825
20272,6,12,1,2412,-69,-91,22,40:e3:d6:da:ba:23,142731048,184,39,142730864,142731048
20273,6,12,1,2412,-70,-91,21,40:e3:d6:da:ba:24,142731267,176,43,142731091,142731267
20274,6,12,1,2412,-69,-91,22,40:e3:d6:da:ba:25,142731468,160,41,142731308,142731468
20275,4,1,1,2412,-86,-91,5,54:e4:3a:ec:fb:64,142787647,2160,54019,142785487,142787647
20276,6,6,1,2412,-87,-91,4,40:e3:d6:de:1e:66,142805166,380,17139,142804786,142805166
20277,6,12,1,2412,-67,-91,24,40:e3:d6:da:ba:20,142814899,136,9597,142814763,142814899
20278,6,6,1,2412,-67,-91,24,40:e3:d6:da:ba:21,142815085,348,-162,142814737,142815085
20279,6,12,1,2412,-67,-91,24,40:e3:d6:da:ba:22,142815479,156,238,142815323,142815479
20280,6,12,1,2412,-67,-91,24,40:e3:d6:da:ba:23,142815678,156,43,142815522,142815678
20281,6,12,1,2412,-67,-91,24,40:e3:d6:da:ba:25,142815887,136,73,142815751,142815887
20282,4,1,1,2412,-85,-91,6,b8:3a:5a:88:e6:e0,142816925,2360,-1322,142814565,142816925
20283,6,12,1,2412,-66,-91,25,40:e3:d6:da:ba:20,142832658,160,15573,142832498,142832658
20284,6,6,1,2412,-66,-91,25,40:e3:d6:da:ba:21,142832877,368,-149,142832509,142832877
20285,6,12,1,2412,-66,-91,25,40:e3:d6:da:ba:22,142833291,180,234,142833111,142833291
20286,6,12,1,2412,-66,-91,25,40:e3:d6:da:ba:23,142833497,184,22,142833313,142833497
20287,6,12,1,2412,-66,-91,25,40:e3:d6:da:ba:24,142833733,176,60,142833557,142833733
20288,6,12,1,2412,-66,-91,25,40:e3:d6:da:ba:25,142833962,160,69,142833802,142833962
20289,6,6,1,2412,-66,-91,25,40:e3:d6:da:ba:26,142834181,380,-161,142833801,142834181
20290,6,12,1,2412,-66,-91,25,40:e3:d6:da:ba:20,142935066,160,100725,142934906,142935066
20291,6,6,1,2412,-66,-91,25,40:e3:d6:da:ba:21,142935258,368,-176,142934890,142935258
20292,6,12,1,2412,-66,-91,25,40:e3:d6:da:ba:22,142935663,180,225,142935483,142935663
20293,6,12,1,2412,-66,-91,25,40:e3:d6:da:ba:23,142935896,184,49,142935712,142935896
20294,6,12,1,2412,-66,-91,25,40:e3:d6:da:ba:24,142936114,176,42,142935938,142936114
20295,4,1,1,2412,-85,-91,6,54:e4:3a:ec:fb:64,142992445,2160,54171,142990285,142992445
20296,4,1,1,2412,-83,-91,8,b8:3a:5a:88:e6:e0,143023300,2360,28495,143020940,143023300
20297,4,1,1,2412,-83,-91,8,b8:3a:5a:88:e6:e1,143025680,2376,4,143023304,143025680
20298,6,12,1,2412,-67,-91,24,40:e3:d6:da:ba:20,143039729,160,13889,143039569,143039729
20299,6,6,1,2412,-67,-91,24,40:e3:d6:da:ba:21,143039930,368,-167,143039562,143039930
20300,6,12,1,2412,-66,-91,25,40:e3:d6:da:ba:22,143040335,180,225,143040155,143040335
20301,6,12,1,2412,-67,-91,24,40:e3:d6:da:ba:23,143040541,184,22,143040357,143040541
20302,6,12,1,2412,-67,-91,24,40:e3:d6:da:ba:24,143040759,176,42,143040583,143040759
20303,6,12,1,2412,-66,-91,25,40:e3:d6:da:ba:25,143040978,160,59,143040818,143040978
20304,6,6,1,2412,-67,-91,24,40:e3:d6:da:ba:26,143041171,380,-187,143040791,143041171
20305,6,6,1,2412,-75,-91,16,e6:aa:ea:c9:ea:33,143062990,408,21411,143062582,143062990
20306,6,6,1,2412,-75,-91,16,e6:aa:ea:c9:ea:33,143075128,408,11730,143074720,143075128
20307,6,6,1,2412,-75,-91,16,e6:aa:ea:c9:ea:33,143087238,408,11702,143086830,143087238
20308,4,1,1,2412,-83,-91,8,b8:3a:5a:88:e6:e0,143123544,2360,33946,143121184,143123544
20309,4,1,1,2412,-84,-91,7,b8:3a:5a:88:e6:e1,143126094,2376,174,143123718,143126094
20310,6,12,1,2412,-67,-91,24,40:e3:d6:da:ba:20,143139859,160,13605,143139699,143139859
20311,6,6,1,2412,-67,-91,24,40:e3:d6:da:ba:21,143140078,368,-149,143139710,143140078
20312,6,12,1,2412,-67,-91,24,40:e3:d6:da:ba:22,143140492,180,234,143140312,143140492
20313,6,12,1,2412,-67,-91,24,40:e3:d6:da:ba:23,143140716,184,40,143140532,143140716
20314,6,12,1,2412,-67,-91,24,40:e3:d6:da:ba:24,143140943,176,51,143140767,143140943
20315,6,12,1,2412,-67,-91,24,40:e3:d6:da:ba:25,143141172,160,69,143141012,143141172
20316,6,6,1,2412,-67,-91,24,40:e3:d6:da:ba:26,143141373,380,-179,143140993,143141373
20317,6,6,1,2412,-82,-91,9,e6:aa:ea:b7:4a:dd,143153755,408,11974,143153347,143153755
20318,6,6,1,2412,-83,-91,8,e6:aa:ea:b7:4a:dd,143165665,408,11502,143165257,143165665
20319,6,6,1,2412,-83,-91,8,e6:aa:ea:b7:4a:dd,143177946,408,11873,143177538,143177946
20320,6,6,1,2412,-83,-91,8,e6:aa:ea:b7:4a:dd,143189884,408,11530,143189476,143189884
20321,4,1,1,2412,-89,-91,2,54:e4:3a:ec:fb:64,143197244,2160,5200,143195084,143197244
20322,6,6,1,2412,-85,-91,6,e6:aa:ea:b7:4a:dd,143202009,408,4357,143201601,143202009
20323,4,1,1,2412,-84,-91,7,b8:3a:5a:88:e6:e0,143225952,2360,21583,143223592,143225952
20324,4,1,1,2412,-84,-91,7,b8:3a:5a:88:e6:e1,143228340,2376,12,143225964,143228340
20325,6,12,1,2412,-71,-91,20,40:e3:d6:da:ba:20,143242249,160,13749,143242089,143242249
20326,6,6,1,2412,-71,-91,20,40:e3:d6:da:ba:21,143242441,368,-176,143242073,143242441
20327,6,12,1,2412,-70,-91,21,40:e3:d6:da:ba:22,143242871,180,250,143242691,143242871
20328,6,12,1,2412,-71,-91,20,40:e3:d6:da:ba:23,143243103,184,48,143242919,143243103
20329,6,12,1,2412,-71,-91,20,40:e3:d6:da:ba:24,143243340,176,61,143243164,143243340
20330,6,12,1,2412,-68,-91,23,40:e3:d6:da:ba:25,143243550,160,50,143243390,143243550
20331,6,6,1,2412,-68,-91,23,40:e3:d6:da:ba:26,143243751,380,-179,143243371,143243751
20332,6,12,1,2412,-69,-91,22,40:e3:d6:da:ba:20,143344674,160,100763,143344514,143344674
20333,6,6,1,2412,-69,-91,22,40:e3:d6:da:ba:21,143344875,368,-167,143344507,143344875
20334,6,12,1,2412,-69,-91,22,40:e3:d6:da:ba:22,143345289,180,234,143345109,143345289
20335,6,12,1,2412,-69,-91,22,40:e3:d6:da:ba:23,143345504,184,31,143345320,143345504
20336,6,12,1,2412,-69,-91,22,40:e3:d6:da:ba:24,143345713,176,33,143345537,143345713
20337,6,12,1,2412,-69,-91,22,40:e3:d6:da:ba:25,143345923,160,50,143345763,143345923
20338,6,6,1,2412,-69,-91,22,40:e3:d6:da:ba:26,143346142,380,-161,143345762,143346142
20339,4,1,1,2412,-94,-91,-3,a6:e5:7c:28:b1:d3,143414116,944,67030,143413172,143414116
20340,4,1,1,2412,-91,-91,0,a6:e5:7c:28:b1:d3,143415194,944,134,143414250,143415194
20341,4,1,1,2412,-91,-91,0,a6:e5:7c:28:b1:d3,143416263,944,125,143415319,143416263
20342,4,1,1,2412,-93,-91,-2,a6:e5:7c:28:b1:d3,143417332,944,125,143416388,143417332
20343,4,1,1,2412,-92,-91,-1,a6:e5:7c:28:b1:d3,143418392,944,116,143417448,143418392
20344,4,1,1,2412,-89,-91,2,a6:e5:7c:28:b1:d3,143421225,944,1889,143420281,143421225
20345,4,1,1,2412,-89,-91,2,,143422920,304,1391,143422616,143422920
20346,4,1,1,2412,-83,-91,8,b8:3a:5a:88:e6:e0,143430737,2360,5457,143428377,143430737
20347,6,12,1,2412,-70,-91,21,40:e3:d6:da:ba:20,143447049,160,16152,143446889,143447049
20348,6,6,1,2412,-70,-91,21,40:e3:d6:da:ba:21,143447250,368,-167,143446882,143447250
20349,6,12,1,2412,-70,-91,21,40:e3:d6:da:ba:22,143447664,180,234,143447484,143447664
20350,6,12,1,2412,-70,-91,21,40:e3:d6:da:ba:23,143447879,184,31,143447695,143447879
20351,6,12,1,2412,-70,-91,21,40:e3:d6:da:ba:24,143448088,176,33,143447912,143448088
20352,6,12,1,2412,-70,-91,21,40:e3:d6:da:ba:25,143448290,160,42,143448130,143448290
20353,6,6,1,2412,-69,-91,22,40:e3:d6:da:ba:26,143448491,380,-179,143448111,143448491
20354,6,6,1,2412,-73,-91,18,e6:aa:ea:c9:ea:33,143468185,408,19286,143467777,143468185
20355,6,6,1,2412,-84,-91,7,e6:aa:ea:b7:4a:dd,143468624,408,31,143468216,143468624
20356,6,6,1,2412,-74,-91,17,e6:aa:ea:c9:ea:33,143480314,408,11282,143479906,143480314
20357,6,6,1,2412,-73,-91,18,e6:aa:ea:c9:ea:33,143492426,408,11704,143492018,143492426
20358,6,6,1,2412,-84,-91,7,e6:aa:ea:b7:4a:dd,143492857,408,23,143492449,143492857
20359,6,6,1,2412,-83,-91,8,e6:aa:ea:b7:4a:dd,143518012,408,24747,143517604,143518012
20360,4,1,1,2412,-82,-91,9,b8:3a:5a:88:e6:e0,143533334,2360,12962,143530974,143533334
20361,4,1,1,2412,-82,-91,9,b8:3a:5a:88:e6:e1,143535723,2376,13,143533347,143535723
20362,6,12,1,2412,-69,-91,22,40:e3:d6:da:ba:22,143550080,180,14177,143549900,143550080
20363,6,12,1,2412,-69,-91,22,40:e3:d6:da:ba:23,143550304,184,40,143550120,143550304
20364,6,12,1,2412,-69,-91,22,40:e3:d6:da:ba:24,143550531,176,51,143550355,143550531
20365,6,12,1,2412,-69,-91,22,40:e3:d6:da:ba:25,143550751,160,60,143550591,143550751
20366,6,6,1,2412,-69,-91,22,40:e3:d6:da:ba:26,143550942,380,-189,143550562,143550942
20367,4,1,1,2412,-85,-91,6,54:e4:3a:ec:fb:64,143606841,2160,53739,143604681,143606841
20368,4,1,1,2412,-81,-91,10,b8:3a:5a:88:e6:e1,143637960,2376,28743,143635584,143637960
20369,6,12,1,2412,-69,-91,22,40:e3:d6:da:ba:20,143651855,160,13735,143651695,143651855
20370,6,6,1,2412,-69,-91,22,40:e3:d6:da:ba:21,143652074,368,-149,143651706,143652074
20371,6,12,1,2412,-69,-91,22,40:e3:d6:da:ba:22,143652460,180,206,143652280,143652460
20372,6,12,1,2412,-69,-91,22,40:e3:d6:da:ba:23,143652666,184,22,143652482,143652666
20373,6,12,1,2412,-69,-91,22,40:e3:d6:da:ba:24,143652875,176,33,143652699,143652875
20374,6,12,1,2412,-68,-91,23,40:e3:d6:da:ba:25,143653077,160,42,143652917,143653077
20375,6,6,1,2412,-69,-91,22,40:e3:d6:da:ba:26,143653287,380,-170,143652907,143653287
20376,4,1,1,2412,-84,-91,7,54:e4:3a:ec:fb:64,143709239,2160,53792,143707079,143709239
20377,4,1,1,2412,-83,-91,8,b8:3a:5a:88:e6:e0,143737945,2360,26346,143735585,143737945
20378,6,12,1,2412,-71,-91,20,40:e3:d6:da:ba:20,143754278,160,16173,143754118,143754278
20379,6,6,1,2412,-71,-91,20,40:e3:d6:da:ba:21,143754488,368,-158,143754120,143754488
20380,6,12,1,2412,-71,-91,20,40:e3:d6:da:ba:22,143754875,180,207,143754695,143754875
20381,6,12,1,2412,-71,-91,20,40:e3:d6:da:ba:23,143755107,184,48,143754923,143755107
20382,6,12,1,2412,-70,-91,21,40:e3:d6:da:ba:24,143755344,176,61,143755168,143755344
20383,6,12,1,2412,-71,-91,20,40:e3:d6:da:ba:25,143755572,160,68,143755412,143755572
20384,6,6,1,2412,-71,-91,20,40:e3:d6:da:ba:26,143755764,380,-188,143755384,143755764
20385,6,6,1,2412,-74,-91,17,e6:aa:ea:c9:ea:33,143783659,408,27487,143783251,143783659
20386,6,6,1,2412,-75,-91,16,e6:aa:ea:c9:ea:33,143807901,408,23834,143807493,143807901
20387,4,1,1,2412,-86,-91,5,54:e4:3a:ec:fb:64,143811742,2160,1681,143809582,143811742
20388,4,1,1,2412,-80,-91,11,ca:c1:70:57:d8:32,143814094,1128,1224,143812966,143814094
20389,6,12,1,2412,-71,-91,20,40:e3:d6:da:ba:20,143815200,136,970,143815064,143815200
20390,6,12,1,2412,-79,-91,12,,143815352,32,120,143815320,143815352
20391,6,6,1,2412,-71,-91,20,40:e3:d6:da:ba:21,143815426,348,-274,143815078,143815426
20392,6,6,1,2412,-80,-91,11,,143815790,44,320,143815746,143815790
20393,6,12,1,2412,-71,-91,20,40:e3:d6:da:ba:22,143815881,156,-65,143815725,143815881
20394,6,12,1,2412,-79,-91,12,,143816053,32,140,143816021,143816053
20395,6,12,1,2412,-71,-91,20,40:e3:d6:da:ba:23,143816120,156,-89,143815964,143816120
20396,6,12,1,2412,-79,-91,12,,143816292,32,140,143816260,143816292
20397,6,12,1,2412,-71,-91,20,40:e3:d6:da:ba:25,143816386,136,-42,143816250,143816386
20398,6,12,1,2412,-80,-91,11,,143816538,32,120,143816506,143816538
20399,4,1,1,2412,-87,-91,4,b8:3a:5a:88:e6:e0,143817874,2240,-904,143815634,143817874
20400,6,6,1,2412,-76,-91,15,e6:aa:ea:c9:ea:33,143820021,408,1739,143819613,143820021
20401,4,1,1,2412,-88,-91,3,b8:3a:5a:88:e6:e1,143820938,2256,-1339,143818682,143820938
20402,4,1,1,2412,-91,-91,0,,143831517,304,10275,143831213,143831517
20403,4,1,1,2412,-82,-91,9,ca:c1:70:57:d8:32,143831959,1128,-686,143830831,143831959
20404,6,6,1,2412,-76,-91,15,e6:aa:ea:c9:ea:33,143832988,408,621,143832580,143832988
20405,6,12,1,2412,-71,-91,20,40:e3:d6:da:ba:20,143833425,136,301,143833289,143833425
20406,6,6,1,2412,-80,-91,11,,143833584,44,115,143833540,143833584
20407,6,6,1,2412,-71,-91,20,40:e3:d6:da:ba:21,143833663,348,-269,143833315,143833663
20408,6,6,1,2412,-81,-91,10,,143834027,44,320,143833983,143834027
20409,6,12,1,2412,-71,-91,20,40:e3:d6:da:ba:22,143834230,156,47,143834074,143834230
20410,6,6,1,2412,-81,-91,10,,143834409,44,135,143834365,143834409
20411,6,12,1,2412,-71,-91,20,40:e3:d6:da:ba:23,143834509,156,-56,143834353,143834509
20412,6,6,1,2412,-80,-91,11,,143834687,44,134,143834643,143834687
20413,6,12,1,2412,-71,-91,20,40:e3:d6:da:ba:25,143834769,136,-54,143834633,143834769
20414,6,6,1,2412,-80,-91,11,,143834928,44,115,143834884,143834928
20415,4,1,1,2412,-85,-91,6,54:e4:3a:ec:fb:64,143835181,2112,-1859,143833069,143835181
20416,4,1,1,2412,-81,-91,10,,143837305,304,1820,143837001,143837305
20417,4,1,1,2412,-88,-91,3,b8:3a:5a:88:e6:e0,143840357,2360,692,143837997,143840357
20418,6,12,1,2412,-72,-91,19,40:e3:d6:da:ba:20,143856654,160,16137,143856494,143856654
20419,6,6,1,2412,-71,-91,20,40:e3:d6:da:ba:21,143856855,368,-167,143856487,143856855
20420,6,12,1,2412,-72,-91,19,40:e3:d6:da:ba:22,143857260,180,225,143857080,143857260
20421,6,12,1,2412,-71,-91,20,40:e3:d6:da:ba:23,143857492,184,48,143857308,143857492
20422,6,12,1,2412,-71,-91,20,40:e3:d6:da:ba:24,143857702,176,34,143857526,143857702
20423,6,12,1,2412,-72,-91,19,40:e3:d6:da:ba:25,143857912,160,50,143857752,143857912
20424,6,6,1,2412,-72,-91,19,40:e3:d6:da:ba:26,143858104,380,-188,143857724,143858104
20425,4,1,1,2412,-85,-91,6,b8:3a:5a:88:e6:e0,143942737,2360,82273,143940377,143942737
20426,6,12,1,2412,-67,-91,24,40:e3:d6:da:ba:20,143959057,160,16160,143958897,143959057
20427,6,6,1,2412,-66,-91,25,40:e3:d6:da:ba:21,143959267,368,-158,143958899,143959267
20428,6,12,1,2412,-67,-91,24,40:e3:d6:da:ba:22,143959663,180,216,143959483,143959663
20429,6,12,1,2412,-68,-91,23,40:e3:d6:da:ba:23,143959878,184,31,143959694,143959878
20430,6,12,1,2412,-71,-91,20,40:e3:d6:da:ba:24,143960096,176,42,143959920,143960096
20431,6,12,1,2412,-68,-91,23,40:e3:d6:da:ba:25,143960325,160,69,143960165,143960325
20432,6,6,1,2412,-67,-91,24,40:e3:d6:da:ba:26,143960526,380,-179,143960146,143960526
20433,6,6,1,2412,-82,-91,9,e6:aa:ea:b7:4a:dd,143989424,408,28490,143989016,143989424
20434,6,6,1,2412,-82,-91,9,e6:aa:ea:b7:4a:dd,144013684,408,23852,144013276,144013684
20435,4,1,1,2412,-85,-91,6,54:e4:3a:ec:fb:64,144016436,2160,592,144014276,144016436
20436,6,6,1,2412,-83,-91,8,e6:aa:ea:b7:4a:dd,144025799,408,8955,144025391,144025799
20437,4,1,1,2412,-86,-91,5,b8:3a:5a:88:e6:e0,144045141,2360,16982,144042781,144045141
20438,6,12,1,2412,-66,-91,25,40:e3:d6:da:ba:20,144061473,160,16172,144061313,144061473
20439,6,6,1,2412,-66,-91,25,40:e3:d6:da:ba:21,144061665,368,-176,144061297,144061665
20440,6,12,1,2412,-66,-91,25,40:e3:d6:da:ba:22,144062052,180,207,144061872,144062052
20441,6,12,1,2412,-66,-91,25,40:e3:d6:da:ba:23,144062258,184,22,144062074,144062258
20442,6,12,1,2412,-66,-91,25,40:e3:d6:da:ba:24,144062485,176,51,144062309,144062485
20443,6,12,1,2412,-66,-91,25,40:e3:d6:da:ba:25,144062686,160,41,144062526,144062686
20444,6,6,1,2412,-66,-91,25,40:e3:d6:da:ba:26,144062896,380,-170,144062516,144062896
20445,6,6,1,2412,-73,-91,18,e6:aa:ea:c9:ea:33,144098743,408,35439,144098335,144098743
20446,6,6,1,2412,-73,-91,18,e6:aa:ea:c9:ea:33,144110809,408,11658,144110401,144110809
20447,6,6,1,2412,-73,-91,18,e6:aa:ea:c9:ea:33,144122920,408,11703,144122512,144122920
20448,6,6,1,2412,-73,-91,18,e6:aa:ea:c9:ea:33,144135035,408,11707,144134627,144135035
20449,4,1,1,2412,-83,-91,8,b8:3a:5a:88:e6:e1,144149940,2376,12529,144147564,144149940
20450,6,12,1,2412,-66,-91,25,40:e3:d6:da:ba:20,144163877,160,13777,144163717,144163877
20451,6,6,1,2412,-65,-91,26,40:e3:d6:da:ba:21,144164069,368,-176,144163701,144164069
20452,6,12,1,2412,-66,-91,25,40:e3:d6:da:ba:22,144164474,180,225,144164294,144164474
20453,6,12,1,2412,-65,-91,26,40:e3:d6:da:ba:23,144164706,184,48,144164522,144164706
20454,6,12,1,2412,-65,-91,26,40:e3:d6:da:ba:24,144164934,176,52,144164758,144164934
20455,6,12,1,2412,-65,-91,26,40:e3:d6:da:ba:25,144165162,160,68,144165002,144165162
20456,6,6,1,2412,-65,-91,26,40:e3:d6:da:ba:26,144165372,380,-170,144164992,144165372
20457,4,1,1,2412,-82,-91,9,b8:3a:5a:88:e6:e0,144189044,2240,21432,144186804,144189044
20458,4,1,1,2412,-82,-91,9,b8:3a:5a:88:e6:e0,144209070,2240,17786,144206830,144209070
20459,4,1,1,2412,-83,-91,8,b8:3a:5a:88:e6:e1,144212436,2256,1110,144210180,144212436
20460,4,1,1,2412,-88,-91,3,54:e4:3a:ec:fb:64,144224113,2160,9517,144221953,144224113
20461,4,1,1,2412,-56,-91,35,b8:3a:5a:88:e6:e0,144249956,2360,23483,144247596,144249956
20462,4,1,1,2412,-84,-91,7,b8:3a:5a:88:e6:e1,144252336,2376,4,144249960,144252336
20463,6,12,1,2412,-71,-91,20,40:e3:d6:da:ba:20,144266271,160,13775,144266111,144266271
20464,6,6,1,2412,-71,-91,20,40:e3:d6:da:ba:21,144266472,368,-167,144266104,144266472
20465,6,12,1,2412,-71,-91,20,40:e3:d6:da:ba:22,144266868,180,216,144266688,144266868
20466,6,12,1,2412,-71,-91,20,40:e3:d6:da:ba:23,144267082,184,30,144266898,144267082
20467,6,12,1,2412,-71,-91,20,40:e3:d6:da:ba:24,144267301,176,43,144267125,144267301
20468,6,12,1,2412,-71,-91,20,40:e3:d6:da:ba:25,144267529,160,68,144267369,144267529
20469,6,6,1,2412,-71,-91,20,40:e3:d6:da:ba:26,144267730,380,-179,144267350,144267730
20470,6,6,1,2412,-80,-91,11,e6:aa:ea:b7:4a:dd,144317173,408,49035,144316765,144317173
20471,4,1,1,2412,-88,-91,3,54:e4:3a:ec:fb:64,144323634,2160,4301,144321474,144323634
20472,6,6,1,2412,-80,-91,11,e6:aa:ea:b7:4a:dd,144329289,408,5247,144328881,144329289
20473,6,6,1,2412,-80,-91,11,e6:aa:ea:b7:4a:dd,144341399,408,11702,144340991,144341399
20474,6,12,1,2412,-65,-91,26,40:e3:d6:da:ba:20,144368679,160,27120,144368519,144368679
20475,6,6,1,2412,-65,-91,26,40:e3:d6:da:ba:21,144368898,368,-149,144368530,144368898
20476,6,12,1,2412,-65,-91,26,40:e3:d6:da:ba:22,144369312,180,234,144369132,144369312
20477,6,12,1,2412,-65,-91,26,40:e3:d6:da:ba:23,144369518,184,22,144369334,144369518
20478,6,12,1,2412,-65,-91,26,40:e3:d6:da:ba:24,144369754,176,60,144369578,144369754
20479,6,12,1,2412,-65,-91,26,40:e3:d6:da:ba:25,144369956,160,42,144369796,144369956
20480,6,6,1,2412,-65,-91,26,40:e3:d6:da:ba:26,144370166,380,-170,144369786,144370166
20481,6,6,1,2412,-70,-91,21,e6:aa:ea:c9:ea:33,144414058,408,43484,144413650,144414058
20482,6,6,1,2412,-70,-91,21,e6:aa:ea:c9:ea:33,144438210,408,23744,144437802,144438210
20483,6,6,1,2412,-71,-91,20,e6:aa:ea:c9:ea:33,144450325,408,11707,144449917,144450325
20484,4,1,1,2412,-85,-91,6,b8:3a:5a:88:e6:e0,144454762,2360,2077,144452402,144454762
20485,6,6,1,2412,-71,-91,20,e6:aa:ea:c9:ea:33,144466307,408,11137,144465899,144466307
20486,6,12,1,2412,-66,-91,25,40:e3:d6:da:ba:20,144471054,160,4587,144470894,144471054
20487,4,1,1,2412,-82,-91,9,54:e4:3a:ec:fb:64,144528433,2160,55219,144526273,144528433
20488,4,1,1,2412,-87,-91,4,b8:3a:5a:88:e6:e0,144557141,2360,26348,144554781,144557141
20489,6,12,1,2412,-69,-91,22,40:e3:d6:da:ba:20,144573467,160,16166,144573307,144573467
20490,6,6,1,2412,-69,-91,22,40:e3:d6:da:ba:21,144573686,368,-149,144573318,144573686
20491,6,12,1,2412,-68,-91,23,40:e3:d6:da:ba:22,144574082,180,216,144573902,144574082
20492,6,12,1,2412,-69,-91,22,40:e3:d6:da:ba:23,144574297,184,31,144574113,144574297
20493,6,12,1,2412,-68,-91,23,40:e3:d6:da:ba:24,144574506,176,33,144574330,144574506
20494,6,12,1,2412,-68,-91,23,40:e3:d6:da:ba:25,144574735,160,69,144574575,144574735
20495,4,1,1,2412,-83,-91,8,54:e4:3a:ec:fb:64,144630955,2160,54060,144628795,144630955
20496,6,12,1,2412,-69,-91,22,40:e3:d6:da:ba:20,144675856,160,44741,144675696,144675856
20497,6,6,1,2412,-69,-91,22,40:e3:d6:da:ba:21,144676066,368,-158,144675698,144676066
20498,6,12,1,2412,-69,-91,22,40:e3:d6:da:ba:22,144676480,180,234,144676300,144676480
20499,6,12,1,2412,-68,-91,23,40:e3:d6:da:ba:23,144676712,184,48,144676528,144676712
20500,6,12,1,2412,-68,-91,23,40:e3:d6:da:ba:24,144676922,176,34,144676746,144676922
20501,6,12,1,2412,-69,-91,22,40:e3:d6:da:ba:25,144677141,160,59,144676981,144677141
20502,6,6,1,2412,-68,-91,23,40:e3:d6:da:ba:26,144677374,380,-147,144676994,144677374
20503,6,6,1,2412,-79,-91,12,e6:aa:ea:b7:4a:dd,144722930,408,45148,144722522,144722930
20504,6,6,1,2412,-74,-91,17,e6:aa:ea:c9:ea:33,144729611,408,6273,144729203,144729611
20505,4,1,1,2412,-86,-91,5,54:e4:3a:ec:fb:64,144733230,2160,1459,144731070,144733230
20506,6,6,1,2412,-79,-91,12,e6:aa:ea:b7:4a:dd,144746972,408,13334,144746564,144746972
20507,6,6,1,2412,-73,-91,18,e6:aa:ea:c9:ea:33,144753848,408,6468,144753440,144753848
20508,6,6,1,2412,-79,-91,12,e6:aa:ea:b7:4a:dd,144759077,408,4821,144758669,144759077
20509,4,1,1,2412,-93,-91,-2,c0:c9:e3:4d:6e:bf,144759737,872,-212,144758865,144759737
20510,4,1,1,2412,-91,-91,0,,144760627,304,586,144760323,144760627
20511,6,6,1,2412,-79,-91,12,e6:aa:ea:b7:4a:dd,144771190,408,10155,144770782,144771190
20512,6,12,1,2412,-68,-91,23,40:e3:d6:da:ba:20,144778518,160,7168,144778358,144778518
20513,6,6,1,2412,-67,-91,24,40:e3:d6:da:ba:21,144778719,368,-167,144778351,144778719
20514,6,12,1,2412,-66,-91,25,40:e3:d6:da:ba:22,144779124,180,225,144778944,144779124
20515,6,12,1,2412,-66,-91,25,40:e3:d6:da:ba:23,144779339,184,31,144779155,144779339
20516,6,12,1,2412,-65,-91,26,40:e3:d6:da:ba:24,144779557,176,42,144779381,144779557
20517,6,12,1,2412,-65,-91,26,40:e3:d6:da:ba:25,144779802,160,85,144779642,144779802
20518,6,6,1,2412,-66,-91,25,40:e3:d6:da:ba:26,144780021,380,-161,144779641,144780021
20519,4,1,1,2412,-88,-91,3,54:e4:3a:ec:fb:64,144835630,2160,53449,144833470,144835630
20520,4,1,1,2412,-87,-91,4,b8:3a:5a:88:e6:e0,144861395,2240,23525,144859155,144861395
20521,4,1,1,2412,-88,-91,3,b8:3a:5a:88:e6:e1,144863690,2256,39,144861434,144863690
20522,6,12,1,2412,-67,-91,24,40:e3:d6:da:ba:20,144880721,160,16871,144880561,144880721
20523,6,6,1,2412,-67,-91,24,40:e3:d6:da:ba:21,144880922,368,-167,144880554,144880922
20524,6,12,1,2412,-67,-91,24,40:e3:d6:da:ba:22,144881318,180,216,144881138,144881318
20525,4,1,1,2412,-87,-91,4,54:e4:3a:ec:fb:64,144938029,2160,54551,144935869,144938029
20526,6,12,1,2412,-89,-91,2,,144960591,32,22530,144960559,144960591
20527,4,1,1,2412,-87,-91,4,b8:3a:5a:88:e6:e1,144969162,2376,6195,144966786,144969162
20528,6,12,1,2412,-67,-91,24,40:e3:d6:da:ba:20,144983073,160,13751,144982913,144983073
20529,6,6,1,2412,-67,-91,24,40:e3:d6:da:ba:21,144983292,368,-149,144982924,144983292
20530,6,12,1,2412,-66,-91,25,40:e3:d6:da:ba:22,144983687,180,215,144983507,144983687
20531,6,12,1,2412,-67,-91,24,40:e3:d6:da:ba:24,144984121,176,258,144983945,144984121
20532,6,12,1,2412,-67,-91,24,40:e3:d6:da:ba:25,144984340,160,59,144984180,144984340
20533,6,6,1,2412,-67,-91,24,40:e3:d6:da:ba:26,144984559,380,-161,144984179,144984559
20534,4,1,1,2412,-86,-91,5,b8:3a:5a:88:e6:e0,145008088,2240,21289,145005848,145008088
20535,4,1,1,2412,-86,-91,5,54:e4:3a:ec:fb:64,145040427,2160,30179,145038267,145040427
20536,6,6,1,2412,-73,-91,18,e6:aa:ea:c9:ea:33,145045338,408,4503,145044930,145045338
20537,6,6,1,2412,-73,-91,18,e6:aa:ea:c9:ea:33,145057462,408,11716,145057054,145057462
20538,4,1,1,2412,-87,-91,4,b8:3a:5a:88:e6:e1,145071552,2376,11714,145069176,145071552
20539,6,6,1,2412,-73,-91,18,e6:aa:ea:c9:ea:33,145081697,408,9737,145081289,145081697
20540,6,12,1,2412,-66,-91,25,40:e3:d6:da:ba:23,145086266,184,4385,145086082,145086266
20541,6,12,1,2412,-66,-91,25,40:e3:d6:da:ba:24,145086493,176,51,145086317,145086493
20542,6,6,1,2412,-73,-91,18,e6:aa:ea:c9:ea:33,145094219,408,7318,145093811,145094219
20543,4,1,1,2412,-92,-91,-1,a6:e5:7c:28:b1:d3,145131107,992,35896,145130115,145131107
20544,6,6,1,2412,-79,-91,12,e6:aa:ea:b7:4a:dd,145140390,408,8875,145139982,145140390
20545,6,6,1,2412,-78,-91,13,e6:aa:ea:b7:4a:dd,145152508,408,11710,145152100,145152508
20546,6,6,1,2412,-80,-91,11,e6:aa:ea:b7:4a:dd,145164632,408,11716,145164224,145164632
20547,4,1,1,2412,-86,-91,5,b8:3a:5a:88:e6:e0,145171571,2360,4579,145169211,145171571
20548,4,1,1,2412,-86,-91,5,b8:3a:5a:88:e6:e1,145173978,2376,31,145171602,145173978
20549,6,12,1,2412,-67,-91,24,40:e3:d6:da:ba:20,145187861,160,13723,145187701,145187861
20550,6,6,1,2412,-67,-91,24,40:e3:d6:da:ba:21,145188062,368,-167,145187694,145188062
20551,6,12,1,2412,-67,-91,24,40:e3:d6:da:ba:22,145188458,180,216,145188278,145188458
20552,6,12,1,2412,-66,-91,25,40:e3:d6:da:ba:23,145188673,184,31,145188489,145188673
20553,6,12,1,2412,-67,-91,24,40:e3:d6:da:ba:24,145188891,176,42,145188715,145188891
20554,6,12,1,2412,-67,-91,24,40:e3:d6:da:ba:25,145189093,160,42,145188933,145189093
20555,6,6,1,2412,-67,-91,24,40:e3:d6:da:ba:26,145189294,380,-179,145188914,145189294
20556,6,6,1,2412,-79,-91,12,e6:aa:ea:b7:4a:dd,145190062,408,360,145189654,145190062
20557,4,1,1,2412,-92,-91,-1,a6:e5:7c:28:b1:d3,145233283,992,42229,145232291,145233283
20558,4,1,1,2412,-88,-91,3,b8:3a:5a:88:e6:e1,145276346,2376,40687,145273970,145276346
20559,6,12,1,2412,-67,-91,24,40:e3:d6:da:ba:20,145290267,160,13761,145290107,145290267
20560,6,6,1,2412,-67,-91,24,40:e3:d6:da:ba:21,145290459,368,-176,145290091,145290459
20561,6,12,1,2412,-67,-91,24,40:e3:d6:da:ba:22,145290864,180,225,145290684,145290864
20562,6,12,1,2412,-67,-91,24,40:e3:d6:da:ba:23,145291070,184,22,145290886,145291070
20563,6,12,1,2412,-67,-91,24,40:e3:d6:da:ba:24,145291297,176,51,145291121,145291297
20564,6,12,1,2412,-67,-91,24,40:e3:d6:da:ba:25,145291517,160,60,145291357,145291517
20565,6,6,1,2412,-67,-91,24,40:e3:d6:da:ba:26,145291727,380,-170,145291347,145291727
20566,4,1,1,2412,-91,-91,0,a6:e5:7c:28:b1:d3,145335618,992,42899,145334626,145335618
20567,6,6,1,2412,-73,-91,18,e6:aa:ea:c9:ea:33,145360054,408,24028,145359646,145360054
20568,6,6,1,2412,-73,-91,18,e6:aa:ea:c9:ea:33,145372171,408,11709,145371763,145372171
20569,6,6,1,2412,-73,-91,18,e6:aa:ea:c9:ea:33,145384287,408,11708,145383879,145384287
20570,6,12,1,2412,-69,-91,22,40:e3:d6:da:ba:20,145392684,160,8237,145392524,145392684
20571,6,6,1,2412,-69,-91,22,40:e3:d6:da:ba:21,145392885,368,-167,145392517,145392885
20572,6,12,1,2412,-67,-91,24,40:e3:d6:da:ba:23,145393496,184,427,145393312,145393496
20573,6,12,1,2412,-67,-91,24,40:e3:d6:da:ba:24,145393714,176,42,145393538,145393714
20574,6,6,1,2412,-67,-91,24,40:e3:d6:da:ba:26,145394170,380,76,145393790,145394170
20575,6,6,1,2412,-73,-91,18,e6:aa:ea:c9:ea:33,145396407,408,1829,145395999,145396407
20576,6,6,1,2412,-73,-91,18,e6:aa:ea:c9:ea:33,145408513,408,11698,145408105,145408513
20577,6,6,1,2412,-78,-91,13,e6:aa:ea:b7:4a:dd,145455769,408,46848,145455361,145455769
20578,4,1,1,2412,-87,-91,4,b8:3a:5a:88:e6:e0,145478749,2360,20620,145476389,145478749
20579,6,6,1,2412,-78,-91,13,e6:aa:ea:b7:4a:dd,145492120,408,12963,145491712,145492120
20580,6,12,1,2412,-68,-91,23,40:e3:d6:da:ba:20,145495064,160,2784,145494904,145495064
20581,6,6,1,2412,-67,-91,24,40:e3:d6:da:ba:21,145495255,368,-177,145494887,145495255
20582,6,12,1,2412,-67,-91,24,40:e3:d6:da:ba:22,145495642,180,207,145495462,145495642
20583,6,12,1,2412,-67,-91,24,40:e3:d6:da:ba:23,145495857,184,31,145495673,145495857
20584,6,12,1,2412,-67,-91,24,40:e3:d6:da:ba:24,145496066,176,33,145495890,145496066
20585,6,12,1,2412,-67,-91,24,40:e3:d6:da:ba:25,145496277,160,51,145496117,145496277
20586,6,6,1,2412,-67,-91,24,40:e3:d6:da:ba:26,145496478,380,-179,145496098,145496478
20587,6,6,1,2412,-78,-91,13,e6:aa:ea:b7:4a:dd,145504240,408,7354,145503832,145504240
20588,4,1,1,2412,-86,-91,5,54:e4:3a:ec:fb:64,145552424,2160,46024,145550264,145552424
20589,4,1,1,2412,-86,-91,5,b8:3a:5a:88:e6:e0,145581162,2360,26378,145578802,145581162
20590,4,1,1,2412,-86,-91,5,b8:3a:5a:88:e6:e1,145584780,2376,1242,145582404,145584780
20591,6,12,1,2412,-68,-91,23,40:e3:d6:da:ba:20,145597476,160,12536,145597316,145597476
20592,6,6,1,2412,-68,-91,23,40:e3:d6:da:ba:21,145597678,368,-166,145597310,145597678
20593,6,12,1,2412,-67,-91,24,40:e3:d6:da:ba:22,145598082,180,224,145597902,145598082
20594,6,12,1,2412,-67,-91,24,40:e3:d6:da:ba:23,145598306,184,40,145598122,145598306
20595,6,12,1,2412,-67,-91,24,40:e3:d6:da:ba:24,145598542,176,60,145598366,145598542
20596,6,12,1,2412,-68,-91,23,40:e3:d6:da:ba:25,145598771,160,69,145598611,145598771
20597,6,6,1,2412,-67,-91,24,40:e3:d6:da:ba:26,145598963,380,-188,145598583,145598963
20598,6,12,1,2412,-68,-91,23,40:e3:d6:da:ba:20,145699861,160,100738,145699701,145699861
20599,4,1,1,2412,-85,-91,6,54:e4:3a:ec:fb:64,145757221,2160,55200,145755061,145757221
20600,6,6,1,2412,-79,-91,12,e6:aa:ea:c9:ea:33,145777229,408,19600,145776821,145777229
20601,4,1,1,2412,-86,-91,5,b8:3a:5a:88:e6:e0,145786683,2360,7094,145784323,145786683
20602,6,6,1,2412,-77,-91,14,e6:aa:ea:c9:ea:33,145801474,408,14383,145801066,145801474
20603,6,12,1,2412,-69,-91,22,40:e3:d6:da:ba:20,145802279,160,645,145802119,145802279
20604,6,6,1,2412,-68,-91,23,40:e3:d6:da:ba:21,145802498,368,-149,145802130,145802498
20605,6,12,1,2412,-68,-91,23,40:e3:d6:da:ba:22,145802894,180,216,145802714,145802894
20606,6,12,1,2412,-68,-91,23,40:e3:d6:da:ba:23,145803109,184,31,145802925,145803109
20607,6,12,1,2412,-68,-91,23,40:e3:d6:da:ba:24,145803345,176,60,145803169,145803345
20608,6,12,1,2412,-68,-91,23,40:e3:d6:da:ba:25,145803574,160,69,145803414,145803574
20609,6,6,1,2412,-69,-91,22,40:e3:d6:da:ba:26,145803793,380,-161,145803413,145803793
20610,6,6,1,2412,-77,-91,14,e6:aa:ea:c9:ea:33,145813600,408,9399,145813192,145813600
20611,6,6,1,2412,-77,-91,14,e6:aa:ea:c9:ea:33,145825744,408,11736,145825336,145825744
20612,4,1,1,2412,-84,-91,7,54:e4:3a:ec:fb:64,145859621,2160,31717,145857461,145859621
20613,4,1,1,2412,-86,-91,5,b8:3a:5a:88:e6:e1,145890889,2376,28892,145888513,145890889
20614,6,12,1,2412,-69,-91,22,40:e3:d6:da:ba:20,145904940,160,13891,145904780,145904940
20615,6,6,1,2412,-69,-91,22,40:e3:d6:da:ba:21,145905132,368,-176,145904764,145905132
20616,6,12,1,2412,-68,-91,23,40:e3:d6:da:ba:22,145905537,180,225,145905357,145905537
20617,6,12,1,2412,-68,-91,23,40:e3:d6:da:ba:23,145905751,184,30,145905567,145905751
20618,6,12,1,2412,-68,-91,23,40:e3:d6:da:ba:24,145905970,176,43,145905794,145905970
20619,6,12,1,2412,-69,-91,22,40:e3:d6:da:ba:25,145906180,160,50,145906020,145906180
20620,6,6,1,2412,-68,-91,23,40:e3:d6:da:ba:26,145906390,380,-170,145906010,145906390
20621,4,1,1,2412,-85,-91,6,54:e4:3a:ec:fb:64,145907554,2112,-948,145905442,145907554
20622,4,1,1,2412,-84,-91,7,54:e4:3a:ec:fb:64,145912261,2112,2595,145910149,145912261
20623,4,1,1,2412,-83,-91,8,54:e4:3a:ec:fb:64,145962020,2160,47599,145959860,145962020
20624,6,6,1,2412,-79,-91,12,e6:aa:ea:b7:4a:dd,145976009,408,13581,145975601,145976009
20625,6,12,1,2412,-67,-91,24,40:e3:d6:da:ba:20,145986191,136,10046,145986055,145986191
20626,6,6,1,2412,-68,-91,23,40:e3:d6:da:ba:21,145986673,348,134,145986325,145986673
20627,6,12,1,2412,-67,-91,24,40:e3:d6:da:ba:22,145987058,156,229,145986902,145987058
20628,6,12,1,2412,-67,-91,24,40:e3:d6:da:ba:23,145987249,156,35,145987093,145987249
20629,6,12,1,2412,-67,-91,24,40:e3:d6:da:ba:25,145987448,136,63,145987312,145987448
20630,4,1,1,2412,-87,-91,4,b8:3a:5a:88:e6:e0,145990753,2360,945,145988393,145990753
20631,4,1,1,2412,-85,-91,6,b8:3a:5a:88:e6:e1,145993132,2376,3,145990756,145993132
20632,6,12,1,2412,-82,-91,9,40:e3:d6:da:c6:e0,145995443,960,1351,145994483,145995443
20633,6,6,1,2412,-79,-91,12,e6:aa:ea:b7:4a:dd,146000240,408,4389,145999832,146000240
20634,6,12,1,2412,-67,-91,24,40:e3:d6:da:ba:20,146007067,160,6667,146006907,146007067
20635,6,6,1,2412,-67,-91,24,40:e3:d6:da:ba:21,146007259,368,-176,146006891,146007259
20636,6,12,1,2412,-67,-91,24,40:e3:d6:da:ba:22,146007664,180,225,146007484,146007664
20637,6,12,1,2412,-67,-91,24,40:e3:d6:da:ba:23,146007879,184,31,146007695,146007879
20638,6,12,1,2412,-67,-91,24,40:e3:d6:da:ba:24,146008088,176,33,146007912,146008088
20639,6,12,1,2412,-67,-91,24,40:e3:d6:da:ba:25,146008316,160,68,146008156,146008316
20640,6,6,1,2412,-67,-91,24,40:e3:d6:da:ba:26,146008535,380,-161,146008155,146008535
20641,6,6,1,2412,-79,-91,12,e6:aa:ea:b7:4a:dd,146012365,408,3422,146011957,146012365
20642,6,6,1,2412,-78,-91,13,e6:aa:ea:b7:4a:dd,146024478,408,11705,146024070,146024478
20643,4,1,1,2412,-84,-91,7,54:e4:3a:ec:fb:64,146064419,2160,37781,146062259,146064419
20644,6,12,1,2412,-67,-91,24,40:e3:d6:da:ba:20,146109487,160,44908,146109327,146109487
20645,6,6,1,2412,-67,-91,24,40:e3:d6:da:ba:21,146109679,368,-176,146109311,146109679
20646,6,12,1,2412,-67,-91,24,40:e3:d6:da:ba:22,146110093,180,234,146109913,146110093
20647,6,12,1,2412,-67,-91,24,40:e3:d6:da:ba:23,146110308,184,31,146110124,146110308
20648,6,12,1,2412,-67,-91,24,40:e3:d6:da:ba:24,146110544,176,60,146110368,146110544
20649,6,12,1,2412,-67,-91,24,40:e3:d6:da:ba:25,146110746,160,42,146110586,146110746
20650,6,6,1,2412,-67,-91,24,40:e3:d6:da:ba:26,146110965,380,-161,146110585,146110965
20651,4,1,1,2412,-85,-91,6,54:e4:3a:ec:fb:64,146166819,2160,53694,146164659,146166819
20652,6,12,1,2412,-67,-91,24,40:e3:d6:da:ba:20,146211883,160,44904,146211723,146211883
20653,6,6,1,2412,-67,-91,24,40:e3:d6:da:ba:21,146212084,368,-167,146211716,146212084
20654,6,12,1,2412,-67,-91,24,40:e3:d6:da:ba:22,146212489,180,225,146212309,146212489
20655,6,12,1,2412,-67,-91,24,40:e3:d6:da:ba:23,146212695,184,22,146212511,146212695
20656,6,12,1,2412,-67,-91,24,40:e3:d6:da:ba:24,146212904,176,33,146212728,146212904
20657,6,12,1,2412,-67,-91,24,40:e3:d6:da:ba:25,146213114,160,50,146212954,146213114
20658,6,6,1,2412,-67,-91,24,40:e3:d6:da:ba:26,146213306,380,-188,146212926,146213306
20659,4,1,1,2412,-83,-91,8,54:e4:3a:ec:fb:64,146269217,2160,53751,146267057,146269217
20660,4,1,1,2412,-83,-91,8,54:e4:3a:ec:fb:64,146275666,2112,4337,146273554,146275666
20661,4,1,1,2412,-86,-91,5,b8:3a:5a:88:e6:e1,146300326,2376,22284,146297950,146300326
20662,6,6,1,2412,-75,-91,16,e6:aa:ea:c9:ea:33,146308690,408,7956,146308282,146308690
20663,6,12,1,2412,-68,-91,23,40:e3:d6:da:ba:20,146314266,160,5416,146314106,146314266
20664,6,6,1,2412,-68,-91,23,40:e3:d6:da:ba:21,146314458,368,-176,146314090,146314458
20665,6,12,1,2412,-68,-91,23,40:e3:d6:da:ba:22,146314872,180,234,146314692,146314872
20666,6,12,1,2412,-68,-91,23,40:e3:d6:da:ba:23,146315105,184,49,146314921,146315105
20667,6,12,1,2412,-68,-91,23,40:e3:d6:da:ba:24,146315341,176,60,146315165,146315341
20668,6,6,1,2412,-75,-91,16,e6:aa:ea:c9:ea:33,146324175,408,8426,146323767,146324175
20669,6,6,1,2412,-76,-91,15,e6:aa:ea:c9:ea:33,146333044,408,8461,146332636,146333044
20670,4,1,1,2412,-83,-91,8,54:e4:3a:ec:fb:64,146371616,2160,36412,146369456,146371616
20671,6,6,1,2412,-80,-91,11,e6:aa:ea:b7:4a:dd,146393904,408,21880,146393496,146393904
20672,6,6,1,2412,-79,-91,12,e6:aa:ea:b7:4a:dd,146406019,408,11707,146405611,146406019
20673,6,12,1,2412,-69,-91,22,40:e3:d6:da:ba:20,146416746,160,10567,146416586,146416746
20674,6,6,1,2412,-69,-91,22,40:e3:d6:da:ba:21,146416938,368,-176,146416570,146416938
20675,6,12,1,2412,-68,-91,23,40:e3:d6:da:ba:22,146417334,180,216,146417154,146417334
20676,6,12,1,2412,-69,-91,22,40:e3:d6:da:ba:23,146417558,184,40,146417374,146417558
20677,6,12,1,2412,-68,-91,23,40:e3:d6:da:ba:24,146417767,176,33,146417591,146417767
20678,6,12,1,2412,-69,-91,22,40:e3:d6:da:ba:25,146417969,160,42,146417809,146417969
20679,6,6,1,2412,-68,-91,23,40:e3:d6:da:ba:26,146418179,380,-170,146417799,146418179
20680,6,6,1,2412,-80,-91,11,e6:aa:ea:b7:4a:dd,146418602,408,15,146418194,146418602
20681,6,6,1,2412,-80,-91,11,e6:aa:ea:b7:4a:dd,146430255,408,11245,146429847,146430255
20682,6,6,1,2412,-80,-91,11,e6:aa:ea:b7:4a:dd,146442370,408,11707,146441962,146442370
20683,6,12,1,2412,-67,-91,24,40:e3:d6:da:ba:20,146520890,160,78360,146520730,146520890
20684,6,6,1,2412,-67,-91,24,40:e3:d6:da:ba:21,146521082,368,-176,146520714,146521082
20685,6,12,1,2412,-67,-91,24,40:e3:d6:da:ba:22,146521496,180,234,146521316,146521496
20686,6,12,1,2412,-67,-91,24,40:e3:d6:da:ba:23,146521729,184,49,146521545,146521729
20687,6,12,1,2412,-67,-91,24,40:e3:d6:da:ba:24,146521947,176,42,146521771,146521947
20688,6,12,1,2412,-67,-91,24,40:e3:d6:da:ba:25,146522167,160,60,146522007,146522167
20689,6,6,1,2412,-67,-91,24,40:e3:d6:da:ba:26,146522359,380,-188,146521979,146522359
20690,4,1,1,2412,-85,-91,6,54:e4:3a:ec:fb:64,146548016,2112,23545,146545904,146548016
20691,4,1,1,2412,-85,-91,6,54:e4:3a:ec:fb:64,146551015,2112,887,146548903,146551015
20692,4,1,1,2412,-85,-91,6,54:e4:3a:ec:fb:64,146553480,2112,353,146551368,146553480
20693,4,1,1,2412,-85,-91,6,54:e4:3a:ec:fb:64,146556828,2112,1236,146554716,146556828
20694,4,1,1,2412,-90,-91,1,a6:e5:7c:28:b1:d3,146565135,992,7315,146564143,146565135
20695,4,1,1,2412,-89,-91,2,54:e4:3a:ec:fb:64,146568002,2112,755,146565890,146568002
20696,4,1,1,2412,-85,-91,6,54:e4:3a:ec:fb:64,146570413,2112,299,146568301,146570413
20697,4,1,1,2412,-86,-91,5,54:e4:3a:ec:fb:64,146573096,2112,571,146570984,146573096
20698,4,1,1,2412,-86,-91,5,54:e4:3a:ec:fb:64,146575425,2112,217,146573313,146575425
20699,4,1,1,2412,-86,-91,5,54:e4:3a:ec:fb:64,146577609,2160,24,146575449,146577609
20700,4,1,1,2412,-86,-91,5,b8:3a:5a:88:e6:e0,146605146,2360,25177,146602786,146605146
20701,4,1,1,2412,-86,-91,5,b8:3a:5a:88:e6:e1,146607678,2376,156,146605302,146607678
20702,6,12,1,2412,-64,-91,27,40:e3:d6:da:ba:20,146621464,160,13626,146621304,146621464
20703,6,6,1,2412,-64,-91,27,40:e3:d6:da:ba:21,146621674,368,-158,146621306,146621674
20704,6,12,1,2412,-64,-91,27,40:e3:d6:da:ba:22,146622079,180,225,146621899,146622079
20705,6,12,1,2412,-64,-91,27,40:e3:d6:da:ba:23,146622312,184,49,146622128,146622312
20706,6,12,1,2412,-64,-91,27,40:e3:d6:da:ba:24,146622539,176,51,146622363,146622539
20707,6,12,1,2412,-64,-91,27,40:e3:d6:da:ba:25,146622759,160,60,146622599,146622759
20708,6,12,1,2412,-64,-91,27,40:e3:d6:da:ba:20,146641980,136,19085,146641844,146641980
20709,6,6,1,2412,-64,-91,27,40:e3:d6:da:ba:21,146642157,348,-171,146641809,146642157
20710,6,12,1,2412,-64,-91,27,40:e3:d6:da:ba:22,146642560,156,247,146642404,146642560
20711,6,12,1,2412,-64,-91,27,40:e3:d6:da:ba:23,146642751,156,35,146642595,146642751
20712,6,12,1,2412,-64,-91,27,40:e3:d6:da:ba:25,146642959,136,72,146642823,146642959
20713,4,1,1,2412,-92,-91,-1,a6:e5:7c:28:b1:d3,146666279,992,22328,146665287,146666279
20714,4,1,1,2412,-87,-91,4,54:e4:3a:ec:fb:64,146678813,2160,10374,146676653,146678813
20715,4,1,1,2412,-84,-91,7,b8:3a:5a:88:e6:e0,146707565,2360,26392,146705205,146707565
20716,4,1,1,2412,-86,-91,5,b8:3a:5a:88:e6:e1,146709945,2376,4,146707569,146709945
20717,6,12,1,2412,-68,-91,23,40:e3:d6:da:ba:23,146724712,184,14583,146724528,146724712
20718,6,12,1,2412,-68,-91,23,40:e3:d6:da:ba:24,146724931,176,43,146724755,146724931
20719,6,12,1,2412,-68,-91,23,40:e3:d6:da:ba:25,146725159,160,68,146724999,146725159
20720,6,6,1,2412,-68,-91,23,40:e3:d6:da:ba:26,146725360,380,-179,146724980,146725360
20721,4,1,1,2412,-85,-91,6,54:e4:3a:ec:fb:64,146781214,2160,53694,146779054,146781214
20722,6,6,1,2412,-78,-91,13,e6:aa:ea:b7:4a:dd,146811618,408,29996,146811210,146811618
20723,6,12,1,2412,-69,-91,22,40:e3:d6:da:ba:20,146826265,160,14487,146826105,146826265
20724,6,6,1,2412,-69,-91,22,40:e3:d6:da:ba:21,146826484,368,-149,146826116,146826484
20725,6,12,1,2412,-69,-91,22,40:e3:d6:da:ba:22,146826889,180,225,146826709,146826889
20726,6,12,1,2412,-69,-91,22,40:e3:d6:da:ba:23,146827095,184,22,146826911,146827095
20727,6,12,1,2412,-69,-91,22,40:e3:d6:da:ba:24,146827322,176,51,146827146,146827322
20728,6,12,1,2412,-69,-91,22,40:e3:d6:da:ba:25,146827524,160,42,146827364,146827524
20729,6,6,1,2412,-69,-91,22,40:e3:d6:da:ba:26,146827725,380,-179,146827345,146827725
20730,6,6,1,2412,-71,-91,20,e6:aa:ea:c9:ea:33,146828265,408,132,146827857,146828265
20731,6,6,1,2412,-80,-91,11,e6:aa:ea:b7:4a:dd,146835855,408,7182,146835447,146835855
20732,6,6,1,2412,-81,-91,10,e6:aa:ea:b7:4a:dd,146848020,408,11757,146847612,146848020
20733,6,6,1,2412,-70,-91,21,e6:aa:ea:c9:ea:33,146852501,408,4073,146852093,146852501
20734,6,6,1,2412,-81,-91,10,e6:aa:ea:b7:4a:dd,146860087,408,7178,146859679,146860087
20735,6,6,1,2412,-70,-91,21,e6:aa:ea:c9:ea:33,146864623,408,4128,146864215,146864623
20736,4,1,1,2412,-84,-91,7,54:e4:3a:ec:fb:64,146883613,2160,16830,146881453,146883613
20737,4,1,1,2412,-86,-91,5,b8:3a:5a:88:e6:e0,146912365,2360,26392,146910005,146912365
20738,4,1,1,2412,-86,-91,5,b8:3a:5a:88:e6:e1,146914763,2376,22,146912387,146914763
20739,6,12,1,2412,-69,-91,22,40:e3:d6:da:ba:20,146928690,160,13767,146928530,146928690
20740,6,6,1,2412,-69,-91,22,40:e3:d6:da:ba:21,146928900,368,-158,146928532,146928900
20741,6,12,1,2412,-68,-91,23,40:e3:d6:da:ba:22,146929305,180,225,146929125,146929305
20742,6,12,1,2412,-69,-91,22,40:e3:d6:da:ba:23,146929520,184,31,146929336,146929520
20743,6,12,1,2412,-69,-91,22,40:e3:d6:da:ba:24,146929729,176,33,146929553,146929729
20744,4,1,1,2412,-85,-91,6,54:e4:3a:ec:fb:64,146986011,2160,54122,146983851,146986011
20745,4,1,1,2412,-86,-91,5,b8:3a:5a:88:e6:e1,147019699,2376,31312,147017323,147019699
20746,6,12,1,2412,-68,-91,23,40:e3:d6:da:ba:20,147031086,160,11227,147030926,147031086
20747,6,6,1,2412,-68,-91,23,40:e3:d6:da:ba:21,147031287,368,-167,147030919,147031287
20748,6,12,1,2412,-68,-91,23,40:e3:d6:da:ba:22,147031701,180,234,147031521,147031701
20749,6,12,1,2412,-68,-91,23,40:e3:d6:da:ba:23,147031915,184,30,147031731,147031915
20750,6,12,1,2412,-68,-91,23,40:e3:d6:da:ba:24,147032143,176,52,147031967,147032143
20751,6,12,1,2412,-68,-91,23,40:e3:d6:da:ba:25,147032362,160,59,147032202,147032362
20752,6,6,1,2412,-68,-91,23,40:e3:d6:da:ba:26,147032563,380,-179,147032183,147032563
20753,6,6,1,2412,-85,-91,6,84:1b:5e:df:1b:99,147055436,80,22793,147055356,147055436
20754,4,1,1,2412,-86,-91,5,54:e4:3a:ec:fb:64,147088410,2160,30814,147086250,147088410
20755,4,1,1,2412,-85,-91,6,b8:3a:5a:88:e6:e0,147117145,2360,26375,147114785,147117145
20756,4,1,1,2412,-84,-91,7,b8:3a:5a:88:e6:e1,147119543,2376,22,147117167,147119543
20757,6,6,1,2412,-70,-91,21,e6:aa:ea:c9:ea:33,147131163,408,11212,147130755,147131163
20758,6,12,1,2412,-67,-91,24,40:e3:d6:da:ba:20,147133481,160,2158,147133321,147133481
20759,6,12,1,2412,-67,-91,24,40:e3:d6:da:ba:24,147134520,176,863,147134344,147134520
20760,6,12,1,2412,-67,-91,24,40:e3:d6:da:ba:25,147134740,160,60,147134580,147134740
20761,6,6,1,2412,-67,-91,24,40:e3:d6:da:ba:26,147134932,380,-188,147134552,147134932
20762,6,6,1,2412,-70,-91,21,e6:aa:ea:c9:ea:33,147143330,408,7990,147142922,147143330
20763,4,1,1,2412,-92,-91,-1,a6:e5:7c:28:b1:d3,147158673,944,14399,147157729,147158673
20764,4,1,1,2412,-89,-91,2,a6:e5:7c:28:b1:d3,147160892,944,1275,147159948,147160892
20765,4,1,1,2412,-91,-91,0,a6:e5:7c:28:b1:d3,147168655,944,6819,147167711,147168655
20766,4,1,1,2412,-87,-91,4,54:e4:3a:ec:fb:64,147190810,2160,19995,147188650,147190810
20767,4,1,1,2412,-81,-91,10,b8:3a:5a:88:e6:e1,147221940,2376,28754,147219564,147221940
20768,6,12,1,2412,-67,-91,24,40:e3:d6:da:ba:20,147235867,160,13767,147235707,147235867
20769,6,12,1,2412,-67,-91,24,40:e3:d6:da:ba:22,147236491,180,444,147236311,147236491
20770,6,12,1,2412,-67,-91,24,40:e3:d6:da:ba:23,147236724,184,49,147236540,147236724
20771,6,12,1,2412,-67,-91,24,40:e3:d6:da:ba:24,147236933,176,33,147236757,147236933
20772,6,12,1,2412,-67,-91,24,40:e3:d6:da:ba:25,147237144,160,51,147236984,147237144
20773,6,6,1,2412,-67,-91,24,40:e3:d6:da:ba:26,147237336,380,-188,147236956,147237336
20774,4,1,1,2412,-91,-91,0,,147268840,304,31200,147268536,147268840
20775,4,1,1,2412,-83,-91,8,b8:3a:5a:88:e6:e0,147321955,2360,50755,147319595,147321955
20776,4,1,1,2412,-85,-91,6,b8:3a:5a:88:e6:e1,147324334,2376,3,147321958,147324334
20777,6,6,1,2412,-81,-91,10,e6:aa:ea:b7:4a:dd,147331346,408,6604,147330938,147331346
20778,6,12,1,2412,-67,-91,24,40:e3:d6:da:ba:20,147338285,160,6779,147338125,147338285
20779,6,6,1,2412,-67,-91,24,40:e3:d6:da:ba:21,147338486,368,-167,147338118,147338486
20780,6,12,1,2412,-67,-91,24,40:e3:d6:da:ba:22,147338890,180,224,147338710,147338890
20781,6,12,1,2412,-67,-91,24,40:e3:d6:da:ba:23,147339096,184,22,147338912,147339096
20782,6,12,1,2412,-67,-91,24,40:e3:d6:da:ba:24,147339305,176,33,147339129,147339305
20783,6,12,1,2412,-67,-91,24,40:e3:d6:da:ba:25,147339525,160,60,147339365,147339525
20784,6,6,1,2412,-67,-91,24,40:e3:d6:da:ba:26,147339735,380,-170,147339355,147339735
20785,6,6,1,2412,-82,-91,9,e6:aa:ea:b7:4a:dd,147343465,408,3322,147343057,147343465
20786,6,6,1,2412,-82,-91,9,e6:aa:ea:b7:4a:dd,147355585,408,11712,147355177,147355585
20787,6,6,1,2412,-83,-91,8,e6:aa:ea:b7:4a:dd,147367695,408,11702,147367287,147367695
20788,6,6,1,2412,-83,-91,8,e6:aa:ea:b7:4a:dd,147379814,408,11711,147379406,147379814
20789,4,1,1,2412,-85,-91,6,54:e4:3a:ec:fb:64,147395607,2160,13633,147393447,147395607
20790,4,1,1,2412,-84,-91,7,b8:3a:5a:88:e6:e1,147426765,2376,28782,147424389,147426765
20791,6,6,1,2412,-68,-91,23,40:e3:d6:da:ba:21,147443183,368,16050,147442815,147443183
20792,6,12,1,2412,-69,-91,22,40:e3:d6:da:ba:22,147443570,180,207,147443390,147443570
20793,6,12,1,2412,-69,-91,22,40:e3:d6:da:ba:23,147443802,184,48,147443618,147443802
20794,6,12,1,2412,-69,-91,22,40:e3:d6:da:ba:24,147444030,176,52,147443854,147444030
20795,6,12,1,2412,-69,-91,22,40:e3:d6:da:ba:25,147444231,160,41,147444071,147444231
20796,6,6,1,2412,-69,-91,22,40:e3:d6:da:ba:26,147444441,380,-170,147444061,147444441
20797,4,1,1,2412,-84,-91,7,54:e4:3a:ec:fb:64,147498007,2160,51406,147495847,147498007
20798,4,1,1,2412,-86,-91,5,b8:3a:5a:88:e6:e0,147527554,2360,27187,147525194,147527554
20799,6,12,1,2412,-70,-91,21,40:e3:d6:da:ba:20,147543092,160,15378,147542932,147543092
20800,6,6,1,2412,-70,-91,21,40:e3:d6:da:ba:21,147543302,368,-158,147542934,147543302
20801,6,12,1,2412,-70,-91,21,40:e3:d6:da:ba:22,147543707,180,225,147543527,147543707
20802,6,12,1,2412,-70,-91,21,40:e3:d6:da:ba:23,147543939,184,48,147543755,147543939
20803,6,12,1,2412,-70,-91,21,40:e3:d6:da:ba:24,147544149,176,34,147543973,147544149
20804,6,12,1,2412,-70,-91,21,40:e3:d6:da:ba:25,147544377,160,68,147544217,147544377
20805,6,6,1,2412,-70,-91,21,40:e3:d6:da:ba:26,147544569,380,-188,147544189,147544569
20806,6,6,1,2412,-72,-91,19,e6:aa:ea:c9:ea:33,147548951,408,3974,147548543,147548951
20807,6,6,1,2412,-72,-91,19,e6:aa:ea:c9:ea:33,147560975,408,11616,147560567,147560975
20808,6,6,1,2412,-73,-91,18,e6:aa:ea:c9:ea:33,147573303,408,11920,147572895,147573303
20809,6,6,1,2412,-72,-91,19,e6:aa:ea:c9:ea:33,147585218,408,11507,147584810,147585218
20810,6,6,1,2412,-73,-91,18,e6:aa:ea:c9:ea:33,147597328,408,11702,147596920,147597328
20811,6,12,1,2412,-69,-91,22,40:e3:d6:da:ba:20,147645482,160,47994,147645322,147645482
20812,6,6,1,2412,-69,-91,22,40:e3:d6:da:ba:21,147645701,368,-149,147645333,147645701
20813,6,12,1,2412,-69,-91,22,40:e3:d6:da:ba:22,147646097,180,216,147645917,147646097
20814,6,12,1,2412,-69,-91,22,40:e3:d6:da:ba:23,147646330,184,49,147646146,147646330
20815,6,12,1,2412,-69,-91,22,40:e3:d6:da:ba:24,147646557,176,51,147646381,147646557
20816,6,12,1,2412,-69,-91,22,40:e3:d6:da:ba:25,147646759,160,42,147646599,147646759
20817,6,6,1,2412,-69,-91,22,40:e3:d6:da:ba:26,147646968,380,-171,147646588,147646968
20818,4,1,1,2412,-87,-91,4,54:e4:3a:ec:fb:64,147702837,2160,53709,147700677,147702837
20819,4,1,1,2412,-88,-91,3,b8:3a:5a:88:e6:e0,147731555,2360,26358,147729195,147731555
20820,6,12,1,2412,-67,-91,24,40:e3:d6:da:ba:20,147747871,160,16156,147747711,147747871
20821,6,6,1,2412,-67,-91,24,40:e3:d6:da:ba:21,147748081,368,-158,147747713,147748081
20822,6,12,1,2412,-67,-91,24,40:e3:d6:da:ba:22,147748495,180,234,147748315,147748495
20823,6,12,1,2412,-67,-91,24,40:e3:d6:da:ba:23,147748710,184,31,147748526,147748710
20824,6,12,1,2412,-67,-91,24,40:e3:d6:da:ba:24,147748928,176,42,147748752,147748928
20825,6,12,1,2412,-67,-91,24,40:e3:d6:da:ba:25,147749157,160,69,147748997,147749157
20826,6,6,1,2412,-67,-91,24,40:e3:d6:da:ba:26,147749349,380,-188,147748969,147749349
20827,4,1,1,2412,-86,-91,5,54:e4:3a:ec:fb:64,147805205,2160,53696,147803045,147805205
20828,4,1,1,2412,-89,-91,2,b8:3a:5a:88:e6:e0,147834647,2360,27082,147832287,147834647
20829,4,1,1,2412,-86,-91,5,b8:3a:5a:88:e6:e1,147839114,2376,2091,147836738,147839114
20830,6,12,1,2412,-68,-91,23,40:e3:d6:da:ba:20,147850297,160,11023,147850137,147850297
20831,6,6,1,2412,-68,-91,23,40:e3:d6:da:ba:21,147850516,368,-149,147850148,147850516
20832,6,12,1,2412,-68,-91,23,40:e3:d6:da:ba:22,147850921,180,225,147850741,147850921
20833,6,12,1,2412,-68,-91,23,40:e3:d6:da:ba:23,147851136,184,31,147850952,147851136
20834,6,12,1,2412,-68,-91,23,40:e3:d6:da:ba:24,147851468,176,156,147851292,147851468
20835,6,12,1,2412,-68,-91,23,40:e3:d6:da:ba:25,147851678,160,50,147851518,147851678
20836,6,6,1,2412,-68,-91,23,40:e3:d6:da:ba:26,147851888,380,-170,147851508,147851888
20837,6,6,1,2412,-82,-91,9,e6:aa:ea:b7:4a:dd,147852665,408,369,147852257,147852665
20838,6,6,1,2412,-85,-91,6,e6:aa:ea:b7:4a:dd,147863444,408,10371,147863036,147863444
20839,6,6,1,2412,-86,-91,5,e6:aa:ea:b7:4a:dd,147875558,408,11706,147875150,147875558
20840,6,6,1,2412,-86,-91,5,e6:aa:ea:b7:4a:dd,147887673,408,11707,147887265,147887673
20841,6,6,1,2412,-86,-91,5,e6:aa:ea:b7:4a:dd,147899789,408,11708,147899381,147899789
20842,4,1,1,2412,-81,-91,10,b8:3a:5a:88:e6:e1,147938765,2376,36600,147936389,147938765
20843,4,1,1,2412,-92,-91,-1,a6:e5:7c:28:b1:d3,148028694,944,88985,148027750,148028694
20844,4,1,1,2412,-94,-91,-3,a6:e5:7c:28:b1:d3,148034102,944,4464,148033158,148034102
20845,4,1,1,2412,-92,-91,-1,a6:e5:7c:28:b1:d3,148044185,944,9139,148043241,148044185
20846,6,12,1,2412,-71,-91,20,40:e3:d6:da:ba:20,148055076,160,10731,148054916,148055076
20847,6,6,1,2412,-72,-91,19,40:e3:d6:da:ba:21,148055268,368,-176,148054900,148055268
20848,6,12,1,2412,-71,-91,20,40:e3:d6:da:ba:22,148055655,180,207,148055475,148055655
20849,6,12,1,2412,-71,-91,20,40:e3:d6:da:ba:23,148055870,184,31,148055686,148055870
20850,6,12,1,2412,-71,-91,20,40:e3:d6:da:ba:24,148056106,176,60,148055930,148056106
20851,6,12,1,2412,-71,-91,20,40:e3:d6:da:ba:25,148056334,160,68,148056174,148056334
20852,6,6,1,2412,-72,-91,19,40:e3:d6:da:ba:26,148056553,380,-161,148056173,148056553
20853,6,6,1,2412,-79,-91,12,e6:aa:ea:c9:ea:33,148069132,408,12171,148068724,148069132
20854,6,6,1,2412,-79,-91,12,e6:aa:ea:c9:ea:33,148081250,408,11710,148080842,148081250
20855,4,1,1,2412,-85,-91,6,54:e4:3a:ec:fb:64,148112402,2160,28992,148110242,148112402
20856,6,6,1,2412,-78,-91,13,e6:aa:ea:c9:ea:33,148117601,408,4791,148117193,148117601
20857,4,1,1,2412,-79,-91,12,b8:3a:5a:88:e6:e0,148141167,2360,21206,148138807,148141167
20858,4,1,1,2412,-83,-91,8,b8:3a:5a:88:e6:e1,148143664,2376,121,148141288,148143664
20859,6,12,1,2412,-70,-91,21,40:e3:d6:da:ba:20,148157473,160,13649,148157313,148157473
20860,6,6,1,2412,-70,-91,21,40:e3:d6:da:ba:21,148157710,368,-131,148157342,148157710
20861,6,12,1,2412,-69,-91,22,40:e3:d6:da:ba:22,148158124,180,234,148157944,148158124
20862,6,12,1,2412,-70,-91,21,40:e3:d6:da:ba:23,148158339,184,31,148158155,148158339
20863,6,12,1,2412,-69,-91,22,40:e3:d6:da:ba:24,148158557,176,42,148158381,148158557
20864,6,12,1,2412,-69,-91,22,40:e3:d6:da:ba:25,148158895,160,178,148158735,148158895
20865,6,6,1,2412,-70,-91,21,40:e3:d6:da:ba:26,148159105,380,-170,148158725,148159105
20866,4,1,1,2412,-85,-91,6,ea:a8:c6:55:cf:82,148180082,992,19985,148179090,148180082
20867,4,1,1,2412,-86,-91,5,54:e4:3a:ec:fb:64,148181190,2112,-1004,148179078,148181190
20868,4,1,1,2412,-84,-91,7,,148183318,304,1824,148183014,148183318
20869,6,12,1,2412,-70,-91,21,40:e3:d6:da:ba:20,148183481,136,27,148183345,148183481
20870,6,12,1,2412,-69,-91,22,40:e3:d6:da:ba:22,148184164,156,527,148184008,148184164
20871,4,1,1,2412,-80,-91,11,b8:3a:5a:88:e6:e1,148185950,2256,-470,148183694,148185950
20872,6,12,1,2412,-84,-91,7,,148188963,32,2981,148188931,148188963
20873,6,12,1,2412,-84,-91,7,,148189332,32,337,148189300,148189332
20874,4,1,1,2412,-86,-91,5,ea:a8:c6:55:cf:82,148202381,992,12057,148201389,148202381
20875,6,12,1,2412,-70,-91,21,40:e3:d6:da:ba:20,148203333,136,816,148203197,148203333
20876,6,12,1,2412,-83,-91,8,,148203486,32,121,148203454,148203486
20877,6,6,1,2412,-70,-91,21,40:e3:d6:da:ba:21,148203582,348,-252,148203234,148203582
20878,6,6,1,2412,-84,-91,7,,148203948,44,322,148203904,148203948
20879,6,12,1,2412,-70,-91,21,40:e3:d6:da:ba:22,148204016,156,-88,148203860,148204016
20880,6,12,1,2412,-84,-91,7,,148204189,32,141,148204157,148204189
20881,6,12,1,2412,-70,-91,21,40:e3:d6:da:ba:23,148204252,156,-93,148204096,148204252
20882,6,12,1,2412,-84,-91,7,,148204425,32,141,148204393,148204425
20883,6,12,1,2412,-70,-91,21,40:e3:d6:da:ba:25,148204488,136,-73,148204352,148204488
20884,6,12,1,2412,-84,-91,7,,148204642,32,122,148204610,148204642
20885,4,1,1,2412,-51,-91,40,,148207124,304,2178,148206820,148207124
20886,4,1,1,2412,-85,-91,6,54:e4:3a:ec:fb:64,148214801,2160,5517,148212641,148214801
20887,6,12,1,2412,-70,-91,21,40:e3:d6:da:ba:20,148231349,136,16412,148231213,148231349
20888,6,6,1,2412,-70,-91,21,40:e3:d6:da:ba:21,148231526,348,-171,148231178,148231526
20889,6,12,1,2412,-70,-91,21,40:e3:d6:da:ba:22,148231902,156,220,148231746,148231902
20890,6,12,1,2412,-70,-91,21,40:e3:d6:da:ba:23,148232110,156,52,148231954,148232110
20891,4,1,1,2412,-82,-91,9,b8:3a:5a:88:e6:e0,148243596,2360,9126,148241236,148243596
20892,4,1,1,2412,-82,-91,9,b8:3a:5a:88:e6:e1,148245976,2376,4,148243600,148245976
20893,6,12,1,2412,-70,-91,21,40:e3:d6:da:ba:20,148259873,160,13737,148259713,148259873
20894,6,6,1,2412,-70,-91,21,40:e3:d6:da:ba:21,148260074,368,-167,148259706,148260074
20895,6,12,1,2412,-70,-91,21,40:e3:d6:da:ba:22,148260488,180,234,148260308,148260488
20896,6,12,1,2412,-70,-91,21,40:e3:d6:da:ba:23,148260693,184,21,148260509,148260693
20897,6,12,1,2412,-70,-91,21,40:e3:d6:da:ba:24,148260929,176,60,148260753,148260929
20898,6,12,1,2412,-70,-91,21,40:e3:d6:da:ba:25,148261131,160,42,148260971,148261131
20899,6,6,1,2412,-71,-91,20,40:e3:d6:da:ba:26,148261341,380,-170,148260961,148261341
20900,6,6,1,2412,-82,-91,9,e6:aa:ea:b7:4a:dd,148268485,408,6736,148268077,148268485
20901,6,6,1,2412,-82,-91,9,e6:aa:ea:b7:4a:dd,148292729,408,23836,148292321,148292729
20902,6,6,1,2412,-82,-91,9,e6:aa:ea:b7:4a:dd,148304845,408,11708,148304437,148304845
20903,6,6,1,2412,-89,-91,2,e6:aa:ea:b7:4a:dd,148316965,408,11712,148316557,148316965
20904,6,6,1,2412,-85,-91,6,40:e3:d6:da:c0:21,148333963,368,16630,148333595,148333963
20905,6,12,1,2412,-68,-91,23,40:e3:d6:da:ba:20,148362289,160,28166,148362129,148362289
20906,6,6,1,2412,-68,-91,23,40:e3:d6:da:ba:21,148362481,368,-176,148362113,148362481
20907,6,12,1,2412,-67,-91,24,40:e3:d6:da:ba:22,148362868,180,207,148362688,148362868
20908,6,12,1,2412,-67,-91,24,40:e3:d6:da:ba:24,148363292,176,248,148363116,148363292
20909,6,12,1,2412,-68,-91,23,40:e3:d6:da:ba:25,148363520,160,68,148363360,148363520
20910,6,6,1,2412,-67,-91,24,40:e3:d6:da:ba:26,148363739,380,-161,148363359,148363739
20911,6,12,1,2412,-67,-91,24,40:e3:d6:da:ba:22,148465291,180,101372,148465111,148465291
20912,6,12,1,2412,-67,-91,24,40:e3:d6:da:ba:25,148465952,160,501,148465792,148465952
20913,6,6,1,2412,-67,-91,24,40:e3:d6:da:ba:26,148466162,380,-170,148465782,148466162
20914,6,6,1,2412,-74,-91,17,e6:aa:ea:c9:ea:33,148499195,408,32625,148498787,148499195
20915,6,6,1,2412,-73,-91,18,e6:aa:ea:c9:ea:33,148511308,408,11705,148510900,148511308
20916,4,1,1,2412,-89,-91,2,b8:3a:5a:88:e6:e0,148550757,2360,37089,148548397,148550757
20917,6,12,1,2412,-66,-91,25,40:e3:d6:da:ba:20,148567084,160,16167,148566924,148567084
20918,6,6,1,2412,-65,-91,26,40:e3:d6:da:ba:21,148567303,368,-149,148566935,148567303
20919,6,12,1,2412,-65,-91,26,40:e3:d6:da:ba:22,148567708,180,225,148567528,148567708
20920,6,12,1,2412,-65,-91,26,40:e3:d6:da:ba:23,148567941,184,49,148567757,148567941
20921,6,12,1,2412,-65,-91,26,40:e3:d6:da:ba:24,148568168,176,51,148567992,148568168
20922,6,12,1,2412,-65,-91,26,40:e3:d6:da:ba:25,148568396,160,68,148568236,148568396
20923,6,6,1,2412,-65,-91,26,40:e3:d6:da:ba:26,148568606,380,-170,148568226,148568606
20924,6,6,1,2412,-80,-91,11,e6:aa:ea:b7:4a:dd,148583904,408,14890,148583496,148583904
20925,6,6,1,2412,-80,-91,11,e6:aa:ea:b7:4a:dd,148596006,408,11694,148595598,148596006
20926,6,6,1,2412,-79,-91,12,e6:aa:ea:b7:4a:dd,148608215,408,11801,148607807,148608215
20927,6,6,1,2412,-80,-91,11,e6:aa:ea:b7:4a:dd,148620233,408,11610,148619825,148620233
20928,6,6,1,2412,-80,-91,11,e6:aa:ea:b7:4a:dd,148632381,408,11740,148631973,148632381
20929,4,1,1,2412,-90,-91,1,b8:3a:5a:88:e6:e0,148653170,2360,18429,148650810,148653170
20930,4,1,1,2412,-86,-91,5,b8:3a:5a:88:e6:e1,148655568,2376,22,148653192,148655568
20931,6,12,1,2412,-67,-91,24,40:e3:d6:da:ba:20,148669475,160,13747,148669315,148669475
20932,6,6,1,2412,-67,-91,24,40:e3:d6:da:ba:21,148669676,368,-167,148669308,148669676
20933,6,12,1,2412,-67,-91,24,40:e3:d6:da:ba:22,148670072,180,216,148669892,148670072
20934,6,12,1,2412,-67,-91,24,40:e3:d6:da:ba:25,148670742,160,510,148670582,148670742
20935,4,1,1,2412,-83,-91,8,54:e4:3a:ec:fb:64,148726796,2160,53894,148724636,148726796
20936,4,1,1,2412,-85,-91,6,b8:3a:5a:88:e6:e0,148755579,2360,26423,148753219,148755579
20937,4,1,1,2412,-87,-91,4,b8:3a:5a:88:e6:e1,148757977,2376,22,148755601,148757977
20938,6,12,1,2412,-67,-91,24,40:e3:d6:da:ba:20,148771880,160,13743,148771720,148771880
20939,6,6,1,2412,-67,-91,24,40:e3:d6:da:ba:21,148772072,368,-176,148771704,148772072
20940,6,12,1,2412,-67,-91,24,40:e3:d6:da:ba:22,148772468,180,216,148772288,148772468
20941,6,12,1,2412,-67,-91,24,40:e3:d6:da:ba:23,148772700,184,48,148772516,148772700
20942,6,12,1,2412,-66,-91,25,40:e3:d6:da:ba:24,148772927,176,51,148772751,148772927
20943,6,12,1,2412,-67,-91,24,40:e3:d6:da:ba:25,148773147,160,60,148772987,148773147
20944,6,6,1,2412,-67,-91,24,40:e3:d6:da:ba:26,148773339,380,-188,148772959,148773339
20945,4,1,1,2412,-87,-91,4,b8:3a:5a:88:e6:e0,148857970,2360,82271,148855610,148857970
20946,6,6,1,2412,-66,-91,25,40:e3:d6:da:ba:21,148874503,368,16165,148874135,148874503
20947,6,12,1,2412,-66,-91,25,40:e3:d6:da:ba:22,148874917,180,234,148874737,148874917
20948,6,12,1,2412,-66,-91,25,40:e3:d6:da:ba:23,148875141,184,40,148874957,148875141
20949,6,12,1,2412,-66,-91,25,40:e3:d6:da:ba:24,148875377,176,60,148875201,148875377
20950,6,12,1,2412,-66,-91,25,40:e3:d6:da:ba:25,148875578,160,41,148875418,148875578
20951,6,6,1,2412,-67,-91,24,40:e3:d6:da:ba:26,148875788,380,-170,148875408,148875788
20952,4,1,1,2412,-84,-91,7,54:e4:3a:ec:fb:64,148949295,2160,71347,148947135,148949295
20953,6,12,1,2412,-68,-91,23,40:e3:d6:da:ba:20,148976677,160,27222,148976517,148976677
20954,6,6,1,2412,-68,-91,23,40:e3:d6:da:ba:21,148976878,368,-167,148976510,148976878
20955,6,12,1,2412,-67,-91,24,40:e3:d6:da:ba:22,148977274,180,216,148977094,148977274
20956,6,6,1,2412,-85,-91,6,e6:aa:ea:b7:4a:dd,149000883,408,23201,149000475,149000883
20957,6,6,1,2412,-75,-91,16,e6:aa:ea:c9:ea:33,149006373,408,5082,149005965,149006373
20958,6,6,1,2412,-75,-91,16,e6:aa:ea:c9:ea:33,149018498,408,11717,149018090,149018498
20959,6,6,1,2412,-86,-91,5,e6:aa:ea:b7:4a:dd,149025115,408,6209,149024707,149025115
20960,6,6,1,2412,-75,-91,16,e6:aa:ea:c9:ea:33,149030612,408,5089,149030204,149030612
20961,4,1,1,2412,-84,-91,7,54:e4:3a:ec:fb:64,149034130,2160,1358,149031970,149034130
20962,6,6,1,2412,-86,-91,5,e6:aa:ea:b7:4a:dd,149037235,408,2697,149036827,149037235
20963,6,6,1,2412,-75,-91,16,e6:aa:ea:c9:ea:33,149042912,408,5269,149042504,149042912
20964,6,6,1,2412,-85,-91,6,e6:aa:ea:b7:4a:dd,149049355,408,6035,149048947,149049355
20965,6,6,1,2412,-75,-91,16,e6:aa:ea:c9:ea:33,149054981,408,5218,149054573,149054981
20966,4,1,1,2412,-84,-91,7,b8:3a:5a:88:e6:e0,149062916,2360,5575,149060556,149062916
20967,4,1,1,2412,-84,-91,7,b8:3a:5a:88:e6:e1,149065296,2376,4,149062920,149065296
20968,6,12,1,2412,-68,-91,23,40:e3:d6:da:ba:20,149079097,160,13641,149078937,149079097
20969,6,6,1,2412,-68,-91,23,40:e3:d6:da:ba:21,149079289,368,-176,149078921,149079289
20970,6,12,1,2412,-68,-91,23,40:e3:d6:da:ba:22,149079685,180,216,149079505,149079685
20971,6,12,1,2412,-68,-91,23,40:e3:d6:da:ba:23,149079891,184,22,149079707,149079891
20972,6,12,1,2412,-68,-91,23,40:e3:d6:da:ba:24,149080118,176,51,149079942,149080118
20973,6,12,1,2412,-68,-91,23,40:e3:d6:da:ba:25,149080338,160,60,149080178,149080338
20974,6,6,1,2412,-68,-91,23,40:e3:d6:da:ba:26,149080539,380,-179,149080159,149080539
20975,4,1,1,2412,-76,-91,15,54:e4:3a:ec:fb:64,149136393,2160,53694,149134233,149136393
20976,4,1,1,2412,-84,-91,7,b8:3a:5a:88:e6:e1,149167561,2376,28792,149165185,149167561
20977,6,12,1,2412,-68,-91,23,40:e3:d6:da:ba:20,149181477,160,13756,149181317,149181477
20978,6,6,1,2412,-68,-91,23,40:e3:d6:da:ba:21,149181687,368,-158,149181319,149181687
20979,6,12,1,2412,-68,-91,23,40:e3:d6:da:ba:22,149182101,180,234,149181921,149182101
20980,6,12,1,2412,-67,-91,24,40:e3:d6:da:ba:23,149182333,184,48,149182149,149182333
20981,4,1,1,2412,-86,-91,5,54:e4:3a:ec:fb:64,149238955,2160,54462,149236795,149238955
20982,4,1,1,2412,-85,-91,6,b8:3a:5a:88:e6:e0,149267570,2360,26255,149265210,149267570
20983,6,12,1,2412,-79,-91,12,40:e3:d6:da:ba:20,149283904,160,16174,149283744,149283904
20984,6,6,1,2412,-79,-91,12,40:e3:d6:da:ba:21,149284096,368,-176,149283728,149284096
20985,6,12,1,2412,-77,-91,14,40:e3:d6:da:ba:22,149284492,180,216,149284312,149284492
20986,6,12,1,2412,-68,-91,23,40:e3:d6:da:ba:23,149284707,184,31,149284523,149284707
20987,6,12,1,2412,-68,-91,23,40:e3:d6:da:ba:24,149284943,176,60,149284767,149284943
20988,6,12,1,2412,-68,-91,23,40:e3:d6:da:ba:25,149285153,160,50,149284993,149285153
20989,6,6,1,2412,-68,-91,23,40:e3:d6:da:ba:26,149285363,380,-170,149284983,149285363
20990,4,1,1,2412,-78,-91,13,54:e4:3a:ec:fb:64,149341190,2160,53667,149339030,149341190
20991,4,1,1,2412,-84,-91,7,b8:3a:5a:88:e6:e0,149369971,2360,26421,149367611,149369971
20992,6,12,1,2412,-77,-91,14,40:e3:d6:da:ba:24,149387317,176,17170,149387141,149387317
20993,6,12,1,2412,-76,-91,15,40:e3:d6:da:ba:25,149387518,160,41,149387358,149387518
20994,6,6,1,2412,-77,-91,14,40:e3:d6:da:ba:26,149387719,380,-179,149387339,149387719
20995,6,12,1,2412,-88,-91,3,40:e3:d6:da:c0:22,149460775,176,72880,149460599,149460775
20996,6,6,1,2412,-90,-91,1,40:e3:d6:da:c0:26,149461649,380,494,149461269,149461649
20997,6,12,1,2412,-66,-91,25,40:e3:d6:da:ba:20,149488680,160,26871,149488520,149488680
20998,6,6,1,2412,-67,-91,24,40:e3:d6:da:ba:21,149488881,368,-167,149488513,149488881
20999,6,12,1,2412,-66,-91,25,40:e3:d6:da:ba:22,149489295,180,234,149489115,149489295
21000,6,12,1,2412,-66,-91,25,40:e3:d6:da:ba:23,149489518,184,39,149489334,149489518
21001,6,12,1,2412,-66,-91,25,40:e3:d6:da:ba:24,149489746,176,52,149489570,149489746
21002,6,12,1,2412,-66,-91,25,40:e3:d6:da:ba:25,149489948,160,42,149489788,149489948
21003,6,6,1,2412,-67,-91,24,40:e3:d6:da:ba:26,149490148,380,-180,149489768,149490148
21004,6,6,1,2412,-82,-91,9,e6:aa:ea:b7:4a:dd,149522264,408,31708,149521856,149522264
21005,6,6,1,2412,-74,-91,17,e6:aa:ea:c9:ea:33,149527534,408,4862,149527126,149527534
21006,6,6,1,2412,-83,-91,8,e6:aa:ea:b7:4a:dd,149534389,408,6447,149533981,149534389
21007,6,6,1,2412,-74,-91,17,e6:aa:ea:c9:ea:33,149539644,408,4847,149539236,149539644
21008,4,1,1,2412,-84,-91,7,54:e4:3a:ec:fb:64,149546162,2160,4358,149544002,149546162
21009,6,6,1,2412,-83,-91,8,e6:aa:ea:b7:4a:dd,149548186,408,1616,149547778,149548186
21010,6,6,1,2412,-73,-91,18,e6:aa:ea:c9:ea:33,149551888,408,3294,149551480,149551888
21011,6,6,1,2412,-73,-91,18,e6:aa:ea:c9:ea:33,149564064,408,11768,149563656,149564064
21012,6,6,1,2412,-83,-91,8,e6:aa:ea:b7:4a:dd,149570917,408,6445,149570509,149570917
21013,6,12,1,2412,-66,-91,25,40:e3:d6:da:ba:20,149591079,160,20002,149590919,149591079
21014,6,6,1,2412,-65,-91,26,40:e3:d6:da:ba:21,149591271,368,-176,149590903,149591271
21015,6,12,1,2412,-65,-91,26,40:e3:d6:da:ba:22,149591685,180,234,149591505,149591685
21016,6,12,1,2412,-65,-91,26,40:e3:d6:da:ba:23,149591891,184,22,149591707,149591891
21017,6,12,1,2412,-65,-91,26,40:e3:d6:da:ba:24,149592127,176,60,149591951,149592127
21018,6,12,1,2412,-65,-91,26,40:e3:d6:da:ba:25,149592338,160,51,149592178,149592338
21019,6,6,1,2412,-65,-91,26,40:e3:d6:da:ba:26,149592530,380,-188,149592150,149592530
21020,6,12,1,2412,-65,-91,26,40:e3:d6:da:ba:20,149693481,160,100791,149693321,149693481
21021,6,12,1,2412,-65,-91,26,40:e3:d6:da:ba:23,149694319,184,654,149694135,149694319
21022,6,12,1,2412,-64,-91,27,40:e3:d6:da:ba:24,149694547,176,52,149694371,149694547
21023,6,12,1,2412,-69,-91,22,40:e3:d6:da:ba:25,149694757,160,50,149694597,149694757
21024,4,1,1,2412,-90,-91,1,b8:3a:5a:88:e6:e1,149781932,2376,84799,149779556,149781932
21025,6,12,1,2412,-65,-91,26,40:e3:d6:da:ba:20,149795880,160,13788,149795720,149795880
21026,6,6,1,2412,-65,-91,26,40:e3:d6:da:ba:21,149796081,368,-167,149795713,149796081
21027,6,12,1,2412,-65,-91,26,40:e3:d6:da:ba:22,149796476,180,215,149796296,149796476
21028,6,12,1,2412,-64,-91,27,40:e3:d6:da:ba:23,149796700,184,40,149796516,149796700
21029,6,12,1,2412,-65,-91,26,40:e3:d6:da:ba:24,149796910,176,34,149796734,149796910
21030,6,12,1,2412,-64,-91,27,40:e3:d6:da:ba:25,149797138,160,68,149796978,149797138
21031,6,6,1,2412,-65,-91,26,40:e3:d6:da:ba:26,149797357,380,-161,149796977,149797357
21032,6,12,1,2412,-65,-91,26,40:e3:d6:da:ba:20,149809860,136,12367,149809724,149809860
21033,6,6,1,2412,-65,-91,26,40:e3:d6:da:ba:21,149810036,348,-172,149809688,149810036
21034,6,12,1,2412,-65,-91,26,40:e3:d6:da:ba:22,149810421,156,229,149810265,149810421
21035,6,12,1,2412,-65,-91,26,40:e3:d6:da:ba:23,149810639,156,62,149810483,149810639
21036,6,12,1,2412,-65,-91,26,40:e3:d6:da:ba:25,149810857,136,82,149810721,149810857
21037,4,1,1,2412,-91,-91,0,e4:46:da:59:af:4c,149828629,1432,16340,149827197,149828629
21038,6,12,1,2412,-66,-91,25,40:e3:d6:da:ba:20,149829921,136,1156,149829785,149829921
21039,6,6,1,2412,-65,-91,26,40:e3:d6:da:ba:21,149830115,348,-154,149829767,149830115
21040,6,12,1,2412,-65,-91,26,40:e3:d6:da:ba:22,149830519,156,248,149830363,149830519
21041,6,12,1,2412,-65,-91,26,40:e3:d6:da:ba:23,149830709,156,34,149830553,149830709
21042,6,12,1,2412,-65,-91,26,40:e3:d6:da:ba:25,149830908,136,63,149830772,149830908
21043,4,1,1,2412,-83,-91,8,54:e4:3a:ec:fb:64,149853187,2160,20119,149851027,149853187
21044,4,1,1,2412,-88,-91,3,b8:3a:5a:88:e6:e0,149881965,2360,26418,149879605,149881965
21045,4,1,1,2412,-88,-91,3,b8:3a:5a:88:e6:e1,149884345,2376,4,149881969,149884345
21046,6,12,1,2412,-65,-91,26,40:e3:d6:da:ba:20,149898312,160,13807,149898152,149898312
21047,6,6,1,2412,-64,-91,27,40:e3:d6:da:ba:21,149898513,368,-167,149898145,149898513
21048,6,12,1,2412,-64,-91,27,40:e3:d6:da:ba:22,149898909,180,216,149898729,149898909
21049,6,12,1,2412,-64,-91,27,40:e3:d6:da:ba:23,149899133,184,40,149898949,149899133
21050,6,12,1,2412,-65,-91,26,40:e3:d6:da:ba:24,149899369,176,60,149899193,149899369
21051,6,12,1,2412,-65,-91,26,40:e3:d6:da:ba:25,149899571,160,42,149899411,149899571
21052,6,6,1,2412,-65,-91,26,40:e3:d6:da:ba:26,149899790,380,-161,149899410,149899790
21053,6,12,1,2412,-65,-91,26,40:e3:d6:da:ba:20,149911674,136,11748,149911538,149911674
21054,6,12,1,2412,-64,-91,27,40:e3:d6:da:ba:22,149912533,156,703,149912377,149912533
21055,6,12,1,2412,-64,-91,27,40:e3:d6:da:ba:23,149912724,156,35,149912568,149912724
21056,6,12,1,2412,-65,-91,26,40:e3:d6:da:ba:25,149912923,136,63,149912787,149912923
21057,6,12,1,2412,-65,-91,26,40:e3:d6:da:ba:20,149931856,136,18797,149931720,149931856
21058,6,6,1,2412,-74,-91,17,e6:aa:ea:c9:ea:33,149944544,408,12280,149944136,149944544
21059,6,6,1,2412,-74,-91,17,e6:aa:ea:c9:ea:33,149968767,408,23815,149968359,149968767
21060,6,6,1,2412,-86,-91,5,84:1b:5e:df:1b:99,149975408,80,6561,149975328,149975408
21061,6,6,1,2412,-74,-91,17,e6:aa:ea:c9:ea:33,149980878,408,5062,149980470,149980878
21062,4,1,1,2412,-89,-91,2,b8:3a:5a:88:e6:e0,149984353,2360,1115,149981993,149984353
21063,6,6,1,2412,-74,-91,17,e6:aa:ea:c9:ea:33,149993000,408,8239,149992592,149993000
21064,6,12,1,2412,-65,-91,26,40:e3:d6:da:ba:20,150000708,160,7548,150000548,150000708
21065,6,12,1,2412,-64,-91,27,40:e3:d6:da:ba:23,150001553,184,661,150001369,150001553
21066,6,12,1,2412,-64,-91,27,40:e3:d6:da:ba:24,150001772,176,43,150001596,150001772
21067,6,12,1,2412,-65,-91,26,40:e3:d6:da:ba:25,150001973,160,41,150001813,150001973
21068,6,6,1,2412,-64,-91,27,40:e3:d6:da:ba:26,150002165,380,-188,150001785,150002165
21069,6,6,1,2412,-87,-91,4,e6:aa:ea:b7:4a:dd,150041868,408,39295,150041460,150041868
21070,4,1,1,2412,-83,-91,8,54:e4:3a:ec:fb:64,150058160,2160,14132,150056000,150058160
21071,6,6,1,2412,-85,-91,6,e6:aa:ea:b7:4a:dd,150078179,408,19611,150077771,150078179
21072,6,12,1,2412,-64,-91,27,40:e3:d6:da:ba:24,150104164,176,25809,150103988,150104164
21073,6,12,1,2412,-64,-91,27,40:e3:d6:da:ba:25,150104393,160,69,150104233,150104393
21074,6,6,1,2412,-64,-91,27,40:e3:d6:da:ba:26,150104612,380,-161,150104232,150104612
21075,4,1,1,2412,-84,-91,7,54:e4:3a:ec:fb:64,150160384,2160,53612,150158224,150160384
21076,6,12,1,2412,-64,-91,27,40:e3:d6:da:ba:20,150205482,160,44938,150205322,150205482
21077,6,6,1,2412,-64,-91,27,40:e3:d6:da:ba:21,150205701,368,-149,150205333,150205701
21078,6,12,1,2412,-64,-91,27,40:e3:d6:da:ba:22,150206097,180,216,150205917,150206097
21079,6,12,1,2412,-64,-91,27,40:e3:d6:da:ba:23,150206320,184,39,150206136,150206320
21080,6,12,1,2412,-64,-91,27,40:e3:d6:da:ba:24,150206557,176,61,150206381,150206557
21081,6,12,1,2412,-64,-91,27,40:e3:d6:da:ba:25,150206776,160,59,150206616,150206776
21082,6,6,1,2412,-64,-91,27,40:e3:d6:da:ba:26,150206968,380,-188,150206588,150206968
21083,4,1,1,2412,-83,-91,8,54:e4:3a:ec:fb:64,150262782,2160,53654,150260622,150262782
21084,4,1,1,2412,-85,-91,6,b8:3a:5a:88:e6:e0,150291561,2360,26419,150289201,150291561
21085,6,12,1,2412,-65,-91,26,40:e3:d6:da:ba:20,150307908,160,16187,150307748,150307908
21086,6,6,1,2412,-64,-91,27,40:e3:d6:da:ba:21,150308109,368,-167,150307741,150308109
21087,6,12,1,2412,-64,-91,27,40:e3:d6:da:ba:22,150308496,180,207,150308316,150308496
21088,6,12,1,2412,-64,-91,27,40:e3:d6:da:ba:23,150308702,184,22,150308518,150308702
21089,6,12,1,2412,-64,-91,27,40:e3:d6:da:ba:24,150308911,176,33,150308735,150308911
21090,6,12,1,2412,-64,-91,27,40:e3:d6:da:ba:25,150309121,160,50,150308961,150309121
21091,6,6,1,2412,-64,-91,27,40:e3:d6:da:ba:26,150309313,380,-188,150308933,150309313
21092,4,1,1,2412,-57,-91,34,54:e4:3a:ec:fb:64,150365182,2160,53709,150363022,150365182
21093,6,12,1,2412,-65,-91,26,40:e3:d6:da:ba:20,150410303,160,44961,150410143,150410303
21094,6,6,1,2412,-64,-91,27,40:e3:d6:da:ba:21,150410522,368,-149,150410154,150410522
21095,6,12,1,2412,-64,-91,27,40:e3:d6:da:ba:22,150410927,180,225,150410747,150410927
21096,6,12,1,2412,-64,-91,27,40:e3:d6:da:ba:23,150411160,184,49,150410976,150411160
21097,6,12,1,2412,-64,-91,27,40:e3:d6:da:ba:24,150411396,176,60,150411220,150411396
21098,6,12,1,2412,-64,-91,27,40:e3:d6:da:ba:25,150411598,160,42,150411438,150411598
21099,6,6,1,2412,-64,-91,27,40:e3:d6:da:ba:26,150411799,380,-179,150411419,150411799
21100,6,6,1,2412,-77,-91,14,e6:aa:ea:c9:ea:33,150465402,408,53195,150464994,150465402
21101,4,1,1,2412,-84,-91,7,54:e4:3a:ec:fb:64,150467582,2160,20,150465422,150467582
21102,6,6,1,2412,-78,-91,13,e6:aa:ea:c9:ea:33,150489642,408,21652,150489234,150489642
21103,4,1,1,2412,-85,-91,6,b8:3a:5a:88:e6:e0,150496379,2360,4377,150494019,150496379
21104,6,6,1,2412,-64,-91,27,40:e3:d6:da:ba:21,150512894,368,16147,150512526,150512894
21105,6,12,1,2412,-64,-91,27,40:e3:d6:da:ba:23,150513513,184,435,150513329,150513513
21106,6,12,1,2412,-64,-91,27,40:e3:d6:da:ba:24,150513723,176,34,150513547,150513723
21107,6,12,1,2412,-65,-91,26,40:e3:d6:da:ba:25,150513933,160,50,150513773,150513933
21108,6,6,1,2412,-64,-91,27,40:e3:d6:da:ba:26,150514134,380,-179,150513754,150514134
21109,6,6,1,2412,-79,-91,12,e6:aa:ea:c9:ea:33,150514567,408,25,150514159,150514567
21110,6,6,1,2412,-82,-91,9,e6:aa:ea:b7:4a:dd,150561553,408,46578,150561145,150561553
21111,6,6,1,2412,-82,-91,9,e6:aa:ea:b7:4a:dd,150585791,408,23830,150585383,150585791
21112,6,6,1,2412,-64,-91,27,40:e3:d6:da:ba:21,150615292,368,29133,150614924,150615292
21113,6,12,1,2412,-63,-91,28,40:e3:d6:da:ba:22,150615706,180,234,150615526,150615706
21114,6,12,1,2412,-64,-91,27,40:e3:d6:da:ba:23,150615920,184,30,150615736,150615920
21115,6,12,1,2412,-63,-91,28,40:e3:d6:da:ba:24,150616139,176,43,150615963,150616139
21116,6,12,1,2412,-63,-91,28,40:e3:d6:da:ba:25,150616358,160,59,150616198,150616358
21117,6,6,1,2412,-64,-91,27,40:e3:d6:da:ba:26,150616568,380,-170,150616188,150616568
21118,4,1,1,2412,-84,-91,7,b8:3a:5a:88:e6:e0,150701155,2360,82227,150698795,150701155
21119,4,1,1,2412,-84,-91,7,b8:3a:5a:88:e6:e1,150703561,2376,30,150701185,150703561
21120,6,6,1,2412,-64,-91,27,40:e3:d6:da:ba:21,150717687,368,13758,150717319,150717687
21121,6,12,1,2412,-64,-91,27,40:e3:d6:da:ba:22,150718092,180,225,150717912,150718092
21122,6,12,1,2412,-64,-91,27,40:e3:d6:da:ba:23,150718297,184,21,150718113,150718297
21123,6,12,1,2412,-64,-91,27,40:e3:d6:da:ba:24,150718507,176,34,150718331,150718507
21124,6,12,1,2412,-64,-91,27,40:e3:d6:da:ba:25,150718708,160,41,150718548,150718708
21125,6,6,1,2412,-64,-91,27,40:e3:d6:da:ba:26,150718918,380,-170,150718538,150718918
21126,4,1,1,2412,-83,-91,8,54:e4:3a:ec:fb:64,150774779,2160,53701,150772619,150774779
21127,4,1,1,2412,-88,-91,3,b8:3a:5a:88:e6:e0,150803574,2360,26435,150801214,150803574
21128,4,1,1,2412,-87,-91,4,b8:3a:5a:88:e6:e1,150806059,2376,109,150803683,150806059
21129,6,12,1,2412,-65,-91,26,40:e3:d6:da:ba:20,150819894,160,13675,150819734,150819894
21130,6,6,1,2412,-65,-91,26,40:e3:d6:da:ba:21,150820086,368,-176,150819718,150820086
21131,6,12,1,2412,-65,-91,26,40:e3:d6:da:ba:22,150820473,180,207,150820293,150820473
21132,6,12,1,2412,-65,-91,26,40:e3:d6:da:ba:23,150820706,184,49,150820522,150820706
21133,6,12,1,2412,-65,-91,26,40:e3:d6:da:ba:24,150820915,176,33,150820739,150820915
21134,6,12,1,2412,-65,-91,26,40:e3:d6:da:ba:25,150821134,160,59,150820974,150821134
21135,6,6,1,2412,-65,-91,26,40:e3:d6:da:ba:26,150821336,380,-178,150820956,150821336
21136,4,1,1,2412,-85,-91,6,54:e4:3a:ec:fb:64,150877177,2160,53681,150875017,150877177
21137,6,6,1,2412,-84,-91,7,e6:aa:ea:b7:4a:dd,150889371,408,11786,150888963,150889371
21138,4,1,1,2412,-88,-91,3,b8:3a:5a:88:e6:e0,150899664,2240,8053,150897424,150899664
21139,4,1,1,2412,-90,-91,1,b8:3a:5a:88:e6:e1,150902056,2256,136,150899800,150902056
21140,4,1,1,2412,-88,-91,3,b8:3a:5a:88:e6:e0,150905976,2360,1560,150903616,150905976
21141,4,1,1,2412,-89,-91,2,b8:3a:5a:88:e6:e1,150908356,2376,4,150905980,150908356
21142,6,6,1,2412,-83,-91,8,e6:aa:ea:b7:4a:dd,150913610,408,4846,150913202,150913610
21143,6,12,1,2412,-65,-91,26,40:e3:d6:da:ba:20,150922294,160,8524,150922134,150922294
21144,6,6,1,2412,-65,-91,26,40:e3:d6:da:ba:21,150922486,368,-176,150922118,150922486
21145,6,12,1,2412,-65,-91,26,40:e3:d6:da:ba:22,150922901,180,235,150922721,150922901
21146,6,12,1,2412,-65,-91,26,40:e3:d6:da:ba:23,150923124,184,39,150922940,150923124
21147,6,12,1,2412,-65,-91,26,40:e3:d6:da:ba:24,150923333,176,33,150923157,150923333
21148,6,6,1,2412,-83,-91,8,e6:aa:ea:b7:4a:dd,150925779,408,2038,150925371,150925779
21149,4,1,1,2412,-87,-91,4,54:e4:3a:ec:fb:64,150979576,2160,51637,150977416,150979576
21150,6,6,1,2412,-79,-91,12,e6:aa:ea:c9:ea:33,150985375,408,5391,150984967,150985375
21151,6,6,1,2412,-79,-91,12,e6:aa:ea:c9:ea:33,150997490,408,11707,150997082,150997490
21152,6,6,1,2412,-78,-91,13,e6:aa:ea:c9:ea:33,151009634,408,11736,151009226,151009634
21153,6,6,1,2412,-66,-91,25,40:e3:d6:da:ba:26,151026168,380,16154,151025788,151026168
21154,6,6,1,2412,-78,-91,13,e6:aa:ea:c9:ea:33,151034514,408,7938,151034106,151034514
21155,6,12,1,2412,-63,-91,28,40:e3:d6:da:ba:20,151127087,160,92413,151126927,151127087
21156,6,6,1,2412,-63,-91,28,40:e3:d6:da:ba:21,151127288,368,-167,151126920,151127288
21157,6,12,1,2412,-63,-91,28,40:e3:d6:da:ba:23,151127899,184,427,151127715,151127899
21158,6,12,1,2412,-63,-91,28,40:e3:d6:da:ba:24,151128117,176,42,151127941,151128117
21159,6,12,1,2412,-63,-91,28,40:e3:d6:da:ba:25,151128337,160,60,151128177,151128337
21160,6,6,1,2412,-63,-91,28,40:e3:d6:da:ba:26,151128556,380,-161,151128176,151128556
21161,4,1,1,2412,-83,-91,8,54:e4:3a:ec:fb:64,151184375,2160,53659,151182215,151184375
21162,6,6,1,2412,-90,-91,1,40:e3:d6:da:c0:26,151202427,380,17672,151202047,151202427
21163,4,1,1,2412,-74,-91,17,b8:3a:5a:88:e6:e0,151213157,2360,8370,151210797,151213157
21164,6,12,1,2412,-64,-91,27,40:e3:d6:da:ba:20,151229506,160,16189,151229346,151229506
21165,6,6,1,2412,-64,-91,27,40:e3:d6:da:ba:21,151229716,368,-158,151229348,151229716
21166,6,12,1,2412,-63,-91,28,40:e3:d6:da:ba:22,151230103,180,207,151229923,151230103
21167,6,12,1,2412,-63,-91,28,40:e3:d6:da:ba:23,151230308,184,21,151230124,151230308
21168,6,12,1,2412,-63,-91,28,40:e3:d6:da:ba:24,151230535,176,51,151230359,151230535
21169,6,12,1,2412,-63,-91,28,40:e3:d6:da:ba:25,151230764,160,69,151230604,151230764
21170,6,6,1,2412,-64,-91,27,40:e3:d6:da:ba:26,151230965,380,-179,151230585,151230965
21171,4,1,1,2412,-85,-91,6,54:e4:3a:ec:fb:64,151286773,2160,53648,151284613,151286773
21172,4,1,1,2412,-93,-91,-2,a6:e5:7c:28:b1:d3,151288972,992,1207,151287980,151288972
21173,6,6,1,2412,-82,-91,9,e6:aa:ea:b7:4a:dd,151295912,408,6532,151295504,151295912
21174,6,6,1,2412,-81,-91,10,e6:aa:ea:b7:4a:dd,151308045,408,11725,151307637,151308045
21175,4,1,1,2412,-86,-91,5,b8:3a:5a:88:e6:e0,151315563,2360,5158,151313203,151315563
21176,4,1,1,2412,-86,-91,5,b8:3a:5a:88:e6:e1,151317961,2376,22,151315585,151317961
21177,6,12,1,2412,-66,-91,25,40:e3:d6:da:ba:20,151331888,160,13767,151331728,151331888
21178,6,6,1,2412,-66,-91,25,40:e3:d6:da:ba:21,151332080,368,-176,151331712,151332080
21179,6,6,1,2412,-81,-91,10,e6:aa:ea:b7:4a:dd,151332837,408,349,151332429,151332837
21180,6,6,1,2412,-80,-91,11,e6:aa:ea:b7:4a:dd,151344408,408,11163,151344000,151344408
21181,4,1,1,2412,-86,-91,5,b8:3a:5a:88:e6:e1,151397290,2256,50626,151395034,151397290
21182,6,6,1,2412,-76,-91,15,e6:aa:ea:c9:ea:33,151403934,408,6236,151403526,151403934
21183,6,6,1,2412,-76,-91,15,e6:aa:ea:c9:ea:33,151415790,408,11448,151415382,151415790
21184,4,1,1,2412,-82,-91,9,b8:3a:5a:88:e6:e0,151417964,2360,-186,151415604,151417964
21185,6,6,1,2412,-76,-91,15,e6:aa:ea:c9:ea:33,151427913,408,9541,151427505,151427913
21186,6,12,1,2412,-63,-91,28,40:e3:d6:da:ba:20,151434299,160,6226,151434139,151434299
21187,6,6,1,2412,-63,-91,28,40:e3:d6:da:ba:21,151434500,368,-167,151434132,151434500
21188,6,12,1,2412,-63,-91,28,40:e3:d6:da:ba:22,151434896,180,216,151434716,151434896
21189,6,12,1,2412,-63,-91,28,40:e3:d6:da:ba:23,151435102,184,22,151434918,151435102
21190,6,12,1,2412,-63,-91,28,40:e3:d6:da:ba:24,151435329,176,51,151435153,151435329
21191,6,12,1,2412,-63,-91,28,40:e3:d6:da:ba:25,151435531,160,42,151435371,151435531
21192,6,6,1,2412,-63,-91,28,40:e3:d6:da:ba:26,151435732,380,-179,151435352,151435732
21193,6,6,1,2412,-77,-91,14,e6:aa:ea:c9:ea:33,151440211,408,4071,151439803,151440211
21194,4,1,1,2412,-88,-91,3,b8:3a:5a:88:e6:e0,151520373,2360,77802,151518013,151520373
21195,6,12,1,2412,-68,-91,23,40:e3:d6:da:ba:20,151536689,160,16156,151536529,151536689
21196,6,6,1,2412,-68,-91,23,40:e3:d6:da:ba:21,151536908,368,-149,151536540,151536908
21197,6,12,1,2412,-68,-91,23,40:e3:d6:da:ba:22,151537295,180,207,151537115,151537295
21198,6,12,1,2412,-68,-91,23,40:e3:d6:da:ba:23,151537527,184,48,151537343,151537527
21199,6,12,1,2412,-68,-91,23,40:e3:d6:da:ba:24,151537746,176,43,151537570,151537746
21200,6,12,1,2412,-68,-91,23,40:e3:d6:da:ba:25,151537981,160,75,151537821,151537981
21201,6,6,1,2412,-68,-91,23,40:e3:d6:da:ba:26,151538182,380,-179,151537802,151538182
21202,4,1,1,2412,-83,-91,8,54:e4:3a:ec:fb:64,151593971,2160,53629,151591811,151593971
21203,6,6,1,2412,-79,-91,12,e6:aa:ea:b7:4a:dd,151611381,408,17002,151610973,151611381
21204,4,1,1,2412,-83,-91,8,b8:3a:5a:88:e6:e0,151622757,2360,9016,151620397,151622757
21205,4,1,1,2412,-82,-91,9,b8:3a:5a:88:e6:e1,151625186,2376,53,151622810,151625186
21206,6,6,1,2412,-83,-91,8,e6:aa:ea:b7:4a:dd,151635619,408,10025,151635211,151635619
21207,6,12,1,2412,-71,-91,20,40:e3:d6:da:ba:20,151639092,160,3313,151638932,151639092
21208,6,12,1,2412,-71,-91,20,40:e3:d6:da:ba:22,151639707,180,435,151639527,151639707
21209,6,12,1,2412,-71,-91,20,40:e3:d6:da:ba:23,151639922,184,31,151639738,151639922
21210,6,12,1,2412,-71,-91,20,40:e3:d6:da:ba:24,151640140,176,42,151639964,151640140
21211,6,12,1,2412,-71,-91,20,40:e3:d6:da:ba:25,151640350,160,50,151640190,151640350
21212,4,1,1,2412,-92,-91,-1,c0:c9:e3:4d:6e:bf,151657537,872,16315,151656665,151657537
21213,6,6,1,2412,-84,-91,7,e6:aa:ea:b7:4a:dd,151659857,408,1912,151659449,151659857
21214,4,1,1,2412,-93,-91,-2,a6:e5:7c:28:b1:d3,151684332,992,23483,151683340,151684332
21215,4,1,1,2412,-86,-91,5,54:e4:3a:ec:fb:64,151696371,2160,9879,151694211,151696371
21216,6,6,1,2412,-81,-91,10,e6:aa:ea:c9:ea:33,151718667,408,21888,151718259,151718667
21217,4,1,1,2412,-81,-91,10,b8:3a:5a:88:e6:e0,151725161,2360,4134,151722801,151725161
21218,4,1,1,2412,-78,-91,13,b8:3a:5a:88:e6:e1,151727568,2376,31,151725192,151727568
21219,6,6,1,2412,-81,-91,10,e6:aa:ea:c9:ea:33,151730784,408,2808,151730376,151730784
21220,6,12,1,2412,-71,-91,20,40:e3:d6:da:ba:25,151742748,160,11804,151742588,151742748
21221,6,6,1,2412,-79,-91,12,e6:aa:ea:c9:ea:33,151755025,408,11869,151754617,151755025
21222,6,6,1,2412,-80,-91,11,e6:aa:ea:c9:ea:33,151767146,408,11713,151766738,151767146
21223,4,1,1,2412,-88,-91,3,54:e4:3a:ec:fb:64,151798770,2160,29464,151796610,151798770
21224,6,12,1,2412,-68,-91,23,40:e3:d6:da:ba:20,151843890,160,44960,151843730,151843890
21225,6,6,1,2412,-68,-91,23,40:e3:d6:da:ba:21,151844091,368,-167,151843723,151844091
21226,6,12,1,2412,-68,-91,23,40:e3:d6:da:ba:22,151844505,180,234,151844325,151844505
21227,6,12,1,2412,-68,-91,23,40:e3:d6:da:ba:23,151844729,184,40,151844545,151844729
21228,6,12,1,2412,-68,-91,23,40:e3:d6:da:ba:24,151844956,176,51,151844780,151844956
21229,6,12,1,2412,-68,-91,23,40:e3:d6:da:ba:25,151845166,160,50,151845006,151845166
21230,6,6,1,2412,-68,-91,23,40:e3:d6:da:ba:26,151845367,380,-179,151844987,151845367
21231,6,12,1,2412,-68,-91,23,40:e3:d6:da:ba:20,151954437,160,108910,151954277,151954437
21232,6,6,1,2412,-68,-91,23,40:e3:d6:da:ba:21,151954629,368,-176,151954261,151954629
21233,6,12,1,2412,-68,-91,23,40:e3:d6:da:ba:22,151955016,180,207,151954836,151955016
21234,6,12,1,2412,-68,-91,23,40:e3:d6:da:ba:23,151955248,184,48,151955064,151955248
21235,6,12,1,2412,-68,-91,23,40:e3:d6:da:ba:24,151955466,176,42,151955290,151955466
21236,6,12,1,2412,-68,-91,23,40:e3:d6:da:ba:25,151955695,160,69,151955535,151955695
21237,6,6,1,2412,-68,-91,23,40:e3:d6:da:ba:26,151955896,380,-179,151955516,151955896
21238,6,12,1,2412,-68,-91,23,40:e3:d6:da:ba:20,152048695,160,92639,152048535,152048695
21239,6,6,1,2412,-69,-91,22,40:e3:d6:da:ba:21,152048887,368,-176,152048519,152048887
21240,6,12,1,2412,-68,-91,23,40:e3:d6:da:ba:22,152049274,180,207,152049094,152049274
21241,6,12,1,2412,-68,-91,23,40:e3:d6:da:ba:23,152049480,184,22,152049296,152049480
21242,6,12,1,2412,-68,-91,23,40:e3:d6:da:ba:24,152049707,176,51,152049531,152049707
21243,6,12,1,2412,-68,-91,23,40:e3:d6:da:ba:25,152049917,160,50,152049757,152049917
21244,4,1,1,2412,-84,-91,7,54:e4:3a:ec:fb:64,152105967,2160,53890,152103807,152105967
21245,6,6,1,2412,-88,-91,3,e6:aa:ea:b7:4a:dd,152130777,408,24402,152130369,152130777
21246,4,1,1,2412,-85,-91,6,b8:3a:5a:88:e6:e0,152134776,2360,1639,152132416,152134776
21247,4,1,1,2412,-88,-91,3,b8:3a:5a:88:e6:e1,152137174,2376,22,152134798,152137174
21248,6,6,1,2412,-86,-91,5,e6:aa:ea:b7:4a:dd,152144505,408,6923,152144097,152144505
21249,6,12,1,2412,-67,-91,24,40:e3:d6:da:ba:20,152151097,160,6432,152150937,152151097
21250,6,6,1,2412,-67,-91,24,40:e3:d6:da:ba:21,152151289,368,-176,152150921,152151289
21251,6,12,1,2412,-67,-91,24,40:e3:d6:da:ba:22,152151694,180,225,152151514,152151694
21252,6,12,1,2412,-67,-91,24,40:e3:d6:da:ba:23,152151918,184,40,152151734,152151918
21253,6,6,1,2412,-86,-91,5,e6:aa:ea:b7:4a:dd,152167128,408,14802,152166720,152167128
21254,6,6,1,2412,-86,-91,5,e6:aa:ea:b7:4a:dd,152179246,408,11710,152178838,152179246
21255,4,1,1,2412,-86,-91,5,54:e4:3a:ec:fb:64,152208365,2160,26959,152206205,152208365
21256,4,1,1,2412,-83,-91,8,b8:3a:5a:88:e6:e0,152237178,2360,26453,152234818,152237178
21257,4,1,1,2412,-83,-91,8,b8:3a:5a:88:e6:e1,152239558,2376,4,152237182,152239558
21258,6,6,1,2412,-73,-91,18,40:e3:d6:da:ba:21,152253687,368,13761,152253319,152253687
21259,6,12,1,2412,-74,-91,17,40:e3:d6:da:ba:22,152254083,180,216,152253903,152254083
21260,6,12,1,2412,-73,-91,18,40:e3:d6:da:ba:23,152254297,184,30,152254113,152254297
21261,6,12,1,2412,-67,-91,24,40:e3:d6:da:ba:24,152254534,176,61,152254358,152254534
21262,6,12,1,2412,-73,-91,18,40:e3:d6:da:ba:25,152254762,160,68,152254602,152254762
21263,6,6,1,2412,-77,-91,14,e6:aa:ea:c9:ea:33,152262872,408,7702,152262464,152262872
21264,6,6,1,2412,-77,-91,14,e6:aa:ea:c9:ea:33,152274946,408,11666,152274538,152274946
21265,4,1,1,2412,-87,-91,4,54:e4:3a:ec:fb:64,152310765,2160,33659,152308605,152310765
21266,4,1,1,2412,-85,-91,6,b8:3a:5a:88:e6:e0,152339583,2360,26458,152337223,152339583
21267,4,1,1,2412,-86,-91,5,b8:3a:5a:88:e6:e1,152341981,2376,22,152339605,152341981
21268,6,12,1,2412,-69,-91,22,40:e3:d6:da:ba:20,152355913,160,13772,152355753,152355913
21269,6,6,1,2412,-69,-91,22,40:e3:d6:da:ba:21,152356104,368,-177,152355736,152356104
21270,6,12,1,2412,-69,-91,22,40:e3:d6:da:ba:22,152356509,180,225,152356329,152356509
21271,6,12,1,2412,-69,-91,22,40:e3:d6:da:ba:23,152356715,184,22,152356531,152356715
21272,6,12,1,2412,-69,-91,22,40:e3:d6:da:ba:24,152356942,176,51,152356766,152356942
21273,6,12,1,2412,-69,-91,22,40:e3:d6:da:ba:25,152357171,160,69,152357011,152357171
21274,6,6,1,2412,-69,-91,22,40:e3:d6:da:ba:26,152357390,380,-161,152357010,152357390
21275,4,1,1,2412,-84,-91,7,b8:3a:5a:88:e6:e0,152441959,2360,82209,152439599,152441959
21276,4,1,1,2412,-86,-91,5,b8:3a:5a:88:e6:e1,152444366,2376,31,152441990,152444366
21277,6,12,1,2412,-65,-91,26,40:e3:d6:da:ba:20,152458293,160,13767,152458133,152458293
21278,6,6,1,2412,-64,-91,27,40:e3:d6:da:ba:21,152458511,368,-150,152458143,152458511
21279,6,12,1,2412,-65,-91,26,40:e3:d6:da:ba:23,152459113,184,418,152458929,152459113
21280,6,12,1,2412,-65,-91,26,40:e3:d6:da:ba:24,152459322,176,33,152459146,152459322
21281,6,12,1,2412,-65,-91,26,40:e3:d6:da:ba:25,152459533,160,51,152459373,152459533
21282,6,6,1,2412,-65,-91,26,40:e3:d6:da:ba:26,152459742,380,-171,152459362,152459742
21283,6,6,1,2412,-84,-91,7,e6:aa:ea:b7:4a:dd,152482734,408,22584,152482326,152482734
21284,4,1,1,2412,-89,-91,2,54:e4:3a:ec:fb:64,152515563,2160,30669,152513403,152515563
21285,6,12,1,2412,-71,-91,20,40:e3:d6:da:ba:20,152560715,160,44992,152560555,152560715
21286,6,6,1,2412,-71,-91,20,40:e3:d6:da:ba:21,152560934,368,-149,152560566,152560934
21287,6,12,1,2412,-71,-91,20,40:e3:d6:da:ba:22,152561330,180,216,152561150,152561330
21288,6,12,1,2412,-71,-91,20,40:e3:d6:da:ba:23,152561563,184,49,152561379,152561563
21289,6,12,1,2412,-71,-91,20,40:e3:d6:da:ba:24,152561790,176,51,152561614,152561790
21290,6,12,1,2412,-71,-91,20,40:e3:d6:da:ba:25,152561991,160,41,152561831,152561991
21291,6,6,1,2412,-71,-91,20,40:e3:d6:da:ba:26,152562210,380,-161,152561830,152562210
21292,4,1,1,2412,-85,-91,6,54:e4:3a:ec:fb:64,152617962,2160,53592,152615802,152617962
21293,4,1,1,2412,-62,-91,29,b8:3a:5a:88:e6:e0,152646776,2360,26454,152644416,152646776
21294,6,12,1,2412,-76,-91,15,40:e3:d6:da:ba:20,152663112,160,16176,152662952,152663112
21295,6,6,1,2412,-75,-91,16,40:e3:d6:da:ba:21,152663313,368,-167,152662945,152663313
21296,6,12,1,2412,-63,-91,28,40:e3:d6:da:ba:23,152663933,184,436,152663749,152663933
21297,6,12,1,2412,-63,-91,28,40:e3:d6:da:ba:24,152664142,176,33,152663966,152664142
21298,6,12,1,2412,-63,-91,28,40:e3:d6:da:ba:25,152664370,160,68,152664210,152664370
21299,6,6,1,2412,-63,-91,28,40:e3:d6:da:ba:26,152664562,380,-188,152664182,152664562
21300,4,1,1,2412,-83,-91,8,54:e4:3a:ec:fb:64,152720965,2160,54243,152718805,152720965
21301,6,6,1,2412,-75,-91,16,e6:aa:ea:c9:ea:33,152759035,408,37662,152758627,152759035
21302,6,12,1,2412,-67,-91,24,40:e3:d6:da:ba:20,152765512,160,6317,152765352,152765512
21303,6,6,1,2412,-67,-91,24,40:e3:d6:da:ba:21,152765722,368,-158,152765354,152765722
21304,6,12,1,2412,-67,-91,24,40:e3:d6:da:ba:22,152766118,180,216,152765938,152766118
21305,6,12,1,2412,-67,-91,24,40:e3:d6:da:ba:23,152766350,184,48,152766166,152766350
21306,6,12,1,2412,-67,-91,24,40:e3:d6:da:ba:24,152766569,176,43,152766393,152766569
21307,6,12,1,2412,-67,-91,24,40:e3:d6:da:ba:25,152766797,160,68,152766637,152766797
21308,6,6,1,2412,-67,-91,24,40:e3:d6:da:ba:26,152766998,380,-179,152766618,152766998
21309,6,6,1,2412,-74,-91,17,e6:aa:ea:c9:ea:33,152783283,408,15877,152782875,152783283
21310,6,6,1,2412,-75,-91,16,e6:aa:ea:c9:ea:33,152795398,408,11707,152794990,152795398
21311,6,6,1,2412,-75,-91,16,e6:aa:ea:c9:ea:33,152807509,408,11703,152807101,152807509
21312,6,6,1,2412,-90,-91,1,40:e3:d6:da:c0:21,152839567,368,31690,152839199,152839567
21313,4,1,1,2412,-70,-91,21,b8:3a:5a:88:e6:e0,152851560,2360,9633,152849200,152851560
21314,6,12,1,2412,-73,-91,18,40:e3:d6:da:ba:20,152867917,160,16197,152867757,152867917
21315,6,12,1,2412,-72,-91,19,40:e3:d6:da:ba:22,152868505,180,408,152868325,152868505
21316,6,12,1,2412,-72,-91,19,40:e3:d6:da:ba:23,152868710,184,21,152868526,152868710
21317,6,12,1,2412,-73,-91,18,40:e3:d6:da:ba:24,152868919,176,33,152868743,152868919
21318,6,12,1,2412,-73,-91,18,40:e3:d6:da:ba:25,152869148,160,69,152868988,152869148
21319,6,6,1,2412,-72,-91,19,40:e3:d6:da:ba:26,152869340,380,-188,152868960,152869340
21320,6,6,1,2412,-89,-91,2,84:1b:5e:df:1b:99,152895419,80,25999,152895339,152895419
21321,4,1,1,2412,-84,-91,7,54:e4:3a:ec:fb:64,152925159,2160,27580,152922999,152925159
21322,4,1,1,2412,-88,-91,3,b8:3a:5a:88:e6:e0,152953980,2360,26461,152951620,152953980
21323,4,1,1,2412,-88,-91,3,b8:3a:5a:88:e6:e1,152956378,2376,22,152954002,152956378
21324,6,6,1,2412,-84,-91,7,e6:aa:ea:b7:4a:dd,152967075,408,10289,152966667,152967075
21325,6,12,1,2412,-68,-91,23,40:e3:d6:da:ba:20,152970296,160,3061,152970136,152970296
21326,6,6,1,2412,-68,-91,23,40:e3:d6:da:ba:21,152970488,368,-176,152970120,152970488
21327,6,12,1,2412,-67,-91,24,40:e3:d6:da:ba:22,152970893,180,225,152970713,152970893
21328,6,12,1,2412,-67,-91,24,40:e3:d6:da:ba:23,152971125,184,48,152970941,152971125
21329,6,12,1,2412,-67,-91,24,40:e3:d6:da:ba:24,152971353,176,52,152971177,152971353
21330,6,12,1,2412,-67,-91,24,40:e3:d6:da:ba:25,152971554,160,41,152971394,152971554
21331,6,6,1,2412,-67,-91,24,40:e3:d6:da:ba:26,152971755,380,-179,152971375,152971755
21332,6,6,1,2412,-84,-91,7,e6:aa:ea:b7:4a:dd,152979200,408,7037,152978792,152979200
21333,6,6,1,2412,-84,-91,7,e6:aa:ea:b7:4a:dd,153003430,408,23822,153003022,153003430
21334,6,6,1,2412,-86,-91,5,e6:aa:ea:b7:4a:dd,153015545,408,11707,153015137,153015545
21335,4,1,1,2412,-86,-91,5,54:e4:3a:ec:fb:64,153027559,2160,9854,153025399,153027559
21336,6,12,1,2412,-64,-91,27,40:e3:d6:da:ba:20,153072696,160,44977,153072536,153072696
21337,6,6,1,2412,-64,-91,27,40:e3:d6:da:ba:21,153072906,368,-158,153072538,153072906
21338,6,12,1,2412,-64,-91,27,40:e3:d6:da:ba:22,153073320,180,234,153073140,153073320
21339,6,12,1,2412,-64,-91,27,40:e3:d6:da:ba:23,153073526,184,22,153073342,153073526
21340,6,12,1,2412,-64,-91,27,40:e3:d6:da:ba:24,153073735,176,33,153073559,153073735
21341,6,12,1,2412,-64,-91,27,40:e3:d6:da:ba:25,153073937,160,42,153073777,153073937
21342,6,6,1,2412,-64,-91,27,40:e3:d6:da:ba:26,153074155,380,-162,153073775,153074155
21343,4,1,1,2412,-85,-91,6,b8:3a:5a:88:e6:e0,153158781,2360,82266,153156421,153158781
21344,4,1,1,2412,-84,-91,7,b8:3a:5a:88:e6:e1,153161400,2376,243,153159024,153161400
21345,6,12,1,2412,-63,-91,28,40:e3:d6:da:ba:20,153175116,160,13556,153174956,153175116
21346,6,6,1,2412,-63,-91,28,40:e3:d6:da:ba:21,153175335,368,-149,153174967,153175335
21347,6,12,1,2412,-63,-91,28,40:e3:d6:da:ba:22,153175749,180,234,153175569,153175749
21348,6,12,1,2412,-63,-91,28,40:e3:d6:da:ba:23,153175982,184,49,153175798,153175982
21349,6,12,1,2412,-63,-91,28,40:e3:d6:da:ba:24,153176200,176,42,153176024,153176200
21350,6,12,1,2412,-63,-91,28,40:e3:d6:da:ba:25,153176411,160,51,153176251,153176411
21351,6,6,1,2412,-63,-91,28,40:e3:d6:da:ba:26,153176629,380,-162,153176249,153176629
21352,6,6,1,2412,-76,-91,15,e6:aa:ea:c9:ea:33,153177539,408,502,153177131,153177539
21353,6,6,1,2412,-76,-91,15,e6:aa:ea:c9:ea:33,153189628,408,11681,153189220,153189628
21354,6,6,1,2412,-76,-91,15,e6:aa:ea:c9:ea:33,153225977,408,35941,153225569,153225977
21355,6,12,1,2412,-64,-91,27,40:e3:d6:da:ba:20,153277502,160,51365,153277342,153277502
21356,6,6,1,2412,-63,-91,28,40:e3:d6:da:ba:21,153277703,368,-167,153277335,153277703
21357,6,12,1,2412,-63,-91,28,40:e3:d6:da:ba:22,153278090,180,207,153277910,153278090
21358,6,12,1,2412,-63,-91,28,40:e3:d6:da:ba:23,153278304,184,30,153278120,153278304
21359,6,12,1,2412,-63,-91,28,40:e3:d6:da:ba:24,153278523,176,43,153278347,153278523
21360,6,12,1,2412,-63,-91,28,40:e3:d6:da:ba:25,153278724,160,41,153278564,153278724
21361,6,6,1,2412,-63,-91,28,40:e3:d6:da:ba:26,153278934,380,-170,153278554,153278934
21362,4,1,1,2412,-80,-91,11,b8:3a:5a:88:e6:e0,153363564,2360,82270,153361204,153363564
21363,6,12,1,2412,-69,-91,22,40:e3:d6:da:ba:20,153379908,160,16184,153379748,153379908
21364,6,6,1,2412,-69,-91,22,40:e3:d6:da:ba:21,153380118,368,-158,153379750,153380118
21365,6,12,1,2412,-69,-91,22,40:e3:d6:da:ba:22,153380505,180,207,153380325,153380505
21366,6,12,1,2412,-69,-91,22,40:e3:d6:da:ba:23,153380729,184,40,153380545,153380729
21367,6,12,1,2412,-69,-91,22,40:e3:d6:da:ba:24,153380965,176,60,153380789,153380965
21368,6,12,1,2412,-69,-91,22,40:e3:d6:da:ba:25,153381185,160,60,153381025,153381185
21369,6,6,1,2412,-70,-91,21,40:e3:d6:da:ba:26,153381404,380,-161,153381024,153381404
21370,4,1,1,2412,-84,-91,7,54:e4:3a:ec:fb:64,153437156,2160,53592,153434996,153437156
21371,4,1,1,2412,-79,-91,12,b8:3a:5a:88:e6:e0,153465962,2360,26446,153463602,153465962
21372,4,1,1,2412,-78,-91,13,b8:3a:5a:88:e6:e1,153484720,2256,16502,153482464,153484720
21373,6,6,1,2412,-80,-91,11,e6:aa:ea:b7:4a:dd,153487085,408,1957,153486677,153487085
21374,6,6,1,2412,-75,-91,16,e6:aa:ea:b7:4a:dd,153499206,408,11713,153498798,153499206
21375,4,1,1,2412,-78,-91,13,b8:3a:5a:88:e6:e1,153534764,2256,33302,153532508,153534764
21376,4,1,1,2412,-85,-91,6,54:e4:3a:ec:fb:64,153539554,2160,2630,153537394,153539554
21377,4,1,1,2412,-91,-91,0,a4:e5:7c:28:b1:d3,153550825,688,10583,153550137,153550825
21378,4,1,1,2412,-76,-91,15,b8:3a:5a:88:e6:e1,153570770,2376,17569,153568394,153570770
21379,6,12,1,2412,-70,-91,21,40:e3:d6:da:ba:20,153584699,160,13769,153584539,153584699
21380,6,6,1,2412,-70,-91,21,40:e3:d6:da:ba:26,153586158,380,1079,153585778,153586158
21381,6,6,1,2412,-80,-91,11,e6:aa:ea:c9:ea:33,153594878,408,8312,153594470,153594878
21382,6,6,1,2412,-80,-91,11,e6:aa:ea:c9:ea:33,153606994,408,11708,153606586,153606994
21383,6,6,1,2412,-79,-91,12,e6:aa:ea:c9:ea:33,153619115,408,11713,153618707,153619115
21384,4,1,1,2412,-91,-91,0,c0:c9:e3:4d:6e:bf,153621191,872,1204,153620319,153621191
21385,6,6,1,2412,-79,-91,12,e6:aa:ea:c9:ea:33,153631312,408,9713,153630904,153631312
21386,4,1,1,2412,-86,-91,5,b8:3a:5a:88:e6:e1,153673211,2376,39523,153670835,153673211
21387,6,12,1,2412,-69,-91,22,40:e3:d6:da:ba:20,153687126,160,13755,153686966,153687126
21388,4,1,1,2412,-92,-91,-1,a6:e5:7c:28:b1:d3,153732056,992,43938,153731064,153732056
21389,4,1,1,2412,-81,-91,10,b8:3a:5a:88:e6:e0,153773178,2360,38762,153770818,153773178
21390,6,12,1,2412,-67,-91,24,40:e3:d6:da:ba:20,153789499,160,16161,153789339,153789499
21391,6,6,1,2412,-67,-91,24,40:e3:d6:da:ba:21,153789718,368,-149,153789350,153789718
21392,6,12,1,2412,-67,-91,24,40:e3:d6:da:ba:22,153790123,180,225,153789943,153790123
21393,6,12,1,2412,-67,-91,24,40:e3:d6:da:ba:23,153790347,184,40,153790163,153790347
21394,6,12,1,2412,-67,-91,24,40:e3:d6:da:ba:24,153790574,176,51,153790398,153790574
21395,6,12,1,2412,-67,-91,24,40:e3:d6:da:ba:25,153790775,160,41,153790615,153790775
21396,6,6,1,2412,-67,-91,24,40:e3:d6:da:ba:26,153790976,380,-179,153790596,153790976
21397,6,12,1,2412,-64,-91,27,40:e3:d6:da:ba:20,153891901,160,100765,153891741,153891901
21398,6,12,1,2412,-64,-91,27,40:e3:d6:da:ba:22,153892498,180,417,153892318,153892498
21399,4,1,1,2412,-88,-91,3,b8:3a:5a:88:e6:e1,153980376,2376,85502,153978000,153980376
21400,6,12,1,2412,-62,-91,29,40:e3:d6:da:ba:20,153994319,160,13783,153994159,153994319
21401,6,6,1,2412,-71,-91,20,40:e3:d6:da:ba:21,153994538,368,-149,153994170,153994538
21402,6,12,1,2412,-70,-91,21,40:e3:d6:da:ba:24,153995412,176,698,153995236,153995412
21403,6,6,1,2412,-83,-91,8,e6:aa:ea:b7:4a:dd,154019134,408,23314,154018726,154019134
21404,6,6,1,2412,-83,-91,8,e6:aa:ea:b7:4a:dd,154031248,408,11706,154030840,154031248
21405,6,6,1,2412,-82,-91,9,e6:aa:ea:b7:4a:dd,154043374,408,11718,154042966,154043374
21406,4,1,1,2412,-86,-91,5,54:e4:3a:ec:fb:64,154051551,2160,6017,154049391,154051551
21407,4,1,1,2412,-88,-91,3,b8:3a:5a:88:e6:e0,154080369,2360,26458,154078009,154080369
21408,4,1,1,2412,-88,-91,3,b8:3a:5a:88:e6:e1,154082775,2376,30,154080399,154082775
21409,6,12,1,2412,-61,-91,30,40:e3:d6:da:ba:20,154096708,160,13773,154096548,154096708
21410,6,6,1,2412,-61,-91,30,40:e3:d6:da:ba:21,154096926,368,-150,154096558,154096926
21411,6,12,1,2412,-61,-91,30,40:e3:d6:da:ba:22,154097331,180,225,154097151,154097331
21412,6,12,1,2412,-61,-91,30,40:e3:d6:da:ba:23,154097564,184,49,154097380,154097564
21413,6,12,1,2412,-61,-91,30,40:e3:d6:da:ba:24,154097816,176,76,154097640,154097816
21414,6,12,1,2412,-61,-91,30,40:e3:d6:da:ba:25,154098027,160,51,154097867,154098027
21415,6,6,1,2412,-61,-91,30,40:e3:d6:da:ba:26,154098219,380,-188,154097839,154098219
21416,6,6,1,2412,-77,-91,14,e6:aa:ea:c9:ea:33,154115009,408,16382,154114601,154115009
21417,6,6,1,2412,-77,-91,14,e6:aa:ea:c9:ea:33,154127143,408,11726,154126735,154127143
21418,6,6,1,2412,-77,-91,14,e6:aa:ea:c9:ea:33,154163495,408,35944,154163087,154163495
21419,4,1,1,2412,-88,-91,3,b8:3a:5a:88:e6:e0,154182931,2360,17076,154180571,154182931
21420,6,12,1,2412,-61,-91,30,40:e3:d6:da:ba:20,154199111,160,16020,154198951,154199111
21421,6,6,1,2412,-61,-91,30,40:e3:d6:da:ba:21,154199303,368,-176,154198935,154199303
21422,6,12,1,2412,-61,-91,30,40:e3:d6:da:ba:22,154199708,180,225,154199528,154199708
21423,6,12,1,2412,-61,-91,30,40:e3:d6:da:ba:23,154199932,184,40,154199748,154199932
21424,6,12,1,2412,-61,-91,30,40:e3:d6:da:ba:24,154200159,176,51,154199983,154200159
21425,6,12,1,2412,-61,-91,30,40:e3:d6:da:ba:25,154200361,160,42,154200201,154200361
21426,6,6,1,2412,-61,-91,30,40:e3:d6:da:ba:26,154200580,380,-161,154200200,154200580
21427,4,1,1,2412,-89,-91,2,54:e4:3a:ec:fb:64,154214018,2112,11326,154211906,154214018
21428,4,1,1,2412,-87,-91,4,54:e4:3a:ec:fb:64,154216527,2112,397,154214415,154216527
21429,4,1,1,2412,-86,-91,5,54:e4:3a:ec:fb:64,154218830,2112,191,154216718,154218830
21430,4,1,1,2412,-84,-91,7,54:e4:3a:ec:fb:64,154256348,2160,35358,154254188,154256348
21431,4,1,1,2412,-87,-91,4,b8:3a:5a:88:e6:e1,154287544,2376,28820,154285168,154287544
21432,6,12,1,2412,-61,-91,30,40:e3:d6:da:ba:20,154301502,160,13798,154301342,154301502
21433,6,6,1,2412,-61,-91,30,40:e3:d6:da:ba:21,154301721,368,-149,154301353,154301721
21434,6,12,1,2412,-60,-91,31,40:e3:d6:da:ba:22,154302117,180,216,154301937,154302117
21435,6,12,1,2412,-61,-91,30,40:e3:d6:da:ba:23,154302341,184,40,154302157,154302341
21436,6,12,1,2412,-61,-91,30,40:e3:d6:da:ba:24,154302550,176,33,154302374,154302550
21437,6,12,1,2412,-60,-91,31,40:e3:d6:da:ba:25,154302769,160,59,154302609,154302769
21438,6,6,1,2412,-61,-91,30,40:e3:d6:da:ba:26,154302961,380,-188,154302581,154302961
21439,6,6,1,2412,-82,-91,9,e6:aa:ea:b7:4a:dd,154322053,408,18684,154321645,154322053
21440,6,6,1,2412,-81,-91,10,e6:aa:ea:b7:4a:dd,154334175,408,11714,154333767,154334175
21441,6,6,1,2412,-81,-91,10,e6:aa:ea:b7:4a:dd,154358415,408,23832,154358007,154358415
21442,4,1,1,2412,-84,-91,7,54:e4:3a:ec:fb:64,154359013,2160,-1562,154356853,154359013
21443,4,1,1,2412,-88,-91,3,b8:3a:5a:88:e6:e0,154387587,2360,26214,154385227,154387587
21444,4,1,1,2412,-88,-91,3,b8:3a:5a:88:e6:e1,154389985,2376,22,154387609,154389985
21445,4,1,1,2412,-88,-91,3,24:f6:77:10:02:c8,154449947,1064,58898,154448883,154449947
21446,4,1,1,2412,-84,-91,7,54:e4:3a:ec:fb:64,154461147,2160,9040,154458987,154461147
21447,4,1,1,2412,-86,-91,5,24:f6:77:10:02:c8,154463359,1064,1148,154462295,154463359
21448,4,1,1,2412,-88,-91,3,b8:3a:5a:88:e6:e0,154489987,2360,24268,154487627,154489987
21449,4,1,1,2412,-87,-91,4,b8:3a:5a:88:e6:e1,154492367,2376,4,154489991,154492367
21450,6,6,1,2412,-62,-91,29,40:e3:d6:da:ba:21,154506510,368,13775,154506142,154506510
21451,6,12,1,2412,-63,-91,28,40:e3:d6:da:ba:22,154506924,180,234,154506744,154506924
21452,6,12,1,2412,-62,-91,29,40:e3:d6:da:ba:23,154507179,184,71,154506995,154507179
21453,6,6,1,2412,-78,-91,13,e6:aa:ea:c9:ea:33,154532379,408,24792,154531971,154532379
21454,4,1,1,2412,-83,-91,8,24:f6:77:10:02:c8,154536290,1064,2847,154535226,154536290
21455,6,6,1,2412,-83,-91,8,e6:aa:ea:c9:ea:33,154544487,408,7789,154544079,154544487
21456,6,6,1,2412,-78,-91,13,e6:aa:ea:c9:ea:33,154556604,408,11709,154556196,154556604
21457,6,6,1,2412,-79,-91,12,e6:aa:ea:c9:ea:33,154580840,408,23828,154580432,154580840
21458,4,1,1,2412,-86,-91,5,b8:3a:5a:88:e6:e0,154592390,2360,9190,154590030,154592390
21459,4,1,1,2412,-88,-91,3,b8:3a:5a:88:e6:e1,154594779,2376,13,154592403,154594779
21460,6,12,1,2412,-67,-91,24,40:e3:d6:da:ba:20,154608704,160,13765,154608544,154608704
21461,6,6,1,2412,-66,-91,25,40:e3:d6:da:ba:21,154608913,368,-159,154608545,154608913
21462,6,12,1,2412,-66,-91,25,40:e3:d6:da:ba:22,154609309,180,216,154609129,154609309
21463,6,12,1,2412,-66,-91,25,40:e3:d6:da:ba:23,154609542,184,49,154609358,154609542
21464,6,12,1,2412,-66,-91,25,40:e3:d6:da:ba:24,154609760,176,42,154609584,154609760
21465,6,12,1,2412,-66,-91,25,40:e3:d6:da:ba:25,154609989,160,69,154609829,154609989
21466,6,6,1,2412,-66,-91,25,40:e3:d6:da:ba:26,154610181,380,-188,154609801,154610181
21467,6,6,1,2412,-79,-91,12,e6:aa:ea:b7:4a:dd,154637012,408,26423,154636604,154637012
21468,6,6,1,2412,-79,-91,12,e6:aa:ea:b7:4a:dd,154649130,408,11710,154648722,154649130
21469,6,6,1,2412,-80,-91,11,e6:aa:ea:b7:4a:dd,154661249,408,11711,154660841,154661249
21470,6,6,1,2412,-80,-91,11,e6:aa:ea:b7:4a:dd,154673362,408,11705,154672954,154673362
21471,6,6,1,2412,-69,-91,22,40:e3:d6:da:ba:21,154711341,368,37611,154710973,154711341
21472,6,12,1,2412,-68,-91,23,40:e3:d6:da:ba:25,154712398,160,897,154712238,154712398
21473,6,6,1,2412,-69,-91,22,40:e3:d6:da:ba:26,154712608,380,-170,154712228,154712608
21474,4,1,1,2412,-89,-91,2,b8:3a:5a:88:e6:e0,154797190,2360,82222,154794830,154797190
21475,6,12,1,2412,-66,-91,25,40:e3:d6:da:ba:20,154813509,160,16159,154813349,154813509
21476,6,6,1,2412,-66,-91,25,40:e3:d6:da:ba:21,154813728,368,-149,154813360,154813728
21477,6,12,1,2412,-66,-91,25,40:e3:d6:da:ba:22,154814149,180,241,154813969,154814149
21478,6,12,1,2412,-66,-91,25,40:e3:d6:da:ba:23,154814373,184,40,154814189,154814373
21479,6,12,1,2412,-66,-91,25,40:e3:d6:da:ba:24,154816884,176,2335,154816708,154816884
21480,6,12,1,2412,-66,-91,25,40:e3:d6:da:ba:25,154817094,160,50,154816934,154817094
21481,6,6,1,2412,-66,-91,25,40:e3:d6:da:ba:26,154817313,380,-161,154816933,154817313
21482,6,12,1,2412,-62,-91,29,40:e3:d6:da:ba:20,154915905,160,98432,154915745,154915905
21483,6,6,1,2412,-62,-91,29,40:e3:d6:da:ba:21,154916106,368,-167,154915738,154916106
21484,6,12,1,2412,-61,-91,30,40:e3:d6:da:ba:22,154916511,180,225,154916331,154916511
21485,6,12,1,2412,-62,-91,29,40:e3:d6:da:ba:23,154916725,184,30,154916541,154916725
21486,6,12,1,2412,-62,-91,29,40:e3:d6:da:ba:24,154916953,176,52,154916777,154916953
21487,6,12,1,2412,-62,-91,29,40:e3:d6:da:ba:25,154917172,160,59,154917012,154917172
21488,6,6,1,2412,-62,-91,29,40:e3:d6:da:ba:26,154917382,380,-170,154917002,154917382
21489,4,1,1,2412,-86,-91,5,54:e4:3a:ec:fb:64,154931887,2160,12345,154929727,154931887
21490,4,1,1,2412,-86,-91,5,b8:3a:5a:88:e6:e0,155002162,2360,67915,154999802,155002162
21491,6,12,1,2412,-61,-91,30,40:e3:d6:da:ba:20,155018305,160,15983,155018145,155018305
21492,6,6,1,2412,-61,-91,30,40:e3:d6:da:ba:21,155018515,368,-158,155018147,155018515
21493,6,12,1,2412,-61,-91,30,40:e3:d6:da:ba:22,155018920,180,225,155018740,155018920
21494,6,12,1,2412,-61,-91,30,40:e3:d6:da:ba:23,155019134,184,30,155018950,155019134
21495,6,12,1,2412,-61,-91,30,40:e3:d6:da:ba:24,155019344,176,34,155019168,155019344
21496,6,12,1,2412,-61,-91,30,40:e3:d6:da:ba:25,155019572,160,68,155019412,155019572
21497,6,6,1,2412,-75,-91,16,e6:aa:ea:c9:ea:33,155088509,408,68529,155088101,155088509
21498,6,6,1,2412,-76,-91,15,e6:aa:ea:c9:ea:33,155100627,408,11710,155100219,155100627
21499,4,1,1,2412,-89,-91,2,c0:c9:e3:4d:6e:bf,155102977,872,1478,155102105,155102977
21500,4,1,1,2412,-83,-91,8,b8:3a:5a:88:e6:e0,155104365,2360,-972,155102005,155104365
21501,4,1,1,2412,-83,-91,8,b8:3a:5a:88:e6:e1,155106772,2376,31,155104396,155106772
21502,6,6,1,2412,-63,-91,28,40:e3:d6:da:ba:21,155120933,368,13793,155120565,155120933
21503,6,12,1,2412,-63,-91,28,40:e3:d6:da:ba:22,155121338,180,225,155121158,155121338
21504,6,12,1,2412,-62,-91,29,40:e3:d6:da:ba:23,155121571,184,49,155121387,155121571
21505,6,12,1,2412,-62,-91,29,40:e3:d6:da:ba:24,155121789,176,42,155121613,155121789
21506,6,12,1,2412,-62,-91,29,40:e3:d6:da:ba:25,155121991,160,42,155121831,155121991
21507,6,6,1,2412,-63,-91,28,40:e3:d6:da:ba:26,155122201,380,-170,155121821,155122201
21508,6,6,1,2412,-80,-91,11,e6:aa:ea:b7:4a:dd,155169530,408,46921,155169122,155169530
21509,6,6,1,2412,-83,-91,8,e6:aa:ea:b7:4a:dd,155181647,408,11709,155181239,155181647
21510,6,6,1,2412,-81,-91,10,e6:aa:ea:b7:4a:dd,155193769,408,11714,155193361,155193769
21511,6,6,1,2412,-79,-91,12,e6:aa:ea:b7:4a:dd,155205884,408,11707,155205476,155205884
21512,6,12,1,2412,-68,-91,23,40:e3:d6:da:ba:20,155223112,160,17068,155222952,155223112
21513,6,6,1,2412,-68,-91,23,40:e3:d6:da:ba:21,155223331,368,-149,155222963,155223331
21514,6,12,1,2412,-67,-91,24,40:e3:d6:da:ba:22,155223718,180,207,155223538,155223718
21515,6,12,1,2412,-68,-91,23,40:e3:d6:da:ba:23,155223923,184,21,155223739,155223923
21516,6,12,1,2412,-68,-91,23,40:e3:d6:da:ba:24,155224160,176,61,155223984,155224160
21517,6,12,1,2412,-68,-91,23,40:e3:d6:da:ba:25,155224370,160,50,155224210,155224370
21518,6,6,1,2412,-68,-91,23,40:e3:d6:da:ba:26,155224580,380,-170,155224200,155224580
21519,4,1,1,2412,-85,-91,6,b8:3a:5a:88:e6:e0,155309231,2360,82291,155306871,155309231
21520,4,1,1,2412,-85,-91,6,b8:3a:5a:88:e6:e1,155311653,2376,46,155309277,155311653
21521,6,12,1,2412,-67,-91,24,40:e3:d6:da:ba:20,155325530,160,13717,155325370,155325530
21522,6,6,1,2412,-67,-91,24,40:e3:d6:da:ba:21,155325749,368,-149,155325381,155325749
21523,6,12,1,2412,-67,-91,24,40:e3:d6:da:ba:22,155326145,180,216,155325965,155326145
21524,6,12,1,2412,-67,-91,24,40:e3:d6:da:ba:23,155326368,184,39,155326184,155326368
21525,6,12,1,2412,-67,-91,24,40:e3:d6:da:ba:24,155326578,176,34,155326402,155326578
21526,6,12,1,2412,-67,-91,24,40:e3:d6:da:ba:25,155326788,160,50,155326628,155326788
21527,6,6,1,2412,-67,-91,24,40:e3:d6:da:ba:26,155326980,380,-188,155326600,155326980
21528,4,1,1,2412,-87,-91,4,54:e4:3a:ec:fb:64,155357748,2112,28656,155355636,155357748
21529,6,12,1,2412,-65,-91,26,40:e3:d6:da:ba:20,155360037,136,2153,155359901,155360037
21530,6,6,1,2412,-65,-91,26,40:e3:d6:da:ba:21,155360232,348,-153,155359884,155360232
21531,6,12,1,2412,-66,-91,25,40:e3:d6:da:ba:22,155360626,156,238,155360470,155360626
21532,6,12,1,2412,-65,-91,26,40:e3:d6:da:ba:23,155360843,156,61,155360687,155360843
21533,6,12,1,2412,-66,-91,25,40:e3:d6:da:ba:25,155361033,136,54,155360897,155361033
21534,4,1,1,2412,-76,-91,15,b8:3a:5a:88:e6:e0,155371151,2240,7878,155368911,155371151
21535,4,1,1,2412,-85,-91,6,b8:3a:5a:88:e6:e1,155374648,2256,1241,155372392,155374648
21536,4,1,1,2412,-85,-91,6,b8:3a:5a:88:e6:e0,155411818,2360,34810,155409458,155411818
21537,4,1,1,2412,-85,-91,6,b8:3a:5a:88:e6:e1,155414198,2376,4,155411822,155414198
21538,6,12,1,2412,-62,-91,29,40:e3:d6:da:ba:20,155427926,160,13568,155427766,155427926
21539,6,6,1,2412,-61,-91,30,40:e3:d6:da:ba:21,155428118,368,-176,155427750,155428118
21540,6,12,1,2412,-61,-91,30,40:e3:d6:da:ba:22,155428523,180,225,155428343,155428523
21541,6,12,1,2412,-62,-91,29,40:e3:d6:da:ba:23,155428738,184,31,155428554,155428738
21542,6,12,1,2412,-61,-91,30,40:e3:d6:da:ba:24,155428947,176,33,155428771,155428947
21543,6,12,1,2412,-61,-91,30,40:e3:d6:da:ba:25,155429149,160,42,155428989,155429149
21544,6,6,1,2412,-61,-91,30,40:e3:d6:da:ba:26,155429340,380,-189,155428960,155429340
21545,4,1,1,2412,-84,-91,7,54:e4:3a:ec:fb:64,155458622,2112,27170,155456510,155458622
21546,4,1,1,2412,-84,-91,7,54:e4:3a:ec:fb:64,155463380,2112,2646,155461268,155463380
21547,4,1,1,2412,-83,-91,8,54:e4:3a:ec:fb:64,155485515,2160,19975,155483355,155485515
21548,4,1,1,2412,-73,-91,18,b8:3a:5a:88:e6:e1,155516361,2376,28470,155513985,155516361
21549,6,12,1,2412,-62,-91,29,40:e3:d6:da:ba:20,155530309,160,13788,155530149,155530309
21550,6,6,1,2412,-62,-91,29,40:e3:d6:da:ba:21,155530528,368,-149,155530160,155530528
21551,6,12,1,2412,-62,-91,29,40:e3:d6:da:ba:22,155530942,180,234,155530762,155530942
21552,6,12,1,2412,-70,-91,21,40:e3:d6:da:ba:25,155531621,160,519,155531461,155531621
21553,4,1,1,2412,-86,-91,5,54:e4:3a:ec:fb:64,155559362,2112,25629,155557250,155559362
21554,4,1,1,2412,-84,-91,7,54:e4:3a:ec:fb:64,155561724,2112,250,155559612,155561724
21555,6,6,1,2412,-77,-91,14,e6:aa:ea:c9:ea:33,155571227,408,9095,155570819,155571227
21556,6,6,1,2412,-78,-91,13,e6:aa:ea:c9:ea:33,155583347,408,11712,155582939,155583347
21557,6,6,1,2412,-78,-91,13,e6:aa:ea:c9:ea:33,155607582,408,23827,155607174,155607582
21558,4,1,1,2412,-81,-91,10,b8:3a:5a:88:e6:e1,155618759,2376,8801,155616383,155618759
21559,6,12,1,2412,-69,-91,22,40:e3:d6:da:ba:20,155632714,160,13795,155632554,155632714
21560,6,6,1,2412,-69,-91,22,40:e3:d6:da:ba:21,155632915,368,-167,155632547,155632915
21561,6,12,1,2412,-69,-91,22,40:e3:d6:da:ba:22,155633311,180,216,155633131,155633311
21562,6,12,1,2412,-69,-91,22,40:e3:d6:da:ba:23,155633534,184,39,155633350,155633534
21563,6,12,1,2412,-69,-91,22,40:e3:d6:da:ba:24,155633771,176,61,155633595,155633771
21564,6,12,1,2412,-69,-91,22,40:e3:d6:da:ba:25,155633999,160,68,155633839,155633999
21565,6,6,1,2412,-69,-91,22,40:e3:d6:da:ba:26,155634218,380,-161,155633838,155634218
21566,4,1,1,2412,-84,-91,7,b8:3a:5a:88:e6:e0,155675866,2240,39408,155673626,155675866
21567,6,6,1,2412,-85,-91,6,e6:aa:ea:b7:4a:dd,155678090,408,1816,155677682,155678090
21568,4,1,1,2412,-84,-91,7,b8:3a:5a:88:e6:e1,155679485,2256,-861,155677229,155679485
21569,4,1,1,2412,-87,-91,4,54:e4:3a:ec:fb:64,155689937,2160,8292,155687777,155689937
21570,4,1,1,2412,-84,-91,7,b8:3a:5a:88:e6:e0,155697171,2240,4994,155694931,155697171
21571,4,1,1,2412,-83,-91,8,b8:3a:5a:88:e6:e1,155700803,2256,1376,155698547,155700803
21572,6,6,1,2412,-81,-91,10,e6:aa:ea:b7:4a:dd,155714441,408,13230,155714033,155714441
21573,4,1,1,2412,-85,-91,6,b8:3a:5a:88:e6:e0,155718768,2360,1967,155716408,155718768
21574,6,6,1,2412,-81,-91,10,e6:aa:ea:b7:4a:dd,155726568,408,7392,155726160,155726568
21575,4,1,1,2412,-83,-91,8,54:e4:3a:ec:fb:64,155792336,2160,63608,155790176,155792336
21576,6,6,1,2412,-85,-91,6,84:1b:5e:df:1b:99,155815427,80,23011,155815347,155815427
21577,4,1,1,2412,-87,-91,4,b8:3a:5a:88:e6:e0,155821173,2360,3386,155818813,155821173
21578,6,12,1,2412,-69,-91,22,40:e3:d6:da:ba:20,155837529,160,16196,155837369,155837529
21579,6,6,1,2412,-69,-91,22,40:e3:d6:da:ba:21,155837730,368,-167,155837362,155837730
21580,6,12,1,2412,-69,-91,22,40:e3:d6:da:ba:22,155838126,180,216,155837946,155838126
21581,6,12,1,2412,-69,-91,22,40:e3:d6:da:ba:23,155838358,184,48,155838174,155838358
21582,4,1,1,2412,-87,-91,4,b8:3a:5a:88:e6:e0,155923612,2360,82894,155921252,155923612
21583,4,1,1,2412,-87,-91,4,b8:3a:5a:88:e6:e1,155925991,2376,3,155923615,155925991
21584,6,12,1,2412,-72,-91,19,40:e3:d6:da:ba:20,155939925,160,13774,155939765,155939925
21585,6,12,1,2412,-71,-91,20,40:e3:d6:da:ba:22,155940548,180,443,155940368,155940548
21586,6,12,1,2412,-63,-91,28,40:e3:d6:da:ba:23,155940754,184,22,155940570,155940754
21587,6,12,1,2412,-72,-91,19,40:e3:d6:da:ba:24,155940981,176,51,155940805,155940981
21588,6,6,1,2412,-89,-91,2,40:e3:d6:da:c0:21,155994935,348,53606,155994587,155994935
21589,6,12,1,2412,-89,-91,2,40:e3:d6:da:c0:22,155995311,156,220,155995155,155995311
21590,6,6,1,2412,-75,-91,16,e6:aa:ea:c9:ea:33,156024810,408,29091,156024402,156024810
21591,4,1,1,2412,-85,-91,6,b8:3a:5a:88:e6:e0,156025984,2360,-1186,156023624,156025984
21592,4,1,1,2412,-85,-91,6,b8:3a:5a:88:e6:e1,156028364,2376,4,156025988,156028364
21593,6,12,1,2412,-70,-91,21,40:e3:d6:da:ba:20,156042613,160,14089,156042453,156042613
21594,6,12,1,2412,-70,-91,21,40:e3:d6:da:ba:23,156043451,184,654,156043267,156043451
21595,6,12,1,2412,-70,-91,21,40:e3:d6:da:ba:24,156043678,176,51,156043502,156043678
21596,6,12,1,2412,-70,-91,21,40:e3:d6:da:ba:25,156043889,160,51,156043729,156043889
21597,6,6,1,2412,-70,-91,21,40:e3:d6:da:ba:26,156044099,380,-170,156043719,156044099
21598,6,6,1,2412,-85,-91,6,e6:aa:ea:b7:4a:dd,156108602,408,64095,156108194,156108602
21599,6,6,1,2412,-85,-91,6,e6:aa:ea:b7:4a:dd,156120720,408,11710,156120312,156120720
21600,6,12,1,2412,-67,-91,24,40:e3:d6:da:ba:20,156144715,160,23835,156144555,156144715
21601,6,12,1,2412,-66,-91,25,40:e3:d6:da:ba:22,156145321,180,426,156145141,156145321
21602,6,12,1,2412,-66,-91,25,40:e3:d6:da:ba:23,156145535,184,30,156145351,156145535
21603,6,6,1,2412,-67,-91,24,40:e3:d6:da:ba:26,156146192,380,277,156145812,156146192
21604,6,6,1,2412,-83,-91,8,e6:aa:ea:b7:4a:dd,156146975,408,375,156146567,156146975
21605,4,1,1,2412,-88,-91,3,54:e4:3a:ec:fb:64,156201931,2160,52796,156199771,156201931
21606,4,1,1,2412,-85,-91,6,b8:3a:5a:88:e6:e1,156233167,2376,28860,156230791,156233167
21607,6,12,1,2412,-67,-91,24,40:e3:d6:da:ba:20,156247125,160,13798,156246965,156247125
21608,6,12,1,2412,-70,-91,21,40:e3:d6:da:ba:23,156247936,184,627,156247752,156247936
21609,6,6,1,2412,-70,-91,21,40:e3:d6:da:ba:26,156248602,380,286,156248222,156248602
21610,4,1,1,2412,-91,-91,0,a6:e5:7c:28:b1:d3,156292603,992,43009,156291611,156292603
21611,4,1,1,2412,-85,-91,6,54:e4:3a:ec:fb:64,156304331,2160,9568,156302171,156304331
21612,4,1,1,2412,-83,-91,8,b8:3a:5a:88:e6:e0,156333169,2360,26478,156330809,156333169
21613,4,1,1,2412,-83,-91,8,b8:3a:5a:88:e6:e1,156343076,2256,7651,156340820,156343076
21614,6,12,1,2412,-71,-91,20,40:e3:d6:da:ba:22,156350786,180,7530,156350606,156350786
21615,6,12,1,2412,-74,-91,17,40:e3:d6:da:ba:24,156351246,176,284,156351070,156351246
21616,6,12,1,2412,-72,-91,19,40:e3:d6:da:ba:25,156351465,160,59,156351305,156351465
21617,6,6,1,2412,-70,-91,21,40:e3:d6:da:ba:26,156351684,380,-161,156351304,156351684
21618,6,6,1,2412,-84,-91,7,e6:aa:ea:b7:4a:dd,156423364,408,71272,156422956,156423364
21619,4,1,1,2412,-82,-91,9,b8:3a:5a:88:e6:e0,156435591,2360,9867,156433231,156435591
21620,6,6,1,2412,-76,-91,15,e6:aa:ea:c9:ea:33,156441911,408,5912,156441503,156441911
21621,6,6,1,2412,-79,-91,12,e6:aa:ea:c9:ea:33,156453930,408,11611,156453522,156453930
21622,6,6,1,2412,-85,-91,6,e6:aa:ea:b7:4a:dd,156459707,408,5369,156459299,156459707
21623,4,1,1,2412,-81,-91,10,b8:3a:5a:88:e6:e0,156537970,2360,75903,156535610,156537970
21624,4,1,1,2412,-81,-91,10,b8:3a:5a:88:e6:e1,156540367,2376,21,156537991,156540367
21625,6,12,1,2412,-66,-91,25,40:e3:d6:da:ba:20,156554312,160,13785,156554152,156554312
21626,6,6,1,2412,-66,-91,25,40:e3:d6:da:ba:21,156554531,368,-149,156554163,156554531
21627,6,12,1,2412,-65,-91,26,40:e3:d6:da:ba:22,156554918,180,207,156554738,156554918
21628,6,12,1,2412,-65,-91,26,40:e3:d6:da:ba:23,156555151,184,49,156554967,156555151
21629,6,12,1,2412,-66,-91,25,40:e3:d6:da:ba:24,156555360,176,33,156555184,156555360
21630,6,12,1,2412,-65,-91,26,40:e3:d6:da:ba:25,156555571,160,51,156555411,156555571
21631,6,6,1,2412,-66,-91,25,40:e3:d6:da:ba:26,156555762,380,-189,156555382,156555762
21632,4,1,1,2412,-83,-91,8,b8:3a:5a:88:e6:e0,156640382,2360,82260,156638022,156640382
21633,6,12,1,2412,-67,-91,24,40:e3:d6:da:ba:20,156656714,160,16172,156656554,156656714
21634,6,6,1,2412,-66,-91,25,40:e3:d6:da:ba:21,156656933,368,-149,156656565,156656933
21635,6,12,1,2412,-66,-91,25,40:e3:d6:da:ba:22,156657347,180,234,156657167,156657347
21636,6,12,1,2412,-66,-91,25,40:e3:d6:da:ba:23,156657570,184,39,156657386,156657570
21637,6,12,1,2412,-67,-91,24,40:e3:d6:da:ba:24,156657798,176,52,156657622,156657798
21638,6,12,1,2412,-67,-91,24,40:e3:d6:da:ba:25,156658008,160,50,156657848,156658008
21639,6,6,1,2412,-66,-91,25,40:e3:d6:da:ba:26,156658218,380,-170,156657838,156658218
21640,4,1,1,2412,-85,-91,6,54:e4:3a:ec:fb:64,156713928,2160,53550,156711768,156713928
21641,4,1,1,2412,-83,-91,8,b8:3a:5a:88:e6:e0,156742956,2360,26668,156740596,156742956
21642,4,1,1,2412,-55,-91,36,b8:3a:5a:88:e6:e1,156745363,2376,31,156742987,156745363
21643,6,12,1,2412,-68,-91,23,40:e3:d6:da:ba:20,156759138,160,13615,156758978,156759138
21644,6,6,1,2412,-68,-91,23,40:e3:d6:da:ba:21,156759357,368,-149,156758989,156759357
21645,6,12,1,2412,-68,-91,23,40:e3:d6:da:ba:22,156759771,180,234,156759591,156759771
21646,6,12,1,2412,-68,-91,23,40:e3:d6:da:ba:23,156760003,184,48,156759819,156760003
21647,6,12,1,2412,-68,-91,23,40:e3:d6:da:ba:24,156760212,176,33,156760036,156760212
21648,6,12,1,2412,-68,-91,23,40:e3:d6:da:ba:25,156760423,160,51,156760263,156760423
21649,6,6,1,2412,-68,-91,23,40:e3:d6:da:ba:26,156760633,380,-170,156760253,156760633
21650,4,1,1,2412,-86,-91,5,b8:3a:5a:88:e6:e0,156845170,2360,82177,156842810,156845170
21651,6,12,1,2412,-68,-91,23,40:e3:d6:da:ba:20,156861525,160,16195,156861365,156861525
21652,6,6,1,2412,-68,-91,23,40:e3:d6:da:ba:21,156861726,368,-167,156861358,156861726
21653,6,12,1,2412,-68,-91,23,40:e3:d6:da:ba:22,156862140,180,234,156861960,156862140
21654,6,6,1,2412,-68,-91,23,40:e3:d6:da:ba:26,156863056,380,536,156862676,156863056
21655,6,6,1,2412,-82,-91,9,e6:aa:ea:b7:4a:dd,156931487,408,68023,156931079,156931487
21656,6,6,1,2412,-75,-91,16,e6:aa:ea:c9:ea:33,156940992,408,9097,156940584,156940992
21657,6,6,1,2412,-80,-91,11,e6:aa:ea:b7:4a:dd,156943600,408,2200,156943192,156943600
21658,4,1,1,2412,-83,-91,8,b8:3a:5a:88:e6:e0,156947584,2360,1624,156945224,156947584
21659,6,6,1,2412,-79,-91,12,e6:aa:ea:c9:ea:33,156953084,408,5092,156952676,156953084
21660,6,6,1,2412,-82,-91,9,e6:aa:ea:b7:4a:dd,156955725,408,2233,156955317,156955725
21661,6,12,1,2412,-69,-91,22,40:e3:d6:da:ba:20,156963915,160,8030,156963755,156963915
21662,6,6,1,2412,-68,-91,23,40:e3:d6:da:ba:21,156964135,368,-148,156963767,156964135
21663,6,12,1,2412,-69,-91,22,40:e3:d6:da:ba:22,156964540,180,225,156964360,156964540
21664,6,12,1,2412,-69,-91,22,40:e3:d6:da:ba:23,156964754,184,30,156964570,156964754
21665,6,12,1,2412,-68,-91,23,40:e3:d6:da:ba:24,156964963,176,33,156964787,156964963
21666,6,12,1,2412,-69,-91,22,40:e3:d6:da:ba:25,156965183,160,60,156965023,156965183
21667,6,6,1,2412,-69,-91,22,40:e3:d6:da:ba:26,156965393,380,-170,156965013,156965393
21668,6,6,1,2412,-75,-91,16,e6:aa:ea:c9:ea:33,156965861,408,60,156965453,156965861
21669,6,6,1,2412,-82,-91,9,e6:aa:ea:b7:4a:dd,156967843,408,1574,156967435,156967843
21670,6,6,1,2412,-75,-91,16,e6:aa:ea:c9:ea:33,156977334,408,9083,156976926,156977334
21671,6,6,1,2412,-83,-91,8,e6:aa:ea:b7:4a:dd,156979959,408,2217,156979551,156979959
21672,4,1,1,2412,-81,-91,10,b8:3a:5a:88:e6:e0,157049970,2360,67651,157047610,157049970
21673,4,1,1,2412,-81,-91,10,b8:3a:5a:88:e6:e1,157052359,2376,13,157049983,157052359
21674,6,12,1,2412,-65,-91,26,40:e3:d6:da:ba:20,157066324,160,13805,157066164,157066324
21675,6,6,1,2412,-65,-91,26,40:e3:d6:da:ba:21,157066525,368,-167,157066157,157066525
21676,6,12,1,2412,-65,-91,26,40:e3:d6:da:ba:22,157066921,180,216,157066741,157066921
21677,6,12,1,2412,-65,-91,26,40:e3:d6:da:ba:23,157067145,184,40,157066961,157067145
21678,6,12,1,2412,-65,-91,26,40:e3:d6:da:ba:24,157067363,176,42,157067187,157067363
21679,6,12,1,2412,-65,-91,26,40:e3:d6:da:ba:25,157067573,160,50,157067413,157067573
21680,6,6,1,2412,-64,-91,27,40:e3:d6:da:ba:26,157067792,380,-161,157067412,157067792
21681,4,1,1,2412,-84,-91,7,54:e4:3a:ec:fb:64,157123523,2160,53571,157121363,157123523
21682,4,1,1,2412,-78,-91,13,b8:3a:5a:88:e6:e0,157152371,2360,26488,157150011,157152371
21683,4,1,1,2412,-81,-91,10,b8:3a:5a:88:e6:e1,157154760,2376,13,157152384,157154760
21684,6,12,1,2412,-66,-91,25,40:e3:d6:da:ba:20,157168717,160,13797,157168557,157168717
21685,6,6,1,2412,-66,-91,25,40:e3:d6:da:ba:21,157168909,368,-176,157168541,157168909
21686,6,12,1,2412,-66,-91,25,40:e3:d6:da:ba:22,157169323,180,234,157169143,157169323
21687,6,12,1,2412,-66,-91,25,40:e3:d6:da:ba:23,157169537,184,30,157169353,157169537
21688,6,12,1,2412,-68,-91,23,40:e3:d6:da:ba:24,157169755,176,42,157169579,157169755
21689,4,1,1,2412,-85,-91,6,54:e4:3a:ec:fb:64,157225922,2160,54007,157223762,157225922
21690,6,6,1,2412,-84,-91,7,e6:aa:ea:b7:4a:dd,157246547,408,20217,157246139,157246547
21691,4,1,1,2412,-85,-91,6,b8:3a:5a:88:e6:e0,157254775,2360,5868,157252415,157254775
21692,6,6,1,2412,-88,-91,3,e6:aa:ea:b7:4a:dd,157270766,408,15583,157270358,157270766
21693,6,12,1,2412,-65,-91,26,40:e3:d6:da:ba:20,157271208,160,282,157271048,157271208
21694,6,6,1,2412,-64,-91,27,40:e3:d6:da:ba:21,157271417,368,-159,157271049,157271417
21695,6,12,1,2412,-64,-91,27,40:e3:d6:da:ba:22,157271822,180,225,157271642,157271822
21696,6,12,1,2412,-64,-91,27,40:e3:d6:da:ba:23,157272028,184,22,157271844,157272028
21697,6,12,1,2412,-69,-91,22,40:e3:d6:da:ba:24,157272255,176,51,157272079,157272255
21698,6,6,1,2412,-89,-91,2,e6:aa:ea:b7:4a:dd,157282886,408,10223,157282478,157282886
21699,6,6,1,2412,-87,-91,4,e6:aa:ea:b7:4a:dd,157294999,408,11705,157294591,157294999
21700,4,1,1,2412,-85,-91,6,54:e4:3a:ec:fb:64,157328323,2160,31164,157326163,157328323
21701,6,6,1,2412,-77,-91,14,e6:aa:ea:c9:ea:33,157346944,408,18213,157346536,157346944
21702,6,6,1,2412,-66,-91,25,40:e3:d6:da:ba:21,157373748,368,26436,157373380,157373748
21703,6,12,1,2412,-66,-91,25,40:e3:d6:da:ba:22,157374135,180,207,157373955,157374135
21704,6,12,1,2412,-66,-91,25,40:e3:d6:da:ba:23,157374340,184,21,157374156,157374340
21705,6,6,1,2412,-75,-91,16,e6:aa:ea:c9:ea:33,157395362,408,20614,157394954,157395362
21706,6,12,1,2412,-65,-91,26,40:e3:d6:da:ba:20,157475918,160,80396,157475758,157475918
21707,6,6,1,2412,-65,-91,26,40:e3:d6:da:ba:21,157476137,368,-149,157475769,157476137
21708,6,12,1,2412,-65,-91,26,40:e3:d6:da:ba:22,157476542,180,225,157476362,157476542
21709,6,12,1,2412,-66,-91,25,40:e3:d6:da:ba:23,157476766,184,40,157476582,157476766
21710,6,12,1,2412,-65,-91,26,40:e3:d6:da:ba:24,157476984,176,42,157476808,157476984
21711,6,12,1,2412,-65,-91,26,40:e3:d6:da:ba:25,157477185,160,41,157477025,157477185
21712,6,6,1,2412,-65,-91,26,40:e3:d6:da:ba:26,157477404,380,-161,157477024,157477404
21713,4,1,1,2412,-85,-91,6,54:e4:3a:ec:fb:64,157533120,2160,53556,157530960,157533120
21714,4,1,1,2412,-87,-91,4,b8:3a:5a:88:e6:e0,157562868,2360,27388,157560508,157562868
21715,6,12,1,2412,-64,-91,27,40:e3:d6:da:ba:20,157578318,160,15290,157578158,157578318
21716,6,6,1,2412,-64,-91,27,40:e3:d6:da:ba:21,157578537,368,-149,157578169,157578537
21717,6,12,1,2412,-64,-91,27,40:e3:d6:da:ba:22,157578933,180,216,157578753,157578933
21718,6,12,1,2412,-63,-91,28,40:e3:d6:da:ba:23,157579157,184,40,157578973,157579157
21719,6,12,1,2412,-64,-91,27,40:e3:d6:da:ba:24,157579375,176,42,157579199,157579375
21720,6,12,1,2412,-64,-91,27,40:e3:d6:da:ba:25,157579594,160,59,157579434,157579594
21721,6,6,1,2412,-64,-91,27,40:e3:d6:da:ba:26,157579786,380,-188,157579406,157579786
21722,4,1,1,2412,-87,-91,4,54:e4:3a:ec:fb:64,157635520,2160,53574,157633360,157635520
21723,4,1,1,2412,-85,-91,6,b8:3a:5a:88:e6:e0,157664419,2360,26539,157662059,157664419
21724,4,1,1,2412,-85,-91,6,b8:3a:5a:88:e6:e1,157666808,2376,13,157664432,157666808
21725,6,6,1,2412,-82,-91,9,e6:aa:ea:b7:4a:dd,157676552,408,9336,157676144,157676552
21726,6,12,1,2412,-67,-91,24,40:e3:d6:da:ba:20,157680728,160,4016,157680568,157680728
21727,6,6,1,2412,-67,-91,24,40:e3:d6:da:ba:21,157680947,368,-149,157680579,157680947
21728,6,6,1,2412,-82,-91,9,e6:aa:ea:b7:4a:dd,157688777,408,7422,157688369,157688777
21729,6,6,1,2412,-81,-91,10,e6:aa:ea:b7:4a:dd,157700777,408,11592,157700369,157700777
21730,6,6,1,2412,-82,-91,9,e6:aa:ea:b7:4a:dd,157712899,408,11714,157712491,157712899
21731,4,1,1,2412,-85,-91,6,54:e4:3a:ec:fb:64,157737919,2160,22860,157735759,157737919
21732,6,6,1,2412,-74,-91,17,e6:aa:ea:c9:ea:33,157765417,408,27090,157765009,157765417
21733,4,1,1,2412,-81,-91,10,b8:3a:5a:88:e6:e0,157767134,2360,-643,157764774,157767134
21734,4,1,1,2412,-84,-91,7,b8:3a:5a:88:e6:e1,157769541,2376,31,157767165,157769541
21735,6,6,1,2412,-73,-91,18,e6:aa:ea:c9:ea:33,157777554,408,7605,157777146,157777554
21736,6,12,1,2412,-65,-91,26,40:e3:d6:da:ba:20,157783119,160,5405,157782959,157783119
21737,6,6,1,2412,-65,-91,26,40:e3:d6:da:ba:21,157783338,368,-149,157782970,157783338
21738,6,12,1,2412,-65,-91,26,40:e3:d6:da:ba:22,157783752,180,234,157783572,157783752
21739,6,12,1,2412,-65,-91,26,40:e3:d6:da:ba:23,157783958,184,22,157783774,157783958
21740,6,12,1,2412,-65,-91,26,40:e3:d6:da:ba:24,157784194,176,60,157784018,157784194
21741,6,12,1,2412,-65,-91,26,40:e3:d6:da:ba:25,157784413,160,59,157784253,157784413
21742,6,6,1,2412,-65,-91,26,40:e3:d6:da:ba:26,157784605,380,-188,157784225,157784605
21743,6,6,1,2412,-73,-91,18,e6:aa:ea:c9:ea:33,157789710,408,4697,157789302,157789710
21744,6,6,1,2412,-74,-91,17,e6:aa:ea:c9:ea:33,157801893,408,11775,157801485,157801893
21745,6,6,1,2412,-74,-91,17,e6:aa:ea:c9:ea:33,157813908,408,11607,157813500,157813908
21746,4,1,1,2412,-85,-91,6,54:e4:3a:ec:fb:64,157840482,2160,24414,157838322,157840482
21747,6,12,1,2412,-89,-91,2,40:e3:d6:da:c0:24,157858015,172,17361,157857843,157858015
21748,6,12,1,2412,-88,-91,3,40:e3:d6:da:c0:25,157858230,156,59,157858074,157858230
21749,4,1,1,2412,-83,-91,8,b8:3a:5a:88:e6:e0,157869173,2360,8583,157866813,157869173
21750,4,1,1,2412,-84,-91,7,b8:3a:5a:88:e6:e1,157871553,2376,4,157869177,157871553
21751,6,12,1,2412,-64,-91,27,40:e3:d6:da:ba:20,157885533,160,13820,157885373,157885533
21752,6,6,1,2412,-64,-91,27,40:e3:d6:da:ba:21,157885743,368,-158,157885375,157885743
21753,6,12,1,2412,-63,-91,28,40:e3:d6:da:ba:25,157886800,160,897,157886640,157886800
21754,6,12,1,2412,-89,-91,2,40:e3:d6:da:c0:20,157959382,156,72426,157959226,157959382
21755,6,6,1,2412,-88,-91,3,40:e3:d6:da:c0:21,157959589,368,-161,157959221,157959589
21756,6,12,1,2412,-63,-91,28,40:e3:d6:da:ba:20,157987922,160,28173,157987762,157987922
21757,6,6,1,2412,-63,-91,28,40:e3:d6:da:ba:21,157988132,368,-158,157987764,157988132
21758,6,12,1,2412,-63,-91,28,40:e3:d6:da:ba:22,157988519,180,207,157988339,157988519
21759,6,12,1,2412,-63,-91,28,40:e3:d6:da:ba:23,157988752,184,49,157988568,157988752
21760,6,12,1,2412,-63,-91,28,40:e3:d6:da:ba:24,157989019,176,91,157988843,157989019
21761,6,12,1,2412,-63,-91,28,40:e3:d6:da:ba:25,157989230,160,51,157989070,157989230
21762,6,6,1,2412,-63,-91,28,40:e3:d6:da:ba:26,157989422,380,-188,157989042,157989422
21763,4,1,1,2412,-86,-91,5,54:e4:3a:ec:fb:64,158045116,2160,53534,158042956,158045116
21764,6,6,1,2412,-89,-91,2,40:e3:d6:da:c0:21,158061973,368,16489,158061605,158061973
21765,6,12,1,2412,-89,-91,2,40:e3:d6:da:c0:22,158062369,176,220,158062193,158062369
21766,6,12,1,2412,-89,-91,2,40:e3:d6:da:c0:23,158062579,180,30,158062399,158062579
21767,6,12,1,2412,-88,-91,3,40:e3:d6:da:c0:24,158062785,172,34,158062613,158062785
21768,4,1,1,2412,-84,-91,7,b8:3a:5a:88:e6:e1,158076372,2376,11211,158073996,158076372
21769,6,12,1,2412,-62,-91,29,40:e3:d6:da:ba:22,158090932,180,14380,158090752,158090932
21770,6,12,1,2412,-63,-91,28,40:e3:d6:da:ba:24,158091383,176,275,158091207,158091383
21771,6,12,1,2412,-63,-91,28,40:e3:d6:da:ba:25,158091612,160,69,158091452,158091612
21772,6,6,1,2412,-63,-91,28,40:e3:d6:da:ba:26,158091813,380,-179,158091433,158091813
21773,6,6,1,2412,-80,-91,11,e6:aa:ea:b7:4a:dd,158093914,408,1693,158093506,158093914
21774,6,6,1,2412,-82,-91,9,e6:aa:ea:b7:4a:dd,158118150,408,23828,158117742,158118150
21775,6,6,1,2412,-82,-91,9,e6:aa:ea:b7:4a:dd,158130264,408,11706,158129856,158130264
21776,4,1,1,2412,-79,-91,12,54:e4:3a:ec:fb:64,158147514,2160,15090,158145354,158147514
21777,6,6,1,2412,-89,-91,2,40:e3:d6:da:c0:26,158165587,380,17693,158165207,158165587
21778,4,1,1,2412,-86,-91,5,b8:3a:5a:88:e6:e0,158176373,2360,8426,158174013,158176373
21779,4,1,1,2412,-85,-91,6,b8:3a:5a:88:e6:e1,158181052,2376,2303,158178676,158181052
21780,6,12,1,2412,-63,-91,28,40:e3:d6:da:ba:20,158192730,160,11518,158192570,158192730
21781,6,6,1,2412,-63,-91,28,40:e3:d6:da:ba:21,158192940,368,-158,158192572,158192940
21782,6,12,1,2412,-62,-91,29,40:e3:d6:da:ba:22,158193359,180,239,158193179,158193359
21783,6,6,1,2412,-62,-91,29,40:e3:d6:da:ba:26,158194287,380,548,158193907,158194287
21784,6,6,1,2412,-75,-91,16,e6:aa:ea:c9:ea:33,158206584,408,11889,158206176,158206584
21785,6,6,1,2412,-75,-91,16,e6:aa:ea:c9:ea:33,158230815,408,23823,158230407,158230815
21786,4,1,1,2412,-85,-91,6,54:e4:3a:ec:fb:64,158249913,2160,16938,158247753,158249913
21787,6,6,1,2412,-88,-91,3,40:e3:d6:da:c0:21,158266771,368,16490,158266403,158266771
21788,6,12,1,2412,-89,-91,2,40:e3:d6:da:c0:24,158267601,172,658,158267429,158267601
21789,6,12,1,2412,-89,-91,2,40:e3:d6:da:c0:25,158267817,156,60,158267661,158267817
21790,4,1,1,2412,-85,-91,6,b8:3a:5a:88:e6:e0,158278797,2360,8620,158276437,158278797
21791,4,1,1,2412,-86,-91,5,b8:3a:5a:88:e6:e1,158281185,2376,12,158278809,158281185
21792,6,12,1,2412,-62,-91,29,40:e3:d6:da:ba:20,158295123,160,13778,158294963,158295123
21793,6,6,1,2412,-62,-91,29,40:e3:d6:da:ba:21,158295342,368,-149,158294974,158295342
21794,6,12,1,2412,-62,-91,29,40:e3:d6:da:ba:22,158295747,180,225,158295567,158295747
21795,6,12,1,2412,-62,-91,29,40:e3:d6:da:ba:23,158295953,184,22,158295769,158295953
21796,6,12,1,2412,-62,-91,29,40:e3:d6:da:ba:24,158296162,176,33,158295986,158296162
21797,6,12,1,2412,-63,-91,28,40:e3:d6:da:ba:25,158296364,160,42,158296204,158296364
21798,6,6,1,2412,-62,-91,29,40:e3:d6:da:ba:26,158296582,380,-162,158296202,158296582
21799,4,1,1,2412,-85,-91,6,b8:3a:5a:88:e6:e0,158342121,2240,43299,158339881,158342121
21800,4,1,1,2412,-83,-91,8,b8:3a:5a:88:e6:e0,158360566,2240,16205,158358326,158360566
21801,6,12,1,2412,-91,-91,0,40:e3:d6:da:c0:23,158369768,180,9022,158369588,158369768
21802,6,12,1,2412,-62,-91,29,40:e3:d6:da:ba:20,158397546,160,27618,158397386,158397546
21803,6,6,1,2412,-62,-91,29,40:e3:d6:da:ba:21,158397765,368,-149,158397397,158397765
21804,6,12,1,2412,-62,-91,29,40:e3:d6:da:ba:22,158398179,180,234,158397999,158398179
21805,6,12,1,2412,-62,-91,29,40:e3:d6:da:ba:23,158398403,184,40,158398219,158398403
21806,6,12,1,2412,-62,-91,29,40:e3:d6:da:ba:24,158398612,176,33,158398436,158398612
21807,6,12,1,2412,-62,-91,29,40:e3:d6:da:ba:25,158398823,160,51,158398663,158398823
21808,6,6,1,2412,-62,-91,29,40:e3:d6:da:ba:26,158399015,380,-188,158398635,158399015
21809,6,12,1,2412,-89,-91,2,40:e3:d6:da:c0:22,158406764,156,7593,158406608,158406764
21810,6,6,1,2412,-82,-91,9,e6:aa:ea:b7:4a:dd,158499051,408,91879,158498643,158499051
21811,6,12,1,2412,-62,-91,29,40:e3:d6:da:ba:20,158499924,160,713,158499764,158499924
21812,6,6,1,2412,-62,-91,29,40:e3:d6:da:ba:21,158500134,368,-158,158499766,158500134
21813,6,12,1,2412,-62,-91,29,40:e3:d6:da:ba:22,158500530,180,216,158500350,158500530
21814,6,12,1,2412,-62,-91,29,40:e3:d6:da:ba:23,158500744,184,30,158500560,158500744
21815,6,12,1,2412,-62,-91,29,40:e3:d6:da:ba:24,158500963,176,43,158500787,158500963
21816,6,6,1,2412,-62,-91,29,40:e3:d6:da:ba:26,158501356,380,13,158500976,158501356
21817,6,6,1,2412,-84,-91,7,e6:aa:ea:b7:4a:dd,158511144,408,9380,158510736,158511144
21818,6,12,1,2412,-63,-91,28,40:e3:d6:da:ba:20,158516792,136,5512,158516656,158516792
21819,6,12,1,2412,-62,-91,29,40:e3:d6:da:ba:22,158517390,156,442,158517234,158517390
21820,6,12,1,2412,-62,-91,29,40:e3:d6:da:ba:23,158517581,156,35,158517425,158517581
21821,4,1,1,2412,-85,-91,6,54:e4:3a:ec:fb:64,158557111,2160,37370,158554951,158557111
21822,6,12,1,2412,-92,-91,-1,40:e3:d6:da:c0:22,158574395,176,17108,158574219,158574395
21823,6,12,1,2412,-62,-91,29,40:e3:d6:da:ba:20,158602346,160,27791,158602186,158602346
21824,6,6,1,2412,-62,-91,29,40:e3:d6:da:ba:21,158602538,368,-176,158602170,158602538
21825,6,12,1,2412,-62,-91,29,40:e3:d6:da:ba:22,158602952,180,234,158602772,158602952
21826,6,12,1,2412,-62,-91,29,40:e3:d6:da:ba:23,158603184,184,48,158603000,158603184
21827,6,12,1,2412,-62,-91,29,40:e3:d6:da:ba:24,158603403,176,43,158603227,158603403
21828,6,12,1,2412,-62,-91,29,40:e3:d6:da:ba:25,158603613,160,50,158603453,158603613
21829,6,6,1,2412,-62,-91,29,40:e3:d6:da:ba:26,158603823,380,-170,158603443,158603823
21830,4,1,1,2412,-85,-91,6,b8:3a:5a:88:e6:e0,158690501,2360,84318,158688141,158690501
21831,4,1,1,2412,-81,-91,10,b8:3a:5a:88:e6:e1,158692889,2376,12,158690513,158692889
21832,6,6,1,2412,-75,-91,16,e6:aa:ea:c9:ea:33,158702660,408,9363,158702252,158702660
21833,6,12,1,2412,-62,-91,29,40:e3:d6:da:ba:20,158704744,160,1924,158704584,158704744
21834,6,12,1,2412,-62,-91,29,40:e3:d6:da:ba:23,158705546,184,618,158705362,158705546
21835,6,6,1,2412,-62,-91,29,40:e3:d6:da:ba:26,158706176,380,250,158705796,158706176
21836,6,6,1,2412,-75,-91,16,e6:aa:ea:c9:ea:33,158714734,408,8150,158714326,158714734
21837,6,6,1,2412,-90,-91,1,84:1b:5e:df:1b:99,158735401,80,20587,158735321,158735401
21838,6,6,1,2412,-84,-91,7,e6:aa:ea:c9:ea:33,158738931,408,3122,158738523,158738931
21839,6,6,1,2412,-75,-91,16,e6:aa:ea:c9:ea:33,158750970,408,11631,158750562,158750970
21840,4,1,1,2412,-81,-91,10,54:e4:3a:ec:fb:64,158761909,2160,8779,158759749,158761909
21841,4,1,1,2412,-85,-91,6,b8:3a:5a:88:e6:e0,158790777,2360,26508,158788417,158790777
21842,4,1,1,2412,-82,-91,9,b8:3a:5a:88:e6:e1,158793156,2376,3,158790780,158793156
21843,6,12,1,2412,-62,-91,29,40:e3:d6:da:ba:20,158807124,160,13808,158806964,158807124
21844,6,6,1,2412,-62,-91,29,40:e3:d6:da:ba:21,158807334,368,-158,158806966,158807334
21845,6,12,1,2412,-62,-91,29,40:e3:d6:da:ba:22,158807748,180,234,158807568,158807748
21846,6,12,1,2412,-61,-91,30,40:e3:d6:da:ba:23,158807954,184,22,158807770,158807954
21847,6,12,1,2412,-61,-91,30,40:e3:d6:da:ba:24,158808163,176,33,158807987,158808163
21848,6,12,1,2412,-61,-91,30,40:e3:d6:da:ba:25,158808392,160,69,158808232,158808392
21849,6,6,1,2412,-62,-91,29,40:e3:d6:da:ba:26,158808583,380,-189,158808203,158808583
21850,6,6,1,2412,-84,-91,7,e6:aa:ea:b7:4a:dd,158813965,408,4974,158813557,158813965
21851,4,1,1,2412,-81,-91,10,42:6b:bc:83:f1:79,158816417,1128,1324,158815289,158816417
21852,6,12,1,2412,-62,-91,29,40:e3:d6:da:ba:20,158819949,136,3396,158819813,158819949
21853,6,12,1,2412,-80,-91,11,,158820101,32,120,158820069,158820101
21854,6,6,1,2412,-80,-91,11,,158820545,44,400,158820501,158820545
21855,6,12,1,2412,-62,-91,29,40:e3:d6:da:ba:22,158820622,156,-79,158820466,158820622
21856,6,12,1,2412,-80,-91,11,,158820794,32,140,158820762,158820794
21857,6,12,1,2412,-62,-91,29,40:e3:d6:da:ba:23,158820932,156,-18,158820776,158820932
21858,6,12,1,2412,-62,-91,29,40:e3:d6:da:ba:25,158821149,136,81,158821013,158821149
21859,6,12,1,2412,-80,-91,11,,158821301,32,120,158821269,158821301
21860,4,1,1,2412,-63,-91,28,42:6b:bc:83:f1:79,158821849,1128,-580,158820721,158821849
21861,6,12,1,2412,-63,-91,28,40:e3:d6:da:ba:20,158822935,136,950,158822799,158822935
21862,6,6,1,2412,-61,-91,30,40:e3:d6:da:ba:21,158823167,348,-116,158822819,158823167
21863,6,6,1,2412,-81,-91,10,,158823531,44,320,158823487,158823531
21864,6,12,1,2412,-61,-91,30,40:e3:d6:da:ba:22,158823626,156,-61,158823470,158823626
21865,6,12,1,2412,-81,-91,10,,158823798,32,140,158823766,158823798
21866,6,12,1,2412,-61,-91,30,40:e3:d6:da:ba:23,158823854,156,-100,158823698,158823854
21867,6,12,1,2412,-80,-91,11,,158824026,32,140,158823994,158824026
21868,6,12,1,2412,-61,-91,30,40:e3:d6:da:ba:25,158824109,136,-53,158823973,158824109
21869,6,12,1,2412,-80,-91,11,,158824261,32,120,158824229,158824261
21870,6,6,1,2412,-84,-91,7,e6:aa:ea:b7:4a:dd,158826085,408,1416,158825677,158826085
21871,6,6,1,2412,-84,-91,7,e6:aa:ea:b7:4a:dd,158838206,408,11713,158837798,158838206
21872,6,6,1,2412,-84,-91,7,e6:aa:ea:b7:4a:dd,158862430,408,23816,158862022,158862430
21873,6,6,1,2412,-88,-91,3,40:e3:d6:da:c0:26,158883498,380,20688,158883118,158883498
21874,6,6,1,2412,-62,-91,29,40:e3:d6:da:ba:21,158909726,368,25860,158909358,158909726
21875,6,12,1,2412,-61,-91,30,40:e3:d6:da:ba:22,158910140,180,234,158909960,158910140
21876,6,12,1,2412,-61,-91,30,40:e3:d6:da:ba:23,158910354,184,30,158910170,158910354
21877,6,12,1,2412,-61,-91,30,40:e3:d6:da:ba:24,158910573,176,43,158910397,158910573
21878,6,12,1,2412,-62,-91,29,40:e3:d6:da:ba:25,158910774,160,41,158910614,158910774
21879,6,6,1,2412,-62,-91,29,40:e3:d6:da:ba:26,158910975,380,-179,158910595,158910975
21880,4,1,1,2412,-83,-91,8,54:e4:3a:ec:fb:64,158966708,2160,53573,158964548,158966708
21881,4,1,1,2412,-85,-91,6,b8:3a:5a:88:e6:e0,158995596,2360,26528,158993236,158995596
21882,6,12,1,2412,-62,-91,29,40:e3:d6:da:ba:20,159011939,160,16183,159011779,159011939
21883,6,12,1,2412,-62,-91,29,40:e3:d6:da:ba:23,159012768,184,645,159012584,159012768
21884,6,12,1,2412,-62,-91,29,40:e3:d6:da:ba:24,159013004,176,60,159012828,159013004
21885,6,12,1,2412,-62,-91,29,40:e3:d6:da:ba:25,159013215,160,51,159013055,159013215
21886,6,6,1,2412,-62,-91,29,40:e3:d6:da:ba:26,159013434,380,-161,159013054,159013434
21887,6,6,1,2412,-75,-91,16,e6:aa:ea:c9:ea:33,159031136,408,17294,159030728,159031136
21888,6,6,1,2412,-85,-91,6,e6:aa:ea:c9:ea:33,159043350,408,11806,159042942,159043350
21889,6,6,1,2412,-75,-91,16,e6:aa:ea:c9:ea:33,159055563,408,11805,159055155,159055563
21890,6,6,1,2412,-75,-91,16,e6:aa:ea:c9:ea:33,159067480,408,11509,159067072,159067480
21891,4,1,1,2412,-86,-91,5,54:e4:3a:ec:fb:64,159069107,2160,-533,159066947,159069107
21892,6,12,1,2412,-63,-91,28,40:e3:d6:da:ba:20,159114330,160,45063,159114170,159114330
21893,6,12,1,2412,-63,-91,28,40:e3:d6:da:ba:22,159114927,180,417,159114747,159114927
21894,6,12,1,2412,-63,-91,28,40:e3:d6:da:ba:23,159115159,184,48,159114975,159115159
21895,6,12,1,2412,-63,-91,28,40:e3:d6:da:ba:24,159115369,176,34,159115193,159115369
21896,6,12,1,2412,-63,-91,28,40:e3:d6:da:ba:25,159115570,160,41,159115410,159115570
21897,6,6,1,2412,-63,-91,28,40:e3:d6:da:ba:26,159115780,380,-170,159115400,159115780
21898,6,12,1,2412,-64,-91,27,40:e3:d6:da:ba:20,159216740,160,100800,159216580,159216740
21899,6,6,1,2412,-64,-91,27,40:e3:d6:da:ba:21,159216932,368,-176,159216564,159216932
21900,6,12,1,2412,-63,-91,28,40:e3:d6:da:ba:22,159217346,180,234,159217166,159217346
21901,6,12,1,2412,-64,-91,27,40:e3:d6:da:ba:23,159217569,184,39,159217385,159217569
21902,6,12,1,2412,-64,-91,27,40:e3:d6:da:ba:24,159217797,176,52,159217621,159217797
21903,6,12,1,2412,-63,-91,28,40:e3:d6:da:ba:25,159217998,160,41,159217838,159217998
21904,6,6,1,2412,-64,-91,27,40:e3:d6:da:ba:26,159218190,380,-188,159217810,159218190
21905,6,12,1,2412,-64,-91,27,40:e3:d6:da:ba:20,159319134,160,100784,159318974,159319134
21906,6,6,1,2412,-64,-91,27,40:e3:d6:da:ba:21,159319335,368,-167,159318967,159319335
21907,6,12,1,2412,-64,-91,27,40:e3:d6:da:ba:22,159319731,180,216,159319551,159319731
21908,6,12,1,2412,-63,-91,28,40:e3:d6:da:ba:23,159319937,184,22,159319753,159319937
21909,6,12,1,2412,-63,-91,28,40:e3:d6:da:ba:24,159320189,176,76,159320013,159320189
21910,6,12,1,2412,-63,-91,28,40:e3:d6:da:ba:25,159320400,160,51,159320240,159320400
21911,6,6,1,2412,-83,-91,8,e6:aa:ea:b7:4a:dd,159334856,408,14048,159334448,159334856
21912,6,6,1,2412,-83,-91,8,e6:aa:ea:b7:4a:dd,159347041,408,11777,159346633,159347041
21913,6,6,1,2412,-88,-91,3,e6:aa:ea:b7:4a:dd,159359085,408,11636,159358677,159359085
21914,6,6,1,2412,-83,-91,8,e6:aa:ea:b7:4a:dd,159371200,408,11707,159370792,159371200
21915,4,1,1,2412,-85,-91,6,54:e4:3a:ec:fb:64,159376305,2160,2945,159374145,159376305
21916,6,6,1,2412,-84,-91,7,e6:aa:ea:b7:4a:dd,159383330,408,6617,159382922,159383330
21917,6,12,1,2412,-87,-91,4,40:e3:d6:da:bb:60,159385749,960,1459,159384789,159385749
21918,4,1,1,2412,-84,-91,7,b8:3a:5a:88:e6:e0,159405209,2360,17100,159402849,159405209
21919,6,6,1,2412,-66,-91,25,40:e3:d6:da:ba:21,159421776,368,16199,159421408,159421776
21920,6,12,1,2412,-67,-91,24,40:e3:d6:da:ba:23,159422412,184,452,159422228,159422412
21921,6,12,1,2412,-66,-91,25,40:e3:d6:da:ba:24,159422639,176,51,159422463,159422639
21922,6,12,1,2412,-67,-91,24,40:e3:d6:da:ba:25,159422859,160,60,159422699,159422859
21923,6,6,1,2412,-66,-91,25,40:e3:d6:da:ba:26,159423051,380,-188,159422671,159423051
21924,6,6,1,2412,-75,-91,16,e6:aa:ea:c9:ea:33,159436367,408,12908,159435959,159436367
21925,6,6,1,2412,-75,-91,16,e6:aa:ea:c9:ea:33,159460610,408,23835,159460202,159460610
21926,6,6,1,2412,-75,-91,16,e6:aa:ea:c9:ea:33,159472727,408,11709,159472319,159472727
21927,6,6,1,2412,-75,-91,16,e6:aa:ea:c9:ea:33,159484922,408,11787,159484514,159484922
21928,4,1,1,2412,-87,-91,4,b8:3a:5a:88:e6:e0,159507601,2360,20319,159505241,159507601
21929,4,1,1,2412,-86,-91,5,b8:3a:5a:88:e6:e1,159509981,2376,4,159507605,159509981
21930,6,12,1,2412,-66,-91,25,40:e3:d6:da:ba:20,159523946,160,13805,159523786,159523946
21931,6,6,1,2412,-66,-91,25,40:e3:d6:da:ba:21,159524156,368,-158,159523788,159524156
21932,6,12,1,2412,-65,-91,26,40:e3:d6:da:ba:22,159524561,180,225,159524381,159524561
21933,6,12,1,2412,-65,-91,26,40:e3:d6:da:ba:23,159524766,184,21,159524582,159524766
21934,6,12,1,2412,-66,-91,25,40:e3:d6:da:ba:24,159524994,176,52,159524818,159524994
21935,6,12,1,2412,-65,-91,26,40:e3:d6:da:ba:25,159525213,160,59,159525053,159525213
21936,6,6,1,2412,-65,-91,26,40:e3:d6:da:ba:26,159525405,380,-188,159525025,159525405
21937,4,1,1,2412,-84,-91,7,54:e4:3a:ec:fb:64,159581102,2160,53537,159578942,159581102
21938,4,1,1,2412,-87,-91,4,b8:3a:5a:88:e6:e1,159612379,2376,28901,159610003,159612379
21939,6,12,1,2412,-65,-91,26,40:e3:d6:da:ba:22,159626942,180,14383,159626762,159626942
21940,6,12,1,2412,-65,-91,26,40:e3:d6:da:ba:24,159627366,176,248,159627190,159627366
21941,6,12,1,2412,-65,-91,26,40:e3:d6:da:ba:25,159627576,160,50,159627416,159627576
21942,6,6,1,2412,-66,-91,25,40:e3:d6:da:ba:26,159627795,380,-161,159627415,159627795
21943,4,1,1,2412,-84,-91,7,54:e4:3a:ec:fb:64,159683502,2160,53547,159681342,159683502
21944,4,1,1,2412,-89,-91,2,b8:3a:5a:88:e6:e0,159712381,2360,26519,159710021,159712381
21945,6,12,1,2412,-66,-91,25,40:e3:d6:da:ba:20,159728728,160,16187,159728568,159728728
21946,6,6,1,2412,-65,-91,26,40:e3:d6:da:ba:21,159728929,368,-167,159728561,159728929
21947,6,12,1,2412,-65,-91,26,40:e3:d6:da:ba:22,159729334,180,225,159729154,159729334
21948,6,12,1,2412,-65,-91,26,40:e3:d6:da:ba:23,159729567,184,49,159729383,159729567
21949,6,12,1,2412,-65,-91,26,40:e3:d6:da:ba:24,159729803,176,60,159729627,159729803
21950,6,12,1,2412,-65,-91,26,40:e3:d6:da:ba:25,159730013,160,50,159729853,159730013
21951,6,6,1,2412,-66,-91,25,40:e3:d6:da:ba:26,159730214,380,-179,159729834,159730214
21952,6,6,1,2412,-85,-91,6,e6:aa:ea:b7:4a:dd,159752443,408,21821,159752035,159752443
21953,6,6,1,2412,-85,-91,6,e6:aa:ea:b7:4a:dd,159764563,408,11712,159764155,159764563
21954,6,6,1,2412,-85,-91,6,e6:aa:ea:b7:4a:dd,159788803,408,23832,159788395,159788803
21955,4,1,1,2412,-86,-91,5,b8:3a:5a:88:e6:e0,159814787,2360,23624,159812427,159814787
21956,4,1,1,2412,-86,-91,5,b8:3a:5a:88:e6:e1,159817176,2376,13,159814800,159817176
21957,6,12,1,2412,-64,-91,27,40:e3:d6:da:ba:22,159831729,180,14373,159831549,159831729
21958,6,12,1,2412,-64,-91,27,40:e3:d6:da:ba:23,159831934,184,21,159831750,159831934
21959,6,6,1,2412,-66,-91,25,e6:aa:ea:c9:ea:33,159854810,408,22468,159854402,159854810
21960,6,6,1,2412,-80,-91,11,e6:aa:ea:c9:ea:33,159866180,408,10962,159865772,159866180
21961,6,6,1,2412,-74,-91,17,e6:aa:ea:c9:ea:33,159878458,408,11870,159878050,159878458
21962,4,1,1,2412,-84,-91,7,54:e4:3a:ec:fb:64,159888299,2160,7681,159886139,159888299
21963,6,6,1,2412,-75,-91,16,e6:aa:ea:c9:ea:33,159890407,408,1700,159889999,159890407
21964,6,6,1,2412,-75,-91,16,e6:aa:ea:c9:ea:33,159902639,408,11824,159902231,159902639
21965,4,1,1,2412,-84,-91,7,b8:3a:5a:88:e6:e0,159917184,2360,12185,159914824,159917184
21966,4,1,1,2412,-85,-91,6,b8:3a:5a:88:e6:e1,159919564,2376,4,159917188,159919564
21967,6,12,1,2412,-64,-91,27,40:e3:d6:da:ba:20,159933540,160,13816,159933380,159933540
21968,6,6,1,2412,-64,-91,27,40:e3:d6:da:ba:21,159933732,368,-176,159933364,159933732
21969,6,12,1,2412,-64,-91,27,40:e3:d6:da:ba:22,159934137,180,225,159933957,159934137
21970,6,12,1,2412,-64,-91,27,40:e3:d6:da:ba:23,159934342,184,21,159934158,159934342
21971,6,12,1,2412,-64,-91,27,40:e3:d6:da:ba:24,159934552,176,34,159934376,159934552
21972,6,12,1,2412,-64,-91,27,40:e3:d6:da:ba:25,159934771,160,59,159934611,159934771
21973,6,6,1,2412,-64,-91,27,40:e3:d6:da:ba:26,159934972,380,-179,159934592,159934972
21974,4,1,1,2412,-85,-91,6,54:e4:3a:ec:fb:64,159990699,2160,53567,159988539,159990699
21975,6,12,1,2412,-62,-91,29,40:e3:d6:da:ba:20,160035930,160,45071,160035770,160035930
21976,6,6,1,2412,-62,-91,29,40:e3:d6:da:ba:21,160036131,368,-167,160035763,160036131
21977,6,12,1,2412,-62,-91,29,40:e3:d6:da:ba:22,160036518,180,207,160036338,160036518
21978,6,12,1,2412,-62,-91,29,40:e3:d6:da:ba:23,160036732,184,30,160036548,160036732
21979,6,12,1,2412,-62,-91,29,40:e3:d6:da:ba:24,160036969,176,61,160036793,160036969
21980,6,12,1,2412,-62,-91,29,40:e3:d6:da:ba:25,160037170,160,41,160037010,160037170
21981,6,12,1,2412,-61,-91,30,40:e3:d6:da:ba:20,160138573,160,101243,160138413,160138573
21982,6,12,1,2412,-61,-91,30,40:e3:d6:da:ba:25,160142681,160,3948,160142521,160142681
21983,6,6,1,2412,-79,-91,12,e6:aa:ea:c9:ea:33,160171553,408,28464,160171145,160171553
21984,6,6,1,2412,-80,-91,11,e6:aa:ea:b7:4a:dd,160182327,408,10366,160181919,160182327
21985,6,6,1,2412,-74,-91,17,e6:aa:ea:c9:ea:33,160183678,408,943,160183270,160183678
21986,6,6,1,2412,-80,-91,11,e6:aa:ea:b7:4a:dd,160194442,408,10356,160194034,160194442
21987,6,6,1,2412,-82,-91,9,e6:aa:ea:b7:4a:dd,160206560,408,11710,160206152,160206560
21988,6,6,1,2412,-74,-91,17,e6:aa:ea:c9:ea:33,160208496,408,1528,160208088,160208496
21989,6,6,1,2412,-81,-91,10,e6:aa:ea:b7:4a:dd,160218679,408,9775,160218271,160218679
21990,4,1,1,2412,-81,-91,10,b8:3a:5a:88:e6:e0,160224401,2360,3362,160222041,160224401
21991,6,12,1,2412,-60,-91,31,40:e3:d6:da:ba:20,160240744,160,16183,160240584,160240744
21992,6,6,1,2412,-60,-91,31,40:e3:d6:da:ba:21,160240954,368,-158,160240586,160240954
21993,6,12,1,2412,-60,-91,31,40:e3:d6:da:ba:22,160241359,180,225,160241179,160241359
21994,6,12,1,2412,-61,-91,30,40:e3:d6:da:ba:23,160241564,184,21,160241380,160241564
21995,6,12,1,2412,-60,-91,31,40:e3:d6:da:ba:24,160241791,176,51,160241615,160241791
21996,6,12,1,2412,-60,-91,31,40:e3:d6:da:ba:25,160242011,160,60,160241851,160242011
21997,4,1,1,2412,-76,-91,15,54:e4:3a:ec:fb:64,160299702,2160,55531,160297542,160299702
21998,6,12,1,2412,-61,-91,30,40:e3:d6:da:ba:20,160343143,160,43281,160342983,160343143
21999,6,6,1,2412,-61,-91,30,40:e3:d6:da:ba:21,160343353,368,-158,160342985,160343353
22000,6,12,1,2412,-61,-91,30,40:e3:d6:da:ba:22,160343766,180,233,160343586,160343766
22001,6,12,1,2412,-61,-91,30,40:e3:d6:da:ba:23,160343972,184,22,160343788,160343972
22002,6,12,1,2412,-61,-91,30,40:e3:d6:da:ba:24,160344181,176,33,160344005,160344181
22003,6,12,1,2412,-61,-91,30,40:e3:d6:da:ba:25,160344410,160,69,160344250,160344410
22004,6,6,1,2412,-61,-91,30,40:e3:d6:da:ba:26,160344602,380,-188,160344222,160344602
22005,6,12,1,2412,-61,-91,30,40:e3:d6:da:ba:20,160445532,160,100770,160445372,160445532
22006,6,6,1,2412,-61,-91,30,40:e3:d6:da:ba:21,160445733,368,-167,160445365,160445733
22007,6,12,1,2412,-61,-91,30,40:e3:d6:da:ba:22,160446147,180,234,160445967,160446147
22008,4,1,1,2412,-84,-91,7,54:e4:3a:ec:fb:64,160502694,2160,54387,160500534,160502694
22009,6,12,1,2412,-84,-91,7,40:e3:d6:da:bb:60,160509745,960,6091,160508785,160509745
22010,4,1,1,2412,-88,-91,3,b8:3a:5a:88:e6:e1,160534753,2376,22632,160532377,160534753
22011,6,12,1,2412,-61,-91,30,40:e3:d6:da:ba:20,160547935,160,13022,160547775,160547935
22012,6,6,1,2412,-61,-91,30,40:e3:d6:da:ba:21,160548145,368,-158,160547777,160548145
22013,6,12,1,2412,-61,-91,30,40:e3:d6:da:ba:22,160548559,180,234,160548379,160548559
22014,6,12,1,2412,-61,-91,30,40:e3:d6:da:ba:23,160548773,184,30,160548589,160548773
22015,6,12,1,2412,-61,-91,30,40:e3:d6:da:ba:24,160548992,176,43,160548816,160548992
22016,6,12,1,2412,-61,-91,30,40:e3:d6:da:ba:25,160549220,160,68,160549060,160549220
22017,6,6,1,2412,-61,-91,30,40:e3:d6:da:ba:26,160549439,380,-161,160549059,160549439
22018,6,6,1,2412,-77,-91,14,e6:aa:ea:c9:ea:33,160600420,408,50573,160600012,160600420
22019,4,1,1,2412,-84,-91,7,54:e4:3a:ec:fb:64,160605094,2160,2514,160602934,160605094
22020,6,6,1,2412,-76,-91,15,e6:aa:ea:c9:ea:33,160624654,408,19152,160624246,160624654
22021,4,1,1,2412,-86,-91,5,b8:3a:5a:88:e6:e0,160633992,2360,6978,160631632,160633992
22022,6,12,1,2412,-68,-91,23,40:e3:d6:da:ba:20,160650350,160,16198,160650190,160650350
22023,6,6,1,2412,-68,-91,23,40:e3:d6:da:ba:21,160650542,368,-176,160650174,160650542
22024,6,12,1,2412,-68,-91,23,40:e3:d6:da:ba:22,160650938,180,216,160650758,160650938
22025,6,12,1,2412,-68,-91,23,40:e3:d6:da:ba:23,160651152,184,30,160650968,160651152
22026,6,12,1,2412,-67,-91,24,40:e3:d6:da:ba:24,160651361,176,33,160651185,160651361
22027,6,12,1,2412,-67,-91,24,40:e3:d6:da:ba:25,160651563,160,42,160651403,160651563
22028,6,6,1,2412,-67,-91,24,40:e3:d6:da:ba:26,160651781,380,-162,160651401,160651781
22029,6,6,1,2412,-79,-91,12,e6:aa:ea:b7:4a:dd,160690592,408,38403,160690184,160690592
22030,6,6,1,2412,-79,-91,12,e6:aa:ea:b7:4a:dd,160714699,408,23699,160714291,160714699
22031,6,6,1,2412,-66,-91,25,40:e3:d6:da:ba:21,160752924,368,37857,160752556,160752924
22032,6,12,1,2412,-66,-91,25,40:e3:d6:da:ba:25,160753991,160,907,160753831,160753991
22033,6,6,1,2412,-65,-91,26,40:e3:d6:da:ba:26,160754192,380,-179,160753812,160754192
22034,4,1,1,2412,-85,-91,6,54:e4:3a:ec:fb:64,160809891,2160,53539,160807731,160809891
22035,4,1,1,2412,-85,-91,6,b8:3a:5a:88:e6:e0,160839022,2360,26771,160836662,160839022
22036,4,1,1,2412,-83,-91,8,b8:3a:5a:88:e6:e1,160841437,2376,39,160839061,160841437
22037,6,12,1,2412,-65,-91,26,40:e3:d6:da:ba:20,160855133,160,13536,160854973,160855133
22038,6,6,1,2412,-65,-91,26,40:e3:d6:da:ba:21,160855343,368,-158,160854975,160855343
22039,6,12,1,2412,-65,-91,26,40:e3:d6:da:ba:22,160855730,180,207,160855550,160855730
22040,6,12,1,2412,-65,-91,26,40:e3:d6:da:ba:23,160855945,184,31,160855761,160855945
22041,6,12,1,2412,-65,-91,26,40:e3:d6:da:ba:24,160856172,176,51,160855996,160856172
22042,6,12,1,2412,-65,-91,26,40:e3:d6:da:ba:25,160856392,160,60,160856232,160856392
22043,6,6,1,2412,-65,-91,26,40:e3:d6:da:ba:26,160856610,380,-162,160856230,160856610
22044,6,6,1,2412,-80,-91,11,e6:aa:ea:c9:ea:33,160903413,408,46395,160903005,160903413
22045,6,6,1,2412,-80,-91,11,e6:aa:ea:c9:ea:33,160915531,408,11710,160915123,160915531
22046,6,6,1,2412,-79,-91,12,e6:aa:ea:c9:ea:33,160927640,408,11701,160927232,160927640
22047,4,1,1,2412,-73,-91,18,b8:3a:5a:88:e6:e0,160941189,2360,11189,160938829,160941189
22048,6,6,1,2412,-80,-91,11,e6:aa:ea:c9:ea:33,160952041,408,10444,160951633,160952041
22049,6,12,1,2412,-67,-91,24,40:e3:d6:da:ba:20,160957538,160,5337,160957378,160957538
22050,6,6,1,2412,-67,-91,24,40:e3:d6:da:ba:21,160957748,368,-158,160957380,160957748
22051,6,12,1,2412,-67,-91,24,40:e3:d6:da:ba:22,160958162,180,234,160957982,160958162
22052,6,12,1,2412,-67,-91,24,40:e3:d6:da:ba:23,160958367,184,21,160958183,160958367
22053,6,12,1,2412,-67,-91,24,40:e3:d6:da:ba:24,160958604,176,61,160958428,160958604
22054,6,12,1,2412,-67,-91,24,40:e3:d6:da:ba:25,160958805,160,41,160958645,160958805
22055,6,6,1,2412,-67,-91,24,40:e3:d6:da:ba:26,160958997,380,-188,160958617,160958997
22056,6,6,1,2412,-82,-91,9,e6:aa:ea:b7:4a:dd,161017766,408,58361,161017358,161017766
22057,4,1,1,2412,-84,-91,7,b8:3a:5a:88:e6:e1,161046115,2376,25973,161043739,161046115
22058,6,6,1,2412,-83,-91,8,e6:aa:ea:b7:4a:dd,161054114,408,7591,161053706,161054114
22059,6,12,1,2412,-68,-91,23,40:e3:d6:da:ba:20,161059941,160,5667,161059781,161059941
22060,6,6,1,2412,-68,-91,23,40:e3:d6:da:ba:21,161060160,368,-149,161059792,161060160
22061,6,12,1,2412,-68,-91,23,40:e3:d6:da:ba:22,161060565,180,225,161060385,161060565
22062,6,12,1,2412,-68,-91,23,40:e3:d6:da:ba:23,161060789,184,40,161060605,161060789
22063,6,12,1,2412,-68,-91,23,40:e3:d6:da:ba:24,161060998,176,33,161060822,161060998
22064,6,12,1,2412,-68,-91,23,40:e3:d6:da:ba:25,161061209,160,51,161061049,161061209
22065,6,6,1,2412,-68,-91,23,40:e3:d6:da:ba:26,161061400,380,-189,161061020,161061400
22066,4,1,1,2412,-87,-91,4,54:e4:3a:ec:fb:64,161117089,2160,53529,161114929,161117089
22067,6,12,1,2412,-71,-91,20,40:e3:d6:da:ba:20,161162350,160,45101,161162190,161162350
22068,6,6,1,2412,-70,-91,21,40:e3:d6:da:ba:21,161162560,368,-158,161162192,161162560
22069,6,12,1,2412,-70,-91,21,40:e3:d6:da:ba:22,161162956,180,216,161162776,161162956
22070,6,12,1,2412,-70,-91,21,40:e3:d6:da:ba:23,161163179,184,39,161162995,161163179
22071,6,12,1,2412,-70,-91,21,40:e3:d6:da:ba:24,161163397,176,42,161163221,161163397
22072,6,12,1,2412,-70,-91,21,40:e3:d6:da:ba:25,161163599,160,42,161163439,161163599
22073,6,6,1,2412,-76,-91,15,e6:aa:ea:c9:ea:33,161218472,408,54465,161218064,161218472
22074,4,1,1,2412,-91,-91,0,54:e4:3a:ec:fb:64,161219488,2160,-1144,161217328,161219488
22075,6,6,1,2412,-78,-91,13,e6:aa:ea:c9:ea:33,161230429,408,10533,161230021,161230429
22076,6,6,1,2412,-77,-91,14,e6:aa:ea:c9:ea:33,161242536,408,11699,161242128,161242536
22077,4,1,1,2412,-85,-91,6,b8:3a:5a:88:e6:e0,161248381,2360,3485,161246021,161248381
22078,4,1,1,2412,-88,-91,3,b8:3a:5a:88:e6:e1,161250761,2376,4,161248385,161250761
22079,6,6,1,2412,-78,-91,13,e6:aa:ea:c9:ea:33,161254649,408,3480,161254241,161254649
22080,6,12,1,2412,-72,-91,19,40:e3:d6:da:ba:20,161264757,160,9948,161264597,161264757
22081,6,6,1,2412,-72,-91,19,40:e3:d6:da:ba:21,161265080,368,-45,161264712,161265080
22082,6,12,1,2412,-72,-91,19,40:e3:d6:da:ba:22,161265494,180,234,161265314,161265494
22083,6,12,1,2412,-72,-91,19,40:e3:d6:da:ba:23,161265699,184,21,161265515,161265699
22084,6,12,1,2412,-73,-91,18,40:e3:d6:da:ba:24,161265909,176,34,161265733,161265909
22085,6,12,1,2412,-72,-91,19,40:e3:d6:da:ba:25,161266110,160,41,161265950,161266110
22086,6,6,1,2412,-77,-91,14,e6:aa:ea:c9:ea:33,161266771,408,253,161266363,161266771
22087,4,1,1,2412,-87,-91,4,54:e4:3a:ec:fb:64,161322143,2160,53212,161319983,161322143
22088,6,12,1,2412,-70,-91,21,40:e3:d6:da:ba:20,161367136,160,44833,161366976,161367136
22089,6,6,1,2412,-70,-91,21,40:e3:d6:da:ba:21,161367355,368,-149,161366987,161367355
22090,6,12,1,2412,-70,-91,21,40:e3:d6:da:ba:22,161367742,180,207,161367562,161367742
22091,6,12,1,2412,-70,-91,21,40:e3:d6:da:ba:23,161367966,184,40,161367782,161367966
22092,6,12,1,2412,-70,-91,21,40:e3:d6:da:ba:24,161368193,176,51,161368017,161368193
22093,6,12,1,2412,-70,-91,21,40:e3:d6:da:ba:25,161368421,160,68,161368261,161368421
22094,6,6,1,2412,-70,-91,21,40:e3:d6:da:ba:26,161368640,380,-161,161368260,161368640
22095,6,6,1,2412,-81,-91,10,e6:aa:ea:b7:4a:dd,161437036,408,67988,161436628,161437036
22096,6,6,1,2412,-81,-91,10,e6:aa:ea:b7:4a:dd,161449005,408,11561,161448597,161449005
22097,4,1,1,2412,-84,-91,7,b8:3a:5a:88:e6:e0,161453200,2360,1835,161450840,161453200
22098,6,6,1,2412,-81,-91,10,e6:aa:ea:b7:4a:dd,161461119,408,7511,161460711,161461119
22099,6,6,1,2412,-69,-91,22,40:e3:d6:da:ba:21,161469756,368,8269,161469388,161469756
22100,6,12,1,2412,-69,-91,22,40:e3:d6:da:ba:22,161470152,180,216,161469972,161470152
22101,6,12,1,2412,-69,-91,22,40:e3:d6:da:ba:23,161470357,184,21,161470173,161470357
22102,6,12,1,2412,-69,-91,22,40:e3:d6:da:ba:24,161470594,176,61,161470418,161470594
22103,6,12,1,2412,-69,-91,22,40:e3:d6:da:ba:25,161470822,160,68,161470662,161470822
22104,6,6,1,2412,-68,-91,23,40:e3:d6:da:ba:26,161471014,380,-188,161470634,161471014
22105,4,1,1,2412,-87,-91,4,54:e4:3a:ec:fb:64,161527157,2160,53983,161524997,161527157
22106,6,6,1,2412,-78,-91,13,e6:aa:ea:c9:ea:33,161546190,408,18625,161545782,161546190
22107,4,1,1,2412,-55,-91,36,b8:3a:5a:88:e6:e0,161558378,2360,9828,161556018,161558378
22108,4,1,1,2412,-85,-91,6,b8:3a:5a:88:e6:e1,161560767,2376,13,161558391,161560767
22109,6,6,1,2412,-78,-91,13,e6:aa:ea:c9:ea:33,161570288,408,9113,161569880,161570288
22110,6,12,1,2412,-66,-91,25,40:e3:d6:da:ba:20,161571938,160,1490,161571778,161571938
22111,6,6,1,2412,-66,-91,25,40:e3:d6:da:ba:21,161572148,368,-158,161571780,161572148
22112,6,12,1,2412,-65,-91,26,40:e3:d6:da:ba:24,161572968,176,644,161572792,161572968
22113,6,12,1,2412,-65,-91,26,40:e3:d6:da:ba:25,161573178,160,50,161573018,161573178
22114,4,1,1,2412,-89,-91,2,b8:3a:5a:88:e6:e1,161662335,2376,86781,161659959,161662335
22115,6,12,1,2412,-64,-91,27,40:e3:d6:da:ba:20,161674347,160,11852,161674187,161674347
22116,6,6,1,2412,-64,-91,27,40:e3:d6:da:ba:21,161674557,368,-158,161674189,161674557
22117,6,12,1,2412,-64,-91,27,40:e3:d6:da:ba:22,161674953,180,216,161674773,161674953
22118,4,1,1,2412,-87,-91,4,b8:3a:5a:88:e6:e0,161760393,2360,83080,161758033,161760393
22119,4,1,1,2412,-89,-91,2,b8:3a:5a:88:e6:e1,161762772,2376,3,161760396,161762772
22120,6,12,1,2412,-64,-91,27,40:e3:d6:da:ba:20,161776739,160,13807,161776579,161776739
22121,6,6,1,2412,-64,-91,27,40:e3:d6:da:ba:21,161776940,368,-167,161776572,161776940
22122,6,12,1,2412,-64,-91,27,40:e3:d6:da:ba:22,161777336,180,216,161777156,161777336
22123,6,12,1,2412,-64,-91,27,40:e3:d6:da:ba:23,161777541,184,21,161777357,161777541
22124,6,12,1,2412,-64,-91,27,40:e3:d6:da:ba:24,161777751,176,34,161777575,161777751
22125,6,12,1,2412,-64,-91,27,40:e3:d6:da:ba:25,161777970,160,59,161777810,161777970
22126,6,12,1,2412,-83,-91,8,40:e3:d6:da:c6:e0,161861469,960,82539,161860509,161861469
22127,6,12,1,2412,-65,-91,26,40:e3:d6:da:ba:20,161879160,160,17531,161879000,161879160
22128,6,6,1,2412,-65,-91,26,40:e3:d6:da:ba:21,161879370,368,-158,161879002,161879370
22129,6,12,1,2412,-65,-91,26,40:e3:d6:da:ba:22,161879784,180,234,161879604,161879784
22130,6,12,1,2412,-65,-91,26,40:e3:d6:da:ba:23,161879990,184,22,161879806,161879990
22131,6,12,1,2412,-65,-91,26,40:e3:d6:da:ba:24,161880208,176,42,161880032,161880208
22132,6,12,1,2412,-65,-91,26,40:e3:d6:da:ba:25,161880419,160,51,161880259,161880419
22133,6,6,1,2412,-65,-91,26,40:e3:d6:da:ba:26,161880638,380,-161,161880258,161880638
22134,6,6,1,2412,-77,-91,14,e6:aa:ea:c9:ea:33,161951938,408,70892,161951530,161951938
22135,6,6,1,2412,-77,-91,14,e6:aa:ea:c9:ea:33,161964062,408,11716,161963654,161964062
22136,4,1,1,2412,-88,-91,3,b8:3a:5a:88:e6:e0,161965198,2360,-1224,161962838,161965198
22137,6,12,1,2412,-68,-91,23,40:e3:d6:da:ba:20,161981618,160,16260,161981458,161981618
22138,6,6,1,2412,-68,-91,23,40:e3:d6:da:ba:21,161981810,368,-176,161981442,161981810
22139,6,12,1,2412,-68,-91,23,40:e3:d6:da:ba:22,161982206,180,216,161982026,161982206
22140,6,6,1,2412,-87,-91,4,e6:aa:ea:b7:4a:dd,161982400,408,-214,161981992,161982400
22141,6,12,1,2412,-68,-91,23,40:e3:d6:da:ba:23,161982824,184,240,161982640,161982824
22142,6,12,1,2412,-67,-91,24,40:e3:d6:da:ba:24,161983042,176,42,161982866,161983042
22143,6,12,1,2412,-68,-91,23,40:e3:d6:da:ba:25,161983252,160,50,161983092,161983252
22144,6,6,1,2412,-68,-91,23,40:e3:d6:da:ba:26,161983462,380,-170,161983082,161983462
22145,6,6,1,2412,-77,-91,14,e6:aa:ea:c9:ea:33,161988301,408,4431,161987893,161988301
22146,6,6,1,2412,-76,-91,15,e6:aa:ea:c9:ea:33,162000408,408,11699,162000000,162000408
22147,4,1,1,2412,-86,-91,5,b8:3a:5a:88:e6:e0,162010324,2240,7676,162008084,162010324
22148,4,1,1,2412,-89,-91,2,54:e4:3a:ec:fb:64,162038682,2160,26198,162036522,162038682
22149,6,6,1,2412,-90,-91,1,40:e3:d6:da:c0:21,162055596,368,16546,162055228,162055596
22150,6,12,1,2412,-69,-91,22,40:e3:d6:da:ba:20,162083959,160,28203,162083799,162083959
22151,6,6,1,2412,-69,-91,22,40:e3:d6:da:ba:21,162084151,368,-176,162083783,162084151
22152,6,12,1,2412,-68,-91,23,40:e3:d6:da:ba:23,162084770,184,435,162084586,162084770
22153,6,12,1,2412,-68,-91,23,40:e3:d6:da:ba:24,162084979,176,33,162084803,162084979
22154,6,12,1,2412,-68,-91,23,40:e3:d6:da:ba:25,162085199,160,60,162085039,162085199
22155,6,6,1,2412,-68,-91,23,40:e3:d6:da:ba:26,162085391,380,-188,162085011,162085391
22156,4,1,1,2412,-61,-91,30,54:e4:3a:ec:fb:64,162141080,2160,53529,162138920,162141080
22157,6,6,1,2412,-89,-91,2,40:e3:d6:da:c0:21,162260367,368,118919,162259999,162260367
22158,4,1,1,2412,-78,-91,13,b8:3a:5a:88:e6:e0,162272410,2360,9683,162270050,162272410
22159,4,1,1,2412,-84,-91,7,b8:3a:5a:88:e6:e1,162274817,2376,31,162272441,162274817
22160,6,12,1,2412,-69,-91,22,40:e3:d6:da:ba:25,162290055,160,15078,162289895,162290055
22161,6,6,1,2412,-71,-91,20,40:e3:d6:da:ba:26,162290264,380,-171,162289884,162290264
22162,4,1,1,2412,-88,-91,3,54:e4:3a:ec:fb:64,162345879,2160,53455,162343719,162345879
22163,6,6,1,2412,-89,-91,2,40:e3:d6:da:c0:21,162362794,368,16547,162362426,162362794
22164,6,6,1,2412,-82,-91,9,e6:aa:ea:b7:4a:dd,162365519,408,2317,162365111,162365519
22165,4,1,1,2412,-86,-91,5,b8:3a:5a:88:e6:e0,162374787,2360,6908,162372427,162374787
22166,4,1,1,2412,-86,-91,5,b8:3a:5a:88:e6:e1,162377167,2376,4,162374791,162377167
22167,6,6,1,2412,-82,-91,9,e6:aa:ea:b7:4a:dd,162389656,408,12081,162389248,162389656
22168,6,12,1,2412,-69,-91,22,40:e3:d6:da:ba:20,162391141,160,1325,162390981,162391141
22169,6,12,1,2412,-68,-91,23,40:e3:d6:da:ba:22,162391738,180,417,162391558,162391738
22170,6,12,1,2412,-68,-91,23,40:e3:d6:da:ba:23,162391953,184,31,162391769,162391953
22171,6,12,1,2412,-68,-91,23,40:e3:d6:da:ba:25,162392425,160,312,162392265,162392425
22172,4,1,1,2412,-87,-91,4,54:e4:3a:ec:fb:64,162448277,2160,53692,162446117,162448277
22173,6,6,1,2412,-78,-91,13,e6:aa:ea:c9:ea:33,162484208,408,35523,162483800,162484208
22174,6,12,1,2412,-67,-91,24,40:e3:d6:da:ba:20,162493546,160,9178,162493386,162493546
22175,6,6,1,2412,-67,-91,24,40:e3:d6:da:ba:21,162493747,368,-167,162493379,162493747
22176,6,12,1,2412,-67,-91,24,40:e3:d6:da:ba:22,162494143,180,216,162493963,162494143
22177,6,12,1,2412,-67,-91,24,40:e3:d6:da:ba:23,162494366,184,39,162494182,162494366
22178,6,12,1,2412,-67,-91,24,40:e3:d6:da:ba:24,162494576,176,34,162494400,162494576
22179,6,12,1,2412,-67,-91,24,40:e3:d6:da:ba:25,162494804,160,68,162494644,162494804
22180,6,6,1,2412,-67,-91,24,40:e3:d6:da:ba:26,162494996,380,-188,162494616,162494996
22181,6,6,1,2412,-79,-91,12,e6:aa:ea:c9:ea:33,162496355,408,951,162495947,162496355
22182,6,6,1,2412,-79,-91,12,e6:aa:ea:c9:ea:33,162520794,408,24031,162520386,162520794
22183,4,1,1,2412,-88,-91,3,54:e4:3a:ec:fb:64,162550680,2160,27726,162548520,162550680
22184,6,12,1,2412,-65,-91,26,40:e3:d6:da:ba:20,162595958,160,45118,162595798,162595958
22185,6,6,1,2412,-65,-91,26,40:e3:d6:da:ba:21,162596177,368,-149,162595809,162596177
22186,6,12,1,2412,-65,-91,26,40:e3:d6:da:ba:22,162596582,180,225,162596402,162596582
22187,6,12,1,2412,-64,-91,27,40:e3:d6:da:ba:23,162596805,184,39,162596621,162596805
22188,6,12,1,2412,-65,-91,26,40:e3:d6:da:ba:24,162597033,176,52,162596857,162597033
22189,6,12,1,2412,-65,-91,26,40:e3:d6:da:ba:25,162597234,160,41,162597074,162597234
22190,6,6,1,2412,-65,-91,26,40:e3:d6:da:ba:26,162597453,380,-161,162597073,162597453
22191,4,1,1,2412,-86,-91,5,54:e4:3a:ec:fb:64,162653077,2160,53464,162650917,162653077
22192,4,1,1,2412,-86,-91,5,b8:3a:5a:88:e6:e0,162682330,2360,26893,162679970,162682330
22193,4,1,1,2412,-86,-91,5,b8:3a:5a:88:e6:e1,162684710,2376,4,162682334,162684710
22194,4,1,1,2412,-87,-91,4,54:e4:3a:ec:fb:64,162755475,2160,68605,162753315,162755475
22195,6,6,1,2412,-81,-91,10,e6:aa:ea:b7:4a:dd,162794656,408,38773,162794248,162794656
22196,6,12,1,2412,-64,-91,27,40:e3:d6:da:ba:20,162800748,160,5932,162800588,162800748
22197,6,6,1,2412,-64,-91,27,40:e3:d6:da:ba:21,162800958,368,-158,162800590,162800958
22198,6,12,1,2412,-64,-91,27,40:e3:d6:da:ba:24,162801805,176,671,162801629,162801805
22199,6,12,1,2412,-64,-91,27,40:e3:d6:da:ba:25,162802015,160,50,162801855,162802015
22200,6,6,1,2412,-81,-91,10,e6:aa:ea:b7:4a:dd,162806700,408,4277,162806292,162806700
22201,6,6,1,2412,-81,-91,10,e6:aa:ea:b7:4a:dd,162818813,408,11705,162818405,162818813
22202,6,6,1,2412,-80,-91,11,e6:aa:ea:b7:4a:dd,162830929,408,11708,162830521,162830929
