,phy,data_rate,channel,frequency,signal_dbm,noise_dbm,snr,tx_addr,timestamp,duration,ifs,start_tsf,end_tsf
0,5,12,149,5745,-78,-96,18,f6:0a:5c:59:72:df,202799000,252,,202798748,202799000
1,5,12,149,5745,-47,-96,49,5e:29:73:5b:30:00,202804018,272,4746,202803746,202804018
2,5,12,149,5745,-66,-96,30,3e:d1:9b:c7:a4:de,202819411,272,15121,202819139,202819411
3,5,6,149,5745,-90,-96,6,54:e4:3a:ec:fb:65,202837999,360,18228,202837639,202837999
4,5,12,149,5745,-50,-96,46,f2:da:61:dd:98:c5,202851181,268,12914,202850913,202851181
5,5,12,149,5745,-74,-96,22,22:ec:75:a8:8a:31,202853078,244,1653,202852834,202853078
6,5,12,149,5745,-80,-96,16,fa:44:8d:e1:c7:1b,202862595,244,9273,202862351,202862595
7,5,12,149,5745,-83,-96,13,72:d1:72:1d:22:a1,202862911,256,60,202862655,202862911
8,5,12,149,5745,-80,-96,16,56:68:e2:c2:8d:d5,202863921,280,730,202863641,202863921
9,5,12,149,5745,-86,-96,10,d2:00:04:7e:2c:ab,202878129,244,13964,202877885,202878129
10,5,12,149,5745,-77,-96,19,c2:21:7d:48:b5:63,202894359,240,15990,202894119,202894359
11,5,12,149,5745,-79,-96,17,f6:0a:5c:59:72:df,202897922,252,3311,202897670,202897922
12,5,24,149,5745,-80,-96,16,,202913404,28,15454,202913376,202913404
13,5,24,149,5745,-80,-96,16,,202913809,28,377,202913781,202913809
14,5,12,149,5745,-84,-96,12,72:d1:72:1d:22:a1,202916548,256,2483,202916292,202916548
15,5,12,149,5745,-83,-96,13,72:d1:72:1d:22:a1,202922965,452,5965,202922513,202922965
16,5,12,149,5745,-80,-96,16,56:68:e2:c2:8d:d5,202923496,476,55,202923020,202923496
17,5,12,149,5745,-86,-96,10,d2:00:04:7e:2c:ab,202926699,440,2763,202926259,202926699
18,5,12,149,5745,-47,-96,49,5e:29:73:5b:30:00,202927253,540,14,202926713,202927253
19,5,12,149,5745,-80,-96,16,fa:44:8d:e1:c7:1b,202932104,244,4607,202931860,202932104
20,5,12,149,5745,-46,-96,50,5e:29:73:5b:30:00,202932859,272,483,202932587,202932859
21,5,12,149,5745,-85,-96,11,d2:00:04:7e:2c:ab,202934785,380,1546,202934405,202934785
22,5,12,149,5745,-79,-96,17,fa:44:8d:e1:c7:1b,202937217,440,1992,202936777,202937217
23,5,12,149,5745,-74,-96,22,22:ec:75:a8:8a:31,202938636,516,903,202938120,202938636
24,5,6,149,5745,-92,-96,4,54:e4:3a:ec:fb:65,202940399,360,1403,202940039,202940399
25,5,12,149,5745,-66,-96,30,3e:d1:9b:c7:a4:de,202940814,544,-129,202940270,202940814
26,5,12,149,5745,-50,-96,46,f2:da:61:dd:98:c5,202942542,268,1460,202942274,202942542
27,5,12,149,5745,-80,-96,16,56:68:e2:c2:8d:d5,202947326,280,4504,202947046,202947326
28,5,12,149,5745,-65,-96,31,3e:d1:9b:c7:a4:de,202949305,272,1707,202949033,202949305
29,5,12,149,5745,-77,-96,19,c2:21:7d:48:b5:63,202951278,240,1733,202951038,202951278
30,5,12,149,5745,-74,-96,22,22:ec:75:a8:8a:31,202965558,244,14036,202965314,202965558
31,5,12,149,5745,-50,-96,46,f2:da:61:dd:98:c5,202967682,268,1856,202967414,202967682
32,5,24,149,5745,-82,-96,14,,202977028,28,9318,202977000,202977028
33,5,24,149,5745,-81,-96,15,,202980938,28,3882,202980910,202980938
34,5,12,149,5745,-85,-96,11,d2:00:04:7e:2c:ab,202981126,244,-56,202980882,202981126
35,5,12,149,5745,-78,-96,18,c2:21:7d:48:b5:63,202982710,240,1344,202982470,202982710
36,5,12,149,5745,-80,-96,16,f6:0a:5c:59:72:df,202991462,448,8304,202991014,202991462
37,5,12,149,5745,-85,-96,11,d2:00:04:7e:2c:ab,202992252,440,350,202991812,202992252
38,5,12,149,5745,-78,-96,18,c2:21:7d:48:b5:63,202996561,240,4069,202996321,202996561
39,5,12,149,5745,-80,-96,16,f6:0a:5c:59:72:df,203009986,252,13173,203009734,203009986
40,5,24,149,5745,-80,-96,16,,203033434,28,23420,203033406,203033434
41,5,12,149,5745,-83,-96,13,72:d1:72:1d:22:a1,203038956,256,5266,203038700,203038956
42,5,6,149,5745,-90,-96,6,54:e4:3a:ec:fb:65,203042800,360,3484,203042440,203042800
43,5,12,149,5745,-80,-96,16,fa:44:8d:e1:c7:1b,203046748,244,3704,203046504,203046748
44,5,12,149,5745,-46,-96,50,5e:29:73:5b:30:00,203047449,272,429,203047177,203047449
45,5,12,149,5745,-78,-96,18,c2:21:7d:48:b5:63,203048396,240,707,203048156,203048396
46,5,12,149,5745,-75,-96,21,0a:b9:b7:b1:4d:fa,203055760,268,7096,203055492,203055760
47,5,12,149,5745,-46,-96,50,5e:29:73:5b:30:00,203057448,540,1148,203056908,203057448
48,5,12,149,5745,-85,-96,11,d2:00:04:7e:2c:ab,203058138,440,250,203057698,203058138
49,5,12,149,5745,-80,-96,16,56:68:e2:c2:8d:d5,203061781,280,3363,203061501,203061781
50,5,12,149,5745,-65,-96,31,3e:d1:9b:c7:a4:de,203064030,272,1977,203063758,203064030
51,5,12,149,5745,-49,-96,47,f2:da:61:dd:98:c5,203065543,268,1245,203065275,203065543
52,5,12,149,5745,-74,-96,22,a6:92:ad:b7:76:65,203065882,456,-117,203065426,203065882
53,5,12,149,5745,-79,-96,17,fa:44:8d:e1:c7:1b,203068875,440,2553,203068435,203068875
54,5,12,149,5745,-74,-96,22,22:ec:75:a8:8a:31,203070593,516,1202,203070077,203070593
55,5,12,149,5745,-65,-96,31,3e:d1:9b:c7:a4:de,203072073,544,936,203071529,203072073
56,5,12,149,5745,-49,-96,47,f2:da:61:dd:98:c5,203073229,268,888,203072961,203073229
57,5,12,149,5745,-85,-96,11,d2:00:04:7e:2c:ab,203079444,244,5971,203079200,203079444
58,5,12,149,5745,-75,-96,21,22:ec:75:a8:8a:31,203095740,244,16052,203095496,203095740
59,5,12,149,5745,-80,-96,16,f6:0a:5c:59:72:df,203121536,252,25544,203121284,203121536
60,5,12,149,5745,-80,-96,16,f6:0a:5c:59:72:df,203122243,448,259,203121795,203122243
61,5,12,149,5745,-78,-96,18,c2:21:7d:48:b5:63,203122762,240,279,203122522,203122762
62,5,12,149,5745,-85,-96,11,d2:00:04:7e:2c:ab,203123389,440,187,203122949,203123389
63,5,6,149,5745,-90,-96,6,54:e4:3a:ec:fb:65,203145200,360,21451,203144840,203145200
64,5,12,149,5745,-46,-96,50,5e:29:73:5b:30:00,203148107,272,2635,203147835,203148107
65,5,12,149,5745,-65,-96,31,3e:d1:9b:c7:a4:de,203156590,272,8211,203156318,203156590
66,5,12,149,5745,-78,-96,18,fa:44:8d:e1:c7:1b,203159475,244,2641,203159231,203159475
67,5,12,149,5745,-82,-96,14,72:d1:72:1d:22:a1,203170186,256,10455,203169930,203170186
68,5,12,149,5745,-80,-96,16,56:68:e2:c2:8d:d5,203174542,280,4076,203174262,203174542
69,5,12,149,5745,-75,-96,21,22:ec:75:a8:8a:31,203194843,244,20057,203194599,203194843
70,5,12,149,5745,-86,-96,10,d2:00:04:7e:2c:ab,203207466,244,12379,203207222,203207466
71,5,12,149,5745,-78,-96,18,f6:0a:5c:59:72:df,203245988,252,38270,203245736,203245988
72,5,6,149,5745,-91,-96,5,54:e4:3a:ec:fb:65,203247601,360,1253,203247241,203247601
73,5,12,149,5745,-49,-96,47,f2:da:61:dd:98:c5,203248168,268,299,203247900,203248168
74,5,12,149,5745,-46,-96,50,5e:29:73:5b:30:00,203265154,272,16714,203264882,203265154
75,5,12,149,5745,-78,-96,18,c2:21:7d:48:b5:63,203272356,240,6962,203272116,203272356
76,5,12,149,5745,-82,-96,14,72:d1:72:1d:22:a1,203272820,256,208,203272564,203272820
77,5,12,149,5745,-78,-96,18,fa:44:8d:e1:c7:1b,203273209,244,145,203272965,203273209
78,5,12,149,5745,-64,-96,32,3e:d1:9b:c7:a4:de,203273489,272,8,203273217,203273489
79,5,12,149,5745,-81,-96,15,56:68:e2:c2:8d:d5,203285222,280,11453,203284942,203285222
80,5,12,149,5745,-75,-96,21,22:ec:75:a8:8a:31,203309855,244,24389,203309611,203309855
81,5,12,149,5745,-49,-96,47,f2:da:61:dd:98:c5,203350425,268,40302,203350157,203350425
82,5,12,149,5745,-80,-96,16,c2:21:7d:48:b5:63,203374414,240,23749,203374174,203374414
83,5,12,149,5745,-83,-96,13,72:d1:72:1d:22:a1,203375074,256,404,203374818,203375074
84,5,12,149,5745,-85,-96,11,d2:00:04:7e:2c:ab,203376173,244,855,203375929,203376173
85,5,12,149,5745,-47,-96,49,5e:29:73:5b:30:00,203382159,272,5714,203381887,203382159
86,5,12,149,5745,-79,-96,17,fa:44:8d:e1:c7:1b,203385960,244,3557,203385716,203385960
87,5,12,149,5745,-64,-96,32,3e:d1:9b:c7:a4:de,203390506,272,4274,203390234,203390506
88,5,12,149,5745,-76,-96,20,22:ec:75:a8:8a:31,203426686,244,35936,203426442,203426686
89,5,6,149,5745,-91,-96,5,54:e4:3a:ec:fb:65,203452401,360,25355,203452041,203452401
90,5,12,149,5745,-51,-96,45,f2:da:61:dd:98:c5,203453577,268,908,203453309,203453577
91,5,12,149,5745,-87,-96,9,d2:00:04:7e:2c:ab,203476429,244,22608,203476185,203476429
92,5,12,149,5745,-79,-96,17,c2:21:7d:48:b5:63,203476708,240,39,203476468,203476708
93,5,12,149,5745,-85,-96,11,72:d1:72:1d:22:a1,203477126,256,162,203476870,203477126
94,5,12,149,5745,-81,-96,15,56:68:e2:c2:8d:d5,203478431,280,1025,203478151,203478431
95,5,12,149,5745,-80,-96,16,fa:44:8d:e1:c7:1b,203482626,244,3951,203482382,203482626
96,5,12,149,5745,-82,-96,14,56:68:e2:c2:8d:d5,203504345,280,21439,203504065,203504345
97,5,12,149,5745,-48,-96,48,5e:29:73:5b:30:00,203506349,272,1732,203506077,203506349
98,5,12,149,5745,-79,-96,17,c2:21:7d:48:b5:63,203507537,240,948,203507297,203507537
99,5,12,149,5745,-82,-96,14,56:68:e2:c2:8d:d5,203509333,476,1320,203508857,203509333
100,5,12,149,5745,-85,-96,11,72:d1:72:1d:22:a1,203511015,452,1230,203510563,203511015
101,5,12,149,5745,-48,-96,48,5e:29:73:5b:30:00,203516046,540,4491,203515506,203516046
102,5,12,149,5745,-78,-96,18,f6:0a:5c:59:72:df,203516737,448,243,203516289,203516737
103,5,6,149,5745,-92,-96,4,94:83:c4:20:2e:0a,203517797,428,632,203517369,203517797
104,5,12,149,5745,-86,-96,10,d2:00:04:7e:2c:ab,203521360,440,3123,203520920,203521360
105,5,12,149,5745,-64,-96,32,3e:d1:9b:c7:a4:de,203522812,272,1180,203522540,203522812
106,5,12,149,5745,-54,-96,42,f2:da:61:dd:98:c5,203524641,268,1561,203524373,203524641
107,5,12,149,5745,-81,-96,15,fa:44:8d:e1:c7:1b,203525526,440,445,203525086,203525526
108,5,12,149,5745,-76,-96,20,22:ec:75:a8:8a:31,203528676,516,2634,203528160,203528676
109,5,12,149,5745,-64,-96,32,3e:d1:9b:c7:a4:de,203529471,544,251,203528927,203529471
110,5,12,149,5745,-54,-96,42,f2:da:61:dd:98:c5,203532440,268,2701,203532172,203532440
111,5,12,149,5745,-86,-96,10,d2:00:04:7e:2c:ab,203538142,244,5458,203537898,203538142
112,5,12,149,5745,-76,-96,20,22:ec:75:a8:8a:31,203553972,244,15586,203553728,203553972
113,5,12,149,5745,-79,-96,17,c2:21:7d:48:b5:63,203554252,240,40,203554012,203554252
114,5,6,149,5745,-90,-96,6,54:e4:3a:ec:fb:65,203554802,360,190,203554442,203554802
115,5,12,149,5745,-79,-96,17,c2:21:7d:48:b5:63,203572528,240,17486,203572288,203572528
116,5,12,149,5745,-82,-96,14,56:68:e2:c2:8d:d5,203574198,476,1194,203573722,203574198
117,5,12,149,5745,-78,-96,18,f6:0a:5c:59:72:df,203575059,252,609,203574807,203575059
118,5,12,149,5745,-85,-96,11,72:d1:72:1d:22:a1,203577398,452,1887,203576946,203577398
119,5,12,149,5745,-77,-96,19,0a:b9:b7:b1:4d:fa,203578973,268,1307,203578705,203578973
120,5,12,149,5745,-49,-96,47,5e:29:73:5b:30:00,203581372,540,1859,203580832,203581372
121,5,12,149,5745,-80,-96,16,f6:0a:5c:59:72:df,203581992,448,172,203581544,203581992
122,5,12,149,5745,-85,-96,11,d2:00:04:7e:2c:ab,203586111,440,3679,203585671,203586111
123,5,12,149,5745,-85,-96,11,72:d1:72:1d:22:a1,203587802,256,1435,203587546,203587802
124,5,12,149,5745,-74,-96,22,a6:92:ad:b7:76:65,203589598,456,1340,203589142,203589598
125,5,12,149,5745,-80,-96,16,fa:44:8d:e1:c7:1b,203592124,440,2086,203591684,203592124
126,5,12,149,5745,-77,-96,19,22:ec:75:a8:8a:31,203593697,516,1057,203593181,203593697
127,5,12,149,5745,-64,-96,32,3e:d1:9b:c7:a4:de,203594539,544,298,203593995,203594539
128,5,12,149,5745,-56,-96,40,f2:da:61:dd:98:c5,203596199,268,1392,203595931,203596199
129,5,12,149,5745,-80,-96,16,fa:44:8d:e1:c7:1b,203603791,244,7348,203603547,203603791
130,5,12,149,5745,-82,-96,14,56:68:e2:c2:8d:d5,203619947,280,15876,203619667,203619947
131,5,12,149,5745,-48,-96,48,5e:29:73:5b:30:00,203621792,272,1573,203621520,203621792
132,5,12,149,5745,-65,-96,31,3e:d1:9b:c7:a4:de,203622116,272,52,203621844,203622116
133,5,12,149,5745,-80,-96,16,f6:0a:5c:59:72:df,203647113,448,24549,203646665,203647113
134,5,12,149,5745,-54,-96,42,f2:da:61:dd:98:c5,203650070,268,2689,203649802,203650070
135,5,12,149,5745,-76,-96,20,22:ec:75:a8:8a:31,203656006,244,5692,203655762,203656006
136,5,6,149,5745,-90,-96,6,54:e4:3a:ec:fb:65,203657203,360,837,203656843,203657203
137,5,12,149,5745,-85,-96,11,d2:00:04:7e:2c:ab,203661186,244,3739,203660942,203661186
138,5,12,149,5745,-78,-96,18,c2:21:7d:48:b5:63,203681015,240,19589,203680775,203681015
139,5,12,149,5745,-77,-96,19,f6:0a:5c:59:72:df,203701910,252,20643,203701658,203701910
140,5,12,149,5745,-66,-96,30,3e:d1:9b:c7:a4:de,203711530,544,9076,203710986,203711530
141,5,12,149,5745,-48,-96,48,5e:29:73:5b:30:00,203723688,272,11886,203723416,203723688
142,5,12,149,5745,-66,-96,30,3e:d1:9b:c7:a4:de,203735782,272,11822,203735510,203735782
143,5,12,149,5745,-54,-96,42,f2:da:61:dd:98:c5,203757366,268,21316,203757098,203757366
144,5,6,149,5745,-91,-96,5,54:e4:3a:ec:fb:65,203759603,360,1877,203759243,203759603
145,5,12,149,5745,-77,-96,19,22:ec:75:a8:8a:31,203773082,244,13235,203772838,203773082
146,5,12,149,5745,-66,-96,30,3e:d1:9b:c7:a4:de,203777051,544,3425,203776507,203777051
147,5,12,149,5745,-86,-96,10,d2:00:04:7e:2c:ab,203783704,244,6409,203783460,203783704
148,5,12,149,5745,-80,-96,16,fa:44:8d:e1:c7:1b,203784198,244,250,203783954,203784198
149,5,12,149,5745,-86,-96,10,72:d1:72:1d:22:a1,203784523,256,69,203784267,203784523
150,5,12,149,5745,-80,-96,16,56:68:e2:c2:8d:d5,203785578,280,775,203785298,203785578
151,5,12,149,5745,-79,-96,17,c2:21:7d:48:b5:63,203793173,240,7355,203792933,203793173
152,5,12,149,5745,-49,-96,47,5e:29:73:5b:30:00,203840687,272,47242,203840415,203840687
153,5,12,149,5745,-66,-96,30,3e:d1:9b:c7:a4:de,203842624,272,1665,203842352,203842624
154,5,6,149,5745,-92,-96,4,54:e4:3a:ec:fb:65,203862004,360,19020,203861644,203862004
155,5,12,149,5745,-51,-96,45,f2:da:61:dd:98:c5,203870659,268,8387,203870391,203870659
156,5,12,149,5745,-85,-96,11,d2:00:04:7e:2c:ab,203886320,244,15417,203886076,203886320
157,5,12,149,5745,-80,-96,16,fa:44:8d:e1:c7:1b,203886669,244,105,203886425,203886669
158,5,12,149,5745,-88,-96,8,72:d1:72:1d:22:a1,203887019,256,94,203886763,203887019
159,5,12,149,5745,-81,-96,15,56:68:e2:c2:8d:d5,203888279,280,980,203887999,203888279
160,5,12,149,5745,-78,-96,18,22:ec:75:a8:8a:31,203890179,244,1656,203889935,203890179
161,5,12,149,5745,-78,-96,18,c2:21:7d:48:b5:63,203902476,240,12057,203902236,203902476
162,5,12,149,5745,-87,-96,9,72:d1:72:1d:22:a1,203941631,256,38899,203941375,203941631
163,5,12,149,5745,-79,-96,17,fa:44:8d:e1:c7:1b,203950402,244,8527,203950158,203950402
164,5,12,149,5745,-82,-96,14,56:68:e2:c2:8d:d5,203963065,280,12383,203962785,203963065
165,5,6,149,5745,-93,-96,3,54:e4:3a:ec:fb:65,203964404,360,979,203964044,203964404
166,5,12,149,5745,-49,-96,47,5e:29:73:5b:30:00,203965089,272,413,203964817,203965089
167,5,12,149,5745,-66,-96,30,3e:d1:9b:c7:a4:de,203965431,272,70,203965159,203965431
168,5,12,149,5745,-78,-96,18,c2:21:7d:48:b5:63,203967845,240,2174,203967605,203967845
169,5,12,149,5745,-87,-96,9,72:d1:72:1d:22:a1,203970316,452,2019,203969864,203970316
170,5,12,149,5745,-82,-96,14,56:68:e2:c2:8d:d5,203970812,476,20,203970336,203970812
171,5,12,149,5745,-78,-96,18,f6:0a:5c:59:72:df,203974858,448,3598,203974410,203974858
172,5,12,149,5745,-66,-96,30,3e:d1:9b:c7:a4:de,203975367,544,-35,203974823,203975367
173,5,12,149,5745,-49,-96,47,5e:29:73:5b:30:00,203975999,540,92,203975459,203975999
174,5,12,149,5745,-84,-96,12,d2:00:04:7e:2c:ab,203980479,440,4040,203980039,203980479
175,5,12,149,5745,-49,-96,47,f2:da:61:dd:98:c5,203982844,268,2097,203982576,203982844
176,5,12,149,5745,-75,-96,21,a6:92:ad:b7:76:65,203984289,456,989,203983833,203984289
177,5,12,149,5745,-78,-96,18,fa:44:8d:e1:c7:1b,203986067,440,1338,203985627,203986067
178,5,12,149,5745,-78,-96,18,22:ec:75:a8:8a:31,203987946,516,1363,203987430,203987946
179,5,12,149,5745,-49,-96,47,f2:da:61:dd:98:c5,203990890,268,2676,203990622,203990890
180,5,12,149,5745,-84,-96,12,d2:00:04:7e:2c:ab,203996853,244,5719,203996609,203996853
181,5,12,149,5745,-77,-96,19,c2:21:7d:48:b5:63,204012795,240,15702,204012555,204012795
182,5,12,149,5745,-77,-96,19,22:ec:75:a8:8a:31,204013286,244,247,204013042,204013286
183,5,6,149,5745,-94,-96,2,94:83:c4:20:2e:0a,204029422,428,15708,204028994,204029422
184,5,12,149,5745,-77,-96,19,c2:21:7d:48:b5:63,204031305,240,1643,204031065,204031305
185,5,12,149,5745,-78,-96,18,f6:0a:5c:59:72:df,204033910,252,2353,204033658,204033910
186,5,12,149,5745,-66,-96,30,3e:d1:9b:c7:a4:de,204039182,544,4728,204038638,204039182
187,5,12,149,5745,-80,-96,16,f6:0a:5c:59:72:df,204041737,448,2107,204041289,204041737
188,5,12,149,5745,-84,-96,12,d2:00:04:7e:2c:ab,204044849,440,2672,204044409,204044849
189,5,12,149,5745,-76,-96,20,a6:92:ad:b7:76:65,204046601,456,1296,204046145,204046601
190,5,12,149,5745,-86,-96,10,72:d1:72:1d:22:a1,204054485,256,7628,204054229,204054485
191,5,12,149,5745,-79,-96,17,fa:44:8d:e1:c7:1b,204066224,244,11495,204065980,204066224
192,5,6,149,5745,-91,-96,5,54:e4:3a:ec:fb:65,204066805,360,221,204066445,204066805
193,5,12,149,5745,-50,-96,46,5e:29:73:5b:30:00,204069993,272,2916,204069721,204069993
194,5,12,149,5745,-82,-96,14,56:68:e2:c2:8d:d5,204072234,280,1961,204071954,204072234
195,5,12,149,5745,-75,-96,21,a6:92:ad:b7:76:65,204079563,256,7073,204079307,204079563
196,5,12,149,5745,-66,-96,30,3e:d1:9b:c7:a4:de,204080231,272,396,204079959,204080231
197,5,12,149,5745,-47,-96,49,f2:da:61:dd:98:c5,204097609,268,17110,204097341,204097609
198,5,12,149,5745,-77,-96,19,c2:21:7d:48:b5:63,204098271,240,422,204098031,204098271
199,5,12,149,5745,-74,-96,22,0a:b9:b7:b1:4d:fa,204101407,268,2868,204101139,204101407
200,5,12,149,5745,-66,-96,30,3e:d1:9b:c7:a4:de,204104344,544,2393,204103800,204104344
201,5,12,149,5745,-78,-96,18,f6:0a:5c:59:72:df,204107066,448,2274,204106618,204107066
202,5,12,149,5745,-50,-96,46,5e:29:73:5b:30:00,204110368,540,2762,204109828,204110368
203,5,12,149,5745,-83,-96,13,d2:00:04:7e:2c:ab,204110996,440,188,204110556,204110996
204,5,12,149,5745,-77,-96,19,a6:92:ad:b7:76:65,204111506,456,54,204111050,204111506
205,5,12,149,5745,-82,-96,14,d2:00:04:7e:2c:ab,204112169,244,419,204111925,204112169
206,5,12,149,5745,-79,-96,17,fa:44:8d:e1:c7:1b,204114608,440,1999,204114168,204114608
207,5,12,149,5745,-77,-96,19,22:ec:75:a8:8a:31,204120437,516,5313,204119921,204120437
208,5,12,149,5745,-47,-96,49,f2:da:61:dd:98:c5,204121410,268,705,204121142,204121410
209,5,12,149,5745,-78,-96,18,c2:21:7d:48:b5:63,204126989,240,5339,204126749,204126989
210,5,12,149,5745,-77,-96,19,22:ec:75:a8:8a:31,204127272,244,39,204127028,204127272
211,5,6,149,5745,-92,-96,4,94:83:c4:20:2e:0a,204131823,428,4123,204131395,204131823
212,5,24,149,5745,-79,-96,17,,204142038,28,10187,204142010,204142038
213,5,12,149,5745,-77,-96,19,f6:0a:5c:59:72:df,204145601,252,3311,204145349,204145601
214,5,6,149,5745,-92,-96,4,54:e4:3a:ec:fb:65,204169205,360,23244,204168845,204169205
215,5,12,149,5745,-67,-96,29,3e:d1:9b:c7:a4:de,204170226,544,477,204169682,204170226
216,5,12,149,5745,-77,-96,19,f6:0a:5c:59:72:df,204171191,448,517,204170743,204171191
217,5,12,149,5745,-79,-96,17,fa:44:8d:e1:c7:1b,204177886,244,6451,204177642,204177886
218,5,24,149,5745,-83,-96,13,,204184240,28,6326,204184212,204184240
219,5,12,149,5745,-49,-96,47,5e:29:73:5b:30:00,204185946,272,1434,204185674,204185946
220,5,12,149,5745,-86,-96,10,72:d1:72:1d:22:a1,204193866,256,7664,204193610,204193866
221,5,12,149,5745,-66,-96,30,3e:d1:9b:c7:a4:de,204194571,272,433,204194299,204194571
222,5,12,149,5745,-81,-96,15,56:68:e2:c2:8d:d5,204195948,280,1097,204195668,204195948
223,5,12,149,5745,-78,-96,18,a6:92:ad:b7:76:65,204200172,256,3968,204199916,204200172
224,5,12,149,5745,-78,-96,18,22:ec:75:a8:8a:31,204231476,244,31060,204231232,204231476
225,5,12,149,5745,-65,-96,31,3e:d1:9b:c7:a4:de,204235876,544,3856,204235332,204235876
226,5,6,149,5745,-90,-96,6,54:e4:3a:ec:fb:65,204271606,360,35370,204271246,204271606
227,5,12,149,5745,-51,-96,45,f2:da:61:dd:98:c5,204272029,268,155,204271761,204272029
228,5,12,149,5745,-79,-96,17,fa:44:8d:e1:c7:1b,204291481,244,19208,204291237,204291481
229,5,12,149,5745,-77,-96,19,c2:21:7d:48:b5:63,204296302,240,4581,204296062,204296302
230,5,12,149,5745,-85,-96,11,72:d1:72:1d:22:a1,204296785,256,227,204296529,204296785
231,5,12,149,5745,-81,-96,15,56:68:e2:c2:8d:d5,204297541,280,476,204297261,204297541
232,5,12,149,5745,-65,-96,31,3e:d1:9b:c7:a4:de,204301311,544,3226,204300767,204301311
233,5,12,149,5745,-52,-96,44,5e:29:73:5b:30:00,204302842,272,1259,204302570,204302842
234,5,12,149,5745,-65,-96,31,3e:d1:9b:c7:a4:de,204309250,272,6136,204308978,204309250
235,5,12,149,5745,-76,-96,20,a6:92:ad:b7:76:65,204310925,256,1419,204310669,204310925
236,5,12,149,5745,-80,-96,16,22:ec:75:a8:8a:31,204349632,244,38463,204349388,204349632
237,5,6,149,5745,-92,-96,4,54:e4:3a:ec:fb:65,204374006,360,24014,204373646,204374006
238,5,12,149,5745,-51,-96,45,f2:da:61:dd:98:c5,204374810,268,536,204374542,204374810
239,5,12,149,5745,-78,-96,18,c2:21:7d:48:b5:63,204398477,240,23427,204398237,204398477
240,5,12,149,5745,-86,-96,10,72:d1:72:1d:22:a1,204398828,256,95,204398572,204398828
241,5,12,149,5745,-79,-96,17,fa:44:8d:e1:c7:1b,204405825,244,6753,204405581,204405825
242,5,12,149,5745,-65,-96,31,3e:d1:9b:c7:a4:de,204407878,272,1781,204407606,204407878
243,5,12,149,5745,-83,-96,13,56:68:e2:c2:8d:d5,204416810,280,8652,204416530,204416810
244,5,12,149,5745,-46,-96,50,5e:29:73:5b:30:00,204419283,272,2201,204419011,204419283
245,5,12,149,5745,-79,-96,17,22:ec:75:a8:8a:31,204462292,244,42765,204462048,204462292
246,5,6,149,5745,-78,-96,18,,204470744,44,8408,204470700,204470744
247,5,6,149,5745,-92,-96,4,54:e4:3a:ec:fb:65,204476407,360,5303,204476047,204476407
248,5,12,149,5745,-48,-96,48,f2:da:61:dd:98:c5,204476949,268,274,204476681,204476949
249,5,12,149,5745,-76,-96,20,a6:92:ad:b7:76:65,204499124,256,21919,204498868,204499124
250,5,12,149,5745,-81,-96,15,72:d1:72:1d:22:a1,204501474,256,2094,204501218,204501474
251,5,12,149,5745,-81,-96,15,c2:21:7d:48:b5:63,204501802,240,88,204501562,204501802
252,5,12,149,5745,-80,-96,16,fa:44:8d:e1:c7:1b,204516677,244,14631,204516433,204516677
253,5,12,149,5745,-80,-96,16,56:68:e2:c2:8d:d5,204517657,280,700,204517377,204517657
254,5,12,149,5745,-64,-96,32,3e:d1:9b:c7:a4:de,204519712,272,1783,204519440,204519712
255,5,12,149,5745,-50,-96,46,5e:29:73:5b:30:00,204531387,272,11403,204531115,204531387
256,5,12,149,5745,-74,-96,22,a6:92:ad:b7:76:65,204539881,256,8238,204539625,204539881
257,5,12,149,5745,-52,-96,44,f2:da:61:dd:98:c5,204543176,268,3027,204542908,204543176
258,5,12,149,5745,-83,-96,13,56:68:e2:c2:8d:d5,204557316,476,13664,204556840,204557316
259,5,12,149,5745,-80,-96,16,c2:21:7d:48:b5:63,204558440,240,884,204558200,204558440
260,5,12,149,5745,-83,-96,13,72:d1:72:1d:22:a1,204561910,452,3018,204561458,204561910
261,5,12,149,5745,-65,-96,31,3e:d1:9b:c7:a4:de,204564278,544,1824,204563734,204564278
262,5,12,149,5745,-74,-96,22,f6:0a:5c:59:72:df,204565125,448,399,204564677,204565125
263,5,12,149,5745,-47,-96,49,5e:29:73:5b:30:00,204567663,540,1998,204567123,204567663
264,5,12,149,5745,-81,-96,15,c2:21:7d:48:b5:63,204569569,240,1666,204569329,204569569
265,5,12,149,5745,-75,-96,21,a6:92:ad:b7:76:65,204571045,456,1020,204570589,204571045
266,5,12,149,5745,-78,-96,18,fa:44:8d:e1:c7:1b,204573948,440,2463,204573508,204573948
267,5,12,149,5745,-74,-96,22,22:ec:75:a8:8a:31,204576276,516,1812,204575760,204576276
268,5,12,149,5745,-75,-96,21,9a:24:38:da:96:bb,204577989,796,917,204577193,204577989
269,5,12,149,5745,-75,-96,21,9a:24:38:da:96:bb,204578892,116,787,204578776,204578892
270,5,12,149,5745,-74,-96,22,9a:24:38:da:96:bb,204579043,116,35,204578927,204579043
271,5,12,149,5745,-75,-96,21,9a:24:38:da:96:bb,204579240,104,93,204579136,204579240
272,5,12,149,5745,-75,-96,21,9a:24:38:da:96:bb,204579433,116,77,204579317,204579433
273,5,12,149,5745,-75,-96,21,9a:24:38:da:96:bb,204579585,104,48,204579481,204579585
274,5,12,149,5745,-75,-96,21,9a:24:38:da:96:bb,204579787,104,98,204579683,204579787
275,5,12,149,5745,-75,-96,21,9a:24:38:da:96:bb,204579926,220,-81,204579706,204579926
276,5,12,149,5745,-75,-96,21,9a:24:38:da:96:bb,204580245,240,79,204580005,204580245
277,5,12,149,5745,-75,-96,21,9a:24:38:da:96:bb,204580520,220,55,204580300,204580520
278,5,12,149,5745,-75,-96,21,9a:24:38:da:96:bb,204580875,220,135,204580655,204580875
279,5,12,149,5745,-75,-96,21,9a:24:38:da:96:bb,204581130,152,103,204580978,204581130
280,5,12,149,5745,-75,-96,21,9a:24:38:da:96:bb,204581416,724,-438,204580692,204581416
281,5,12,149,5745,-75,-96,21,9a:24:38:da:96:bb,204582176,828,-68,204581348,204582176
282,5,12,149,5745,-75,-96,21,9a:24:38:da:96:bb,204583075,152,747,204582923,204583075
283,5,12,149,5745,-54,-96,42,f2:da:61:dd:98:c5,204583261,268,-82,204582993,204583261
284,5,12,149,5745,-73,-96,23,9a:24:38:da:96:bb,204583708,104,343,204583604,204583708
285,5,12,149,5745,-73,-96,23,9a:24:38:da:96:bb,204583847,796,-657,204583051,204583847
286,5,12,149,5745,-74,-96,22,22:ec:75:a8:8a:31,204585859,244,1768,204585615,204585859
287,5,12,149,5745,-74,-96,22,f6:0a:5c:59:72:df,204596587,252,10476,204596335,204596587
288,5,12,149,5745,-82,-96,14,72:d1:72:1d:22:a1,204604821,256,7978,204604565,204604821
289,5,12,149,5745,-83,-96,13,56:68:e2:c2:8d:d5,204618453,280,13352,204618173,204618453
290,5,12,149,5745,-79,-96,17,fa:44:8d:e1:c7:1b,204620308,244,1611,204620064,204620308
291,5,12,149,5745,-80,-96,16,c2:21:7d:48:b5:63,204621091,240,543,204620851,204621091
292,5,12,149,5745,-83,-96,13,56:68:e2:c2:8d:d5,204622626,476,1059,204622150,204622626
293,5,12,149,5745,-81,-96,15,72:d1:72:1d:22:a1,204625441,452,2363,204624989,204625441
294,5,12,149,5745,-72,-96,24,0a:b9:b7:b1:4d:fa,204627664,268,1955,204627396,204627664
295,5,12,149,5745,-65,-96,31,3e:d1:9b:c7:a4:de,204628456,544,248,204627912,204628456
296,5,12,149,5745,-77,-96,19,f6:0a:5c:59:72:df,204631014,448,2110,204630566,204631014
297,5,12,149,5745,-45,-96,51,5e:29:73:5b:30:00,204632432,540,878,204631892,204632432
298,5,12,149,5745,-78,-96,18,a6:92:ad:b7:76:65,204635832,456,2944,204635376,204635832
299,5,12,149,5745,-78,-96,18,a6:92:ad:b7:76:65,204638207,256,2119,204637951,204638207
300,5,12,149,5745,-80,-96,16,fa:44:8d:e1:c7:1b,204638985,440,338,204638545,204638985
301,5,12,149,5745,-77,-96,19,22:ec:75:a8:8a:31,204641639,516,2138,204641123,204641639
302,5,12,149,5745,-71,-96,25,9a:24:38:da:96:bb,204642198,824,-265,204641374,204642198
303,5,12,149,5745,-53,-96,43,f2:da:61:dd:98:c5,204645387,268,2921,204645119,204645387
304,5,12,149,5745,-67,-96,29,3e:d1:9b:c7:a4:de,204653305,272,7646,204653033,204653305
305,5,12,149,5745,-52,-96,44,f2:da:61:dd:98:c5,204654841,268,1268,204654573,204654841
306,5,12,149,5745,-46,-96,50,5e:29:73:5b:30:00,204656067,272,954,204655795,204656067
307,5,6,149,5745,-91,-96,5,54:e4:3a:ec:fb:65,204681208,360,24781,204680848,204681208
308,5,12,149,5745,-76,-96,20,22:ec:75:a8:8a:31,204686361,244,4909,204686117,204686361
309,5,12,149,5745,-78,-96,18,f6:0a:5c:59:72:df,204695930,448,9121,204695482,204695930
310,5,12,149,5745,-79,-96,17,c2:21:7d:48:b5:63,204698091,240,1921,204697851,204698091
311,5,12,149,5745,-70,-96,26,9a:24:38:da:96:bb,204707670,824,8755,204706846,204707670
312,5,12,149,5745,-78,-96,18,f6:0a:5c:59:72:df,204709308,252,1386,204709056,204709308
313,5,12,149,5745,-73,-96,23,9a:24:38:da:96:bb,204736270,272,26690,204735998,204736270
314,5,12,149,5745,-67,-96,29,3e:d1:9b:c7:a4:de,204748984,272,12442,204748712,204748984
315,5,12,149,5745,-49,-96,47,5e:29:73:5b:30:00,204759886,272,10630,204759614,204759886
316,5,12,149,5745,-46,-96,50,f2:da:61:dd:98:c5,204772188,268,12034,204771920,204772188
317,5,6,149,5745,-89,-96,7,54:e4:3a:ec:fb:65,204783608,360,11060,204783248,204783608
318,5,12,149,5745,-76,-96,20,22:ec:75:a8:8a:31,204804446,244,20594,204804202,204804446
319,5,12,149,5745,-77,-96,19,a6:92:ad:b7:76:65,204806902,256,2200,204806646,204806902
320,5,12,149,5745,-76,-96,20,fa:44:8d:e1:c7:1b,204808246,244,1100,204808002,204808246
321,5,12,149,5745,-83,-96,13,72:d1:72:1d:22:a1,204808525,256,23,204808269,204808525
322,5,12,149,5745,-81,-96,15,56:68:e2:c2:8d:d5,204811309,280,2504,204811029,204811309
323,5,12,149,5745,-76,-96,20,c2:21:7d:48:b5:63,204811813,240,264,204811573,204811813
324,5,12,149,5745,-76,-96,20,f6:0a:5c:59:72:df,204837392,252,25327,204837140,204837392
325,5,12,149,5745,-72,-96,24,9a:24:38:da:96:bb,204848011,272,10347,204847739,204848011
326,5,12,149,5745,-69,-96,27,3e:d1:9b:c7:a4:de,204865699,272,17416,204865427,204865699
327,5,24,149,5745,-90,-96,6,,204870631,28,4904,204870603,204870631
328,5,12,149,5745,-52,-96,44,5e:29:73:5b:30:00,204875265,272,4362,204874993,204875265
329,5,12,149,5745,-51,-96,45,f2:da:61:dd:98:c5,204884665,268,9132,204884397,204884665
330,5,6,149,5745,-87,-96,9,54:e4:3a:ec:fb:65,204886009,360,984,204885649,204886009
331,5,24,149,5745,-91,-96,5,,204898428,28,12391,204898400,204898428
332,5,12,149,5745,-79,-96,17,a6:92:ad:b7:76:65,204909452,256,10768,204909196,204909452
333,5,12,149,5745,-76,-96,20,fa:44:8d:e1:c7:1b,204910645,244,949,204910401,204910645
334,5,12,149,5745,-84,-96,12,72:d1:72:1d:22:a1,204911076,256,175,204910820,204911076
335,5,12,149,5745,-78,-96,18,56:68:e2:c2:8d:d5,204914379,280,3023,204914099,204914379
336,5,12,149,5745,-77,-96,19,22:ec:75:a8:8a:31,204921479,244,6856,204921235,204921479
337,5,12,149,5745,-79,-96,17,c2:21:7d:48:b5:63,204922642,240,923,204922402,204922642
338,5,12,149,5745,-84,-96,12,72:d1:72:1d:22:a1,204957057,256,34159,204956801,204957057
339,5,12,149,5745,-68,-96,28,9a:24:38:da:96:bb,204963682,272,6353,204963410,204963682
340,5,12,149,5745,-73,-96,23,f6:0a:5c:59:72:df,204970475,252,6541,204970223,204970475
341,5,12,149,5745,-79,-96,17,56:68:e2:c2:8d:d5,204972822,280,2067,204972542,204972822
342,5,12,149,5745,-79,-96,17,fa:44:8d:e1:c7:1b,204973280,244,214,204973036,204973280
343,5,12,149,5745,-68,-96,28,3e:d1:9b:c7:a4:de,204981766,272,8214,204981494,204981766
344,5,6,149,5745,-89,-96,7,54:e4:3a:ec:fb:65,204988409,360,6283,204988049,204988409
345,5,12,149,5745,-51,-96,45,5e:29:73:5b:30:00,204989949,272,1268,204989677,204989949
346,5,12,149,5745,-69,-96,27,5e:36:fe:bc:a2:fe,204999693,116,9628,204999577,204999693
347,5,12,149,5745,-55,-96,41,f2:da:61:dd:98:c5,205000439,268,478,205000171,205000439
348,5,12,149,5745,-80,-96,16,c2:21:7d:48:b5:63,205016275,240,15596,205016035,205016275
349,5,12,149,5745,-80,-96,16,56:68:e2:c2:8d:d5,205017661,476,910,205017185,205017661
350,5,12,149,5745,-85,-96,11,72:d1:72:1d:22:a1,205020261,452,2148,205019809,205020261
351,5,12,149,5745,-75,-96,21,f6:0a:5c:59:72:df,205025817,448,5108,205025369,205025817
352,5,12,149,5745,-80,-96,16,c2:21:7d:48:b5:63,205028136,240,2079,205027896,205028136
353,5,12,149,5745,-50,-96,46,5e:29:73:5b:30:00,205028437,540,-239,205027897,205028437
354,5,12,149,5745,-78,-96,18,a6:92:ad:b7:76:65,205029011,456,118,205028555,205029011
355,5,12,149,5745,-82,-96,14,fa:44:8d:e1:c7:1b,205032248,440,2797,205031808,205032248
356,5,12,149,5745,-69,-96,27,5e:36:fe:bc:a2:fe,205032857,436,173,205032421,205032857
357,5,12,149,5745,-73,-96,23,9a:24:38:da:96:bb,205036301,824,2620,205035477,205036301
358,5,12,149,5745,-65,-96,31,3e:d1:9b:c7:a4:de,205037159,544,314,205036615,205037159
359,5,12,149,5745,-74,-96,22,22:ec:75:a8:8a:31,205037791,516,116,205037275,205037791
360,5,12,149,5745,-56,-96,40,f2:da:61:dd:98:c5,205038737,268,678,205038469,205038737
361,5,12,149,5745,-73,-96,23,22:ec:75:a8:8a:31,205044583,244,5602,205044339,205044583
362,5,12,149,5745,-77,-96,19,f6:0a:5c:59:72:df,205049478,252,4643,205049226,205049478
363,5,12,149,5745,-84,-96,12,72:d1:72:1d:22:a1,205063454,256,13720,205063198,205063454
364,5,12,149,5745,-74,-96,22,9a:24:38:da:96:bb,205071828,272,8102,205071556,205071828
365,5,12,149,5745,-78,-96,18,c2:21:7d:48:b5:63,205079727,240,7659,205079487,205079727
366,5,12,149,5745,-76,-96,20,a6:92:ad:b7:76:65,205087345,456,7162,205086889,205087345
367,5,12,149,5745,-81,-96,15,56:68:e2:c2:8d:d5,205090531,280,2906,205090251,205090531
368,5,12,149,5745,-81,-96,15,f6:0a:5c:59:72:df,205091277,448,298,205090829,205091277
369,5,12,149,5745,-76,-96,20,fa:44:8d:e1:c7:1b,205092700,244,1179,205092456,205092700
370,5,12,149,5745,-67,-96,29,5e:36:fe:bc:a2:fe,205092979,440,-161,205092539,205092979
371,5,12,149,5745,-67,-96,29,5e:36:fe:bc:a2:fe,205095046,244,1823,205094802,205095046
372,5,12,149,5745,-76,-96,20,a6:92:ad:b7:76:65,205095491,256,189,205095235,205095491
373,5,12,149,5745,-49,-96,47,5e:29:73:5b:30:00,205107011,272,11248,205106739,205107011
374,5,12,149,5745,-80,-96,16,d2:00:04:7e:2c:ab,205112160,272,4877,205111888,205112160
375,5,12,149,5745,-57,-96,39,f2:da:61:dd:98:c5,205119528,268,7100,205119260,205119528
376,5,12,149,5745,-76,-96,20,c2:21:7d:48:b5:63,205142762,240,22994,205142522,205142762
377,5,12,149,5745,-74,-96,22,9a:24:38:da:96:bb,205144633,824,1047,205143809,205144633
378,5,12,149,5745,-76,-96,20,c2:21:7d:48:b5:63,205146013,240,1140,205145773,205146013
379,5,12,149,5745,-73,-96,23,22:ec:75:a8:8a:31,205146287,516,-242,205145771,205146287
380,5,12,149,5745,-74,-96,22,0a:b9:b7:b1:4d:fa,205150411,268,3856,205150143,205150411
381,5,12,149,5745,-77,-96,19,a6:92:ad:b7:76:65,205153285,456,2418,205152829,205153285
382,5,12,149,5745,-82,-96,14,f6:0a:5c:59:72:df,205156592,448,2859,205156144,205156592
383,5,12,149,5745,-48,-96,48,5e:29:73:5b:30:00,205157101,540,-31,205156561,205157101
384,5,12,149,5745,-83,-96,13,d2:00:04:7e:2c:ab,205158558,412,1045,205158146,205158558
385,5,12,149,5745,-73,-96,23,22:ec:75:a8:8a:31,205159481,244,679,205159237,205159481
386,5,12,149,5745,-74,-96,22,5e:36:fe:bc:a2:fe,205159795,440,-126,205159355,205159795
387,5,12,149,5745,-82,-96,14,f6:0a:5c:59:72:df,205162276,252,2229,205162024,205162276
388,5,12,149,5745,-78,-96,18,fa:44:8d:e1:c7:1b,205163977,440,1261,205163537,205163977
389,5,12,149,5745,-57,-96,39,f2:da:61:dd:98:c5,205168536,268,4291,205168268,205168536
390,5,12,149,5745,-68,-96,28,3e:d1:9b:c7:a4:de,205170007,544,927,205169463,205170007
391,5,12,149,5745,-75,-96,21,9a:24:38:da:96:bb,205188275,272,17996,205188003,205188275
392,5,12,149,5745,-77,-96,19,5e:36:fe:bc:a2:fe,205208815,440,20100,205208375,205208815
393,5,12,149,5745,-75,-96,21,9a:24:38:da:96:bb,205209691,824,52,205208867,205209691
394,5,12,149,5745,-66,-96,30,3e:d1:9b:c7:a4:de,205213510,272,3547,205213238,205213510
395,5,12,149,5745,-84,-96,12,72:d1:72:1d:22:a1,205218146,256,4380,205217890,205218146
396,5,12,149,5745,-79,-96,17,a6:92:ad:b7:76:65,205219522,256,1120,205219266,205219522
397,5,12,149,5745,-83,-96,13,56:68:e2:c2:8d:d5,205220721,280,919,205220441,205220721
398,5,12,149,5745,-48,-96,48,5e:29:73:5b:30:00,205224064,272,3071,205223792,205224064
399,5,12,149,5745,-56,-96,40,f2:da:61:dd:98:c5,205226748,268,2416,205226480,205226748
400,5,12,149,5745,-86,-96,10,d2:00:04:7e:2c:ab,205227050,244,58,205226806,205227050
401,5,12,149,5745,-86,-96,10,d2:00:04:7e:2c:ab,205228239,440,749,205227799,205228239
402,5,12,149,5745,-78,-96,18,22:ec:75:a8:8a:31,205260839,244,32356,205260595,205260839
403,5,24,149,5745,-82,-96,14,,205271087,28,10220,205271059,205271087
404,5,24,149,5745,-84,-96,12,,205271195,32,76,205271163,205271195
405,5,24,149,5745,-84,-96,12,,205272176,28,953,205272148,205272176
406,5,24,149,5745,-84,-96,12,,205272708,28,504,205272680,205272708
407,5,12,149,5745,-75,-96,21,5e:36:fe:bc:a2:fe,205284343,440,11195,205283903,205284343
408,5,12,149,5745,-75,-96,21,f6:0a:5c:59:72:df,205286777,252,2182,205286525,205286777
409,5,6,149,5745,-90,-96,6,54:e4:3a:ec:fb:65,205295611,360,8474,205295251,205295611
410,5,12,149,5745,-71,-96,25,9a:24:38:da:96:bb,205300351,272,4468,205300079,205300351
411,5,12,149,5745,-80,-96,16,fa:44:8d:e1:c7:1b,205319124,244,18529,205318880,205319124
412,5,12,149,5745,-78,-96,18,c2:21:7d:48:b5:63,205320371,240,1007,205320131,205320371
413,5,12,149,5745,-83,-96,13,72:d1:72:1d:22:a1,205320863,256,236,205320607,205320863
414,5,12,149,5745,-83,-96,13,56:68:e2:c2:8d:d5,205322197,280,1054,205321917,205322197
415,5,6,149,5745,-80,-96,16,2e:ed:35:8b:f4:33,205325248,192,2859,205325056,205325248
416,5,6,149,5745,-91,-96,5,54:e4:3a:ec:fb:65,205325590,352,-10,205325238,205325590
417,5,6,149,5745,-80,-96,16,,205325958,44,324,205325914,205325958
418,5,12,149,5745,-64,-96,32,3e:d1:9b:c7:a4:de,205330336,272,4106,205330064,205330336
419,5,12,149,5745,-78,-96,18,a6:92:ad:b7:76:65,205334786,256,4194,205334530,205334786
420,5,12,149,5745,-52,-96,44,5e:29:73:5b:30:00,205340856,272,5798,205340584,205340856
421,5,24,149,5745,-84,-96,12,,205345421,28,4537,205345393,205345421
422,5,24,149,5745,-86,-96,10,,205345529,32,76,205345497,205345529
423,5,6,149,5745,-81,-96,15,2e:ed:35:8b:f4:33,205345628,192,-93,205345436,205345628
424,5,6,149,5745,-91,-96,5,54:e4:3a:ec:fb:65,205345969,352,-11,205345617,205345969
425,5,6,149,5745,-81,-96,15,,205346337,44,324,205346293,205346337
426,5,24,149,5745,-86,-96,10,,205346502,28,137,205346474,205346502
427,5,12,149,5745,-76,-96,20,22:ec:75:a8:8a:31,205376487,244,29741,205376243,205376487
428,5,6,149,5745,-91,-96,5,54:e4:3a:ec:fb:65,205398012,360,21165,205397652,205398012
429,5,12,149,5745,-54,-96,42,f2:da:61:dd:98:c5,205399533,268,1253,205399265,205399533
430,5,24,149,5745,-85,-96,11,66:48:51:4e:71:fa,205407959,328,8098,205407631,205407959
431,5,24,149,5745,-85,-96,11,,205408518,28,531,205408490,205408518
432,5,24,149,5745,-85,-96,11,,205408626,32,76,205408594,205408626
433,5,12,149,5745,-70,-96,26,9a:24:38:da:96:bb,205417194,272,8296,205416922,205417194
434,5,12,149,5745,-78,-96,18,c2:21:7d:48:b5:63,205422438,240,5004,205422198,205422438
435,5,12,149,5745,-88,-96,8,d2:00:04:7e:2c:ab,205422723,244,41,205422479,205422723
436,5,12,149,5745,-84,-96,12,72:d1:72:1d:22:a1,205423002,256,23,205422746,205423002
437,5,12,149,5745,-82,-96,14,56:68:e2:c2:8d:d5,205423497,280,215,205423217,205423497
438,5,12,149,5745,-77,-96,19,a6:92:ad:b7:76:65,205437338,256,13585,205437082,205437338
439,5,12,149,5745,-80,-96,16,fa:44:8d:e1:c7:1b,205438051,244,469,205437807,205438051
440,5,12,149,5745,-65,-96,31,3e:d1:9b:c7:a4:de,205447335,272,9012,205447063,205447335
441,5,12,149,5745,-49,-96,47,5e:29:73:5b:30:00,205456927,272,9320,205456655,205456927
442,5,12,149,5745,-76,-96,20,22:ec:75:a8:8a:31,205492510,244,35339,205492266,205492510
443,5,24,149,5745,-79,-96,17,,205499589,28,7051,205499561,205499589
444,5,24,149,5745,-79,-96,17,,205499815,28,198,205499787,205499815
445,5,24,149,5745,-79,-96,17,,205500096,28,253,205500068,205500096
446,5,6,149,5745,-90,-96,6,54:e4:3a:ec:fb:65,205500412,360,-44,205500052,205500412
447,5,12,149,5745,-47,-96,49,f2:da:61:dd:98:c5,205500986,268,306,205500718,205500986
448,5,12,149,5745,-80,-96,16,c2:21:7d:48:b5:63,205524431,240,23205,205524191,205524431
449,5,12,149,5745,-83,-96,13,72:d1:72:1d:22:a1,205525014,256,327,205524758,205525014
450,5,12,149,5745,-86,-96,10,d2:00:04:7e:2c:ab,205525641,244,383,205525397,205525641
451,5,12,149,5745,-81,-96,15,fa:44:8d:e1:c7:1b,205541147,244,15262,205540903,205541147
452,5,12,149,5745,-84,-96,12,56:68:e2:c2:8d:d5,205541657,280,230,205541377,205541657
453,5,24,149,5745,-84,-96,12,,205554372,28,12687,205554344,205554372
454,5,12,149,5745,-78,-96,18,a6:92:ad:b7:76:65,205554866,256,238,205554610,205554866
455,5,12,149,5745,-66,-96,30,3e:d1:9b:c7:a4:de,205559319,272,4181,205559047,205559319
456,5,12,149,5745,-52,-96,44,f2:da:61:dd:98:c5,205565375,268,5788,205565107,205565375
457,5,12,149,5745,-51,-96,45,5e:29:73:5b:30:00,205568788,272,3141,205568516,205568788
458,5,12,149,5745,-83,-96,13,d2:00:04:7e:2c:ab,205569833,244,801,205569589,205569833
459,5,12,149,5745,-78,-96,18,c2:21:7d:48:b5:63,205601536,240,31463,205601296,205601536
460,5,12,149,5745,-80,-96,16,22:ec:75:a8:8a:31,205601937,516,-115,205601421,205601937
461,5,6,149,5745,-90,-96,6,54:e4:3a:ec:fb:65,205602893,360,596,205602533,205602893
462,5,12,149,5745,-69,-96,27,9a:24:38:da:96:bb,205603965,824,248,205603141,205603965
463,5,12,149,5745,-82,-96,14,56:68:e2:c2:8d:d5,205608589,476,4148,205608113,205608589
464,5,12,149,5745,-74,-96,22,f6:0a:5c:59:72:df,205610354,252,1513,205610102,205610354
465,5,12,149,5745,-85,-96,11,72:d1:72:1d:22:a1,205610651,452,-155,205610199,205610651
466,5,12,149,5745,-50,-96,46,5e:29:73:5b:30:00,205616243,540,5052,205615703,205616243
467,5,12,149,5745,-72,-96,24,5e:36:fe:bc:a2:fe,205616828,440,145,205616388,205616828
468,5,12,149,5745,-85,-96,11,d2:00:04:7e:2c:ab,205617320,440,52,205616880,205617320
469,5,12,149,5745,-82,-96,14,22:ec:75:a8:8a:31,205618355,244,791,205618111,205618355
470,5,12,149,5745,-86,-96,10,72:d1:72:1d:22:a1,205619517,256,906,205619261,205619517
471,5,12,149,5745,-78,-96,18,fa:44:8d:e1:c7:1b,205622644,440,2687,205622204,205622644
472,5,12,149,5745,-66,-96,30,3e:d1:9b:c7:a4:de,205624027,544,839,205623483,205624027
473,5,12,149,5745,-80,-96,16,c2:21:7d:48:b5:63,205625263,240,996,205625023,205625263
474,5,12,149,5745,-54,-96,42,f2:da:61:dd:98:c5,205627648,268,2117,205627380,205627648
475,5,12,149,5745,-82,-96,14,56:68:e2:c2:8d:d5,205634285,280,6357,205634005,205634285
476,5,12,149,5745,-78,-96,18,fa:44:8d:e1:c7:1b,205652106,244,17577,205651862,205652106
477,5,12,149,5745,-78,-96,18,a6:92:ad:b7:76:65,205652393,256,31,205652137,205652393
478,5,12,149,5745,-79,-96,17,22:ec:75:a8:8a:31,205667844,516,14935,205667328,205667844
479,5,12,149,5745,-82,-96,14,d2:00:04:7e:2c:ab,205668558,244,470,205668314,205668558
480,5,12,149,5745,-55,-96,41,f2:da:61:dd:98:c5,205670447,268,1621,205670179,205670447
481,5,12,149,5745,-82,-96,14,56:68:e2:c2:8d:d5,205671308,476,385,205670832,205671308
482,5,12,149,5745,-71,-96,25,9a:24:38:da:96:bb,205675158,824,3026,205674334,205675158
483,5,12,149,5745,-70,-96,26,9a:24:38:da:96:bb,205678396,356,2882,205678040,205678396
484,5,12,149,5745,-78,-96,18,a6:92:ad:b7:76:65,205682222,456,3370,205681766,205682222
485,5,12,149,5745,-83,-96,13,d2:00:04:7e:2c:ab,205682714,440,52,205682274,205682714
486,5,12,149,5745,-78,-96,18,f6:0a:5c:59:72:df,205683215,448,53,205682767,205683215
487,5,12,149,5745,-83,-96,13,72:d1:72:1d:22:a1,205684437,452,770,205683985,205684437
488,5,12,149,5745,-73,-96,23,0a:b9:b7:b1:4d:fa,205685382,268,677,205685114,205685382
489,5,12,149,5745,-68,-96,28,3e:d1:9b:c7:a4:de,205685720,272,66,205685448,205685720
490,5,12,149,5745,-74,-96,22,fa:44:8d:e1:c7:1b,205686028,440,-132,205685588,205686028
491,5,12,149,5745,-48,-96,48,5e:29:73:5b:30:00,205687501,540,933,205686961,205687501
492,5,12,149,5745,-48,-96,48,5e:29:73:5b:30:00,205688058,272,285,205687786,205688058
493,5,12,149,5745,-55,-96,41,f2:da:61:dd:98:c5,205688401,268,75,205688133,205688401
494,5,12,149,5745,-68,-96,28,3e:d1:9b:c7:a4:de,205690246,544,1301,205689702,205690246
495,5,12,149,5745,-74,-96,22,5e:36:fe:bc:a2:fe,205694347,356,3745,205693991,205694347
496,5,12,149,5745,-74,-96,22,5e:36:fe:bc:a2:fe,205694854,132,375,205694722,205694854
497,5,12,149,5745,-81,-96,15,c2:21:7d:48:b5:63,205699808,240,4714,205699568,205699808
498,5,6,149,5745,-88,-96,8,54:e4:3a:ec:fb:65,205705213,360,5045,205704853,205705213
499,5,12,149,5745,-68,-96,28,9a:24:38:da:96:bb,205710378,272,4893,205710106,205710378
500,5,12,149,5745,-75,-96,21,22:ec:75:a8:8a:31,205719279,244,8657,205719035,205719279
501,5,12,149,5745,-75,-96,21,f6:0a:5c:59:72:df,205734873,252,15342,205734621,205734873
502,5,12,149,5745,-69,-96,27,9a:24:38:da:96:bb,205740923,824,5226,205740099,205740923
503,5,12,149,5745,-85,-96,11,d2:00:04:7e:2c:ab,205748256,440,6893,205747816,205748256
504,5,12,149,5745,-85,-96,11,72:d1:72:1d:22:a1,205748768,256,256,205748512,205748768
505,5,12,149,5745,-50,-96,46,5e:29:73:5b:30:00,205754476,540,5168,205753936,205754476
506,5,12,149,5745,-79,-96,17,56:68:e2:c2:8d:d5,205757527,280,2771,205757247,205757527
507,5,12,149,5745,-76,-96,20,fa:44:8d:e1:c7:1b,205768250,244,10479,205768006,205768250
508,5,12,149,5745,-78,-96,18,a6:92:ad:b7:76:65,205779218,256,10712,205778962,205779218
509,5,12,149,5745,-84,-96,12,d2:00:04:7e:2c:ab,205784119,244,4657,205783875,205784119
510,5,12,149,5745,-65,-96,31,3e:d1:9b:c7:a4:de,205788652,272,4261,205788380,205788652
511,5,12,149,5745,-51,-96,45,f2:da:61:dd:98:c5,205790132,268,1212,205789864,205790132
512,5,12,149,5745,-49,-96,47,5e:29:73:5b:30:00,205802584,272,12180,205802312,205802584
513,5,6,149,5745,-89,-96,7,54:e4:3a:ec:fb:65,205807614,360,4670,205807254,205807614
514,5,12,149,5745,-48,-96,48,5e:29:73:5b:30:00,205819664,540,11510,205819124,205819664
515,5,12,149,5745,-72,-96,24,9a:24:38:da:96:bb,205823374,272,3438,205823102,205823374
516,5,12,149,5745,-80,-96,16,c2:21:7d:48:b5:63,205826101,240,2487,205825861,205826101
517,5,12,149,5745,-75,-96,21,22:ec:75:a8:8a:31,205834040,244,7695,205833796,205834040
518,5,12,149,5745,-48,-96,48,5e:29:73:5b:30:00,205885618,540,51038,205885078,205885618
519,5,12,149,5745,-52,-96,44,f2:da:61:dd:98:c5,205903080,268,17194,205902812,205903080
520,5,12,149,5745,-66,-96,30,3e:d1:9b:c7:a4:de,205905988,272,2636,205905716,205905988
521,5,6,149,5745,-88,-96,8,54:e4:3a:ec:fb:65,205910014,360,3666,205909654,205910014
522,5,12,149,5745,-48,-96,48,5e:29:73:5b:30:00,205918079,272,7793,205917807,205918079
523,5,12,149,5745,-78,-96,18,a6:92:ad:b7:76:65,205933315,256,14980,205933059,205933315
524,5,12,149,5745,-78,-96,18,fa:44:8d:e1:c7:1b,205934680,244,1121,205934436,205934680
525,5,12,149,5745,-84,-96,12,72:d1:72:1d:22:a1,205934968,256,32,205934712,205934968
526,5,12,149,5745,-86,-96,10,d2:00:04:7e:2c:ab,205936205,244,993,205935961,205936205
527,5,12,149,5745,-80,-96,16,56:68:e2:c2:8d:d5,205937291,280,806,205937011,205937291
528,5,12,149,5745,-76,-96,20,c2:21:7d:48:b5:63,205939488,240,1957,205939248,205939488
529,5,12,149,5745,-72,-96,24,9a:24:38:da:96:bb,205940077,272,317,205939805,205940077
530,5,12,149,5745,-76,-96,20,22:ec:75:a8:8a:31,205951100,244,10779,205950856,205951100
531,5,6,149,5745,-89,-96,7,54:e4:3a:ec:fb:65,206012415,360,60955,206012055,206012415
532,5,12,149,5745,-50,-96,46,f2:da:61:dd:98:c5,206016239,268,3556,206015971,206016239
533,5,12,149,5745,-63,-96,33,3e:d1:9b:c7:a4:de,206017666,272,1155,206017394,206017666
534,5,12,149,5745,-46,-96,50,5e:29:73:5b:30:00,206023520,272,5582,206023248,206023520
535,5,12,149,5745,-77,-96,19,a6:92:ad:b7:76:65,206034894,256,11118,206034638,206034894
536,5,12,149,5745,-84,-96,12,d2:00:04:7e:2c:ab,206036719,244,1581,206036475,206036719
537,5,12,149,5745,-83,-96,13,72:d1:72:1d:22:a1,206037173,256,198,206036917,206037173
538,5,12,149,5745,-79,-96,17,fa:44:8d:e1:c7:1b,206037625,244,208,206037381,206037625
539,5,12,149,5745,-83,-96,13,56:68:e2:c2:8d:d5,206039244,280,1339,206038964,206039244
540,5,12,149,5745,-78,-96,18,c2:21:7d:48:b5:63,206045638,240,6154,206045398,206045638
541,5,12,149,5745,-78,-96,18,f6:0a:5c:59:72:df,206058965,252,13075,206058713,206058965
542,5,12,149,5745,-74,-96,22,22:ec:75:a8:8a:31,206063107,516,3626,206062591,206063107
543,5,12,149,5745,-72,-96,24,9a:24:38:da:96:bb,206068727,824,4796,206067903,206068727
544,5,12,149,5745,-74,-96,22,5e:36:fe:bc:a2:fe,206074970,440,5803,206074530,206074970
545,5,12,149,5745,-77,-96,19,f6:0a:5c:59:72:df,206075534,448,116,206075086,206075534
546,5,12,149,5745,-76,-96,20,a6:92:ad:b7:76:65,206076043,456,53,206075587,206076043
547,5,12,149,5745,-84,-96,12,d2:00:04:7e:2c:ab,206076535,440,52,206076095,206076535
548,5,12,149,5745,-74,-96,22,22:ec:75:a8:8a:31,206077009,244,230,206076765,206077009
549,5,12,149,5745,-82,-96,14,56:68:e2:c2:8d:d5,206077296,476,-189,206076820,206077296
550,5,12,149,5745,-83,-96,13,56:68:e2:c2:8d:d5,206077789,280,213,206077509,206077789
551,5,12,149,5745,-84,-96,12,72:d1:72:1d:22:a1,206078104,452,-137,206077652,206078104
552,5,12,149,5745,-82,-96,14,72:d1:72:1d:22:a1,206078644,256,284,206078388,206078644
553,5,12,149,5745,-48,-96,48,f2:da:61:dd:98:c5,206080996,268,2084,206080728,206080996
554,5,12,149,5745,-78,-96,18,c2:21:7d:48:b5:63,206082306,240,1070,206082066,206082306
555,5,12,149,5745,-63,-96,33,3e:d1:9b:c7:a4:de,206082580,544,-270,206082036,206082580
556,5,12,149,5745,-73,-96,23,5e:36:fe:bc:a2:fe,206084756,156,2020,206084600,206084756
557,5,12,149,5745,-44,-96,52,5e:29:73:5b:30:00,206084946,540,-350,206084406,206084946
558,5,12,149,5745,-76,-96,20,a6:92:ad:b7:76:65,206111114,256,25912,206110858,206111114
559,5,6,149,5745,-89,-96,7,54:e4:3a:ec:fb:65,206114815,360,3341,206114455,206114815
560,5,12,149,5745,-85,-96,11,d2:00:04:7e:2c:ab,206127264,244,12205,206127020,206127264
561,5,12,149,5745,-75,-96,21,9a:24:38:da:96:bb,206134001,824,5913,206133177,206134001
562,5,12,149,5745,-64,-96,32,3e:d1:9b:c7:a4:de,206134913,272,640,206134641,206134913
563,5,12,149,5745,-80,-96,16,f6:0a:5c:59:72:df,206140511,448,5150,206140063,206140511
564,5,12,149,5745,-53,-96,43,f2:da:61:dd:98:c5,206141029,268,250,206140761,206141029
565,5,12,149,5745,-85,-96,11,d2:00:04:7e:2c:ab,206141566,440,97,206141126,206141566
566,5,12,149,5745,-74,-96,22,5e:36:fe:bc:a2:fe,206142049,440,43,206141609,206142049
567,5,12,149,5745,-79,-96,17,c2:21:7d:48:b5:63,206146303,240,4014,206146063,206146303
568,5,12,149,5745,-45,-96,51,5e:29:73:5b:30:00,206146640,272,65,206146368,206146640
569,5,12,149,5745,-45,-96,51,5e:29:73:5b:30:00,206147212,540,32,206146672,206147212
570,5,12,149,5745,-78,-96,18,c2:21:7d:48:b5:63,206158532,240,11080,206158292,206158532
571,5,12,149,5745,-76,-96,20,9a:24:38:da:96:bb,206159518,272,714,206159246,206159518
572,5,12,149,5745,-79,-96,17,f6:0a:5c:59:72:df,206170596,252,10826,206170344,206170596
573,5,12,149,5745,-78,-96,18,22:ec:75:a8:8a:31,206192289,244,21449,206192045,206192289
574,5,12,149,5745,-78,-96,18,22:ec:75:a8:8a:31,206192550,516,-255,206192034,206192550
575,5,12,149,5745,-79,-96,17,fa:44:8d:e1:c7:1b,206194412,440,1422,206193972,206194412
576,5,12,149,5745,-75,-96,21,9a:24:38:da:96:bb,206198758,824,3522,206197934,206198758
577,5,12,149,5745,-80,-96,16,f6:0a:5c:59:72:df,206206435,448,7229,206205987,206206435
578,5,12,149,5745,-85,-96,11,d2:00:04:7e:2c:ab,206206946,440,71,206206506,206206946
579,5,12,149,5745,-74,-96,22,5e:36:fe:bc:a2:fe,206207419,440,33,206206979,206207419
580,5,12,149,5745,-76,-96,20,a6:92:ad:b7:76:65,206209368,456,1493,206208912,206209368
581,5,12,149,5745,-73,-96,23,0a:b9:b7:b1:4d:fa,206209885,268,249,206209617,206209885
582,5,12,149,5745,-77,-96,19,c2:21:7d:48:b5:63,206211366,240,1241,206211126,206211366
583,5,12,149,5745,-51,-96,45,f2:da:61:dd:98:c5,206212162,268,528,206211894,206212162
584,5,12,149,5745,-46,-96,50,5e:29:73:5b:30:00,206213319,540,617,206212779,206213319
585,5,12,149,5745,-65,-96,31,3e:d1:9b:c7:a4:de,206216781,544,2918,206216237,206216781
586,5,6,149,5745,-89,-96,7,54:e4:3a:ec:fb:65,206217357,360,216,206216997,206217357
587,5,12,149,5745,-76,-96,20,a6:92:ad:b7:76:65,206225558,256,7945,206225302,206225558
588,5,12,149,5745,-50,-96,46,f2:da:61:dd:98:c5,206227371,268,1545,206227103,206227371
589,5,12,149,5745,-82,-96,14,72:d1:72:1d:22:a1,206241626,256,13999,206241370,206241626
590,5,12,149,5745,-84,-96,12,d2:00:04:7e:2c:ab,206242925,244,1055,206242681,206242925
591,5,12,149,5745,-80,-96,16,56:68:e2:c2:8d:d5,206244075,280,870,206243795,206244075
592,5,24,149,5745,-78,-96,18,,206244403,28,300,206244375,206244403
593,5,12,149,5745,-64,-96,32,3e:d1:9b:c7:a4:de,206247258,272,2583,206246986,206247258
594,5,12,149,5745,-46,-96,50,5e:29:73:5b:30:00,206261324,272,13794,206261052,206261324
595,5,12,149,5745,-72,-96,24,9a:24:38:da:96:bb,206265010,824,2862,206264186,206265010
596,5,12,149,5745,-71,-96,25,9a:24:38:da:96:bb,206272610,272,7328,206272338,206272610
597,5,12,149,5745,-77,-96,19,c2:21:7d:48:b5:63,206277875,240,5025,206277635,206277875
598,5,12,149,5745,-46,-96,50,5e:29:73:5b:30:00,206278356,540,-59,206277816,206278356
599,5,12,149,5745,-79,-96,17,22:ec:75:a8:8a:31,206295129,244,16529,206294885,206295129
600,5,6,149,5745,-86,-96,10,54:e4:3a:ec:fb:65,206319616,360,24127,206319256,206319616
601,5,12,149,5745,-48,-96,48,5e:29:73:5b:30:00,206343803,540,23647,206343263,206343803
602,5,12,149,5745,-78,-96,18,a6:92:ad:b7:76:65,206344395,256,336,206344139,206344395
603,5,12,149,5745,-85,-96,11,72:d1:72:1d:22:a1,206344732,256,81,206344476,206344732
604,5,12,149,5745,-78,-96,18,56:68:e2:c2:8d:d5,206345913,280,901,206345633,206345913
605,5,12,149,5745,-85,-96,11,d2:00:04:7e:2c:ab,206356287,244,10130,206356043,206356287
606,5,12,149,5745,-63,-96,33,3e:d1:9b:c7:a4:de,206364420,272,7861,206364148,206364420
607,5,12,149,5745,-48,-96,48,5e:29:73:5b:30:00,206376327,272,11635,206376055,206376327
608,5,12,149,5745,-72,-96,24,9a:24:38:da:96:bb,206385544,272,8945,206385272,206385544
609,5,12,149,5745,-77,-96,19,f6:0a:5c:59:72:df,206405791,252,19995,206405539,206405791
610,5,12,149,5745,-75,-96,21,22:ec:75:a8:8a:31,206407930,244,1895,206407686,206407930
611,5,12,149,5745,-48,-96,48,5e:29:73:5b:30:00,206409945,540,1475,206409405,206409945
612,5,6,149,5745,-88,-96,8,54:e4:3a:ec:fb:65,206422017,360,11712,206421657,206422017
613,5,12,149,5745,-46,-96,50,f2:da:61:dd:98:c5,206423658,268,1373,206423390,206423658
614,5,6,149,5745,-76,-96,20,24:f6:77:10:02:c8,206432214,100,8456,206432114,206432214
615,5,6,149,5745,-76,-96,20,24:f6:77:10:02:c8,206432331,92,25,206432239,206432331
616,5,6,149,5745,-76,-96,20,24:f6:77:10:02:c8,206432440,92,17,206432348,206432440
617,5,12,149,5745,-74,-96,22,c2:21:7d:48:b5:63,206446044,240,13364,206445804,206446044
618,5,12,149,5745,-84,-96,12,72:d1:72:1d:22:a1,206446337,256,37,206446081,206446337
619,5,6,149,5745,-76,-96,20,24:f6:77:10:02:c8,206451992,100,5555,206451892,206451992
620,5,6,149,5745,-76,-96,20,24:f6:77:10:02:c8,206452109,92,25,206452017,206452109
621,5,6,149,5745,-77,-96,19,24:f6:77:10:02:c8,206452218,92,17,206452126,206452218
622,5,12,149,5745,-80,-96,16,56:68:e2:c2:8d:d5,206454147,280,1649,206453867,206454147
623,5,12,149,5745,-76,-96,20,a6:92:ad:b7:76:65,206457175,256,2772,206456919,206457175
624,5,12,149,5745,-49,-96,47,5e:29:73:5b:30:00,206477064,272,19617,206476792,206477064
625,5,12,149,5745,-63,-96,33,3e:d1:9b:c7:a4:de,206481519,272,4183,206481247,206481519
626,5,12,149,5745,-71,-96,25,9a:24:38:da:96:bb,206500788,272,18997,206500516,206500788
627,5,12,149,5745,-78,-96,18,22:ec:75:a8:8a:31,206525095,244,24063,206524851,206525095
628,5,12,149,5745,-46,-96,50,f2:da:61:dd:98:c5,206525740,268,377,206525472,206525740
629,5,24,149,5745,-91,-96,5,,206538760,28,12992,206538732,206538760
630,5,12,149,5745,-82,-96,14,d2:00:04:7e:2c:ab,206548206,244,9202,206547962,206548206
631,5,12,149,5745,-75,-96,21,c2:21:7d:48:b5:63,206548546,240,100,206548306,206548546
632,5,12,149,5745,-83,-96,13,72:d1:72:1d:22:a1,206548867,256,65,206548611,206548867
633,5,12,149,5745,-79,-96,17,56:68:e2:c2:8d:d5,206551207,280,2060,206550927,206551207
634,5,12,149,5745,-74,-96,22,a6:92:ad:b7:76:65,206579086,256,27623,206578830,206579086
635,5,12,149,5745,-81,-96,15,d2:00:04:7e:2c:ab,206584859,244,5529,206584615,206584859
636,5,12,149,5745,-50,-96,46,5e:29:73:5b:30:00,206588959,272,3828,206588687,206588959
637,5,12,149,5745,-65,-96,31,3e:d1:9b:c7:a4:de,206593435,272,4204,206593163,206593435
638,5,12,149,5745,-80,-96,16,c2:21:7d:48:b5:63,206617179,240,23504,206616939,206617179
639,5,6,149,5745,-89,-96,7,54:e4:3a:ec:fb:65,206626818,360,9279,206626458,206626818
640,5,12,149,5745,-48,-96,48,f2:da:61:dd:98:c5,206627614,268,528,206627346,206627614
641,5,12,149,5745,-79,-96,17,56:68:e2:c2:8d:d5,206650101,280,22207,206649821,206650101
642,5,12,149,5745,-79,-96,17,22:ec:75:a8:8a:31,206650442,244,97,206650198,206650442
643,5,12,149,5745,-79,-96,17,22:ec:75:a8:8a:31,206650702,516,-256,206650186,206650702
644,5,12,149,5745,-80,-96,16,72:d1:72:1d:22:a1,206653684,256,2726,206653428,206653684
645,5,12,149,5745,-72,-96,24,5e:36:fe:bc:a2:fe,206657097,440,2973,206656657,206657097
646,5,12,149,5745,-74,-96,22,9a:24:38:da:96:bb,206657701,824,-220,206656877,206657701
647,5,12,149,5745,-75,-96,21,f6:0a:5c:59:72:df,206665719,448,7570,206665271,206665719
648,5,12,149,5745,-75,-96,21,a6:92:ad:b7:76:65,206666255,456,80,206665799,206666255
649,5,12,149,5745,-81,-96,15,d2:00:04:7e:2c:ab,206667465,440,770,206667025,206667465
650,5,12,149,5745,-75,-96,21,a6:92:ad:b7:76:65,206668059,256,338,206667803,206668059
651,5,12,149,5745,-79,-96,17,56:68:e2:c2:8d:d5,206668350,476,-185,206667874,206668350
652,5,12,149,5745,-50,-96,46,f2:da:61:dd:98:c5,206669247,268,629,206668979,206669247
653,5,12,149,5745,-81,-96,15,72:d1:72:1d:22:a1,206671726,452,2027,206671274,206671726
654,5,12,149,5745,-47,-96,49,5e:29:73:5b:30:00,206672258,540,-8,206671718,206672258
655,5,12,149,5745,-68,-96,28,3e:d1:9b:c7:a4:de,206672877,544,75,206672333,206672877
656,5,12,149,5745,-76,-96,20,c2:21:7d:48:b5:63,206673502,240,385,206673262,206673502
657,5,12,149,5745,-81,-96,15,d2:00:04:7e:2c:ab,206684245,244,10499,206684001,206684245
658,5,12,149,5745,-51,-96,45,f2:da:61:dd:98:c5,206686066,268,1553,206685798,206686066
659,5,12,149,5745,-75,-96,21,22:ec:75:a8:8a:31,206716464,516,29882,206715948,206716464
660,5,12,149,5745,-67,-96,29,3e:d1:9b:c7:a4:de,206717850,272,1114,206717578,206717850
661,5,12,149,5745,-76,-96,20,c2:21:7d:48:b5:63,206718344,240,254,206718104,206718344
662,5,12,149,5745,-70,-96,26,fa:44:8d:e1:c7:1b,206718799,440,15,206718359,206718799
663,5,12,149,5745,-71,-96,25,5e:36:fe:bc:a2:fe,206719300,440,61,206718860,206719300
664,5,12,149,5745,-46,-96,50,5e:29:73:5b:30:00,206720261,272,689,206719989,206720261
665,5,12,149,5745,-46,-96,50,5e:29:73:5b:30:00,206721170,540,369,206720630,206721170
666,5,12,149,5745,-75,-96,21,9a:24:38:da:96:bb,206723149,824,1155,206722325,206723149
667,5,6,149,5745,-90,-96,6,54:e4:3a:ec:fb:65,206729219,360,5710,206728859,206729219
668,5,12,149,5745,-78,-96,18,56:68:e2:c2:8d:d5,206729826,476,131,206729350,206729826
669,5,12,149,5745,-74,-96,22,f6:0a:5c:59:72:df,206730390,448,116,206729942,206730390
670,5,12,149,5745,-72,-96,24,a6:92:ad:b7:76:65,206730881,456,35,206730425,206730881
671,5,12,149,5745,-79,-96,17,d2:00:04:7e:2c:ab,206731391,440,70,206730951,206731391
672,5,12,149,5745,-73,-96,23,0a:b9:b7:b1:4d:fa,206733899,268,2240,206733631,206733899
673,5,12,149,5745,-79,-96,17,d2:00:04:7e:2c:ab,206734282,380,3,206733902,206734282
674,5,12,149,5745,-48,-96,48,f2:da:61:dd:98:c5,206734696,268,146,206734428,206734696
675,5,12,149,5745,-76,-96,20,f6:0a:5c:59:72:df,206735304,252,356,206735052,206735304
676,5,12,149,5745,-80,-96,16,72:d1:72:1d:22:a1,206735646,452,-110,206735194,206735646
677,5,12,149,5745,-72,-96,24,5e:36:fe:bc:a2:fe,206737011,116,1249,206736895,206737011
678,5,12,149,5745,-72,-96,24,5e:36:fe:bc:a2:fe,206737188,356,-179,206736832,206737188
679,5,12,149,5745,-65,-96,31,3e:d1:9b:c7:a4:de,206737714,544,-18,206737170,206737714
680,5,12,149,5745,-76,-96,20,c2:21:7d:48:b5:63,206738537,240,583,206738297,206738537
681,5,12,149,5745,-81,-96,15,72:d1:72:1d:22:a1,206751962,256,13169,206751706,206751962
682,5,12,149,5745,-78,-96,18,56:68:e2:c2:8d:d5,206765761,280,13519,206765481,206765761
683,5,12,149,5745,-73,-96,23,22:ec:75:a8:8a:31,206766120,244,115,206765876,206766120
684,5,12,149,5745,-73,-96,23,a6:92:ad:b7:76:65,206796383,256,30007,206796127,206796383
685,5,12,149,5745,-78,-96,18,d2:00:04:7e:2c:ab,206796720,440,-103,206796280,206796720
686,5,12,149,5745,-78,-96,18,d2:00:04:7e:2c:ab,206798978,244,2014,206798734,206798978
687,5,12,149,5745,-47,-96,49,f2:da:61:dd:98:c5,206808390,268,9144,206808122,206808390
688,5,12,149,5745,-52,-96,44,5e:29:73:5b:30:00,206816746,272,8084,206816474,206816746
689,5,12,149,5745,-65,-96,31,3e:d1:9b:c7:a4:de,206823065,272,6047,206822793,206823065
690,5,6,149,5745,-90,-96,6,54:e4:3a:ec:fb:65,206831619,360,8194,206831259,206831619
691,5,12,149,5745,-70,-96,26,c2:21:7d:48:b5:63,206841786,240,9927,206841546,206841786
692,5,12,149,5745,-71,-96,25,f6:0a:5c:59:72:df,206862642,252,20604,206862390,206862642
693,5,12,149,5745,-76,-96,20,22:ec:75:a8:8a:31,206866609,244,3723,206866365,206866609
694,5,12,149,5745,-74,-96,22,9a:24:38:da:96:bb,206890924,272,24043,206890652,206890924
695,5,12,149,5745,-52,-96,44,5e:29:73:5b:30:00,206934368,272,43172,206934096,206934368
696,5,12,149,5745,-46,-96,50,f2:da:61:dd:98:c5,206934782,268,146,206934514,206934782
697,5,12,149,5745,-66,-96,30,3e:d1:9b:c7:a4:de,206939519,272,4465,206939247,206939519
698,5,12,149,5745,-71,-96,25,c2:21:7d:48:b5:63,206955032,240,15273,206954792,206955032
699,5,12,149,5745,-72,-96,24,a6:92:ad:b7:76:65,206957688,256,2400,206957432,206957688
700,5,12,149,5745,-78,-96,18,d2:00:04:7e:2c:ab,206958388,244,456,206958144,206958388
701,5,12,149,5745,-81,-96,15,72:d1:72:1d:22:a1,206958844,256,200,206958588,206958844
702,5,12,149,5745,-78,-96,18,56:68:e2:c2:8d:d5,206961420,280,2296,206961140,206961420
703,5,12,149,5745,-71,-96,25,f6:0a:5c:59:72:df,206980955,252,19283,206980703,206980955
704,5,12,149,5745,-72,-96,24,22:ec:75:a8:8a:31,206982329,244,1130,206982085,206982329
705,5,12,149,5745,-75,-96,21,9a:24:38:da:96:bb,207014148,272,31547,207013876,207014148
706,5,6,149,5745,-87,-96,9,54:e4:3a:ec:fb:65,207036420,360,21912,207036060,207036420
707,5,12,149,5745,-49,-96,47,f2:da:61:dd:98:c5,207037434,268,746,207037166,207037434
708,5,12,149,5745,-49,-96,47,5e:29:73:5b:30:00,207050242,272,12536,207049970,207050242
709,5,12,149,5745,-62,-96,34,3e:d1:9b:c7:a4:de,207055919,272,5405,207055647,207055919
710,5,12,149,5745,-71,-96,25,a6:92:ad:b7:76:65,207059779,256,3604,207059523,207059779
711,5,12,149,5745,-81,-96,15,d2:00:04:7e:2c:ab,207060668,244,645,207060424,207060668
712,5,12,149,5745,-79,-96,17,72:d1:72:1d:22:a1,207061445,256,521,207061189,207061445
713,5,12,149,5745,-79,-96,17,56:68:e2:c2:8d:d5,207065073,280,3348,207064793,207065073
714,5,12,149,5745,-75,-96,21,c2:21:7d:48:b5:63,207066883,240,1570,207066643,207066883
715,5,12,149,5745,-78,-96,18,72:d1:72:1d:22:a1,207099093,256,31954,207098837,207099093
716,5,12,149,5745,-75,-96,21,56:68:e2:c2:8d:d5,207108914,280,9541,207108634,207108914
717,5,12,149,5745,-77,-96,19,22:ec:75:a8:8a:31,207109247,244,89,207109003,207109247
718,5,12,149,5745,-77,-96,19,22:ec:75:a8:8a:31,207110776,516,1013,207110260,207110776
719,5,12,149,5745,-75,-96,21,9a:24:38:da:96:bb,207113732,272,2684,207113460,207113732
720,5,12,149,5745,-72,-96,24,5e:36:fe:bc:a2:fe,207115150,440,978,207114710,207115150
721,5,12,149,5745,-53,-96,43,5e:29:73:5b:30:00,207117460,540,1770,207116920,207117460
722,5,12,149,5745,-75,-96,21,f6:0a:5c:59:72:df,207123722,448,5814,207123274,207123722
723,5,12,149,5745,-75,-96,21,56:68:e2:c2:8d:d5,207127164,476,2966,207126688,207127164
724,5,12,149,5745,-76,-96,20,9a:24:38:da:96:bb,207128283,824,295,207127459,207128283
725,5,12,149,5745,-72,-96,24,5e:36:fe:bc:a2:fe,207129302,156,863,207129146,207129302
726,5,12,149,5745,-49,-96,47,f2:da:61:dd:98:c5,207129700,268,130,207129432,207129700
727,5,12,149,5745,-78,-96,18,72:d1:72:1d:22:a1,207130578,452,426,207130126,207130578
728,5,12,149,5745,-75,-96,21,c2:21:7d:48:b5:63,207131066,240,248,207130826,207131066
729,5,12,149,5745,-63,-96,33,3e:d1:9b:c7:a4:de,207133568,544,1958,207133024,207133568
730,5,6,149,5745,-89,-96,7,54:e4:3a:ec:fb:65,207138821,360,4893,207138461,207138821
731,5,12,149,5745,-49,-96,47,f2:da:61:dd:98:c5,207144869,268,5780,207144601,207144869
732,5,12,149,5745,-54,-96,42,5e:29:73:5b:30:00,207163380,272,18239,207163108,207163380
733,5,12,149,5745,-63,-96,33,3e:d1:9b:c7:a4:de,207170172,272,6520,207169900,207170172
734,5,12,149,5745,-76,-96,20,c2:21:7d:48:b5:63,207176473,240,6061,207176233,207176473
735,5,12,149,5745,-71,-96,25,fa:44:8d:e1:c7:1b,207179854,440,2941,207179414,207179854
736,5,12,149,5745,-72,-96,24,5e:36:fe:bc:a2:fe,207187231,440,6937,207186791,207187231
737,5,12,149,5745,-75,-96,21,f6:0a:5c:59:72:df,207189064,448,1385,207188616,207189064
738,5,12,149,5745,-76,-96,20,f6:0a:5c:59:72:df,207189529,252,213,207189277,207189529
739,5,12,149,5745,-77,-96,19,c2:21:7d:48:b5:63,207196962,240,7193,207196722,207196962
740,5,12,149,5745,-76,-96,20,22:ec:75:a8:8a:31,207212788,244,15582,207212544,207212788
741,5,12,149,5745,-81,-96,15,72:d1:72:1d:22:a1,207219059,256,6015,207218803,207219059
742,5,12,149,5745,-71,-96,25,fa:44:8d:e1:c7:1b,207224867,244,5564,207224623,207224867
743,5,12,149,5745,-79,-96,17,9a:24:38:da:96:bb,207225757,272,618,207225485,207225757
744,5,12,149,5745,-75,-96,21,56:68:e2:c2:8d:d5,207235302,280,9265,207235022,207235302
745,5,6,149,5745,-91,-96,5,54:e4:3a:ec:fb:65,207241221,360,5559,207240861,207241221
746,5,12,149,5745,-76,-96,20,22:ec:75:a8:8a:31,207242312,516,575,207241796,207242312
747,5,12,149,5745,-47,-96,49,f2:da:61:dd:98:c5,207243150,268,570,207242882,207243150
748,5,12,149,5745,-69,-96,27,fa:44:8d:e1:c7:1b,207245801,440,2211,207245361,207245801
749,5,12,149,5745,-51,-96,45,5e:29:73:5b:30:00,207247643,540,1302,207247103,207247643
750,5,12,149,5745,-72,-96,24,5e:36:fe:bc:a2:fe,207251729,440,3646,207251289,207251729
751,5,12,149,5745,-75,-96,21,f6:0a:5c:59:72:df,207254570,448,2393,207254122,207254570
752,5,12,149,5745,-74,-96,22,a6:92:ad:b7:76:65,207255097,456,71,207254641,207255097
753,5,12,149,5745,-76,-96,20,9a:24:38:da:96:bb,207257672,824,1751,207256848,207257672
754,5,12,149,5745,-76,-96,20,0a:b9:b7:b1:4d:fa,207258530,268,590,207258262,207258530
755,5,12,149,5745,-47,-96,49,f2:da:61:dd:98:c5,207260831,268,2033,207260563,207260831
756,5,12,149,5745,-76,-96,20,c2:21:7d:48:b5:63,207263302,240,2231,207263062,207263302
757,5,12,149,5745,-61,-96,35,3e:d1:9b:c7:a4:de,207264138,544,292,207263594,207264138
758,5,12,149,5745,-79,-96,17,d2:00:04:7e:2c:ab,207266976,440,2398,207266536,207266976
759,5,12,149,5745,-75,-96,21,c2:21:7d:48:b5:63,207291604,240,24388,207291364,207291604
760,5,12,149,5745,-61,-96,35,3e:d1:9b:c7:a4:de,207292025,272,149,207291753,207292025
761,5,12,149,5745,-51,-96,45,5e:29:73:5b:30:00,207294365,272,2068,207294093,207294365
762,5,12,149,5745,-72,-96,24,f6:0a:5c:59:72:df,207318412,252,23795,207318160,207318412
763,5,12,149,5745,-77,-96,19,22:ec:75:a8:8a:31,207326674,244,8018,207326430,207326674
764,5,24,149,5745,-77,-96,19,,207332971,28,6269,207332943,207332971
765,5,12,149,5745,-77,-96,19,9a:24:38:da:96:bb,207338690,272,5447,207338418,207338690
766,5,6,149,5745,-91,-96,5,54:e4:3a:ec:fb:65,207343622,360,4572,207343262,207343622
767,5,12,149,5745,-71,-96,25,fa:44:8d:e1:c7:1b,207344330,244,464,207344086,207344330
768,5,12,149,5745,-84,-96,12,72:d1:72:1d:22:a1,207368367,256,23781,207368111,207368367
769,5,12,149,5745,-71,-96,25,56:68:e2:c2:8d:d5,207370988,280,2341,207370708,207370988
770,5,12,149,5745,-47,-96,49,5e:29:73:5b:30:00,207388880,272,17620,207388608,207388880
771,5,12,149,5745,-64,-96,32,3e:d1:9b:c7:a4:de,207399287,272,10135,207399015,207399287
772,5,24,149,5745,-83,-96,13,,207421231,32,21912,207421199,207421231
773,5,24,149,5745,-84,-96,12,,207422571,28,1312,207422543,207422571
774,5,24,149,5745,-83,-96,13,,207423622,28,1023,207423594,207423622
775,5,12,149,5745,-72,-96,24,22:ec:75:a8:8a:31,207444800,244,20934,207444556,207444800
776,5,6,149,5745,-88,-96,8,54:e4:3a:ec:fb:65,207446022,360,862,207445662,207446022
777,5,12,149,5745,-47,-96,49,f2:da:61:dd:98:c5,207446983,268,693,207446715,207446983
778,5,12,149,5745,-76,-96,20,9a:24:38:da:96:bb,207454064,272,6809,207453792,207454064
779,5,12,149,5745,-75,-96,21,fa:44:8d:e1:c7:1b,207470125,244,15817,207469881,207470125
780,5,12,149,5745,-70,-96,26,c2:21:7d:48:b5:63,207470771,240,406,207470531,207470771
781,5,12,149,5745,-85,-96,11,72:d1:72:1d:22:a1,207471092,256,65,207470836,207471092
782,5,12,149,5745,-71,-96,25,56:68:e2:c2:8d:d5,207472012,280,640,207471732,207472012
783,5,24,149,5745,-80,-96,16,,207495783,28,23743,207495755,207495783
784,5,24,149,5745,-79,-96,17,,207495891,32,76,207495859,207495891
785,5,24,149,5745,-81,-96,15,,207496828,28,909,207496800,207496828
786,5,12,149,5745,-50,-96,46,5e:29:73:5b:30:00,207506118,272,9018,207505846,207506118
787,5,12,149,5745,-64,-96,32,3e:d1:9b:c7:a4:de,207515070,272,8680,207514798,207515070
788,5,12,149,5745,-46,-96,50,f2:da:61:dd:98:c5,207549096,268,33758,207548828,207549096
789,5,24,149,5745,-78,-96,18,66:48:51:4e:71:fa,207558350,328,8926,207558022,207558350
790,5,24,149,5745,-78,-96,18,66:48:51:4e:71:fa,207558906,328,228,207558578,207558906
791,5,24,149,5745,-79,-96,17,,207559520,28,586,207559492,207559520
792,5,24,149,5745,-78,-96,18,,207559628,32,76,207559596,207559628
793,5,12,149,5745,-72,-96,24,22:ec:75:a8:8a:31,207561842,244,1970,207561598,207561842
794,5,12,149,5745,-72,-96,24,9a:24:38:da:96:bb,207562951,272,837,207562679,207562951
795,5,12,149,5745,-76,-96,20,fa:44:8d:e1:c7:1b,207571989,244,8794,207571745,207571989
796,5,12,149,5745,-84,-96,12,72:d1:72:1d:22:a1,207572736,256,491,207572480,207572736
797,5,12,149,5745,-69,-96,27,c2:21:7d:48:b5:63,207573046,240,70,207572806,207573046
798,5,12,149,5745,-72,-96,24,56:68:e2:c2:8d:d5,207574722,280,1396,207574442,207574722
799,5,12,149,5745,-52,-96,44,5e:29:73:5b:30:00,207623335,272,48341,207623063,207623335
800,5,12,149,5745,-59,-96,37,3e:d1:9b:c7:a4:de,207626980,272,3373,207626708,207626980
801,5,6,149,5745,-91,-96,5,54:e4:3a:ec:fb:65,207650823,360,23483,207650463,207650823
802,5,12,149,5745,-47,-96,49,f2:da:61:dd:98:c5,207651319,268,228,207651051,207651319
803,5,12,149,5745,-71,-96,25,22:ec:75:a8:8a:31,207673657,244,22094,207673413,207673657
804,5,12,149,5745,-71,-96,25,fa:44:8d:e1:c7:1b,207674578,244,677,207674334,207674578
805,5,12,149,5745,-79,-96,17,72:d1:72:1d:22:a1,207675383,256,549,207675127,207675383
806,5,12,149,5745,-68,-96,28,c2:21:7d:48:b5:63,207676028,240,405,207675788,207676028
807,5,12,149,5745,-75,-96,21,56:68:e2:c2:8d:d5,207676887,280,579,207676607,207676887
808,5,12,149,5745,-71,-96,25,22:ec:75:a8:8a:31,207699021,516,21618,207698505,207699021
809,5,12,149,5745,-48,-96,48,f2:da:61:dd:98:c5,207701956,268,2667,207701688,207701956
810,5,12,149,5745,-72,-96,24,fa:44:8d:e1:c7:1b,207704508,440,2112,207704068,207704508
811,5,12,149,5745,-50,-96,46,5e:29:73:5b:30:00,207705009,540,-39,207704469,207705009
812,5,12,149,5745,-68,-96,28,5e:36:fe:bc:a2:fe,207711462,440,6013,207711022,207711462
813,5,12,149,5745,-74,-96,22,56:68:e2:c2:8d:d5,207713142,476,1204,207712666,207713142
814,5,12,149,5745,-71,-96,25,f6:0a:5c:59:72:df,207714120,448,530,207713672,207714120
815,5,12,149,5745,-80,-96,16,72:d1:72:1d:22:a1,207718215,452,3643,207717763,207718215
816,5,12,149,5745,-49,-96,47,f2:da:61:dd:98:c5,207720626,268,2143,207720358,207720626
817,5,12,149,5745,-60,-96,36,3e:d1:9b:c7:a4:de,207721100,544,-70,207720556,207721100
818,5,12,149,5745,-68,-96,28,c2:21:7d:48:b5:63,207721734,240,394,207721494,207721734
819,5,12,149,5745,-68,-96,28,c2:21:7d:48:b5:63,207733528,240,11554,207733288,207733528
820,5,12,149,5745,-60,-96,36,3e:d1:9b:c7:a4:de,207750295,272,16495,207750023,207750295
821,5,12,149,5745,-50,-96,46,5e:29:73:5b:30:00,207750646,272,79,207750374,207750646
822,5,12,149,5745,-71,-96,25,22:ec:75:a8:8a:31,207765080,516,13918,207764564,207765080
823,5,12,149,5745,-50,-96,46,5e:29:73:5b:30:00,207767491,540,1871,207766951,207767491
824,5,12,149,5745,-79,-96,17,72:d1:72:1d:22:a1,207768112,256,365,207767856,207768112
825,5,12,149,5745,-70,-96,26,fa:44:8d:e1:c7:1b,207769519,440,967,207769079,207769519
826,5,12,149,5745,-68,-96,28,5e:36:fe:bc:a2:fe,207774025,440,4066,207773585,207774025
827,5,12,149,5745,-76,-96,20,9a:24:38:da:96:bb,207774509,824,-340,207773685,207774509
828,5,12,149,5745,-76,-96,20,9a:24:38:da:96:bb,207775378,356,513,207775022,207775378
829,5,12,149,5745,-69,-96,27,c2:21:7d:48:b5:63,207776797,240,1179,207776557,207776797
830,5,12,149,5745,-75,-96,21,56:68:e2:c2:8d:d5,207778601,476,1328,207778125,207778601
831,5,12,149,5745,-73,-96,23,f6:0a:5c:59:72:df,207779255,448,206,207778807,207779255
832,5,12,149,5745,-76,-96,20,a6:92:ad:b7:76:65,207779745,456,34,207779289,207779745
833,5,12,149,5745,-75,-96,21,56:68:e2:c2:8d:d5,207780767,280,742,207780487,207780767
834,5,12,149,5745,-73,-96,23,0a:b9:b7:b1:4d:fa,207782506,268,1471,207782238,207782506
835,5,12,149,5745,-70,-96,26,fa:44:8d:e1:c7:1b,207782843,244,93,207782599,207782843
836,5,12,149,5745,-51,-96,45,f2:da:61:dd:98:c5,207783223,268,112,207782955,207783223
837,5,12,149,5745,-78,-96,18,72:d1:72:1d:22:a1,207784596,452,921,207784144,207784596
838,5,12,149,5745,-76,-96,20,9a:24:38:da:96:bb,207785979,272,1111,207785707,207785979
839,5,12,149,5745,-59,-96,37,3e:d1:9b:c7:a4:de,207786400,544,-123,207785856,207786400
840,5,12,149,5745,-81,-96,15,d2:00:04:7e:2c:ab,207793359,440,6519,207792919,207793359
841,5,12,149,5745,-72,-96,24,22:ec:75:a8:8a:31,207797109,244,3506,207796865,207797109
842,5,12,149,5745,-51,-96,45,f2:da:61:dd:98:c5,207817199,268,19822,207816931,207817199
843,5,12,149,5745,-49,-96,47,5e:29:73:5b:30:00,207848038,272,30567,207847766,207848038
844,5,12,149,5745,-62,-96,34,3e:d1:9b:c7:a4:de,207854229,272,5919,207853957,207854229
845,5,6,149,5745,-89,-96,7,54:e4:3a:ec:fb:65,207855624,360,1035,207855264,207855624
846,5,12,149,5745,-69,-96,27,c2:21:7d:48:b5:63,207856623,240,759,207856383,207856623
847,5,12,149,5745,-78,-96,18,72:d1:72:1d:22:a1,207893497,256,36618,207893241,207893497
848,5,12,149,5745,-80,-96,16,9a:24:38:da:96:bb,207898541,272,4772,207898269,207898541
849,5,12,149,5745,-74,-96,22,22:ec:75:a8:8a:31,207903379,244,4594,207903135,207903379
850,5,24,149,5745,-75,-96,21,,207956419,28,53012,207956391,207956419
851,5,6,149,5745,-90,-96,6,54:e4:3a:ec:fb:65,207958025,360,1246,207957665,207958025
852,5,12,149,5745,-54,-96,42,f2:da:61:dd:98:c5,207958582,268,289,207958314,207958582
853,5,12,149,5745,-52,-96,44,5e:29:73:5b:30:00,207963860,272,5006,207963588,207963860
854,5,12,149,5745,-65,-96,31,3e:d1:9b:c7:a4:de,207968104,272,3972,207967832,207968104
855,5,12,149,5745,-73,-96,23,fa:44:8d:e1:c7:1b,207981874,244,13526,207981630,207981874
856,5,12,149,5745,-70,-96,26,c2:21:7d:48:b5:63,207982477,240,363,207982237,207982477
857,5,12,149,5745,-77,-96,19,56:68:e2:c2:8d:d5,207984821,280,2064,207984541,207984821
858,5,24,149,5745,-75,-96,21,,208010078,28,25229,208010050,208010078
859,5,12,149,5745,-75,-96,21,22:ec:75:a8:8a:31,208020207,244,9885,208019963,208020207
860,5,6,149,5745,-90,-96,6,54:e4:3a:ec:fb:65,208060425,360,39858,208060065,208060425
861,5,12,149,5745,-51,-96,45,f2:da:61:dd:98:c5,208060984,268,291,208060716,208060984
862,5,12,149,5745,-50,-96,46,5e:29:73:5b:30:00,208080760,272,19504,208080488,208080760
863,5,12,149,5745,-61,-96,35,3e:d1:9b:c7:a4:de,208081599,272,567,208081327,208081599
864,5,12,149,5745,-71,-96,25,c2:21:7d:48:b5:63,208085008,240,3169,208084768,208085008
865,5,12,149,5745,-78,-96,18,72:d1:72:1d:22:a1,208085320,256,56,208085064,208085320
866,5,12,149,5745,-74,-96,22,fa:44:8d:e1:c7:1b,208085717,244,153,208085473,208085717
867,5,12,149,5745,-75,-96,21,56:68:e2:c2:8d:d5,208086987,280,990,208086707,208086987
868,5,12,149,5745,-74,-96,22,f6:0a:5c:59:72:df,208097765,252,10526,208097513,208097765
869,5,12,149,5745,-77,-96,19,72:d1:72:1d:22:a1,208120582,256,22561,208120326,208120582
870,5,12,149,5745,-70,-96,26,9a:24:38:da:96:bb,208125690,272,4836,208125418,208125690
871,5,12,149,5745,-73,-96,23,56:68:e2:c2:8d:d5,208131770,280,5800,208131490,208131770
872,5,6,149,5745,-85,-96,11,74:a2:e6:10:5d:50,208133983,168,2045,208133815,208133983
873,5,12,149,5745,-78,-96,18,fa:44:8d:e1:c7:1b,208134773,244,546,208134529,208134773
874,5,6,149,5745,-82,-96,14,74:a2:e6:10:5d:50,208141256,132,6351,208141124,208141256
875,5,12,149,5745,-76,-96,20,22:ec:75:a8:8a:31,208157618,244,16118,208157374,208157618
876,5,12,149,5745,-76,-96,20,22:ec:75:a8:8a:31,208157933,516,-201,208157417,208157933
877,5,12,149,5745,-48,-96,48,f2:da:61:dd:98:c5,208160616,268,2415,208160348,208160616
878,5,12,149,5745,-77,-96,19,fa:44:8d:e1:c7:1b,208163114,440,2058,208162674,208163114
879,5,12,149,5745,-49,-96,47,5e:29:73:5b:30:00,208163844,540,190,208163304,208163844
880,5,12,149,5745,-71,-96,25,9a:24:38:da:96:bb,208166876,824,2208,208166052,208166876
881,5,12,149,5745,-71,-96,25,5e:36:fe:bc:a2:fe,208170029,440,2713,208169589,208170029
882,5,12,149,5745,-70,-96,26,c2:21:7d:48:b5:63,208171421,240,1152,208171181,208171421
883,5,12,149,5745,-72,-96,24,f6:0a:5c:59:72:df,208172109,448,240,208171661,208172109
884,5,12,149,5745,-73,-96,23,56:68:e2:c2:8d:d5,208173410,476,825,208172934,208173410
885,5,12,149,5745,-72,-96,24,a6:92:ad:b7:76:65,208175361,456,1495,208174905,208175361
886,5,12,149,5745,-77,-96,19,72:d1:72:1d:22:a1,208176851,452,1038,208176399,208176851
887,5,12,149,5745,-48,-96,48,f2:da:61:dd:98:c5,208177553,268,434,208177285,208177553
888,5,12,149,5745,-67,-96,29,3e:d1:9b:c7:a4:de,208180088,544,1991,208179544,208180088
889,5,12,149,5745,-69,-96,27,c2:21:7d:48:b5:63,208192251,240,11923,208192011,208192251
890,5,12,149,5745,-70,-96,26,f6:0a:5c:59:72:df,208199634,252,7131,208199382,208199634
891,5,12,149,5745,-70,-96,26,3e:d1:9b:c7:a4:de,208209570,272,9664,208209298,208209570
892,5,12,149,5745,-50,-96,46,5e:29:73:5b:30:00,208209921,272,79,208209649,208209921
893,5,12,149,5745,-70,-96,26,5e:36:fe:bc:a2:fe,208226744,440,16383,208226304,208226744
894,5,12,149,5745,-77,-96,19,9a:24:38:da:96:bb,208233680,272,6664,208233408,208233680
895,5,12,149,5745,-73,-96,23,f6:0a:5c:59:72:df,208237724,448,3596,208237276,208237724
896,5,12,149,5745,-79,-96,17,72:d1:72:1d:22:a1,208238902,256,922,208238646,208238902
897,5,12,149,5745,-74,-96,22,fa:44:8d:e1:c7:1b,208240615,440,1273,208240175,208240615
898,5,12,149,5745,-74,-96,22,fa:44:8d:e1:c7:1b,208241073,244,214,208240829,208241073
899,5,12,149,5745,-72,-96,24,a6:92:ad:b7:76:65,208242154,456,625,208241698,208242154
900,5,12,149,5745,-73,-96,23,56:68:e2:c2:8d:d5,208244246,280,1812,208243966,208244246
901,5,12,149,5745,-76,-96,20,22:ec:75:a8:8a:31,208251184,244,6694,208250940,208251184
902,5,6,149,5745,-89,-96,7,54:e4:3a:ec:fb:65,208265492,360,13948,208265132,208265492
903,5,12,149,5745,-72,-96,24,a6:92:ad:b7:76:65,208273935,256,8187,208273679,208273935
904,5,12,149,5745,-50,-96,46,f2:da:61:dd:98:c5,208277169,268,2966,208276901,208277169
905,5,12,149,5745,-70,-96,26,5e:36:fe:bc:a2:fe,208292242,440,14633,208291802,208292242
906,5,12,149,5745,-50,-96,46,5e:29:73:5b:30:00,208294966,540,2184,208294426,208294966
907,5,12,149,5745,-76,-96,20,22:ec:75:a8:8a:31,208295594,516,112,208295078,208295594
908,5,12,149,5745,-74,-96,22,9a:24:38:da:96:bb,208298217,824,1799,208297393,208298217
909,5,12,149,5745,-70,-96,26,c2:21:7d:48:b5:63,208302842,240,4385,208302602,208302842
910,5,12,149,5745,-73,-96,23,f6:0a:5c:59:72:df,208303202,448,-88,208302754,208303202
911,5,12,149,5745,-75,-96,21,fa:44:8d:e1:c7:1b,208305132,440,1490,208304692,208305132
912,5,12,149,5745,-70,-96,26,0a:b9:b7:b1:4d:fa,208306686,268,1286,208306418,208306686
913,5,12,149,5745,-70,-96,26,c2:21:7d:48:b5:63,208307043,240,117,208306803,208307043
914,5,12,149,5745,-71,-96,25,a6:92:ad:b7:76:65,208307326,456,-173,208306870,208307326
915,5,12,149,5745,-48,-96,48,f2:da:61:dd:98:c5,208308518,268,924,208308250,208308518
916,5,12,149,5745,-73,-96,23,f6:0a:5c:59:72:df,208311574,252,2804,208311322,208311574
917,5,12,149,5745,-65,-96,31,3e:d1:9b:c7:a4:de,208311869,544,-249,208311325,208311869
918,5,12,149,5745,-65,-96,31,3e:d1:9b:c7:a4:de,208323399,272,11258,208323127,208323399
919,5,12,149,5745,-47,-96,49,5e:29:73:5b:30:00,208323705,272,34,208323433,208323705
920,5,12,149,5745,-73,-96,23,9a:24:38:da:96:bb,208346609,272,22632,208346337,208346609
921,5,6,149,5745,-88,-96,8,54:e4:3a:ec:fb:65,208367627,360,20658,208367267,208367627
922,5,12,149,5745,-79,-96,17,22:ec:75:a8:8a:31,208368360,244,489,208368116,208368360
923,5,12,149,5745,-72,-96,24,a6:92:ad:b7:76:65,208390168,256,21552,208389912,208390168
924,5,12,149,5745,-76,-96,20,fa:44:8d:e1:c7:1b,208391200,244,788,208390956,208391200
925,5,12,149,5745,-77,-96,19,72:d1:72:1d:22:a1,208392371,256,915,208392115,208392371
926,5,12,149,5745,-74,-96,22,56:68:e2:c2:8d:d5,208392697,280,46,208392417,208392697
927,5,12,149,5745,-66,-96,30,3e:d1:9b:c7:a4:de,208422121,272,29152,208421849,208422121
928,5,12,149,5745,-53,-96,43,5e:29:73:5b:30:00,208422445,272,52,208422173,208422445
929,5,12,149,5745,-72,-96,24,f6:0a:5c:59:72:df,208433644,252,10947,208433392,208433644
930,5,12,149,5745,-73,-96,23,9a:24:38:da:96:bb,208463940,272,30024,208463668,208463940
931,5,6,149,5745,-89,-96,7,54:e4:3a:ec:fb:65,208470027,360,5727,208469667,208470027
932,5,12,149,5745,-50,-96,46,f2:da:61:dd:98:c5,208470604,268,309,208470336,208470604
933,5,12,149,5745,-76,-96,20,22:ec:75:a8:8a:31,208484162,244,13314,208483918,208484162
934,5,12,149,5745,-74,-96,22,fa:44:8d:e1:c7:1b,208494294,244,9888,208494050,208494294
935,5,12,149,5745,-71,-96,25,c2:21:7d:48:b5:63,208494733,240,199,208494493,208494733
936,5,12,149,5745,-78,-96,18,72:d1:72:1d:22:a1,208495063,256,74,208494807,208495063
937,5,12,149,5745,-77,-96,19,56:68:e2:c2:8d:d5,208497424,280,2081,208497144,208497424
938,5,12,149,5745,-76,-96,20,a6:92:ad:b7:76:65,208509129,256,11449,208508873,208509129
939,5,12,149,5745,-50,-96,46,5e:29:73:5b:30:00,208538070,272,28669,208537798,208538070
940,5,12,149,5745,-64,-96,32,3e:d1:9b:c7:a4:de,208539115,272,773,208538843,208539115
941,5,24,149,5745,-78,-96,18,,208550026,28,10883,208549998,208550026
942,5,12,149,5745,-74,-96,22,f6:0a:5c:59:72:df,208550844,252,566,208550592,208550844
943,5,12,149,5745,-74,-96,22,9a:24:38:da:96:bb,208571758,272,20642,208571486,208571758
944,5,6,149,5745,-88,-96,8,54:e4:3a:ec:fb:65,208572428,360,310,208572068,208572428
945,5,12,149,5745,-51,-96,45,f2:da:61:dd:98:c5,208572987,268,291,208572719,208572987
946,5,24,149,5745,-76,-96,20,,208579825,28,6810,208579797,208579825
947,5,12,149,5745,-75,-96,21,5e:36:fe:bc:a2:fe,208583287,244,3218,208583043,208583287
948,5,12,149,5745,-70,-96,26,c2:21:7d:48:b5:63,208596504,240,12977,208596264,208596504
949,5,12,149,5745,-71,-96,25,fa:44:8d:e1:c7:1b,208596791,244,43,208596547,208596791
950,5,12,149,5745,-78,-96,18,72:d1:72:1d:22:a1,208597511,256,464,208597255,208597511
951,5,12,149,5745,-74,-96,22,56:68:e2:c2:8d:d5,208599232,280,1441,208598952,208599232
952,5,12,149,5745,-78,-96,18,22:ec:75:a8:8a:31,208600967,244,1491,208600723,208600967
953,5,24,149,5745,-77,-96,19,,208626249,28,25254,208626221,208626249
954,5,12,149,5745,-77,-96,19,5e:36:fe:bc:a2:fe,208629820,440,3131,208629380,208629820
955,5,12,149,5745,-65,-96,31,3e:d1:9b:c7:a4:de,208653399,272,23307,208653127,208653399
956,5,12,149,5745,-48,-96,48,5e:29:73:5b:30:00,208655039,272,1368,208654767,208655039
957,5,6,149,5745,-84,-96,12,54:e4:3a:ec:fb:65,208674828,360,19429,208674468,208674828
958,5,12,149,5745,-52,-96,44,f2:da:61:dd:98:c5,208675981,268,885,208675713,208675981
959,5,12,149,5745,-71,-96,25,a6:92:ad:b7:76:65,208697535,256,21298,208697279,208697535
960,5,12,149,5745,-72,-96,24,fa:44:8d:e1:c7:1b,208698664,244,885,208698420,208698664
961,5,12,149,5745,-70,-96,26,c2:21:7d:48:b5:63,208699008,240,104,208698768,208699008
962,5,12,149,5745,-80,-96,16,72:d1:72:1d:22:a1,208699429,256,165,208699173,208699429
963,5,12,149,5745,-75,-96,21,22:ec:75:a8:8a:31,208712878,244,13205,208712634,208712878
964,5,12,149,5745,-71,-96,25,a6:92:ad:b7:76:65,208732662,256,19528,208732406,208732662
965,5,12,149,5745,-52,-96,44,f2:da:61:dd:98:c5,208736147,268,3217,208735879,208736147
966,5,12,149,5745,-69,-96,27,c2:21:7d:48:b5:63,208749310,240,12923,208749070,208749310
967,5,12,149,5745,-53,-96,43,5e:29:73:5b:30:00,208750877,540,1027,208750337,208750877
968,5,12,149,5745,-74,-96,22,22:ec:75:a8:8a:31,208752112,516,719,208751596,208752112
969,5,12,149,5745,-69,-96,27,c2:21:7d:48:b5:63,208756738,240,4386,208756498,208756738
970,5,12,149,5745,-73,-96,23,5e:36:fe:bc:a2:fe,208757615,440,437,208757175,208757615
971,5,12,149,5745,-69,-96,27,f6:0a:5c:59:72:df,208759199,448,1136,208758751,208759199
972,5,12,149,5745,-71,-96,25,a6:92:ad:b7:76:65,208761292,456,1637,208760836,208761292
973,5,12,149,5745,-69,-96,27,f6:0a:5c:59:72:df,208762241,252,697,208761989,208762241
974,5,12,149,5745,-75,-96,21,56:68:e2:c2:8d:d5,208764350,476,1633,208763874,208764350
975,5,12,149,5745,-73,-96,23,fa:44:8d:e1:c7:1b,208766193,440,1403,208765753,208766193
976,5,12,149,5745,-52,-96,44,f2:da:61:dd:98:c5,208767477,268,1016,208767209,208767477
977,5,12,149,5745,-81,-96,15,72:d1:72:1d:22:a1,208769174,452,1245,208768722,208769174
978,5,12,149,5745,-63,-96,33,3e:d1:9b:c7:a4:de,208774152,544,4434,208773608,208774152
979,5,6,149,5745,-88,-96,8,54:e4:3a:ec:fb:65,208777229,360,2717,208776869,208777229
980,5,12,149,5745,-63,-96,33,3e:d1:9b:c7:a4:de,208782177,272,4676,208781905,208782177
981,5,12,149,5745,-55,-96,41,5e:29:73:5b:30:00,208782537,272,88,208782265,208782537
982,5,12,149,5745,-81,-96,15,72:d1:72:1d:22:a1,208783902,256,1109,208783646,208783902
983,5,12,149,5745,-76,-96,20,56:68:e2:c2:8d:d5,208796991,280,12809,208796711,208796991
984,5,12,149,5745,-73,-96,23,fa:44:8d:e1:c7:1b,208797631,244,396,208797387,208797631
985,5,12,149,5745,-51,-96,45,f2:da:61:dd:98:c5,208816511,268,18612,208816243,208816511
986,5,12,149,5745,-72,-96,24,22:ec:75:a8:8a:31,208816994,516,-33,208816478,208816994
987,5,12,149,5745,-72,-96,24,c2:21:7d:48:b5:63,208819503,240,2269,208819263,208819503
988,5,12,149,5745,-72,-96,24,5e:36:fe:bc:a2:fe,208821856,440,1913,208821416,208821856
989,5,12,149,5745,-72,-96,24,f6:0a:5c:59:72:df,208824068,448,1764,208823620,208824068
990,5,12,149,5745,-69,-96,27,0a:b9:b7:b1:4d:fa,208827012,268,2676,208826744,208827012
991,5,12,149,5745,-70,-96,26,a6:92:ad:b7:76:65,208827593,456,125,208827137,208827593
992,5,12,149,5745,-58,-96,38,5e:29:73:5b:30:00,208828083,540,-50,208827543,208828083
993,5,12,149,5745,-73,-96,23,fa:44:8d:e1:c7:1b,208829117,440,594,208828677,208829117
994,5,12,149,5745,-72,-96,24,5e:36:fe:bc:a2:fe,208829917,380,420,208829537,208829917
995,5,12,149,5745,-76,-96,20,56:68:e2:c2:8d:d5,208830331,476,-62,208829855,208830331
996,5,12,149,5745,-70,-96,26,a6:92:ad:b7:76:65,208830868,256,281,208830612,208830868
997,5,12,149,5745,-51,-96,45,f2:da:61:dd:98:c5,208832373,268,1237,208832105,208832373
998,5,12,149,5745,-63,-96,33,3e:d1:9b:c7:a4:de,208839470,544,6553,208838926,208839470
999,5,12,149,5745,-73,-96,23,22:ec:75:a8:8a:31,208845718,244,6004,208845474,208845718
1000,5,12,149,5745,-76,-96,20,9a:24:38:da:96:bb,208856093,272,10103,208855821,208856093
1001,5,12,149,5745,-73,-96,23,c2:21:7d:48:b5:63,208864554,240,8221,208864314,208864554
1002,5,12,149,5745,-62,-96,34,3e:d1:9b:c7:a4:de,208878208,272,13382,208877936,208878208
1003,5,6,149,5745,-88,-96,8,54:e4:3a:ec:fb:65,208879630,360,1062,208879270,208879630
1004,5,12,149,5745,-53,-96,43,5e:29:73:5b:30:00,208880404,272,502,208880132,208880404
1005,5,12,149,5745,-72,-96,24,f6:0a:5c:59:72:df,208901665,252,21009,208901413,208901665
1006,5,12,149,5745,-77,-96,19,72:d1:72:1d:22:a1,208910017,256,8096,208909761,208910017
1007,5,12,149,5745,-75,-96,21,56:68:e2:c2:8d:d5,208918677,280,8380,208918397,208918677
1008,5,24,149,5745,-76,-96,20,,208932987,28,14282,208932959,208932987
1009,5,6,149,5745,-89,-96,7,48:e7:da:41:38:ff,208938716,80,5649,208938636,208938716
1010,5,6,149,5745,-89,-96,7,48:e7:da:41:38:ff,208938842,80,46,208938762,208938842
1011,5,12,149,5745,-73,-96,23,22:ec:75:a8:8a:31,208941872,244,2786,208941628,208941872
1012,5,24,149,5745,-74,-96,22,,208952816,28,10916,208952788,208952816
1013,5,24,149,5745,-74,-96,22,,208953053,28,209,208953025,208953053
1014,5,24,149,5745,-74,-96,22,,208953308,28,227,208953280,208953308
1015,5,24,149,5745,-80,-96,16,66:48:51:4e:71:fa,208957318,328,3682,208956990,208957318
1016,5,24,149,5745,-82,-96,14,,208957850,28,504,208957822,208957850
1017,5,24,149,5745,-82,-96,14,,208957958,32,76,208957926,208957958
1018,5,12,149,5745,-51,-96,45,f2:da:61:dd:98:c5,208958947,268,721,208958679,208958947
1019,5,24,149,5745,-82,-96,14,,208959351,28,376,208959323,208959351
1020,5,24,149,5745,-82,-96,14,,208960245,28,866,208960217,208960245
1021,5,12,149,5745,-77,-96,19,9a:24:38:da:96:bb,208969022,272,8505,208968750,208969022
1022,5,6,149,5745,-86,-96,10,54:e4:3a:ec:fb:65,208982030,360,12648,208981670,208982030
1023,5,12,149,5745,-61,-96,35,3e:d1:9b:c7:a4:de,208992497,272,10195,208992225,208992497
1024,5,24,149,5745,-76,-96,20,,208994588,28,2063,208994560,208994588
1025,5,12,149,5745,-51,-96,45,5e:29:73:5b:30:00,208999527,272,4667,208999255,208999527
1026,5,12,149,5745,-75,-96,21,a6:92:ad:b7:76:65,209005310,256,5527,209005054,209005310
1027,5,12,149,5745,-70,-96,26,c2:21:7d:48:b5:63,209006017,240,467,209005777,209006017
1028,5,12,149,5745,-76,-96,20,fa:44:8d:e1:c7:1b,209006374,244,113,209006130,209006374
1029,5,12,149,5745,-78,-96,18,72:d1:72:1d:22:a1,209018924,256,12294,209018668,209018924
1030,5,24,149,5745,-83,-96,13,66:48:51:4e:71:fa,209031022,328,11770,209030694,209031022
1031,5,24,149,5745,-84,-96,12,,209031481,28,431,209031453,209031481
1032,5,24,149,5745,-83,-96,13,,209031589,32,76,209031557,209031589
1033,5,24,149,5745,-82,-96,14,,209032542,28,925,209032514,209032542
1034,5,12,149,5745,-79,-96,17,d2:00:04:7e:2c:ab,209048730,412,15776,209048318,209048730
1035,5,12,149,5745,-75,-96,21,22:ec:75:a8:8a:31,209059623,244,10649,209059379,209059623
1036,5,6,149,5745,-86,-96,10,54:e4:3a:ec:fb:65,209084431,360,24448,209084071,209084431
1037,5,12,149,5745,-57,-96,39,f2:da:61:dd:98:c5,209085079,268,380,209084811,209085079
1038,5,24,149,5745,-81,-96,15,66:48:51:4e:71:fa,209093513,328,8106,209093185,209093513
1039,5,24,149,5745,-82,-96,14,,209093937,28,396,209093909,209093937
1040,5,24,149,5745,-81,-96,15,,209094045,32,76,209094013,209094045
1041,5,12,149,5745,-79,-96,17,9a:24:38:da:96:bb,209101842,272,7525,209101570,209101842
1042,5,12,149,5745,-71,-96,25,a6:92:ad:b7:76:65,209107815,256,5717,209107559,209107815
1043,5,12,149,5745,-70,-96,26,fa:44:8d:e1:c7:1b,209108713,244,654,209108469,209108713
1044,5,12,149,5745,-76,-96,20,c2:21:7d:48:b5:63,209109989,240,1036,209109749,209109989
1045,5,12,149,5745,-73,-96,23,56:68:e2:c2:8d:d5,209111200,280,931,209110920,209111200
1046,5,12,149,5745,-59,-96,37,3e:d1:9b:c7:a4:de,209111901,272,429,209111629,209111901
1047,5,12,149,5745,-53,-96,43,5e:29:73:5b:30:00,209115684,272,3511,209115412,209115684
1048,5,24,149,5745,-76,-96,20,,209116832,28,1120,209116804,209116832
1049,5,12,149,5745,-78,-96,18,72:d1:72:1d:22:a1,209142006,256,24918,209141750,209142006
1050,5,12,149,5745,-72,-96,24,56:68:e2:c2:8d:d5,209147668,280,5382,209147388,209147668
1051,5,12,149,5745,-70,-96,26,fa:44:8d:e1:c7:1b,209149654,244,1742,209149410,209149654
1052,5,12,149,5745,-74,-96,22,22:ec:75:a8:8a:31,209172690,244,22792,209172446,209172690
1053,5,12,149,5745,-74,-96,22,a6:92:ad:b7:76:65,209183476,256,10530,209183220,209183476
1054,5,6,149,5745,-90,-96,6,54:e4:3a:ec:fb:65,209186831,360,2995,209186471,209186831
1055,5,12,149,5745,-54,-96,42,f2:da:61:dd:98:c5,209187417,268,318,209187149,209187417
1056,5,12,149,5745,-77,-96,19,9a:24:38:da:96:bb,209191423,272,3734,209191151,209191423
1057,5,12,149,5745,-74,-96,22,c2:21:7d:48:b5:63,209207994,240,16331,209207754,209207994
1058,5,12,149,5745,-53,-96,43,f2:da:61:dd:98:c5,209209438,268,1176,209209170,209209438
1059,5,12,149,5745,-70,-96,26,f6:0a:5c:59:72:df,209210635,252,945,209210383,209210635
1060,5,12,149,5745,-77,-96,19,9a:24:38:da:96:bb,209211203,824,-256,209210379,209211203
1061,5,12,149,5745,-81,-96,15,72:d1:72:1d:22:a1,209212047,452,392,209211595,209212047
1062,5,12,149,5745,-73,-96,23,22:ec:75:a8:8a:31,209213155,516,592,209212639,209213155
1063,5,12,149,5745,-74,-96,22,c2:21:7d:48:b5:63,209213706,240,311,209213466,209213706
1064,5,12,149,5745,-76,-96,20,5e:36:fe:bc:a2:fe,209216722,440,2576,209216282,209216722
1065,5,12,149,5745,-71,-96,25,f6:0a:5c:59:72:df,209217303,448,133,209216855,209217303
1066,5,12,149,5745,-54,-96,42,5e:29:73:5b:30:00,209224432,540,6589,209223892,209224432
1067,5,12,149,5745,-72,-96,24,56:68:e2:c2:8d:d5,209227391,476,2483,209226915,209227391
1068,5,12,149,5745,-64,-96,32,3e:d1:9b:c7:a4:de,209235193,544,7258,209234649,209235193
1069,5,12,149,5745,-64,-96,32,3e:d1:9b:c7:a4:de,209240896,272,5431,209240624,209240896
1070,5,12,149,5745,-52,-96,44,5e:29:73:5b:30:00,209241203,272,35,209240931,209241203
1071,5,12,149,5745,-82,-96,14,72:d1:72:1d:22:a1,209242662,256,1203,209242406,209242662
1072,5,6,149,5745,-77,-96,19,aa:78:9c:01:b1:05,209243190,164,364,209243026,209243190
1073,5,6,149,5745,-87,-96,9,54:e4:3a:ec:fb:65,209243505,352,-37,209243153,209243505
1074,5,6,149,5745,-78,-96,18,,209243875,44,326,209243831,209243875
1075,5,12,149,5745,-73,-96,23,56:68:e2:c2:8d:d5,209256174,280,12019,209255894,209256174
1076,5,6,149,5745,-77,-96,19,aa:78:9c:01:b1:05,209263758,164,7420,209263594,209263758
1077,5,6,149,5745,-87,-96,9,54:e4:3a:ec:fb:65,209264075,352,-35,209263723,209264075
1078,5,6,149,5745,-77,-96,19,,209264445,44,326,209264401,209264445
1079,5,12,149,5745,-75,-96,21,5e:36:fe:bc:a2:fe,209277288,440,12403,209276848,209277288
1080,5,24,149,5745,-89,-96,7,,209278778,28,1462,209278750,209278778
1081,5,12,149,5745,-73,-96,23,f6:0a:5c:59:72:df,209282063,448,2837,209281615,209282063
1082,5,6,149,5745,-88,-96,8,54:e4:3a:ec:fb:65,209289232,360,6809,209288872,209289232
1083,5,12,149,5745,-73,-96,23,22:ec:75:a8:8a:31,209289905,244,429,209289661,209289905
1084,5,12,149,5745,-81,-96,15,9a:24:38:da:96:bb,209304406,272,14229,209304134,209304406
1085,5,12,149,5745,-56,-96,40,f2:da:61:dd:98:c5,209306025,268,1351,209305757,209306025
1086,5,12,149,5745,-73,-96,23,f6:0a:5c:59:72:df,209322326,252,16049,209322074,209322326
1087,5,12,149,5745,-76,-96,20,c2:21:7d:48:b5:63,209324421,240,1855,209324181,209324421
1088,5,12,149,5745,-56,-96,40,f2:da:61:dd:98:c5,209340799,268,16110,209340531,209340799
1089,5,12,149,5745,-76,-96,20,5e:36:fe:bc:a2:fe,209342826,440,1587,209342386,209342826
1090,5,12,149,5745,-73,-96,23,22:ec:75:a8:8a:31,209344443,516,1101,209343927,209344443
1091,5,12,149,5745,-76,-96,20,c2:21:7d:48:b5:63,209345283,240,600,209345043,209345283
1092,5,12,149,5745,-77,-96,19,a6:92:ad:b7:76:65,209346420,456,681,209345964,209346420
1093,5,12,149,5745,-80,-96,16,d2:00:04:7e:2c:ab,209346957,440,97,209346517,209346957
1094,5,12,149,5745,-74,-96,22,f6:0a:5c:59:72:df,209347970,448,565,209347522,209347970
1095,5,12,149,5745,-72,-96,24,0a:b9:b7:b1:4d:fa,209355293,268,7055,209355025,209355293
1096,5,12,149,5745,-64,-96,32,3e:d1:9b:c7:a4:de,209355631,272,66,209355359,209355631
1097,5,12,149,5745,-53,-96,43,5e:29:73:5b:30:00,209355937,540,-234,209355397,209355937
1098,5,12,149,5745,-53,-96,43,5e:29:73:5b:30:00,209356493,272,284,209356221,209356493
1099,5,12,149,5745,-70,-96,26,fa:44:8d:e1:c7:1b,209362303,440,5370,209361863,209362303
1100,5,12,149,5745,-63,-96,33,3e:d1:9b:c7:a4:de,209365721,544,2874,209365177,209365721
1101,5,24,149,5745,-88,-96,8,,209370773,28,5024,209370745,209370773
1102,5,6,149,5745,-90,-96,6,54:e4:3a:ec:fb:65,209391632,360,20499,209391272,209391632
1103,5,12,149,5745,-74,-96,22,22:ec:75:a8:8a:31,209404059,244,12183,209403815,209404059
1104,5,12,149,5745,-80,-96,16,72:d1:72:1d:22:a1,209416374,256,12059,209416118,209416374
1105,5,12,149,5745,-55,-96,41,f2:da:61:dd:98:c5,209417245,268,603,209416977,209417245
1106,5,12,149,5745,-74,-96,22,56:68:e2:c2:8d:d5,209418429,280,904,209418149,209418429
1107,5,12,149,5745,-78,-96,18,9a:24:38:da:96:bb,209420297,272,1596,209420025,209420297
1108,5,12,149,5745,-62,-96,34,3e:d1:9b:c7:a4:de,209451117,272,30548,209450845,209451117
1109,5,12,149,5745,-54,-96,42,5e:29:73:5b:30:00,209455999,272,4610,209455727,209455999
1110,5,6,149,5745,-88,-96,8,54:e4:3a:ec:fb:65,209494032,360,37673,209493672,209494032
1111,5,12,149,5745,-72,-96,24,c2:21:7d:48:b5:63,209518722,240,24450,209518482,209518722
1112,5,12,149,5745,-84,-96,12,72:d1:72:1d:22:a1,209519115,256,137,209518859,209519115
1113,5,12,149,5745,-74,-96,22,56:68:e2:c2:8d:d5,209519486,280,91,209519206,209519486
1114,5,12,149,5745,-77,-96,19,22:ec:75:a8:8a:31,209521073,244,1343,209520829,209521073
1115,5,12,149,5745,-76,-96,20,9a:24:38:da:96:bb,209535101,272,13756,209534829,209535101
1116,5,12,149,5745,-72,-96,24,5e:36:fe:bc:a2:fe,209553292,440,17751,209552852,209553292
1117,5,12,149,5745,-73,-96,23,f6:0a:5c:59:72:df,209561023,252,7479,209560771,209561023
1118,5,12,149,5745,-64,-96,32,02:31:8a:29:26:f4,209561337,240,74,209561097,209561337
1119,5,12,149,5745,-63,-96,33,3e:d1:9b:c7:a4:de,209566796,272,5187,209566524,209566796
1120,5,12,149,5745,-54,-96,42,72:fd:09:2f:da:5f,209572024,444,4784,209571580,209572024
1121,5,12,149,5745,-53,-96,43,5e:29:73:5b:30:00,209572952,272,656,209572680,209572952
1122,5,6,149,5745,-88,-96,8,54:e4:3a:ec:fb:65,209596433,360,23121,209596073,209596433
1123,5,12,149,5745,-55,-96,41,f2:da:61:dd:98:c5,209597010,268,309,209596742,209597010
1124,5,12,149,5745,-71,-96,25,5e:36:fe:bc:a2:fe,209617908,440,20458,209617468,209617908
1125,5,12,149,5745,-70,-96,26,c2:21:7d:48:b5:63,209620848,240,2700,209620608,209620848
1126,5,12,149,5745,-82,-96,14,72:d1:72:1d:22:a1,209621385,256,281,209621129,209621385
1127,5,12,149,5745,-73,-96,23,56:68:e2:c2:8d:d5,209622009,280,344,209621729,209622009
1128,5,12,149,5745,-72,-96,24,22:ec:75:a8:8a:31,209638174,244,15921,209637930,209638174
1129,5,12,149,5745,-72,-96,24,9a:24:38:da:96:bb,209643670,272,5224,209643398,209643670
1130,5,12,149,5745,-57,-96,39,72:fd:09:2f:da:5f,209648707,284,4753,209648423,209648707
1131,5,12,149,5745,-73,-96,23,f6:0a:5c:59:72:df,209668700,252,19741,209668448,209668700
1132,5,12,149,5745,-60,-96,36,3e:d1:9b:c7:a4:de,209680838,272,11866,209680566,209680838
1133,5,12,149,5745,-69,-96,27,5e:36:fe:bc:a2:fe,209684314,440,3036,209683874,209684314
1134,5,12,149,5745,-50,-96,46,5e:29:73:5b:30:00,209688102,272,3516,209687830,209688102
1135,5,6,149,5745,-89,-96,7,54:e4:3a:ec:fb:65,209698834,360,10372,209698474,209698834
1136,5,12,149,5745,-54,-96,42,f2:da:61:dd:98:c5,209699554,268,452,209699286,209699554
1137,5,12,149,5745,-71,-96,25,c2:21:7d:48:b5:63,209723137,240,23343,209722897,209723137
1138,5,12,149,5745,-82,-96,14,72:d1:72:1d:22:a1,209723458,256,65,209723202,209723458
1139,5,12,149,5745,-74,-96,22,56:68:e2:c2:8d:d5,209724090,280,352,209723810,209724090
1140,5,12,149,5745,-55,-96,41,f2:da:61:dd:98:c5,209748397,268,24039,209748129,209748397
1141,5,12,149,5745,-72,-96,24,22:ec:75:a8:8a:31,209749993,244,1352,209749749,209749993
1142,5,12,149,5745,-59,-96,37,72:fd:09:2f:da:5f,209760982,284,10705,209760698,209760982
1143,5,12,149,5745,-70,-96,26,c2:21:7d:48:b5:63,209783276,240,22054,209783036,209783276
1144,5,12,149,5745,-72,-96,24,22:ec:75:a8:8a:31,209798726,516,14934,209798210,209798726
1145,5,12,149,5745,-81,-96,15,72:d1:72:1d:22:a1,209799314,256,332,209799058,209799314
1146,5,6,149,5745,-84,-96,12,54:e4:3a:ec:fb:65,209801234,360,1560,209800874,209801234
1147,5,12,149,5745,-53,-96,43,f2:da:61:dd:98:c5,209802387,268,885,209802119,209802387
1148,5,12,149,5745,-81,-96,15,72:d1:72:1d:22:a1,209802734,452,-105,209802282,209802734
1149,5,12,149,5745,-70,-96,26,c2:21:7d:48:b5:63,209803934,240,960,209803694,209803934
1150,5,12,149,5745,-60,-96,36,72:fd:09:2f:da:5f,209805414,480,1000,209804934,209805414
1151,5,12,149,5745,-76,-96,20,f6:0a:5c:59:72:df,209807239,448,1377,209806791,209807239
1152,5,12,149,5745,-50,-96,46,5e:29:73:5b:30:00,209811832,540,4053,209811292,209811832
1153,5,12,149,5745,-77,-96,19,56:68:e2:c2:8d:d5,209812407,280,295,209812127,209812407
1154,5,12,149,5745,-59,-96,37,3e:d1:9b:c7:a4:de,209814369,272,1690,209814097,209814369
1155,5,12,149,5745,-50,-96,46,5e:29:73:5b:30:00,209814684,272,43,209814412,209814684
1156,5,12,149,5745,-77,-96,19,56:68:e2:c2:8d:d5,209815963,476,803,209815487,209815963
1157,5,12,149,5745,-59,-96,37,3e:d1:9b:c7:a4:de,209822744,544,6237,209822200,209822744
1158,5,12,149,5745,-55,-96,41,f2:da:61:dd:98:c5,209848495,268,25483,209848227,209848495
1159,5,12,149,5745,-61,-96,35,72:fd:09:2f:da:5f,209865512,284,16733,209865228,209865512
1160,5,12,149,5745,-76,-96,20,72:d1:72:1d:22:a1,209865885,452,-79,209865433,209865885
1161,5,12,149,5745,-75,-96,21,9a:24:38:da:96:bb,209867430,272,1273,209867158,209867430
1162,5,12,149,5745,-69,-96,27,c2:21:7d:48:b5:63,209868179,240,509,209867939,209868179
1163,5,12,149,5745,-55,-96,41,f2:da:61:dd:98:c5,209868471,268,24,209868203,209868471
1164,5,12,149,5745,-77,-96,19,f6:0a:5c:59:72:df,209869335,448,416,209868887,209869335
1165,5,12,149,5745,-61,-96,35,72:fd:09:2f:da:5f,209870777,480,962,209870297,209870777
1166,5,12,149,5745,-68,-96,28,02:31:8a:29:26:f4,209871436,116,543,209871320,209871436
1167,5,12,149,5745,-68,-96,28,02:31:8a:29:26:f4,209871605,132,37,209871473,209871605
1168,5,12,149,5745,-69,-96,27,02:31:8a:29:26:f4,209871843,116,122,209871727,209871843
1169,5,12,149,5745,-69,-96,27,02:31:8a:29:26:f4,209872038,116,79,209871922,209872038
1170,5,12,149,5745,-69,-96,27,02:31:8a:29:26:f4,209872333,132,163,209872201,209872333
1171,5,12,149,5745,-80,-96,16,a6:92:ad:b7:76:65,209872526,456,-263,209872070,209872526
1172,5,12,149,5745,-82,-96,14,d2:00:04:7e:2c:ab,209873594,440,628,209873154,209873594
1173,5,12,149,5745,-71,-96,25,0a:b9:b7:b1:4d:fa,209874527,268,665,209874259,209874527
1174,5,12,149,5745,-49,-96,47,5e:29:73:5b:30:00,209877297,540,2230,209876757,209877297
1175,5,12,149,5745,-79,-96,17,22:ec:75:a8:8a:31,209877846,244,305,209877602,209877846
1176,5,12,149,5745,-79,-96,17,56:68:e2:c2:8d:d5,209878759,476,437,209878283,209878759
1177,5,12,149,5745,-69,-96,27,02:31:8a:29:26:f4,209880012,268,985,209879744,209880012
1178,5,12,149,5745,-69,-96,27,c2:21:7d:48:b5:63,209880594,240,342,209880354,209880594
1179,5,12,149,5745,-79,-96,17,f6:0a:5c:59:72:df,209882722,252,1876,209882470,209882722
1180,5,12,149,5745,-71,-96,25,fa:44:8d:e1:c7:1b,209886054,440,2892,209885614,209886054
1181,5,12,149,5745,-63,-96,33,3e:d1:9b:c7:a4:de,209887964,544,1366,209887420,209887964
1182,5,6,149,5745,-88,-96,8,54:e4:3a:ec:fb:65,209903635,360,15311,209903275,209903635
1183,5,12,149,5745,-62,-96,34,3e:d1:9b:c7:a4:de,209913489,272,9582,209913217,209913489
1184,5,12,149,5745,-47,-96,49,5e:29:73:5b:30:00,209913849,272,88,209913577,209913849
1185,5,12,149,5745,-75,-96,21,72:d1:72:1d:22:a1,209914787,256,682,209914531,209914787
1186,5,24,149,5745,-81,-96,15,,209915720,28,905,209915692,209915720
1187,5,24,149,5745,-81,-96,15,,209915831,28,83,209915803,209915831
1188,5,6,149,5745,-82,-96,14,,209916004,52,121,209915952,209916004
1189,5,6,149,5745,-80,-96,16,,209916536,52,480,209916484,209916536
1190,5,12,149,5745,-77,-96,19,22:ec:75:a8:8a:31,209929512,516,12460,209928996,209929512
1191,5,12,149,5745,-56,-96,40,f2:da:61:dd:98:c5,209933473,268,3693,209933205,209933473
1192,5,12,149,5745,-60,-96,36,72:fd:09:2f:da:5f,209936592,480,2639,209936112,209936592
1193,5,24,149,5745,-82,-96,14,,209938956,28,2336,209938928,209938956
1194,5,12,149,5745,-81,-96,15,56:68:e2:c2:8d:d5,209941842,280,2606,209941562,209941842
1195,5,12,149,5745,-54,-96,42,f2:da:61:dd:98:c5,209962790,268,20680,209962522,209962790
1196,5,12,149,5745,-58,-96,38,72:fd:09:2f:da:5f,209981384,284,18310,209981100,209981384
1197,5,24,149,5745,-81,-96,15,,209990602,28,9190,209990574,209990602
1198,5,12,149,5745,-76,-96,20,22:ec:75:a8:8a:31,209992598,244,1752,209992354,209992598
1199,5,12,149,5745,-76,-96,20,22:ec:75:a8:8a:31,209994532,516,1418,209994016,209994532
1200,5,12,149,5745,-53,-96,43,f2:da:61:dd:98:c5,209999022,268,4222,209998754,209999022
1201,5,6,149,5745,-87,-96,9,54:e4:3a:ec:fb:65,210006036,360,6654,210005676,210006036
1202,5,12,149,5745,-70,-96,26,c2:21:7d:48:b5:63,210007088,240,812,210006848,210007088
1203,5,12,149,5745,-73,-96,23,f6:0a:5c:59:72:df,210007706,252,366,210007454,210007706
1204,5,12,149,5745,-61,-96,35,3e:d1:9b:c7:a4:de,210020389,272,12411,210020117,210020389
1205,5,12,149,5745,-51,-96,45,5e:29:73:5b:30:00,210029480,272,8819,210029208,210029480
1206,5,12,149,5745,-79,-96,17,72:d1:72:1d:22:a1,210037512,256,7776,210037256,210037512
1207,5,12,149,5745,-81,-96,15,56:68:e2:c2:8d:d5,210045056,280,7264,210044776,210045056
1208,5,12,149,5745,-75,-96,21,22:ec:75:a8:8a:31,210060628,516,15056,210060112,210060628
1209,5,12,149,5745,-53,-96,43,f2:da:61:dd:98:c5,210064229,268,3333,210063961,210064229
1210,5,12,149,5745,-66,-96,30,02:31:8a:29:26:f4,210075479,268,10982,210075211,210075479
1211,5,12,149,5745,-54,-96,42,f2:da:61:dd:98:c5,210077475,268,1728,210077207,210077475
1212,5,12,149,5745,-81,-96,15,9a:24:38:da:96:bb,210092326,272,14579,210092054,210092326
1213,5,12,149,5745,-55,-96,41,72:fd:09:2f:da:5f,210097817,284,5207,210097533,210097817
1214,5,12,149,5745,-75,-96,21,22:ec:75:a8:8a:31,210108152,244,10091,210107908,210108152
1215,5,6,149,5745,-87,-96,9,54:e4:3a:ec:fb:65,210108435,360,-77,210108075,210108435
1216,5,12,149,5745,-64,-96,32,3e:d1:9b:c7:a4:de,210132104,272,23397,210131832,210132104
1217,5,12,149,5745,-70,-96,26,c2:21:7d:48:b5:63,210132954,240,610,210132714,210132954
1218,5,12,149,5745,-54,-96,42,5e:29:73:5b:30:00,210146370,272,13144,210146098,210146370
1219,5,12,149,5745,-77,-96,19,72:d1:72:1d:22:a1,210149136,256,2510,210148880,210149136
1220,5,12,149,5745,-57,-96,39,f2:da:61:dd:98:c5,210199074,268,49670,210198806,210199074
1221,5,12,149,5745,-73,-96,23,22:ec:75:a8:8a:31,210204206,244,4888,210203962,210204206
1222,5,12,149,5745,-77,-96,19,9a:24:38:da:96:bb,210208151,272,3673,210207879,210208151
1223,5,12,149,5745,-57,-96,39,72:fd:09:2f:da:5f,210210788,284,2353,210210504,210210788
1224,5,6,149,5745,-91,-96,5,54:e4:3a:ec:fb:65,210211103,360,-45,210210743,210211103
1225,5,12,149,5745,-73,-96,23,c2:21:7d:48:b5:63,210235392,240,24049,210235152,210235392
1226,5,12,149,5745,-80,-96,16,56:68:e2:c2:8d:d5,210242975,280,7303,210242695,210242975
1227,5,12,149,5745,-80,-96,16,56:68:e2:c2:8d:d5,210254702,280,11447,210254422,210254702
1228,5,12,149,5745,-64,-96,32,3e:d1:9b:c7:a4:de,210256750,272,1776,210256478,210256750
1229,5,12,149,5745,-71,-96,25,22:ec:75:a8:8a:31,210258635,516,1369,210258119,210258635
1230,5,12,149,5745,-77,-96,19,72:d1:72:1d:22:a1,210260446,452,1359,210259994,210260446
1231,5,12,149,5745,-74,-96,22,f6:0a:5c:59:72:df,210262004,448,1110,210261556,210262004
1232,5,12,149,5745,-57,-96,39,f2:da:61:dd:98:c5,210262872,268,600,210262604,210262872
1233,5,12,149,5745,-58,-96,38,72:fd:09:2f:da:5f,210266415,480,3063,210265935,210266415
1234,5,12,149,5745,-55,-96,41,5e:29:73:5b:30:00,210273040,540,6085,210272500,210273040
1235,5,12,149,5745,-55,-96,41,5e:29:73:5b:30:00,210273596,272,284,210273324,210273596
1236,5,12,149,5745,-81,-96,15,56:68:e2:c2:8d:d5,210276063,476,1991,210275587,210276063
1237,5,12,149,5745,-72,-96,24,c2:21:7d:48:b5:63,210277744,240,1441,210277504,210277744
1238,5,12,149,5745,-65,-96,31,3e:d1:9b:c7:a4:de,210283884,544,5596,210283340,210283884
1239,5,12,149,5745,-56,-96,40,f2:da:61:dd:98:c5,210307200,268,23048,210306932,210307200
1240,5,12,149,5745,-59,-96,37,72:fd:09:2f:da:5f,210307521,284,37,210307237,210307521
1241,5,6,149,5745,-91,-96,5,54:e4:3a:ec:fb:65,210313237,360,5356,210312877,210313237
1242,5,12,149,5745,-79,-96,17,9a:24:38:da:96:bb,210316051,272,2542,210315779,210316051
1243,5,12,149,5745,-74,-96,22,22:ec:75:a8:8a:31,210322779,516,6212,210322263,210322779
1244,5,12,149,5745,-56,-96,40,f2:da:61:dd:98:c5,210326767,268,3720,210326499,210326767
1245,5,12,149,5745,-73,-96,23,02:31:8a:29:26:f4,210329176,268,2141,210328908,210329176
1246,5,12,149,5745,-61,-96,35,72:fd:09:2f:da:5f,210329532,480,-124,210329052,210329532
1247,5,12,149,5745,-74,-96,22,22:ec:75:a8:8a:31,210336689,244,6913,210336445,210336689
1248,5,12,149,5745,-71,-96,25,5e:36:fe:bc:a2:fe,210345265,468,8108,210344797,210345265
1249,5,12,149,5745,-74,-96,22,c2:21:7d:48:b5:63,210353720,240,8215,210353480,210353720
1250,5,12,149,5745,-70,-96,26,5e:36:fe:bc:a2:fe,210356594,272,2602,210356322,210356594
1251,5,12,149,5745,-66,-96,30,3e:d1:9b:c7:a4:de,210362426,272,5560,210362154,210362426
1252,5,12,149,5745,-73,-96,23,02:31:8a:29:26:f4,210373569,268,10875,210373301,210373569
1253,5,12,149,5745,-54,-96,42,5e:29:73:5b:30:00,210387940,272,14099,210387668,210387940
1254,5,12,149,5745,-74,-96,22,22:ec:75:a8:8a:31,210388292,516,-164,210387776,210388292
1255,5,12,149,5745,-79,-96,17,9a:24:38:da:96:bb,210388869,824,-247,210388045,210388869
1256,5,12,149,5745,-74,-96,22,c2:21:7d:48:b5:63,210392022,240,2913,210391782,210392022
1257,5,12,149,5745,-54,-96,42,f2:da:61:dd:98:c5,210392350,268,60,210392082,210392350
1258,5,12,149,5745,-83,-96,13,d2:00:04:7e:2c:ab,210394952,440,2162,210394512,210394952
1259,5,12,149,5745,-73,-96,23,02:31:8a:29:26:f4,210395436,268,216,210395168,210395436
1260,5,12,149,5745,-70,-96,26,5e:36:fe:bc:a2:fe,210395747,440,-129,210395307,210395747
1261,5,12,149,5745,-60,-96,36,72:fd:09:2f:da:5f,210396221,480,-6,210395741,210396221
1262,5,12,149,5745,-73,-96,23,a6:92:ad:b7:76:65,210396789,456,112,210396333,210396789
1263,5,12,149,5745,-69,-96,27,0a:b9:b7:b1:4d:fa,210399876,268,2819,210399608,210399876
1264,5,12,149,5745,-53,-96,43,5e:29:73:5b:30:00,210402240,540,1824,210401700,210402240
1265,5,12,149,5745,-72,-96,24,fa:44:8d:e1:c7:1b,210410419,440,7739,210409979,210410419
1266,5,12,149,5745,-65,-96,31,3e:d1:9b:c7:a4:de,210414934,544,3971,210414390,210414934
1267,5,6,149,5745,-88,-96,8,54:e4:3a:ec:fb:65,210415638,360,344,210415278,210415638
1268,5,12,149,5745,-55,-96,41,f2:da:61:dd:98:c5,210421479,268,5573,210421211,210421479
1269,5,12,149,5745,-60,-96,36,72:fd:09:2f:da:5f,210421781,284,18,210421497,210421781
1270,5,12,149,5745,-78,-96,18,9a:24:38:da:96:bb,210427801,272,5748,210427529,210427801
1271,5,12,149,5745,-72,-96,24,22:ec:75:a8:8a:31,210435308,244,7263,210435064,210435308
1272,5,12,149,5745,-79,-96,17,72:d1:72:1d:22:a1,210440280,256,4716,210440024,210440280
1273,5,12,149,5745,-81,-96,15,56:68:e2:c2:8d:d5,210442379,280,1819,210442099,210442379
1274,5,12,149,5745,-72,-96,24,22:ec:75:a8:8a:31,210453916,516,11021,210453400,210453916
1275,5,12,149,5745,-56,-96,40,f2:da:61:dd:98:c5,210457724,268,3540,210457456,210457724
1276,5,12,149,5745,-74,-96,22,f6:0a:5c:59:72:df,210458991,252,1015,210458739,210458991
1277,5,12,149,5745,-70,-96,26,5e:36:fe:bc:a2:fe,210459295,440,-136,210458855,210459295
1278,5,12,149,5745,-58,-96,38,72:fd:09:2f:da:5f,210460814,480,1039,210460334,210460814
1279,5,12,149,5745,-75,-96,21,c2:21:7d:48:b5:63,210464487,240,3433,210464247,210464487
1280,5,12,149,5745,-65,-96,31,3e:d1:9b:c7:a4:de,210479456,272,14697,210479184,210479456
1281,5,12,149,5745,-69,-96,27,5e:36:fe:bc:a2:fe,210484623,244,4923,210484379,210484623
1282,5,12,149,5745,-52,-96,44,5e:29:73:5b:30:00,210489642,272,4747,210489370,210489642
1283,5,12,149,5745,-73,-96,23,02:31:8a:29:26:f4,210493962,268,4052,210493694,210493962
1284,5,6,149,5745,-88,-96,8,54:e4:3a:ec:fb:65,210518038,360,23716,210517678,210518038
1285,5,12,149,5745,-72,-96,24,22:ec:75:a8:8a:31,210519354,516,800,210518838,210519354
1286,5,12,149,5745,-58,-96,38,f2:da:61:dd:98:c5,210523303,268,3681,210523035,210523303
1287,5,12,149,5745,-58,-96,38,f2:da:61:dd:98:c5,210536187,268,12616,210535919,210536187
1288,5,12,149,5745,-78,-96,18,9a:24:38:da:96:bb,210541187,272,4728,210540915,210541187
1289,5,12,149,5745,-80,-96,16,72:d1:72:1d:22:a1,210542749,256,1306,210542493,210542749
1290,5,12,149,5745,-80,-96,16,56:68:e2:c2:8d:d5,210543380,280,351,210543100,210543380
1291,5,12,149,5745,-55,-96,41,72:fd:09:2f:da:5f,210546963,284,3299,210546679,210546963
1292,5,12,149,5745,-72,-96,24,22:ec:75:a8:8a:31,210549657,244,2450,210549413,210549657
1293,5,12,149,5745,-73,-96,23,22:ec:75:a8:8a:31,210584451,516,34278,210583935,210584451
1294,5,12,149,5745,-60,-96,36,f2:da:61:dd:98:c5,210588844,268,4125,210588576,210588844
1295,5,12,149,5745,-65,-96,31,3e:d1:9b:c7:a4:de,210596421,272,7305,210596149,210596421
1296,5,12,149,5745,-51,-96,45,5e:29:73:5b:30:00,210606061,272,9368,210605789,210606061
1297,5,12,149,5745,-69,-96,27,5e:36:fe:bc:a2:fe,210620073,244,13768,210619829,210620073
1298,5,6,149,5745,-85,-96,11,54:e4:3a:ec:fb:65,210620438,360,5,210620078,210620438
1299,5,12,149,5745,-72,-96,24,02:31:8a:29:26:f4,210620988,268,282,210620720,210620988
1300,5,12,149,5745,-60,-96,36,f2:da:61:dd:98:c5,210635134,268,13878,210634866,210635134
1301,5,12,149,5745,-83,-96,13,72:d1:72:1d:22:a1,210645140,256,9750,210644884,210645140
1302,5,12,149,5745,-78,-96,18,c2:21:7d:48:b5:63,210645700,240,320,210645460,210645700
1303,5,12,149,5745,-82,-96,14,56:68:e2:c2:8d:d5,210646091,280,111,210645811,210646091
1304,5,12,149,5745,-72,-96,24,22:ec:75:a8:8a:31,210658049,244,11714,210657805,210658049
1305,5,12,149,5745,-76,-96,20,9a:24:38:da:96:bb,210658634,272,313,210658362,210658634
1306,5,12,149,5745,-65,-96,31,3e:d1:9b:c7:a4:de,210713331,272,54425,210713059,210713331
1307,5,12,149,5745,-53,-96,43,72:fd:09:2f:da:5f,210720065,284,6450,210719781,210720065
1308,5,12,149,5745,-71,-96,25,5e:36:fe:bc:a2:fe,210722472,244,2163,210722228,210722472
1309,5,6,149,5745,-88,-96,8,54:e4:3a:ec:fb:65,210722839,360,7,210722479,210722839
1310,5,12,149,5745,-82,-96,14,72:d1:72:1d:22:a1,210747892,256,24797,210747636,210747892
1311,5,12,149,5745,-79,-96,17,56:68:e2:c2:8d:d5,210748209,280,37,210747929,210748209
1312,5,12,149,5745,-77,-96,19,c2:21:7d:48:b5:63,210748518,240,69,210748278,210748518
1313,5,12,149,5745,-72,-96,24,22:ec:75:a8:8a:31,210769871,244,21109,210769627,210769871
1314,5,12,149,5745,-77,-96,19,c2:21:7d:48:b5:63,210799290,240,29179,210799050,210799290
1315,5,12,149,5745,-53,-96,43,72:fd:09:2f:da:5f,210820748,284,21174,210820464,210820748
1316,5,6,149,5745,-88,-96,8,54:e4:3a:ec:fb:65,210825240,360,4132,210824880,210825240
1317,5,12,149,5745,-59,-96,37,f2:da:61:dd:98:c5,210825654,268,146,210825386,210825654
1318,5,12,149,5745,-70,-96,26,02:31:8a:29:26:f4,210826555,268,633,210826287,210826555
1319,5,12,149,5745,-71,-96,25,5e:36:fe:bc:a2:fe,210829359,244,2560,210829115,210829359
1320,5,12,149,5745,-78,-96,18,56:68:e2:c2:8d:d5,210831113,280,1474,210830833,210831113
1321,5,12,149,5745,-54,-96,42,72:fd:09:2f:da:5f,210834105,380,2612,210833725,210834105
1322,5,12,149,5745,-65,-96,31,3e:d1:9b:c7:a4:de,210846565,272,12188,210846293,210846565
1323,5,12,149,5745,-52,-96,44,5e:29:73:5b:30:00,210846907,272,70,210846635,210846907
1324,5,12,149,5745,-83,-96,13,72:d1:72:1d:22:a1,210850625,452,3266,210850173,210850625
1325,5,12,149,5745,-75,-96,21,c2:21:7d:48:b5:63,210852197,240,1332,210851957,210852197
1326,5,12,149,5745,-74,-96,22,f6:0a:5c:59:72:df,210852849,448,204,210852401,210852849
1327,5,12,149,5745,-71,-96,25,5e:36:fe:bc:a2:fe,210853367,440,78,210852927,210853367
1328,5,12,149,5745,-69,-96,27,02:31:8a:29:26:f4,210854292,268,657,210854024,210854292
1329,5,12,149,5745,-56,-96,40,72:fd:09:2f:da:5f,210854649,480,-123,210854169,210854649
1330,5,12,149,5745,-60,-96,36,f2:da:61:dd:98:c5,210855218,268,301,210854950,210855218
1331,5,12,149,5745,-51,-96,45,5e:29:73:5b:30:00,210860408,540,4650,210859868,210860408
1332,5,12,149,5745,-72,-96,24,22:ec:75:a8:8a:31,210861783,516,859,210861267,210861783
1333,5,12,149,5745,-60,-96,36,f2:da:61:dd:98:c5,210863872,268,1821,210863604,210863872
1334,5,12,149,5745,-78,-96,18,56:68:e2:c2:8d:d5,210864174,476,-174,210863698,210864174
1335,5,12,149,5745,-64,-96,32,3e:d1:9b:c7:a4:de,210871938,544,7220,210871394,210871938
1336,5,12,149,5745,-74,-96,22,9a:24:38:da:96:bb,210876787,272,4577,210876515,210876787
1337,5,12,149,5745,-56,-96,40,72:fd:09:2f:da:5f,210880477,284,3406,210880193,210880477
1338,5,12,149,5745,-73,-96,23,22:ec:75:a8:8a:31,210894061,244,13340,210893817,210894061
1339,5,12,149,5745,-75,-96,21,c2:21:7d:48:b5:63,210895952,240,1651,210895712,210895952
1340,5,12,149,5745,-73,-96,23,f6:0a:5c:59:72:df,210903398,252,7194,210903146,210903398
1341,5,24,149,5745,-77,-96,19,,210910099,28,6673,210910071,210910099
1342,5,12,149,5745,-77,-96,19,9a:24:38:da:96:bb,210913889,824,2966,210913065,210913889
1343,5,12,149,5745,-74,-96,22,c2:21:7d:48:b5:63,210916299,240,2170,210916059,210916299
1344,5,12,149,5745,-75,-96,21,5e:36:fe:bc:a2:fe,210917680,440,941,210917240,210917680
1345,5,12,149,5745,-70,-96,26,02:31:8a:29:26:f4,210918244,156,408,210918088,210918244
1346,5,12,149,5745,-75,-96,21,f6:0a:5c:59:72:df,210918443,448,-249,210917995,210918443
1347,5,12,149,5745,-61,-96,35,f2:da:61:dd:98:c5,210919384,268,673,210919116,210919384
1348,5,12,149,5745,-58,-96,38,72:fd:09:2f:da:5f,210919686,480,-178,210919206,210919686
1349,5,12,149,5745,-70,-96,26,02:31:8a:29:26:f4,210920229,268,275,210919961,210920229
1350,5,12,149,5745,-80,-96,16,d2:00:04:7e:2c:ab,210920577,440,-92,210920137,210920577
1351,5,12,149,5745,-74,-96,22,a6:92:ad:b7:76:65,210921248,456,215,210920792,210921248
1352,5,12,149,5745,-59,-96,37,72:fd:09:2f:da:5f,210923067,380,1439,210922687,210923067
1353,5,12,149,5745,-70,-96,26,0a:b9:b7:b1:4d:fa,210924144,268,809,210923876,210924144
1354,5,12,149,5745,-50,-96,46,5e:29:73:5b:30:00,210925248,540,564,210924708,210925248
1355,5,12,149,5745,-78,-96,18,56:68:e2:c2:8d:d5,210926434,280,906,210926154,210926434
1356,5,12,149,5745,-78,-96,18,56:68:e2:c2:8d:d5,210927253,476,343,210926777,210927253
1357,5,24,149,5745,-78,-96,18,,210928702,28,1421,210928674,210928702
1358,5,12,149,5745,-81,-96,15,72:d1:72:1d:22:a1,210929664,256,706,210929408,210929664
1359,5,12,149,5745,-70,-96,26,02:31:8a:29:26:f4,210930216,268,284,210929948,210930216
1360,5,12,149,5745,-70,-96,26,fa:44:8d:e1:c7:1b,210934615,440,3959,210934175,210934615
1361,5,12,149,5745,-63,-96,33,3e:d1:9b:c7:a4:de,210936538,544,1379,210935994,210936538
1362,5,12,149,5745,-62,-96,34,3e:d1:9b:c7:a4:de,210944862,272,8052,210944590,210944862
1363,5,12,149,5745,-48,-96,48,5e:29:73:5b:30:00,210962165,272,17031,210961893,210962165
1364,5,24,149,5745,-76,-96,20,,210970890,28,8697,210970862,210970890
1365,5,24,149,5745,-77,-96,19,,210971214,28,296,210971186,210971214
1366,5,24,149,5745,-77,-96,19,,210971724,28,482,210971696,210971724
1367,5,12,149,5745,-75,-96,21,5e:36:fe:bc:a2:fe,210983512,440,11348,210983072,210983512
1368,5,12,149,5745,-59,-96,37,72:fd:09:2f:da:5f,210984922,480,930,210984442,210984922
1369,5,12,149,5745,-80,-96,16,40:e3:d6:da:c4:10,210986535,960,653,210985575,210986535
1370,5,12,149,5745,-80,-96,16,9a:24:38:da:96:bb,210989414,272,2607,210989142,210989414
1371,5,12,149,5745,-60,-96,36,f2:da:61:dd:98:c5,210994171,268,4489,210993903,210994171
1372,5,12,149,5745,-58,-96,38,72:fd:09:2f:da:5f,210995098,284,643,210994814,210995098
1373,5,12,149,5745,-73,-96,23,22:ec:75:a8:8a:31,210999742,244,4400,210999498,210999742
1374,5,12,149,5745,-75,-96,21,c2:21:7d:48:b5:63,211026111,240,26129,211025871,211026111
1375,5,6,149,5745,-90,-96,6,54:e4:3a:ec:fb:65,211030041,360,3570,211029681,211030041
1376,5,12,149,5745,-72,-96,24,5e:36:fe:bc:a2:fe,211051919,244,21634,211051675,211051919
1377,5,12,149,5745,-60,-96,36,3e:d1:9b:c7:a4:de,211054928,272,2737,211054656,211054928
1378,5,12,149,5745,-82,-96,14,56:68:e2:c2:8d:d5,211055702,280,494,211055422,211055702
1379,5,12,149,5745,-84,-96,12,72:d1:72:1d:22:a1,211057761,256,1803,211057505,211057761
1380,5,12,149,5745,-49,-96,47,5e:29:73:5b:30:00,211065125,272,7092,211064853,211065125
1381,5,12,149,5745,-75,-96,21,9a:24:38:da:96:bb,211105192,272,39795,211104920,211105192
1382,5,12,149,5745,-54,-96,42,72:fd:09:2f:da:5f,211109103,284,3627,211108819,211109103
1383,5,12,149,5745,-74,-96,22,22:ec:75:a8:8a:31,211111832,244,2485,211111588,211111832
1384,5,6,149,5745,-89,-96,7,54:e4:3a:ec:fb:65,211132441,360,20249,211132081,211132441
1385,5,12,149,5745,-67,-96,29,02:31:8a:29:26:f4,211133000,268,291,211132732,211133000
1386,5,12,149,5745,-58,-96,38,f2:da:61:dd:98:c5,211133330,268,62,211133062,211133330
1387,5,12,149,5745,-74,-96,22,c2:21:7d:48:b5:63,211156999,240,23429,211156759,211156999
1388,5,12,149,5745,-81,-96,15,56:68:e2:c2:8d:d5,211167970,280,10691,211167690,211167970
1389,5,12,149,5745,-86,-96,10,72:d1:72:1d:22:a1,211169525,256,1299,211169269,211169525
1390,5,12,149,5745,-60,-96,36,3e:d1:9b:c7:a4:de,211172387,272,2590,211172115,211172387
1391,5,12,149,5745,-54,-96,42,5e:29:73:5b:30:00,211179000,272,6341,211178728,211179000
1392,5,12,149,5745,-74,-96,22,9a:24:38:da:96:bb,211214038,272,34766,211213766,211214038
1393,5,12,149,5745,-53,-96,43,72:fd:09:2f:da:5f,211220576,284,6254,211220292,211220576
1394,5,12,149,5745,-73,-96,23,22:ec:75:a8:8a:31,211229521,244,8701,211229277,211229521
1395,5,12,149,5745,-72,-96,24,5e:36:fe:bc:a2:fe,211234226,244,4461,211233982,211234226
1396,5,6,149,5745,-88,-96,8,54:e4:3a:ec:fb:65,211234842,360,256,211234482,211234842
1397,5,12,149,5745,-71,-96,25,02:31:8a:29:26:f4,211235364,268,254,211235096,211235364
1398,5,12,149,5745,-57,-96,39,f2:da:61:dd:98:c5,211235695,268,63,211235427,211235695
1399,5,12,149,5745,-75,-96,21,c2:21:7d:48:b5:63,211259318,240,23383,211259078,211259318
1400,5,12,149,5745,-74,-96,22,5e:36:fe:bc:a2:fe,211271417,244,11855,211271173,211271417
1401,5,12,149,5745,-76,-96,20,56:68:e2:c2:8d:d5,211277654,280,5957,211277374,211277654
1402,5,12,149,5745,-72,-96,24,02:31:8a:29:26:f4,211282879,268,4957,211282611,211282879
1403,5,12,149,5745,-77,-96,19,f6:0a:5c:59:72:df,211289979,252,6848,211289727,211289979
1404,5,12,149,5745,-83,-96,13,72:d1:72:1d:22:a1,211293058,256,2823,211292802,211293058
1405,5,24,149,5745,-88,-96,8,,211296342,28,3256,211296314,211296342
1406,5,24,149,5745,-87,-96,9,,211296455,32,81,211296423,211296455
1407,5,24,149,5745,-86,-96,10,,211296814,32,327,211296782,211296814
1408,5,24,149,5745,-87,-96,9,,211297023,28,181,211296995,211297023
1409,5,24,149,5745,-86,-96,10,,211297132,32,77,211297100,211297132
1410,5,12,149,5745,-61,-96,35,3e:d1:9b:c7:a4:de,211305398,272,7994,211305126,211305398
1411,5,12,149,5745,-50,-96,46,5e:29:73:5b:30:00,211305758,272,88,211305486,211305758
1412,5,12,149,5745,-76,-96,20,9a:24:38:da:96:bb,211307596,824,1014,211306772,211307596
1413,5,12,149,5745,-82,-96,14,72:d1:72:1d:22:a1,211309563,452,1515,211309111,211309563
1414,5,12,149,5745,-77,-96,19,f6:0a:5c:59:72:df,211311266,448,1255,211310818,211311266
1415,5,12,149,5745,-73,-96,23,5e:36:fe:bc:a2:fe,211312434,440,728,211311994,211312434
1416,5,12,149,5745,-75,-96,21,c2:21:7d:48:b5:63,211312917,240,243,211312677,211312917
1417,5,12,149,5745,-78,-96,18,f6:0a:5c:59:72:df,211313326,268,141,211313058,211313326
1418,5,12,149,5745,-59,-96,37,f2:da:61:dd:98:c5,211313979,268,385,211313711,211313979
1419,5,12,149,5745,-58,-96,38,72:fd:09:2f:da:5f,211316765,480,2306,211316285,211316765
1420,5,12,149,5745,-58,-96,38,72:fd:09:2f:da:5f,211321199,380,4054,211320819,211321199
1421,5,12,149,5745,-50,-96,46,5e:29:73:5b:30:00,211321650,540,-89,211321110,211321650
1422,5,12,149,5745,-75,-96,21,56:68:e2:c2:8d:d5,211322390,476,264,211321914,211322390
1423,5,12,149,5745,-59,-96,37,72:fd:09:2f:da:5f,211322926,284,252,211322642,211322926
1424,5,12,149,5745,-72,-96,24,22:ec:75:a8:8a:31,211323272,516,-170,211322756,211323272
1425,5,12,149,5745,-59,-96,37,f2:da:61:dd:98:c5,211323822,268,282,211323554,211323822
1426,5,12,149,5745,-78,-96,18,9a:24:38:da:96:bb,211324565,272,471,211324293,211324565
1427,5,12,149,5745,-62,-96,34,3e:d1:9b:c7:a4:de,211330748,544,5639,211330204,211330748
1428,5,6,149,5745,-87,-96,9,54:e4:3a:ec:fb:65,211337242,360,6134,211336882,211337242
1429,5,12,149,5745,-72,-96,24,22:ec:75:a8:8a:31,211353349,244,15863,211353105,211353349
1430,5,12,149,5745,-75,-96,21,c2:21:7d:48:b5:63,211354754,240,1165,211354514,211354754
1431,5,12,149,5745,-74,-96,22,f6:0a:5c:59:72:df,211369071,252,14065,211368819,211369071
1432,5,12,149,5745,-75,-96,21,a6:92:ad:b7:76:65,211375774,456,6247,211375318,211375774
1433,5,12,149,5745,-73,-96,23,5e:36:fe:bc:a2:fe,211376750,440,536,211376310,211376750
1434,5,12,149,5745,-61,-96,35,72:fd:09:2f:da:5f,211378025,480,795,211377545,211378025
1435,5,12,149,5745,-73,-96,23,5e:36:fe:bc:a2:fe,211385624,244,7355,211385380,211385624
1436,5,12,149,5745,-75,-96,21,56:68:e2:c2:8d:d5,211391253,280,5349,211390973,211391253
1437,5,12,149,5745,-82,-96,14,72:d1:72:1d:22:a1,211396411,256,4902,211396155,211396411
1438,5,12,149,5745,-60,-96,36,3e:d1:9b:c7:a4:de,211404743,272,8060,211404471,211404743
1439,5,12,149,5745,-53,-96,43,5e:29:73:5b:30:00,211410689,272,5674,211410417,211410689
1440,5,12,149,5745,-77,-96,19,a6:92:ad:b7:76:65,211419631,256,8686,211419375,211419631
1441,5,12,149,5745,-75,-96,21,9a:24:38:da:96:bb,211437005,272,17102,211436733,211437005
1442,5,12,149,5745,-57,-96,39,f2:da:61:dd:98:c5,211437329,268,56,211437061,211437329
1443,5,12,149,5745,-74,-96,22,9a:24:38:da:96:bb,211437632,824,-521,211436808,211437632
1444,5,12,149,5745,-59,-96,37,72:fd:09:2f:da:5f,211438490,284,574,211438206,211438490
1445,5,6,149,5745,-86,-96,10,54:e4:3a:ec:fb:65,211439642,360,792,211439282,211439642
1446,5,12,149,5745,-76,-96,20,a6:92:ad:b7:76:65,211441616,456,1518,211441160,211441616
1447,5,12,149,5745,-72,-96,24,5e:36:fe:bc:a2:fe,211442241,440,185,211441801,211442241
1448,5,12,149,5745,-75,-96,21,c2:21:7d:48:b5:63,211442760,240,279,211442520,211442760
1449,5,12,149,5745,-73,-96,23,22:ec:75:a8:8a:31,211443071,516,-205,211442555,211443071
1450,5,12,149,5745,-58,-96,38,72:fd:09:2f:da:5f,211443636,480,85,211443156,211443636
1451,5,12,149,5745,-74,-96,22,02:31:8a:29:26:f4,211444998,268,1094,211444730,211444998
1452,5,12,149,5745,-56,-96,40,f2:da:61:dd:98:c5,211445986,268,720,211445718,211445986
1453,5,12,149,5745,-68,-96,28,0a:b9:b7:b1:4d:fa,211448196,268,1942,211447928,211448196
1454,5,12,149,5745,-51,-96,45,5e:29:73:5b:30:00,211452701,540,3965,211452161,211452701
1455,5,12,149,5745,-79,-96,17,d2:00:04:7e:2c:ab,211453635,440,494,211453195,211453635
1456,5,12,149,5745,-75,-96,21,fa:44:8d:e1:c7:1b,211458836,440,4761,211458396,211458836
1457,5,12,149,5745,-59,-96,37,3e:d1:9b:c7:a4:de,211460957,544,1577,211460413,211460957
1458,5,12,149,5745,-74,-96,22,22:ec:75:a8:8a:31,211467170,244,5969,211466926,211467170
1459,5,12,149,5745,-74,-96,22,c2:21:7d:48:b5:63,211468835,240,1425,211468595,211468835
1460,5,12,149,5745,-71,-96,25,5e:36:fe:bc:a2:fe,211484319,244,15240,211484075,211484319
1461,5,12,149,5745,-72,-96,24,5e:36:fe:bc:a2:fe,211507899,440,23140,211507459,211507899
1462,5,12,149,5745,-57,-96,39,72:fd:09:2f:da:5f,211509210,480,831,211508730,211509210
1463,5,12,149,5745,-60,-96,36,3e:d1:9b:c7:a4:de,211517844,272,8362,211517572,211517844
1464,5,12,149,5745,-49,-96,47,5e:29:73:5b:30:00,211526532,272,8416,211526260,211526532
1465,5,12,149,5745,-77,-96,19,a6:92:ad:b7:76:65,211537440,256,10652,211537184,211537440
1466,5,6,149,5745,-85,-96,11,54:e4:3a:ec:fb:65,211542043,360,4243,211541683,211542043
1467,5,12,149,5745,-77,-96,19,9a:24:38:da:96:bb,211549357,272,7042,211549085,211549357
1468,5,12,149,5745,-59,-96,37,f2:da:61:dd:98:c5,211554607,268,4982,211554339,211554607
1469,5,12,149,5745,-55,-96,41,72:fd:09:2f:da:5f,211559619,284,4728,211559335,211559619
1470,5,12,149,5745,-81,-96,15,72:d1:72:1d:22:a1,211566934,256,7059,211566678,211566934
1471,5,12,149,5745,-74,-96,22,56:68:e2:c2:8d:d5,211567368,280,154,211567088,211567368
1472,5,12,149,5745,-75,-96,21,22:ec:75:a8:8a:31,211571200,244,3588,211570956,211571200
1473,5,12,149,5745,-75,-96,21,c2:21:7d:48:b5:63,211582133,240,10693,211581893,211582133
1474,5,12,149,5745,-72,-96,24,5e:36:fe:bc:a2:fe,211609853,244,27476,211609609,211609853
1475,5,12,149,5745,-60,-96,36,3e:d1:9b:c7:a4:de,211633711,272,23586,211633439,211633711
1476,5,12,149,5745,-73,-96,23,02:31:8a:29:26:f4,211641984,268,8005,211641716,211641984
1477,5,12,149,5745,-47,-96,49,5e:29:73:5b:30:00,211643491,272,1235,211643219,211643491
1478,5,6,149,5745,-87,-96,9,54:e4:3a:ec:fb:65,211644443,360,592,211644083,211644443
1479,5,12,149,5745,-76,-96,20,a6:92:ad:b7:76:65,211667592,256,22893,211667336,211667592
1480,5,12,149,5745,-75,-96,21,56:68:e2:c2:8d:d5,211669422,280,1550,211669142,211669422
1481,5,12,149,5745,-84,-96,12,72:d1:72:1d:22:a1,211669755,256,77,211669499,211669755
1482,5,12,149,5745,-76,-96,20,22:ec:75:a8:8a:31,211688269,244,18270,211688025,211688269
1483,5,12,149,5745,-80,-96,16,f6:0a:5c:59:72:df,211715546,252,27025,211715294,211715546
1484,5,12,149,5745,-54,-96,42,72:fd:09:2f:da:5f,211744341,284,28511,211744057,211744341
1485,5,12,149,5745,-71,-96,25,5e:36:fe:bc:a2:fe,211746250,244,1665,211746006,211746250
1486,5,6,149,5745,-88,-96,8,54:e4:3a:ec:fb:65,211746844,360,234,211746484,211746844
1487,5,12,149,5745,-58,-96,38,f2:da:61:dd:98:c5,211748951,268,1839,211748683,211748951
1488,5,12,149,5745,-61,-96,35,3e:d1:9b:c7:a4:de,211750708,272,1485,211750436,211750708
1489,5,12,149,5745,-46,-96,50,5e:29:73:5b:30:00,211760608,272,9628,211760336,211760608
1490,5,12,149,5745,-77,-96,19,a6:92:ad:b7:76:65,211770326,256,9462,211770070,211770326
1491,5,12,149,5745,-83,-96,13,72:d1:72:1d:22:a1,211772036,256,1454,211771780,211772036
1492,5,12,149,5745,-74,-96,22,c2:21:7d:48:b5:63,211772515,240,239,211772275,211772515
1493,5,12,149,5745,-76,-96,20,56:68:e2:c2:8d:d5,211773653,280,858,211773373,211773653
1494,5,12,149,5745,-75,-96,21,9a:24:38:da:96:bb,211793981,272,20056,211793709,211793981
1495,5,12,149,5745,-76,-96,20,22:ec:75:a8:8a:31,211805006,244,10781,211804762,211805006
1496,5,24,149,5745,-78,-96,18,,211828736,28,23702,211828708,211828736
1497,5,24,149,5745,-79,-96,17,,211829070,28,306,211829042,211829070
1498,5,24,149,5745,-77,-96,19,,211839757,28,10659,211839729,211839757
1499,5,12,149,5745,-55,-96,41,72:fd:09:2f:da:5f,211845152,284,5111,211844868,211845152
1500,5,12,149,5745,-70,-96,26,5e:36:fe:bc:a2:fe,211848334,244,2938,211848090,211848334
1501,5,6,149,5745,-87,-96,9,54:e4:3a:ec:fb:65,211849245,360,551,211848885,211849245
1502,5,12,149,5745,-58,-96,38,f2:da:61:dd:98:c5,211850321,268,808,211850053,211850321
1503,5,12,149,5745,-61,-96,35,3e:d1:9b:c7:a4:de,211862593,272,12000,211862321,211862593
1504,5,12,149,5745,-48,-96,48,5e:29:73:5b:30:00,211872552,272,9687,211872280,211872552
1505,5,12,149,5745,-76,-96,20,a6:92:ad:b7:76:65,211873518,256,710,211873262,211873518
1506,5,12,149,5745,-76,-96,20,c2:21:7d:48:b5:63,211873934,240,176,211873694,211873934
1507,5,12,149,5745,-81,-96,15,72:d1:72:1d:22:a1,211874218,256,28,211873962,211874218
1508,5,12,149,5745,-77,-96,19,56:68:e2:c2:8d:d5,211879773,280,5275,211879493,211879773
1509,5,12,149,5745,-59,-96,37,f2:da:61:dd:98:c5,211895989,268,15948,211895721,211895989
1510,5,12,149,5745,-56,-96,40,72:fd:09:2f:da:5f,211896301,284,28,211896017,211896301
1511,5,12,149,5745,-81,-96,15,72:d1:72:1d:22:a1,211897196,452,443,211896744,211897196
1512,5,12,149,5745,-76,-96,20,22:ec:75:a8:8a:31,211899824,516,2112,211899308,211899824
1513,5,12,149,5745,-77,-96,19,f6:0a:5c:59:72:df,211902561,448,2289,211902113,211902561
1514,5,12,149,5745,-59,-96,37,f2:da:61:dd:98:c5,211903924,268,1095,211903656,211903924
1515,5,12,149,5745,-56,-96,40,72:fd:09:2f:da:5f,211906386,480,1982,211905906,211906386
1516,5,12,149,5745,-49,-96,47,5e:29:73:5b:30:00,211909672,540,2746,211909132,211909672
1517,5,12,149,5745,-75,-96,21,c2:21:7d:48:b5:63,211911292,240,1380,211911052,211911292
1518,5,12,149,5745,-70,-96,26,5e:36:fe:bc:a2:fe,211912700,440,968,211912260,211912700
1519,5,12,149,5745,-77,-96,19,56:68:e2:c2:8d:d5,211913201,476,25,211912725,211913201
1520,5,12,149,5745,-61,-96,35,3e:d1:9b:c7:a4:de,211914620,544,875,211914076,211914620
1521,5,24,149,5745,-77,-96,19,,211923894,28,9246,211923866,211923894
1522,5,24,149,5745,-77,-96,19,,211924174,28,252,211924146,211924174
1523,5,24,149,5745,-77,-96,19,,211924341,28,139,211924313,211924341
1524,5,6,149,5745,-76,-96,20,,211924549,52,156,211924497,211924549
1525,5,6,149,5745,-77,-96,19,,211926704,52,2103,211926652,211926704
1526,5,6,149,5745,-89,-96,7,,211926771,44,23,211926727,211926771
1527,5,12,149,5745,-77,-96,19,22:ec:75:a8:8a:31,211927200,244,185,211926956,211927200
1528,5,12,149,5745,-77,-96,19,f6:0a:5c:59:72:df,211928213,252,761,211927961,211928213
1529,5,24,149,5745,-77,-96,19,,211928537,28,296,211928509,211928537
1530,5,12,149,5745,-76,-96,20,a6:92:ad:b7:76:65,211933206,456,4213,211932750,211933206
1531,5,12,149,5745,-74,-96,22,c2:21:7d:48:b5:63,211934851,240,1405,211934611,211934851
1532,5,12,149,5745,-78,-96,18,56:68:e2:c2:8d:d5,211942853,280,7722,211942573,211942853
1533,5,12,149,5745,-69,-96,27,5e:36:fe:bc:a2:fe,211943193,244,96,211942949,211943193
1534,5,24,149,5745,-76,-96,20,,211944398,28,1177,211944370,211944398
1535,5,24,149,5745,-76,-96,20,,211945797,28,1371,211945769,211945797
1536,5,12,149,5745,-79,-96,17,72:d1:72:1d:22:a1,211946614,256,561,211946358,211946614
1537,5,24,149,5745,-76,-96,20,,211947688,28,1046,211947660,211947688
1538,5,6,149,5745,-88,-96,8,54:e4:3a:ec:fb:65,211951645,360,3597,211951285,211951645
1539,5,12,149,5745,-58,-96,38,72:fd:09:2f:da:5f,211963913,480,11788,211963433,211963913
1540,5,12,149,5745,-74,-96,22,02:31:8a:29:26:f4,211964671,268,490,211964403,211964671
1541,5,12,149,5745,-76,-96,20,22:ec:75:a8:8a:31,211965010,516,-177,211964494,211965010
1542,5,12,149,5745,-78,-96,18,9a:24:38:da:96:bb,211967722,356,2356,211967366,211967722
1543,5,12,149,5745,-51,-96,45,5e:29:73:5b:30:00,211968350,540,88,211967810,211968350
1544,5,12,149,5745,-79,-96,17,f6:0a:5c:59:72:df,211969059,268,441,211968791,211969059
1545,5,12,149,5745,-73,-96,23,fa:44:8d:e1:c7:1b,211970110,440,611,211969670,211970110
1546,5,12,149,5745,-68,-96,28,0a:b9:b7:b1:4d:fa,211974112,268,3734,211973844,211974112
1547,5,24,149,5745,-87,-96,9,,211975754,28,1614,211975726,211975754
1548,5,12,149,5745,-75,-96,21,a6:92:ad:b7:76:65,211976414,256,404,211976158,211976414
1549,5,12,149,5745,-70,-96,26,5e:36:fe:bc:a2:fe,211976804,440,-50,211976364,211976804
1550,5,12,149,5745,-78,-96,18,56:68:e2:c2:8d:d5,211977907,476,627,211977431,211977907
1551,5,12,149,5745,-61,-96,35,3e:d1:9b:c7:a4:de,211979262,544,811,211978718,211979262
1552,5,12,149,5745,-60,-96,36,f2:da:61:dd:98:c5,211980382,268,852,211980114,211980382
1553,5,12,149,5745,-74,-96,22,a6:92:ad:b7:76:65,211981152,456,314,211980696,211981152
1554,5,12,149,5745,-80,-96,16,f6:0a:5c:59:72:df,211982002,448,402,211981554,211982002
1555,5,12,149,5745,-74,-96,22,c2:21:7d:48:b5:63,211984468,240,2226,211984228,211984468
1556,5,12,149,5745,-61,-96,35,3e:d1:9b:c7:a4:de,211993490,272,8750,211993218,211993490
1557,5,12,149,5745,-51,-96,45,5e:29:73:5b:30:00,211993823,272,61,211993551,211993823
1558,5,12,149,5745,-58,-96,38,72:fd:09:2f:da:5f,211994668,284,561,211994384,211994668
1559,5,24,149,5745,-76,-96,20,,211999294,28,4598,211999266,211999294
1560,5,24,149,5745,-89,-96,7,,211999454,32,128,211999422,211999454
1561,5,24,149,5745,-76,-96,20,,211999615,28,133,211999587,211999615
1562,5,12,149,5745,-77,-96,19,9a:24:38:da:96:bb,211999847,272,-40,211999575,211999847
1563,5,12,149,5745,-79,-96,17,72:d1:72:1d:22:a1,212003394,452,3095,212002942,212003394
1564,5,6,149,5745,-91,-96,5,78:ba:f9:ec:b1:f0,212008233,168,4671,212008065,212008233
1565,5,12,149,5745,-61,-96,35,f2:da:61:dd:98:c5,212011295,268,2794,212011027,212011295
1566,5,12,149,5745,-76,-96,20,22:ec:75:a8:8a:31,212034158,244,22619,212033914,212034158
1567,5,24,149,5745,-88,-96,8,,212034554,28,368,212034526,212034554
1568,5,12,149,5745,-73,-96,23,c2:21:7d:48:b5:63,212040833,240,6039,212040593,212040833
1569,5,12,149,5745,-69,-96,27,5e:36:fe:bc:a2:fe,212042250,440,977,212041810,212042250
1570,5,6,149,5745,-88,-96,8,54:e4:3a:ec:fb:65,212054046,360,11436,212053686,212054046
1571,5,24,149,5745,-89,-96,7,,212054397,28,323,212054369,212054397
1572,5,12,149,5745,-70,-96,26,5e:36:fe:bc:a2:fe,212057385,244,2744,212057141,212057385
1573,5,12,149,5745,-78,-96,18,56:68:e2:c2:8d:d5,212067669,280,10004,212067389,212067669
1574,5,24,149,5745,-88,-96,8,,212068114,28,417,212068086,212068114
1575,5,24,149,5745,-89,-96,7,,212068414,28,272,212068386,212068414
1576,5,24,149,5745,-88,-96,8,,212068528,32,82,212068496,212068528
1577,5,24,149,5745,-88,-96,8,,212069776,32,1216,212069744,212069776
1578,5,12,149,5745,-79,-96,17,72:d1:72:1d:22:a1,212072267,256,2235,212072011,212072267
1579,5,24,149,5745,-88,-96,8,,212072572,28,277,212072544,212072572
1580,5,24,149,5745,-88,-96,8,,212072750,32,146,212072718,212072750
1581,5,24,149,5745,-88,-96,8,,212073232,28,454,212073204,212073232
1582,5,12,149,5745,-60,-96,36,3e:d1:9b:c7:a4:de,212092479,272,18975,212092207,212092479
1583,5,24,149,5745,-88,-96,8,,212097919,32,5408,212097887,212097919
1584,5,12,149,5745,-52,-96,44,5e:29:73:5b:30:00,212099243,272,1052,212098971,212099243
1585,5,12,149,5745,-79,-96,17,9a:24:38:da:96:bb,212112837,272,13322,212112565,212112837
1586,5,24,149,5745,-88,-96,8,,212132409,28,19544,212132381,212132409
1587,5,12,149,5745,-74,-96,22,22:ec:75:a8:8a:31,212151682,244,19029,212151438,212151682
1588,5,12,149,5745,-56,-96,40,72:fd:09:2f:da:5f,212152932,284,966,212152648,212152932
1589,5,24,149,5745,-89,-96,7,,212154832,32,1868,212154800,212154832
1590,5,6,149,5745,-88,-96,8,54:e4:3a:ec:fb:65,212156446,360,1254,212156086,212156446
1591,5,12,149,5745,-56,-96,40,f2:da:61:dd:98:c5,212157339,268,625,212157071,212157339
1592,5,12,149,5745,-73,-96,23,02:31:8a:29:26:f4,212162093,268,4486,212161825,212162093
1593,5,12,149,5745,-70,-96,26,5e:36:fe:bc:a2:fe,212167907,244,5570,212167663,212167907
1594,5,12,149,5745,-73,-96,23,f6:0a:5c:59:72:df,212173358,252,5199,212173106,212173358
1595,5,12,149,5745,-77,-96,19,56:68:e2:c2:8d:d5,212177915,280,4277,212177635,212177915
1596,5,12,149,5745,-72,-96,24,a6:92:ad:b7:76:65,212179655,256,1484,212179399,212179655
1597,5,12,149,5745,-75,-96,21,c2:21:7d:48:b5:63,212182224,240,2329,212181984,212182224
1598,5,12,149,5745,-78,-96,18,72:d1:72:1d:22:a1,212185808,256,3328,212185552,212185808
1599,5,24,149,5745,-88,-96,8,,212186853,32,1013,212186821,212186853
1600,5,24,149,5745,-89,-96,7,,212207026,28,20145,212206998,212207026
1601,5,12,149,5745,-60,-96,36,3e:d1:9b:c7:a4:de,212209601,272,2303,212209329,212209601
1602,5,12,149,5745,-51,-96,45,5e:29:73:5b:30:00,212216544,272,6671,212216272,212216544
1603,5,12,149,5745,-75,-96,21,9a:24:38:da:96:bb,212228269,272,11453,212227997,212228269
1604,5,24,149,5745,-87,-96,9,,212249179,28,20882,212249151,212249179
1605,5,12,149,5745,-90,-96,6,,212249687,36,472,212249651,212249687
1606,5,12,149,5745,-87,-96,9,,212249741,32,22,212249709,212249741
1607,5,12,149,5745,-87,-96,9,,212249858,44,73,212249814,212249858
1608,5,12,149,5745,-56,-96,40,72:fd:09:2f:da:5f,212254763,284,4621,212254479,212254763
1609,5,6,149,5745,-87,-96,9,54:e4:3a:ec:fb:65,212258847,360,3724,212258487,212258847
1610,5,12,149,5745,-57,-96,39,f2:da:61:dd:98:c5,212259676,268,561,212259408,212259676
1611,5,24,149,5745,-88,-96,8,,212264378,28,4674,212264350,212264378
1612,5,12,149,5745,-73,-96,23,22:ec:75:a8:8a:31,212268861,244,4239,212268617,212268861
1613,5,12,149,5745,-72,-96,24,a6:92:ad:b7:76:65,212282279,256,13162,212282023,212282279
1614,5,12,149,5745,-76,-96,20,c2:21:7d:48:b5:63,212285363,240,2844,212285123,212285363
1615,5,12,149,5745,-73,-96,23,f6:0a:5c:59:72:df,212288255,252,2640,212288003,212288255
1616,5,12,149,5745,-70,-96,26,5e:36:fe:bc:a2:fe,212290458,244,1959,212290214,212290458
1617,5,12,149,5745,-77,-96,19,56:68:e2:c2:8d:d5,212291451,280,713,212291171,212291451
1618,5,12,149,5745,-77,-96,19,72:d1:72:1d:22:a1,212296063,256,4356,212295807,212296063
1619,5,12,149,5745,-60,-96,36,3e:d1:9b:c7:a4:de,212326739,272,30404,212326467,212326739
1620,5,12,149,5745,-74,-96,22,a6:92:ad:b7:76:65,212330641,256,3646,212330385,212330641
1621,5,12,149,5745,-76,-96,20,9a:24:38:da:96:bb,212336342,272,5429,212336070,212336342
1622,5,12,149,5745,-54,-96,42,72:fd:09:2f:da:5f,212343971,284,7345,212343687,212343971
1623,5,12,149,5745,-51,-96,45,5e:29:73:5b:30:00,212354027,272,9784,212353755,212354027
1624,5,12,149,5745,-61,-96,35,f2:da:61:dd:98:c5,212354956,268,661,212354688,212354956
1625,5,12,149,5745,-74,-96,22,22:ec:75:a8:8a:31,212361144,516,5672,212360628,212361144
1626,5,6,149,5745,-86,-96,10,54:e4:3a:ec:fb:65,212361692,360,188,212361332,212361692
1627,5,12,149,5745,-54,-96,42,72:fd:09:2f:da:5f,212362116,480,-56,212361636,212362116
1628,5,12,149,5745,-51,-96,45,5e:29:73:5b:30:00,212362837,540,181,212362297,212362837
1629,5,12,149,5745,-76,-96,20,9a:24:38:da:96:bb,212365152,824,1491,212364328,212365152
1630,5,12,149,5745,-75,-96,21,c2:21:7d:48:b5:63,212369911,240,4519,212369671,212369911
1631,5,12,149,5745,-60,-96,36,3e:d1:9b:c7:a4:de,212373758,544,3303,212373214,212373758
1632,5,12,149,5745,-76,-96,20,f6:0a:5c:59:72:df,212374808,448,602,212374360,212374808
1633,5,12,149,5745,-76,-96,20,56:68:e2:c2:8d:d5,212375290,476,6,212374814,212375290
1634,5,12,149,5745,-61,-96,35,f2:da:61:dd:98:c5,212375854,268,296,212375586,212375854
1635,5,12,149,5745,-76,-96,20,c2:21:7d:48:b5:63,212378686,240,2592,212378446,212378686
1636,5,12,149,5745,-77,-96,19,72:d1:72:1d:22:a1,212381832,452,2694,212381380,212381832
1637,5,12,149,5745,-77,-96,19,f6:0a:5c:59:72:df,212385407,252,3323,212385155,212385407
1638,5,12,149,5745,-77,-96,19,72:d1:72:1d:22:a1,212405260,256,19597,212405004,212405260
1639,5,12,149,5745,-55,-96,41,72:fd:09:2f:da:5f,212422704,480,16964,212422224,212422704
1640,5,12,149,5745,-76,-96,20,fa:44:8d:e1:c7:1b,212433451,440,10307,212433011,212433451
1641,5,12,149,5745,-60,-96,36,3e:d1:9b:c7:a4:de,212443423,272,9700,212443151,212443423
1642,5,12,149,5745,-78,-96,18,9a:24:38:da:96:bb,212449228,272,5533,212448956,212449228
1643,5,12,149,5745,-53,-96,43,5e:29:73:5b:30:00,212450220,272,720,212449948,212450220
1644,5,12,149,5745,-54,-96,42,72:fd:09:2f:da:5f,212453335,284,2831,212453051,212453335
1645,5,6,149,5745,-87,-96,9,54:e4:3a:ec:fb:65,212463648,360,9953,212463288,212463648
1646,5,12,149,5745,-75,-96,21,fa:44:8d:e1:c7:1b,212467487,244,3595,212467243,212467487
1647,5,12,149,5745,-71,-96,25,5e:36:fe:bc:a2:fe,212468972,372,1113,212468600,212468972
1648,5,12,149,5745,-59,-96,37,f2:da:61:dd:98:c5,212471190,268,1950,212470922,212471190
1649,5,12,149,5745,-77,-96,19,c2:21:7d:48:b5:63,212484630,240,13200,212484390,212484630
1650,5,12,149,5745,-54,-96,42,72:fd:09:2f:da:5f,212488246,480,3136,212487766,212488246
1651,5,12,149,5745,-75,-96,21,22:ec:75:a8:8a:31,212490779,516,2017,212490263,212490779
1652,5,12,149,5745,-72,-96,24,02:31:8a:29:26:f4,212492393,268,1346,212492125,212492393
1653,5,12,149,5745,-55,-96,41,5e:29:73:5b:30:00,212495317,540,2384,212494777,212495317
1654,5,12,149,5745,-78,-96,18,9a:24:38:da:96:bb,212496449,824,308,212495625,212496449
1655,5,12,149,5745,-73,-96,23,fa:44:8d:e1:c7:1b,212498132,440,1243,212497692,212498132
1656,5,12,149,5745,-75,-96,21,22:ec:75:a8:8a:31,212499434,244,1058,212499190,212499434
1657,5,12,149,5745,-70,-96,26,0a:b9:b7:b1:4d:fa,212500113,268,411,212499845,212500113
1658,5,12,149,5745,-72,-96,24,5e:36:fe:bc:a2:fe,212504397,440,3844,212503957,212504397
1659,5,12,149,5745,-60,-96,36,f2:da:61:dd:98:c5,212505763,268,1098,212505495,212505763
1660,5,12,149,5745,-61,-96,35,3e:d1:9b:c7:a4:de,212506120,544,-187,212505576,212506120
1661,5,12,149,5745,-74,-96,22,a6:92:ad:b7:76:65,212509758,456,3182,212509302,212509758
1662,5,12,149,5745,-78,-96,18,c2:21:7d:48:b5:63,212510621,240,623,212510381,212510621
1663,5,12,149,5745,-63,-96,33,3e:d1:9b:c7:a4:de,212560807,272,49914,212560535,212560807
1664,5,12,149,5745,-78,-96,18,9a:24:38:da:96:bb,212561854,272,775,212561582,212561854
1665,5,6,149,5745,-87,-96,9,54:e4:3a:ec:fb:65,212566048,360,3834,212565688,212566048
1666,5,12,149,5745,-54,-96,42,5e:29:73:5b:30:00,212567566,272,1246,212567294,212567566
1667,5,12,149,5745,-53,-96,43,72:fd:09:2f:da:5f,212570789,284,2939,212570505,212570789
1668,5,12,149,5745,-75,-96,21,fa:44:8d:e1:c7:1b,212586311,244,15278,212586067,212586311
1669,5,12,149,5745,-79,-96,17,72:d1:72:1d:22:a1,212590986,256,4419,212590730,212590986
1670,5,12,149,5745,-78,-96,18,56:68:e2:c2:8d:d5,212592842,280,1576,212592562,212592842
1671,5,12,149,5745,-76,-96,20,c2:21:7d:48:b5:63,212602615,240,9533,212602375,212602615
1672,5,12,149,5745,-73,-96,23,22:ec:75:a8:8a:31,212610401,244,7542,212610157,212610401
1673,5,12,149,5745,-73,-96,23,f6:0a:5c:59:72:df,212628657,252,18004,212628405,212628657
1674,5,6,149,5745,-87,-96,9,54:e4:3a:ec:fb:65,212668449,360,39432,212668089,212668449
1675,5,12,149,5745,-55,-96,41,f2:da:61:dd:98:c5,212669003,268,286,212668735,212669003
1676,5,12,149,5745,-61,-96,35,3e:d1:9b:c7:a4:de,212676846,272,7571,212676574,212676846
1677,5,12,149,5745,-74,-96,22,9a:24:38:da:96:bb,212679500,272,2382,212679228,212679500
1678,5,12,149,5745,-53,-96,43,72:fd:09:2f:da:5f,212681046,284,1262,212680762,212681046
1679,5,12,149,5745,-52,-96,44,5e:29:73:5b:30:00,212684630,272,3312,212684358,212684630
1680,5,12,149,5745,-71,-96,25,02:31:8a:29:26:f4,212688502,268,3604,212688234,212688502
1681,5,12,149,5745,-79,-96,17,72:d1:72:1d:22:a1,212693163,256,4405,212692907,212693163
1682,5,12,149,5745,-80,-96,16,56:68:e2:c2:8d:d5,212695235,280,1792,212694955,212695235
1683,5,12,149,5745,-72,-96,24,fa:44:8d:e1:c7:1b,212698777,244,3298,212698533,212698777
1684,5,24,149,5745,-78,-96,18,,212706827,28,8022,212706799,212706827
1685,5,12,149,5745,-71,-96,25,22:ec:75:a8:8a:31,212721642,244,14571,212721398,212721642
1686,5,12,149,5745,-72,-96,24,f6:0a:5c:59:72:df,212751711,252,29817,212751459,212751711
1687,5,6,149,5745,-88,-96,8,54:e4:3a:ec:fb:65,212770849,360,18778,212770489,212770849
1688,5,12,149,5745,-54,-96,42,f2:da:61:dd:98:c5,212771562,268,445,212771294,212771562
1689,5,12,149,5745,-73,-96,23,9a:24:38:da:96:bb,212785599,272,13765,212785327,212785599
1690,5,12,149,5745,-60,-96,36,3e:d1:9b:c7:a4:de,212794787,272,8916,212794515,212794787
1691,5,12,149,5745,-78,-96,18,c2:21:7d:48:b5:63,212795335,240,308,212795095,212795335
1692,5,12,149,5745,-80,-96,16,72:d1:72:1d:22:a1,212795672,256,81,212795416,212795672
1693,5,12,149,5745,-78,-96,18,56:68:e2:c2:8d:d5,212797616,280,1664,212797336,212797616
1694,5,12,149,5745,-54,-96,42,5e:29:73:5b:30:00,212801620,272,3732,212801348,212801620
1695,5,12,149,5745,-74,-96,22,fa:44:8d:e1:c7:1b,212806755,244,4891,212806511,212806755
1696,5,12,149,5745,-72,-96,24,22:ec:75:a8:8a:31,212835045,244,28046,212834801,212835045
1697,5,12,149,5745,-58,-96,38,72:fd:09:2f:da:5f,212869803,284,34474,212869519,212869803
1698,5,6,149,5745,-87,-96,9,54:e4:3a:ec:fb:65,212873250,360,3087,212872890,212873250
1699,5,12,149,5745,-51,-96,45,f2:da:61:dd:98:c5,212874519,268,1001,212874251,212874519
1700,5,12,149,5745,-81,-96,15,72:d1:72:1d:22:a1,212897913,256,23138,212897657,212897913
1701,5,12,149,5745,-79,-96,17,c2:21:7d:48:b5:63,212898437,240,284,212898197,212898437
1702,5,12,149,5745,-82,-96,14,56:68:e2:c2:8d:d5,212899393,280,676,212899113,212899393
1703,5,12,149,5745,-58,-96,38,72:fd:09:2f:da:5f,212905477,284,5800,212905193,212905477
1704,5,12,149,5745,-59,-96,37,3e:d1:9b:c7:a4:de,212906641,272,892,212906369,212906641
1705,5,12,149,5745,-52,-96,44,5e:29:73:5b:30:00,212913600,272,6687,212913328,212913600
1706,5,12,149,5745,-74,-96,22,fa:44:8d:e1:c7:1b,212914059,244,215,212913815,212914059
1707,5,24,149,5745,-77,-96,19,,212922674,28,8587,212922646,212922674
1708,5,12,149,5745,-57,-96,39,72:fd:09:2f:da:5f,212929655,380,6601,212929275,212929655
1709,5,12,149,5745,-56,-96,40,f2:da:61:dd:98:c5,212930124,268,201,212929856,212930124
1710,5,12,149,5745,-81,-96,15,d2:00:04:7e:2c:ab,212932145,244,1777,212931901,212932145
1711,5,12,149,5745,-79,-96,17,c2:21:7d:48:b5:63,212943533,240,11148,212943293,212943533
1712,5,12,149,5745,-57,-96,39,72:fd:09:2f:da:5f,212947479,480,3466,212946999,212947479
1713,5,12,149,5745,-76,-96,20,22:ec:75:a8:8a:31,212948803,516,808,212948287,212948803
1714,5,12,149,5745,-52,-96,44,5e:29:73:5b:30:00,212951399,540,2056,212950859,212951399
1715,5,12,149,5745,-73,-96,23,f6:0a:5c:59:72:df,212956209,252,4558,212955957,212956209
1716,5,12,149,5745,-76,-96,20,fa:44:8d:e1:c7:1b,212957783,440,1134,212957343,212957783
1717,5,12,149,5745,-80,-96,16,56:68:e2:c2:8d:d5,212958285,280,222,212958005,212958285
1718,5,12,149,5745,-76,-96,20,22:ec:75:a8:8a:31,212958599,244,70,212958355,212958599
1719,5,12,149,5745,-82,-96,14,d2:00:04:7e:2c:ab,212961067,412,2056,212960655,212961067
1720,5,12,149,5745,-81,-96,15,56:68:e2:c2:8d:d5,212961513,476,-30,212961037,212961513
1721,5,12,149,5745,-59,-96,37,3e:d1:9b:c7:a4:de,212962078,544,21,212961534,212962078
1722,5,12,149,5745,-56,-96,40,f2:da:61:dd:98:c5,212964952,268,2606,212964684,212964952
1723,5,12,149,5745,-74,-96,22,f6:0a:5c:59:72:df,212965381,448,-19,212964933,212965381
1724,5,12,149,5745,-79,-96,17,c2:21:7d:48:b5:63,212968780,240,3159,212968540,212968780
1725,5,12,149,5745,-85,-96,11,72:d1:72:1d:22:a1,212972251,452,3019,212971799,212972251
1726,5,6,149,5745,-89,-96,7,54:e4:3a:ec:fb:65,212975651,360,3040,212975291,212975651
1727,5,24,149,5745,-79,-96,17,,212994628,28,18949,212994600,212994628
1728,5,12,149,5745,-81,-96,15,9a:24:38:da:96:bb,213008595,272,13695,213008323,213008595
1729,5,12,149,5745,-55,-96,41,72:fd:09:2f:da:5f,213010403,284,1524,213010119,213010403
1730,5,12,149,5745,-80,-96,16,9a:24:38:da:96:bb,213012188,824,961,213011364,213012188
1731,5,12,149,5745,-55,-96,41,72:fd:09:2f:da:5f,213013046,480,378,213012566,213013046
1732,5,12,149,5745,-77,-96,19,22:ec:75:a8:8a:31,213013587,516,25,213013071,213013587
1733,5,12,149,5745,-72,-96,24,02:31:8a:29:26:f4,213016362,268,2507,213016094,213016362
1734,5,12,149,5745,-50,-96,46,5e:29:73:5b:30:00,213016664,540,-238,213016124,213016664
1735,5,12,149,5745,-80,-96,16,d2:00:04:7e:2c:ab,213020847,440,3743,213020407,213020847
1736,5,12,149,5745,-54,-96,42,72:fd:09:2f:da:5f,213021895,380,668,213021515,213021895
1737,5,12,149,5745,-74,-96,22,fa:44:8d:e1:c7:1b,213022615,440,280,213022175,213022615
1738,5,12,149,5745,-73,-96,23,fa:44:8d:e1:c7:1b,213024151,244,1292,213023907,213024151
1739,5,12,149,5745,-72,-96,24,0a:b9:b7:b1:4d:fa,213024438,268,19,213024170,213024438
1740,5,12,149,5745,-65,-96,31,3e:d1:9b:c7:a4:de,213025659,544,677,213025115,213025659
1741,5,12,149,5745,-80,-96,16,d2:00:04:7e:2c:ab,213026318,380,279,213025938,213026318
1742,5,12,149,5745,-56,-96,40,f2:da:61:dd:98:c5,213026732,268,146,213026464,213026732
1743,5,12,149,5745,-83,-96,13,56:68:e2:c2:8d:d5,213027088,476,-120,213026612,213027088
1744,5,12,149,5745,-56,-96,40,f2:da:61:dd:98:c5,213028021,268,665,213027753,213028021
1745,5,12,149,5745,-73,-96,23,5e:36:fe:bc:a2:fe,213030834,440,2373,213030394,213030834
1746,5,12,149,5745,-79,-96,17,f6:0a:5c:59:72:df,213031425,448,143,213030977,213031425
1747,5,12,149,5745,-76,-96,20,c2:21:7d:48:b5:63,213032530,240,865,213032290,213032530
1748,5,12,149,5745,-75,-96,21,a6:92:ad:b7:76:65,213034118,456,1132,213033662,213034118
1749,5,12,149,5745,-81,-96,15,72:d1:72:1d:22:a1,213035537,452,967,213035085,213035537
1750,5,12,149,5745,-66,-96,30,3e:d1:9b:c7:a4:de,213039828,272,4019,213039556,213039828
1751,5,12,149,5745,-50,-96,46,5e:29:73:5b:30:00,213042168,272,2068,213041896,213042168
1752,5,12,149,5745,-80,-96,16,d2:00:04:7e:2c:ab,213042528,244,116,213042284,213042528
1753,5,24,149,5745,-78,-96,18,,213044974,28,2418,213044946,213044974
1754,5,12,149,5745,-75,-96,21,c2:21:7d:48:b5:63,213058616,240,13402,213058376,213058616
1755,5,12,149,5745,-77,-96,19,22:ec:75:a8:8a:31,213060375,244,1515,213060131,213060375
1756,5,6,149,5745,-86,-96,10,54:e4:3a:ec:fb:65,213078051,360,17316,213077691,213078051
1757,5,12,149,5745,-77,-96,19,f6:0a:5c:59:72:df,213080249,252,1946,213079997,213080249
1758,5,12,149,5745,-80,-96,16,56:68:e2:c2:8d:d5,213086478,280,5949,213086198,213086478
1759,5,12,149,5745,-80,-96,16,72:d1:72:1d:22:a1,213091493,256,4759,213091237,213091493
1760,5,12,149,5745,-79,-96,17,d2:00:04:7e:2c:ab,213096754,440,4821,213096314,213096754
1761,5,12,149,5745,-76,-96,20,9a:24:38:da:96:bb,213121586,272,24560,213121314,213121586
1762,5,12,149,5745,-51,-96,45,72:fd:09:2f:da:5f,213130696,284,8826,213130412,213130696
1763,5,12,149,5745,-64,-96,32,3e:d1:9b:c7:a4:de,213141238,272,10270,213140966,213141238
1764,5,12,149,5745,-51,-96,45,5e:29:73:5b:30:00,213142175,272,665,213141903,213142175
1765,5,12,149,5745,-80,-96,16,d2:00:04:7e:2c:ab,213156629,244,14210,213156385,213156629
1766,5,12,149,5745,-76,-96,20,22:ec:75:a8:8a:31,213178430,244,21557,213178186,213178430
1767,5,6,149,5745,-87,-96,9,54:e4:3a:ec:fb:65,213180452,360,1662,213180092,213180452
1768,5,12,149,5745,-55,-96,41,f2:da:61:dd:98:c5,213181038,268,318,213180770,213181038
1769,5,12,149,5745,-80,-96,16,56:68:e2:c2:8d:d5,213190189,280,8871,213189909,213190189
1770,5,12,149,5745,-80,-96,16,72:d1:72:1d:22:a1,213204361,256,13916,213204105,213204361
1771,5,12,149,5745,-73,-96,23,c2:21:7d:48:b5:63,213205048,240,447,213204808,213205048
1772,5,12,149,5745,-71,-96,25,fa:44:8d:e1:c7:1b,213205431,244,139,213205187,213205431
1773,5,12,149,5745,-75,-96,21,02:31:8a:29:26:f4,213209355,268,3656,213209087,213209355
1774,5,12,149,5745,-63,-96,33,3e:d1:9b:c7:a4:de,213258249,272,48622,213257977,213258249
1775,5,12,149,5745,-50,-96,46,5e:29:73:5b:30:00,213259053,272,532,213258781,213259053
1776,5,12,149,5745,-54,-96,42,72:fd:09:2f:da:5f,213279038,284,19701,213278754,213279038
1777,5,6,149,5745,-88,-96,8,54:e4:3a:ec:fb:65,213282852,360,3454,213282492,213282852
1778,5,12,149,5745,-55,-96,41,f2:da:61:dd:98:c5,213283708,268,588,213283440,213283708
1779,5,12,149,5745,-75,-96,21,22:ec:75:a8:8a:31,213295464,244,11512,213295220,213295464
1780,5,12,149,5745,-81,-96,15,56:68:e2:c2:8d:d5,213300913,280,5169,213300633,213300913
1781,5,12,149,5745,-71,-96,25,fa:44:8d:e1:c7:1b,213306475,244,5318,213306231,213306475
1782,5,12,149,5745,-79,-96,17,d2:00:04:7e:2c:ab,213306800,244,81,213306556,213306800
1783,5,12,149,5745,-74,-96,22,c2:21:7d:48:b5:63,213307241,240,201,213307001,213307241
1784,5,24,149,5745,-80,-96,16,,213314110,28,6841,213314082,213314110
1785,5,12,149,5745,-81,-96,15,72:d1:72:1d:22:a1,213317475,256,3109,213317219,213317475
1786,5,12,149,5745,-71,-96,25,9a:24:38:da:96:bb,213349402,272,31655,213349130,213349402
1787,5,24,149,5745,-79,-96,17,,213367696,28,18266,213367668,213367696
1788,5,12,149,5745,-52,-96,44,5e:29:73:5b:30:00,213374538,272,6570,213374266,213374538
1789,5,12,149,5745,-63,-96,33,3e:d1:9b:c7:a4:de,213374844,272,34,213374572,213374844
1790,5,12,149,5745,-71,-96,25,fa:44:8d:e1:c7:1b,213378248,244,3160,213378004,213378248
1791,5,12,149,5745,-54,-96,42,72:fd:09:2f:da:5f,213382485,284,3953,213382201,213382485
1792,5,6,149,5745,-86,-96,10,54:e4:3a:ec:fb:65,213385253,360,2408,213384893,213385253
1793,5,12,149,5745,-80,-96,16,d2:00:04:7e:2c:ab,213388151,244,2654,213387907,213388151
1794,5,12,149,5745,-52,-96,44,f2:da:61:dd:98:c5,213388618,268,199,213388350,213388618
1795,5,12,149,5745,-80,-96,16,56:68:e2:c2:8d:d5,213400440,280,11542,213400160,213400440
1796,5,12,149,5745,-76,-96,20,c2:21:7d:48:b5:63,213401997,240,1317,213401757,213401997
1797,5,12,149,5745,-78,-96,18,9a:24:38:da:96:bb,213403712,824,891,213402888,213403712
1798,5,12,149,5745,-55,-96,41,72:fd:09:2f:da:5f,213407550,480,3358,213407070,213407550
1799,5,12,149,5745,-76,-96,20,c2:21:7d:48:b5:63,213408991,240,1201,213408751,213408991
1800,5,12,149,5745,-74,-96,22,22:ec:75:a8:8a:31,213410237,516,730,213409721,213410237
1801,5,12,149,5745,-77,-96,19,f6:0a:5c:59:72:df,213411147,252,658,213410895,213411147
1802,5,12,149,5745,-52,-96,44,5e:29:73:5b:30:00,213411921,540,234,213411381,213411921
1803,5,12,149,5745,-70,-96,26,fa:44:8d:e1:c7:1b,213415681,440,3320,213415241,213415681
1804,5,12,149,5745,-56,-96,40,72:fd:09:2f:da:5f,213416228,380,167,213415848,213416228
1805,5,12,149,5745,-74,-96,22,22:ec:75:a8:8a:31,213416930,244,458,213416686,213416930
1806,5,12,149,5745,-63,-96,33,3e:d1:9b:c7:a4:de,213418783,544,1309,213418239,213418783
1807,5,12,149,5745,-79,-96,17,72:d1:72:1d:22:a1,213420650,256,1611,213420394,213420650
1808,5,12,149,5745,-52,-96,44,f2:da:61:dd:98:c5,213423118,268,2200,213422850,213423118
1809,5,12,149,5745,-77,-96,19,56:68:e2:c2:8d:d5,213423834,476,240,213423358,213423834
1810,5,12,149,5745,-77,-96,19,f6:0a:5c:59:72:df,213424452,448,170,213424004,213424452
1811,5,12,149,5745,-80,-96,16,d2:00:04:7e:2c:ab,213426187,440,1295,213425747,213426187
1812,5,12,149,5745,-73,-96,23,a6:92:ad:b7:76:65,213429307,456,2664,213428851,213429307
1813,5,12,149,5745,-78,-96,18,72:d1:72:1d:22:a1,213430114,452,355,213429662,213430114
1814,5,12,149,5745,-56,-96,40,72:fd:09:2f:da:5f,213450691,284,20293,213450407,213450691
1815,5,12,149,5745,-75,-96,21,9a:24:38:da:96:bb,213457418,272,6455,213457146,213457418
1816,5,12,149,5745,-71,-96,25,fa:44:8d:e1:c7:1b,213467170,440,9312,213466730,213467170
1817,5,12,149,5745,-55,-96,41,72:fd:09:2f:da:5f,213468742,480,1092,213468262,213468742
1818,5,12,149,5745,-73,-96,23,a6:92:ad:b7:76:65,213475898,456,6700,213475442,213475898
1819,5,12,149,5745,-72,-96,24,fa:44:8d:e1:c7:1b,213482887,244,6745,213482643,213482887
1820,5,12,149,5745,-77,-96,19,d2:00:04:7e:2c:ab,213484553,244,1422,213484309,213484553
1821,5,6,149,5745,-89,-96,7,54:e4:3a:ec:fb:65,213487653,360,2740,213487293,213487653
1822,5,12,149,5745,-51,-96,45,f2:da:61:dd:98:c5,213488433,268,512,213488165,213488433
1823,5,12,149,5745,-68,-96,28,3e:d1:9b:c7:a4:de,213489581,272,876,213489309,213489581
1824,5,12,149,5745,-78,-96,18,d2:00:04:7e:2c:ab,213490013,440,-8,213489573,213490013
1825,5,12,149,5745,-48,-96,48,5e:29:73:5b:30:00,213492456,272,2171,213492184,213492456
1826,5,12,149,5745,-73,-96,23,a6:92:ad:b7:76:65,213516745,256,24033,213516489,213516745
1827,5,12,149,5745,-75,-96,21,c2:21:7d:48:b5:63,213518624,240,1639,213518384,213518624
1828,5,12,149,5745,-78,-96,18,56:68:e2:c2:8d:d5,213525047,280,6143,213524767,213525047
1829,5,12,149,5745,-74,-96,22,22:ec:75:a8:8a:31,213531590,244,6299,213531346,213531590
1830,5,12,149,5745,-70,-96,26,fa:44:8d:e1:c7:1b,213533021,440,991,213532581,213533021
1831,5,12,149,5745,-54,-96,42,72:fd:09:2f:da:5f,213534143,480,642,213533663,213534143
1832,5,12,149,5745,-78,-96,18,9a:24:38:da:96:bb,213534788,824,-179,213533964,213534788
1833,5,12,149,5745,-76,-96,20,f6:0a:5c:59:72:df,213535806,252,766,213535554,213535806
1834,5,12,149,5745,-70,-96,26,02:31:8a:29:26:f4,213537156,268,1082,213536888,213537156
1835,5,12,149,5745,-75,-96,21,c2:21:7d:48:b5:63,213540132,240,2736,213539892,213540132
1836,5,12,149,5745,-75,-96,21,22:ec:75:a8:8a:31,213540461,516,-187,213539945,213540461
1837,5,12,149,5745,-73,-96,23,a6:92:ad:b7:76:65,213541641,456,724,213541185,213541641
1838,5,12,149,5745,-49,-96,47,5e:29:73:5b:30:00,213543769,540,1588,213543229,213543769
1839,5,12,149,5745,-71,-96,25,0a:b9:b7:b1:4d:fa,213547520,268,3483,213547252,213547520
1840,5,12,149,5745,-70,-96,26,3e:d1:9b:c7:a4:de,213552242,544,4178,213551698,213552242
1841,5,12,149,5745,-69,-96,27,5e:36:fe:bc:a2:fe,213553154,440,472,213552714,213553154
1842,5,12,149,5745,-52,-96,44,f2:da:61:dd:98:c5,213554534,268,1112,213554266,213554534
1843,5,12,149,5745,-80,-96,16,d2:00:04:7e:2c:ab,213555916,440,942,213555476,213555916
1844,5,12,149,5745,-54,-96,42,72:fd:09:2f:da:5f,213565674,284,9474,213565390,213565674
1845,5,12,149,5745,-77,-96,19,9a:24:38:da:96:bb,213568445,272,2499,213568173,213568445
1846,5,24,149,5745,-81,-96,15,,213582967,28,14494,213582939,213582967
1847,5,6,149,5745,-88,-96,8,54:e4:3a:ec:fb:65,213590053,360,6726,213589693,213590053
1848,5,12,149,5745,-79,-96,17,d2:00:04:7e:2c:ab,213599246,244,8949,213599002,213599246
1849,5,12,149,5745,-66,-96,30,3e:d1:9b:c7:a4:de,213601845,272,2327,213601573,213601845
1850,5,12,149,5745,-74,-96,22,fa:44:8d:e1:c7:1b,213608414,244,6325,213608170,213608414
1851,5,12,149,5745,-51,-96,45,5e:29:73:5b:30:00,213608788,272,102,213608516,213608788
1852,5,12,149,5745,-55,-96,41,f2:da:61:dd:98:c5,213611652,268,2596,213611384,213611652
1853,5,12,149,5745,-85,-96,11,72:d1:72:1d:22:a1,213614717,256,2809,213614461,213614717
1854,5,12,149,5745,-79,-96,17,d2:00:04:7e:2c:ab,213621453,440,6296,213621013,213621453
1855,5,12,149,5745,-74,-96,22,c2:21:7d:48:b5:63,213627099,240,5406,213626859,213627099
1856,5,12,149,5745,-74,-96,22,22:ec:75:a8:8a:31,213637640,244,10297,213637396,213637640
1857,5,24,149,5745,-83,-96,13,,213640210,28,2542,213640182,213640210
1858,5,24,149,5745,-82,-96,14,,213652830,28,12592,213652802,213652830
1859,5,12,149,5745,-79,-96,17,9a:24:38:da:96:bb,213681620,272,28518,213681348,213681620
1860,5,12,149,5745,-52,-96,44,72:fd:09:2f:da:5f,213692252,284,10348,213691968,213692252
1861,5,6,149,5745,-86,-96,10,54:e4:3a:ec:fb:65,213692568,360,-44,213692208,213692568
1862,5,12,149,5745,-74,-96,22,a6:92:ad:b7:76:65,213715621,256,22797,213715365,213715621
1863,5,12,149,5745,-71,-96,25,fa:44:8d:e1:c7:1b,213716500,244,635,213716256,213716500
1864,5,12,149,5745,-83,-96,13,72:d1:72:1d:22:a1,213717448,256,692,213717192,213717448
1865,5,12,149,5745,-77,-96,19,56:68:e2:c2:8d:d5,213717909,280,181,213717629,213717909
1866,5,12,149,5745,-80,-96,16,d2:00:04:7e:2c:ab,213722456,244,4303,213722212,213722456
1867,5,12,149,5745,-51,-96,45,5e:29:73:5b:30:00,213725783,272,3055,213725511,213725783
1868,5,12,149,5745,-60,-96,36,3e:d1:9b:c7:a4:de,213727943,272,1888,213727671,213727943
1869,5,12,149,5745,-72,-96,24,02:31:8a:29:26:f4,213733578,268,5367,213733310,213733578
1870,5,12,149,5745,-61,-96,35,3e:d1:9b:c7:a4:de,213747432,544,13310,213746888,213747432
1871,5,12,149,5745,-73,-96,23,22:ec:75:a8:8a:31,213754074,244,6398,213753830,213754074
1872,5,6,149,5745,-86,-96,10,54:e4:3a:ec:fb:65,213794855,360,40421,213794495,213794855
1873,5,12,149,5745,-55,-96,41,f2:da:61:dd:98:c5,213795555,268,432,213795287,213795555
1874,5,12,149,5745,-73,-96,23,9a:24:38:da:96:bb,213796829,272,1002,213796557,213796829
1875,5,12,149,5745,-51,-96,45,72:fd:09:2f:da:5f,213804356,284,7243,213804072,213804356
1876,5,12,149,5745,-77,-96,19,a6:92:ad:b7:76:65,213818021,256,13409,213817765,213818021
1877,5,12,149,5745,-75,-96,21,c2:21:7d:48:b5:63,213819616,240,1355,213819376,213819616
1878,5,12,149,5745,-87,-96,9,72:d1:72:1d:22:a1,213820126,256,254,213819870,213820126
1879,5,12,149,5745,-77,-96,19,56:68:e2:c2:8d:d5,213820434,280,28,213820154,213820434
1880,5,12,149,5745,-72,-96,24,fa:44:8d:e1:c7:1b,213828664,244,7986,213828420,213828664
1881,5,12,149,5745,-61,-96,35,3e:d1:9b:c7:a4:de,213831052,272,2116,213830780,213831052
1882,5,12,149,5745,-79,-96,17,d2:00:04:7e:2c:ab,213831511,244,215,213831267,213831511
1883,5,12,149,5745,-47,-96,49,5e:29:73:5b:30:00,213840105,272,8322,213839833,213840105
1884,5,12,149,5745,-77,-96,19,22:ec:75:a8:8a:31,213872684,244,32335,213872440,213872684
1885,5,12,149,5745,-75,-96,21,f6:0a:5c:59:72:df,213876965,252,4029,213876713,213876965
1886,5,6,149,5745,-89,-96,7,54:e4:3a:ec:fb:65,213885710,352,8393,213885358,213885710
1887,5,6,149,5745,-90,-96,6,54:e4:3a:ec:fb:65,213895954,352,9892,213895602,213895954
1888,5,6,149,5745,-89,-96,7,54:e4:3a:ec:fb:65,213897255,360,941,213896895,213897255
1889,5,12,149,5745,-56,-96,40,f2:da:61:dd:98:c5,213897794,268,271,213897526,213897794
1890,5,12,149,5745,-77,-96,19,a6:92:ad:b7:76:65,213919643,256,21593,213919387,213919643
1891,5,12,149,5745,-75,-96,21,c2:21:7d:48:b5:63,213921667,240,1784,213921427,213921667
1892,5,12,149,5745,-83,-96,13,72:d1:72:1d:22:a1,213922132,256,209,213921876,213922132
1893,5,12,149,5745,-76,-96,20,56:68:e2:c2:8d:d5,213923223,280,811,213922943,213923223
1894,5,12,149,5745,-48,-96,48,72:fd:09:2f:da:5f,213924344,284,837,213924060,213924344
1895,5,12,149,5745,-78,-96,18,fa:44:8d:e1:c7:1b,213938160,244,13572,213937916,213938160
1896,5,12,149,5745,-65,-96,31,3e:d1:9b:c7:a4:de,213943102,272,4670,213942830,213943102
1897,5,12,149,5745,-54,-96,42,f2:da:61:dd:98:c5,213950761,268,7391,213950493,213950761
1898,5,12,149,5745,-47,-96,49,5e:29:73:5b:30:00,213952307,272,1274,213952035,213952307
1899,5,12,149,5745,-83,-96,13,d2:00:04:7e:2c:ab,213953325,244,774,213953081,213953325
1900,5,12,149,5745,-73,-96,23,c2:21:7d:48:b5:63,213968212,240,14647,213967972,213968212
1901,5,12,149,5745,-76,-96,20,a6:92:ad:b7:76:65,213975494,256,7026,213975238,213975494
1902,5,12,149,5745,-76,-96,20,56:68:e2:c2:8d:d5,213977189,280,1415,213976909,213977189
1903,5,12,149,5745,-76,-96,20,f6:0a:5c:59:72:df,213978190,252,749,213977938,213978190
1904,5,24,149,5745,-76,-96,20,,213979972,28,1754,213979944,213979972
1905,5,12,149,5745,-77,-96,19,22:ec:75:a8:8a:31,213990356,244,10140,213990112,213990356
1906,5,12,149,5745,-80,-96,16,fa:44:8d:e1:c7:1b,213992679,440,1883,213992239,213992679
1907,5,12,149,5745,-81,-96,15,72:d1:72:1d:22:a1,213993361,256,426,213993105,213993361
1908,5,12,149,5745,-48,-96,48,72:fd:09:2f:da:5f,213995961,480,2120,213995481,213995961
1909,5,12,149,5745,-77,-96,19,22:ec:75:a8:8a:31,213996601,516,124,213996085,213996601
1910,5,12,149,5745,-72,-96,24,c2:21:7d:48:b5:63,213997855,240,1014,213997615,213997855
1911,5,12,149,5745,-77,-96,19,a6:92:ad:b7:76:65,213999470,456,1159,213999014,213999470
1912,5,12,149,5745,-48,-96,48,5e:29:73:5b:30:00,214000021,540,11,213999481,214000021
1913,5,12,149,5745,-52,-96,44,f2:da:61:dd:98:c5,214009624,268,9335,214009356,214009624
1914,5,12,149,5745,-66,-96,30,3e:d1:9b:c7:a4:de,214009980,544,-188,214009436,214009980
1915,5,12,149,5745,-76,-96,20,56:68:e2:c2:8d:d5,214012259,476,1803,214011783,214012259
1916,5,12,149,5745,-76,-96,20,f6:0a:5c:59:72:df,214013759,448,1052,214013311,214013759
1917,5,12,149,5745,-81,-96,15,d2:00:04:7e:2c:ab,214015323,440,1124,214014883,214015323
1918,5,12,149,5745,-80,-96,16,9a:24:38:da:96:bb,214018944,272,3349,214018672,214018944
1919,5,12,149,5745,-81,-96,15,72:d1:72:1d:22:a1,214019380,452,-16,214018928,214019380
1920,5,12,149,5745,-48,-96,48,72:fd:09:2f:da:5f,214023669,284,4005,214023385,214023669
1921,5,24,149,5745,-77,-96,19,,214026356,28,2659,214026328,214026356
1922,5,12,149,5745,-79,-96,17,fa:44:8d:e1:c7:1b,214040304,244,13704,214040060,214040304
1923,5,12,149,5745,-53,-96,43,f2:da:61:dd:98:c5,214056329,268,15757,214056061,214056329
1924,5,12,149,5745,-77,-96,19,fa:44:8d:e1:c7:1b,214056928,440,159,214056488,214056928
1925,5,12,149,5745,-79,-96,17,d2:00:04:7e:2c:ab,214058347,244,1175,214058103,214058347
1926,5,12,149,5745,-49,-96,47,72:fd:09:2f:da:5f,214058652,480,-175,214058172,214058652
1927,5,12,149,5745,-79,-96,17,9a:24:38:da:96:bb,214059319,824,-157,214058495,214059319
1928,5,12,149,5745,-66,-96,30,02:31:8a:29:26:f4,214061086,268,1499,214060818,214061086
1929,5,12,149,5745,-66,-96,30,02:31:8a:29:26:f4,214062011,180,745,214061831,214062011
1930,5,12,149,5745,-77,-96,19,22:ec:75:a8:8a:31,214062224,516,-303,214061708,214062224
1931,5,12,149,5745,-50,-96,46,5e:29:73:5b:30:00,214063323,540,559,214062783,214063323
1932,5,12,149,5745,-72,-96,24,c2:21:7d:48:b5:63,214063943,240,380,214063703,214063943
1933,5,12,149,5745,-77,-96,19,56:68:e2:c2:8d:d5,214064254,268,43,214063986,214064254
1934,5,12,149,5745,-75,-96,21,a6:92:ad:b7:76:65,214066057,456,1347,214065601,214066057
1935,5,12,149,5745,-67,-96,29,0a:b9:b7:b1:4d:fa,214071623,268,5298,214071355,214071623
1936,5,12,149,5745,-66,-96,30,3e:d1:9b:c7:a4:de,214072079,272,184,214071807,214072079
1937,5,12,149,5745,-50,-96,46,5e:29:73:5b:30:00,214072385,272,34,214072113,214072385
1938,5,12,149,5745,-75,-96,21,a6:92:ad:b7:76:65,214073458,256,817,214073202,214073458
1939,5,12,149,5745,-72,-96,24,c2:21:7d:48:b5:63,214073795,240,97,214073555,214073795
1940,5,12,149,5745,-54,-96,42,f2:da:61:dd:98:c5,214075714,268,1651,214075446,214075714
1941,5,12,149,5745,-66,-96,30,3e:d1:9b:c7:a4:de,214076026,544,-232,214075482,214076026
1942,5,12,149,5745,-79,-96,17,d2:00:04:7e:2c:ab,214077463,380,1057,214077083,214077463
1943,5,12,149,5745,-71,-96,25,5e:36:fe:bc:a2:fe,214077895,440,-8,214077455,214077895
1944,5,12,149,5745,-71,-96,25,5e:36:fe:bc:a2:fe,214078441,284,262,214078157,214078441
1945,5,12,149,5745,-77,-96,19,f6:0a:5c:59:72:df,214078876,448,-13,214078428,214078876
1946,5,12,149,5745,-79,-96,17,d2:00:04:7e:2c:ab,214079495,440,179,214079055,214079495
1947,5,12,149,5745,-78,-96,18,72:d1:72:1d:22:a1,214084272,452,4325,214083820,214084272
1948,5,12,149,5745,-76,-96,20,56:68:e2:c2:8d:d5,214088566,280,4014,214088286,214088566
1949,5,12,149,5745,-77,-96,19,f6:0a:5c:59:72:df,214089833,252,1015,214089581,214089833
1950,5,12,149,5745,-78,-96,18,72:d1:72:1d:22:a1,214091624,256,1535,214091368,214091624
1951,5,6,149,5745,-89,-96,7,54:e4:3a:ec:fb:65,214102056,360,10072,214101696,214102056
1952,5,12,149,5745,-75,-96,21,22:ec:75:a8:8a:31,214105909,244,3609,214105665,214105909
1953,5,12,149,5745,-78,-96,18,9a:24:38:da:96:bb,214131694,272,25513,214131422,214131694
1954,5,12,149,5745,-66,-96,30,3e:d1:9b:c7:a4:de,214140207,544,7969,214139663,214140207
1955,5,12,149,5745,-48,-96,48,72:fd:09:2f:da:5f,214140947,284,456,214140663,214140947
1956,5,12,149,5745,-79,-96,17,d2:00:04:7e:2c:ab,214145576,440,4189,214145136,214145576
1957,5,12,149,5745,-78,-96,18,d2:00:04:7e:2c:ab,214173600,244,27780,214173356,214173600
1958,5,12,149,5745,-52,-96,44,f2:da:61:dd:98:c5,214175265,268,1397,214174997,214175265
1959,5,12,149,5745,-50,-96,46,5e:29:73:5b:30:00,214182501,272,6964,214182229,214182501
1960,5,12,149,5745,-65,-96,31,3e:d1:9b:c7:a4:de,214186804,272,4031,214186532,214186804
1961,5,6,149,5745,-88,-96,8,54:e4:3a:ec:fb:65,214204457,360,17293,214204097,214204457
1962,5,12,149,5745,-65,-96,31,3e:d1:9b:c7:a4:de,214205736,544,735,214205192,214205736
1963,5,12,149,5745,-75,-96,21,22:ec:75:a8:8a:31,214213084,244,7104,214212840,214213084
1964,5,12,149,5745,-78,-96,18,72:d1:72:1d:22:a1,214219133,256,5793,214218877,214219133
1965,5,12,149,5745,-76,-96,20,a6:92:ad:b7:76:65,214227579,256,8190,214227323,214227579
1966,5,12,149,5745,-77,-96,19,fa:44:8d:e1:c7:1b,214228621,244,798,214228377,214228621
1967,5,12,149,5745,-73,-96,23,c2:21:7d:48:b5:63,214229134,240,273,214228894,214229134
1968,5,12,149,5745,-75,-96,21,56:68:e2:c2:8d:d5,214231216,280,1802,214230936,214231216
1969,5,12,149,5745,-77,-96,19,9a:24:38:da:96:bb,214247729,272,16241,214247457,214247729
1970,5,12,149,5745,-64,-96,32,02:31:8a:29:26:f4,214257872,268,9875,214257604,214257872
1971,5,12,149,5745,-69,-96,27,3e:d1:9b:c7:a4:de,214271744,544,13328,214271200,214271744
1972,5,12,149,5745,-50,-96,46,5e:29:73:5b:30:00,214296115,272,24099,214295843,214296115
1973,5,12,149,5745,-64,-96,32,3e:d1:9b:c7:a4:de,214302280,272,5893,214302008,214302280
1974,5,12,149,5745,-51,-96,45,72:fd:09:2f:da:5f,214304027,284,1463,214303743,214304027
1975,5,6,149,5745,-84,-96,12,54:e4:3a:ec:fb:65,214306857,360,2470,214306497,214306857
1976,5,12,149,5745,-52,-96,44,f2:da:61:dd:98:c5,214307479,268,354,214307211,214307479
1977,5,12,149,5745,-75,-96,21,a6:92:ad:b7:76:65,214330068,256,22333,214329812,214330068
1978,5,12,149,5745,-77,-96,19,22:ec:75:a8:8a:31,214330403,244,91,214330159,214330403
1979,5,12,149,5745,-78,-96,18,fa:44:8d:e1:c7:1b,214330728,244,81,214330484,214330728
1980,5,12,149,5745,-80,-96,16,d2:00:04:7e:2c:ab,214331222,244,250,214330978,214331222
1981,5,12,149,5745,-74,-96,22,c2:21:7d:48:b5:63,214331608,240,146,214331368,214331608
1982,5,12,149,5745,-78,-96,18,72:d1:72:1d:22:a1,214332079,256,215,214331823,214332079
1983,5,12,149,5745,-75,-96,21,56:68:e2:c2:8d:d5,214332370,280,11,214332090,214332370
1984,5,12,149,5745,-75,-96,21,f6:0a:5c:59:72:df,214333352,252,730,214333100,214333352
1985,5,12,149,5745,-76,-96,20,9a:24:38:da:96:bb,214355170,272,21546,214354898,214355170
1986,5,12,149,5745,-63,-96,33,3e:d1:9b:c7:a4:de,214393545,272,38103,214393273,214393545
1987,5,12,149,5745,-54,-96,42,72:fd:09:2f:da:5f,214406491,284,12662,214406207,214406491
1988,5,6,149,5745,-86,-96,10,54:e4:3a:ec:fb:65,214409258,360,2407,214408898,214409258
1989,5,12,149,5745,-52,-96,44,f2:da:61:dd:98:c5,214410359,268,833,214410091,214410359
1990,5,12,149,5745,-51,-96,45,5e:29:73:5b:30:00,214412980,272,2349,214412708,214412980
1991,5,12,149,5745,-76,-96,20,a6:92:ad:b7:76:65,214432433,256,19197,214432177,214432433
1992,5,12,149,5745,-80,-96,16,fa:44:8d:e1:c7:1b,214433915,244,1238,214433671,214433915
1993,5,12,149,5745,-75,-96,21,f6:0a:5c:59:72:df,214434256,252,89,214434004,214434256
1994,5,12,149,5745,-72,-96,24,c2:21:7d:48:b5:63,214435922,240,1426,214435682,214435922
1995,5,12,149,5745,-76,-96,20,56:68:e2:c2:8d:d5,214436736,280,534,214436456,214436736
1996,5,12,149,5745,-81,-96,15,d2:00:04:7e:2c:ab,214437151,244,171,214436907,214437151
1997,5,12,149,5745,-79,-96,17,72:d1:72:1d:22:a1,214437620,256,213,214437364,214437620
1998,5,12,149,5745,-76,-96,20,22:ec:75:a8:8a:31,214449106,244,11242,214448862,214449106
1999,5,12,149,5745,-78,-96,18,fa:44:8d:e1:c7:1b,214450798,440,1252,214450358,214450798
2000,5,12,149,5745,-76,-96,20,9a:24:38:da:96:bb,214453015,824,1393,214452191,214453015
2001,5,12,149,5745,-50,-96,46,72:fd:09:2f:da:5f,214455842,480,2347,214455362,214455842
2002,5,12,149,5745,-73,-96,23,c2:21:7d:48:b5:63,214457274,240,1192,214457034,214457274
2003,5,12,149,5745,-50,-96,46,5e:29:73:5b:30:00,214458404,540,590,214457864,214458404
2004,5,12,149,5745,-77,-96,19,a6:92:ad:b7:76:65,214460795,456,1935,214460339,214460795
2005,5,12,149,5745,-77,-96,19,f6:0a:5c:59:72:df,214461402,268,339,214461134,214461402
2006,5,12,149,5745,-75,-96,21,56:68:e2:c2:8d:d5,214461741,268,71,214461473,214461741
2007,5,12,149,5745,-50,-96,46,72:fd:09:2f:da:5f,214466025,284,4000,214465741,214466025
2008,5,12,149,5745,-76,-96,20,9a:24:38:da:96:bb,214466356,272,59,214466084,214466356
2009,5,12,149,5745,-54,-96,42,f2:da:61:dd:98:c5,214467814,268,1190,214467546,214467814
2010,5,12,149,5745,-63,-96,33,3e:d1:9b:c7:a4:de,214471322,544,2964,214470778,214471322
2011,5,12,149,5745,-75,-96,21,56:68:e2:c2:8d:d5,214471918,476,120,214471442,214471918
2012,5,12,149,5745,-68,-96,28,5e:36:fe:bc:a2:fe,214472428,440,70,214471988,214472428
2013,5,12,149,5745,-78,-96,18,f6:0a:5c:59:72:df,214473874,448,998,214473426,214473874
2014,5,12,149,5745,-82,-96,14,d2:00:04:7e:2c:ab,214474981,440,667,214474541,214474981
2015,5,12,149,5745,-79,-96,17,72:d1:72:1d:22:a1,214478147,452,2714,214477695,214478147
2016,5,12,149,5745,-76,-96,20,fa:44:8d:e1:c7:1b,214499021,244,20630,214498777,214499021
2017,5,12,149,5745,-57,-96,39,f2:da:61:dd:98:c5,214499299,268,10,214499031,214499299
2018,5,12,149,5745,-82,-96,14,d2:00:04:7e:2c:ab,214501717,244,2174,214501473,214501717
2019,5,6,149,5745,-89,-96,7,54:e4:3a:ec:fb:65,214511658,360,9581,214511298,214511658
2020,5,12,149,5745,-63,-96,33,3e:d1:9b:c7:a4:de,214514458,272,2528,214514186,214514458
2021,5,12,149,5745,-75,-96,21,fa:44:8d:e1:c7:1b,214515934,440,1036,214515494,214515934
2022,5,12,149,5745,-50,-96,46,72:fd:09:2f:da:5f,214517263,480,849,214516783,214517263
2023,5,12,149,5745,-52,-96,44,5e:29:73:5b:30:00,214528759,272,11224,214528487,214528759
2024,5,12,149,5745,-75,-96,21,a6:92:ad:b7:76:65,214529668,456,453,214529212,214529668
2025,5,12,149,5745,-75,-96,21,a6:92:ad:b7:76:65,214532210,256,2286,214531954,214532210
2026,5,24,149,5745,-79,-96,17,,214533473,28,1235,214533445,214533473
2027,5,12,149,5745,-64,-96,32,3e:d1:9b:c7:a4:de,214533723,544,-294,214533179,214533723
2028,5,12,149,5745,-70,-96,26,c2:21:7d:48:b5:63,214536148,240,2185,214535908,214536148
2029,5,12,149,5745,-75,-96,21,56:68:e2:c2:8d:d5,214537052,280,624,214536772,214537052
2030,5,12,149,5745,-68,-96,28,5e:36:fe:bc:a2:fe,214537392,440,-100,214536952,214537392
2031,5,12,149,5745,-68,-96,28,5e:36:fe:bc:a2:fe,214547623,244,9987,214547379,214547623
2032,5,12,149,5745,-82,-96,14,d2:00:04:7e:2c:ab,214555299,440,7236,214554859,214555299
2033,5,12,149,5745,-77,-96,19,9a:24:38:da:96:bb,214578900,272,23329,214578628,214578900
2034,5,12,149,5745,-73,-96,23,22:ec:75:a8:8a:31,214580186,244,1042,214579942,214580186
2035,5,12,149,5745,-51,-96,45,72:fd:09:2f:da:5f,214580644,284,174,214580360,214580644
2036,5,12,149,5745,-75,-96,21,fa:44:8d:e1:c7:1b,214581595,440,511,214581155,214581595
2037,5,12,149,5745,-52,-96,44,72:fd:09:2f:da:5f,214582771,480,696,214582291,214582771
2038,5,12,149,5745,-73,-96,23,22:ec:75:a8:8a:31,214584917,516,1630,214584401,214584917
2039,5,12,149,5745,-65,-96,31,02:31:8a:29:26:f4,214585600,268,415,214585332,214585600
2040,5,12,149,5745,-70,-96,26,c2:21:7d:48:b5:63,214589048,240,3208,214588808,214589048
2041,5,12,149,5745,-54,-96,42,5e:29:73:5b:30:00,214589597,540,9,214589057,214589597
2042,5,12,149,5745,-74,-96,22,a6:92:ad:b7:76:65,214594951,456,4898,214594495,214594951
2043,5,12,149,5745,-71,-96,25,0a:b9:b7:b1:4d:fa,214595995,268,776,214595727,214595995
2044,5,12,149,5745,-62,-96,34,3e:d1:9b:c7:a4:de,214599448,544,2909,214598904,214599448
2045,5,12,149,5745,-55,-96,41,f2:da:61:dd:98:c5,214601170,268,1454,214600902,214601170
2046,5,12,149,5745,-71,-96,25,5e:36:fe:bc:a2:fe,214602273,440,663,214601833,214602273
2047,5,12,149,5745,-82,-96,14,d2:00:04:7e:2c:ab,214604447,440,1734,214604007,214604447
2048,5,12,149,5745,-56,-96,40,f2:da:61:dd:98:c5,214613337,268,8622,214613069,214613337
2049,5,12,149,5745,-74,-96,22,fa:44:8d:e1:c7:1b,214613666,244,85,214613422,214613666
2050,5,6,149,5745,-89,-96,7,54:e4:3a:ec:fb:65,214614059,360,33,214613699,214614059
2051,5,12,149,5745,-82,-96,14,d2:00:04:7e:2c:ab,214615319,244,1016,214615075,214615319
2052,5,12,149,5745,-60,-96,36,3e:d1:9b:c7:a4:de,214629475,272,13884,214629203,214629475
2053,5,12,149,5745,-70,-96,26,c2:21:7d:48:b5:63,214631402,240,1687,214631162,214631402
2054,5,12,149,5745,-82,-96,14,72:d1:72:1d:22:a1,214638737,256,7079,214638481,214638737
2055,5,12,149,5745,-55,-96,41,5e:29:73:5b:30:00,214642416,272,3407,214642144,214642416
2056,5,12,149,5745,-75,-96,21,56:68:e2:c2:8d:d5,214656875,280,14179,214656595,214656875
2057,5,12,149,5745,-75,-96,21,a6:92:ad:b7:76:65,214657262,256,131,214657006,214657262
2058,5,12,149,5745,-62,-96,34,3e:d1:9b:c7:a4:de,214665020,544,7214,214664476,214665020
2059,5,12,149,5745,-80,-96,16,d2:00:04:7e:2c:ab,214669967,440,4507,214669527,214669967
2060,5,12,149,5745,-69,-96,27,5e:36:fe:bc:a2:fe,214670938,244,727,214670694,214670938
2061,5,12,149,5745,-74,-96,22,22:ec:75:a8:8a:31,214676216,244,5034,214675972,214676216
2062,5,12,149,5745,-76,-96,20,9a:24:38:da:96:bb,214691985,272,15497,214691713,214691985
2063,5,12,149,5745,-55,-96,41,72:fd:09:2f:da:5f,214703596,284,11327,214703312,214703596
2064,5,6,149,5745,-87,-96,9,54:e4:3a:ec:fb:65,214716459,360,12503,214716099,214716459
2065,5,12,149,5745,-61,-96,35,3e:d1:9b:c7:a4:de,214729312,272,12581,214729040,214729312
2066,5,12,149,5745,-81,-96,15,d2:00:04:7e:2c:ab,214737568,244,8012,214737324,214737568
2067,5,12,149,5745,-77,-96,19,fa:44:8d:e1:c7:1b,214740406,244,2594,214740162,214740406
2068,5,12,149,5745,-79,-96,17,72:d1:72:1d:22:a1,214741471,256,809,214741215,214741471
2069,5,12,149,5745,-74,-96,22,c2:21:7d:48:b5:63,214756531,240,14820,214756291,214756531
2070,5,12,149,5745,-48,-96,48,5e:29:73:5b:30:00,214759164,272,2361,214758892,214759164
2071,5,12,149,5745,-68,-96,28,02:31:8a:29:26:f4,214782102,268,22670,214781834,214782102
2072,5,6,149,5745,-91,-96,5,54:e4:3a:ec:fb:65,214782568,352,114,214782216,214782568
2073,5,6,149,5745,-90,-96,6,54:e4:3a:ec:fb:65,214784096,352,1176,214783744,214784096
2074,5,12,149,5745,-76,-96,20,f6:0a:5c:59:72:df,214792271,252,7923,214792019,214792271
2075,5,12,149,5745,-77,-96,19,22:ec:75:a8:8a:31,214793977,244,1462,214793733,214793977
2076,5,12,149,5745,-57,-96,39,72:fd:09:2f:da:5f,214816424,284,22163,214816140,214816424
2077,5,12,149,5745,-70,-96,26,5e:36:fe:bc:a2:fe,214818194,244,1526,214817950,214818194
2078,5,6,149,5745,-89,-96,7,54:e4:3a:ec:fb:65,214818860,360,306,214818500,214818860
2079,5,12,149,5745,-60,-96,36,f2:da:61:dd:98:c5,214819761,268,633,214819493,214819761
2080,5,12,149,5745,-62,-96,34,3e:d1:9b:c7:a4:de,214841519,272,21486,214841247,214841519
2081,5,12,149,5745,-77,-96,19,a6:92:ad:b7:76:65,214842017,256,242,214841761,214842017
2082,5,12,149,5745,-80,-96,16,fa:44:8d:e1:c7:1b,214843085,244,824,214842841,214843085
2083,5,12,149,5745,-80,-96,16,72:d1:72:1d:22:a1,214843563,256,222,214843307,214843563
2084,5,12,149,5745,-74,-96,22,56:68:e2:c2:8d:d5,214845605,280,1762,214845325,214845605
2085,5,12,149,5745,-80,-96,16,d2:00:04:7e:2c:ab,214850163,244,4314,214849919,214850163
2086,5,24,149,5745,-77,-96,19,,214860234,28,10043,214860206,214860234
2087,5,24,149,5745,-77,-96,19,,214870817,28,10555,214870789,214870817
2088,5,24,149,5745,-77,-96,19,,214871568,28,723,214871540,214871568
2089,5,6,149,5745,-77,-96,19,,214871965,52,345,214871913,214871965
2090,5,6,149,5745,-91,-96,5,,214872033,44,24,214871989,214872033
2091,5,6,149,5745,-77,-96,19,,214872302,52,217,214872250,214872302
2092,5,6,149,5745,-91,-96,5,,214872370,44,24,214872326,214872370
2093,5,12,149,5745,-54,-96,42,5e:29:73:5b:30:00,214874410,272,1768,214874138,214874410
2094,5,12,149,5745,-75,-96,21,22:ec:75:a8:8a:31,214907249,244,32595,214907005,214907249
2095,5,12,149,5745,-76,-96,20,9a:24:38:da:96:bb,214918766,272,11245,214918494,214918766
2096,5,12,149,5745,-69,-96,27,5e:36:fe:bc:a2:fe,214920500,244,1490,214920256,214920500
2097,5,6,149,5745,-86,-96,10,54:e4:3a:ec:fb:65,214921261,360,401,214920901,214921261
2098,5,12,149,5745,-54,-96,42,f2:da:61:dd:98:c5,214921970,268,441,214921702,214921970
2099,5,12,149,5745,-51,-96,45,72:fd:09:2f:da:5f,214928040,284,5786,214927756,214928040
2100,5,12,149,5745,-74,-96,22,a6:92:ad:b7:76:65,214944461,256,16165,214944205,214944461
2101,5,12,149,5745,-74,-96,22,c2:21:7d:48:b5:63,214945736,240,1035,214945496,214945736
2102,5,12,149,5745,-83,-96,13,72:d1:72:1d:22:a1,214946199,256,207,214945943,214946199
2103,5,12,149,5745,-76,-96,20,56:68:e2:c2:8d:d5,214948408,280,1929,214948128,214948408
2104,5,12,149,5745,-63,-96,33,3e:d1:9b:c7:a4:de,214953744,272,5064,214953472,214953744
2105,5,12,149,5745,-79,-96,17,d2:00:04:7e:2c:ab,214957467,244,3479,214957223,214957467
2106,5,12,149,5745,-80,-96,16,fa:44:8d:e1:c7:1b,214961506,244,3795,214961262,214961506
2107,5,12,149,5745,-74,-96,22,c2:21:7d:48:b5:63,214982296,240,20550,214982056,214982296
2108,5,12,149,5745,-48,-96,48,5e:29:73:5b:30:00,214986476,272,3908,214986204,214986476
2109,5,12,149,5745,-76,-96,20,56:68:e2:c2:8d:d5,214993318,280,6562,214993038,214993318
2110,5,12,149,5745,-73,-96,23,a6:92:ad:b7:76:65,214998338,256,4764,214998082,214998338
2111,5,12,149,5745,-81,-96,15,72:d1:72:1d:22:a1,215009359,256,10765,215009103,215009359
2112,5,12,149,5745,-69,-96,27,5e:36:fe:bc:a2:fe,215023467,244,13864,215023223,215023467
2113,5,6,149,5745,-87,-96,9,54:e4:3a:ec:fb:65,215023743,360,-84,215023383,215023743
2114,5,12,149,5745,-55,-96,41,f2:da:61:dd:98:c5,215024995,268,984,215024727,215024995
2115,5,12,149,5745,-76,-96,20,9a:24:38:da:96:bb,215026350,272,1083,215026078,215026350
2116,5,12,149,5745,-77,-96,19,22:ec:75:a8:8a:31,215038914,244,12320,215038670,215038914
2117,5,12,149,5745,-53,-96,43,72:fd:09:2f:da:5f,215039588,284,390,215039304,215039588
2118,5,12,149,5745,-77,-96,19,22:ec:75:a8:8a:31,215043235,516,3131,215042719,215043235
2119,5,12,149,5745,-53,-96,43,72:fd:09:2f:da:5f,215044235,480,520,215043755,215044235
2120,5,12,149,5745,-48,-96,48,5e:29:73:5b:30:00,215046612,540,1837,215046072,215046612
2121,5,12,149,5745,-75,-96,21,a6:92:ad:b7:76:65,215053909,456,6841,215053453,215053909
2122,5,12,149,5745,-68,-96,28,5e:36:fe:bc:a2:fe,215059034,440,4685,215058594,215059034
2123,5,12,149,5745,-54,-96,42,f2:da:61:dd:98:c5,215059518,268,216,215059250,215059518
2124,5,12,149,5745,-75,-96,21,c2:21:7d:48:b5:63,215060729,240,971,215060489,215060729
2125,5,12,149,5745,-76,-96,20,56:68:e2:c2:8d:d5,215061003,476,-202,215060527,215061003
2126,5,12,149,5745,-61,-96,35,3e:d1:9b:c7:a4:de,215061550,544,3,215061006,215061550
2127,5,12,149,5745,-79,-96,17,d2:00:04:7e:2c:ab,215062182,440,192,215061742,215062182
2128,5,12,149,5745,-75,-96,21,f6:0a:5c:59:72:df,215063851,252,1417,215063599,215063851
2129,5,12,149,5745,-79,-96,17,fa:44:8d:e1:c7:1b,215064758,440,467,215064318,215064758
2130,5,12,149,5745,-81,-96,15,72:d1:72:1d:22:a1,215066485,452,1275,215066033,215066485
2131,5,12,149,5745,-54,-96,42,f2:da:61:dd:98:c5,215072074,268,5321,215071806,215072074
2132,5,12,149,5745,-79,-96,17,fa:44:8d:e1:c7:1b,215072430,244,112,215072186,215072430
2133,5,12,149,5745,-79,-96,17,d2:00:04:7e:2c:ab,215073869,244,1195,215073625,215073869
2134,5,12,149,5745,-60,-96,36,3e:d1:9b:c7:a4:de,215088223,272,14082,215087951,215088223
2135,5,12,149,5745,-76,-96,20,c2:21:7d:48:b5:63,215093679,240,5216,215093439,215093679
2136,5,12,149,5745,-77,-96,19,56:68:e2:c2:8d:d5,215104403,280,10444,215104123,215104403
2137,5,12,149,5745,-70,-96,26,5e:36:fe:bc:a2:fe,215104735,244,88,215104491,215104735
2138,5,12,149,5745,-74,-96,22,a6:92:ad:b7:76:65,215106138,256,1147,215105882,215106138
2139,5,12,149,5745,-78,-96,18,56:68:e2:c2:8d:d5,215106581,476,-33,215106105,215106581
2140,5,12,149,5745,-54,-96,42,f2:da:61:dd:98:c5,215107352,268,503,215107084,215107352
2141,5,12,149,5745,-75,-96,21,22:ec:75:a8:8a:31,215107690,516,-178,215107174,215107690
2142,5,12,149,5745,-79,-96,17,72:d1:72:1d:22:a1,215108522,256,576,215108266,215108522
2143,5,12,149,5745,-78,-96,18,72:d1:72:1d:22:a1,215112655,452,3681,215112203,215112655
2144,5,12,149,5745,-57,-96,39,72:fd:09:2f:da:5f,215113112,480,-23,215112632,215113112
2145,5,12,149,5745,-50,-96,46,5e:29:73:5b:30:00,215113653,540,1,215113113,215113653
2146,5,12,149,5745,-75,-96,21,9a:24:38:da:96:bb,215118118,824,3641,215117294,215118118
2147,5,12,149,5745,-74,-96,22,a6:92:ad:b7:76:65,215120143,456,1569,215119687,215120143
2148,5,12,149,5745,-49,-96,47,5e:29:73:5b:30:00,215120786,272,371,215120514,215120786
2149,5,12,149,5745,-69,-96,27,02:31:8a:29:26:f4,215123100,268,2046,215122832,215123100
2150,5,12,149,5745,-70,-96,26,5e:36:fe:bc:a2:fe,215124430,440,890,215123990,215124430
2151,5,12,149,5745,-60,-96,36,3e:d1:9b:c7:a4:de,215125804,544,830,215125260,215125804
2152,5,6,149,5745,-86,-96,10,54:e4:3a:ec:fb:65,215126380,360,216,215126020,215126380
2153,5,12,149,5745,-76,-96,20,c2:21:7d:48:b5:63,215127608,240,988,215127368,215127608
2154,5,12,149,5745,-74,-96,22,f6:0a:5c:59:72:df,215127963,252,103,215127711,215127963
2155,5,12,149,5745,-78,-96,18,fa:44:8d:e1:c7:1b,215129861,440,1458,215129421,215129861
2156,5,12,149,5745,-72,-96,24,0a:b9:b7:b1:4d:fa,215133368,268,3239,215133100,215133368
2157,5,12,149,5745,-57,-96,39,72:fd:09:2f:da:5f,215137712,284,4060,215137428,215137712
2158,5,12,149,5745,-76,-96,20,9a:24:38:da:96:bb,215144669,272,6685,215144397,215144669
2159,5,12,149,5745,-73,-96,23,22:ec:75:a8:8a:31,215154415,244,9502,215154171,215154415
2160,5,12,149,5745,-62,-96,34,3e:d1:9b:c7:a4:de,215184133,272,29446,215183861,215184133
2161,5,12,149,5745,-78,-96,18,fa:44:8d:e1:c7:1b,215185631,244,1254,215185387,215185631
2162,5,12,149,5745,-81,-96,15,d2:00:04:7e:2c:ab,215188169,244,2294,215187925,215188169
2163,5,12,149,5745,-55,-96,41,f2:da:61:dd:98:c5,215191217,268,2780,215190949,215191217
2164,5,24,149,5745,-81,-96,15,66:48:51:4e:71:fa,215204123,328,12578,215203795,215204123
2165,5,24,149,5745,-81,-96,15,,215204727,32,572,215204695,215204727
2166,5,24,149,5745,-80,-96,16,,215205555,28,800,215205527,215205555
2167,5,24,149,5745,-80,-96,16,,215206037,28,454,215206009,215206037
2168,5,24,149,5745,-81,-96,15,,215206362,28,297,215206334,215206362
2169,5,24,149,5745,-80,-96,16,,215206848,28,458,215206820,215206848
2170,5,12,149,5745,-73,-96,23,c2:21:7d:48:b5:63,215207184,240,96,215206944,215207184
2171,5,24,149,5745,-80,-96,16,,215207683,28,471,215207655,215207683
2172,5,12,149,5745,-50,-96,46,5e:29:73:5b:30:00,215214269,272,6314,215213997,215214269
2173,5,12,149,5745,-77,-96,19,56:68:e2:c2:8d:d5,215218617,280,4068,215218337,215218617
2174,5,12,149,5745,-74,-96,22,a6:92:ad:b7:76:65,215222168,256,3295,215221912,215222168
2175,5,6,149,5745,-86,-96,10,54:e4:3a:ec:fb:65,215228462,360,5934,215228102,215228462
2176,5,12,149,5745,-66,-96,30,5e:36:fe:bc:a2:fe,215233885,244,5179,215233641,215233885
2177,5,12,149,5745,-84,-96,12,72:d1:72:1d:22:a1,215234316,256,175,215234060,215234316
2178,5,12,149,5745,-74,-96,22,f6:0a:5c:59:72:df,215236676,252,2108,215236424,215236676
2179,5,12,149,5745,-73,-96,23,22:ec:75:a8:8a:31,215249422,244,12502,215249178,215249422
2180,5,12,149,5745,-77,-96,19,9a:24:38:da:96:bb,215258019,272,8325,215257747,215258019
2181,5,24,149,5745,-81,-96,15,66:48:51:4e:71:fa,215271237,328,12890,215270909,215271237
2182,5,24,149,5745,-82,-96,14,,215271769,32,500,215271737,215271769
2183,5,24,149,5745,-82,-96,14,,215272588,28,791,215272560,215272588
2184,5,12,149,5745,-61,-96,35,3e:d1:9b:c7:a4:de,215301104,272,28244,215300832,215301104
2185,5,12,149,5745,-69,-96,27,02:31:8a:29:26:f4,215319447,268,18075,215319179,215319447
2186,5,12,149,5745,-54,-96,42,72:fd:09:2f:da:5f,215327065,284,7334,215326781,215327065
2187,5,6,149,5745,-87,-96,9,54:e4:3a:ec:fb:65,215330862,360,3437,215330502,215330862
2188,5,12,149,5745,-55,-96,41,f2:da:61:dd:98:c5,215331286,268,156,215331018,215331286
2189,5,12,149,5745,-53,-96,43,5e:29:73:5b:30:00,215331821,272,263,215331549,215331821
2190,5,24,149,5745,-81,-96,15,66:48:51:4e:71:fa,215333728,328,1579,215333400,215333728
2191,5,24,149,5745,-81,-96,15,,215334269,28,513,215334241,215334269
2192,5,24,149,5745,-81,-96,15,,215334377,32,76,215334345,215334377
2193,5,12,149,5745,-68,-96,28,5e:36:fe:bc:a2:fe,215343874,244,9253,215343630,215343874
2194,5,12,149,5745,-83,-96,13,72:d1:72:1d:22:a1,215346978,256,2848,215346722,215346978
2195,5,12,149,5745,-74,-96,22,a6:92:ad:b7:76:65,215354168,256,6934,215353912,215354168
2196,5,12,149,5745,-77,-96,19,fa:44:8d:e1:c7:1b,215355494,244,1082,215355250,215355494
2197,5,12,149,5745,-77,-96,19,d2:00:04:7e:2c:ab,215355834,244,96,215355590,215355834
2198,5,12,149,5745,-70,-96,26,c2:21:7d:48:b5:63,215356161,240,87,215355921,215356161
2199,5,12,149,5745,-78,-96,18,56:68:e2:c2:8d:d5,215356595,280,154,215356315,215356595
2200,5,12,149,5745,-72,-96,24,22:ec:75:a8:8a:31,215366497,244,9658,215366253,215366497
2201,5,12,149,5745,-74,-96,22,9a:24:38:da:96:bb,215373444,272,6675,215373172,215373444
2202,5,12,149,5745,-61,-96,35,3e:d1:9b:c7:a4:de,215415246,272,41530,215414974,215415246
2203,5,12,149,5745,-54,-96,42,72:fd:09:2f:da:5f,215430372,284,14842,215430088,215430372
2204,5,6,149,5745,-84,-96,12,54:e4:3a:ec:fb:65,215433263,360,2531,215432903,215433263
2205,5,12,149,5745,-57,-96,39,f2:da:61:dd:98:c5,215434033,268,502,215433765,215434033
2206,5,12,149,5745,-53,-96,43,5e:29:73:5b:30:00,215448844,272,14539,215448572,215448844
2207,5,12,149,5745,-72,-96,24,a6:92:ad:b7:76:65,215456474,256,7374,215456218,215456474
2208,5,12,149,5745,-67,-96,29,c2:21:7d:48:b5:63,215457907,240,1193,215457667,215457907
2209,5,12,149,5745,-80,-96,16,fa:44:8d:e1:c7:1b,215458299,244,148,215458055,215458299
2210,5,12,149,5745,-79,-96,17,56:68:e2:c2:8d:d5,215458791,280,212,215458511,215458791
2211,5,12,149,5745,-77,-96,19,d2:00:04:7e:2c:ab,215459492,244,457,215459248,215459492
2212,5,12,149,5745,-77,-96,19,72:d1:72:1d:22:a1,215460347,256,599,215460091,215460347
2213,5,12,149,5745,-71,-96,25,5e:36:fe:bc:a2:fe,215464242,244,3651,215463998,215464242
2214,5,24,149,5745,-82,-96,14,,215470017,28,5747,215469989,215470017
2215,5,12,149,5745,-80,-96,16,9a:24:38:da:96:bb,215480436,272,10147,215480164,215480436
2216,5,12,149,5745,-56,-96,40,72:fd:09:2f:da:5f,215487271,284,6551,215486987,215487271
2217,5,12,149,5745,-72,-96,24,22:ec:75:a8:8a:31,215497687,244,10172,215497443,215497687
2218,5,12,149,5745,-71,-96,25,22:ec:75:a8:8a:31,215501497,516,3294,215500981,215501497
2219,5,12,149,5745,-57,-96,39,f2:da:61:dd:98:c5,215502344,268,579,215502076,215502344
2220,5,12,149,5745,-77,-96,19,72:d1:72:1d:22:a1,215505805,452,3009,215505353,215505805
2221,5,12,149,5745,-56,-96,40,5e:29:73:5b:30:00,215507668,540,1323,215507128,215507668
2222,5,12,149,5745,-80,-96,16,56:68:e2:c2:8d:d5,215508251,476,107,215507775,215508251
2223,5,12,149,5745,-73,-96,23,f6:0a:5c:59:72:df,215510816,132,2433,215510684,215510816
2224,5,12,149,5745,-57,-96,39,72:fd:09:2f:da:5f,215511378,480,82,215510898,215511378
2225,5,12,149,5745,-57,-96,39,f2:da:61:dd:98:c5,215514380,268,2734,215514112,215514380
2226,5,12,149,5745,-79,-96,17,fa:44:8d:e1:c7:1b,215514700,244,76,215514456,215514700
2227,5,12,149,5745,-78,-96,18,d2:00:04:7e:2c:ab,215516139,244,1195,215515895,215516139
2228,5,12,149,5745,-67,-96,29,c2:21:7d:48:b5:63,215516419,240,40,215516179,215516419
2229,5,12,149,5745,-74,-96,22,5e:36:fe:bc:a2:fe,215517728,440,869,215517288,215517728
2230,5,12,149,5745,-73,-96,23,f6:0a:5c:59:72:df,215521631,252,3651,215521379,215521631
2231,5,12,149,5745,-62,-96,34,3e:d1:9b:c7:a4:de,215521963,544,-212,215521419,215521963
2232,5,12,149,5745,-77,-96,19,fa:44:8d:e1:c7:1b,215522596,440,193,215522156,215522596
2233,5,12,149,5745,-67,-96,29,c2:21:7d:48:b5:63,215532153,240,9317,215531913,215532153
2234,5,6,149,5745,-87,-96,9,54:e4:3a:ec:fb:65,215535664,360,3151,215535304,215535664
2235,5,12,149,5745,-79,-96,17,56:68:e2:c2:8d:d5,215547150,280,11206,215546870,215547150
2236,5,12,149,5745,-62,-96,34,3e:d1:9b:c7:a4:de,215547447,272,25,215547175,215547447
2237,5,24,149,5745,-83,-96,13,,215551350,32,3871,215551318,215551350
2238,5,12,149,5745,-51,-96,45,5e:29:73:5b:30:00,215563245,272,11623,215562973,215563245
2239,5,12,149,5745,-71,-96,25,5e:36:fe:bc:a2:fe,215563570,244,81,215563326,215563570
2240,5,12,149,5745,-71,-96,25,5e:36:fe:bc:a2:fe,215565955,440,1945,215565515,215565955
2241,5,12,149,5745,-78,-96,18,d2:00:04:7e:2c:ab,215566996,440,601,215566556,215566996
2242,5,12,149,5745,-58,-96,38,72:fd:09:2f:da:5f,215571880,480,4404,215571400,215571880
2243,5,12,149,5745,-73,-96,23,f6:0a:5c:59:72:df,215575041,252,2909,215574789,215575041
2244,5,12,149,5745,-77,-96,19,72:d1:72:1d:22:a1,215577526,256,2229,215577270,215577526
2245,5,12,149,5745,-77,-96,19,fa:44:8d:e1:c7:1b,215588041,440,10075,215587601,215588041
2246,5,12,149,5745,-57,-96,39,72:fd:09:2f:da:5f,215596483,284,8158,215596199,215596483
2247,5,12,149,5745,-72,-96,24,22:ec:75:a8:8a:31,215597950,244,1223,215597706,215597950
2248,5,12,149,5745,-75,-96,21,9a:24:38:da:96:bb,215616633,272,18411,215616361,215616633
2249,5,12,149,5745,-56,-96,40,f2:da:61:dd:98:c5,215629071,268,12170,215628803,215629071
2250,5,12,149,5745,-76,-96,20,fa:44:8d:e1:c7:1b,215629418,244,103,215629174,215629418
2251,5,12,149,5745,-71,-96,25,5e:36:fe:bc:a2:fe,215630947,440,1089,215630507,215630947
2252,5,12,149,5745,-80,-96,16,d2:00:04:7e:2c:ab,215631476,244,285,215631232,215631476
2253,5,12,149,5745,-55,-96,41,f2:da:61:dd:98:c5,215633583,268,1839,215633315,215633583
2254,5,12,149,5745,-73,-96,23,a6:92:ad:b7:76:65,215634839,456,800,215634383,215634839
2255,5,12,149,5745,-74,-96,22,22:ec:75:a8:8a:31,215635329,516,-26,215634813,215635329
2256,5,12,149,5745,-56,-96,40,72:fd:09:2f:da:5f,215637418,480,1609,215636938,215637418
2257,5,6,149,5745,-88,-96,8,54:e4:3a:ec:fb:65,215638065,360,287,215637705,215638065
2258,5,12,149,5745,-55,-96,41,5e:29:73:5b:30:00,215639919,540,1314,215639379,215639919
2259,5,12,149,5745,-77,-96,19,9a:24:38:da:96:bb,215644127,824,3384,215643303,215644127
2260,5,12,149,5745,-70,-96,26,c2:21:7d:48:b5:63,215646525,240,2158,215646285,215646525
2261,5,12,149,5745,-68,-96,28,02:31:8a:29:26:f4,215648141,268,1348,215647873,215648141
2262,5,12,149,5745,-70,-96,26,c2:21:7d:48:b5:63,215649147,240,766,215648907,215649147
2263,5,12,149,5745,-61,-96,35,3e:d1:9b:c7:a4:de,215652702,544,3011,215652158,215652702
2264,5,12,149,5745,-77,-96,19,fa:44:8d:e1:c7:1b,215653570,440,428,215653130,215653570
2265,5,12,149,5745,-81,-96,15,d2:00:04:7e:2c:ab,215654882,412,900,215654470,215654882
2266,5,12,149,5745,-65,-96,31,0a:b9:b7:b1:4d:fa,215655355,268,205,215655087,215655355
2267,5,12,149,5745,-60,-96,36,3e:d1:9b:c7:a4:de,215661372,272,5745,215661100,215661372
2268,5,12,149,5745,-75,-96,21,56:68:e2:c2:8d:d5,215669442,280,7790,215669162,215669442
2269,5,12,149,5745,-69,-96,27,5e:36:fe:bc:a2:fe,215678540,244,8854,215678296,215678540
2270,5,12,149,5745,-52,-96,44,5e:29:73:5b:30:00,215678854,272,42,215678582,215678854
2271,5,12,149,5745,-80,-96,16,9a:24:38:da:96:bb,215706487,272,27361,215706215,215706487
2272,5,12,149,5745,-54,-96,42,72:fd:09:2f:da:5f,215713873,284,7102,215713589,215713873
2273,5,12,149,5745,-52,-96,44,5e:29:73:5b:30:00,215715157,540,744,215714617,215715157
2274,5,6,149,5745,-87,-96,9,54:e4:3a:ec:fb:65,215740465,360,24948,215740105,215740465
2275,5,12,149,5745,-76,-96,20,fa:44:8d:e1:c7:1b,215751765,244,11056,215751521,215751765
2276,5,12,149,5745,-58,-96,38,f2:da:61:dd:98:c5,215753559,268,1526,215753291,215753559
2277,5,12,149,5745,-59,-96,37,3e:d1:9b:c7:a4:de,215754472,272,641,215754200,215754472
2278,5,12,149,5745,-51,-96,45,5e:29:73:5b:30:00,215762128,540,7116,215761588,215762128
2279,5,12,149,5745,-81,-96,15,72:d1:72:1d:22:a1,215765035,256,2651,215764779,215765035
2280,5,12,149,5745,-75,-96,21,56:68:e2:c2:8d:d5,215779503,280,14188,215779223,215779503
2281,5,12,149,5745,-50,-96,46,5e:29:73:5b:30:00,215809251,272,29476,215808979,215809251
2282,5,12,149,5745,-74,-96,22,9a:24:38:da:96:bb,215821953,272,12430,215821681,215821953
2283,5,12,149,5745,-52,-96,44,5e:29:73:5b:30:00,215827839,540,5346,215827299,215827839
2284,5,12,149,5745,-75,-96,21,22:ec:75:a8:8a:31,215828436,244,353,215828192,215828436
2285,5,12,149,5745,-58,-96,38,72:fd:09:2f:da:5f,215840222,284,11502,215839938,215840222
2286,5,12,149,5745,-65,-96,31,5e:36:fe:bc:a2:fe,215841799,244,1333,215841555,215841799
2287,5,6,149,5745,-86,-96,10,54:e4:3a:ec:fb:65,215842866,360,707,215842506,215842866
2288,5,12,149,5745,-71,-96,25,02:31:8a:29:26:f4,215843253,268,119,215842985,215843253
2289,5,12,149,5745,-74,-96,22,fa:44:8d:e1:c7:1b,215864140,244,20643,215863896,215864140
2290,5,12,149,5745,-78,-96,18,72:d1:72:1d:22:a1,215867505,256,3109,215867249,215867505
2291,5,12,149,5745,-69,-96,27,3e:d1:9b:c7:a4:de,215870210,272,2433,215869938,215870210
2292,5,6,149,5745,-76,-96,20,,215870556,52,294,215870504,215870556
2293,5,6,149,5745,-89,-96,7,,215870624,44,24,215870580,215870624
2294,5,6,149,5745,-76,-96,20,,215870866,52,190,215870814,215870866
2295,5,6,149,5745,-92,-96,4,,215870934,44,24,215870890,215870934
2296,5,12,149,5745,-53,-96,43,5e:29:73:5b:30:00,215904654,272,33448,215904382,215904654
2297,5,12,149,5745,-74,-96,22,f6:0a:5c:59:72:df,215915311,252,10405,215915059,215915311
2298,5,12,149,5745,-72,-96,24,9a:24:38:da:96:bb,215930759,272,15176,215930487,215930759
2299,5,12,149,5745,-52,-96,44,72:fd:09:2f:da:5f,215942525,284,11482,215942241,215942525
2300,5,12,149,5745,-70,-96,26,5e:36:fe:bc:a2:fe,215944225,244,1456,215943981,215944225
2301,5,12,149,5745,-53,-96,43,f2:da:61:dd:98:c5,215945689,268,1196,215945421,215945689
2302,5,12,149,5745,-80,-96,16,72:d1:72:1d:22:a1,215970196,256,24251,215969940,215970196
2303,5,12,149,5745,-74,-96,22,56:68:e2:c2:8d:d5,215971953,280,1477,215971673,215971953
2304,5,12,149,5745,-77,-96,19,fa:44:8d:e1:c7:1b,215976835,244,4638,215976591,215976835
2305,5,12,149,5745,-65,-96,31,3e:d1:9b:c7:a4:de,215987267,272,10160,215986995,215987267
2306,5,24,149,5745,-88,-96,8,,215993963,28,6668,215993935,215993963
2307,5,12,149,5745,-52,-96,44,5e:29:73:5b:30:00,216016475,272,22240,216016203,216016475
2308,5,12,149,5745,-72,-96,24,5e:36:fe:bc:a2:fe,216046569,244,29850,216046325,216046569
2309,5,6,149,5745,-85,-96,11,54:e4:3a:ec:fb:65,216047666,360,737,216047306,216047666
2310,5,12,149,5745,-56,-96,40,f2:da:61:dd:98:c5,216049998,268,2064,216049730,216049998
2311,5,12,149,5745,-76,-96,20,22:ec:75:a8:8a:31,216057423,244,7181,216057179,216057423
2312,5,12,149,5745,-52,-96,44,72:fd:09:2f:da:5f,216058764,284,1057,216058480,216058764
2313,5,12,149,5745,-75,-96,21,56:68:e2:c2:8d:d5,216075035,280,15991,216074755,216075035
2314,5,12,149,5745,-83,-96,13,72:d1:72:1d:22:a1,216076566,256,1275,216076310,216076566
2315,5,12,149,5745,-56,-96,40,f2:da:61:dd:98:c5,216087781,268,10947,216087513,216087781
2316,5,12,149,5745,-74,-96,22,fa:44:8d:e1:c7:1b,216088120,244,95,216087876,216088120
2317,5,12,149,5745,-52,-96,44,5e:29:73:5b:30:00,216089610,540,950,216089070,216089610
2318,5,12,149,5745,-72,-96,24,5e:36:fe:bc:a2:fe,216090671,440,621,216090231,216090671
2319,5,12,149,5745,-77,-96,19,22:ec:75:a8:8a:31,216091317,516,130,216090801,216091317
2320,5,12,149,5745,-57,-96,39,f2:da:61:dd:98:c5,216091903,268,318,216091635,216091903
2321,5,12,149,5745,-75,-96,21,56:68:e2:c2:8d:d5,216093078,476,699,216092602,216093078
2322,5,12,149,5745,-52,-96,44,72:fd:09:2f:da:5f,216096453,480,2895,216095973,216096453
2323,5,12,149,5745,-81,-96,15,72:d1:72:1d:22:a1,216096976,452,71,216096524,216096976
2324,5,12,149,5745,-76,-96,20,56:68:e2:c2:8d:d5,216103861,280,6605,216103581,216103861
2325,5,12,149,5745,-63,-96,33,3e:d1:9b:c7:a4:de,216109086,544,4681,216108542,216109086
2326,5,12,149,5745,-72,-96,24,f6:0a:5c:59:72:df,216112831,252,3493,216112579,216112831
2327,5,12,149,5745,-76,-96,20,fa:44:8d:e1:c7:1b,216114498,440,1227,216114058,216114498
2328,5,12,149,5745,-63,-96,33,3e:d1:9b:c7:a4:de,216120111,272,5341,216119839,216120111
2329,5,12,149,5745,-72,-96,24,f6:0a:5c:59:72:df,216122159,252,1796,216121907,216122159
2330,5,12,149,5745,-79,-96,17,72:d1:72:1d:22:a1,216125024,256,2609,216124768,216125024
2331,5,12,149,5745,-50,-96,46,5e:29:73:5b:30:00,216136964,272,11668,216136692,216136964
2332,5,12,149,5745,-71,-96,25,5e:36:fe:bc:a2:fe,216137272,244,64,216137028,216137272
2333,5,6,149,5745,-84,-96,12,54:e4:3a:ec:fb:65,216150067,360,12435,216149707,216150067
2334,5,12,149,5745,-53,-96,43,72:fd:09:2f:da:5f,216153578,284,3227,216153294,216153578
2335,5,12,149,5745,-73,-96,23,9a:24:38:da:96:bb,216153914,272,64,216153642,216153914
2336,5,12,149,5745,-77,-96,19,56:68:e2:c2:8d:d5,216155147,476,757,216154671,216155147
2337,5,12,149,5745,-49,-96,47,5e:29:73:5b:30:00,216155745,540,58,216155205,216155745
2338,5,12,149,5745,-71,-96,25,5e:36:fe:bc:a2:fe,216156321,440,136,216155881,216156321
2339,5,12,149,5745,-57,-96,39,f2:da:61:dd:98:c5,216156823,268,234,216156555,216156823
2340,5,12,149,5745,-75,-96,21,a6:92:ad:b7:76:65,216159145,456,1866,216158689,216159145
2341,5,12,149,5745,-81,-96,15,72:d1:72:1d:22:a1,216161599,452,2002,216161147,216161599
2342,5,12,149,5745,-54,-96,42,72:fd:09:2f:da:5f,216162139,480,60,216161659,216162139
2343,5,12,149,5745,-74,-96,22,9a:24:38:da:96:bb,216169127,824,6164,216168303,216169127
2344,5,12,149,5745,-66,-96,30,02:31:8a:29:26:f4,216172676,268,3281,216172408,216172676
2345,5,12,149,5745,-63,-96,33,3e:d1:9b:c7:a4:de,216173931,544,711,216173387,216173931
2346,5,12,149,5745,-74,-96,22,f6:0a:5c:59:72:df,216177646,252,3463,216177394,216177646
2347,5,12,149,5745,-73,-96,23,fa:44:8d:e1:c7:1b,216177934,440,-152,216177494,216177934
2348,5,12,149,5745,-74,-96,22,0a:b9:b7:b1:4d:fa,216180226,268,2024,216179958,216180226
2349,5,12,149,5745,-75,-96,21,22:ec:75:a8:8a:31,216185798,244,5328,216185554,216185798
2350,5,12,149,5745,-55,-96,41,f2:da:61:dd:98:c5,216202886,268,16820,216202618,216202886
2351,5,12,149,5745,-73,-96,23,fa:44:8d:e1:c7:1b,216203215,244,85,216202971,216203215
2352,5,12,149,5745,-64,-96,32,3e:d1:9b:c7:a4:de,216212431,272,8944,216212159,216212431
2353,5,12,149,5745,-48,-96,48,5e:29:73:5b:30:00,216221044,540,8073,216220504,216221044
2354,5,12,149,5745,-76,-96,20,56:68:e2:c2:8d:d5,216237476,280,16152,216237196,216237476
2355,5,12,149,5745,-73,-96,23,5e:36:fe:bc:a2:fe,216249953,244,12233,216249709,216249953
2356,5,12,149,5745,-82,-96,14,72:d1:72:1d:22:a1,216250276,256,67,216250020,216250276
2357,5,12,149,5745,-48,-96,48,5e:29:73:5b:30:00,216251383,272,835,216251111,216251383
2358,5,6,149,5745,-86,-96,10,54:e4:3a:ec:fb:65,216252467,360,724,216252107,216252467
2359,5,12,149,5745,-73,-96,23,9a:24:38:da:96:bb,216266553,272,13814,216266281,216266553
2360,5,12,149,5745,-50,-96,46,5e:29:73:5b:30:00,216286103,540,19010,216285563,216286103
2361,5,12,149,5745,-77,-96,19,22:ec:75:a8:8a:31,216287108,244,761,216286864,216287108
2362,5,12,149,5745,-65,-96,31,3e:d1:9b:c7:a4:de,216329598,272,42218,216329326,216329598
2363,5,12,149,5745,-53,-96,43,72:fd:09:2f:da:5f,216351499,284,21617,216351215,216351499
2364,5,12,149,5745,-52,-96,44,5e:29:73:5b:30:00,216351871,540,-168,216351331,216351871
2365,5,6,149,5745,-86,-96,10,54:e4:3a:ec:fb:65,216354868,360,2637,216354508,216354868
2366,5,12,149,5745,-59,-96,37,f2:da:61:dd:98:c5,216355436,268,300,216355168,216355436
2367,5,12,149,5745,-80,-96,16,72:d1:72:1d:22:a1,216362304,256,6612,216362048,216362304
2368,5,12,149,5745,-70,-96,26,5e:36:fe:bc:a2:fe,216363415,244,867,216363171,216363415
2369,5,12,149,5745,-52,-96,44,5e:29:73:5b:30:00,216365946,272,2259,216365674,216365946
2370,5,12,149,5745,-72,-96,24,02:31:8a:29:26:f4,216367405,268,1191,216367137,216367405
2371,5,12,149,5745,-73,-96,23,f6:0a:5c:59:72:df,216375222,252,7565,216374970,216375222
2372,5,12,149,5745,-77,-96,19,fa:44:8d:e1:c7:1b,216379628,244,4162,216379384,216379628
2373,5,12,149,5745,-77,-96,19,56:68:e2:c2:8d:d5,216381662,280,1754,216381382,216381662
2374,5,12,149,5745,-75,-96,21,22:ec:75:a8:8a:31,216404171,244,22265,216403927,216404171
2375,5,12,149,5745,-62,-96,34,3e:d1:9b:c7:a4:de,216443917,272,39474,216443645,216443917
2376,5,12,149,5745,-51,-96,45,72:fd:09:2f:da:5f,216453910,284,9709,216453626,216453910
2377,5,6,149,5745,-84,-96,12,54:e4:3a:ec:fb:65,216457269,360,2999,216456909,216457269
2378,5,12,149,5745,-56,-96,40,f2:da:61:dd:98:c5,216457701,268,164,216457433,216457701
2379,5,12,149,5745,-51,-96,45,5e:29:73:5b:30:00,216470766,272,12793,216470494,216470766
2380,5,12,149,5745,-72,-96,24,5e:36:fe:bc:a2:fe,216472301,244,1291,216472057,216472301
2381,5,12,149,5745,-80,-96,16,72:d1:72:1d:22:a1,216475396,256,2839,216475140,216475396
2382,5,12,149,5745,-75,-96,21,fa:44:8d:e1:c7:1b,216480827,244,5187,216480583,216480827
2383,5,12,149,5745,-78,-96,18,56:68:e2:c2:8d:d5,216482714,280,1607,216482434,216482714
2384,5,12,149,5745,-75,-96,21,9a:24:38:da:96:bb,216494318,272,11332,216494046,216494318
2385,5,12,149,5745,-51,-96,45,72:fd:09:2f:da:5f,216501658,284,7056,216501374,216501658
2386,5,12,149,5745,-73,-96,23,22:ec:75:a8:8a:31,216519567,244,17665,216519323,216519567
2387,5,12,149,5745,-60,-96,36,f2:da:61:dd:98:c5,216546560,268,26725,216546292,216546560
2388,5,12,149,5745,-75,-96,21,fa:44:8d:e1:c7:1b,216546889,244,85,216546645,216546889
2389,5,12,149,5745,-84,-96,12,d2:00:04:7e:2c:ab,216549255,244,2122,216549011,216549255
2390,5,12,149,5745,-72,-96,24,5e:36:fe:bc:a2:fe,216549534,440,-161,216549094,216549534
2391,5,12,149,5745,-60,-96,36,f2:da:61:dd:98:c5,216550765,268,963,216550497,216550765
2392,5,12,149,5745,-51,-96,45,5e:29:73:5b:30:00,216551104,540,-201,216550564,216551104
2393,5,12,149,5745,-73,-96,23,22:ec:75:a8:8a:31,216552596,516,976,216552080,216552596
2394,5,12,149,5745,-77,-96,19,56:68:e2:c2:8d:d5,216553164,476,92,216552688,216553164
2395,5,12,149,5745,-82,-96,14,72:d1:72:1d:22:a1,216555939,452,2323,216555487,216555939
2396,5,6,149,5745,-85,-96,11,54:e4:3a:ec:fb:65,216559669,360,3370,216559309,216559669
2397,5,12,149,5745,-64,-96,32,3e:d1:9b:c7:a4:de,216562442,272,2501,216562170,216562442
2398,5,12,149,5745,-63,-96,33,3e:d1:9b:c7:a4:de,216569638,544,6652,216569094,216569638
2399,5,12,149,5745,-84,-96,12,d2:00:04:7e:2c:ab,216570261,412,211,216569849,216570261
2400,5,12,149,5745,-74,-96,22,f6:0a:5c:59:72:df,216570707,252,194,216570455,216570707
2401,5,12,149,5745,-74,-96,22,f6:0a:5c:59:72:df,216570976,252,17,216570724,216570976
2402,5,12,149,5745,-75,-96,21,fa:44:8d:e1:c7:1b,216573046,440,1630,216572606,216573046
2403,5,12,149,5745,-51,-96,45,72:fd:09:2f:da:5f,216575888,380,2462,216575508,216575888
2404,5,12,149,5745,-72,-96,24,5e:36:fe:bc:a2:fe,216579116,244,2984,216578872,216579116
2405,5,12,149,5745,-82,-96,14,72:d1:72:1d:22:a1,216581905,256,2533,216581649,216581905
2406,5,12,149,5745,-51,-96,45,72:fd:09:2f:da:5f,216589249,480,6864,216588769,216589249
2407,5,12,149,5745,-51,-96,45,5e:29:73:5b:30:00,216595721,272,6200,216595449,216595721
2408,5,12,149,5745,-53,-96,43,72:fd:09:2f:da:5f,216596909,284,904,216596625,216596909
2409,5,12,149,5745,-74,-96,22,9a:24:38:da:96:bb,216602243,272,5062,216601971,216602243
2410,5,12,149,5745,-68,-96,28,02:31:8a:29:26:f4,216612539,268,10028,216612271,216612539
2411,5,12,149,5745,-72,-96,24,5e:36:fe:bc:a2:fe,216614092,440,1113,216613652,216614092
2412,5,12,149,5745,-52,-96,44,5e:29:73:5b:30:00,216614584,540,-48,216614044,216614584
2413,5,12,149,5745,-83,-96,13,d2:00:04:7e:2c:ab,216615203,440,179,216614763,216615203
2414,5,12,149,5745,-73,-96,23,22:ec:75:a8:8a:31,216636987,244,21540,216636743,216636987
2415,5,12,149,5745,-75,-96,21,fa:44:8d:e1:c7:1b,216637260,440,-167,216636820,216637260
2416,5,12,149,5745,-75,-96,21,fa:44:8d:e1:c7:1b,216644840,244,7336,216644596,216644840
2417,5,12,149,5745,-56,-96,40,f2:da:61:dd:98:c5,216656983,268,11875,216656715,216656983
2418,5,12,149,5745,-67,-96,29,02:31:8a:29:26:f4,216661551,268,4300,216661283,216661551
2419,5,6,149,5745,-86,-96,10,54:e4:3a:ec:fb:65,216662069,360,158,216661709,216662069
2420,5,12,149,5745,-83,-96,13,d2:00:04:7e:2c:ab,216664988,244,2675,216664744,216664988
2421,5,12,149,5745,-67,-96,29,02:31:8a:29:26:f4,216676975,268,11719,216676707,216676975
2422,5,12,149,5745,-61,-96,35,3e:d1:9b:c7:a4:de,216677313,272,66,216677041,216677313
2423,5,12,149,5745,-53,-96,43,5e:29:73:5b:30:00,216679869,540,2016,216679329,216679869
2424,5,12,149,5745,-71,-96,25,5e:36:fe:bc:a2:fe,216680472,440,163,216680032,216680472
2425,5,12,149,5745,-54,-96,42,f2:da:61:dd:98:c5,216682798,268,2058,216682530,216682798
2426,5,12,149,5745,-74,-96,22,22:ec:75:a8:8a:31,216683100,516,-214,216682584,216683100
2427,5,12,149,5745,-78,-96,18,a6:92:ad:b7:76:65,216683911,456,355,216683455,216683911
2428,5,12,149,5745,-77,-96,19,56:68:e2:c2:8d:d5,216685401,280,1210,216685121,216685401
2429,5,12,149,5745,-76,-96,20,f6:0a:5c:59:72:df,216692675,252,7022,216692423,216692675
2430,5,12,149,5745,-75,-96,21,9a:24:38:da:96:bb,216693123,824,-376,216692299,216693123
2431,5,12,149,5745,-71,-96,25,5e:36:fe:bc:a2:fe,216694089,244,722,216693845,216694089
2432,5,12,149,5745,-83,-96,13,d2:00:04:7e:2c:ab,216696271,440,1742,216695831,216696271
2433,5,12,149,5745,-82,-96,14,72:d1:72:1d:22:a1,216698928,256,2401,216698672,216698928
2434,5,12,149,5745,-61,-96,35,3e:d1:9b:c7:a4:de,216701225,544,1753,216700681,216701225
2435,5,12,149,5745,-76,-96,20,fa:44:8d:e1:c7:1b,216702074,440,409,216701634,216702074
2436,5,12,149,5745,-67,-96,29,0a:b9:b7:b1:4d:fa,216705262,268,2920,216704994,216705262
2437,5,12,149,5745,-52,-96,44,5e:29:73:5b:30:00,216710100,272,4566,216709828,216710100
2438,5,12,149,5745,-76,-96,20,9a:24:38:da:96:bb,216714246,272,3874,216713974,216714246
2439,5,12,149,5745,-75,-96,21,22:ec:75:a8:8a:31,216750734,244,36244,216750490,216750734
2440,5,12,149,5745,-54,-96,42,72:fd:09:2f:da:5f,216761115,284,10097,216760831,216761115
2441,5,12,149,5745,-82,-96,14,d2:00:04:7e:2c:ab,216762810,440,1255,216762370,216762810
2442,5,6,149,5745,-88,-96,8,54:e4:3a:ec:fb:65,216764470,360,1300,216764110,216764470
2443,5,12,149,5745,-79,-96,17,fa:44:8d:e1:c7:1b,216766757,244,2043,216766513,216766757
2444,5,12,149,5745,-52,-96,44,f2:da:61:dd:98:c5,216769393,268,2368,216769125,216769393
2445,5,12,149,5745,-64,-96,32,02:31:8a:29:26:f4,216778101,268,8440,216777833,216778101
2446,5,12,149,5745,-83,-96,13,d2:00:04:7e:2c:ab,216778511,244,166,216778267,216778511
2447,5,12,149,5745,-62,-96,34,3e:d1:9b:c7:a4:de,216785416,272,6633,216785144,216785416
2448,5,12,149,5745,-78,-96,18,56:68:e2:c2:8d:d5,216800667,280,14971,216800387,216800667
2449,5,24,149,5745,-87,-96,9,,216801062,28,367,216801034,216801062
2450,5,12,149,5745,-52,-96,44,5e:29:73:5b:30:00,216809662,272,8328,216809390,216809662
2451,5,12,149,5745,-74,-96,22,f6:0a:5c:59:72:df,216812907,252,2993,216812655,216812907
2452,5,24,149,5745,-85,-96,11,,216826529,28,13594,216826501,216826529
2453,5,24,149,5745,-84,-96,12,,216826640,32,79,216826608,216826640
2454,5,12,149,5745,-73,-96,23,9a:24:38:da:96:bb,216827391,272,479,216827119,216827391
2455,5,12,149,5745,-52,-96,44,72:fd:09:2f:da:5f,216864033,284,36358,216863749,216864033
2456,5,12,149,5745,-69,-96,27,5e:36:fe:bc:a2:fe,216865837,244,1560,216865593,216865837
2457,5,6,149,5745,-89,-96,7,54:e4:3a:ec:fb:65,216866870,360,673,216866510,216866870
2458,5,12,149,5745,-73,-96,23,22:ec:75:a8:8a:31,216868824,244,1710,216868580,216868824
2459,5,12,149,5745,-57,-96,39,f2:da:61:dd:98:c5,216879648,268,10556,216879380,216879648
2460,5,12,149,5745,-77,-96,19,fa:44:8d:e1:c7:1b,216890873,244,10981,216890629,216890873
2461,5,12,149,5745,-82,-96,14,72:d1:72:1d:22:a1,216891749,256,620,216891493,216891749
2462,5,12,149,5745,-80,-96,16,d2:00:04:7e:2c:ab,216892157,244,164,216891913,216892157
2463,5,12,149,5745,-62,-96,34,3e:d1:9b:c7:a4:de,216902328,272,9899,216902056,216902328
2464,5,12,149,5745,-77,-96,19,56:68:e2:c2:8d:d5,216909689,280,7081,216909409,216909689
2465,5,12,149,5745,-51,-96,45,5e:29:73:5b:30:00,216926940,272,16979,216926668,216926940
2466,5,12,149,5745,-71,-96,25,9a:24:38:da:96:bb,216943448,272,16236,216943176,216943448
2467,5,12,149,5745,-55,-96,41,72:fd:09:2f:da:5f,216966550,284,22818,216966266,216966550
2468,5,12,149,5745,-68,-96,28,5e:36:fe:bc:a2:fe,216968928,244,2134,216968684,216968928
2469,5,6,149,5745,-85,-96,11,54:e4:3a:ec:fb:65,216969271,360,-17,216968911,216969271
2470,5,12,149,5745,-70,-96,26,02:31:8a:29:26:f4,216970424,268,885,216970156,216970424
2471,5,12,149,5745,-76,-96,20,22:ec:75:a8:8a:31,216984641,244,13973,216984397,216984641
2472,5,12,149,5745,-78,-96,18,fa:44:8d:e1:c7:1b,216993412,244,8527,216993168,216993412
2473,5,12,149,5745,-81,-96,15,72:d1:72:1d:22:a1,216993728,256,60,216993472,216993728
2474,5,12,149,5745,-79,-96,17,d2:00:04:7e:2c:ab,217004866,244,10894,217004622,217004866
2475,5,12,149,5745,-61,-96,35,3e:d1:9b:c7:a4:de,217019312,272,14174,217019040,217019312
2476,5,12,149,5745,-50,-96,46,5e:29:73:5b:30:00,217039948,272,20364,217039676,217039948
2477,5,24,149,5745,-86,-96,10,,217040605,28,629,217040577,217040605
2478,5,12,149,5745,-75,-96,21,9a:24:38:da:96:bb,217051022,272,10145,217050750,217051022
2479,5,24,149,5745,-87,-96,9,,217057701,32,6647,217057669,217057701
2480,5,12,149,5745,-59,-96,37,72:fd:09:2f:da:5f,217066846,284,8861,217066562,217066846
2481,5,12,149,5745,-67,-96,29,5e:36:fe:bc:a2:fe,217070384,244,3294,217070140,217070384
2482,5,12,149,5745,-50,-96,46,f2:da:61:dd:98:c5,217070952,268,300,217070684,217070952
2483,5,6,149,5745,-87,-96,9,54:e4:3a:ec:fb:65,217071672,360,360,217071312,217071672
2484,5,12,149,5745,-67,-96,29,02:31:8a:29:26:f4,217072403,268,463,217072135,217072403
2485,5,12,149,5745,-83,-96,13,72:d1:72:1d:22:a1,217095592,256,22933,217095336,217095592
2486,5,12,149,5745,-75,-96,21,22:ec:75:a8:8a:31,217096630,244,794,217096386,217096630
2487,5,12,149,5745,-75,-96,21,56:68:e2:c2:8d:d5,217097707,280,797,217097427,217097707
2488,5,12,149,5745,-50,-96,46,f2:da:61:dd:98:c5,217107275,268,9300,217107007,217107275
2489,5,12,149,5745,-74,-96,22,56:68:e2:c2:8d:d5,217111464,280,3909,217111184,217111464
2490,5,12,149,5745,-80,-96,16,d2:00:04:7e:2c:ab,217111804,244,96,217111560,217111804
2491,5,12,149,5745,-81,-96,15,fa:44:8d:e1:c7:1b,217112086,244,38,217111842,217112086
2492,5,12,149,5745,-66,-96,30,02:31:8a:29:26:f4,217121610,268,9256,217121342,217121610
2493,5,12,149,5745,-74,-96,22,f6:0a:5c:59:72:df,217123415,252,1553,217123163,217123415
2494,5,12,149,5745,-75,-96,21,f6:0a:5c:59:72:df,217130929,252,7262,217130677,217130929
2495,5,12,149,5745,-66,-96,30,02:31:8a:29:26:f4,217137130,268,5933,217136862,217137130
2496,5,12,149,5745,-75,-96,21,56:68:e2:c2:8d:d5,217138755,476,1149,217138279,217138755
2497,5,12,149,5745,-75,-96,21,22:ec:75:a8:8a:31,217139274,516,3,217138758,217139274
2498,5,12,149,5745,-50,-96,46,f2:da:61:dd:98:c5,217139851,268,309,217139583,217139851
2499,5,12,149,5745,-67,-96,29,5e:36:fe:bc:a2:fe,217140164,440,-127,217139724,217140164
2500,5,12,149,5745,-83,-96,13,72:d1:72:1d:22:a1,217140638,256,218,217140382,217140638
2501,5,12,149,5745,-49,-96,47,5e:29:73:5b:30:00,217142755,540,1577,217142215,217142755
2502,5,12,149,5745,-82,-96,14,72:d1:72:1d:22:a1,217144294,452,1087,217143842,217144294
2503,5,12,149,5745,-61,-96,35,3e:d1:9b:c7:a4:de,217152336,272,7770,217152064,217152336
2504,5,12,149,5745,-67,-96,29,5e:36:fe:bc:a2:fe,217152671,244,91,217152427,217152671
2505,5,12,149,5745,-79,-96,17,d2:00:04:7e:2c:ab,217155334,440,2223,217154894,217155334
2506,5,12,149,5745,-61,-96,35,3e:d1:9b:c7:a4:de,217157599,544,1721,217157055,217157599
2507,5,12,149,5745,-77,-96,19,f6:0a:5c:59:72:df,217160313,252,2462,217160061,217160313
2508,5,12,149,5745,-83,-96,13,fa:44:8d:e1:c7:1b,217161094,440,341,217160654,217161094
2509,5,12,149,5745,-56,-96,40,72:fd:09:2f:da:5f,217162763,480,1189,217162283,217162763
2510,5,12,149,5745,-78,-96,18,9a:24:38:da:96:bb,217163296,272,261,217163024,217163296
2511,5,12,149,5745,-50,-96,46,5e:29:73:5b:30:00,217168890,272,5322,217168618,217168890
2512,5,12,149,5745,-56,-96,40,72:fd:09:2f:da:5f,217169349,284,175,217169065,217169349
2513,5,6,149,5745,-87,-96,9,54:e4:3a:ec:fb:65,217174072,360,4363,217173712,217174072
2514,5,12,149,5745,-65,-96,31,02:31:8a:29:26:f4,217201276,268,26936,217201008,217201276
2515,5,12,149,5745,-82,-96,14,fa:44:8d:e1:c7:1b,217201911,244,391,217201667,217201911
2516,5,12,149,5745,-73,-96,23,56:68:e2:c2:8d:d5,217203674,476,1287,217203198,217203674
2517,5,12,149,5745,-67,-96,29,5e:36:fe:bc:a2:fe,217204184,440,70,217203744,217204184
2518,5,12,149,5745,-51,-96,45,f2:da:61:dd:98:c5,217204687,268,235,217204419,217204687
2519,5,12,149,5745,-75,-96,21,22:ec:75:a8:8a:31,217205095,516,-108,217204579,217205095
2520,5,12,149,5745,-76,-96,20,a6:92:ad:b7:76:65,217207313,456,1762,217206857,217207313
2521,5,12,149,5745,-50,-96,46,5e:29:73:5b:30:00,217208056,540,203,217207516,217208056
2522,5,12,149,5745,-82,-96,14,72:d1:72:1d:22:a1,217209811,452,1303,217209359,217209811
2523,5,12,149,5745,-77,-96,19,f6:0a:5c:59:72:df,217211406,132,1463,217211274,217211406
2524,5,12,149,5745,-56,-96,40,72:fd:09:2f:da:5f,217212801,380,1015,217212421,217212801
2525,5,12,149,5745,-78,-96,18,9a:24:38:da:96:bb,217216539,824,2914,217215715,217216539
2526,5,12,149,5745,-76,-96,20,22:ec:75:a8:8a:31,217217967,244,1184,217217723,217217967
2527,5,12,149,5745,-50,-96,46,f2:da:61:dd:98:c5,217218389,268,154,217218121,217218389
2528,5,12,149,5745,-78,-96,18,d2:00:04:7e:2c:ab,217218719,440,-110,217218279,217218719
2529,5,12,149,5745,-78,-96,18,d2:00:04:7e:2c:ab,217219240,244,277,217218996,217219240
2530,5,12,149,5745,-78,-96,18,d2:00:04:7e:2c:ab,217222050,380,2430,217221670,217222050
2531,5,12,149,5745,-60,-96,36,3e:d1:9b:c7:a4:de,217222464,544,-130,217221920,217222464
2532,5,12,149,5745,-56,-96,40,72:fd:09:2f:da:5f,217225328,480,2384,217224848,217225328
2533,5,12,149,5745,-82,-96,14,fa:44:8d:e1:c7:1b,217226884,440,1116,217226444,217226884
2534,5,12,149,5745,-65,-96,31,0a:b9:b7:b1:4d:fa,217229771,268,2619,217229503,217229771
2535,5,12,149,5745,-73,-96,23,56:68:e2:c2:8d:d5,217234536,280,4485,217234256,217234536
2536,5,12,149,5745,-79,-96,17,f6:0a:5c:59:72:df,217243708,252,8920,217243456,217243708
2537,5,12,149,5745,-61,-96,35,3e:d1:9b:c7:a4:de,217251637,272,7657,217251365,217251637
2538,5,12,149,5745,-81,-96,15,72:d1:72:1d:22:a1,217254704,256,2811,217254448,217254704
2539,5,12,149,5745,-51,-96,45,5e:29:73:5b:30:00,217266980,272,12004,217266708,217266980
2540,5,12,149,5745,-78,-96,18,9a:24:38:da:96:bb,217275706,272,8454,217275434,217275706
2541,5,6,149,5745,-86,-96,10,54:e4:3a:ec:fb:65,217276473,360,407,217276113,217276473
2542,5,12,149,5745,-66,-96,30,5e:36:fe:bc:a2:fe,217277713,244,996,217277469,217277713
2543,5,12,149,5745,-78,-96,18,d2:00:04:7e:2c:ab,217284134,440,5981,217283694,217284134
2544,5,12,149,5745,-56,-96,40,72:fd:09:2f:da:5f,217286660,284,2242,217286376,217286660
2545,5,12,149,5745,-77,-96,19,22:ec:75:a8:8a:31,217326385,244,39481,217326141,217326385
2546,5,12,149,5745,-79,-96,17,d2:00:04:7e:2c:ab,217347988,244,21359,217347744,217347988
2547,5,12,149,5745,-61,-96,35,3e:d1:9b:c7:a4:de,217360610,272,12350,217360338,217360610
2548,5,6,149,5745,-88,-96,8,54:e4:3a:ec:fb:65,217378873,360,17903,217378513,217378873
2549,5,12,149,5745,-65,-96,31,5e:36:fe:bc:a2:fe,217379306,244,189,217379062,217379306
2550,5,12,149,5745,-55,-96,41,f2:da:61:dd:98:c5,217379639,268,65,217379371,217379639
2551,5,12,149,5745,-63,-96,33,02:31:8a:29:26:f4,217380058,268,151,217379790,217380058
2552,5,12,149,5745,-53,-96,43,5e:29:73:5b:30:00,217384162,272,3832,217383890,217384162
2553,5,12,149,5745,-74,-96,22,9a:24:38:da:96:bb,217390684,272,6250,217390412,217390684
2554,5,12,149,5745,-79,-96,17,72:d1:72:1d:22:a1,217402910,256,11970,217402654,217402910
2555,5,12,149,5745,-82,-96,14,fa:44:8d:e1:c7:1b,217403632,244,478,217403388,217403632
2556,5,12,149,5745,-74,-96,22,56:68:e2:c2:8d:d5,217405645,280,1733,217405365,217405645
2557,5,12,149,5745,-76,-96,20,22:ec:75:a8:8a:31,217441151,244,35262,217440907,217441151
2558,5,12,149,5745,-56,-96,40,72:fd:09:2f:da:5f,217477323,284,35888,217477039,217477323
2559,5,12,149,5745,-62,-96,34,3e:d1:9b:c7:a4:de,217477946,272,351,217477674,217477946
2560,5,12,149,5745,-73,-96,23,f6:0a:5c:59:72:df,217478465,252,267,217478213,217478465
2561,5,6,149,5745,-87,-96,9,54:e4:3a:ec:fb:65,217481273,360,2448,217480913,217481273
2562,5,12,149,5745,-54,-96,42,f2:da:61:dd:98:c5,217481832,268,291,217481564,217481832
2563,5,12,149,5745,-61,-96,35,02:31:8a:29:26:f4,217482163,268,63,217481895,217482163
2564,5,12,149,5745,-65,-96,31,5e:36:fe:bc:a2:fe,217490784,244,8377,217490540,217490784
2565,5,12,149,5745,-74,-96,22,9a:24:38:da:96:bb,217499265,272,8209,217498993,217499265
2566,5,12,149,5745,-52,-96,44,5e:29:73:5b:30:00,217501165,272,1628,217500893,217501165
2567,5,12,149,5745,-81,-96,15,d2:00:04:7e:2c:ab,217505706,244,4297,217505462,217505706
2568,5,12,149,5745,-83,-96,13,fa:44:8d:e1:c7:1b,217506046,244,96,217505802,217506046
2569,5,12,149,5745,-78,-96,18,72:d1:72:1d:22:a1,217506335,256,33,217506079,217506335
2570,5,12,149,5745,-73,-96,23,56:68:e2:c2:8d:d5,217512049,280,5434,217511769,217512049
2571,5,12,149,5745,-82,-96,14,fa:44:8d:e1:c7:1b,217557626,244,45333,217557382,217557626
2572,5,12,149,5745,-75,-96,21,22:ec:75:a8:8a:31,217558775,244,905,217558531,217558775
2573,5,12,149,5745,-52,-96,44,f2:da:61:dd:98:c5,217559071,268,28,217558803,217559071
2574,5,12,149,5745,-61,-96,35,02:31:8a:29:26:f4,217571479,268,12140,217571211,217571479
2575,5,12,149,5745,-82,-96,14,d2:00:04:7e:2c:ab,217574205,244,2482,217573961,217574205
2576,5,12,149,5745,-75,-96,21,f6:0a:5c:59:72:df,217580018,252,5561,217579766,217580018
2577,5,12,149,5745,-74,-96,22,56:68:e2:c2:8d:d5,217582896,280,2598,217582616,217582896
2578,5,12,149,5745,-53,-96,43,72:fd:09:2f:da:5f,217583625,284,445,217583341,217583625
2579,5,6,149,5745,-86,-96,10,54:e4:3a:ec:fb:65,217583940,360,-45,217583580,217583940
2580,5,12,149,5745,-61,-96,35,02:31:8a:29:26:f4,217594398,268,10190,217594130,217594398
2581,5,12,149,5745,-65,-96,31,5e:36:fe:bc:a2:fe,217594979,244,337,217594735,217594979
2582,5,12,149,5745,-52,-96,44,f2:da:61:dd:98:c5,217597590,268,2343,217597322,217597590
2583,5,12,149,5745,-78,-96,18,72:d1:72:1d:22:a1,217597892,256,46,217597636,217597892
2584,5,12,149,5745,-66,-96,30,5e:36:fe:bc:a2:fe,217598182,440,-150,217597742,217598182
2585,5,12,149,5745,-75,-96,21,22:ec:75:a8:8a:31,217599707,516,1009,217599191,217599707
2586,5,12,149,5745,-51,-96,45,5e:29:73:5b:30:00,217602943,540,2696,217602403,217602943
2587,5,12,149,5745,-77,-96,19,72:d1:72:1d:22:a1,217604455,452,1060,217604003,217604455
2588,5,12,149,5745,-76,-96,20,f6:0a:5c:59:72:df,217606128,132,1541,217605996,217606128
2589,5,12,149,5745,-79,-96,17,9a:24:38:da:96:bb,217610135,824,3183,217609311,217610135
2590,5,12,149,5745,-79,-96,17,9a:24:38:da:96:bb,217610976,272,569,217610704,217610976
2591,5,12,149,5745,-61,-96,35,3e:d1:9b:c7:a4:de,217611328,272,80,217611056,217611328
2592,5,12,149,5745,-53,-96,43,72:fd:09:2f:da:5f,217611766,284,154,217611482,217611766
2593,5,12,149,5745,-74,-96,22,56:68:e2:c2:8d:d5,217615199,476,2957,217614723,217615199
2594,5,12,149,5745,-61,-96,35,3e:d1:9b:c7:a4:de,217618841,544,3098,217618297,217618841
2595,5,12,149,5745,-80,-96,16,fa:44:8d:e1:c7:1b,217619573,440,292,217619133,217619573
2596,5,12,149,5745,-77,-96,19,f6:0a:5c:59:72:df,217620338,252,513,217620086,217620338
2597,5,12,149,5745,-54,-96,42,72:fd:09:2f:da:5f,217622676,480,1858,217622196,217622676
2598,5,12,149,5745,-51,-96,45,5e:29:73:5b:30:00,217627564,272,4616,217627292,217627564
2599,5,12,149,5745,-82,-96,14,d2:00:04:7e:2c:ab,217628527,440,523,217628087,217628527
2600,5,12,149,5745,-81,-96,15,d2:00:04:7e:2c:ab,217647975,104,19344,217647871,217647975
2601,5,12,149,5745,-78,-96,18,fa:44:8d:e1:c7:1b,217662130,244,13911,217661886,217662130
2602,5,12,149,5745,-66,-96,30,5e:36:fe:bc:a2:fe,217662426,440,-144,217661986,217662426
2603,5,12,149,5745,-74,-96,22,22:ec:75:a8:8a:31,217671897,244,9227,217671653,217671897
2604,5,12,149,5745,-54,-96,42,f2:da:61:dd:98:c5,217676449,268,4284,217676181,217676449
2605,5,12,149,5745,-64,-96,32,02:31:8a:29:26:f4,217676869,268,152,217676601,217676869
2606,5,12,149,5745,-81,-96,15,d2:00:04:7e:2c:ab,217677900,440,591,217677460,217677900
2607,5,12,149,5745,-81,-96,15,d2:00:04:7e:2c:ab,217678619,244,475,217678375,217678619
2608,5,12,149,5745,-64,-96,32,02:31:8a:29:26:f4,217681932,268,3045,217681664,217681932
2609,5,6,149,5745,-86,-96,10,54:e4:3a:ec:fb:65,217686075,360,3783,217685715,217686075
2610,5,12,149,5745,-74,-96,22,56:68:e2:c2:8d:d5,217696564,280,10209,217696284,217696564
2611,5,12,149,5745,-66,-96,30,5e:36:fe:bc:a2:fe,217709948,244,13140,217709704,217709948
2612,5,12,149,5745,-78,-96,18,72:d1:72:1d:22:a1,217720291,256,10087,217720035,217720291
2613,5,12,149,5745,-78,-96,18,9a:24:38:da:96:bb,217722809,272,2246,217722537,217722809
2614,5,12,149,5745,-60,-96,36,3e:d1:9b:c7:a4:de,217727949,272,4868,217727677,217727949
2615,5,12,149,5745,-66,-96,30,5e:36:fe:bc:a2:fe,217728437,440,48,217727997,217728437
2616,5,12,149,5745,-56,-96,40,f2:da:61:dd:98:c5,217729677,268,972,217729409,217729677
2617,5,12,149,5745,-74,-96,22,a6:92:ad:b7:76:65,217732589,456,2456,217732133,217732589
2618,5,12,149,5745,-52,-96,44,5e:29:73:5b:30:00,217735089,540,1960,217734549,217735089
2619,5,12,149,5745,-81,-96,15,fa:44:8d:e1:c7:1b,217735672,440,143,217735232,217735672
2620,5,12,149,5745,-52,-96,44,5e:29:73:5b:30:00,217742250,272,6306,217741978,217742250
2621,5,12,149,5745,-74,-96,22,22:ec:75:a8:8a:31,217745137,516,2371,217744621,217745137
2622,5,12,149,5745,-65,-96,31,02:31:8a:29:26:f4,217749649,268,4244,217749381,217749649
2623,5,12,149,5745,-60,-96,36,3e:d1:9b:c7:a4:de,217749969,544,-224,217749425,217749969
2624,5,12,149,5745,-65,-96,31,0a:b9:b7:b1:4d:fa,217756207,268,5970,217755939,217756207
2625,5,12,149,5745,-82,-96,14,fa:44:8d:e1:c7:1b,217775867,244,19416,217775623,217775867
2626,5,12,149,5745,-58,-96,38,f2:da:61:dd:98:c5,217778131,268,1996,217777863,217778131
2627,5,12,149,5745,-51,-96,45,72:fd:09:2f:da:5f,217785625,284,7210,217785341,217785625
2628,5,12,149,5745,-74,-96,22,22:ec:75:a8:8a:31,217786187,244,318,217785943,217786187
2629,5,6,149,5745,-85,-96,11,54:e4:3a:ec:fb:65,217788476,360,1929,217788116,217788476
2630,5,12,149,5745,-82,-96,14,d2:00:04:7e:2c:ab,217792281,244,3561,217792037,217792281
2631,5,12,149,5745,-63,-96,33,02:31:8a:29:26:f4,217805316,268,12767,217805048,217805316
2632,5,12,149,5745,-74,-96,22,56:68:e2:c2:8d:d5,217809512,280,3916,217809232,217809512
2633,5,12,149,5745,-83,-96,13,d2:00:04:7e:2c:ab,217814479,440,4527,217814039,217814479
2634,5,12,149,5745,-60,-96,36,3e:d1:9b:c7:a4:de,217822376,272,7625,217822104,217822376
2635,5,12,149,5745,-79,-96,17,72:d1:72:1d:22:a1,217829480,256,6848,217829224,217829480
2636,5,12,149,5745,-65,-96,31,5e:36:fe:bc:a2:fe,217830614,244,890,217830370,217830614
2637,5,12,149,5745,-77,-96,19,9a:24:38:da:96:bb,217836005,272,5119,217835733,217836005
2638,5,12,149,5745,-54,-96,42,5e:29:73:5b:30:00,217842896,272,6619,217842624,217842896
2639,5,6,149,5745,-77,-96,19,,217881491,52,38543,217881439,217881491
2640,5,6,149,5745,-76,-96,20,,217881945,52,402,217881893,217881945
2641,5,12,149,5745,-51,-96,45,72:fd:09:2f:da:5f,217887883,284,5654,217887599,217887883
2642,5,6,149,5745,-85,-96,11,54:e4:3a:ec:fb:65,217890876,360,2633,217890516,217890876
2643,5,12,149,5745,-58,-96,38,f2:da:61:dd:98:c5,217901782,268,10638,217901514,217901782
2644,5,12,149,5745,-74,-96,22,22:ec:75:a8:8a:31,217903349,244,1323,217903105,217903349
2645,5,12,149,5745,-83,-96,13,d2:00:04:7e:2c:ab,217913192,244,9599,217912948,217913192
2646,5,12,149,5745,-82,-96,14,fa:44:8d:e1:c7:1b,217915584,244,2148,217915340,217915584
2647,5,6,149,5745,-76,-96,20,24:f6:77:10:02:c8,217917075,176,1315,217916899,217917075
2648,5,12,149,5745,-74,-96,22,56:68:e2:c2:8d:d5,217920194,280,2839,217919914,217920194
2649,5,6,149,5745,-76,-96,20,24:f6:77:10:02:c8,217927155,176,6785,217926979,217927155
2650,5,12,149,5745,-73,-96,23,f6:0a:5c:59:72:df,217934042,252,6635,217933790,217934042
2651,5,12,149,5745,-60,-96,36,3e:d1:9b:c7:a4:de,217939510,272,5196,217939238,217939510
2652,5,12,149,5745,-79,-96,17,9a:24:38:da:96:bb,217950699,272,10917,217950427,217950699
2653,5,12,149,5745,-54,-96,42,5e:29:73:5b:30:00,217959854,272,8883,217959582,217959854
2654,5,12,149,5745,-51,-96,45,72:fd:09:2f:da:5f,217990422,284,30284,217990138,217990422
2655,5,12,149,5745,-66,-96,30,5e:36:fe:bc:a2:fe,217992356,244,1690,217992112,217992356
2656,5,6,149,5745,-85,-96,11,54:e4:3a:ec:fb:65,217993276,360,560,217992916,217993276
2657,5,12,149,5745,-63,-96,33,02:31:8a:29:26:f4,217993781,268,237,217993513,217993781
2658,5,12,149,5745,-57,-96,39,f2:da:61:dd:98:c5,218009991,268,15942,218009723,218009991
2659,5,12,149,5745,-80,-96,16,fa:44:8d:e1:c7:1b,218017906,244,7671,218017662,218017906
2660,5,12,149,5745,-79,-96,17,72:d1:72:1d:22:a1,218018375,256,213,218018119,218018375
2661,5,12,149,5745,-74,-96,22,22:ec:75:a8:8a:31,218020394,244,1775,218020150,218020394
2662,5,12,149,5745,-81,-96,15,d2:00:04:7e:2c:ab,218026056,244,5418,218025812,218026056
2663,5,12,149,5745,-74,-96,22,56:68:e2:c2:8d:d5,218032292,280,5956,218032012,218032292
2664,5,12,149,5745,-60,-96,36,3e:d1:9b:c7:a4:de,218051601,272,19037,218051329,218051601
2665,5,12,149,5745,-73,-96,23,f6:0a:5c:59:72:df,218053408,252,1555,218053156,218053408
2666,5,12,149,5745,-79,-96,17,9a:24:38:da:96:bb,218059391,272,5711,218059119,218059391
2667,5,6,149,5745,-75,-96,21,,218065395,52,5952,218065343,218065395
2668,5,6,149,5745,-76,-96,20,,218065867,52,420,218065815,218065867
2669,5,24,149,5745,-77,-96,19,,218072314,28,6419,218072286,218072314
2670,5,12,149,5745,-53,-96,43,5e:29:73:5b:30:00,218074247,272,1661,218073975,218074247
2671,5,12,149,5745,-52,-96,44,72:fd:09:2f:da:5f,218092846,284,18315,218092562,218092846
2672,5,12,149,5745,-66,-96,30,5e:36:fe:bc:a2:fe,218094706,244,1616,218094462,218094706
2673,5,6,149,5745,-85,-96,11,54:e4:3a:ec:fb:65,218095677,360,611,218095317,218095677
2674,5,12,149,5745,-63,-96,33,02:31:8a:29:26:f4,218096146,268,201,218095878,218096146
2675,5,12,149,5745,-80,-96,16,fa:44:8d:e1:c7:1b,218119521,244,23131,218119277,218119521
2676,5,12,149,5745,-79,-96,17,72:d1:72:1d:22:a1,218121325,256,1548,218121069,218121325
2677,5,12,149,5745,-56,-96,40,f2:da:61:dd:98:c5,218127923,268,6330,218127655,218127923
2678,5,12,149,5745,-73,-96,23,22:ec:75:a8:8a:31,218132191,244,4024,218131947,218132191
2679,5,12,149,5745,-82,-96,14,d2:00:04:7e:2c:ab,218135748,244,3313,218135504,218135748
2680,5,12,149,5745,-64,-96,32,02:31:8a:29:26:f4,218137483,268,1467,218137215,218137483
2681,5,12,149,5745,-75,-96,21,56:68:e2:c2:8d:d5,218156231,280,18468,218155951,218156231
2682,5,12,149,5745,-59,-96,37,3e:d1:9b:c7:a4:de,218163683,272,7180,218163411,218163683
2683,5,12,149,5745,-67,-96,29,5e:36:fe:bc:a2:fe,218168879,244,4952,218168635,218168879
2684,5,12,149,5745,-78,-96,18,9a:24:38:da:96:bb,218170604,272,1453,218170332,218170604
2685,5,12,149,5745,-78,-96,18,72:d1:72:1d:22:a1,218173782,256,2922,218173526,218173782
2686,5,12,149,5745,-53,-96,43,72:fd:09:2f:da:5f,218185285,284,11219,218185001,218185285
2687,5,12,149,5745,-74,-96,22,56:68:e2:c2:8d:d5,218189167,476,3406,218188691,218189167
2688,5,12,149,5745,-56,-96,40,f2:da:61:dd:98:c5,218192342,268,2907,218192074,218192342
2689,5,12,149,5745,-52,-96,44,5e:29:73:5b:30:00,218194219,540,1337,218193679,218194219
2690,5,12,149,5745,-79,-96,17,72:d1:72:1d:22:a1,218194803,452,132,218194351,218194803
2691,5,6,149,5745,-86,-96,10,54:e4:3a:ec:fb:65,218198077,360,2914,218197717,218198077
2692,5,12,149,5745,-80,-96,16,fa:44:8d:e1:c7:1b,218198846,440,329,218198406,218198846
2693,5,12,149,5745,-73,-96,23,22:ec:75:a8:8a:31,218201408,516,2046,218200892,218201408
2694,5,12,149,5745,-59,-96,37,3e:d1:9b:c7:a4:de,218203029,544,1077,218202485,218203029
2695,5,12,149,5745,-52,-96,44,5e:29:73:5b:30:00,218204498,272,1197,218204226,218204498
2696,5,12,149,5745,-72,-96,24,f6:0a:5c:59:72:df,218209160,252,4410,218208908,218209160
2697,5,12,149,5745,-81,-96,15,d2:00:04:7e:2c:ab,218209493,440,-107,218209053,218209493
2698,5,12,149,5745,-64,-96,32,02:31:8a:29:26:f4,218210589,268,828,218210321,218210589
2699,5,12,149,5745,-67,-96,29,5e:36:fe:bc:a2:fe,218210938,440,-91,218210498,218210938
2700,5,12,149,5745,-53,-96,43,72:fd:09:2f:da:5f,218212834,480,1416,218212354,218212834
2701,5,12,149,5745,-81,-96,15,fa:44:8d:e1:c7:1b,218234425,244,21347,218234181,218234425
2702,5,12,149,5745,-64,-96,32,02:31:8a:29:26:f4,218236359,268,1666,218236091,218236359
2703,5,12,149,5745,-57,-96,39,f2:da:61:dd:98:c5,218236851,268,224,218236583,218236851
2704,5,12,149,5745,-81,-96,15,d2:00:04:7e:2c:ab,218251070,244,13975,218250826,218251070
2705,5,12,149,5745,-75,-96,21,56:68:e2:c2:8d:d5,218252212,280,862,218251932,218252212
2706,5,12,149,5745,-75,-96,21,56:68:e2:c2:8d:d5,218254399,476,1711,218253923,218254399
2707,5,12,149,5745,-77,-96,19,72:d1:72:1d:22:a1,218258223,452,3372,218257771,218258223
2708,5,12,149,5745,-68,-96,28,5e:36:fe:bc:a2:fe,218259780,440,1117,218259340,218259780
2709,5,12,149,5745,-79,-96,17,fa:44:8d:e1:c7:1b,218261460,440,1240,218261020,218261460
2710,5,12,149,5745,-65,-96,31,0a:b9:b7:b1:4d:fa,218262114,268,386,218261846,218262114
2711,5,12,149,5745,-58,-96,38,f2:da:61:dd:98:c5,218262444,268,62,218262176,218262444
2712,5,12,149,5745,-72,-96,24,f6:0a:5c:59:72:df,218262782,252,86,218262530,218262782
2713,5,12,149,5745,-73,-96,23,22:ec:75:a8:8a:31,218266461,516,3163,218265945,218266461
2714,5,12,149,5745,-73,-96,23,22:ec:75:a8:8a:31,218266994,244,289,218266750,218266994
2715,5,12,149,5745,-73,-96,23,a6:92:ad:b7:76:65,218267291,456,-159,218266835,218267291
2716,5,12,149,5745,-60,-96,36,3e:d1:9b:c7:a4:de,218267781,544,-54,218267237,218267781
2717,5,12,149,5745,-77,-96,19,72:d1:72:1d:22:a1,218269477,256,1440,218269221,218269477
2718,5,12,149,5745,-81,-96,15,d2:00:04:7e:2c:ab,218270959,380,1102,218270579,218270959
2719,5,12,149,5745,-51,-96,45,5e:29:73:5b:30:00,218271373,540,-126,218270833,218271373
2720,5,12,149,5745,-81,-96,15,d2:00:04:7e:2c:ab,218273009,440,1196,218272569,218273009
2721,5,12,149,5745,-65,-96,31,02:31:8a:29:26:f4,218274645,268,1368,218274377,218274645
2722,5,12,149,5745,-54,-96,42,72:fd:09:2f:da:5f,218275999,480,874,218275519,218275999
2723,5,12,149,5745,-68,-96,28,5e:36:fe:bc:a2:fe,218283013,244,6770,218282769,218283013
2724,5,12,149,5745,-60,-96,36,3e:d1:9b:c7:a4:de,218284992,272,1707,218284720,218284992
2725,5,12,149,5745,-54,-96,42,72:fd:09:2f:da:5f,218285927,284,651,218285643,218285927
2726,5,12,149,5745,-77,-96,19,9a:24:38:da:96:bb,218290992,272,4793,218290720,218290992
2727,5,6,149,5745,-87,-96,9,54:e4:3a:ec:fb:65,218300478,360,9126,218300118,218300478
2728,5,12,149,5745,-50,-96,46,5e:29:73:5b:30:00,218303593,272,2843,218303321,218303593
2729,5,12,149,5745,-82,-96,14,d2:00:04:7e:2c:ab,218338672,440,34639,218338232,218338672
2730,5,12,149,5745,-81,-96,15,d2:00:04:7e:2c:ab,218349279,244,10363,218349035,218349279
2731,5,12,149,5745,-57,-96,39,f2:da:61:dd:98:c5,218352015,268,2468,218351747,218352015
2732,5,12,149,5745,-73,-96,23,22:ec:75:a8:8a:31,218359698,244,7439,218359454,218359698
2733,5,12,149,5745,-64,-96,32,02:31:8a:29:26:f4,218361794,268,1828,218361526,218361794
2734,5,12,149,5745,-71,-96,25,f6:0a:5c:59:72:df,218388563,252,26517,218388311,218388563
2735,5,12,149,5745,-59,-96,37,3e:d1:9b:c7:a4:de,218392086,272,3251,218391814,218392086
2736,5,12,149,5745,-69,-96,27,5e:36:fe:bc:a2:fe,218398082,244,5752,218397838,218398082
2737,5,6,149,5745,-89,-96,7,54:e4:3a:ec:fb:65,218402879,360,4437,218402519,218402879
2738,5,12,149,5745,-77,-96,19,9a:24:38:da:96:bb,218403310,272,159,218403038,218403310
2739,5,12,149,5745,-53,-96,43,72:fd:09:2f:da:5f,218411171,284,7577,218410887,218411171
2740,5,12,149,5745,-50,-96,46,5e:29:73:5b:30:00,218415761,272,4318,218415489,218415761
2741,5,12,149,5745,-79,-96,17,fa:44:8d:e1:c7:1b,218427052,244,11047,218426808,218427052
2742,5,12,149,5745,-79,-96,17,72:d1:72:1d:22:a1,218427863,256,555,218427607,218427863
2743,5,12,149,5745,-73,-96,23,56:68:e2:c2:8d:d5,218429607,280,1464,218429327,218429607
2744,5,12,149,5745,-74,-96,22,22:ec:75:a8:8a:31,218475831,244,45980,218475587,218475831
2745,5,12,149,5745,-82,-96,14,d2:00:04:7e:2c:ab,218476951,244,876,218476707,218476951
2746,5,6,149,5745,-89,-96,7,54:e4:3a:ec:fb:65,218505279,360,27968,218504919,218505279
2747,5,12,149,5745,-63,-96,33,02:31:8a:29:26:f4,218506095,268,548,218505827,218506095
2748,5,12,149,5745,-55,-96,41,f2:da:61:dd:98:c5,218506595,268,232,218506327,218506595
2749,5,12,149,5745,-59,-96,37,3e:d1:9b:c7:a4:de,218509086,272,2219,218508814,218509086
2750,5,12,149,5745,-66,-96,30,5e:36:fe:bc:a2:fe,218510369,244,1039,218510125,218510369
2751,5,12,149,5745,-75,-96,21,9a:24:38:da:96:bb,218518719,272,8078,218518447,218518719
2752,5,12,149,5745,-75,-96,21,fa:44:8d:e1:c7:1b,218529467,244,10504,218529223,218529467
2753,5,12,149,5745,-80,-96,16,72:d1:72:1d:22:a1,218530064,256,341,218529808,218530064
2754,5,12,149,5745,-73,-96,23,56:68:e2:c2:8d:d5,218531578,280,1234,218531298,218531578
2755,5,12,149,5745,-49,-96,47,5e:29:73:5b:30:00,218532795,272,945,218532523,218532795
2756,5,6,149,5745,-75,-96,21,,218543347,52,10500,218543295,218543347
2757,5,6,149,5745,-90,-96,6,,218543415,44,24,218543371,218543415
2758,5,12,149,5745,-78,-96,18,fa:44:8d:e1:c7:1b,218578167,244,34508,218577923,218578167
2759,5,12,149,5745,-82,-96,14,d2:00:04:7e:2c:ab,218589561,244,11150,218589317,218589561
2760,5,12,149,5745,-74,-96,22,22:ec:75:a8:8a:31,218590636,244,831,218590392,218590636
2761,5,12,149,5745,-73,-96,23,56:68:e2:c2:8d:d5,218595216,280,4300,218594936,218595216
2762,5,12,149,5745,-53,-96,43,72:fd:09:2f:da:5f,218604885,284,9385,218604601,218604885
2763,5,6,149,5745,-89,-96,7,54:e4:3a:ec:fb:65,218607680,360,2435,218607320,218607680
2764,5,12,149,5745,-64,-96,32,02:31:8a:29:26:f4,218608155,268,207,218607887,218608155
2765,5,12,149,5745,-55,-96,41,f2:da:61:dd:98:c5,218608673,268,250,218608405,218608673
2766,5,12,149,5745,-53,-96,43,72:fd:09:2f:da:5f,218613286,284,4329,218613002,218613286
2767,5,12,149,5745,-65,-96,31,5e:36:fe:bc:a2:fe,218619910,244,6380,218619666,218619910
2768,5,12,149,5745,-80,-96,16,72:d1:72:1d:22:a1,218622489,256,2323,218622233,218622489
2769,5,12,149,5745,-77,-96,19,9a:24:38:da:96:bb,218629791,272,7030,218629519,218629791
2770,5,12,149,5745,-59,-96,37,3e:d1:9b:c7:a4:de,218645532,272,15469,218645260,218645532
2771,5,12,149,5745,-55,-96,41,72:fd:09:2f:da:5f,218647116,480,1104,218646636,218647116
2772,5,12,149,5745,-80,-96,16,72:d1:72:1d:22:a1,218651401,452,3833,218650949,218651401
2773,5,12,149,5745,-64,-96,32,02:31:8a:29:26:f4,218652744,268,1075,218652476,218652744
2774,5,12,149,5745,-65,-96,31,5e:36:fe:bc:a2:fe,218653091,440,-93,218652651,218653091
2775,5,12,149,5745,-54,-96,42,f2:da:61:dd:98:c5,218655528,268,2169,218655260,218655528
2776,5,12,149,5745,-79,-96,17,fa:44:8d:e1:c7:1b,218656317,440,349,218655877,218656317
2777,5,12,149,5745,-74,-96,22,56:68:e2:c2:8d:d5,218656800,476,7,218656324,218656800
2778,5,12,149,5745,-74,-96,22,a6:92:ad:b7:76:65,218661727,456,4471,218661271,218661727
2779,5,12,149,5745,-74,-96,22,22:ec:75:a8:8a:31,218662226,516,-17,218661710,218662226
2780,5,12,149,5745,-59,-96,37,3e:d1:9b:c7:a4:de,218662821,544,51,218662277,218662821
2781,5,12,149,5745,-49,-96,47,5e:29:73:5b:30:00,218663426,272,333,218663154,218663426
2782,5,12,149,5745,-49,-96,47,5e:29:73:5b:30:00,218666466,540,2500,218665926,218666466
2783,5,12,149,5745,-79,-96,17,fa:44:8d:e1:c7:1b,218676409,244,9699,218676165,218676409
2784,5,12,149,5745,-55,-96,41,f2:da:61:dd:98:c5,218679054,268,2377,218678786,218679054
2785,5,24,149,5745,-89,-96,7,,218694382,28,15300,218694354,218694382
2786,5,24,149,5745,-89,-96,7,,218694491,32,77,218694459,218694491
2787,5,12,149,5745,-64,-96,32,02:31:8a:29:26:f4,218695161,268,402,218694893,218695161
2788,5,12,149,5745,-74,-96,22,56:68:e2:c2:8d:d5,218695566,280,125,218695286,218695566
2789,5,6,149,5745,-88,-96,8,e6:32:ea:f2:3d:18,218704587,108,8913,218704479,218704587
2790,5,6,149,5745,-88,-96,8,54:e4:3a:ec:fb:65,218704843,352,-96,218704491,218704843
2791,5,6,149,5745,-87,-96,9,,218705213,44,326,218705169,218705213
2792,5,12,149,5745,-74,-96,22,22:ec:75:a8:8a:31,218706034,244,577,218705790,218706034
2793,5,6,149,5745,-87,-96,9,54:e4:3a:ec:fb:65,218710080,360,3686,218709720,218710080
2794,5,12,149,5745,-65,-96,31,5e:36:fe:bc:a2:fe,218718243,440,7723,218717803,218718243
2795,5,12,149,5745,-64,-96,32,02:31:8a:29:26:f4,218718719,268,208,218718451,218718719
2796,5,6,149,5745,-86,-96,10,e6:32:ea:f2:3d:18,218724639,108,5812,218724531,218724639
2797,5,6,149,5745,-87,-96,9,54:e4:3a:ec:fb:65,218724928,352,-63,218724576,218724928
2798,5,12,149,5745,-65,-96,31,5e:36:fe:bc:a2:fe,218725408,244,236,218725164,218725408
2799,5,6,149,5745,-87,-96,9,54:e4:3a:ec:fb:65,218726159,352,399,218725807,218726159
2800,5,6,149,5745,-86,-96,10,,218726530,44,327,218726486,218726530
2801,5,6,149,5745,-87,-96,9,54:e4:3a:ec:fb:65,218726714,352,-168,218726362,218726714
2802,5,12,149,5745,-74,-96,22,a6:92:ad:b7:76:65,218732754,456,5584,218732298,218732754
2803,5,12,149,5745,-71,-96,25,f6:0a:5c:59:72:df,218734128,252,1122,218733876,218734128
2804,5,12,149,5745,-81,-96,15,72:d1:72:1d:22:a1,218735719,256,1335,218735463,218735719
2805,5,24,149,5745,-88,-96,8,,218741851,32,6100,218741819,218741851
2806,5,12,149,5745,-58,-96,38,3e:d1:9b:c7:a4:de,218742579,272,456,218742307,218742579
2807,5,12,149,5745,-53,-96,43,72:fd:09:2f:da:5f,218749489,284,6626,218749205,218749489
2808,5,12,149,5745,-73,-96,23,a6:92:ad:b7:76:65,218759653,256,9908,218759397,218759653
2809,5,12,149,5745,-75,-96,21,9a:24:38:da:96:bb,218764356,272,4431,218764084,218764356
2810,5,12,149,5745,-52,-96,44,5e:29:73:5b:30:00,218777857,272,13229,218777585,218777857
2811,5,12,149,5745,-81,-96,15,d2:00:04:7e:2c:ab,218779225,440,928,218778785,218779225
2812,5,12,149,5745,-66,-96,30,5e:36:fe:bc:a2:fe,218784001,440,4336,218783561,218784001
2813,5,12,149,5745,-68,-96,28,02:31:8a:29:26:f4,218784485,268,216,218784217,218784485
2814,5,12,149,5745,-64,-96,32,0a:b9:b7:b1:4d:fa,218785409,268,656,218785141,218785409
2815,5,12,149,5745,-79,-96,17,fa:44:8d:e1:c7:1b,218788423,440,2574,218787983,218788423
2816,5,12,149,5745,-54,-96,42,f2:da:61:dd:98:c5,218788915,268,224,218788647,218788915
2817,5,12,149,5745,-79,-96,17,fa:44:8d:e1:c7:1b,218791049,244,1890,218790805,218791049
2818,5,12,149,5745,-75,-96,21,9a:24:38:da:96:bb,218791665,824,-208,218790841,218791665
2819,5,12,149,5745,-54,-96,42,f2:da:61:dd:98:c5,218793576,268,1643,218793308,218793576
2820,5,12,149,5745,-74,-96,22,22:ec:75:a8:8a:31,218793951,516,-141,218793435,218793951
2821,5,12,149,5745,-58,-96,38,3e:d1:9b:c7:a4:de,218795118,544,623,218794574,218795118
2822,5,12,149,5745,-53,-96,43,5e:29:73:5b:30:00,218795732,540,74,218795192,218795732
2823,5,12,149,5745,-73,-96,23,a6:92:ad:b7:76:65,218798700,456,2512,218798244,218798700
2824,5,12,149,5745,-69,-96,27,02:31:8a:29:26:f4,218809469,268,10501,218809201,218809469
2825,5,6,149,5745,-86,-96,10,54:e4:3a:ec:fb:65,218812480,360,2651,218812120,218812480
2826,5,12,149,5745,-74,-96,22,22:ec:75:a8:8a:31,218824469,244,11745,218824225,218824469
2827,5,12,149,5745,-76,-96,20,56:68:e2:c2:8d:d5,218839282,280,14533,218839002,218839282
2828,5,12,149,5745,-72,-96,24,f6:0a:5c:59:72:df,218843013,252,3479,218842761,218843013
2829,5,12,149,5745,-82,-96,14,72:d1:72:1d:22:a1,218848840,256,5571,218848584,218848840
2830,5,12,149,5745,-67,-96,29,5e:36:fe:bc:a2:fe,218852878,244,3794,218852634,218852878
2831,5,12,149,5745,-75,-96,21,9a:24:38:da:96:bb,218854525,272,1375,218854253,218854525
2832,5,12,149,5745,-60,-96,36,3e:d1:9b:c7:a4:de,218859820,272,5023,218859548,218859820
2833,5,12,149,5745,-53,-96,43,5e:29:73:5b:30:00,218874498,272,14406,218874226,218874498
2834,5,12,149,5745,-73,-96,23,a6:92:ad:b7:76:65,218878953,256,4199,218878697,218878953
2835,5,12,149,5745,-55,-96,41,72:fd:09:2f:da:5f,218910786,284,31549,218910502,218910786
2836,5,12,149,5745,-81,-96,15,fa:44:8d:e1:c7:1b,218912344,244,1314,218912100,218912344
2837,5,6,149,5745,-86,-96,10,54:e4:3a:ec:fb:65,218914881,360,2177,218914521,218914881
2838,5,12,149,5745,-57,-96,39,f2:da:61:dd:98:c5,218916978,268,1829,218916710,218916978
2839,5,12,149,5745,-67,-96,29,02:31:8a:29:26:f4,218925680,268,8434,218925412,218925680
2840,5,12,149,5745,-77,-96,19,22:ec:75:a8:8a:31,218935466,244,9542,218935222,218935466
2841,5,12,149,5745,-78,-96,18,56:68:e2:c2:8d:d5,218941665,280,5919,218941385,218941665
2842,5,12,149,5745,-71,-96,25,9a:24:38:da:96:bb,218970652,272,28715,218970380,218970652
2843,5,12,149,5745,-60,-96,36,3e:d1:9b:c7:a4:de,218976799,272,5875,218976527,218976799
2844,5,12,149,5745,-50,-96,46,5e:29:73:5b:30:00,218992187,272,15116,218991915,218992187
2845,5,12,149,5745,-56,-96,40,72:fd:09:2f:da:5f,219013446,284,20975,219013162,219013446
2846,5,12,149,5745,-63,-96,33,5e:36:fe:bc:a2:fe,219016249,244,2559,219016005,219016249
2847,5,6,149,5745,-86,-96,10,54:e4:3a:ec:fb:65,219017282,360,673,219016922,219017282
2848,5,12,149,5745,-60,-96,36,f2:da:61:dd:98:c5,219029335,268,11785,219029067,219029335
2849,5,12,149,5745,-70,-96,26,02:31:8a:29:26:f4,219033998,268,4395,219033730,219033998
2850,5,12,149,5745,-73,-96,23,a6:92:ad:b7:76:65,219040497,256,6243,219040241,219040497
2851,5,12,149,5745,-81,-96,15,fa:44:8d:e1:c7:1b,219041490,244,749,219041246,219041490
2852,5,12,149,5745,-83,-96,13,72:d1:72:1d:22:a1,219042039,256,293,219041783,219042039
2853,5,12,149,5745,-79,-96,17,56:68:e2:c2:8d:d5,219044031,280,1712,219043751,219044031
2854,5,12,149,5745,-77,-96,19,22:ec:75:a8:8a:31,219052525,244,8250,219052281,219052525
2855,5,12,149,5745,-71,-96,25,9a:24:38:da:96:bb,219078785,272,25988,219078513,219078785
2856,5,12,149,5745,-60,-96,36,3e:d1:9b:c7:a4:de,219093995,272,14938,219093723,219093995
2857,5,12,149,5745,-52,-96,44,5e:29:73:5b:30:00,219106757,272,12490,219106485,219106757
2858,5,12,149,5745,-55,-96,41,72:fd:09:2f:da:5f,219115002,284,7961,219114718,219115002
2859,5,12,149,5745,-67,-96,29,5e:36:fe:bc:a2:fe,219119314,244,4068,219119070,219119314
2860,5,6,149,5745,-87,-96,9,54:e4:3a:ec:fb:65,219119682,360,8,219119322,219119682
2861,5,12,149,5745,-72,-96,24,a6:92:ad:b7:76:65,219142900,256,22962,219142644,219142900
2862,5,12,149,5745,-83,-96,13,72:d1:72:1d:22:a1,219143908,256,752,219143652,219143908
2863,5,12,149,5745,-77,-96,19,fa:44:8d:e1:c7:1b,219144288,244,136,219144044,219144288
2864,5,12,149,5745,-69,-96,27,02:31:8a:29:26:f4,219152011,268,7455,219151743,219152011
2865,5,12,149,5745,-58,-96,38,f2:da:61:dd:98:c5,219152664,268,385,219152396,219152664
2866,5,12,149,5745,-81,-96,15,56:68:e2:c2:8d:d5,219160698,280,7754,219160418,219160698
2867,5,6,149,5745,-76,-96,20,,219163404,52,2654,219163352,219163404
2868,5,6,149,5745,-92,-96,4,,219163472,44,24,219163428,219163472
2869,5,12,149,5745,-75,-96,21,22:ec:75:a8:8a:31,219164349,244,633,219164105,219164349
2870,5,12,149,5745,-83,-96,13,72:d1:72:1d:22:a1,219186720,256,22115,219186464,219186720
2871,5,12,149,5745,-69,-96,27,5e:36:fe:bc:a2:fe,219190696,244,3732,219190452,219190696
2872,5,12,149,5745,-59,-96,37,3e:d1:9b:c7:a4:de,219205819,272,14851,219205547,219205819
2873,5,12,149,5745,-71,-96,25,a6:92:ad:b7:76:65,219218532,256,12457,219218276,219218532
2874,5,6,149,5745,-89,-96,7,54:e4:3a:ec:fb:65,219222083,360,3191,219221723,219222083
2875,5,12,149,5745,-56,-96,40,72:fd:09:2f:da:5f,219222538,284,171,219222254,219222538
2876,5,12,149,5745,-55,-96,41,5e:29:73:5b:30:00,219236626,272,13816,219236354,219236626
2877,5,12,149,5745,-56,-96,40,72:fd:09:2f:da:5f,219237653,480,547,219237173,219237653
2878,5,12,149,5745,-70,-96,26,5e:36:fe:bc:a2:fe,219243045,440,4952,219242605,219243045
2879,5,12,149,5745,-81,-96,15,56:68:e2:c2:8d:d5,219245472,476,1951,219244996,219245472
2880,5,12,149,5745,-74,-96,22,02:31:8a:29:26:f4,219246181,268,441,219245913,219246181
2881,5,12,149,5745,-77,-96,19,fa:44:8d:e1:c7:1b,219247826,440,1205,219247386,219247826
2882,5,12,149,5745,-55,-96,41,f2:da:61:dd:98:c5,219248579,268,485,219248311,219248579
2883,5,12,149,5745,-75,-96,21,22:ec:75:a8:8a:31,219250069,516,974,219249553,219250069
2884,5,12,149,5745,-78,-96,18,fa:44:8d:e1:c7:1b,219250656,244,343,219250412,219250656
2885,5,12,149,5745,-75,-96,21,f6:0a:5c:59:72:df,219250970,252,62,219250718,219250970
2886,5,12,149,5745,-60,-96,36,3e:d1:9b:c7:a4:de,219251302,544,-212,219250758,219251302
2887,5,12,149,5745,-81,-96,15,56:68:e2:c2:8d:d5,219251880,280,298,219251600,219251880
2888,5,12,149,5745,-74,-96,22,02:31:8a:29:26:f4,219252223,268,75,219251955,219252223
2889,5,12,149,5745,-55,-96,41,f2:da:61:dd:98:c5,219252759,268,268,219252491,219252759
2890,5,12,149,5745,-82,-96,14,72:d1:72:1d:22:a1,219253961,452,750,219253509,219253961
2891,5,12,149,5745,-55,-96,41,5e:29:73:5b:30:00,219255265,540,764,219254725,219255265
2892,5,12,149,5745,-71,-96,25,a6:92:ad:b7:76:65,219257072,456,1351,219256616,219257072
2893,5,12,149,5745,-75,-96,21,f6:0a:5c:59:72:df,219285705,252,28381,219285453,219285705
2894,5,12,149,5745,-81,-96,15,72:d1:72:1d:22:a1,219286334,256,373,219286078,219286334
2895,5,12,149,5745,-70,-96,26,5e:36:fe:bc:a2:fe,219299620,244,13042,219299376,219299620
2896,5,12,149,5745,-75,-96,21,22:ec:75:a8:8a:31,219300147,244,283,219299903,219300147
2897,5,12,149,5745,-58,-96,38,72:fd:09:2f:da:5f,219301148,480,521,219300668,219301148
2898,5,12,149,5745,-58,-96,38,72:fd:09:2f:da:5f,219301645,284,213,219301361,219301645
2899,5,12,149,5745,-74,-96,22,9a:24:38:da:96:bb,219302137,272,220,219301865,219302137
2900,5,12,149,5745,-83,-96,13,d2:00:04:7e:2c:ab,219304981,412,2432,219304569,219304981
2901,5,12,149,5745,-77,-96,19,f6:0a:5c:59:72:df,219306315,132,1202,219306183,219306315
2902,5,12,149,5745,-82,-96,14,56:68:e2:c2:8d:d5,219308074,476,1283,219307598,219308074
2903,5,12,149,5745,-75,-96,21,02:31:8a:29:26:f4,219308594,268,252,219308326,219308594
2904,5,12,149,5745,-70,-96,26,5e:36:fe:bc:a2:fe,219308923,440,-111,219308483,219308923
2905,5,12,149,5745,-64,-96,32,0a:b9:b7:b1:4d:fa,219309848,268,657,219309580,219309848
2906,5,12,149,5745,-56,-96,40,f2:da:61:dd:98:c5,219311024,268,908,219310756,219311024
2907,5,12,149,5745,-79,-96,17,fa:44:8d:e1:c7:1b,219311335,440,-129,219310895,219311335
2908,5,12,149,5745,-75,-96,21,22:ec:75:a8:8a:31,219314766,516,2915,219314250,219314766
2909,5,12,149,5745,-60,-96,36,3e:d1:9b:c7:a4:de,219316260,544,950,219315716,219316260
2910,5,12,149,5745,-79,-96,17,72:d1:72:1d:22:a1,219316840,452,128,219316388,219316840
2911,5,12,149,5745,-70,-96,26,a6:92:ad:b7:76:65,219317326,256,230,219317070,219317326
2912,5,12,149,5745,-56,-96,40,5e:29:73:5b:30:00,219319722,540,1856,219319182,219319722
2913,5,12,149,5745,-82,-96,14,d2:00:04:7e:2c:ab,219320318,152,444,219320166,219320318
2914,5,12,149,5745,-70,-96,26,a6:92:ad:b7:76:65,219322970,456,2196,219322514,219322970
2915,5,6,149,5745,-88,-96,8,54:e4:3a:ec:fb:65,219324483,360,1153,219324123,219324483
2916,5,12,149,5745,-61,-96,35,3e:d1:9b:c7:a4:de,219333628,272,8873,219333356,219333628
2917,5,12,149,5745,-82,-96,14,fa:44:8d:e1:c7:1b,219348652,244,14780,219348408,219348652
2918,5,12,149,5745,-56,-96,40,5e:29:73:5b:30:00,219352178,272,3254,219351906,219352178
2919,5,12,149,5745,-54,-96,42,f2:da:61:dd:98:c5,219378256,268,25810,219377988,219378256
2920,5,12,149,5745,-76,-96,20,02:31:8a:29:26:f4,219381177,268,2653,219380909,219381177
2921,5,12,149,5745,-81,-96,15,56:68:e2:c2:8d:d5,219385463,280,4006,219385183,219385463
2922,5,12,149,5745,-76,-96,20,22:ec:75:a8:8a:31,219391258,244,5551,219391014,219391258
2923,5,12,149,5745,-79,-96,17,72:d1:72:1d:22:a1,219411998,256,20484,219411742,219411998
2924,5,12,149,5745,-76,-96,20,9a:24:38:da:96:bb,219414378,272,2108,219414106,219414378
2925,5,12,149,5745,-67,-96,29,5e:36:fe:bc:a2:fe,219416422,244,1800,219416178,219416422
2926,5,12,149,5745,-56,-96,40,72:fd:09:2f:da:5f,219422751,284,6045,219422467,219422751
2927,5,6,149,5745,-88,-96,8,54:e4:3a:ec:fb:65,219426884,360,3773,219426524,219426884
2928,5,12,149,5745,-61,-96,35,3e:d1:9b:c7:a4:de,219434766,272,7610,219434494,219434766
2929,5,12,149,5745,-72,-96,24,a6:92:ad:b7:76:65,219442617,256,7595,219442361,219442617
2930,5,12,149,5745,-52,-96,44,5e:29:73:5b:30:00,219449186,272,6297,219448914,219449186
2931,5,12,149,5745,-81,-96,15,22:ec:75:a8:8a:31,219507657,244,58227,219507413,219507657
2932,5,12,149,5745,-67,-96,29,5e:36:fe:bc:a2:fe,219529063,244,21162,219528819,219529063
2933,5,6,149,5745,-89,-96,7,54:e4:3a:ec:fb:65,219529339,360,-84,219528979,219529339
2934,5,12,149,5745,-55,-96,41,f2:da:61:dd:98:c5,219529771,268,164,219529503,219529771
2935,5,12,149,5745,-75,-96,21,02:31:8a:29:26:f4,219530182,268,143,219529914,219530182
2936,5,12,149,5745,-53,-96,43,72:fd:09:2f:da:5f,219534183,284,3717,219533899,219534183
2937,5,12,149,5745,-62,-96,34,3e:d1:9b:c7:a4:de,219552520,272,18065,219552248,219552520
2938,5,12,149,5745,-79,-96,17,fa:44:8d:e1:c7:1b,219553880,244,1116,219553636,219553880
2939,5,12,149,5745,-81,-96,15,72:d1:72:1d:22:a1,219554376,256,240,219554120,219554376
2940,5,12,149,5745,-73,-96,23,a6:92:ad:b7:76:65,219556151,256,1519,219555895,219556151
2941,5,6,149,5745,-75,-96,21,,219557728,52,1525,219557676,219557728
2942,5,12,149,5745,-82,-96,14,56:68:e2:c2:8d:d5,219559269,280,1261,219558989,219559269
2943,5,12,149,5745,-52,-96,44,5e:29:73:5b:30:00,219565851,272,6310,219565579,219565851
2944,5,12,149,5745,-76,-96,20,22:ec:75:a8:8a:31,219625405,244,59310,219625161,219625405
2945,5,6,149,5745,-89,-96,7,54:e4:3a:ec:fb:65,219631685,360,5920,219631325,219631685
2946,5,12,149,5745,-71,-96,25,02:31:8a:29:26:f4,219632220,268,267,219631952,219632220
2947,5,12,149,5745,-59,-96,37,f2:da:61:dd:98:c5,219632521,268,33,219632253,219632521
2948,5,12,149,5745,-74,-96,22,f6:0a:5c:59:72:df,219641793,252,9020,219641541,219641793
2949,5,12,149,5745,-54,-96,42,72:fd:09:2f:da:5f,219644318,284,2241,219644034,219644318
2950,5,12,149,5745,-77,-96,19,fa:44:8d:e1:c7:1b,219656274,244,11712,219656030,219656274
2951,5,12,149,5745,-81,-96,15,72:d1:72:1d:22:a1,219656715,256,185,219656459,219656715
2952,5,12,149,5745,-78,-96,18,56:68:e2:c2:8d:d5,219658472,280,1477,219658192,219658472
2953,5,12,149,5745,-72,-96,24,a6:92:ad:b7:76:65,219667075,256,8347,219666819,219667075
2954,5,12,149,5745,-59,-96,37,3e:d1:9b:c7:a4:de,219669520,272,2173,219669248,219669520
2955,5,12,149,5745,-76,-96,20,fa:44:8d:e1:c7:1b,219692117,244,22353,219691873,219692117
2956,5,12,149,5745,-57,-96,39,f2:da:61:dd:98:c5,219694564,268,2179,219694296,219694564
2957,5,12,149,5745,-50,-96,46,5e:29:73:5b:30:00,219695424,272,588,219695152,219695424
2958,5,12,149,5745,-51,-96,45,72:fd:09:2f:da:5f,219698845,480,2941,219698365,219698845
2959,5,12,149,5745,-75,-96,21,f6:0a:5c:59:72:df,219700617,132,1640,219700485,219700617
2960,5,12,149,5745,-69,-96,27,5e:36:fe:bc:a2:fe,219702016,440,959,219701576,219702016
2961,5,12,149,5745,-81,-96,15,56:68:e2:c2:8d:d5,219703045,476,553,219702569,219703045
2962,5,12,149,5745,-69,-96,27,02:31:8a:29:26:f4,219703565,268,252,219703297,219703565
2963,5,12,149,5745,-73,-96,23,fa:44:8d:e1:c7:1b,219703896,440,-109,219703456,219703896
2964,5,12,149,5745,-56,-96,40,f2:da:61:dd:98:c5,219706235,268,2071,219705967,219706235
2965,5,12,149,5745,-74,-96,22,f6:0a:5c:59:72:df,219709823,252,3336,219709571,219709823
2966,5,12,149,5745,-69,-96,27,02:31:8a:29:26:f4,219711302,268,1211,219711034,219711302
2967,5,12,149,5745,-63,-96,33,3e:d1:9b:c7:a4:de,219711731,544,-115,219711187,219711731
2968,5,12,149,5745,-48,-96,48,5e:29:73:5b:30:00,219714658,540,2387,219714118,219714658
2969,5,6,149,5745,-89,-96,7,54:e4:3a:ec:fb:65,219734085,360,19067,219733725,219734085
2970,5,12,149,5745,-74,-96,22,f6:0a:5c:59:72:df,219739784,252,5447,219739532,219739784
2971,5,12,149,5745,-69,-96,27,5e:36:fe:bc:a2:fe,219741523,244,1495,219741279,219741523
2972,5,12,149,5745,-81,-96,15,72:d1:72:1d:22:a1,219744692,256,2913,219744436,219744692
2973,5,12,149,5745,-54,-96,42,72:fd:09:2f:da:5f,219744991,284,15,219744707,219744991
2974,5,12,149,5745,-75,-96,21,9a:24:38:da:96:bb,219750993,272,5730,219750721,219750993
2975,5,12,149,5745,-74,-96,22,22:ec:75:a8:8a:31,219757540,244,6303,219757296,219757540
2976,5,12,149,5745,-68,-96,28,5e:36:fe:bc:a2:fe,219767100,440,9120,219766660,219767100
2977,5,12,149,5745,-72,-96,24,02:31:8a:29:26:f4,219767575,268,207,219767307,219767575
2978,5,12,149,5745,-74,-96,22,22:ec:75:a8:8a:31,219769507,516,1416,219768991,219769507
2979,5,12,149,5745,-64,-96,32,3e:d1:9b:c7:a4:de,219786666,272,16887,219786394,219786666
2980,5,12,149,5745,-49,-96,47,5e:29:73:5b:30:00,219795182,272,8244,219794910,219795182
2981,5,12,149,5745,-77,-96,19,fa:44:8d:e1:c7:1b,219809627,244,14201,219809383,219809627
2982,5,12,149,5745,-53,-96,43,f2:da:61:dd:98:c5,219811725,268,1830,219811457,219811725
2983,5,12,149,5745,-73,-96,23,02:31:8a:29:26:f4,219825212,268,13219,219824944,219825212
2984,5,12,149,5745,-68,-96,28,5e:36:fe:bc:a2:fe,219832606,440,6954,219832166,219832606
2985,5,12,149,5745,-73,-96,23,02:31:8a:29:26:f4,219833298,268,424,219833030,219833298
2986,5,12,149,5745,-78,-96,18,56:68:e2:c2:8d:d5,219833654,280,76,219833374,219833654
2987,5,12,149,5745,-75,-96,21,22:ec:75:a8:8a:31,219835058,516,888,219834542,219835058
2988,5,12,149,5745,-70,-96,26,0a:b9:b7:b1:4d:fa,219835617,268,291,219835349,219835617
2989,5,12,149,5745,-75,-96,21,a6:92:ad:b7:76:65,219836046,456,-27,219835590,219836046
2990,5,12,149,5745,-76,-96,20,fa:44:8d:e1:c7:1b,219836942,440,456,219836502,219836942
2991,5,12,149,5745,-78,-96,18,9a:24:38:da:96:bb,219841060,824,3294,219840236,219841060
2992,5,12,149,5745,-61,-96,35,3e:d1:9b:c7:a4:de,219842016,544,412,219841472,219842016
2993,5,12,149,5745,-51,-96,45,5e:29:73:5b:30:00,219846653,540,4097,219846113,219846653
2994,5,12,149,5745,-51,-96,45,f2:da:61:dd:98:c5,219847264,268,343,219846996,219847264
2995,5,12,149,5745,-68,-96,28,5e:36:fe:bc:a2:fe,219855790,244,8282,219855546,219855790
2996,5,12,149,5745,-78,-96,18,22:ec:75:a8:8a:31,219856122,244,88,219855878,219856122
2997,5,12,149,5745,-80,-96,16,72:d1:72:1d:22:a1,219866521,256,10143,219866265,219866521
2998,5,12,149,5745,-76,-96,20,22:ec:75:a8:8a:31,219901129,516,34092,219900613,219901129
2999,5,12,149,5745,-60,-96,36,3e:d1:9b:c7:a4:de,219902335,272,934,219902063,219902335
3000,5,12,149,5745,-55,-96,41,f2:da:61:dd:98:c5,219910725,268,8122,219910457,219910725
3001,5,12,149,5745,-51,-96,45,5e:29:73:5b:30:00,219912237,272,1240,219911965,219912237
3002,5,6,149,5745,-77,-96,19,,219914687,52,2398,219914635,219914687
3003,5,12,149,5745,-57,-96,39,f2:da:61:dd:98:c5,219923971,268,9016,219923703,219923971
3004,5,12,149,5745,-71,-96,25,fa:44:8d:e1:c7:1b,219928944,244,4729,219928700,219928944
3005,5,12,149,5745,-51,-96,45,72:fd:09:2f:da:5f,219935446,284,6218,219935162,219935446
3006,5,6,149,5745,-89,-96,7,54:e4:3a:ec:fb:65,219938886,360,3080,219938526,219938886
3007,5,12,149,5745,-71,-96,25,02:31:8a:29:26:f4,219945601,268,6447,219945333,219945601
3008,5,12,149,5745,-82,-96,14,56:68:e2:c2:8d:d5,219963812,280,17931,219963532,219963812
3009,5,12,149,5745,-74,-96,22,22:ec:75:a8:8a:31,219966232,516,1904,219965716,219966232
3010,5,12,149,5745,-74,-96,22,22:ec:75:a8:8a:31,219970553,244,4077,219970309,219970553
3011,5,12,149,5745,-85,-96,11,72:d1:72:1d:22:a1,219975104,256,4295,219974848,219975104
3012,5,6,149,5745,-77,-96,19,,219975564,52,408,219975512,219975564
3013,5,12,149,5745,-74,-96,22,9a:24:38:da:96:bb,219975769,272,-67,219975497,219975769
3014,5,12,149,5745,-57,-96,39,f2:da:61:dd:98:c5,219976330,268,293,219976062,219976330
3015,5,6,149,5745,-77,-96,19,,219988058,52,11676,219988006,219988058
3016,5,6,149,5745,-92,-96,4,,219988126,44,24,219988082,219988126
3017,5,12,149,5745,-61,-96,35,3e:d1:9b:c7:a4:de,220017383,272,28985,220017111,220017383
3018,5,12,149,5745,-47,-96,49,5e:29:73:5b:30:00,220028725,272,11070,220028453,220028725
3019,5,12,149,5745,-76,-96,20,22:ec:75:a8:8a:31,220032206,516,2965,220031690,220032206
3020,5,12,149,5745,-50,-96,46,72:fd:09:2f:da:5f,220036765,284,4275,220036481,220036765
3021,5,12,149,5745,-56,-96,40,f2:da:61:dd:98:c5,220038713,268,1680,220038445,220038713
3022,5,12,149,5745,-67,-96,29,5e:36:fe:bc:a2:fe,220040707,244,1750,220040463,220040707
3023,5,6,149,5745,-88,-96,8,54:e4:3a:ec:fb:65,220041287,360,220,220040927,220041287
3024,5,12,149,5745,-56,-96,40,f2:da:61:dd:98:c5,220041954,268,399,220041686,220041954
3025,5,12,149,5745,-68,-96,28,02:31:8a:29:26:f4,220054019,268,11797,220053751,220054019
3026,5,12,149,5745,-70,-96,26,fa:44:8d:e1:c7:1b,220066087,244,11824,220065843,220066087
3027,5,12,149,5745,-81,-96,15,56:68:e2:c2:8d:d5,220068020,280,1653,220067740,220068020
3028,5,12,149,5745,-75,-96,21,22:ec:75:a8:8a:31,220077644,244,9380,220077400,220077644
3029,5,12,149,5745,-72,-96,24,9a:24:38:da:96:bb,220091100,272,13184,220090828,220091100
3030,5,12,149,5745,-73,-96,23,f6:0a:5c:59:72:df,220097126,252,5774,220096874,220097126
3031,5,12,149,5745,-60,-96,36,3e:d1:9b:c7:a4:de,220133856,272,36458,220133584,220133856
3032,5,12,149,5745,-53,-96,43,72:fd:09:2f:da:5f,220139892,284,5752,220139608,220139892
3033,5,12,149,5745,-68,-96,28,5e:36:fe:bc:a2:fe,220143058,244,2922,220142814,220143058
3034,5,6,149,5745,-87,-96,9,54:e4:3a:ec:fb:65,220143688,360,270,220143328,220143688
3035,5,12,149,5745,-50,-96,46,5e:29:73:5b:30:00,220146319,272,2359,220146047,220146319
3036,5,12,149,5745,-58,-96,38,f2:da:61:dd:98:c5,220156654,268,10067,220156386,220156654
3037,5,12,149,5745,-78,-96,18,fa:44:8d:e1:c7:1b,220168374,244,11476,220168130,220168374
3038,5,12,149,5745,-80,-96,16,56:68:e2:c2:8d:d5,220168749,280,95,220168469,220168749
3039,5,12,149,5745,-80,-96,16,72:d1:72:1d:22:a1,220169058,256,53,220168802,220169058
3040,5,12,149,5745,-78,-96,18,22:ec:75:a8:8a:31,220194856,244,25554,220194612,220194856
3041,5,12,149,5745,-80,-96,16,72:d1:72:1d:22:a1,220202301,256,7189,220202045,220202301
3042,5,12,149,5745,-50,-96,46,72:fd:09:2f:da:5f,220242013,284,39428,220241729,220242013
3043,5,12,149,5745,-60,-96,36,3e:d1:9b:c7:a4:de,220245637,272,3352,220245365,220245637
3044,5,12,149,5745,-68,-96,28,02:31:8a:29:26:f4,220246014,268,109,220245746,220246014
3045,5,12,149,5745,-70,-96,26,5e:36:fe:bc:a2:fe,220246379,244,121,220246135,220246379
3046,5,12,149,5745,-50,-96,46,5e:29:73:5b:30:00,220258386,272,11735,220258114,220258386
3047,5,12,149,5745,-69,-96,27,02:31:8a:29:26:f4,220260107,268,1453,220259839,220260107
3048,5,12,149,5745,-59,-96,37,f2:da:61:dd:98:c5,220262587,268,2212,220262319,220262587
3049,5,12,149,5745,-75,-96,21,f6:0a:5c:59:72:df,220267079,252,4240,220266827,220267079
3050,5,12,149,5745,-76,-96,20,fa:44:8d:e1:c7:1b,220267754,244,431,220267510,220267754
3051,5,12,149,5745,-51,-96,45,72:fd:09:2f:da:5f,220283962,480,15728,220283482,220283962
3052,5,12,149,5745,-68,-96,28,5e:36:fe:bc:a2:fe,220291558,440,7156,220291118,220291558
3053,5,12,149,5745,-73,-96,23,02:31:8a:29:26:f4,220292275,268,449,220292007,220292275
3054,5,12,149,5745,-80,-96,16,56:68:e2:c2:8d:d5,220293911,476,1160,220293435,220293911
3055,5,12,149,5745,-79,-96,17,22:ec:75:a8:8a:31,220294440,516,13,220293924,220294440
3056,5,12,149,5745,-85,-96,11,d2:00:04:7e:2c:ab,220295028,412,176,220294616,220295028
3057,5,12,149,5745,-76,-96,20,fa:44:8d:e1:c7:1b,220295781,440,313,220295341,220295781
3058,5,12,149,5745,-62,-96,34,3e:d1:9b:c7:a4:de,220300270,544,3945,220299726,220300270
3059,5,12,149,5745,-74,-96,22,f6:0a:5c:59:72:df,220300902,252,380,220300650,220300902
3060,5,12,149,5745,-83,-96,13,72:d1:72:1d:22:a1,220302296,452,942,220301844,220302296
3061,5,12,149,5745,-51,-96,45,5e:29:73:5b:30:00,220303223,540,387,220302683,220303223
3062,5,12,149,5745,-56,-96,40,f2:da:61:dd:98:c5,220304771,268,1280,220304503,220304771
3063,5,12,149,5745,-75,-96,21,f6:0a:5c:59:72:df,220311895,252,6872,220311643,220311895
3064,5,12,149,5745,-74,-96,22,9a:24:38:da:96:bb,220312968,272,801,220312696,220312968
3065,5,12,149,5745,-69,-96,27,5e:36:fe:bc:a2:fe,220314566,244,1354,220314322,220314566
3066,5,12,149,5745,-77,-96,19,22:ec:75:a8:8a:31,220314853,244,43,220314609,220314853
3067,5,12,149,5745,-53,-96,43,72:fd:09:2f:da:5f,220317291,284,2154,220317007,220317291
3068,5,6,149,5745,-88,-96,8,54:e4:3a:ec:fb:65,220348489,360,30838,220348129,220348489
3069,5,12,149,5745,-53,-96,43,72:fd:09:2f:da:5f,220349173,480,204,220348693,220349173
3070,5,12,149,5745,-79,-96,17,56:68:e2:c2:8d:d5,220356680,476,7031,220356204,220356680
3071,5,12,149,5745,-73,-96,23,02:31:8a:29:26:f4,220357209,268,261,220356941,220357209
3072,5,12,149,5745,-71,-96,25,5e:36:fe:bc:a2:fe,220357556,440,-93,220357116,220357556
3073,5,12,149,5745,-69,-96,27,a6:92:ad:b7:76:65,220359326,456,1314,220358870,220359326
3074,5,12,149,5745,-74,-96,22,0a:b9:b7:b1:4d:fa,220359844,268,250,220359576,220359844
3075,5,12,149,5745,-69,-96,27,fa:44:8d:e1:c7:1b,220360146,440,-138,220359706,220360146
3076,5,12,149,5745,-76,-96,20,22:ec:75:a8:8a:31,220360620,516,-42,220360104,220360620
3077,5,12,149,5745,-76,-96,20,9a:24:38:da:96:bb,220363652,824,2208,220362828,220363652
3078,5,12,149,5745,-61,-96,35,3e:d1:9b:c7:a4:de,220364777,544,581,220364233,220364777
3079,5,12,149,5745,-76,-96,20,72:d1:72:1d:22:a1,220365401,452,172,220364949,220365401
3080,5,12,149,5745,-61,-96,35,3e:d1:9b:c7:a4:de,220365887,272,214,220365615,220365887
3081,5,12,149,5745,-52,-96,44,5e:29:73:5b:30:00,220368281,540,1854,220367741,220368281
3082,5,12,149,5745,-53,-96,43,f2:da:61:dd:98:c5,220369469,268,920,220369201,220369469
3083,5,12,149,5745,-68,-96,28,fa:44:8d:e1:c7:1b,220380204,244,10491,220379960,220380204
3084,5,12,149,5745,-77,-96,19,56:68:e2:c2:8d:d5,220382228,280,1744,220381948,220382228
3085,5,12,149,5745,-70,-96,26,02:31:8a:29:26:f4,220382570,268,74,220382302,220382570
3086,5,12,149,5745,-53,-96,43,f2:da:61:dd:98:c5,220382927,268,89,220382659,220382927
3087,5,12,149,5745,-53,-96,43,5e:29:73:5b:30:00,220383670,272,471,220383398,220383670
3088,5,12,149,5745,-79,-96,17,22:ec:75:a8:8a:31,220429314,244,45400,220429070,220429314
3089,5,12,149,5745,-79,-96,17,72:d1:72:1d:22:a1,220431703,256,2133,220431447,220431703
3090,5,12,149,5745,-72,-96,24,5e:36:fe:bc:a2:fe,220433329,244,1382,220433085,220433329
3091,5,12,149,5745,-75,-96,21,f6:0a:5c:59:72:df,220434554,252,973,220434302,220434554
3092,5,12,149,5745,-56,-96,40,72:fd:09:2f:da:5f,220434859,284,21,220434575,220434859
3093,5,12,149,5745,-55,-96,41,f2:da:61:dd:98:c5,220435178,268,51,220434910,220435178
3094,5,6,149,5745,-90,-96,6,54:e4:3a:ec:fb:65,220450889,360,15351,220450529,220450889
3095,5,12,149,5745,-59,-96,37,3e:d1:9b:c7:a4:de,220475397,272,24236,220475125,220475397
3096,5,12,149,5745,-54,-96,42,f2:da:61:dd:98:c5,220481005,268,5340,220480737,220481005
3097,5,12,149,5745,-53,-96,43,5e:29:73:5b:30:00,220487912,272,6635,220487640,220487912
3098,5,12,149,5745,-74,-96,22,fa:44:8d:e1:c7:1b,220488353,244,197,220488109,220488353
3099,5,12,149,5745,-79,-96,17,22:ec:75:a8:8a:31,220490611,516,1742,220490095,220490611
3100,5,12,149,5745,-55,-96,41,f2:da:61:dd:98:c5,220500448,268,9569,220500180,220500448
3101,5,12,149,5745,-73,-96,23,9a:24:38:da:96:bb,220540500,272,39780,220540228,220540500
3102,5,12,149,5745,-75,-96,21,22:ec:75:a8:8a:31,220543944,244,3200,220543700,220543944
3103,5,12,149,5745,-80,-96,16,72:d1:72:1d:22:a1,220544422,256,222,220544166,220544422
3104,5,12,149,5745,-55,-96,41,72:fd:09:2f:da:5f,220545664,284,958,220545380,220545664
3105,5,12,149,5745,-68,-96,28,5e:36:fe:bc:a2:fe,220552960,244,7052,220552716,220552960
3106,5,6,149,5745,-87,-96,9,54:e4:3a:ec:fb:65,220553289,360,-31,220552929,220553289
3107,5,12,149,5745,-66,-96,30,02:31:8a:29:26:f4,220553863,268,306,220553595,220553863
3108,5,12,149,5745,-73,-96,23,f6:0a:5c:59:72:df,220555616,252,1501,220555364,220555616
3109,5,12,149,5745,-74,-96,22,22:ec:75:a8:8a:31,220555956,516,-176,220555440,220555956
3110,5,12,149,5745,-51,-96,45,f2:da:61:dd:98:c5,220566064,268,9840,220565796,220566064
3111,5,6,149,5745,-79,-96,17,,220571291,52,5175,220571239,220571291
3112,5,6,149,5745,-90,-96,6,,220571360,44,25,220571316,220571360
3113,5,6,149,5745,-80,-96,16,,220571629,52,217,220571577,220571629
3114,5,6,149,5745,-89,-96,7,,220571697,44,24,220571653,220571697
3115,5,12,149,5745,-80,-96,16,56:68:e2:c2:8d:d5,220578506,280,6529,220578226,220578506
3116,5,12,149,5745,-64,-96,32,3e:d1:9b:c7:a4:de,220592532,272,13754,220592260,220592532
3117,5,12,149,5745,-50,-96,46,f2:da:61:dd:98:c5,220596242,268,3442,220595974,220596242
3118,5,12,149,5745,-48,-96,48,5e:29:73:5b:30:00,220600543,272,4029,220600271,220600543
3119,5,24,149,5745,-85,-96,11,,220649684,28,49113,220649656,220649684
3120,5,24,149,5745,-84,-96,12,,220649794,32,78,220649762,220649794
3121,5,12,149,5745,-76,-96,20,22:ec:75:a8:8a:31,220650149,244,111,220649905,220650149
3122,5,6,149,5745,-88,-96,8,54:e4:3a:ec:fb:65,220655690,360,5181,220655330,220655690
3123,5,12,149,5745,-66,-96,30,02:31:8a:29:26:f4,220656533,268,575,220656265,220656533
3124,5,12,149,5745,-51,-96,45,72:fd:09:2f:da:5f,220659553,284,2736,220659269,220659553
3125,5,12,149,5745,-72,-96,24,fa:44:8d:e1:c7:1b,220680257,244,20460,220680013,220680257
3126,5,12,149,5745,-59,-96,37,3e:d1:9b:c7:a4:de,220709939,272,29410,220709667,220709939
3127,5,12,149,5745,-54,-96,42,5e:29:73:5b:30:00,220717589,272,7378,220717317,220717589
3128,5,12,149,5745,-71,-96,25,fa:44:8d:e1:c7:1b,220721281,244,3448,220721037,220721281
3129,5,12,149,5745,-56,-96,40,f2:da:61:dd:98:c5,220721595,268,46,220721327,220721595
3130,5,12,149,5745,-63,-96,33,02:31:8a:29:26:f4,220727947,268,6084,220727679,220727947
3131,5,12,149,5745,-79,-96,17,56:68:e2:c2:8d:d5,220729302,280,1075,220729022,220729302
3132,5,24,149,5745,-87,-96,9,,220734753,28,5423,220734725,220734753
3133,5,24,149,5745,-86,-96,10,,220735081,32,296,220735049,220735081
3134,5,12,149,5745,-76,-96,20,f6:0a:5c:59:72:df,220739998,252,4665,220739746,220739998
3135,5,12,149,5745,-51,-96,45,72:fd:09:2f:da:5f,220746786,480,6308,220746306,220746786
3136,5,12,149,5745,-79,-96,17,56:68:e2:c2:8d:d5,220752385,476,5123,220751909,220752385
3137,5,12,149,5745,-73,-96,23,fa:44:8d:e1:c7:1b,220753122,440,297,220752682,220753122
3138,5,12,149,5745,-68,-96,28,5e:36:fe:bc:a2:fe,220753974,440,412,220753534,220753974
3139,5,12,149,5745,-76,-96,20,9a:24:38:da:96:bb,220757921,824,3123,220757097,220757921
3140,5,12,149,5745,-51,-96,45,72:fd:09:2f:da:5f,220759625,284,1420,220759341,220759625
3141,5,12,149,5745,-58,-96,38,3e:d1:9b:c7:a4:de,220760707,544,538,220760163,220760707
3142,5,12,149,5745,-51,-96,45,5e:29:73:5b:30:00,220764175,540,2928,220763635,220764175
3143,5,12,149,5745,-76,-96,20,f6:0a:5c:59:72:df,220766225,252,1798,220765973,220766225
3144,5,12,149,5745,-79,-96,17,22:ec:75:a8:8a:31,220766529,516,-212,220766013,220766529
3145,5,12,149,5745,-64,-96,32,02:31:8a:29:26:f4,220767080,268,283,220766812,220767080
3146,5,12,149,5745,-79,-96,17,22:ec:75:a8:8a:31,220773296,244,5972,220773052,220773296
3147,5,12,149,5745,-68,-96,28,5e:36:fe:bc:a2:fe,220775617,244,2077,220775373,220775617
3148,5,12,149,5745,-50,-96,46,f2:da:61:dd:98:c5,220778947,268,3062,220778679,220778947
3149,5,12,149,5745,-77,-96,19,f6:0a:5c:59:72:df,220805539,252,26340,220805287,220805539
3150,5,12,149,5745,-64,-96,32,02:31:8a:29:26:f4,220815676,268,9869,220815408,220815676
3151,5,12,149,5745,-59,-96,37,3e:d1:9b:c7:a4:de,220826638,272,10690,220826366,220826638
3152,5,12,149,5745,-57,-96,39,5e:29:73:5b:30:00,220834767,272,7857,220834495,220834767
3153,5,12,149,5745,-49,-96,47,f2:da:61:dd:98:c5,220835092,268,57,220834824,220835092
3154,5,12,149,5745,-72,-96,24,fa:44:8d:e1:c7:1b,220835675,244,339,220835431,220835675
3155,5,12,149,5745,-64,-96,32,02:31:8a:29:26:f4,220841031,268,5088,220840763,220841031
3156,5,12,149,5745,-79,-96,17,56:68:e2:c2:8d:d5,220845347,280,4036,220845067,220845347
3157,5,6,149,5745,-90,-96,6,54:e4:3a:ec:fb:65,220860491,360,14784,220860131,220860491
3158,5,12,149,5745,-80,-96,16,d2:00:04:7e:2c:ab,220862238,104,1643,220862134,220862238
3159,5,12,149,5745,-81,-96,15,d2:00:04:7e:2c:ab,220862396,380,-222,220862016,220862396
3160,5,12,149,5745,-78,-96,18,f6:0a:5c:59:72:df,220871433,252,8785,220871181,220871433
3161,5,12,149,5745,-78,-96,18,9a:24:38:da:96:bb,220873158,272,1453,220872886,220873158
3162,5,12,149,5745,-77,-96,19,f6:0a:5c:59:72:df,220877968,252,4558,220877716,220877968
3163,5,12,149,5745,-79,-96,17,d2:00:04:7e:2c:ab,220878418,440,10,220877978,220878418
3164,5,12,149,5745,-68,-96,28,02:31:8a:29:26:f4,220881170,268,2484,220880902,220881170
3165,5,12,149,5745,-80,-96,16,72:d1:72:1d:22:a1,220882613,256,1187,220882357,220882613
3166,5,12,149,5745,-72,-96,24,fa:44:8d:e1:c7:1b,220882941,440,-112,220882501,220882941
3167,5,12,149,5745,-67,-96,29,0a:b9:b7:b1:4d:fa,220883847,268,638,220883579,220883847
3168,5,12,149,5745,-67,-96,29,a6:92:ad:b7:76:65,220884230,456,-73,220883774,220884230
3169,5,12,149,5745,-67,-96,29,5e:36:fe:bc:a2:fe,220887024,440,2354,220886584,220887024
3170,5,12,149,5745,-54,-96,42,f2:da:61:dd:98:c5,220887733,268,441,220887465,220887733
3171,5,12,149,5745,-77,-96,19,22:ec:75:a8:8a:31,220888063,244,86,220887819,220888063
3172,5,12,149,5745,-80,-96,16,9a:24:38:da:96:bb,220890820,824,1933,220889996,220890820
3173,5,12,149,5745,-62,-96,34,3e:d1:9b:c7:a4:de,220891784,544,420,220891240,220891784
3174,5,12,149,5745,-55,-96,41,5e:29:73:5b:30:00,220894820,540,2496,220894280,220894820
3175,5,12,149,5745,-77,-96,19,22:ec:75:a8:8a:31,220895421,516,85,220894905,220895421
3176,5,6,149,5745,-77,-96,19,,220909606,52,14133,220909554,220909606
3177,5,6,149,5745,-89,-96,7,,220909674,44,24,220909630,220909674
3178,5,12,149,5745,-76,-96,20,f6:0a:5c:59:72:df,220937124,252,27198,220936872,220937124
3179,5,12,149,5745,-61,-96,35,3e:d1:9b:c7:a4:de,220941210,272,3814,220940938,220941210
3180,5,12,149,5745,-71,-96,25,fa:44:8d:e1:c7:1b,220950112,244,8658,220949868,220950112
3181,5,12,149,5745,-54,-96,42,5e:29:73:5b:30:00,220951047,272,663,220950775,220951047
3182,5,12,149,5745,-55,-96,41,f2:da:61:dd:98:c5,220954082,268,2767,220953814,220954082
3183,5,12,149,5745,-66,-96,30,02:31:8a:29:26:f4,220959277,268,4927,220959009,220959277
3184,5,12,149,5745,-49,-96,47,72:fd:09:2f:da:5f,220960129,284,568,220959845,220960129
3185,5,6,149,5745,-89,-96,7,54:e4:3a:ec:fb:65,220962892,360,2403,220962532,220962892
3186,5,6,149,5745,-77,-96,19,,220986068,52,23124,220986016,220986068
3187,5,6,149,5745,-91,-96,5,,220986479,44,367,220986435,220986479
3188,5,12,149,5745,-77,-96,19,56:68:e2:c2:8d:d5,220989638,280,2879,220989358,220989638
3189,5,12,149,5745,-78,-96,18,22:ec:75:a8:8a:31,220990498,244,616,220990254,220990498
3190,5,12,149,5745,-81,-96,15,72:d1:72:1d:22:a1,220995527,256,4773,220995271,220995527
3191,5,12,149,5745,-71,-96,25,f6:0a:5c:59:72:df,221000228,252,4449,220999976,221000228
3192,5,24,149,5745,-87,-96,9,,221042783,32,42523,221042751,221042783
3193,5,12,149,5745,-60,-96,36,3e:d1:9b:c7:a4:de,221058198,272,15143,221057926,221058198
3194,5,12,149,5745,-52,-96,44,72:fd:09:2f:da:5f,221062360,284,3878,221062076,221062360
3195,5,12,149,5745,-51,-96,45,5e:29:73:5b:30:00,221064075,272,1443,221063803,221064075
3196,5,12,149,5745,-70,-96,26,5e:36:fe:bc:a2:fe,221064689,244,370,221064445,221064689
3197,5,6,149,5745,-87,-96,9,54:e4:3a:ec:fb:65,221065292,360,243,221064932,221065292
3198,5,12,149,5745,-56,-96,40,f2:da:61:dd:98:c5,221067305,268,1745,221067037,221067305
3199,5,12,149,5745,-71,-96,25,02:31:8a:29:26:f4,221071450,268,3877,221071182,221071450
3200,5,12,149,5745,-68,-96,28,fa:44:8d:e1:c7:1b,221089646,244,17952,221089402,221089646
3201,5,12,149,5745,-82,-96,14,56:68:e2:c2:8d:d5,221090750,280,824,221090470,221090750
3202,5,12,149,5745,-76,-96,20,22:ec:75:a8:8a:31,221103959,244,12965,221103715,221103959
3203,5,12,149,5745,-80,-96,16,72:d1:72:1d:22:a1,221105973,256,1758,221105717,221105973
3204,5,12,149,5745,-55,-96,41,72:fd:09:2f:da:5f,221164269,284,58012,221163985,221164269
3205,5,6,149,5745,-86,-96,10,54:e4:3a:ec:fb:65,221167693,360,3064,221167333,221167693
3206,5,12,149,5745,-63,-96,33,3e:d1:9b:c7:a4:de,221175396,272,7431,221175124,221175396
3207,5,12,149,5745,-55,-96,41,f2:da:61:dd:98:c5,221179811,268,4147,221179543,221179811
3208,5,12,149,5745,-72,-96,24,02:31:8a:29:26:f4,221180531,268,452,221180263,221180531
3209,5,12,149,5745,-47,-96,49,5e:29:73:5b:30:00,221181435,272,632,221181163,221181435
3210,5,12,149,5745,-70,-96,26,fa:44:8d:e1:c7:1b,221192327,244,10648,221192083,221192327
3211,5,12,149,5745,-83,-96,13,56:68:e2:c2:8d:d5,221192920,280,313,221192640,221192920
3212,5,12,149,5745,-77,-96,19,9a:24:38:da:96:bb,221213601,272,20409,221213329,221213601
3213,5,12,149,5745,-74,-96,22,22:ec:75:a8:8a:31,221221191,244,7346,221220947,221221191
3214,5,12,149,5745,-56,-96,40,72:fd:09:2f:da:5f,221265239,284,43764,221264955,221265239
3215,5,12,149,5745,-60,-96,36,3e:d1:9b:c7:a4:de,221288327,272,22816,221288055,221288327
3216,5,12,149,5745,-48,-96,48,5e:29:73:5b:30:00,221293508,272,4909,221293236,221293508
3217,5,12,149,5745,-73,-96,23,fa:44:8d:e1:c7:1b,221294349,244,597,221294105,221294349
3218,5,12,149,5745,-79,-96,17,72:d1:72:1d:22:a1,221295166,256,561,221294910,221295166
3219,5,12,149,5745,-82,-96,14,56:68:e2:c2:8d:d5,221296084,280,638,221295804,221296084
3220,5,12,149,5745,-59,-96,37,f2:da:61:dd:98:c5,221302292,268,5940,221302024,221302292
3221,5,12,149,5745,-69,-96,27,02:31:8a:29:26:f4,221303314,268,754,221303046,221303314
3222,5,12,149,5745,-76,-96,20,9a:24:38:da:96:bb,221321161,272,17575,221320889,221321161
3223,5,12,149,5745,-69,-96,27,f6:0a:5c:59:72:df,221332647,252,11234,221332395,221332647
3224,5,12,149,5745,-77,-96,19,72:d1:72:1d:22:a1,221333061,256,158,221332805,221333061
3225,5,12,149,5745,-56,-96,40,72:fd:09:2f:da:5f,221333351,284,6,221333067,221333351
3226,5,12,149,5745,-60,-96,36,3e:d1:9b:c7:a4:de,221334803,544,908,221334259,221334803
3227,5,12,149,5745,-56,-96,40,72:fd:09:2f:da:5f,221335381,480,98,221334901,221335381
3228,5,12,149,5745,-80,-96,16,56:68:e2:c2:8d:d5,221339945,476,4088,221339469,221339945
3229,5,12,149,5745,-71,-96,25,02:31:8a:29:26:f4,221340457,268,244,221340189,221340457
3230,5,12,149,5745,-69,-96,27,f6:0a:5c:59:72:df,221344152,252,3443,221343900,221344152
3231,5,12,149,5745,-58,-96,38,f2:da:61:dd:98:c5,221346816,268,2396,221346548,221346816
3232,5,12,149,5745,-71,-96,25,fa:44:8d:e1:c7:1b,221347199,440,-57,221346759,221347199
3233,5,12,149,5745,-73,-96,23,22:ec:75:a8:8a:31,221347669,244,226,221347425,221347669
3234,5,12,149,5745,-76,-96,20,72:d1:72:1d:22:a1,221349121,452,1000,221348669,221349121
3235,5,12,149,5745,-48,-96,48,5e:29:73:5b:30:00,221351568,540,1907,221351028,221351568
3236,5,12,149,5745,-71,-96,25,5e:36:fe:bc:a2:fe,221359166,440,7158,221358726,221359166
3237,5,6,149,5745,-86,-96,10,54:e4:3a:ec:fb:65,221372494,360,12968,221372134,221372494
3238,5,12,149,5745,-66,-96,30,fa:44:8d:e1:c7:1b,221396036,244,23298,221395792,221396036
3239,5,12,149,5745,-75,-96,21,02:31:8a:29:26:f4,221398017,268,1713,221397749,221398017
3240,5,12,149,5745,-79,-96,17,56:68:e2:c2:8d:d5,221398328,280,31,221398048,221398328
3241,5,12,149,5745,-75,-96,21,02:31:8a:29:26:f4,221398670,268,74,221398402,221398670
3242,5,12,149,5745,-57,-96,39,f2:da:61:dd:98:c5,221399001,268,63,221398733,221399001
3243,5,12,149,5745,-61,-96,35,3e:d1:9b:c7:a4:de,221400158,544,613,221399614,221400158
3244,5,12,149,5745,-49,-96,47,5e:29:73:5b:30:00,221400781,540,83,221400241,221400781
3245,5,12,149,5745,-79,-96,17,56:68:e2:c2:8d:d5,221406188,476,4931,221405712,221406188
3246,5,12,149,5745,-70,-96,26,f6:0a:5c:59:72:df,221408840,252,2400,221408588,221408840
3247,5,12,149,5745,-57,-96,39,f2:da:61:dd:98:c5,221410089,268,981,221409821,221410089
3248,5,12,149,5745,-78,-96,18,72:d1:72:1d:22:a1,221410391,452,-150,221409939,221410391
3249,5,12,149,5745,-71,-96,25,a6:92:ad:b7:76:65,221410931,456,84,221410475,221410931
3250,5,12,149,5745,-79,-96,17,d2:00:04:7e:2c:ab,221412910,380,1599,221412530,221412910
3251,5,12,149,5745,-66,-96,30,fa:44:8d:e1:c7:1b,221413334,440,-16,221412894,221413334
3252,5,12,149,5745,-56,-96,40,72:fd:09:2f:da:5f,221413881,480,67,221413401,221413881
3253,5,12,149,5745,-72,-96,24,0a:b9:b7:b1:4d:fa,221414404,268,255,221414136,221414404
3254,5,12,149,5745,-61,-96,35,3e:d1:9b:c7:a4:de,221414733,272,57,221414461,221414733
3255,5,12,149,5745,-50,-96,46,5e:29:73:5b:30:00,221415831,272,826,221415559,221415831
3256,5,12,149,5745,-73,-96,23,22:ec:75:a8:8a:31,221416164,516,-183,221415648,221416164
3257,5,12,149,5745,-79,-96,17,d2:00:04:7e:2c:ab,221416734,440,130,221416294,221416734
3258,5,12,149,5745,-72,-96,24,5e:36:fe:bc:a2:fe,221422705,440,5531,221422265,221422705
3259,5,12,149,5745,-56,-96,40,72:fd:09:2f:da:5f,221431441,284,8452,221431157,221431441
3260,5,12,149,5745,-79,-96,17,9a:24:38:da:96:bb,221437985,272,6272,221437713,221437985
3261,5,12,149,5745,-71,-96,25,f6:0a:5c:59:72:df,221444342,252,6105,221444090,221444342
3262,5,12,149,5745,-74,-96,22,5e:36:fe:bc:a2:fe,221447823,244,3237,221447579,221447823
3263,5,12,149,5745,-74,-96,22,22:ec:75:a8:8a:31,221449855,244,1788,221449611,221449855
3264,5,12,149,5745,-71,-96,25,f6:0a:5c:59:72:df,221474249,252,24142,221473997,221474249
3265,5,6,149,5745,-88,-96,8,54:e4:3a:ec:fb:65,221474894,360,285,221474534,221474894
3266,5,12,149,5745,-69,-96,27,fa:44:8d:e1:c7:1b,221511660,244,36522,221511416,221511660
3267,5,12,149,5745,-79,-96,17,56:68:e2:c2:8d:d5,221513964,280,2024,221513684,221513964
3268,5,12,149,5745,-65,-96,31,3e:d1:9b:c7:a4:de,221518293,272,4057,221518021,221518293
3269,5,12,149,5745,-47,-96,49,5e:29:73:5b:30:00,221519960,272,1395,221519688,221519960
3270,5,12,149,5745,-80,-96,16,9a:24:38:da:96:bb,221550152,272,29920,221549880,221550152
3271,5,12,149,5745,-72,-96,24,22:ec:75:a8:8a:31,221560286,244,9890,221560042,221560286
3272,5,12,149,5745,-54,-96,42,72:fd:09:2f:da:5f,221572200,284,11630,221571916,221572200
3273,5,6,149,5745,-85,-96,11,54:e4:3a:ec:fb:65,221577294,360,4734,221576934,221577294
3274,5,12,149,5745,-66,-96,30,02:31:8a:29:26:f4,221578060,268,498,221577792,221578060
3275,5,12,149,5745,-50,-96,46,f2:da:61:dd:98:c5,221578362,268,34,221578094,221578362
3276,5,12,149,5745,-79,-96,17,72:d1:72:1d:22:a1,221602377,256,23759,221602121,221602377
3277,5,12,149,5745,-60,-96,36,3e:d1:9b:c7:a4:de,221635227,272,32578,221634955,221635227
3278,5,12,149,5745,-48,-96,48,5e:29:73:5b:30:00,221637139,272,1640,221636867,221637139
3279,5,12,149,5745,-77,-96,19,9a:24:38:da:96:bb,221665499,272,28088,221665227,221665499
3280,5,12,149,5745,-54,-96,42,72:fd:09:2f:da:5f,221675532,284,9749,221675248,221675532
3281,5,12,149,5745,-71,-96,25,22:ec:75:a8:8a:31,221678303,244,2527,221678059,221678303
3282,5,12,149,5745,-70,-96,26,5e:36:fe:bc:a2:fe,221679028,240,485,221678788,221679028
3283,5,12,149,5745,-70,-96,26,02:31:8a:29:26:f4,221679361,268,65,221679093,221679361
3284,5,6,149,5745,-85,-96,11,54:e4:3a:ec:fb:65,221679695,360,-26,221679335,221679695
3285,5,12,149,5745,-51,-96,45,f2:da:61:dd:98:c5,221681189,268,1226,221680921,221681189
3286,5,12,149,5745,-71,-96,25,fa:44:8d:e1:c7:1b,221704319,244,22886,221704075,221704319
3287,5,12,149,5745,-80,-96,16,72:d1:72:1d:22:a1,221704677,256,102,221704421,221704677
3288,5,12,149,5745,-78,-96,18,56:68:e2:c2:8d:d5,221706479,280,1522,221706199,221706479
3289,5,12,149,5745,-72,-96,24,fa:44:8d:e1:c7:1b,221742661,244,35938,221742417,221742661
3290,5,12,149,5745,-78,-96,18,56:68:e2:c2:8d:d5,221743516,280,575,221743236,221743516
3291,5,12,149,5745,-51,-96,45,f2:da:61:dd:98:c5,221743847,268,63,221743579,221743847
3292,5,12,149,5745,-70,-96,26,02:31:8a:29:26:f4,221747959,268,3844,221747691,221747959
3293,5,12,149,5745,-58,-96,38,3e:d1:9b:c7:a4:de,221752424,272,4193,221752152,221752424
3294,5,12,149,5745,-50,-96,46,5e:29:73:5b:30:00,221754192,272,1496,221753920,221754192
3295,5,12,149,5745,-77,-96,19,9a:24:38:da:96:bb,221774642,272,20178,221774370,221774642
3296,5,12,149,5745,-80,-96,16,72:d1:72:1d:22:a1,221777891,256,2993,221777635,221777891
3297,5,12,149,5745,-57,-96,39,72:fd:09:2f:da:5f,221778733,284,558,221778449,221778733
3298,5,6,149,5745,-86,-96,10,54:e4:3a:ec:fb:65,221782096,360,3003,221781736,221782096
3299,5,12,149,5745,-67,-96,29,f6:0a:5c:59:72:df,221787868,252,5520,221787616,221787868
3300,5,12,149,5745,-58,-96,38,3e:d1:9b:c7:a4:de,221794274,544,5862,221793730,221794274
3301,5,12,149,5745,-78,-96,18,56:68:e2:c2:8d:d5,221794907,476,157,221794431,221794907
3302,5,12,149,5745,-50,-96,46,5e:29:73:5b:30:00,221795684,540,237,221795144,221795684
3303,5,12,149,5745,-72,-96,24,02:31:8a:29:26:f4,221801660,268,5708,221801392,221801660
3304,5,12,149,5745,-67,-96,29,f6:0a:5c:59:72:df,221802061,252,149,221801809,221802061
3305,5,12,149,5745,-69,-96,27,5e:36:fe:bc:a2:fe,221802401,240,100,221802161,221802401
3306,5,12,149,5745,-51,-96,45,f2:da:61:dd:98:c5,221804566,268,1897,221804298,221804566
3307,5,12,149,5745,-72,-96,24,22:ec:75:a8:8a:31,221805517,244,707,221805273,221805517
3308,5,12,149,5745,-77,-96,19,fa:44:8d:e1:c7:1b,221805841,440,-116,221805401,221805841
3309,5,12,149,5745,-71,-96,25,a6:92:ad:b7:76:65,221807403,456,1106,221806947,221807403
3310,5,12,149,5745,-69,-96,27,5e:36:fe:bc:a2:fe,221809659,152,2104,221809507,221809659
3311,5,12,149,5745,-72,-96,24,22:ec:75:a8:8a:31,221809881,516,-294,221809365,221809881
3312,5,12,149,5745,-57,-96,39,72:fd:09:2f:da:5f,221810467,480,106,221809987,221810467
3313,5,12,149,5745,-77,-96,19,9a:24:38:da:96:bb,221812499,824,1208,221811675,221812499
3314,5,12,149,5745,-81,-96,15,72:d1:72:1d:22:a1,221819324,452,6373,221818872,221819324
3315,5,24,149,5745,-73,-96,23,,221825907,28,6555,221825879,221825907
3316,5,24,149,5745,-73,-96,23,,221826217,28,282,221826189,221826217
3317,5,24,149,5745,-73,-96,23,,221826419,28,174,221826391,221826419
3318,5,24,149,5745,-75,-96,21,,221827920,28,1473,221827892,221827920
3319,5,12,149,5745,-77,-96,19,56:68:e2:c2:8d:d5,221841370,280,13170,221841090,221841370
3320,5,12,149,5745,-51,-96,45,f2:da:61:dd:98:c5,221841720,268,82,221841452,221841720
3321,5,12,149,5745,-79,-96,17,fa:44:8d:e1:c7:1b,221865316,244,23352,221865072,221865316
3322,5,12,149,5745,-60,-96,36,3e:d1:9b:c7:a4:de,221866522,272,934,221866250,221866522
3323,5,12,149,5745,-71,-96,25,a6:92:ad:b7:76:65,221866875,456,-103,221866419,221866875
3324,5,12,149,5745,-72,-96,24,02:31:8a:29:26:f4,221867897,268,754,221867629,221867897
3325,5,12,149,5745,-49,-96,47,5e:29:73:5b:30:00,221870613,272,2444,221870341,221870613
3326,5,6,149,5745,-89,-96,7,54:e4:3a:ec:fb:65,221884496,360,13523,221884136,221884496
3327,5,12,149,5745,-80,-96,16,9a:24:38:da:96:bb,221886540,272,1772,221886268,221886540
3328,5,24,149,5745,-75,-96,21,,221893196,28,6628,221893168,221893196
3329,5,12,149,5745,-54,-96,42,72:fd:09:2f:da:5f,221897118,284,3638,221896834,221897118
3330,5,12,149,5745,-79,-96,17,72:d1:72:1d:22:a1,221898049,256,675,221897793,221898049
3331,5,12,149,5745,-69,-96,27,5e:36:fe:bc:a2:fe,221899807,240,1518,221899567,221899807
3332,5,12,149,5745,-69,-96,27,f6:0a:5c:59:72:df,221900351,252,292,221900099,221900351
3333,5,12,149,5745,-69,-96,27,a6:92:ad:b7:76:65,221905264,256,4657,221905008,221905264
3334,5,24,149,5745,-76,-96,20,,221910342,28,5050,221910314,221910342
3335,5,24,149,5745,-90,-96,6,,221910495,28,125,221910467,221910495
3336,5,24,149,5745,-75,-96,21,,221910616,28,93,221910588,221910616
3337,5,24,149,5745,-75,-96,21,,221910860,28,216,221910832,221910860
3338,5,12,149,5745,-72,-96,24,22:ec:75:a8:8a:31,221920254,244,9150,221920010,221920254
3339,5,12,149,5745,-70,-96,26,5e:36:fe:bc:a2:fe,221925572,240,5078,221925332,221925572
3340,5,12,149,5745,-50,-96,46,5e:29:73:5b:30:00,221927912,540,1800,221927372,221927912
3341,5,24,149,5745,-76,-96,20,,221929545,28,1605,221929517,221929545
3342,5,12,149,5745,-71,-96,25,f6:0a:5c:59:72:df,221932661,252,2864,221932409,221932661
3343,5,12,149,5745,-70,-96,26,a6:92:ad:b7:76:65,221933037,456,-80,221932581,221933037
3344,5,12,149,5745,-69,-96,27,02:31:8a:29:26:f4,221934078,268,773,221933810,221934078
3345,5,12,149,5745,-51,-96,45,f2:da:61:dd:98:c5,221936857,268,2511,221936589,221936857
3346,5,12,149,5745,-74,-96,22,fa:44:8d:e1:c7:1b,221938275,440,978,221937835,221938275
3347,5,12,149,5745,-64,-96,32,0a:b9:b7:b1:4d:fa,221938768,268,225,221938500,221938768
3348,5,12,149,5745,-73,-96,23,22:ec:75:a8:8a:31,221941644,516,2360,221941128,221941644
3349,5,12,149,5745,-77,-96,19,9a:24:38:da:96:bb,221942328,824,-140,221941504,221942328
3350,5,12,149,5745,-82,-96,14,d2:00:04:7e:2c:ab,221943465,440,697,221943025,221943465
3351,5,12,149,5745,-74,-96,22,fa:44:8d:e1:c7:1b,221953040,244,9331,221952796,221953040
3352,5,12,149,5745,-51,-96,45,f2:da:61:dd:98:c5,221955485,268,2177,221955217,221955485
3353,5,12,149,5745,-70,-96,26,02:31:8a:29:26:f4,221971788,268,16035,221971520,221971788
3354,5,12,149,5745,-67,-96,29,3e:d1:9b:c7:a4:de,221981088,272,9028,221980816,221981088
3355,5,24,149,5745,-75,-96,21,,221985830,28,4714,221985802,221985830
3356,5,24,149,5745,-76,-96,20,,221986076,28,218,221986048,221986076
3357,5,12,149,5745,-51,-96,45,5e:29:73:5b:30:00,221986373,272,25,221986101,221986373
3358,5,6,149,5745,-86,-96,10,54:e4:3a:ec:fb:65,221986897,360,164,221986537,221986897
3359,5,12,149,5745,-82,-96,14,9a:24:38:da:96:bb,221998901,272,11732,221998629,221998901
3360,5,12,149,5745,-70,-96,26,f6:0a:5c:59:72:df,221999394,252,241,221999142,221999394
3361,5,12,149,5745,-78,-96,18,72:d1:72:1d:22:a1,222010886,256,11236,222010630,222010886
3362,5,12,149,5745,-71,-96,25,f6:0a:5c:59:72:df,222011671,252,533,222011419,222011671
3363,5,12,149,5745,-70,-96,26,5e:36:fe:bc:a2:fe,222012949,240,1038,222012709,222012949
3364,5,12,149,5745,-77,-96,19,56:68:e2:c2:8d:d5,222013689,280,460,222013409,222013689
3365,5,12,149,5745,-74,-96,22,22:ec:75:a8:8a:31,222022054,244,8121,222021810,222022054
3366,5,12,149,5745,-72,-96,24,a6:92:ad:b7:76:65,222022409,256,99,222022153,222022409
3367,5,24,149,5745,-89,-96,7,,222066354,28,43917,222066326,222066354
3368,5,12,149,5745,-49,-96,47,f2:da:61:dd:98:c5,222081713,268,15091,222081445,222081713
3369,5,12,149,5745,-70,-96,26,02:31:8a:29:26:f4,222086281,268,4300,222086013,222086281
3370,5,12,149,5745,-53,-96,43,72:fd:09:2f:da:5f,222086843,284,278,222086559,222086843
3371,5,6,149,5745,-87,-96,9,54:e4:3a:ec:fb:65,222089297,360,2094,222088937,222089297
3372,5,12,149,5745,-61,-96,35,3e:d1:9b:c7:a4:de,222093501,272,3932,222093229,222093501
3373,5,12,149,5745,-55,-96,41,5e:29:73:5b:30:00,222099255,272,5482,222098983,222099255
3374,5,12,149,5745,-78,-96,18,9a:24:38:da:96:bb,222111110,272,11583,222110838,222111110
3375,5,12,149,5745,-75,-96,21,fa:44:8d:e1:c7:1b,222113414,244,2060,222113170,222113414
3376,5,12,149,5745,-77,-96,19,56:68:e2:c2:8d:d5,222115789,280,2095,222115509,222115789
3377,5,6,149,5745,-83,-96,13,34:7d:f6:81:74:23,222119629,164,3676,222119465,222119629
3378,5,12,149,5745,-79,-96,17,72:d1:72:1d:22:a1,222124416,256,4531,222124160,222124416
3379,5,12,149,5745,-76,-96,20,22:ec:75:a8:8a:31,222139119,244,14459,222138875,222139119
3380,5,12,149,5745,-72,-96,24,f6:0a:5c:59:72:df,222139417,252,46,222139165,222139417
3381,5,12,149,5745,-56,-96,40,72:fd:09:2f:da:5f,222188832,284,49131,222188548,222188832
3382,5,6,149,5745,-88,-96,8,54:e4:3a:ec:fb:65,222191698,360,2506,222191338,222191698
3383,5,12,149,5745,-76,-96,20,5e:36:fe:bc:a2:fe,222192173,240,235,222191933,222192173
3384,5,12,149,5745,-49,-96,47,f2:da:61:dd:98:c5,222194837,268,2396,222194569,222194837
3385,5,12,149,5745,-73,-96,23,02:31:8a:29:26:f4,222197897,268,2792,222197629,222197897
3386,5,12,149,5745,-63,-96,33,3e:d1:9b:c7:a4:de,222206038,272,7869,222205766,222206038
3387,5,12,149,5745,-74,-96,22,a6:92:ad:b7:76:65,222214918,256,8624,222214662,222214918
3388,5,12,149,5745,-70,-96,26,fa:44:8d:e1:c7:1b,222215738,244,576,222215494,222215738
3389,5,12,149,5745,-52,-96,44,5e:29:73:5b:30:00,222216361,272,351,222216089,222216361
3390,5,12,149,5745,-78,-96,18,56:68:e2:c2:8d:d5,222217055,280,414,222216775,222217055
3391,5,12,149,5745,-80,-96,16,9a:24:38:da:96:bb,222224714,272,7387,222224442,222224714
3392,5,12,149,5745,-81,-96,15,72:d1:72:1d:22:a1,222232438,256,7468,222232182,222232438
3393,5,12,149,5745,-74,-96,22,22:ec:75:a8:8a:31,222253932,244,21250,222253688,222253932
3394,5,12,149,5745,-72,-96,24,f6:0a:5c:59:72:df,222255624,252,1440,222255372,222255624
3395,5,12,149,5745,-54,-96,42,72:fd:09:2f:da:5f,222290709,284,34801,222290425,222290709
3396,5,6,149,5745,-88,-96,8,54:e4:3a:ec:fb:65,222294098,360,3029,222293738,222294098
3397,5,12,149,5745,-74,-96,22,5e:36:fe:bc:a2:fe,222294522,240,184,222294282,222294522
3398,5,12,149,5745,-58,-96,38,f2:da:61:dd:98:c5,222306650,268,11860,222306382,222306650
3399,5,12,149,5745,-70,-96,26,02:31:8a:29:26:f4,222311407,268,4489,222311139,222311407
3400,5,12,149,5745,-73,-96,23,a6:92:ad:b7:76:65,222316982,256,5319,222316726,222316982
3401,5,12,149,5745,-62,-96,34,3e:d1:9b:c7:a4:de,222317854,272,600,222317582,222317854
3402,5,12,149,5745,-70,-96,26,fa:44:8d:e1:c7:1b,222318776,244,678,222318532,222318776
3403,5,12,149,5745,-78,-96,18,56:68:e2:c2:8d:d5,222320086,280,1030,222319806,222320086
3404,5,12,149,5745,-50,-96,46,5e:29:73:5b:30:00,222328311,272,7953,222328039,222328311
3405,5,12,149,5745,-50,-96,46,72:fd:09:2f:da:5f,222346444,284,17849,222346160,222346444
3406,5,12,149,5745,-82,-96,14,72:d1:72:1d:22:a1,222351159,256,4459,222350903,222351159
3407,5,12,149,5745,-70,-96,26,5e:36:fe:bc:a2:fe,222352306,240,907,222352066,222352306
3408,5,12,149,5745,-73,-96,23,a6:92:ad:b7:76:65,222364769,256,12207,222364513,222364769
3409,5,12,149,5745,-74,-96,22,22:ec:75:a8:8a:31,222379059,244,14046,222378815,222379059
3410,5,12,149,5745,-75,-96,21,56:68:e2:c2:8d:d5,222383135,476,3600,222382659,222383135
3411,5,12,149,5745,-60,-96,36,3e:d1:9b:c7:a4:de,222383645,544,-34,222383101,222383645
3412,5,12,149,5745,-46,-96,50,5e:29:73:5b:30:00,222384277,540,92,222383737,222384277
3413,5,12,149,5745,-71,-96,25,5e:36:fe:bc:a2:fe,222384907,240,390,222384667,222384907
3414,5,12,149,5745,-73,-96,23,a6:92:ad:b7:76:65,222392534,456,7171,222392078,222392534
3415,5,12,149,5745,-81,-96,15,72:d1:72:1d:22:a1,222393061,452,75,222392609,222393061
3416,5,12,149,5745,-72,-96,24,f6:0a:5c:59:72:df,222393575,252,262,222393323,222393575
3417,5,12,149,5745,-69,-96,27,02:31:8a:29:26:f4,222394573,268,730,222394305,222394573
3418,5,12,149,5745,-55,-96,41,f2:da:61:dd:98:c5,222395831,268,990,222395563,222395831
3419,5,6,149,5745,-90,-96,6,54:e4:3a:ec:fb:65,222396499,360,308,222396139,222396499
3420,5,12,149,5745,-50,-96,46,72:fd:09:2f:da:5f,222397093,480,114,222396613,222397093
3421,5,12,149,5745,-72,-96,24,fa:44:8d:e1:c7:1b,222397697,440,164,222397257,222397697
3422,5,12,149,5745,-73,-96,23,22:ec:75:a8:8a:31,222399729,516,1516,222399213,222399729
3423,5,12,149,5745,-71,-96,25,fa:44:8d:e1:c7:1b,222411762,244,11789,222411518,222411762
3424,5,12,149,5745,-74,-96,22,56:68:e2:c2:8d:d5,222413885,280,1843,222413605,222413885
3425,5,12,149,5745,-56,-96,40,f2:da:61:dd:98:c5,222414316,268,163,222414048,222414316
3426,5,12,149,5745,-68,-96,28,02:31:8a:29:26:f4,222415286,268,702,222415018,222415286
3427,5,12,149,5745,-75,-96,21,56:68:e2:c2:8d:d5,222445801,476,30039,222445325,222445801
3428,5,12,149,5745,-57,-96,39,3e:d1:9b:c7:a4:de,222446725,272,652,222446453,222446725
3429,5,12,149,5745,-50,-96,46,72:fd:09:2f:da:5f,222447221,284,212,222446937,222447221
3430,5,12,149,5745,-47,-96,49,5e:29:73:5b:30:00,222448114,272,621,222447842,222448114
3431,5,12,149,5745,-79,-96,17,9a:24:38:da:96:bb,222448457,272,71,222448185,222448457
3432,5,12,149,5745,-47,-96,49,5e:29:73:5b:30:00,222448979,540,-18,222448439,222448979
3433,5,12,149,5745,-67,-96,29,5e:36:fe:bc:a2:fe,222449563,240,344,222449323,222449563
3434,5,12,149,5745,-57,-96,39,3e:d1:9b:c7:a4:de,222449892,544,-215,222449348,222449892
3435,5,12,149,5745,-67,-96,29,02:31:8a:29:26:f4,222450682,204,586,222450478,222450682
3436,5,12,149,5745,-82,-96,14,d2:00:04:7e:2c:ab,222456393,440,5271,222455953,222456393
3437,5,12,149,5745,-67,-96,29,02:31:8a:29:26:f4,222456967,268,306,222456699,222456967
3438,5,12,149,5745,-74,-96,22,f6:0a:5c:59:72:df,222457323,252,104,222457071,222457323
3439,5,12,149,5745,-73,-96,23,a6:92:ad:b7:76:65,222457708,456,-71,222457252,222457708
3440,5,12,149,5745,-58,-96,38,f2:da:61:dd:98:c5,222458324,268,348,222458056,222458324
3441,5,12,149,5745,-82,-96,14,72:d1:72:1d:22:a1,222458644,452,-132,222458192,222458644
3442,5,12,149,5745,-71,-96,25,fa:44:8d:e1:c7:1b,222460896,440,1812,222460456,222460896
3443,5,12,149,5745,-69,-96,27,0a:b9:b7:b1:4d:fa,222461802,268,638,222461534,222461802
3444,5,12,149,5745,-49,-96,47,72:fd:09:2f:da:5f,222462509,480,227,222462029,222462509
3445,5,12,149,5745,-73,-96,23,a6:92:ad:b7:76:65,222463024,256,259,222462768,222463024
3446,5,12,149,5745,-66,-96,30,5e:36:fe:bc:a2:fe,222463359,240,95,222463119,222463359
3447,5,12,149,5745,-76,-96,20,22:ec:75:a8:8a:31,222464992,516,1117,222464476,222464992
3448,5,12,149,5745,-75,-96,21,f6:0a:5c:59:72:df,222466712,252,1468,222466460,222466712
3449,5,12,149,5745,-80,-96,16,9a:24:38:da:96:bb,222468023,824,487,222467199,222468023
3450,5,12,149,5745,-75,-96,21,22:ec:75:a8:8a:31,222494480,244,26213,222494236,222494480
3451,5,6,149,5745,-88,-96,8,54:e4:3a:ec:fb:65,222498899,360,4059,222498539,222498899
3452,5,12,149,5745,-75,-96,21,f6:0a:5c:59:72:df,222523567,252,24416,222523315,222523567
3453,5,12,149,5745,-75,-96,21,56:68:e2:c2:8d:d5,222530755,280,6908,222530475,222530755
3454,5,12,149,5745,-75,-96,21,fa:44:8d:e1:c7:1b,222531649,244,650,222531405,222531649
3455,5,12,149,5745,-55,-96,41,f2:da:61:dd:98:c5,222533211,268,1294,222532943,222533211
3456,5,12,149,5745,-66,-96,30,02:31:8a:29:26:f4,222537068,268,3589,222536800,222537068
3457,5,12,149,5745,-57,-96,39,3e:d1:9b:c7:a4:de,222547742,272,10402,222547470,222547742
3458,5,12,149,5745,-48,-96,48,5e:29:73:5b:30:00,222557930,272,9916,222557658,222557930
3459,5,12,149,5745,-78,-96,18,9a:24:38:da:96:bb,222560039,272,1837,222559767,222560039
3460,5,12,149,5745,-54,-96,42,72:fd:09:2f:da:5f,222571783,284,11460,222571499,222571783
3461,5,12,149,5745,-85,-96,11,72:d1:72:1d:22:a1,222574319,256,2280,222574063,222574319
3462,5,12,149,5745,-68,-96,28,5e:36:fe:bc:a2:fe,222580287,240,5728,222580047,222580287
3463,5,12,149,5745,-72,-96,24,f6:0a:5c:59:72:df,222594237,252,13698,222593985,222594237
3464,5,12,149,5745,-76,-96,20,22:ec:75:a8:8a:31,222596102,244,1621,222595858,222596102
3465,5,6,149,5745,-85,-96,11,54:e4:3a:ec:fb:65,222601300,360,4838,222600940,222601300
3466,5,12,149,5745,-72,-96,24,a6:92:ad:b7:76:65,222624554,256,22998,222624298,222624554
3467,5,12,149,5745,-76,-96,20,56:68:e2:c2:8d:d5,222638969,280,14135,222638689,222638969
3468,5,12,149,5745,-77,-96,19,fa:44:8d:e1:c7:1b,222641516,244,2303,222641272,222641516
3469,5,12,149,5745,-59,-96,37,3e:d1:9b:c7:a4:de,222664053,272,22265,222663781,222664053
3470,5,12,149,5745,-77,-96,19,9a:24:38:da:96:bb,222671632,272,7307,222671360,222671632
3471,5,12,149,5745,-53,-96,43,5e:29:73:5b:30:00,222674932,272,3028,222674660,222674932
3472,5,12,149,5745,-76,-96,20,72:d1:72:1d:22:a1,222687126,256,11938,222686870,222687126
3473,5,12,149,5745,-59,-96,37,72:fd:09:2f:da:5f,222700849,284,13439,222700565,222700849
3474,5,6,149,5745,-84,-96,12,54:e4:3a:ec:fb:65,222703700,360,2491,222703340,222703700
3475,5,12,149,5745,-70,-96,26,5e:36:fe:bc:a2:fe,222704167,240,227,222703927,222704167
3476,5,12,149,5745,-57,-96,39,f2:da:61:dd:98:c5,222704470,268,35,222704202,222704470
3477,5,12,149,5745,-64,-96,32,02:31:8a:29:26:f4,222705031,268,293,222704763,222705031
3478,5,12,149,5745,-73,-96,23,f6:0a:5c:59:72:df,222708924,252,3641,222708672,222708924
3479,5,12,149,5745,-77,-96,19,22:ec:75:a8:8a:31,222713146,244,3978,222712902,222713146
3480,5,12,149,5745,-71,-96,25,a6:92:ad:b7:76:65,222727104,256,13702,222726848,222727104
3481,5,12,149,5745,-74,-96,22,fa:44:8d:e1:c7:1b,222759687,244,32339,222759443,222759687
3482,5,12,149,5745,-75,-96,21,56:68:e2:c2:8d:d5,222760668,280,701,222760388,222760668
3483,5,12,149,5745,-56,-96,40,3e:d1:9b:c7:a4:de,222781290,272,20350,222781018,222781290
3484,5,12,149,5745,-79,-96,17,9a:24:38:da:96:bb,222784166,272,2604,222783894,222784166
3485,5,12,149,5745,-52,-96,44,5e:29:73:5b:30:00,222791405,272,6967,222791133,222791405
3486,5,12,149,5745,-76,-96,20,72:d1:72:1d:22:a1,222800123,256,8462,222799867,222800123
3487,5,12,149,5745,-54,-96,42,72:fd:09:2f:da:5f,222803249,284,2842,222802965,222803249
3488,5,6,149,5745,-87,-96,9,54:e4:3a:ec:fb:65,222806101,360,2492,222805741,222806101
3489,5,12,149,5745,-55,-96,41,f2:da:61:dd:98:c5,222806945,268,576,222806677,222806945
3490,5,12,149,5745,-63,-96,33,02:31:8a:29:26:f4,222807310,268,97,222807042,222807310
3491,5,12,149,5745,-68,-96,28,5e:36:fe:bc:a2:fe,222807674,240,124,222807434,222807674
3492,5,24,149,5745,-75,-96,21,,222814770,28,7068,222814742,222814770
3493,5,12,149,5745,-69,-96,27,a6:92:ad:b7:76:65,222815083,256,57,222814827,222815083
3494,5,12,149,5745,-75,-96,21,22:ec:75:a8:8a:31,222837793,244,22466,222837549,222837793
3495,5,12,149,5745,-75,-96,21,56:68:e2:c2:8d:d5,222843511,476,5242,222843035,222843511
3496,5,12,149,5745,-56,-96,40,3e:d1:9b:c7:a4:de,222844031,544,-24,222843487,222844031
3497,5,12,149,5745,-51,-96,45,5e:29:73:5b:30:00,222845572,540,1001,222845032,222845572
3498,5,12,149,5745,-62,-96,34,02:31:8a:29:26:f4,222849856,268,4016,222849588,222849856
3499,5,12,149,5745,-71,-96,25,a6:92:ad:b7:76:65,222850482,456,170,222850026,222850482
3500,5,12,149,5745,-56,-96,40,f2:da:61:dd:98:c5,222851359,268,609,222851091,222851359
3501,5,12,149,5745,-77,-96,19,72:d1:72:1d:22:a1,222851661,452,-150,222851209,222851661
3502,5,12,149,5745,-75,-96,21,fa:44:8d:e1:c7:1b,222855369,440,3268,222854929,222855369
3503,5,12,149,5745,-71,-96,25,f6:0a:5c:59:72:df,222855843,252,222,222855591,222855843
3504,5,12,149,5745,-75,-96,21,56:68:e2:c2:8d:d5,222856691,280,568,222856411,222856691
3505,5,12,149,5745,-57,-96,39,f2:da:61:dd:98:c5,222857032,268,73,222856764,222857032
3506,5,12,149,5745,-53,-96,43,72:fd:09:2f:da:5f,222857335,480,-177,222856855,222857335
3507,5,12,149,5745,-75,-96,21,22:ec:75:a8:8a:31,222860000,516,2149,222859484,222860000
3508,5,12,149,5745,-75,-96,21,fa:44:8d:e1:c7:1b,222870470,244,10226,222870226,222870470
3509,5,12,149,5745,-63,-96,33,02:31:8a:29:26:f4,222872477,268,1739,222872209,222872477
3510,5,12,149,5745,-79,-96,17,9a:24:38:da:96:bb,222896469,272,23720,222896197,222896469
3511,5,12,149,5745,-72,-96,24,a6:92:ad:b7:76:65,222905090,456,8165,222904634,222905090
3512,5,12,149,5745,-55,-96,41,3e:d1:9b:c7:a4:de,222905580,272,218,222905308,222905580
3513,5,12,149,5745,-52,-96,44,5e:29:73:5b:30:00,222905887,272,35,222905615,222905887
3514,5,12,149,5745,-56,-96,40,3e:d1:9b:c7:a4:de,222906359,544,-72,222905815,222906359
3515,5,6,149,5745,-87,-96,9,54:e4:3a:ec:fb:65,222908502,360,1783,222908142,222908502
3516,5,12,149,5745,-79,-96,17,72:d1:72:1d:22:a1,222917681,256,8923,222917425,222917681
3517,5,12,149,5745,-70,-96,26,f6:0a:5c:59:72:df,222918835,252,902,222918583,222918835
3518,5,12,149,5745,-52,-96,44,72:fd:09:2f:da:5f,222919397,284,278,222919113,222919397
3519,5,12,149,5745,-72,-96,24,a6:92:ad:b7:76:65,222921317,256,1664,222921061,222921317
3520,5,12,149,5745,-73,-96,23,f6:0a:5c:59:72:df,222921652,252,83,222921400,222921652
3521,5,12,149,5745,-67,-96,29,5e:36:fe:bc:a2:fe,222922422,240,530,222922182,222922422
3522,5,24,149,5745,-79,-96,17,,222924637,28,2187,222924609,222924637
3523,5,12,149,5745,-74,-96,22,22:ec:75:a8:8a:31,222942415,244,17534,222942171,222942415
3524,5,24,149,5745,-76,-96,20,,222943835,28,1392,222943807,222943835
3525,5,24,149,5745,-76,-96,20,,222944037,28,174,222944009,222944037
3526,5,12,149,5745,-82,-96,14,d2:00:04:7e:2c:ab,222959731,284,15410,222959447,222959731
3527,5,12,149,5745,-78,-96,18,fa:44:8d:e1:c7:1b,222968763,244,8788,222968519,222968763
3528,5,12,149,5745,-74,-96,22,a6:92:ad:b7:76:65,222970256,456,1037,222969800,222970256
3529,5,12,149,5745,-52,-96,44,f2:da:61:dd:98:c5,222971808,268,1284,222971540,222971808
3530,5,12,149,5745,-56,-96,40,3e:d1:9b:c7:a4:de,222972164,544,-188,222971620,222972164
3531,5,12,149,5745,-69,-96,27,5e:36:fe:bc:a2:fe,222974885,240,2481,222974645,222974885
3532,5,12,149,5745,-52,-96,44,5e:29:73:5b:30:00,222975178,540,-247,222974638,222975178
3533,5,12,149,5745,-83,-96,13,d2:00:04:7e:2c:ab,222980999,412,5409,222980587,222980999
3534,5,12,149,5745,-65,-96,31,02:31:8a:29:26:f4,222984062,268,2795,222983794,222984062
3535,5,12,149,5745,-52,-96,44,f2:da:61:dd:98:c5,222985195,268,865,222984927,222985195
3536,5,12,149,5745,-66,-96,30,0a:b9:b7:b1:4d:fa,222985497,268,34,222985229,222985497
3537,5,12,149,5745,-78,-96,18,fa:44:8d:e1:c7:1b,222986102,440,165,222985662,222986102
3538,5,12,149,5745,-64,-96,32,02:31:8a:29:26:f4,222987171,268,801,222986903,222987171
3539,5,12,149,5745,-75,-96,21,22:ec:75:a8:8a:31,222991091,516,3404,222990575,222991091
3540,5,24,149,5745,-77,-96,19,,222999279,28,8160,222999251,222999279
3541,5,12,149,5745,-79,-96,17,9a:24:38:da:96:bb,223007953,272,8402,223007681,223007953
3542,5,6,149,5745,-85,-96,11,54:e4:3a:ec:fb:65,223010902,360,2589,223010542,223010902
3543,5,12,149,5745,-54,-96,42,72:fd:09:2f:da:5f,223019737,284,8551,223019453,223019737
3544,5,12,149,5745,-57,-96,39,3e:d1:9b:c7:a4:de,223020360,272,351,223020088,223020360
3545,5,12,149,5745,-69,-96,27,5e:36:fe:bc:a2:fe,223020661,240,61,223020421,223020661
3546,5,12,149,5745,-53,-96,43,5e:29:73:5b:30:00,223022573,272,1640,223022301,223022573
3547,5,12,149,5745,-81,-96,15,72:d1:72:1d:22:a1,223024793,256,1964,223024537,223024793
3548,5,12,149,5745,-77,-96,19,56:68:e2:c2:8d:d5,223037666,280,12593,223037386,223037666
3549,5,12,149,5745,-57,-96,39,3e:d1:9b:c7:a4:de,223038007,544,-203,223037463,223038007
3550,5,12,149,5745,-70,-96,26,f6:0a:5c:59:72:df,223043725,252,5466,223043473,223043725
3551,5,12,149,5745,-75,-96,21,a6:92:ad:b7:76:65,223045818,256,1837,223045562,223045818
3552,5,12,149,5745,-75,-96,21,22:ec:75:a8:8a:31,223059535,244,13473,223059291,223059535
3553,5,12,149,5745,-53,-96,43,f2:da:61:dd:98:c5,223097065,268,37262,223096797,223097065
3554,5,12,149,5745,-65,-96,31,02:31:8a:29:26:f4,223101533,268,4200,223101265,223101533
3555,5,12,149,5745,-58,-96,38,3e:d1:9b:c7:a4:de,223103501,544,1424,223102957,223103501
3556,5,6,149,5745,-88,-96,8,54:e4:3a:ec:fb:65,223113302,360,9441,223112942,223113302
3557,5,12,149,5745,-78,-96,18,9a:24:38:da:96:bb,223120641,272,7067,223120369,223120641
3558,5,12,149,5745,-54,-96,42,5e:29:73:5b:30:00,223134373,272,13460,223134101,223134373
3559,5,12,149,5745,-58,-96,38,3e:d1:9b:c7:a4:de,223134733,272,88,223134461,223134733
3560,5,12,149,5745,-75,-96,21,fa:44:8d:e1:c7:1b,223137309,244,2332,223137065,223137309
3561,5,12,149,5745,-76,-96,20,56:68:e2:c2:8d:d5,223138631,280,1042,223138351,223138631
3562,5,12,149,5745,-81,-96,15,72:d1:72:1d:22:a1,223139181,256,294,223138925,223139181
3563,5,12,149,5745,-72,-96,24,a6:92:ad:b7:76:65,223148188,256,8751,223147932,223148188
3564,5,12,149,5745,-59,-96,37,3e:d1:9b:c7:a4:de,223169004,544,20272,223168460,223169004
3565,5,12,149,5745,-75,-96,21,22:ec:75:a8:8a:31,223175592,244,6344,223175348,223175592
3566,5,12,149,5745,-53,-96,43,f2:da:61:dd:98:c5,223209731,268,33871,223209463,223209731
3567,5,12,149,5745,-54,-96,42,72:fd:09:2f:da:5f,223212634,284,2619,223212350,223212634
3568,5,12,149,5745,-66,-96,30,02:31:8a:29:26:f4,223213721,268,819,223213453,223213721
3569,5,6,149,5745,-87,-96,9,54:e4:3a:ec:fb:65,223215703,360,1622,223215343,223215703
3570,5,12,149,5745,-72,-96,24,5e:36:fe:bc:a2:fe,223217243,240,1300,223217003,223217243
3571,5,12,149,5745,-60,-96,36,3e:d1:9b:c7:a4:de,223234871,272,17356,223234599,223234871
3572,5,12,149,5745,-78,-96,18,9a:24:38:da:96:bb,223236208,272,1065,223235936,223236208
3573,5,12,149,5745,-74,-96,22,fa:44:8d:e1:c7:1b,223239692,244,3240,223239448,223239692
3574,5,12,149,5745,-77,-96,19,56:68:e2:c2:8d:d5,223241028,280,1056,223240748,223241028
3575,5,12,149,5745,-53,-96,43,5e:29:73:5b:30:00,223251352,272,10052,223251080,223251352
3576,5,12,149,5745,-80,-96,16,72:d1:72:1d:22:a1,223251830,256,222,223251574,223251830
3577,5,12,149,5745,-75,-96,21,22:ec:75:a8:8a:31,223293638,244,41564,223293394,223293638
3578,5,12,149,5745,-51,-96,45,72:fd:09:2f:da:5f,223313002,284,19080,223312718,223313002
3579,5,6,149,5745,-86,-96,10,54:e4:3a:ec:fb:65,223318104,360,4742,223317744,223318104
3580,5,12,149,5745,-73,-96,23,5e:36:fe:bc:a2:fe,223319037,240,693,223318797,223319037
3581,5,12,149,5745,-53,-96,43,f2:da:61:dd:98:c5,223322699,268,3394,223322431,223322699
3582,5,12,149,5745,-67,-96,29,02:31:8a:29:26:f4,223327223,268,4256,223326955,223327223
3583,5,12,149,5745,-71,-96,25,a6:92:ad:b7:76:65,223341329,256,13850,223341073,223341329
3584,5,12,149,5745,-73,-96,23,fa:44:8d:e1:c7:1b,223342053,244,480,223341809,223342053
3585,5,12,149,5745,-76,-96,20,56:68:e2:c2:8d:d5,223343276,280,943,223342996,223343276
3586,5,12,149,5745,-59,-96,37,3e:d1:9b:c7:a4:de,223350022,272,6474,223349750,223350022
3587,5,12,149,5745,-78,-96,18,72:d1:72:1d:22:a1,223358718,256,8440,223358462,223358718
3588,5,12,149,5745,-51,-96,45,5e:29:73:5b:30:00,223363274,272,4284,223363002,223363274
3589,5,12,149,5745,-72,-96,24,5e:36:fe:bc:a2:fe,223377515,240,14001,223377275,223377515
3590,5,12,149,5745,-71,-96,25,a6:92:ad:b7:76:65,223380383,256,2612,223380127,223380383
3591,5,12,149,5745,-74,-96,22,22:ec:75:a8:8a:31,223404819,244,24192,223404575,223404819
3592,5,12,149,5745,-76,-96,20,9a:24:38:da:96:bb,223415311,272,10220,223415039,223415311
3593,5,12,149,5745,-52,-96,44,72:fd:09:2f:da:5f,223416850,284,1255,223416566,223416850
3594,5,6,149,5745,-85,-96,11,54:e4:3a:ec:fb:65,223420504,360,3294,223420144,223420504
3595,5,12,149,5745,-72,-96,24,fa:44:8d:e1:c7:1b,223427518,244,6770,223427274,223427518
3596,5,12,149,5745,-67,-96,29,02:31:8a:29:26:f4,223429526,268,1740,223429258,223429526
3597,5,12,149,5745,-76,-96,20,56:68:e2:c2:8d:d5,223429864,280,58,223429584,223429864
3598,5,12,149,5745,-53,-96,43,f2:da:61:dd:98:c5,223430214,268,82,223429946,223430214
3599,5,12,149,5745,-72,-96,24,a6:92:ad:b7:76:65,223430867,456,197,223430411,223430867
3600,5,12,149,5745,-62,-96,34,3e:d1:9b:c7:a4:de,223431358,544,-53,223430814,223431358
3601,5,12,149,5745,-76,-96,20,56:68:e2:c2:8d:d5,223431981,476,147,223431505,223431981
3602,5,12,149,5745,-73,-96,23,5e:36:fe:bc:a2:fe,223432626,240,405,223432386,223432626
3603,5,12,149,5745,-51,-96,45,5e:29:73:5b:30:00,223432936,540,-230,223432396,223432936
3604,5,12,149,5745,-67,-96,29,02:31:8a:29:26:f4,223441548,268,8344,223441280,223441548
3605,5,12,149,5745,-52,-96,44,f2:da:61:dd:98:c5,223442824,268,1008,223442556,223442824
3606,5,12,149,5745,-72,-96,24,fa:44:8d:e1:c7:1b,223446862,440,3598,223446422,223446862
3607,5,12,149,5745,-52,-96,44,72:fd:09:2f:da:5f,223448038,480,696,223447558,223448038
3608,5,12,149,5745,-75,-96,21,22:ec:75:a8:8a:31,223448552,516,-2,223448036,223448552
3609,5,12,149,5745,-77,-96,19,9a:24:38:da:96:bb,223457217,272,8393,223456945,223457217
3610,5,12,149,5745,-53,-96,43,72:fd:09:2f:da:5f,223463013,284,5512,223462729,223463013
3611,5,12,149,5745,-72,-96,24,a6:92:ad:b7:76:65,223478032,256,14763,223477776,223478032
3612,5,12,149,5745,-60,-96,36,3e:d1:9b:c7:a4:de,223479259,272,955,223478987,223479259
3613,5,12,149,5745,-74,-96,22,5e:36:fe:bc:a2:fe,223479777,240,278,223479537,223479777
3614,5,12,149,5745,-75,-96,21,f6:0a:5c:59:72:df,223487593,252,7564,223487341,223487593
3615,5,12,149,5745,-79,-96,17,56:68:e2:c2:8d:d5,223494449,476,6380,223493973,223494449
3616,5,12,149,5745,-71,-96,25,a6:92:ad:b7:76:65,223494986,456,81,223494530,223494986
3617,5,12,149,5745,-54,-96,42,5e:29:73:5b:30:00,223496858,272,1600,223496586,223496858
3618,5,12,149,5745,-59,-96,37,3e:d1:9b:c7:a4:de,223497174,544,-228,223496630,223497174
3619,5,12,149,5745,-53,-96,43,5e:29:73:5b:30:00,223497806,540,92,223497266,223497806
3620,5,12,149,5745,-73,-96,23,5e:36:fe:bc:a2:fe,223498689,240,643,223498449,223498689
3621,5,12,149,5745,-72,-96,24,02:31:8a:29:26:f4,223505641,268,6684,223505373,223505641
3622,5,12,149,5745,-75,-96,21,72:d1:72:1d:22:a1,223506962,452,869,223506510,223506962
3623,5,12,149,5745,-52,-96,44,f2:da:61:dd:98:c5,223507448,268,218,223507180,223507448
3624,5,12,149,5745,-76,-96,20,f6:0a:5c:59:72:df,223508492,252,792,223508240,223508492
3625,5,12,149,5745,-70,-96,26,fa:44:8d:e1:c7:1b,223509778,440,846,223509338,223509778
3626,5,12,149,5745,-65,-96,31,0a:b9:b7:b1:4d:fa,223510882,268,836,223510614,223510882
3627,5,12,149,5745,-53,-96,43,72:fd:09:2f:da:5f,223511221,480,-141,223510741,223511221
3628,5,12,149,5745,-77,-96,19,22:ec:75:a8:8a:31,223513590,516,1853,223513074,223513590
3629,5,6,149,5745,-87,-96,9,54:e4:3a:ec:fb:65,223522904,360,8954,223522544,223522904
3630,5,12,149,5745,-76,-96,20,22:ec:75:a8:8a:31,223525894,244,2746,223525650,223525894
3631,5,12,149,5745,-77,-96,19,56:68:e2:c2:8d:d5,223528035,280,1861,223527755,223528035
3632,5,12,149,5745,-70,-96,26,fa:44:8d:e1:c7:1b,223542553,244,14274,223542309,223542553
3633,5,12,149,5745,-72,-96,24,02:31:8a:29:26:f4,223544767,268,1946,223544499,223544767
3634,5,12,149,5745,-51,-96,45,f2:da:61:dd:98:c5,223545264,268,229,223544996,223545264
3635,5,12,149,5745,-61,-96,35,3e:d1:9b:c7:a4:de,223562297,544,16489,223561753,223562297
3636,5,12,149,5745,-76,-96,20,9a:24:38:da:96:bb,223570440,272,7871,223570168,223570440
3637,5,12,149,5745,-50,-96,46,72:fd:09:2f:da:5f,223586833,284,16109,223586549,223586833
3638,5,12,149,5745,-80,-96,16,72:d1:72:1d:22:a1,223589932,256,2843,223589676,223589932
3639,5,12,149,5745,-55,-96,41,5e:29:73:5b:30:00,223591833,272,1629,223591561,223591833
3640,5,12,149,5745,-63,-96,33,3e:d1:9b:c7:a4:de,223593534,272,1429,223593262,223593534
3641,5,12,149,5745,-72,-96,24,5e:36:fe:bc:a2:fe,223602571,240,8797,223602331,223602571
3642,5,12,149,5745,-72,-96,24,a6:92:ad:b7:76:65,223604884,256,2057,223604628,223604884
3643,5,6,149,5745,-88,-96,8,54:e4:3a:ec:fb:65,223625305,360,20061,223624945,223625305
3644,5,12,149,5745,-63,-96,33,3e:d1:9b:c7:a4:de,223627322,544,1473,223626778,223627322
3645,5,12,149,5745,-76,-96,20,22:ec:75:a8:8a:31,223634558,244,6992,223634314,223634558
3646,5,12,149,5745,-78,-96,18,56:68:e2:c2:8d:d5,223652541,280,17703,223652261,223652541
3647,5,12,149,5745,-70,-96,26,fa:44:8d:e1:c7:1b,223662559,244,9774,223662315,223662559
3648,5,12,149,5745,-62,-96,34,3e:d1:9b:c7:a4:de,223684590,272,21759,223684318,223684590
3649,5,12,149,5745,-75,-96,21,9a:24:38:da:96:bb,223686710,272,1848,223686438,223686710
3650,5,12,149,5745,-57,-96,39,5e:29:73:5b:30:00,223708687,272,21705,223708415,223708687
3651,5,12,149,5745,-54,-96,42,72:fd:09:2f:da:5f,223724374,284,15403,223724090,223724374
3652,5,12,149,5745,-68,-96,28,5e:36:fe:bc:a2:fe,223727315,240,2701,223727075,223727315
3653,5,6,149,5745,-90,-96,6,54:e4:3a:ec:fb:65,223727706,360,31,223727346,223727706
3654,5,12,149,5745,-70,-96,26,02:31:8a:29:26:f4,223728253,268,279,223727985,223728253
3655,5,12,149,5745,-49,-96,47,f2:da:61:dd:98:c5,223728635,268,114,223728367,223728635
3656,5,12,149,5745,-74,-96,22,a6:92:ad:b7:76:65,223750970,256,22079,223750714,223750970
3657,5,12,149,5745,-78,-96,18,22:ec:75:a8:8a:31,223751707,244,493,223751463,223751707
3658,5,12,149,5745,-83,-96,13,72:d1:72:1d:22:a1,223752409,256,446,223752153,223752409
3659,5,12,149,5745,-77,-96,19,56:68:e2:c2:8d:d5,223763862,280,11173,223763582,223763862
3660,5,12,149,5745,-76,-96,20,9a:24:38:da:96:bb,223794835,272,30701,223794563,223794835
3661,5,12,149,5745,-60,-96,36,3e:d1:9b:c7:a4:de,223796896,272,1789,223796624,223796896
3662,5,24,149,5745,-85,-96,11,,223822317,28,25393,223822289,223822317
3663,5,12,149,5745,-53,-96,43,5e:29:73:5b:30:00,223822369,272,-220,223822097,223822369
3664,5,12,149,5745,-89,-96,7,,223822689,36,284,223822653,223822689
3665,5,12,149,5745,-83,-96,13,,223822743,32,22,223822711,223822743
3666,5,12,149,5745,-84,-96,12,,223822861,44,74,223822817,223822861
3667,5,12,149,5745,-50,-96,46,72:fd:09:2f:da:5f,223827342,284,4197,223827058,223827342
3668,5,12,149,5745,-71,-96,25,5e:36:fe:bc:a2:fe,223829445,240,1863,223829205,223829445
3669,5,6,149,5745,-88,-96,8,54:e4:3a:ec:fb:65,223830107,360,302,223829747,223830107
3670,5,12,149,5745,-71,-96,25,02:31:8a:29:26:f4,223830692,268,317,223830424,223830692
3671,5,12,149,5745,-54,-96,42,f2:da:61:dd:98:c5,223831041,268,81,223830773,223831041
3672,5,12,149,5745,-72,-96,24,f6:0a:5c:59:72:df,223845392,252,14099,223845140,223845392
3673,5,12,149,5745,-73,-96,23,a6:92:ad:b7:76:65,223853283,256,7635,223853027,223853283
3674,5,12,149,5745,-72,-96,24,fa:44:8d:e1:c7:1b,223854706,244,1179,223854462,223854706
3675,5,12,149,5745,-78,-96,18,72:d1:72:1d:22:a1,223855155,256,193,223854899,223855155
3676,5,12,149,5745,-76,-96,20,56:68:e2:c2:8d:d5,223876831,280,21396,223876551,223876831
3677,5,12,149,5745,-72,-96,24,fa:44:8d:e1:c7:1b,223886291,244,9216,223886047,223886291
3678,5,12,149,5745,-76,-96,20,22:ec:75:a8:8a:31,223886605,244,70,223886361,223886605
3679,5,12,149,5745,-68,-96,28,02:31:8a:29:26:f4,223888325,268,1452,223888057,223888325
3680,5,12,149,5745,-51,-96,45,f2:da:61:dd:98:c5,223888700,268,107,223888432,223888700
3681,5,12,149,5745,-80,-96,16,9a:24:38:da:96:bb,223890692,824,1168,223889868,223890692
3682,5,12,149,5745,-71,-96,25,5e:36:fe:bc:a2:fe,223891595,240,663,223891355,223891595
3683,5,12,149,5745,-54,-96,42,5e:29:73:5b:30:00,223891869,540,-266,223891329,223891869
3684,5,12,149,5745,-59,-96,37,3e:d1:9b:c7:a4:de,223892452,544,39,223891908,223892452
3685,5,12,149,5745,-76,-96,20,56:68:e2:c2:8d:d5,223893031,476,103,223892555,223893031
3686,5,12,149,5745,-79,-96,17,72:d1:72:1d:22:a1,223900058,452,6575,223899606,223900058
3687,5,12,149,5745,-67,-96,29,02:31:8a:29:26:f4,223900555,268,229,223900287,223900555
3688,5,12,149,5745,-50,-96,46,f2:da:61:dd:98:c5,223901659,268,836,223901391,223901659
3689,5,12,149,5745,-72,-96,24,f6:0a:5c:59:72:df,223902006,252,95,223901754,223902006
3690,5,12,149,5745,-69,-96,27,fa:44:8d:e1:c7:1b,223902987,440,541,223902547,223902987
3691,5,12,149,5745,-72,-96,24,5e:36:fe:bc:a2:fe,223903497,152,358,223903345,223903497
3692,5,12,149,5745,-51,-96,45,72:fd:09:2f:da:5f,223905321,284,1540,223905037,223905321
3693,5,12,149,5745,-79,-96,17,9a:24:38:da:96:bb,223906377,272,784,223906105,223906377
3694,5,12,149,5745,-76,-96,20,22:ec:75:a8:8a:31,223908023,516,1130,223907507,223908023
3695,5,12,149,5745,-51,-96,45,72:fd:09:2f:da:5f,223908573,480,70,223908093,223908573
3696,5,12,149,5745,-59,-96,37,3e:d1:9b:c7:a4:de,223921242,272,12397,223920970,223921242
3697,5,12,149,5745,-76,-96,20,72:d1:72:1d:22:a1,223924178,256,2680,223923922,223924178
3698,5,6,149,5745,-85,-96,11,54:e4:3a:ec:fb:65,223932506,360,7968,223932146,223932506
3699,5,12,149,5745,-75,-96,21,5e:36:fe:bc:a2:fe,223938078,240,5332,223937838,223938078
3700,5,12,149,5745,-50,-96,46,5e:29:73:5b:30:00,223939793,272,1443,223939521,223939793
3701,5,12,149,5745,-73,-96,23,f6:0a:5c:59:72:df,223941575,252,1530,223941323,223941575
3702,5,12,149,5745,-73,-96,23,f6:0a:5c:59:72:df,223968565,252,26738,223968313,223968565
3703,5,24,149,5745,-77,-96,19,,223984190,28,15597,223984162,223984190
3704,5,12,149,5745,-75,-96,21,22:ec:75:a8:8a:31,223985818,244,1384,223985574,223985818
3705,5,24,149,5745,-79,-96,17,,223988801,28,2955,223988773,223988801
3706,5,24,149,5745,-76,-96,20,,223989532,28,703,223989504,223989532
3707,5,24,149,5745,-76,-96,20,,223989820,28,260,223989792,223989820
3708,5,24,149,5745,-78,-96,18,,223994597,28,4749,223994569,223994597
3709,5,24,149,5745,-76,-96,20,,223994935,28,310,223994907,223994935
3710,5,12,149,5745,-72,-96,24,fa:44:8d:e1:c7:1b,224003423,244,8244,224003179,224003423
3711,5,12,149,5745,-68,-96,28,02:31:8a:29:26:f4,224004479,268,788,224004211,224004479
3712,5,12,149,5745,-55,-96,41,f2:da:61:dd:98:c5,224005178,268,431,224004910,224005178
3713,5,12,149,5745,-78,-96,18,9a:24:38:da:96:bb,224017525,272,12075,224017253,224017525
3714,5,12,149,5745,-73,-96,23,5e:36:fe:bc:a2:fe,224022724,240,4959,224022484,224022724
3715,5,12,149,5745,-57,-96,39,3e:d1:9b:c7:a4:de,224023025,544,-243,224022481,224023025
3716,5,12,149,5745,-78,-96,18,9a:24:38:da:96:bb,224023631,824,-218,224022807,224023631
3717,5,12,149,5745,-53,-96,43,5e:29:73:5b:30:00,224024872,540,701,224024332,224024872
3718,5,12,149,5745,-68,-96,28,02:31:8a:29:26:f4,224030983,268,5843,224030715,224030983
3719,5,12,149,5745,-55,-96,41,f2:da:61:dd:98:c5,224032204,268,953,224031936,224032204
3720,5,12,149,5745,-75,-96,21,a6:92:ad:b7:76:65,224032515,456,-145,224032059,224032515
3721,5,12,149,5745,-73,-96,23,f6:0a:5c:59:72:df,224033059,252,292,224032807,224033059
3722,5,12,149,5745,-51,-96,45,72:fd:09:2f:da:5f,224033957,284,614,224033673,224033957
3723,5,6,149,5745,-87,-96,9,54:e4:3a:ec:fb:65,224034907,360,590,224034547,224034907
3724,5,12,149,5745,-66,-96,30,0a:b9:b7:b1:4d:fa,224035464,268,289,224035196,224035464
3725,5,12,149,5745,-71,-96,25,fa:44:8d:e1:c7:1b,224035793,440,-111,224035353,224035793
3726,5,12,149,5745,-57,-96,39,3e:d1:9b:c7:a4:de,224036294,272,229,224036022,224036294
3727,5,12,149,5745,-73,-96,23,5e:36:fe:bc:a2:fe,224052369,240,15835,224052129,224052369
3728,5,12,149,5745,-73,-96,23,f6:0a:5c:59:72:df,224053074,252,453,224052822,224053074
3729,5,12,149,5745,-53,-96,43,5e:29:73:5b:30:00,224053630,272,284,224053358,224053630
3730,5,12,149,5745,-78,-96,18,72:d1:72:1d:22:a1,224059640,256,5754,224059384,224059640
3731,5,12,149,5745,-77,-96,19,56:68:e2:c2:8d:d5,224061855,280,1935,224061575,224061855
3732,5,12,149,5745,-79,-96,17,d2:00:04:7e:2c:ab,224069433,244,7334,224069189,224069433
3733,5,12,149,5745,-79,-96,17,d2:00:04:7e:2c:ab,224084990,412,15145,224084578,224084990
3734,5,12,149,5745,-75,-96,21,22:ec:75:a8:8a:31,224099274,244,14040,224099030,224099274
3735,5,12,149,5745,-52,-96,44,f2:da:61:dd:98:c5,224115774,268,16232,224115506,224115774
3736,5,12,149,5745,-73,-96,23,fa:44:8d:e1:c7:1b,224121623,244,5605,224121379,224121623
3737,5,12,149,5745,-69,-96,27,02:31:8a:29:26:f4,224122747,268,856,224122479,224122747
3738,5,12,149,5745,-79,-96,17,9a:24:38:da:96:bb,224130628,272,7609,224130356,224130628
3739,5,6,149,5745,-88,-96,8,54:e4:3a:ec:fb:65,224137308,360,6320,224136948,224137308
3740,5,12,149,5745,-64,-96,32,3e:d1:9b:c7:a4:de,224139472,272,1892,224139200,224139472
3741,5,12,149,5745,-52,-96,44,72:fd:09:2f:da:5f,224146149,284,6393,224145865,224146149
3742,5,12,149,5745,-78,-96,18,72:d1:72:1d:22:a1,224162028,256,15623,224161772,224162028
3743,5,12,149,5745,-78,-96,18,56:68:e2:c2:8d:d5,224162910,280,602,224162630,224162910
3744,5,12,149,5745,-53,-96,43,5e:29:73:5b:30:00,224163795,272,613,224163523,224163795
3745,5,12,149,5745,-74,-96,22,22:ec:75:a8:8a:31,224216310,244,52271,224216066,224216310
3746,5,12,149,5745,-72,-96,24,02:31:8a:29:26:f4,224235484,268,18906,224235216,224235484
3747,5,6,149,5745,-88,-96,8,54:e4:3a:ec:fb:65,224239709,360,3865,224239349,224239709
3748,5,12,149,5745,-54,-96,42,f2:da:61:dd:98:c5,224240095,268,118,224239827,224240095
3749,5,12,149,5745,-68,-96,28,5e:36:fe:bc:a2:fe,224241352,240,1017,224241112,224241352
3750,5,12,149,5745,-61,-96,35,3e:d1:9b:c7:a4:de,224254503,272,12879,224254231,224254503
3751,5,12,149,5745,-72,-96,24,fa:44:8d:e1:c7:1b,224263909,244,9162,224263665,224263909
3752,5,12,149,5745,-80,-96,16,72:d1:72:1d:22:a1,224264338,256,173,224264082,224264338
3753,5,12,149,5745,-79,-96,17,56:68:e2:c2:8d:d5,224264734,280,116,224264454,224264734
3754,5,12,149,5745,-79,-96,17,d2:00:04:7e:2c:ab,224265498,244,520,224265254,224265498
3755,5,12,149,5745,-54,-96,42,5e:29:73:5b:30:00,224280592,272,14822,224280320,224280592
3756,5,12,149,5745,-73,-96,23,f6:0a:5c:59:72:df,224295619,252,14775,224295367,224295619
3757,5,12,149,5745,-73,-96,23,22:ec:75:a8:8a:31,224331797,244,35934,224331553,224331797
3758,5,12,149,5745,-52,-96,44,72:fd:09:2f:da:5f,224338804,284,6723,224338520,224338804
3759,5,6,149,5745,-86,-96,10,54:e4:3a:ec:fb:65,224342109,360,2945,224341749,224342109
3760,5,12,149,5745,-50,-96,46,f2:da:61:dd:98:c5,224342730,268,353,224342462,224342730
3761,5,12,149,5745,-68,-96,28,5e:36:fe:bc:a2:fe,224344326,240,1356,224344086,224344326
3762,5,12,149,5745,-73,-96,23,02:31:8a:29:26:f4,224348105,268,3511,224347837,224348105
3763,5,12,149,5745,-81,-96,15,9a:24:38:da:96:bb,224358754,272,10377,224358482,224358754
3764,5,12,149,5745,-74,-96,22,fa:44:8d:e1:c7:1b,224366069,244,7071,224365825,224366069
3765,5,12,149,5745,-79,-96,17,d2:00:04:7e:2c:ab,224366581,244,268,224366337,224366581
3766,5,12,149,5745,-80,-96,16,56:68:e2:c2:8d:d5,224367147,280,286,224366867,224367147
3767,5,12,149,5745,-61,-96,35,3e:d1:9b:c7:a4:de,224371697,272,4278,224371425,224371697
3768,5,12,149,5745,-79,-96,17,72:d1:72:1d:22:a1,224382753,256,10800,224382497,224382753
3769,5,12,149,5745,-54,-96,42,5e:29:73:5b:30:00,224398506,272,15481,224398234,224398506
3770,5,12,149,5745,-78,-96,18,d2:00:04:7e:2c:ab,224424924,244,26174,224424680,224424924
3771,5,12,149,5745,-80,-96,16,56:68:e2:c2:8d:d5,224437608,280,12404,224437328,224437608
3772,5,12,149,5745,-50,-96,46,72:fd:09:2f:da:5f,224440409,284,2517,224440125,224440409
3773,5,12,149,5745,-66,-96,30,5e:36:fe:bc:a2:fe,224443591,240,2942,224443351,224443591
3774,5,12,149,5745,-71,-96,25,22:ec:75:a8:8a:31,224443874,244,39,224443630,224443874
3775,5,6,149,5745,-85,-96,11,54:e4:3a:ec:fb:65,224444509,360,275,224444149,224444509
3776,5,12,149,5745,-77,-96,19,fa:44:8d:e1:c7:1b,224455160,244,10407,224454916,224455160
3777,5,12,149,5745,-72,-96,24,02:31:8a:29:26:f4,224463512,268,8084,224463244,224463512
3778,5,12,149,5745,-53,-96,43,f2:da:61:dd:98:c5,224464140,268,360,224463872,224464140
3779,5,12,149,5745,-79,-96,17,9a:24:38:da:96:bb,224466846,272,2434,224466574,224466846
3780,5,12,149,5745,-80,-96,16,56:68:e2:c2:8d:d5,224477671,476,10349,224477195,224477671
3781,5,12,149,5745,-48,-96,48,72:fd:09:2f:da:5f,224478870,284,915,224478586,224478870
3782,5,12,149,5745,-66,-96,30,5e:36:fe:bc:a2:fe,224481064,240,1954,224480824,224481064
3783,5,12,149,5745,-55,-96,41,5e:29:73:5b:30:00,224481356,540,-248,224480816,224481356
3784,5,12,149,5745,-61,-96,35,3e:d1:9b:c7:a4:de,224481939,544,39,224481395,224481939
3785,5,12,149,5745,-77,-96,19,d2:00:04:7e:2c:ab,224483021,440,642,224482581,224483021
3786,5,12,149,5745,-72,-96,24,22:ec:75:a8:8a:31,224484144,516,607,224483628,224484144
3787,5,12,149,5745,-73,-96,23,02:31:8a:29:26:f4,224490050,268,5638,224489782,224490050
3788,5,12,149,5745,-52,-96,44,f2:da:61:dd:98:c5,224491308,268,990,224491040,224491308
3789,5,12,149,5745,-79,-96,17,72:d1:72:1d:22:a1,224491619,452,-141,224491167,224491619
3790,5,12,149,5745,-50,-96,46,72:fd:09:2f:da:5f,224494283,480,2184,224493803,224494283
3791,5,12,149,5745,-60,-96,36,3e:d1:9b:c7:a4:de,224494842,272,287,224494570,224494842
3792,5,12,149,5745,-67,-96,29,5e:36:fe:bc:a2:fe,224495159,240,77,224494919,224495159
3793,5,12,149,5745,-72,-96,24,f6:0a:5c:59:72:df,224495486,252,75,224495234,224495486
3794,5,12,149,5745,-77,-96,19,fa:44:8d:e1:c7:1b,224497214,440,1288,224496774,224497214
3795,5,12,149,5745,-72,-96,24,f6:0a:5c:59:72:df,224507280,252,9814,224507028,224507280
3796,5,12,149,5745,-77,-96,19,d2:00:04:7e:2c:ab,224528234,244,20710,224527990,224528234
3797,5,12,149,5745,-53,-96,43,5e:29:73:5b:30:00,224529034,272,528,224528762,224529034
3798,5,12,149,5745,-82,-96,14,9a:24:38:da:96:bb,224544962,824,15104,224544138,224544962
3799,5,12,149,5745,-67,-96,29,5e:36:fe:bc:a2:fe,224546298,240,1096,224546058,224546298
3800,5,12,149,5745,-53,-96,43,5e:29:73:5b:30:00,224546609,540,-229,224546069,224546609
3801,5,6,149,5745,-87,-96,9,54:e4:3a:ec:fb:65,224547180,360,211,224546820,224547180
3802,5,12,149,5745,-77,-96,19,d2:00:04:7e:2c:ab,224548121,440,501,224547681,224548121
3803,5,12,149,5745,-72,-96,24,22:ec:75:a8:8a:31,224548724,516,87,224548208,224548724
3804,5,12,149,5745,-60,-96,36,3e:d1:9b:c7:a4:de,224549274,544,6,224548730,224549274
3805,5,12,149,5745,-74,-96,22,02:31:8a:29:26:f4,224554007,268,4465,224553739,224554007
3806,5,12,149,5745,-79,-96,17,72:d1:72:1d:22:a1,224555246,452,787,224554794,224555246
3807,5,12,149,5745,-81,-96,15,a6:92:ad:b7:76:65,224555732,456,30,224555276,224555732
3808,5,12,149,5745,-51,-96,45,f2:da:61:dd:98:c5,224556233,268,233,224555965,224556233
3809,5,12,149,5745,-64,-96,32,0a:b9:b7:b1:4d:fa,224558056,268,1555,224557788,224558056
3810,5,12,149,5745,-48,-96,48,72:fd:09:2f:da:5f,224559510,480,974,224559030,224559510
3811,5,12,149,5745,-74,-96,22,02:31:8a:29:26:f4,224560071,268,293,224559803,224560071
3812,5,12,149,5745,-73,-96,23,fa:44:8d:e1:c7:1b,224560419,244,104,224560175,224560419
3813,5,12,149,5745,-51,-96,45,f2:da:61:dd:98:c5,224560753,268,66,224560485,224560753
3814,5,12,149,5745,-79,-96,17,56:68:e2:c2:8d:d5,224563162,476,1933,224562686,224563162
3815,5,12,149,5745,-75,-96,21,f6:0a:5c:59:72:df,224563671,252,257,224563419,224563671
3816,5,12,149,5745,-73,-96,23,fa:44:8d:e1:c7:1b,224564166,440,55,224563726,224564166
3817,5,12,149,5745,-77,-96,19,d2:00:04:7e:2c:ab,224566394,380,1848,224566014,224566394
3818,5,24,149,5745,-73,-96,23,,224567073,28,651,224567045,224567073
3819,5,24,149,5745,-87,-96,9,,224567118,28,17,224567090,224567118
3820,5,24,149,5745,-87,-96,9,,224567226,28,80,224567198,224567226
3821,5,12,149,5745,-72,-96,24,22:ec:75:a8:8a:31,224574452,244,6982,224574208,224574452
3822,5,12,149,5745,-84,-96,12,9a:24:38:da:96:bb,224578901,272,4177,224578629,224578901
3823,5,12,149,5745,-48,-96,48,72:fd:09:2f:da:5f,224594435,284,15250,224594151,224594435
3824,5,12,149,5745,-59,-96,37,3e:d1:9b:c7:a4:de,224596710,272,2003,224596438,224596710
3825,5,12,149,5745,-78,-96,18,d2:00:04:7e:2c:ab,224613293,440,16143,224612853,224613293
3826,5,12,149,5745,-66,-96,30,5e:36:fe:bc:a2:fe,224624208,240,10675,224623968,224624208
3827,5,12,149,5745,-52,-96,44,5e:29:73:5b:30:00,224627190,272,2710,224626918,224627190
3828,5,12,149,5745,-72,-96,24,f6:0a:5c:59:72:df,224633206,252,5764,224632954,224633206
3829,5,12,149,5745,-78,-96,18,d2:00:04:7e:2c:ab,224641800,244,8350,224641556,224641800
3830,5,6,149,5745,-87,-96,9,54:e4:3a:ec:fb:65,224649310,360,7150,224648950,224649310
3831,5,12,149,5745,-78,-96,18,56:68:e2:c2:8d:d5,224665089,280,15499,224664809,224665089
3832,5,12,149,5745,-73,-96,23,fa:44:8d:e1:c7:1b,224681041,244,15708,224680797,224681041
3833,5,12,149,5745,-84,-96,12,9a:24:38:da:96:bb,224691558,272,10245,224691286,224691558
3834,5,12,149,5745,-58,-96,38,3e:d1:9b:c7:a4:de,224714232,272,22402,224713960,224714232
3835,5,12,149,5745,-52,-96,44,5e:29:73:5b:30:00,224741028,272,26524,224740756,224741028
3836,5,12,149,5745,-47,-96,49,72:fd:09:2f:da:5f,224748906,284,7594,224748622,224748906
3837,5,6,149,5745,-87,-96,9,54:e4:3a:ec:fb:65,224751711,360,2445,224751351,224751711
3838,5,12,149,5745,-72,-96,24,02:31:8a:29:26:f4,224752480,268,501,224752212,224752480
3839,5,12,149,5745,-48,-96,48,f2:da:61:dd:98:c5,224752973,268,225,224752705,224752973
3840,5,12,149,5745,-72,-96,24,f6:0a:5c:59:72:df,224753332,252,107,224753080,224753332
3841,5,12,149,5745,-67,-96,29,5e:36:fe:bc:a2:fe,224753618,240,46,224753378,224753618
3842,5,12,149,5745,-80,-96,16,d2:00:04:7e:2c:ab,224763481,244,9619,224763237,224763481
3843,5,12,149,5745,-81,-96,15,56:68:e2:c2:8d:d5,224774369,280,10608,224774089,224774369
3844,5,12,149,5745,-77,-96,19,72:d1:72:1d:22:a1,224776444,256,1819,224776188,224776444
3845,5,12,149,5745,-73,-96,23,fa:44:8d:e1:c7:1b,224791672,244,14984,224791428,224791672
3846,5,12,149,5745,-80,-96,16,9a:24:38:da:96:bb,224806739,272,14795,224806467,224806739
3847,5,12,149,5745,-56,-96,40,3e:d1:9b:c7:a4:de,224831204,272,24193,224830932,224831204
3848,5,12,149,5745,-47,-96,49,72:fd:09:2f:da:5f,224851305,284,19817,224851021,224851305
3849,5,6,149,5745,-88,-96,8,54:e4:3a:ec:fb:65,224854112,360,2447,224853752,224854112
3850,5,12,149,5745,-73,-96,23,02:31:8a:29:26:f4,224854540,268,160,224854272,224854540
3851,5,12,149,5745,-69,-96,27,5e:36:fe:bc:a2:fe,224854852,240,72,224854612,224854852
3852,5,12,149,5745,-48,-96,48,f2:da:61:dd:98:c5,224855137,268,17,224854869,224855137
3853,5,12,149,5745,-54,-96,42,5e:29:73:5b:30:00,224858931,272,3522,224858659,224858931
3854,5,12,149,5745,-81,-96,15,d2:00:04:7e:2c:ab,224875107,244,15932,224874863,224875107
3855,5,12,149,5745,-78,-96,18,72:d1:72:1d:22:a1,224879077,256,3714,224878821,224879077
3856,5,12,149,5745,-78,-96,18,56:68:e2:c2:8d:d5,224887304,280,7947,224887024,224887304
3857,5,12,149,5745,-48,-96,48,f2:da:61:dd:98:c5,224904655,268,17083,224904387,224904655
3858,5,12,149,5745,-72,-96,24,fa:44:8d:e1:c7:1b,224910067,244,5168,224909823,224910067
3859,5,12,149,5745,-73,-96,23,02:31:8a:29:26:f4,224912480,268,2145,224912212,224912480
3860,5,12,149,5745,-79,-96,17,9a:24:38:da:96:bb,224914240,272,1488,224913968,224914240
3861,5,12,149,5745,-77,-96,19,72:d1:72:1d:22:a1,224937333,256,22837,224937077,224937333
3862,5,12,149,5745,-48,-96,48,72:fd:09:2f:da:5f,224937639,284,22,224937355,224937639
3863,5,12,149,5745,-81,-96,15,9a:24:38:da:96:bb,224938405,824,-58,224937581,224938405
3864,5,12,149,5745,-75,-96,21,22:ec:75:a8:8a:31,224941876,516,2955,224941360,224941876
3865,5,12,149,5745,-72,-96,24,5e:36:fe:bc:a2:fe,224942623,240,507,224942383,224942623
3866,5,12,149,5745,-81,-96,15,d2:00:04:7e:2c:ab,224942997,440,-66,224942557,224942997
3867,5,12,149,5745,-57,-96,39,3e:d1:9b:c7:a4:de,224944032,544,491,224943488,224944032
3868,5,12,149,5745,-48,-96,48,72:fd:09:2f:da:5f,224950154,480,5642,224949674,224950154
3869,5,12,149,5745,-72,-96,24,02:31:8a:29:26:f4,224950670,268,248,224950402,224950670
3870,5,12,149,5745,-77,-96,19,72:d1:72:1d:22:a1,224950991,452,-131,224950539,224950991
3871,5,12,149,5745,-54,-96,42,5e:29:73:5b:30:00,224952026,540,495,224951486,224952026
3872,5,12,149,5745,-72,-96,24,5e:36:fe:bc:a2:fe,224953467,240,1201,224953227,224953467
3873,5,12,149,5745,-57,-96,39,3e:d1:9b:c7:a4:de,224953777,272,38,224953505,224953777
3874,5,12,149,5745,-72,-96,24,f6:0a:5c:59:72:df,224954479,252,450,224954227,224954479
3875,5,12,149,5745,-50,-96,46,f2:da:61:dd:98:c5,224955854,268,1107,224955586,224955854
3876,5,6,149,5745,-87,-96,9,54:e4:3a:ec:fb:65,224956512,360,298,224956152,224956512
3877,5,12,149,5745,-72,-96,24,fa:44:8d:e1:c7:1b,224957353,440,401,224956913,224957353
3878,5,12,149,5745,-77,-96,19,56:68:e2:c2:8d:d5,224958610,476,781,224958134,224958610
3879,5,12,149,5745,-71,-96,25,f6:0a:5c:59:72:df,224964565,252,5703,224964313,224964565
3880,5,12,149,5745,-81,-96,15,d2:00:04:7e:2c:ab,224986921,244,22112,224986677,224986921
3881,5,12,149,5745,-77,-96,19,56:68:e2:c2:8d:d5,224987226,280,25,224986946,224987226
3882,5,12,149,5745,-54,-96,42,5e:29:73:5b:30:00,224988477,272,979,224988205,224988477
3883,5,12,149,5745,-80,-96,16,d2:00:04:7e:2c:ab,225006460,440,17543,225006020,225006460
3884,5,12,149,5745,-74,-96,22,22:ec:75:a8:8a:31,225011772,244,5068,225011528,225011772
3885,5,12,149,5745,-51,-96,45,f2:da:61:dd:98:c5,225017053,268,5013,225016785,225017053
3886,5,12,149,5745,-72,-96,24,fa:44:8d:e1:c7:1b,225019416,244,2119,225019172,225019416
3887,5,12,149,5745,-74,-96,22,f6:0a:5c:59:72:df,225019811,252,143,225019559,225019811
3888,5,12,149,5745,-72,-96,24,a6:92:ad:b7:76:65,225021097,456,830,225020641,225021097
3889,5,12,149,5745,-74,-96,22,02:31:8a:29:26:f4,225024876,268,3511,225024608,225024876
3890,5,12,149,5745,-49,-96,47,72:fd:09:2f:da:5f,225049043,284,23883,225048759,225049043
3891,5,12,149,5745,-72,-96,24,a6:92:ad:b7:76:65,225050963,256,1664,225050707,225050963
3892,5,6,149,5745,-86,-96,10,54:e4:3a:ec:fb:65,225058913,360,7590,225058553,225058913
3893,5,12,149,5745,-79,-96,17,72:d1:72:1d:22:a1,225062477,256,3308,225062221,225062477
3894,5,12,149,5745,-58,-96,38,3e:d1:9b:c7:a4:de,225068102,272,5353,225067830,225068102
3895,5,12,149,5745,-70,-96,26,5e:36:fe:bc:a2:fe,225068446,240,104,225068206,225068446
3896,5,12,149,5745,-79,-96,17,d2:00:04:7e:2c:ab,225071942,440,3056,225071502,225071942
3897,5,12,149,5745,-69,-96,27,5e:36:fe:bc:a2:fe,225072956,240,774,225072716,225072956
3898,5,12,149,5745,-63,-96,33,0a:b9:b7:b1:4d:fa,225073258,268,34,225072990,225073258
3899,5,12,149,5745,-74,-96,22,22:ec:75:a8:8a:31,225075972,516,2198,225075456,225075972
3900,5,12,149,5745,-58,-96,38,3e:d1:9b:c7:a4:de,225076531,544,15,225075987,225076531
3901,5,12,149,5745,-74,-96,22,f6:0a:5c:59:72:df,225077118,252,335,225076866,225077118
3902,5,12,149,5745,-55,-96,41,5e:29:73:5b:30:00,225080833,540,3175,225080293,225080833
3903,5,12,149,5745,-74,-96,22,02:31:8a:29:26:f4,225081409,268,308,225081141,225081409
3904,5,12,149,5745,-74,-96,22,f6:0a:5c:59:72:df,225086384,252,4723,225086132,225086384
3905,5,12,149,5745,-71,-96,25,a6:92:ad:b7:76:65,225086778,456,-62,225086322,225086778
3906,5,12,149,5745,-80,-96,16,9a:24:38:da:96:bb,225088517,824,915,225087693,225088517
3907,5,12,149,5745,-52,-96,44,f2:da:61:dd:98:c5,225089375,268,590,225089107,225089375
3908,5,12,149,5745,-73,-96,23,fa:44:8d:e1:c7:1b,225092674,440,2859,225092234,225092674
3909,5,6,149,5745,-72,-96,24,74:a2:e6:07:0d:f0,225098995,168,6153,225098827,225098995
3910,5,12,149,5745,-78,-96,18,d2:00:04:7e:2c:ab,225100557,244,1318,225100313,225100557
3911,5,12,149,5745,-55,-96,41,5e:29:73:5b:30:00,225102203,272,1374,225101931,225102203
3912,5,6,149,5745,-74,-96,22,74:a2:e6:07:0d:f0,225106563,132,4228,225106431,225106563
3913,5,12,149,5745,-81,-96,15,9a:24:38:da:96:bb,225115071,272,8236,225114799,225115071
3914,5,12,149,5745,-73,-96,23,fa:44:8d:e1:c7:1b,225117688,244,2373,225117444,225117688
3915,5,12,149,5745,-53,-96,43,f2:da:61:dd:98:c5,225117995,268,39,225117727,225117995
3916,5,12,149,5745,-73,-96,23,22:ec:75:a8:8a:31,225125850,244,7611,225125606,225125850
3917,5,12,149,5745,-78,-96,18,d2:00:04:7e:2c:ab,225137531,440,11241,225137091,225137531
3918,5,12,149,5745,-73,-96,23,02:31:8a:29:26:f4,225144640,268,6841,225144372,225144640
3919,5,24,149,5745,-74,-96,22,,225158522,28,13854,225158494,225158522
3920,5,6,149,5745,-87,-96,9,54:e4:3a:ec:fb:65,225161313,360,2431,225160953,225161313
3921,5,12,149,5745,-54,-96,42,72:fd:09:2f:da:5f,225162866,284,1269,225162582,225162866
3922,5,12,149,5745,-58,-96,38,3e:d1:9b:c7:a4:de,225169339,272,6201,225169067,225169339
3923,5,24,149,5745,-76,-96,20,,225170962,28,1595,225170934,225170962
3924,5,12,149,5745,-73,-96,23,a6:92:ad:b7:76:65,225173042,256,1824,225172786,225173042
3925,5,6,149,5745,-74,-96,22,,225180300,52,7206,225180248,225180300
3926,5,6,149,5745,-88,-96,8,,225180369,44,25,225180325,225180369
3927,5,12,149,5745,-80,-96,16,72:d1:72:1d:22:a1,225186157,256,5532,225185901,225186157
3928,5,12,149,5745,-79,-96,17,56:68:e2:c2:8d:d5,225188148,280,1711,225187868,225188148
3929,5,12,149,5745,-72,-96,24,f6:0a:5c:59:72:df,225200164,252,11764,225199912,225200164
3930,5,12,149,5745,-55,-96,41,5e:29:73:5b:30:00,225200667,272,231,225200395,225200667
3931,5,12,149,5745,-79,-96,17,d2:00:04:7e:2c:ab,225214044,244,13133,225213800,225214044
3932,5,12,149,5745,-72,-96,24,22:ec:75:a8:8a:31,225241547,244,27259,225241303,225241547
3933,5,12,149,5745,-73,-96,23,fa:44:8d:e1:c7:1b,225244639,244,2848,225244395,225244639
3934,5,12,149,5745,-72,-96,24,02:31:8a:29:26:f4,225250447,268,5540,225250179,225250447
3935,5,6,149,5745,-87,-96,9,54:e4:3a:ec:fb:65,225263713,360,12906,225263353,225263713
3936,5,12,149,5745,-54,-96,42,f2:da:61:dd:98:c5,225264371,268,390,225264103,225264371
3937,5,12,149,5745,-67,-96,29,5e:36:fe:bc:a2:fe,225265253,240,642,225265013,225265253
3938,5,12,149,5745,-57,-96,39,72:fd:09:2f:da:5f,225272771,284,7234,225272487,225272771
3939,5,12,149,5745,-73,-96,23,a6:92:ad:b7:76:65,225286129,256,13102,225285873,225286129
3940,5,12,149,5745,-57,-96,39,3e:d1:9b:c7:a4:de,225287331,272,930,225287059,225287331
3941,5,12,149,5745,-82,-96,14,72:d1:72:1d:22:a1,225288534,256,947,225288278,225288534
3942,5,12,149,5745,-81,-96,15,56:68:e2:c2:8d:d5,225290387,280,1573,225290107,225290387
3943,5,12,149,5745,-55,-96,41,5e:29:73:5b:30:00,225317711,272,27052,225317439,225317711
3944,5,12,149,5745,-80,-96,16,9a:24:38:da:96:bb,225344303,272,26320,225344031,225344303
3945,5,12,149,5745,-72,-96,24,22:ec:75:a8:8a:31,225358204,244,13657,225357960,225358204
3946,5,12,149,5745,-69,-96,27,02:31:8a:29:26:f4,225363378,268,4906,225363110,225363378
3947,5,6,149,5745,-90,-96,6,54:e4:3a:ec:fb:65,225366114,360,2376,225365754,225366114
3948,5,12,149,5745,-53,-96,43,f2:da:61:dd:98:c5,225366736,268,354,225366468,225366736
3949,5,12,149,5745,-68,-96,28,5e:36:fe:bc:a2:fe,225368329,240,1353,225368089,225368329
3950,5,12,149,5745,-74,-96,22,fa:44:8d:e1:c7:1b,225390070,244,21497,225389826,225390070
3951,5,12,149,5745,-79,-96,17,56:68:e2:c2:8d:d5,225391719,280,1369,225391439,225391719
3952,5,12,149,5745,-79,-96,17,d2:00:04:7e:2c:ab,225392349,244,386,225392105,225392349
3953,5,12,149,5745,-75,-96,21,a6:92:ad:b7:76:65,225398408,256,5803,225398152,225398408
3954,5,12,149,5745,-56,-96,40,3e:d1:9b:c7:a4:de,225404326,272,5646,225404054,225404326
3955,5,12,149,5745,-80,-96,16,72:d1:72:1d:22:a1,225406884,256,2302,225406628,225406884
3956,5,12,149,5745,-53,-96,43,5e:29:73:5b:30:00,225432490,272,25334,225432218,225432490
3957,5,12,149,5745,-48,-96,48,72:fd:09:2f:da:5f,225464414,284,31640,225464130,225464414
3958,5,12,149,5745,-70,-96,26,5e:36:fe:bc:a2:fe,225468392,240,3738,225468152,225468392
3959,5,6,149,5745,-88,-96,8,54:e4:3a:ec:fb:65,225468742,360,-10,225468382,225468742
3960,5,12,149,5745,-54,-96,42,f2:da:61:dd:98:c5,225469166,268,156,225468898,225469166
3961,5,12,149,5745,-71,-96,25,22:ec:75:a8:8a:31,225470622,244,1212,225470378,225470622
3962,5,12,149,5745,-67,-96,29,02:31:8a:29:26:f4,225475275,268,4385,225475007,225475275
3963,5,12,149,5745,-72,-96,24,fa:44:8d:e1:c7:1b,225492139,244,16620,225491895,225492139
3964,5,12,149,5745,-80,-96,16,d2:00:04:7e:2c:ab,225493184,244,801,225492940,225493184
3965,5,12,149,5745,-76,-96,20,56:68:e2:c2:8d:d5,225494431,280,967,225494151,225494431
3966,5,12,149,5745,-49,-96,47,72:fd:09:2f:da:5f,225500322,284,5607,225500038,225500322
3967,5,12,149,5745,-76,-96,20,a6:92:ad:b7:76:65,225508493,256,7915,225508237,225508493
3968,5,12,149,5745,-79,-96,17,72:d1:72:1d:22:a1,225513449,256,4700,225513193,225513449
3969,5,12,149,5745,-69,-96,27,5e:36:fe:bc:a2:fe,225526879,240,13190,225526639,225526879
3970,5,12,149,5745,-58,-96,38,3e:d1:9b:c7:a4:de,225527198,272,47,225526926,225527198
3971,5,12,149,5745,-69,-96,27,02:31:8a:29:26:f4,225529513,268,2047,225529245,225529513
3972,5,12,149,5745,-81,-96,15,d2:00:04:7e:2c:ab,225531027,440,1074,225530587,225531027
3973,5,12,149,5745,-74,-96,22,f6:0a:5c:59:72:df,225531927,252,648,225531675,225531927
3974,5,12,149,5745,-58,-96,38,3e:d1:9b:c7:a4:de,225532259,544,-212,225531715,225532259
3975,5,12,149,5745,-69,-96,27,5e:36:fe:bc:a2:fe,225532847,240,348,225532607,225532847
3976,5,12,149,5745,-76,-96,20,22:ec:75:a8:8a:31,225533122,516,-241,225532606,225533122
3977,5,12,149,5745,-51,-96,45,72:fd:09:2f:da:5f,225538028,480,4426,225537548,225538028
3978,5,12,149,5745,-55,-96,41,5e:29:73:5b:30:00,225539451,540,883,225538911,225539451
3979,5,12,149,5745,-79,-96,17,d2:00:04:7e:2c:ab,225542995,244,3300,225542751,225542995
3980,5,12,149,5745,-73,-96,23,f6:0a:5c:59:72:df,225546526,252,3279,225546274,225546526
3981,5,12,149,5745,-76,-96,20,a6:92:ad:b7:76:65,225547289,456,307,225546833,225547289
3982,5,12,149,5745,-70,-96,26,fa:44:8d:e1:c7:1b,225547790,440,61,225547350,225547790
3983,5,12,149,5745,-56,-96,40,f2:da:61:dd:98:c5,225548822,268,764,225548554,225548822
3984,5,12,149,5745,-75,-96,21,56:68:e2:c2:8d:d5,225550789,476,1491,225550313,225550789
3985,5,12,149,5745,-80,-96,16,72:d1:72:1d:22:a1,225551337,452,96,225550885,225551337
3986,5,12,149,5745,-76,-96,20,56:68:e2:c2:8d:d5,225559671,280,8054,225559391,225559671
3987,5,12,149,5745,-55,-96,41,5e:29:73:5b:30:00,225560939,272,996,225560667,225560939
3988,5,6,149,5745,-73,-96,23,,225564539,52,3548,225564487,225564539
3989,5,6,149,5745,-89,-96,7,,225564607,44,24,225564563,225564607
3990,5,12,149,5745,-80,-96,16,9a:24:38:da:96:bb,225564883,272,4,225564611,225564883
3991,5,6,149,5745,-86,-96,10,54:e4:3a:ec:fb:65,225570915,360,5672,225570555,225570915
3992,5,12,149,5745,-64,-96,32,02:31:8a:29:26:f4,225576019,268,4836,225575751,225576019
3993,5,12,149,5745,-70,-96,26,fa:44:8d:e1:c7:1b,225576377,244,114,225576133,225576377
3994,5,12,149,5745,-56,-96,40,f2:da:61:dd:98:c5,225576691,268,46,225576423,225576691
3995,5,12,149,5745,-76,-96,20,22:ec:75:a8:8a:31,225590313,244,13378,225590069,225590313
3996,5,12,149,5745,-64,-96,32,02:31:8a:29:26:f4,225592762,268,2181,225592494,225592762
3997,5,12,149,5745,-79,-96,17,d2:00:04:7e:2c:ab,225596268,440,3066,225595828,225596268
3998,5,12,149,5745,-70,-96,26,5e:36:fe:bc:a2:fe,225596859,240,351,225596619,225596859
3999,5,12,149,5745,-76,-96,20,22:ec:75:a8:8a:31,225597772,516,397,225597256,225597772
4000,5,12,149,5745,-63,-96,33,3e:d1:9b:c7:a4:de,225598377,544,61,225597833,225598377
4001,5,12,149,5745,-68,-96,28,0a:b9:b7:b1:4d:fa,225599180,268,535,225598912,225599180
4002,5,12,149,5745,-55,-96,41,72:fd:09:2f:da:5f,225603091,480,3431,225602611,225603091
4003,5,12,149,5745,-56,-96,40,5e:29:73:5b:30:00,225605428,540,1797,225604888,225605428
4004,5,12,149,5745,-74,-96,22,a6:92:ad:b7:76:65,225607793,256,2109,225607537,225607793
4005,5,12,149,5745,-55,-96,41,72:fd:09:2f:da:5f,225609404,284,1327,225609120,225609404
4006,5,12,149,5745,-80,-96,16,d2:00:04:7e:2c:ab,225609758,104,250,225609654,225609758
4007,5,12,149,5745,-56,-96,40,f2:da:61:dd:98:c5,225610913,268,887,225610645,225610913
4008,5,12,149,5745,-74,-96,22,a6:92:ad:b7:76:65,225611251,456,-118,225610795,225611251
4009,5,12,149,5745,-76,-96,20,56:68:e2:c2:8d:d5,225611786,476,59,225611310,225611786
4010,5,12,149,5745,-73,-96,23,fa:44:8d:e1:c7:1b,225613387,440,1161,225612947,225613387
4011,5,12,149,5745,-77,-96,19,72:d1:72:1d:22:a1,225614970,452,1131,225614518,225614970
4012,5,12,149,5745,-78,-96,18,72:d1:72:1d:22:a1,225625410,256,10184,225625154,225625410
4013,5,12,149,5745,-72,-96,24,5e:36:fe:bc:a2:fe,225642017,240,16367,225641777,225642017
4014,5,12,149,5745,-62,-96,34,3e:d1:9b:c7:a4:de,225642436,272,147,225642164,225642436
4015,5,12,149,5745,-55,-96,41,5e:29:73:5b:30:00,225657072,272,14364,225656800,225657072
4016,5,12,149,5745,-79,-96,17,d2:00:04:7e:2c:ab,225657613,244,297,225657369,225657613
4017,5,12,149,5745,-78,-96,18,d2:00:04:7e:2c:ab,225661798,440,3745,225661358,225661798
4018,5,6,149,5745,-88,-96,8,54:e4:3a:ec:fb:65,225669404,352,7254,225669052,225669404
4019,5,6,149,5745,-89,-96,7,54:e4:3a:ec:fb:65,225673316,360,3552,225672956,225673316
4020,5,12,149,5745,-69,-96,27,f6:0a:5c:59:72:df,225673793,252,225,225673541,225673793
4021,5,12,149,5745,-74,-96,22,56:68:e2:c2:8d:d5,225677094,280,3021,225676814,225677094
4022,5,12,149,5745,-79,-96,17,9a:24:38:da:96:bb,225677753,272,387,225677481,225677753
4023,5,6,149,5745,-88,-96,8,54:e4:3a:ec:fb:65,225689684,352,11579,225689332,225689684
4024,5,12,149,5745,-74,-96,22,fa:44:8d:e1:c7:1b,225690549,244,621,225690305,225690549
4025,5,12,149,5745,-74,-96,22,fa:44:8d:e1:c7:1b,225697055,440,6066,225696615,225697055
4026,5,12,149,5745,-72,-96,24,22:ec:75:a8:8a:31,225699767,244,2468,225699523,225699767
4027,5,12,149,5745,-72,-96,24,fa:44:8d:e1:c7:1b,225728776,440,28569,225728336,225728776
4028,5,12,149,5745,-54,-96,42,5e:29:73:5b:30:00,225738359,540,9043,225737819,225738359
4029,5,12,149,5745,-61,-96,35,3e:d1:9b:c7:a4:de,225744579,272,5948,225744307,225744579
4030,5,24,149,5745,-79,-96,17,,225751735,32,7124,225751703,225751735
4031,5,24,149,5745,-78,-96,18,,225752057,32,290,225752025,225752057
4032,5,24,149,5745,-79,-96,17,,225752974,28,889,225752946,225752974
4033,5,24,149,5745,-78,-96,18,,225753452,28,450,225753424,225753452
4034,5,24,149,5745,-80,-96,16,,225753937,28,457,225753909,225753937
4035,5,12,149,5745,-58,-96,38,72:fd:09:2f:da:5f,225771808,284,17587,225771524,225771808
4036,5,6,149,5745,-91,-96,5,54:e4:3a:ec:fb:65,225775716,360,3548,225775356,225775716
4037,5,12,149,5745,-53,-96,43,f2:da:61:dd:98:c5,225776182,268,198,225775914,225776182
4038,5,12,149,5745,-64,-96,32,02:31:8a:29:26:f4,225776558,268,108,225776290,225776558
4039,5,12,149,5745,-66,-96,30,5e:36:fe:bc:a2:fe,225777400,240,602,225777160,225777400
4040,5,12,149,5745,-79,-96,17,d2:00:04:7e:2c:ab,225777978,244,334,225777734,225777978
4041,5,6,149,5745,-58,-96,38,20:c1:9b:ff:3b:83,225780283,204,2101,225780079,225780283
4042,5,6,149,5745,-90,-96,6,54:e4:3a:ec:fb:65,225780637,352,2,225780285,225780637
4043,5,6,149,5745,-58,-96,38,,225781005,44,324,225780961,225781005
4044,5,12,149,5745,-53,-96,43,5e:29:73:5b:30:00,225790392,272,9115,225790120,225790392
4045,5,12,149,5745,-76,-96,20,9a:24:38:da:96:bb,225792975,272,2311,225792703,225792975
4046,5,12,149,5745,-72,-96,24,fa:44:8d:e1:c7:1b,225794451,440,1036,225794011,225794451
4047,5,6,149,5745,-57,-96,39,20:c1:9b:ff:3b:83,225795317,204,662,225795113,225795317
4048,5,6,149,5745,-88,-96,8,54:e4:3a:ec:fb:65,225795695,352,26,225795343,225795695
4049,5,6,149,5745,-57,-96,39,,225796063,44,324,225796019,225796063
4050,5,12,149,5745,-74,-96,22,a6:92:ad:b7:76:65,225799310,256,2991,225799054,225799310
4051,5,12,149,5745,-81,-96,15,72:d1:72:1d:22:a1,225799689,256,123,225799433,225799689
4052,5,12,149,5745,-75,-96,21,56:68:e2:c2:8d:d5,225802488,280,2519,225802208,225802488
4053,5,12,149,5745,-51,-96,45,5e:29:73:5b:30:00,225803828,540,800,225803288,225803828
4054,5,12,149,5745,-71,-96,25,fa:44:8d:e1:c7:1b,225805719,244,1647,225805475,225805719
4055,5,12,149,5745,-76,-96,20,22:ec:75:a8:8a:31,225812811,244,6848,225812567,225812811
4056,5,24,149,5745,-80,-96,16,,225824038,32,11195,225824006,225824038
4057,5,24,149,5745,-80,-96,16,,225825003,28,937,225824975,225825003
4058,5,12,149,5745,-57,-96,39,3e:d1:9b:c7:a4:de,225860213,272,34938,225859941,225860213
4059,5,12,149,5745,-51,-96,45,72:fd:09:2f:da:5f,225875280,284,14783,225874996,225875280
4060,5,12,149,5745,-69,-96,27,02:31:8a:29:26:f4,225878586,268,3038,225878318,225878586
4061,5,12,149,5745,-55,-96,41,f2:da:61:dd:98:c5,225879097,268,243,225878829,225879097
4062,5,12,149,5745,-51,-96,45,5e:29:73:5b:30:00,225886314,272,6945,225886042,225886314
4063,5,24,149,5745,-80,-96,16,66:48:51:4e:71:fa,225886774,328,132,225886446,225886774
4064,5,24,149,5745,-80,-96,16,,225887324,28,522,225887296,225887324
4065,5,24,149,5745,-80,-96,16,,225887432,32,76,225887400,225887432
4066,5,12,149,5745,-76,-96,20,a6:92:ad:b7:76:65,225897676,256,9988,225897420,225897676
4067,5,12,149,5745,-82,-96,14,72:d1:72:1d:22:a1,225903010,256,5078,225902754,225903010
4068,5,12,149,5745,-73,-96,23,56:68:e2:c2:8d:d5,225903415,280,125,225903135,225903415
4069,5,12,149,5745,-72,-96,24,02:31:8a:29:26:f4,225927143,268,23460,225926875,225927143
4070,5,12,149,5745,-55,-96,41,f2:da:61:dd:98:c5,225927988,268,577,225927720,225927988
4071,5,12,149,5745,-71,-96,25,22:ec:75:a8:8a:31,225930245,244,2013,225930001,225930245
4072,5,12,149,5745,-74,-96,22,fa:44:8d:e1:c7:1b,225930607,244,118,225930363,225930607
4073,5,12,149,5745,-50,-96,46,72:fd:09:2f:da:5f,225950888,284,19997,225950604,225950888
4074,5,12,149,5745,-77,-96,19,a6:92:ad:b7:76:65,225953341,256,2197,225953085,225953341
4075,5,12,149,5745,-80,-96,16,72:d1:72:1d:22:a1,225965028,256,11431,225964772,225965028
4076,5,6,149,5745,-85,-96,11,54:e4:3a:ec:fb:65,225980517,360,15129,225980157,225980517
4077,5,12,149,5745,-75,-96,21,f6:0a:5c:59:72:df,225982604,252,1835,225982352,225982604
4078,5,12,149,5745,-69,-96,27,5e:36:fe:bc:a2:fe,225985541,240,2697,225985301,225985541
4079,5,12,149,5745,-59,-96,37,3e:d1:9b:c7:a4:de,225985824,272,11,225985552,225985824
4080,5,12,149,5745,-73,-96,23,02:31:8a:29:26:f4,225987176,268,1084,225986908,225987176
4081,5,12,149,5745,-70,-96,26,22:ec:75:a8:8a:31,225991454,516,3762,225990938,225991454
4082,5,12,149,5745,-71,-96,25,fa:44:8d:e1:c7:1b,225992330,440,436,225991890,225992330
4083,5,12,149,5745,-69,-96,27,5e:36:fe:bc:a2:fe,225992804,240,234,225992564,225992804
4084,5,12,149,5745,-59,-96,37,3e:d1:9b:c7:a4:de,225993105,544,-243,225992561,225993105
4085,5,12,149,5745,-51,-96,45,72:fd:09:2f:da:5f,225998174,480,4589,225997694,225998174
4086,5,12,149,5745,-56,-96,40,5e:29:73:5b:30:00,226000678,540,1964,226000138,226000678
4087,5,12,149,5745,-73,-96,23,56:68:e2:c2:8d:d5,226002032,280,1074,226001752,226002032
4088,5,12,149,5745,-75,-96,21,f6:0a:5c:59:72:df,226002454,252,170,226002202,226002454
4089,5,12,149,5745,-79,-96,17,a6:92:ad:b7:76:65,226003820,456,910,226003364,226003820
4090,5,12,149,5745,-69,-96,27,5e:36:fe:bc:a2:fe,226004427,152,455,226004275,226004427
4091,5,12,149,5745,-54,-96,42,f2:da:61:dd:98:c5,226005343,268,648,226005075,226005343
4092,5,12,149,5745,-81,-96,15,9a:24:38:da:96:bb,226005767,824,-400,226004943,226005767
4093,5,12,149,5745,-73,-96,23,56:68:e2:c2:8d:d5,226008958,476,2715,226008482,226008958
4094,5,12,149,5745,-81,-96,15,9a:24:38:da:96:bb,226012345,272,3115,226012073,226012345
4095,5,12,149,5745,-54,-96,42,f2:da:61:dd:98:c5,226018528,268,5915,226018260,226018528
4096,5,12,149,5745,-54,-96,42,5e:29:73:5b:30:00,226019713,272,913,226019441,226019713
4097,5,12,149,5745,-82,-96,14,72:d1:72:1d:22:a1,226024510,452,4345,226024058,226024510
4098,5,12,149,5745,-71,-96,25,fa:44:8d:e1:c7:1b,226034951,244,10197,226034707,226034951
4099,5,12,149,5745,-69,-96,27,02:31:8a:29:26:f4,226035258,268,39,226034990,226035258
4100,5,12,149,5745,-70,-96,26,22:ec:75:a8:8a:31,226043394,244,7892,226043150,226043394
4101,5,12,149,5745,-70,-96,26,fa:44:8d:e1:c7:1b,226056517,440,12683,226056077,226056517
4102,5,12,149,5745,-54,-96,42,5e:29:73:5b:30:00,226066000,540,8943,226065460,226066000
4103,5,12,149,5745,-77,-96,19,a6:92:ad:b7:76:65,226066583,256,327,226066327,226066583
4104,5,12,149,5745,-76,-96,20,f6:0a:5c:59:72:df,226068970,252,2135,226068718,226068970
4105,5,12,149,5745,-51,-96,45,72:fd:09:2f:da:5f,226069382,284,128,226069098,226069382
4106,5,12,149,5745,-76,-96,20,a6:92:ad:b7:76:65,226072886,456,3048,226072430,226072886
4107,5,12,149,5745,-82,-96,14,72:d1:72:1d:22:a1,226077304,256,4162,226077048,226077304
4108,5,6,149,5745,-88,-96,8,54:e4:3a:ec:fb:65,226082918,360,5254,226082558,226082918
4109,5,12,149,5745,-60,-96,36,3e:d1:9b:c7:a4:de,226088607,272,5417,226088335,226088607
4110,5,12,149,5745,-77,-96,19,f6:0a:5c:59:72:df,226095295,252,6436,226095043,226095295
4111,5,12,149,5745,-69,-96,27,5e:36:fe:bc:a2:fe,226095732,240,197,226095492,226095732
4112,5,12,149,5745,-53,-96,43,5e:29:73:5b:30:00,226118065,272,22061,226117793,226118065
4113,5,12,149,5745,-66,-96,30,02:31:8a:29:26:f4,226118400,268,67,226118132,226118400
4114,5,12,149,5745,-75,-96,21,56:68:e2:c2:8d:d5,226121951,280,3271,226121671,226121951
4115,5,12,149,5745,-71,-96,25,fa:44:8d:e1:c7:1b,226122321,440,-70,226121881,226122321
4116,5,12,149,5745,-67,-96,29,0a:b9:b7:b1:4d:fa,226122867,268,278,226122599,226122867
4117,5,12,149,5745,-72,-96,24,22:ec:75:a8:8a:31,226124776,516,1393,226124260,226124776
4118,5,12,149,5745,-62,-96,34,3e:d1:9b:c7:a4:de,226125335,544,15,226124791,226125335
4119,5,12,149,5745,-80,-96,16,d2:00:04:7e:2c:ab,226128505,440,2730,226128065,226128505
4120,5,12,149,5745,-53,-96,43,5e:29:73:5b:30:00,226131004,540,1959,226130464,226131004
4121,5,12,149,5745,-54,-96,42,f2:da:61:dd:98:c5,226133189,268,1917,226132921,226133189
4122,5,12,149,5745,-78,-96,18,f6:0a:5c:59:72:df,226133581,252,140,226133329,226133581
4123,5,12,149,5745,-79,-96,17,9a:24:38:da:96:bb,226135958,824,1553,226135134,226135958
4124,5,12,149,5745,-54,-96,42,f2:da:61:dd:98:c5,226136834,268,608,226136566,226136834
4125,5,12,149,5745,-68,-96,28,5e:36:fe:bc:a2:fe,226137489,240,415,226137249,226137489
4126,5,12,149,5745,-73,-96,23,a6:92:ad:b7:76:65,226138275,456,330,226137819,226138275
4127,5,12,149,5745,-65,-96,31,02:31:8a:29:26:f4,226149170,268,10627,226148902,226149170
4128,5,12,149,5745,-72,-96,24,fa:44:8d:e1:c7:1b,226149492,244,78,226149248,226149492
4129,5,12,149,5745,-79,-96,17,9a:24:38:da:96:bb,226157054,272,7290,226156782,226157054
4130,5,12,149,5745,-75,-96,21,22:ec:75:a8:8a:31,226164045,244,6747,226163801,226164045
4131,5,12,149,5745,-49,-96,47,72:fd:09:2f:da:5f,226182107,284,17778,226181823,226182107
4132,5,6,149,5745,-87,-96,9,54:e4:3a:ec:fb:65,226185318,360,2851,226184958,226185318
4133,5,12,149,5745,-71,-96,25,fa:44:8d:e1:c7:1b,226187672,440,1914,226187232,226187672
4134,5,12,149,5745,-77,-96,19,a6:92:ad:b7:76:65,226192650,256,4722,226192394,226192650
4135,5,12,149,5745,-53,-96,43,5e:29:73:5b:30:00,226197044,540,3854,226196504,226197044
4136,5,12,149,5745,-61,-96,35,3e:d1:9b:c7:a4:de,226206616,272,9300,226206344,226206616
4137,5,12,149,5745,-78,-96,18,72:d1:72:1d:22:a1,226210127,256,3255,226209871,226210127
4138,5,12,149,5745,-71,-96,25,fa:44:8d:e1:c7:1b,226247567,244,37196,226247323,226247567
4139,5,12,149,5745,-71,-96,25,fa:44:8d:e1:c7:1b,226253021,440,5014,226252581,226253021
4140,5,12,149,5745,-54,-96,42,5e:29:73:5b:30:00,226262226,540,8665,226261686,226262226
4141,5,12,149,5745,-73,-96,23,22:ec:75:a8:8a:31,226270792,244,8322,226270548,226270792
4142,5,6,149,5745,-85,-96,11,54:e4:3a:ec:fb:65,226287719,360,16567,226287359,226287719
4143,5,12,149,5745,-61,-96,35,02:31:8a:29:26:f4,226288219,268,232,226287951,226288219
4144,5,12,149,5745,-52,-96,44,f2:da:61:dd:98:c5,226288649,268,162,226288381,226288649
4145,5,12,149,5745,-66,-96,30,5e:36:fe:bc:a2:fe,226289946,240,1057,226289706,226289946
4146,5,12,149,5745,-55,-96,41,72:fd:09:2f:da:5f,226293001,284,2771,226292717,226293001
4147,5,12,149,5745,-73,-96,23,a6:92:ad:b7:76:65,226310831,256,17574,226310575,226310831
4148,5,12,149,5745,-77,-96,19,72:d1:72:1d:22:a1,226312399,256,1312,226312143,226312399
4149,5,12,149,5745,-76,-96,20,56:68:e2:c2:8d:d5,226314541,280,1862,226314261,226314541
4150,5,12,149,5745,-73,-96,23,fa:44:8d:e1:c7:1b,226318574,440,3593,226318134,226318574
4151,5,12,149,5745,-63,-96,33,3e:d1:9b:c7:a4:de,226324837,272,5991,226324565,226324837
4152,5,12,149,5745,-55,-96,41,5e:29:73:5b:30:00,226328110,540,2733,226327570,226328110
4153,5,12,149,5745,-74,-96,22,f6:0a:5c:59:72:df,226330332,252,1970,226330080,226330332
4154,5,12,149,5745,-56,-96,40,5e:29:73:5b:30:00,226347414,272,16810,226347142,226347414
4155,5,12,149,5745,-73,-96,23,fa:44:8d:e1:c7:1b,226362633,244,14975,226362389,226362633
4156,5,12,149,5745,-78,-96,18,9a:24:38:da:96:bb,226386648,272,23743,226386376,226386648
4157,5,12,149,5745,-72,-96,24,22:ec:75:a8:8a:31,226388926,244,2034,226388682,226388926
4158,5,6,149,5745,-88,-96,8,54:e4:3a:ec:fb:65,226390119,360,833,226389759,226390119
4159,5,12,149,5745,-61,-96,35,02:31:8a:29:26:f4,226390631,268,244,226390363,226390631
4160,5,12,149,5745,-50,-96,46,f2:da:61:dd:98:c5,226390980,268,81,226390712,226390980
4161,5,12,149,5745,-69,-96,27,5e:36:fe:bc:a2:fe,226392107,240,887,226391867,226392107
4162,5,12,149,5745,-55,-96,41,72:fd:09:2f:da:5f,226402764,284,10373,226402480,226402764
4163,5,12,149,5745,-75,-96,21,a6:92:ad:b7:76:65,226412643,256,9623,226412387,226412643
4164,5,12,149,5745,-77,-96,19,72:d1:72:1d:22:a1,226414984,256,2085,226414728,226414984
4165,5,12,149,5745,-76,-96,20,56:68:e2:c2:8d:d5,226416919,280,1655,226416639,226416919
4166,5,12,149,5745,-59,-96,37,3e:d1:9b:c7:a4:de,226442007,272,24816,226441735,226442007
4167,5,12,149,5745,-74,-96,22,f6:0a:5c:59:72:df,226443086,252,827,226442834,226443086
4168,5,12,149,5745,-56,-96,40,5e:29:73:5b:30:00,226451269,272,7911,226450997,226451269
4169,5,6,149,5745,-87,-96,9,54:e4:3a:ec:fb:65,226492520,360,40891,226492160,226492520
4170,5,12,149,5745,-61,-96,35,02:31:8a:29:26:f4,226493132,268,344,226492864,226493132
4171,5,12,149,5745,-51,-96,45,f2:da:61:dd:98:c5,226493605,268,205,226493337,226493605
4172,5,12,149,5745,-69,-96,27,5e:36:fe:bc:a2:fe,226493987,240,142,226493747,226493987
4173,5,12,149,5745,-71,-96,25,22:ec:75:a8:8a:31,226500696,244,6465,226500452,226500696
4174,5,12,149,5745,-72,-96,24,fa:44:8d:e1:c7:1b,226516816,244,15876,226516572,226516816
4175,5,12,149,5745,-75,-96,21,56:68:e2:c2:8d:d5,226518607,280,1511,226518327,226518607
4176,5,12,149,5745,-57,-96,39,72:fd:09:2f:da:5f,226519612,284,721,226519328,226519612
4177,5,12,149,5745,-75,-96,21,a6:92:ad:b7:76:65,226531405,256,11537,226531149,226531405
4178,5,12,149,5745,-78,-96,18,72:d1:72:1d:22:a1,226533257,256,1596,226533001,226533257
4179,5,12,149,5745,-68,-96,28,5e:36:fe:bc:a2:fe,226561187,240,27690,226560947,226561187
4180,5,12,149,5745,-75,-96,21,56:68:e2:c2:8d:d5,226575469,280,14002,226575189,226575469
4181,5,12,149,5745,-59,-96,37,3e:d1:9b:c7:a4:de,226575829,272,88,226575557,226575829
4182,5,12,149,5745,-54,-96,42,5e:29:73:5b:30:00,226576756,272,655,226576484,226576756
4183,5,12,149,5745,-62,-96,34,02:31:8a:29:26:f4,226579759,268,2735,226579491,226579759
4184,5,12,149,5745,-71,-96,25,22:ec:75:a8:8a:31,226580952,516,677,226580436,226580952
4185,5,12,149,5745,-59,-96,37,3e:d1:9b:c7:a4:de,226581511,544,15,226580967,226581511
4186,5,12,149,5745,-71,-96,25,fa:44:8d:e1:c7:1b,226583477,440,1526,226583037,226583477
4187,5,12,149,5745,-59,-96,37,72:fd:09:2f:da:5f,226589199,480,5242,226588719,226589199
4188,5,12,149,5745,-54,-96,42,5e:29:73:5b:30:00,226590604,540,865,226590064,226590604
4189,5,12,149,5745,-51,-96,45,f2:da:61:dd:98:c5,226592458,268,1586,226592190,226592458
4190,5,12,149,5745,-71,-96,25,fa:44:8d:e1:c7:1b,226592805,244,103,226592561,226592805
4191,5,12,149,5745,-72,-96,24,f6:0a:5c:59:72:df,226593461,252,404,226593209,226593461
4192,5,12,149,5745,-62,-96,34,02:31:8a:29:26:f4,226594009,268,280,226593741,226594009
4193,5,6,149,5745,-88,-96,8,54:e4:3a:ec:fb:65,226594921,360,552,226594561,226594921
4194,5,12,149,5745,-67,-96,29,5e:36:fe:bc:a2:fe,226596248,240,1087,226596008,226596248
4195,5,12,149,5745,-77,-96,19,a6:92:ad:b7:76:65,226597287,456,583,226596831,226597287
4196,5,12,149,5745,-74,-96,22,56:68:e2:c2:8d:d5,226597786,476,23,226597310,226597786
4197,5,12,149,5745,-51,-96,45,f2:da:61:dd:98:c5,226598296,268,242,226598028,226598296
4198,5,12,149,5745,-78,-96,18,72:d1:72:1d:22:a1,226598643,452,-105,226598191,226598643
4199,5,12,149,5745,-80,-96,16,9a:24:38:da:96:bb,226606615,272,7700,226606343,226606615
4200,5,12,149,5745,-72,-96,24,22:ec:75:a8:8a:31,226622757,244,15898,226622513,226622757
4201,5,12,149,5745,-60,-96,36,72:fd:09:2f:da:5f,226625609,284,2568,226625325,226625609
4202,5,12,149,5745,-75,-96,21,a6:92:ad:b7:76:65,226639945,256,14080,226639689,226639945
4203,5,12,149,5745,-76,-96,20,72:d1:72:1d:22:a1,226641263,256,1062,226641007,226641263
4204,5,12,149,5745,-64,-96,32,02:31:8a:29:26:f4,226643768,268,2237,226643500,226643768
4205,5,12,149,5745,-68,-96,28,5e:36:fe:bc:a2:fe,226645332,240,1324,226645092,226645332
4206,5,12,149,5745,-60,-96,36,3e:d1:9b:c7:a4:de,226646191,544,315,226645647,226646191
4207,5,12,149,5745,-72,-96,24,22:ec:75:a8:8a:31,226646769,516,62,226646253,226646769
4208,5,12,149,5745,-68,-96,28,fa:44:8d:e1:c7:1b,226647321,440,112,226646881,226647321
4209,5,12,149,5745,-86,-96,10,d2:00:04:7e:2c:ab,226647796,440,35,226647356,226647796
4210,5,12,149,5745,-70,-96,26,0a:b9:b7:b1:4d:fa,226648298,268,234,226648030,226648298
4211,5,12,149,5745,-62,-96,34,72:fd:09:2f:da:5f,226651669,480,2891,226651189,226651669
4212,5,12,149,5745,-73,-96,23,f6:0a:5c:59:72:df,226654595,252,2674,226654343,226654595
4213,5,12,149,5745,-53,-96,43,5e:29:73:5b:30:00,226655837,540,702,226655297,226655837
4214,5,12,149,5745,-80,-96,16,9a:24:38:da:96:bb,226657188,824,527,226656364,226657188
4215,5,12,149,5745,-75,-96,21,f6:0a:5c:59:72:df,226658877,252,1437,226658625,226658877
4216,5,12,149,5745,-50,-96,46,f2:da:61:dd:98:c5,226659820,268,675,226659552,226659820
4217,5,12,149,5745,-74,-96,22,56:68:e2:c2:8d:d5,226660167,476,-129,226659691,226660167
4218,5,12,149,5745,-76,-96,20,72:d1:72:1d:22:a1,226663450,452,2831,226662998,226663450
4219,5,12,149,5745,-74,-96,22,a6:92:ad:b7:76:65,226663936,456,30,226663480,226663936
4220,5,12,149,5745,-68,-96,28,5e:36:fe:bc:a2:fe,226673738,240,9562,226673498,226673738
4221,5,12,149,5745,-61,-96,35,3e:d1:9b:c7:a4:de,226674055,272,45,226673783,226674055
4222,5,12,149,5745,-53,-96,43,5e:29:73:5b:30:00,226692283,272,17956,226692011,226692283
4223,5,6,149,5745,-86,-96,10,54:e4:3a:ec:fb:65,226697321,360,4678,226696961,226697321
4224,5,12,149,5745,-49,-96,47,f2:da:61:dd:98:c5,226718730,268,21141,226718462,226718730
4225,5,12,149,5745,-71,-96,25,fa:44:8d:e1:c7:1b,226720648,244,1674,226720404,226720648
4226,5,12,149,5745,-63,-96,33,02:31:8a:29:26:f4,226723032,268,2116,226722764,226723032
4227,5,6,149,5745,-76,-96,20,24:f6:77:10:02:c8,226728266,176,5058,226728090,226728266
4228,5,12,149,5745,-72,-96,24,22:ec:75:a8:8a:31,226729217,244,707,226728973,226729217
4229,5,6,149,5745,-76,-96,20,,226735154,52,5885,226735102,226735154
4230,5,6,149,5745,-89,-96,7,,226735222,44,24,226735178,226735222
4231,5,6,149,5745,-77,-96,19,24:f6:77:10:02:c8,226739363,176,3965,226739187,226739363
4232,5,6,149,5745,-76,-96,20,,226741524,52,2109,226741472,226741524
4233,5,6,149,5745,-89,-96,7,,226741592,44,24,226741548,226741592
4234,5,24,149,5745,-89,-96,7,,226741709,28,89,226741681,226741709
4235,5,6,149,5745,-76,-96,20,,226741894,52,133,226741842,226741894
4236,5,6,149,5745,-89,-96,7,,226741962,44,24,226741918,226741962
4237,5,24,149,5745,-89,-96,7,,226742080,28,90,226742052,226742080
4238,5,12,149,5745,-59,-96,37,72:fd:09:2f:da:5f,226744581,284,2217,226744297,226744581
4239,5,6,149,5745,-76,-96,20,,226747156,52,2523,226747104,226747156
4240,5,6,149,5745,-88,-96,8,,226747224,44,24,226747180,226747224
4241,5,24,149,5745,-89,-96,7,,226747342,28,90,226747314,226747342
4242,5,6,149,5745,-77,-96,19,,226747511,52,117,226747459,226747511
4243,5,6,149,5745,-88,-96,8,,226747579,44,24,226747535,226747579
4244,5,24,149,5745,-88,-96,8,,226750409,28,2802,226750381,226750409
4245,5,12,149,5745,-73,-96,23,f6:0a:5c:59:72:df,226778955,252,28294,226778703,226778955
4246,5,12,149,5745,-63,-96,33,3e:d1:9b:c7:a4:de,226781973,272,2746,226781701,226781973
4247,5,12,149,5745,-54,-96,42,5e:29:73:5b:30:00,226789506,272,7261,226789234,226789506
4248,5,12,149,5745,-69,-96,27,5e:36:fe:bc:a2:fe,226791251,240,1505,226791011,226791251
4249,5,6,149,5745,-85,-96,11,54:e4:3a:ec:fb:65,226799722,360,8111,226799362,226799722
4250,5,12,149,5745,-77,-96,19,a6:92:ad:b7:76:65,226823003,256,23025,226822747,226823003
4251,5,12,149,5745,-79,-96,17,72:d1:72:1d:22:a1,226824373,256,1114,226824117,226824373
4252,5,12,149,5745,-74,-96,22,56:68:e2:c2:8d:d5,226826452,280,1799,226826172,226826452
4253,5,24,149,5745,-88,-96,8,,226828633,32,2149,226828601,226828633
4254,5,24,149,5745,-87,-96,9,,226829704,28,1043,226829676,226829704
4255,5,24,149,5745,-88,-96,8,,226830186,28,454,226830158,226830186
4256,5,12,149,5745,-73,-96,23,fa:44:8d:e1:c7:1b,226832360,244,1930,226832116,226832360
4257,5,12,149,5745,-78,-96,18,9a:24:38:da:96:bb,226835414,272,2782,226835142,226835414
4258,5,12,149,5745,-72,-96,24,22:ec:75:a8:8a:31,226843008,244,7350,226842764,226843008
4259,5,6,149,5745,-77,-96,19,,226883494,52,40434,226883442,226883494
4260,5,6,149,5745,-89,-96,7,,226883562,44,24,226883518,226883562
4261,5,12,149,5745,-62,-96,34,3e:d1:9b:c7:a4:de,226899304,272,15470,226899032,226899304
4262,5,6,149,5745,-85,-96,11,54:e4:3a:ec:fb:65,226902122,360,2458,226901762,226902122
4263,5,12,149,5745,-62,-96,34,02:31:8a:29:26:f4,226902596,268,206,226902328,226902596
4264,5,12,149,5745,-51,-96,45,f2:da:61:dd:98:c5,226903514,268,650,226903246,226903514
4265,5,12,149,5745,-57,-96,39,5e:29:73:5b:30:00,226907431,272,3645,226907159,226907431
4266,5,12,149,5745,-68,-96,28,5e:36:fe:bc:a2:fe,226908559,240,888,226908319,226908559
4267,5,24,149,5745,-76,-96,20,,226915650,28,7063,226915622,226915650
4268,5,12,149,5745,-77,-96,19,a6:92:ad:b7:76:65,226925384,256,9478,226925128,226925384
4269,5,12,149,5745,-80,-96,16,72:d1:72:1d:22:a1,226926820,256,1180,226926564,226926820
4270,5,12,149,5745,-75,-96,21,56:68:e2:c2:8d:d5,226927225,280,125,226926945,226927225
4271,5,12,149,5745,-70,-96,26,fa:44:8d:e1:c7:1b,226942957,244,15488,226942713,226942957
4272,5,12,149,5745,-81,-96,15,9a:24:38:da:96:bb,226943779,272,550,226943507,226943779
4273,5,12,149,5745,-72,-96,24,22:ec:75:a8:8a:31,226959598,244,15575,226959354,226959598
4274,5,6,149,5745,-78,-96,18,,226961324,52,1674,226961272,226961324
4275,5,6,149,5745,-89,-96,7,,226961392,44,24,226961348,226961392
4276,5,24,149,5745,-88,-96,8,,226961510,28,90,226961482,226961510
4277,5,12,149,5745,-81,-96,15,72:d1:72:1d:22:a1,226979707,256,17941,226979451,226979707
4278,5,12,149,5745,-78,-96,18,a6:92:ad:b7:76:65,226982460,256,2497,226982204,226982460
4279,5,6,149,5745,-77,-96,19,,226993177,52,10665,226993125,226993177
4280,5,6,149,5745,-88,-96,8,,226993246,44,25,226993202,226993246
4281,5,24,149,5745,-87,-96,9,,226993363,28,89,226993335,226993363
4282,5,24,149,5745,-87,-96,9,,226996580,32,3185,226996548,226996580
4283,5,24,149,5745,-88,-96,8,,226997133,32,521,226997101,226997133
4284,5,24,149,5745,-88,-96,8,,226997687,28,526,226997659,226997687
4285,5,12,149,5745,-51,-96,45,72:fd:09:2f:da:5f,227001756,284,3785,227001472,227001756
4286,5,6,149,5745,-86,-96,10,54:e4:3a:ec:fb:65,227004522,360,2406,227004162,227004522
4287,5,12,149,5745,-63,-96,33,02:31:8a:29:26:f4,227004955,268,165,227004687,227004955
4288,5,12,149,5745,-52,-96,44,f2:da:61:dd:98:c5,227005891,268,668,227005623,227005891
4289,5,6,149,5745,-78,-96,18,,227006644,52,701,227006592,227006644
4290,5,6,149,5745,-87,-96,9,,227006712,44,24,227006668,227006712
4291,5,24,149,5745,-88,-96,8,,227006830,28,90,227006802,227006830
4292,5,6,149,5745,-87,-96,9,54:e4:3a:ec:fb:65,227013760,352,6578,227013408,227013760
4293,5,12,149,5745,-67,-96,29,5e:36:fe:bc:a2:fe,227018221,240,4221,227017981,227018221
4294,5,24,149,5745,-87,-96,9,,227018793,28,544,227018765,227018793
4295,5,24,149,5745,-88,-96,8,,227019426,32,601,227019394,227019426
4296,5,12,149,5745,-77,-96,19,56:68:e2:c2:8d:d5,227022588,280,2882,227022308,227022588
4297,5,24,149,5745,-86,-96,10,,227033290,28,10674,227033262,227033290
4298,5,24,149,5745,-86,-96,10,,227033633,28,315,227033605,227033633
4299,5,12,149,5745,-60,-96,36,3e:d1:9b:c7:a4:de,227034277,272,372,227034005,227034277
4300,5,12,149,5745,-52,-96,44,f2:da:61:dd:98:c5,227034630,268,85,227034362,227034630
4301,5,12,149,5745,-56,-96,40,5e:29:73:5b:30:00,227035544,272,642,227035272,227035544
4302,5,12,149,5745,-64,-96,32,02:31:8a:29:26:f4,227036968,268,1156,227036700,227036968
4303,5,24,149,5745,-87,-96,9,,227037988,28,992,227037960,227037988
4304,5,12,149,5745,-67,-96,29,5e:36:fe:bc:a2:fe,227038423,240,195,227038183,227038423
4305,5,12,149,5745,-69,-96,27,fa:44:8d:e1:c7:1b,227038697,440,-166,227038257,227038697
4306,5,24,149,5745,-88,-96,8,,227039975,28,1250,227039947,227039975
4307,5,24,149,5745,-87,-96,9,,227040276,28,273,227040248,227040276
4308,5,24,149,5745,-88,-96,8,,227040734,28,430,227040706,227040734
4309,5,24,149,5745,-88,-96,8,,227040842,32,76,227040810,227040842
4310,5,12,149,5745,-72,-96,24,22:ec:75:a8:8a:31,227040918,516,-440,227040402,227040918
4311,5,24,149,5745,-87,-96,9,,227041477,28,531,227041449,227041477
4312,5,12,149,5745,-59,-96,37,3e:d1:9b:c7:a4:de,227041695,544,-326,227041151,227041695
4313,5,12,149,5745,-72,-96,24,f6:0a:5c:59:72:df,227042318,128,495,227042190,227042318
4314,5,12,149,5745,-56,-96,40,5e:29:73:5b:30:00,227044217,540,1359,227043677,227044217
4315,5,12,149,5745,-50,-96,46,72:fd:09:2f:da:5f,227046753,480,2056,227046273,227046753
4316,5,24,149,5745,-89,-96,7,,227049420,32,2635,227049388,227049420
4317,5,12,149,5745,-69,-96,27,fa:44:8d:e1:c7:1b,227050386,244,722,227050142,227050386
4318,5,12,149,5745,-72,-96,24,f6:0a:5c:59:72:df,227051450,252,812,227051198,227051450
4319,5,12,149,5745,-82,-96,14,9a:24:38:da:96:bb,227052088,824,-186,227051264,227052088
4320,5,12,149,5745,-65,-96,31,02:31:8a:29:26:f4,227052946,268,590,227052678,227052946
4321,5,12,149,5745,-53,-96,43,f2:da:61:dd:98:c5,227053304,268,90,227053036,227053304
4322,5,12,149,5745,-83,-96,13,9a:24:38:da:96:bb,227055053,272,1477,227054781,227055053
4323,5,12,149,5745,-79,-96,17,a6:92:ad:b7:76:65,227056357,456,848,227055901,227056357
4324,5,24,149,5745,-88,-96,8,,227056865,28,480,227056837,227056865
4325,5,12,149,5745,-77,-96,19,56:68:e2:c2:8d:d5,227057615,476,274,227057139,227057615
4326,5,12,149,5745,-80,-96,16,72:d1:72:1d:22:a1,227058153,452,86,227057701,227058153
4327,5,24,149,5745,-88,-96,8,,227059766,28,1585,227059738,227059766
4328,5,24,149,5745,-89,-96,7,,227059874,32,76,227059842,227059874
4329,5,24,149,5745,-88,-96,8,,227064851,28,4949,227064823,227064851
4330,5,12,149,5745,-51,-96,45,72:fd:09:2f:da:5f,227067545,284,2410,227067261,227067545
4331,5,6,149,5745,-89,-96,7,54:e4:3a:ec:fb:65,227069034,352,1137,227068682,227069034
4332,5,12,149,5745,-79,-96,17,a6:92:ad:b7:76:65,227082535,256,13245,227082279,227082535
4333,5,12,149,5745,-72,-96,24,22:ec:75:a8:8a:31,227082861,244,82,227082617,227082861
4334,5,12,149,5745,-79,-96,17,72:d1:72:1d:22:a1,227084869,256,1752,227084613,227084869
4335,5,12,149,5745,-73,-96,23,f6:0a:5c:59:72:df,227103095,252,17974,227102843,227103095
4336,5,6,149,5745,-90,-96,6,54:e4:3a:ec:fb:65,227106923,360,3468,227106563,227106923
4337,5,24,149,5745,-88,-96,8,,227116060,28,9109,227116032,227116060
4338,5,24,149,5745,-88,-96,8,,227118071,28,1983,227118043,227118071
4339,5,12,149,5745,-72,-96,24,f6:0a:5c:59:72:df,227118378,252,55,227118126,227118378
4340,5,24,149,5745,-87,-96,9,,227118781,28,375,227118753,227118781
4341,5,12,149,5745,-79,-96,17,a6:92:ad:b7:76:65,227121355,456,2118,227120899,227121355
4342,5,12,149,5745,-60,-96,36,3e:d1:9b:c7:a4:de,227131396,272,9769,227131124,227131396
4343,5,12,149,5745,-67,-96,29,5e:36:fe:bc:a2:fe,227135561,240,3925,227135321,227135561
4344,5,24,149,5745,-90,-96,6,,227136673,28,1084,227136645,227136673
4345,5,12,149,5745,-77,-96,19,56:68:e2:c2:8d:d5,227139357,280,2404,227139077,227139357
4346,5,12,149,5745,-54,-96,42,5e:29:73:5b:30:00,227140141,272,512,227139869,227140141
4347,5,24,149,5745,-88,-96,8,,227140938,28,769,227140910,227140938
4348,5,24,149,5745,-88,-96,8,,227143763,28,2797,227143735,227143763
4349,5,24,149,5745,-87,-96,9,,227143871,32,76,227143839,227143871
4350,5,24,149,5745,-87,-96,9,,227149761,28,5862,227149733,227149761
4351,5,12,149,5745,-69,-96,27,fa:44:8d:e1:c7:1b,227165069,244,15064,227164825,227165069
4352,5,12,149,5745,-52,-96,44,f2:da:61:dd:98:c5,227165392,268,55,227165124,227165392
4353,5,12,149,5745,-81,-96,15,9a:24:38:da:96:bb,227167139,272,1475,227166867,227167139
4354,5,12,149,5745,-66,-96,30,02:31:8a:29:26:f4,227167481,268,74,227167213,227167481
4355,5,12,149,5745,-66,-96,30,02:31:8a:29:26:f4,227168665,268,916,227168397,227168665
4356,5,12,149,5745,-69,-96,27,fa:44:8d:e1:c7:1b,227168978,440,-127,227168538,227168978
4357,5,12,149,5745,-67,-96,29,5e:36:fe:bc:a2:fe,227170046,240,828,227169806,227170046
4358,5,12,149,5745,-65,-96,31,0a:b9:b7:b1:4d:fa,227171255,268,941,227170987,227171255
4359,5,12,149,5745,-60,-96,36,3e:d1:9b:c7:a4:de,227173277,544,1478,227172733,227173277
4360,5,12,149,5745,-54,-96,42,5e:29:73:5b:30:00,227173864,540,47,227173324,227173864
4361,5,12,149,5745,-71,-96,25,f6:0a:5c:59:72:df,227183136,252,9020,227182884,227183136
4362,5,12,149,5745,-80,-96,16,9a:24:38:da:96:bb,227185015,824,1055,227184191,227185015
4363,5,12,149,5745,-52,-96,44,f2:da:61:dd:98:c5,227185891,268,608,227185623,227185891
4364,5,12,149,5745,-78,-96,18,a6:92:ad:b7:76:65,227186589,456,242,227186133,227186589
4365,5,12,149,5745,-73,-96,23,22:ec:75:a8:8a:31,227190374,516,3269,227189858,227190374
4366,5,12,149,5745,-49,-96,47,72:fd:09:2f:da:5f,227191275,284,617,227190991,227191275
4367,5,12,149,5745,-73,-96,23,22:ec:75:a8:8a:31,227195949,244,4430,227195705,227195949
4368,5,12,149,5745,-78,-96,18,a6:92:ad:b7:76:65,227197487,256,1282,227197231,227197487
4369,5,6,149,5745,-91,-96,5,54:e4:3a:ec:fb:65,227209324,360,11477,227208964,227209324
4370,5,12,149,5745,-79,-96,17,72:d1:72:1d:22:a1,227234048,256,24468,227233792,227234048
4371,5,12,149,5745,-70,-96,26,f6:0a:5c:59:72:df,227235771,252,1471,227235519,227235771
4372,5,12,149,5745,-61,-96,35,3e:d1:9b:c7:a4:de,227246830,272,10787,227246558,227246830
4373,5,12,149,5745,-77,-96,19,56:68:e2:c2:8d:d5,227248342,280,1232,227248062,227248342
4374,5,12,149,5745,-68,-96,28,5e:36:fe:bc:a2:fe,227250003,240,1421,227249763,227250003
4375,5,12,149,5745,-55,-96,41,5e:29:73:5b:30:00,227254557,272,4282,227254285,227254557
4376,5,12,149,5745,-50,-96,46,f2:da:61:dd:98:c5,227273726,268,18901,227273458,227273726
4377,5,12,149,5745,-81,-96,15,9a:24:38:da:96:bb,227280557,272,6559,227280285,227280557
4378,5,12,149,5745,-66,-96,30,02:31:8a:29:26:f4,227289120,268,8295,227288852,227289120
4379,5,6,149,5745,-90,-96,6,54:e4:3a:ec:fb:65,227297503,352,8031,227297151,227297503
4380,5,12,149,5745,-72,-96,24,22:ec:75:a8:8a:31,227297946,244,199,227297702,227297946
4381,5,24,149,5745,-88,-96,8,,227300856,28,2882,227300828,227300856
4382,5,12,149,5745,-50,-96,46,72:fd:09:2f:da:5f,227302962,284,1822,227302678,227302962
4383,5,6,149,5745,-89,-96,7,54:e4:3a:ec:fb:65,227307743,352,4429,227307391,227307743
4384,5,6,149,5745,-89,-96,7,54:e4:3a:ec:fb:65,227311724,360,3621,227311364,227311724
4385,5,12,149,5745,-78,-96,18,a6:92:ad:b7:76:65,227335007,256,23027,227334751,227335007
4386,5,12,149,5745,-68,-96,28,fa:44:8d:e1:c7:1b,227335896,244,645,227335652,227335896
4387,5,12,149,5745,-80,-96,16,72:d1:72:1d:22:a1,227336418,256,266,227336162,227336418
4388,5,12,149,5745,-60,-96,36,3e:d1:9b:c7:a4:de,227363863,272,27173,227363591,227363863
4389,5,12,149,5745,-57,-96,39,5e:29:73:5b:30:00,227371811,272,7676,227371539,227371811
4390,5,6,149,5745,-88,-96,8,54:e4:3a:ec:fb:65,227414125,360,41954,227413765,227414125
4391,5,12,149,5745,-67,-96,29,02:31:8a:29:26:f4,227414521,268,128,227414253,227414521
4392,5,12,149,5745,-52,-96,44,72:fd:09:2f:da:5f,227414824,284,19,227414540,227414824
4393,5,12,149,5745,-69,-96,27,5e:36:fe:bc:a2:fe,227415144,240,80,227414904,227415144
4394,5,12,149,5745,-50,-96,46,f2:da:61:dd:98:c5,227415447,268,35,227415179,227415447
4395,5,12,149,5745,-78,-96,18,a6:92:ad:b7:76:65,227437226,256,21523,227436970,227437226
4396,5,12,149,5745,-69,-96,27,fa:44:8d:e1:c7:1b,227438078,244,608,227437834,227438078
4397,5,12,149,5745,-80,-96,16,72:d1:72:1d:22:a1,227438928,256,594,227438672,227438928
4398,5,12,149,5745,-75,-96,21,56:68:e2:c2:8d:d5,227440874,280,1666,227440594,227440874
4399,5,12,149,5745,-59,-96,37,3e:d1:9b:c7:a4:de,227479573,272,38427,227479301,227479573
4400,5,12,149,5745,-57,-96,39,5e:29:73:5b:30:00,227488813,272,8968,227488541,227488813
4401,5,24,149,5745,-88,-96,8,,227492006,28,3165,227491978,227492006
4402,5,24,149,5745,-89,-96,7,,227503817,28,11783,227503789,227503817
4403,5,24,149,5745,-87,-96,9,,227503925,32,76,227503893,227503925
4404,5,12,149,5745,-79,-96,17,9a:24:38:da:96:bb,227508036,272,3839,227507764,227508036
4405,5,6,149,5745,-87,-96,9,54:e4:3a:ec:fb:65,227516525,360,8129,227516165,227516525
4406,5,12,149,5745,-67,-96,29,02:31:8a:29:26:f4,227517060,268,267,227516792,227517060
4407,5,12,149,5745,-50,-96,46,f2:da:61:dd:98:c5,227517400,268,72,227517132,227517400
4408,5,12,149,5745,-69,-96,27,5e:36:fe:bc:a2:fe,227517989,240,349,227517749,227517989
4409,5,24,149,5745,-87,-96,9,,227521621,28,3604,227521593,227521621
4410,5,24,149,5745,-88,-96,8,,227522979,28,1330,227522951,227522979
4411,5,12,149,5745,-53,-96,43,72:fd:09:2f:da:5f,227526187,284,2924,227525903,227526187
4412,5,12,149,5745,-70,-96,26,22:ec:75:a8:8a:31,227529608,244,3177,227529364,227529608
4413,5,12,149,5745,-67,-96,29,fa:44:8d:e1:c7:1b,227540658,244,10806,227540414,227540658
4414,5,12,149,5745,-81,-96,15,72:d1:72:1d:22:a1,227541314,256,400,227541058,227541314
4415,5,12,149,5745,-74,-96,22,56:68:e2:c2:8d:d5,227542034,280,440,227541754,227542034
4416,5,12,149,5745,-78,-96,18,a6:92:ad:b7:76:65,227556719,256,14429,227556463,227556719
4417,5,12,149,5745,-76,-96,20,56:68:e2:c2:8d:d5,227588993,280,31994,227588713,227588993
4418,5,12,149,5745,-67,-96,29,5e:36:fe:bc:a2:fe,227590187,240,954,227589947,227590187
4419,5,12,149,5745,-60,-96,36,3e:d1:9b:c7:a4:de,227591514,272,1055,227591242,227591514
4420,5,12,149,5745,-57,-96,39,5e:29:73:5b:30:00,227600801,272,9015,227600529,227600801
4421,5,12,149,5745,-52,-96,44,f2:da:61:dd:98:c5,227610841,268,9772,227610573,227610841
4422,5,12,149,5745,-80,-96,16,9a:24:38:da:96:bb,227615607,272,4494,227615335,227615607
4423,5,6,149,5745,-86,-96,10,54:e4:3a:ec:fb:65,227618926,360,2959,227618566,227618926
4424,5,12,149,5745,-67,-96,29,5e:36:fe:bc:a2:fe,227623696,240,4530,227623456,227623696
4425,5,12,149,5745,-66,-96,30,fa:44:8d:e1:c7:1b,227624015,244,75,227623771,227624015
4426,5,12,149,5745,-52,-96,44,72:fd:09:2f:da:5f,227624637,284,338,227624353,227624637
4427,5,12,149,5745,-65,-96,31,02:31:8a:29:26:f4,227625928,268,1023,227625660,227625928
4428,5,24,149,5745,-89,-96,7,,227627097,28,1141,227627069,227627097
4429,5,12,149,5745,-65,-96,31,02:31:8a:29:26:f4,227627918,268,553,227627650,227627918
4430,5,12,149,5745,-61,-96,35,3e:d1:9b:c7:a4:de,227631362,544,2900,227630818,227631362
4431,5,12,149,5745,-57,-96,39,5e:29:73:5b:30:00,227632543,540,641,227632003,227632543
4432,5,12,149,5745,-66,-96,30,fa:44:8d:e1:c7:1b,227633612,440,629,227633172,227633612
4433,5,12,149,5745,-52,-96,44,72:fd:09:2f:da:5f,227637734,480,3642,227637254,227637734
4434,5,12,149,5745,-83,-96,13,72:d1:72:1d:22:a1,227640552,256,2562,227640296,227640552
4435,5,12,149,5745,-79,-96,17,a6:92:ad:b7:76:65,227641994,456,986,227641538,227641994
4436,5,12,149,5745,-76,-96,20,56:68:e2:c2:8d:d5,227643591,476,1121,227643115,227643591
4437,5,12,149,5745,-70,-96,26,f6:0a:5c:59:72:df,227644663,252,820,227644411,227644663
4438,5,12,149,5745,-53,-96,43,f2:da:61:dd:98:c5,227645039,268,108,227644771,227645039
4439,5,12,149,5745,-71,-96,25,22:ec:75:a8:8a:31,227646664,516,1109,227646148,227646664
4440,5,12,149,5745,-82,-96,14,72:d1:72:1d:22:a1,227648341,452,1225,227647889,227648341
4441,5,12,149,5745,-72,-96,24,22:ec:75:a8:8a:31,227654695,244,6110,227654451,227654695
4442,5,12,149,5745,-79,-96,17,a6:92:ad:b7:76:65,227656305,256,1354,227656049,227656305
4443,5,12,149,5745,-70,-96,26,f6:0a:5c:59:72:df,227669735,252,13178,227669483,227669735
4444,5,12,149,5745,-68,-96,28,5e:36:fe:bc:a2:fe,227688867,240,18892,227688627,227688867
4445,5,12,149,5745,-68,-96,28,5e:36:fe:bc:a2:fe,227689429,240,322,227689189,227689429
4446,5,12,149,5745,-77,-96,19,56:68:e2:c2:8d:d5,227689739,280,30,227689459,227689739
4447,5,12,149,5745,-61,-96,35,3e:d1:9b:c7:a4:de,227695604,544,5321,227695060,227695604
4448,5,12,149,5745,-69,-96,27,0a:b9:b7:b1:4d:fa,227696812,268,940,227696544,227696812
4449,5,12,149,5745,-57,-96,39,5e:29:73:5b:30:00,227697133,540,-219,227696593,227697133
4450,5,12,149,5745,-64,-96,32,fa:44:8d:e1:c7:1b,227697796,440,223,227697356,227697796
4451,5,12,149,5745,-53,-96,43,72:fd:09:2f:da:5f,227700211,480,1935,227699731,227700211
4452,5,12,149,5745,-81,-96,15,9a:24:38:da:96:bb,227705196,824,4161,227704372,227705196
4453,5,12,149,5745,-66,-96,30,02:31:8a:29:26:f4,227706072,240,636,227705832,227706072
4454,5,12,149,5745,-79,-96,17,a6:92:ad:b7:76:65,227707408,456,880,227706952,227707408
4455,5,12,149,5745,-54,-96,42,f2:da:61:dd:98:c5,227708251,268,575,227707983,227708251
4456,5,12,149,5745,-76,-96,20,56:68:e2:c2:8d:d5,227708724,476,-3,227708248,227708724
4457,5,12,149,5745,-72,-96,24,22:ec:75:a8:8a:31,227711966,516,2726,227711450,227711966
4458,5,12,149,5745,-80,-96,16,72:d1:72:1d:22:a1,227712976,452,558,227712524,227712976
4459,5,6,149,5745,-85,-96,11,54:e4:3a:ec:fb:65,227721326,360,7990,227720966,227721326
4460,5,12,149,5745,-66,-96,30,fa:44:8d:e1:c7:1b,227722093,244,523,227721849,227722093
4461,5,12,149,5745,-61,-96,35,3e:d1:9b:c7:a4:de,227722389,272,24,227722117,227722389
4462,5,12,149,5745,-54,-96,42,f2:da:61:dd:98:c5,227722697,268,40,227722429,227722697
4463,5,12,149,5745,-56,-96,40,5e:29:73:5b:30:00,227723645,272,676,227723373,227723645
4464,5,12,149,5745,-81,-96,15,9a:24:38:da:96:bb,227727754,272,3837,227727482,227727754
4465,5,24,149,5745,-88,-96,8,,227735073,32,7287,227735041,227735073
4466,5,12,149,5745,-53,-96,43,72:fd:09:2f:da:5f,227740183,284,4826,227739899,227740183
4467,5,12,149,5745,-72,-96,24,22:ec:75:a8:8a:31,227756995,244,16568,227756751,227756995
4468,5,12,149,5745,-81,-96,15,72:d1:72:1d:22:a1,227770610,256,13359,227770354,227770610
4469,5,12,149,5745,-79,-96,17,a6:92:ad:b7:76:65,227773080,256,2214,227772824,227773080
4470,5,12,149,5745,-74,-96,22,56:68:e2:c2:8d:d5,227814161,280,40801,227813881,227814161
4471,5,12,149,5745,-71,-96,25,5e:36:fe:bc:a2:fe,227817452,240,3051,227817212,227817452
4472,5,12,149,5745,-59,-96,37,3e:d1:9b:c7:a4:de,227821140,272,3416,227820868,227821140
4473,5,6,149,5745,-86,-96,10,54:e4:3a:ec:fb:65,227823727,360,2227,227823367,227823727
4474,5,12,149,5745,-56,-96,40,5e:29:73:5b:30:00,227830406,272,6407,227830134,227830406
4475,5,12,149,5745,-49,-96,47,f2:da:61:dd:98:c5,227836903,268,6229,227836635,227836903
4476,5,24,149,5745,-87,-96,9,,227840157,32,3222,227840125,227840157
4477,5,12,149,5745,-82,-96,14,9a:24:38:da:96:bb,227840472,272,43,227840200,227840472
4478,5,12,149,5745,-67,-96,29,fa:44:8d:e1:c7:1b,227849760,244,9044,227849516,227849760
4479,5,24,149,5745,-87,-96,9,,227855716,28,5928,227855688,227855716
4480,5,12,149,5745,-70,-96,26,22:ec:75:a8:8a:31,227874112,244,18152,227873868,227874112
4481,5,12,149,5745,-56,-96,40,72:fd:09:2f:da:5f,227923334,284,48938,227923050,227923334
4482,5,6,149,5745,-87,-96,9,54:e4:3a:ec:fb:65,227926127,360,2433,227925767,227926127
4483,5,12,149,5745,-57,-96,39,3e:d1:9b:c7:a4:de,227934711,272,8312,227934439,227934711
4484,5,12,149,5745,-70,-96,26,5e:36:fe:bc:a2:fe,227935106,240,155,227934866,227935106
4485,5,12,149,5745,-55,-96,41,5e:29:73:5b:30:00,227946306,272,10928,227946034,227946306
4486,5,12,149,5745,-75,-96,21,a6:92:ad:b7:76:65,227949335,256,2773,227949079,227949335
4487,5,12,149,5745,-77,-96,19,72:d1:72:1d:22:a1,227950798,256,1207,227950542,227950798
4488,5,12,149,5745,-73,-96,23,56:68:e2:c2:8d:d5,227952866,280,1788,227952586,227952866
4489,5,12,149,5745,-77,-96,19,9a:24:38:da:96:bb,227955761,272,2623,227955489,227955761
4490,5,12,149,5745,-69,-96,27,fa:44:8d:e1:c7:1b,227962374,244,6369,227962130,227962374
4491,5,12,149,5745,-70,-96,26,22:ec:75:a8:8a:31,227988376,244,25758,227988132,227988376
4492,5,12,149,5745,-82,-96,14,d2:00:04:7e:2c:ab,228004761,412,15973,228004349,228004761
4493,5,24,149,5745,-89,-96,7,,228009803,28,5014,228009775,228009803
4494,5,24,149,5745,-89,-96,7,,228024365,28,14534,228024337,228024365
4495,5,12,149,5745,-53,-96,43,72:fd:09:2f:da:5f,228025741,284,1092,228025457,228025741
4496,5,24,149,5745,-89,-96,7,,228026122,28,353,228026094,228026122
4497,5,12,149,5745,-68,-96,28,f6:0a:5c:59:72:df,228026770,252,396,228026518,228026770
4498,5,6,149,5745,-83,-96,13,54:e4:3a:ec:fb:65,228028528,360,1398,228028168,228028528
4499,5,12,149,5745,-50,-96,46,f2:da:61:dd:98:c5,228029944,268,1148,228029676,228029944
4500,5,24,149,5745,-89,-96,7,,228031705,28,1733,228031677,228031705
4501,5,12,149,5745,-67,-96,29,5e:36:fe:bc:a2:fe,228046148,240,14203,228045908,228046148
4502,5,12,149,5745,-56,-96,40,3e:d1:9b:c7:a4:de,228047979,272,1559,228047707,228047979
4503,5,12,149,5745,-73,-96,23,a6:92:ad:b7:76:65,228051764,256,3529,228051508,228051764
4504,5,12,149,5745,-75,-96,21,56:68:e2:c2:8d:d5,228053513,280,1469,228053233,228053513
4505,5,12,149,5745,-79,-96,17,72:d1:72:1d:22:a1,228053822,256,53,228053566,228053822
4506,5,12,149,5745,-51,-96,45,f2:da:61:dd:98:c5,228062838,268,8748,228062570,228062838
4507,5,12,149,5745,-80,-96,16,9a:24:38:da:96:bb,228067269,272,4159,228066997,228067269
4508,5,12,149,5745,-66,-96,30,5e:36:fe:bc:a2:fe,228082123,240,14614,228081883,228082123
4509,5,12,149,5745,-65,-96,31,fa:44:8d:e1:c7:1b,228082578,244,211,228082334,228082578
4510,5,12,149,5745,-50,-96,46,72:fd:09:2f:da:5f,228083387,284,525,228083103,228083387
4511,5,12,149,5745,-70,-96,26,f6:0a:5c:59:72:df,228083750,252,111,228083498,228083750
4512,5,12,149,5745,-55,-96,41,5e:29:73:5b:30:00,228085508,272,1486,228085236,228085508
4513,5,12,149,5745,-59,-96,37,3e:d1:9b:c7:a4:de,228090332,544,4280,228089788,228090332
4514,5,12,149,5745,-50,-96,46,72:fd:09:2f:da:5f,228090946,480,134,228090466,228090946
4515,5,12,149,5745,-65,-96,31,fa:44:8d:e1:c7:1b,228092621,440,1235,228092181,228092621
4516,5,12,149,5745,-74,-96,22,a6:92:ad:b7:76:65,228098117,256,5240,228097861,228098117
4517,5,12,149,5745,-79,-96,17,72:d1:72:1d:22:a1,228099444,256,1071,228099188,228099444
4518,5,12,149,5745,-75,-96,21,56:68:e2:c2:8d:d5,228101007,476,1087,228100531,228101007
4519,5,12,149,5745,-53,-96,43,5e:29:73:5b:30:00,228105278,540,3731,228104738,228105278
4520,5,12,149,5745,-77,-96,19,72:d1:72:1d:22:a1,228106376,452,646,228105924,228106376
4521,5,12,149,5745,-70,-96,26,22:ec:75:a8:8a:31,228107871,516,979,228107355,228107871
4522,5,12,149,5745,-54,-96,42,f2:da:61:dd:98:c5,228109384,268,1245,228109116,228109384
4523,5,24,149,5745,-89,-96,7,,228110474,28,1062,228110446,228110474
4524,5,24,149,5745,-88,-96,8,,228111809,28,1307,228111781,228111809
4525,5,24,149,5745,-87,-96,9,,228113386,28,1549,228113358,228113386
4526,5,24,149,5745,-88,-96,8,,228113494,32,76,228113462,228113494
4527,5,12,149,5745,-70,-96,26,22:ec:75:a8:8a:31,228113588,244,-150,228113344,228113588
4528,5,24,149,5745,-89,-96,7,,228114822,28,1206,228114794,228114822
4529,5,12,149,5745,-70,-96,26,f6:0a:5c:59:72:df,228120983,252,5909,228120731,228120983
4530,5,6,149,5745,-85,-96,11,54:e4:3a:ec:fb:65,228130928,360,9585,228130568,228130928
4531,5,12,149,5745,-68,-96,28,5e:36:fe:bc:a2:fe,228161080,240,29912,228160840,228161080
4532,5,12,149,5745,-75,-96,21,56:68:e2:c2:8d:d5,228161535,280,175,228161255,228161535
4533,5,12,149,5745,-57,-96,39,3e:d1:9b:c7:a4:de,228164946,272,3139,228164674,228164946
4534,5,12,149,5745,-75,-96,21,a6:92:ad:b7:76:65,228165664,456,262,228165208,228165664
4535,5,12,149,5745,-52,-96,44,f2:da:61:dd:98:c5,228176068,268,10136,228175800,228176068
4536,5,12,149,5745,-55,-96,41,5e:29:73:5b:30:00,228176424,272,84,228176152,228176424
4537,5,12,149,5745,-67,-96,29,fa:44:8d:e1:c7:1b,228189612,244,12944,228189368,228189612
4538,5,12,149,5745,-49,-96,47,72:fd:09:2f:da:5f,228209546,284,19650,228209262,228209546
4539,5,12,149,5745,-74,-96,22,a6:92:ad:b7:76:65,228212798,256,2996,228212542,228212798
4540,5,12,149,5745,-68,-96,28,5e:36:fe:bc:a2:fe,228214177,240,1139,228213937,228214177
4541,5,12,149,5745,-67,-96,29,fa:44:8d:e1:c7:1b,228222065,440,7448,228221625,228222065
4542,5,12,149,5745,-56,-96,40,3e:d1:9b:c7:a4:de,228222593,544,-16,228222049,228222593
4543,5,12,149,5745,-54,-96,42,f2:da:61:dd:98:c5,228223425,268,564,228223157,228223425
4544,5,12,149,5745,-70,-96,26,22:ec:75:a8:8a:31,228228285,244,4616,228228041,228228285
4545,5,12,149,5745,-74,-96,22,a6:92:ad:b7:76:65,228231398,456,2657,228230942,228231398
4546,5,12,149,5745,-53,-96,43,5e:29:73:5b:30:00,228237179,540,5241,228236639,228237179
4547,5,12,149,5745,-70,-96,26,22:ec:75:a8:8a:31,228237780,516,85,228237264,228237780
4548,5,12,149,5745,-77,-96,19,72:d1:72:1d:22:a1,228258341,256,20305,228258085,228258341
4549,5,12,149,5745,-76,-96,20,56:68:e2:c2:8d:d5,228260089,280,1468,228259809,228260089
4550,5,12,149,5745,-69,-96,27,5e:36:fe:bc:a2:fe,228263258,240,2929,228263018,228263258
4551,5,12,149,5745,-56,-96,40,3e:d1:9b:c7:a4:de,228277339,272,13809,228277067,228277339
4552,5,12,149,5745,-56,-96,40,5e:29:73:5b:30:00,228293471,272,15860,228293199,228293471
4553,5,12,149,5745,-53,-96,43,f2:da:61:dd:98:c5,228294519,268,780,228294251,228294519
4554,5,12,149,5745,-67,-96,29,fa:44:8d:e1:c7:1b,228302357,244,7594,228302113,228302357
4555,5,12,149,5745,-53,-96,43,72:fd:09:2f:da:5f,228320407,284,17766,228320123,228320407
4556,5,12,149,5745,-69,-96,27,22:ec:75:a8:8a:31,228330342,244,9691,228330098,228330342
4557,5,6,149,5745,-91,-96,5,54:e4:3a:ec:fb:65,228335729,360,5027,228335369,228335729
4558,5,12,149,5745,-74,-96,22,a6:92:ad:b7:76:65,228338093,256,2108,228337837,228338093
4559,5,12,149,5745,-77,-96,19,72:d1:72:1d:22:a1,228360357,256,22008,228360101,228360357
4560,5,12,149,5745,-67,-96,29,f6:0a:5c:59:72:df,228366037,252,5428,228365785,228366037
4561,5,12,149,5745,-77,-96,19,56:68:e2:c2:8d:d5,228378518,280,12201,228378238,228378518
4562,5,12,149,5745,-60,-96,36,3e:d1:9b:c7:a4:de,228394604,272,15814,228394332,228394604
4563,5,12,149,5745,-53,-96,43,5e:29:73:5b:30:00,228410485,272,15609,228410213,228410485
4564,5,24,149,5745,-88,-96,8,,228413911,28,3398,228413883,228413911
4565,5,12,149,5745,-49,-96,47,72:fd:09:2f:da:5f,228434439,284,20244,228434155,228434439
4566,5,6,149,5745,-88,-96,8,54:e4:3a:ec:fb:65,228438130,360,3331,228437770,228438130
4567,5,12,149,5745,-53,-96,43,f2:da:61:dd:98:c5,228438806,268,408,228438538,228438806
4568,5,12,149,5745,-69,-96,27,22:ec:75:a8:8a:31,228447556,244,8506,228447312,228447556
4569,5,12,149,5745,-75,-96,21,a6:92:ad:b7:76:65,228461300,256,13488,228461044,228461300
4570,5,12,149,5745,-70,-96,26,fa:44:8d:e1:c7:1b,228462746,244,1202,228462502,228462746
4571,5,12,149,5745,-76,-96,20,72:d1:72:1d:22:a1,228463196,256,194,228462940,228463196
4572,5,12,149,5745,-69,-96,27,f6:0a:5c:59:72:df,228478260,252,14812,228478008,228478260
4573,5,12,149,5745,-80,-96,16,9a:24:38:da:96:bb,228489221,272,10689,228488949,228489221
4574,5,12,149,5745,-62,-96,34,3e:d1:9b:c7:a4:de,228511564,272,22071,228511292,228511564
4575,5,12,149,5745,-55,-96,41,5e:29:73:5b:30:00,228527010,272,15174,228526738,228527010
4576,5,24,149,5745,-88,-96,8,,228533068,28,6030,228533040,228533068
4577,5,24,149,5745,-88,-96,8,,228533398,28,302,228533370,228533398
4578,5,24,149,5745,-90,-96,6,,228533967,28,541,228533939,228533967
4579,5,24,149,5745,-88,-96,8,,228535428,28,1433,228535400,228535428
4580,5,24,149,5745,-89,-96,7,,228536558,28,1102,228536530,228536558
4581,5,24,149,5745,-88,-96,8,,228536666,32,76,228536634,228536666
4582,5,24,149,5745,-88,-96,8,,228537771,28,1077,228537743,228537771
4583,5,6,149,5745,-87,-96,9,54:e4:3a:ec:fb:65,228540530,360,2399,228540170,228540530
4584,5,12,149,5745,-56,-96,40,f2:da:61:dd:98:c5,228541395,268,597,228541127,228541395
4585,5,12,149,5745,-52,-96,44,72:fd:09:2f:da:5f,228546179,284,4500,228545895,228546179
4586,5,24,149,5745,-87,-96,9,,228554373,28,8166,228554345,228554373
4587,5,24,149,5745,-88,-96,8,,228554627,28,226,228554599,228554627
4588,5,24,149,5745,-88,-96,8,,228557320,28,2665,228557292,228557320
4589,5,12,149,5745,-71,-96,25,a6:92:ad:b7:76:65,228563669,256,6093,228563413,228563669
4590,5,12,149,5745,-70,-96,26,22:ec:75:a8:8a:31,228564602,244,689,228564358,228564602
4591,5,12,149,5745,-71,-96,25,fa:44:8d:e1:c7:1b,228565123,244,277,228564879,228565123
4592,5,12,149,5745,-76,-96,20,72:d1:72:1d:22:a1,228565583,256,204,228565327,228565583
4593,5,12,149,5745,-78,-96,18,56:68:e2:c2:8d:d5,228570370,280,4507,228570090,228570370
4594,5,12,149,5745,-77,-96,19,56:68:e2:c2:8d:d5,228612870,280,42220,228612590,228612870
4595,5,12,149,5745,-62,-96,34,3e:d1:9b:c7:a4:de,228623345,272,10203,228623073,228623345
4596,5,12,149,5745,-54,-96,42,5e:29:73:5b:30:00,228639528,272,15911,228639256,228639528
4597,5,12,149,5745,-71,-96,25,fa:44:8d:e1:c7:1b,228642010,244,2238,228641766,228642010
4598,5,6,149,5745,-86,-96,10,54:e4:3a:ec:fb:65,228642931,360,561,228642571,228642931
4599,5,12,149,5745,-54,-96,42,f2:da:61:dd:98:c5,228644286,268,1087,228644018,228644286
4600,5,12,149,5745,-54,-96,42,72:fd:09:2f:da:5f,228654095,284,9525,228653811,228654095
4601,5,12,149,5745,-72,-96,24,a6:92:ad:b7:76:65,228671629,256,17278,228671373,228671629
4602,5,12,149,5745,-77,-96,19,72:d1:72:1d:22:a1,228672974,256,1089,228672718,228672974
4603,5,12,149,5745,-71,-96,25,f6:0a:5c:59:72:df,228673399,252,173,228673147,228673399
4604,5,12,149,5745,-54,-96,42,72:fd:09:2f:da:5f,228676538,480,2659,228676058,228676538
4605,5,12,149,5745,-61,-96,35,3e:d1:9b:c7:a4:de,228679310,544,2228,228678766,228679310
4606,5,12,149,5745,-71,-96,25,fa:44:8d:e1:c7:1b,228681284,440,1534,228680844,228681284
4607,5,12,149,5745,-53,-96,43,f2:da:61:dd:98:c5,228682668,268,1116,228682400,228682668
4608,5,12,149,5745,-71,-96,25,22:ec:75:a8:8a:31,228686877,244,3965,228686633,228686877
4609,5,24,149,5745,-87,-96,9,,228687183,28,278,228687155,228687183
4610,5,12,149,5745,-76,-96,20,56:68:e2:c2:8d:d5,228690428,476,2769,228689952,228690428
4611,5,24,149,5745,-88,-96,8,,228691140,32,680,228691108,228691140
4612,5,12,149,5745,-71,-96,25,f6:0a:5c:59:72:df,228691214,252,-178,228690962,228691214
4613,5,24,149,5745,-88,-96,8,,228691981,28,739,228691953,228691981
4614,5,24,149,5745,-88,-96,8,,228692101,32,88,228692069,228692101
4615,5,12,149,5745,-72,-96,24,a6:92:ad:b7:76:65,228692176,456,-381,228691720,228692176
4616,5,24,149,5745,-86,-96,10,,228692810,28,606,228692782,228692810
4617,5,24,149,5745,-86,-96,10,,228693148,28,310,228693120,228693148
4618,5,12,149,5745,-55,-96,41,5e:29:73:5b:30:00,228694331,540,643,228693791,228694331
4619,5,12,149,5745,-71,-96,25,22:ec:75:a8:8a:31,228695233,516,386,228694717,228695233
4620,5,24,149,5745,-87,-96,9,,228695900,28,639,228695872,228695900
4621,5,24,149,5745,-88,-96,8,,228696020,32,88,228695988,228696020
4622,5,12,149,5745,-78,-96,18,72:d1:72:1d:22:a1,228698092,452,1620,228697640,228698092
4623,5,12,149,5745,-76,-96,20,56:68:e2:c2:8d:d5,228705364,280,6992,228705084,228705364
4624,5,12,149,5745,-81,-96,15,9a:24:38:da:96:bb,228709767,272,4131,228709495,228709767
4625,5,12,149,5745,-55,-96,41,f2:da:61:dd:98:c5,228738658,268,28623,228738390,228738658
4626,5,12,149,5745,-73,-96,23,f6:0a:5c:59:72:df,228739418,252,508,228739166,228739418
4627,5,12,149,5745,-55,-96,41,72:fd:09:2f:da:5f,228741883,480,1985,228741403,228741883
4628,5,12,149,5745,-59,-96,37,3e:d1:9b:c7:a4:de,228744215,544,1788,228743671,228744215
4629,5,24,149,5745,-87,-96,9,,228744937,28,694,228744909,228744937
4630,5,6,149,5745,-85,-96,11,54:e4:3a:ec:fb:65,228745331,360,34,228744971,228745331
4631,5,12,149,5745,-70,-96,26,fa:44:8d:e1:c7:1b,228746149,440,378,228745709,228746149
4632,5,12,149,5745,-55,-96,41,f2:da:61:dd:98:c5,228747748,268,1331,228747480,228747748
4633,5,12,149,5745,-78,-96,18,56:68:e2:c2:8d:d5,228753374,476,5150,228752898,228753374
4634,5,12,149,5745,-59,-96,37,3e:d1:9b:c7:a4:de,228754613,272,967,228754341,228754613
4635,5,12,149,5745,-53,-96,43,5e:29:73:5b:30:00,228758877,540,3724,228758337,228758877
4636,5,12,149,5745,-65,-96,31,0a:b9:b7:b1:4d:fa,228759550,268,405,228759282,228759550
4637,5,12,149,5745,-72,-96,24,22:ec:75:a8:8a:31,228760095,516,29,228759579,228760095
4638,5,12,149,5745,-79,-96,17,72:d1:72:1d:22:a1,228761691,452,1144,228761239,228761691
4639,5,12,149,5745,-80,-96,16,d2:00:04:7e:2c:ab,228763448,440,1317,228763008,228763448
4640,5,12,149,5745,-79,-96,17,72:d1:72:1d:22:a1,228771024,256,7320,228770768,228771024
4641,5,12,149,5745,-53,-96,43,5e:29:73:5b:30:00,228772264,272,968,228771992,228772264
4642,5,24,149,5745,-88,-96,8,,228781903,28,9611,228781875,228781903
4643,5,24,149,5745,-88,-96,8,,228782253,28,322,228782225,228782253
4644,5,12,149,5745,-68,-96,28,a6:92:ad:b7:76:65,228786700,256,4191,228786444,228786700
4645,5,12,149,5745,-70,-96,26,22:ec:75:a8:8a:31,228790953,244,4009,228790709,228790953
4646,5,24,149,5745,-86,-96,10,,228804098,28,13117,228804070,228804098
4647,5,24,149,5745,-89,-96,7,,228814724,32,10594,228814692,228814724
4648,5,24,149,5745,-89,-96,7,,228814994,28,242,228814966,228814994
4649,5,12,149,5745,-71,-96,25,f6:0a:5c:59:72:df,228819049,252,3803,228818797,228819049
4650,5,12,149,5745,-84,-96,12,9a:24:38:da:96:bb,228822791,272,3470,228822519,228822791
4651,5,24,149,5745,-88,-96,8,,228823547,28,728,228823519,228823547
4652,5,24,149,5745,-88,-96,8,,228826980,28,3405,228826952,228826980
4653,5,24,149,5745,-87,-96,9,,228827088,32,76,228827056,228827088
4654,5,12,149,5745,-78,-96,18,56:68:e2:c2:8d:d5,228828460,280,1092,228828180,228828460
4655,5,12,149,5745,-55,-96,41,f2:da:61:dd:98:c5,228843646,268,14918,228843378,228843646
4656,5,6,149,5745,-86,-96,10,54:e4:3a:ec:fb:65,228847732,360,3726,228847372,228847732
4657,5,12,149,5745,-61,-96,35,3e:d1:9b:c7:a4:de,228852349,272,4345,228852077,228852349
4658,5,12,149,5745,-56,-96,40,f2:da:61:dd:98:c5,228853251,268,634,228852983,228853251
4659,5,24,149,5745,-88,-96,8,,228855824,28,2545,228855796,228855824
4660,5,24,149,5745,-89,-96,7,,228859674,32,3818,228859642,228859674
4661,5,12,149,5745,-72,-96,24,fa:44:8d:e1:c7:1b,228868926,244,9008,228868682,228868926
4662,5,12,149,5745,-50,-96,46,5e:29:73:5b:30:00,228869213,272,15,228868941,228869213
4663,5,12,149,5745,-57,-96,39,f2:da:61:dd:98:c5,228874799,268,5318,228874531,228874799
4664,5,24,149,5745,-88,-96,8,,228893465,28,18638,228893437,228893465
4665,5,24,149,5745,-88,-96,8,,228894051,28,558,228894023,228894051
4666,5,24,149,5745,-88,-96,8,,228896488,32,2405,228896456,228896488
4667,5,24,149,5745,-88,-96,8,,228897616,32,1096,228897584,228897616
4668,5,24,149,5745,-87,-96,9,,228898707,28,1063,228898679,228898707
4669,5,24,149,5745,-88,-96,8,,228899060,28,325,228899032,228899060
4670,5,24,149,5745,-89,-96,7,,228901758,32,2666,228901726,228901758
4671,5,12,149,5745,-69,-96,27,22:ec:75:a8:8a:31,228907769,244,5767,228907525,228907769
4672,5,24,149,5745,-87,-96,9,,228926581,32,18780,228926549,228926581
4673,5,12,149,5745,-78,-96,18,9a:24:38:da:96:bb,228937841,272,10988,228937569,228937841
4674,5,12,149,5745,-57,-96,39,f2:da:61:dd:98:c5,228942890,268,4781,228942622,228942890
4675,5,12,149,5745,-54,-96,42,72:fd:09:2f:da:5f,228947319,284,4145,228947035,228947319
4676,5,6,149,5745,-90,-96,6,54:e4:3a:ec:fb:65,228950133,360,2454,228949773,228950133
4677,5,24,149,5745,-89,-96,7,,228953632,32,3467,228953600,228953632
4678,5,24,149,5745,-89,-96,7,,228954756,28,1096,228954728,228954756
4679,5,12,149,5745,-64,-96,32,3e:d1:9b:c7:a4:de,228969975,272,14947,228969703,228969975
4680,5,12,149,5745,-57,-96,39,f2:da:61:dd:98:c5,228970282,268,39,228970014,228970282
4681,5,12,149,5745,-73,-96,23,a6:92:ad:b7:76:65,228973785,256,3247,228973529,228973785
4682,5,12,149,5745,-82,-96,14,72:d1:72:1d:22:a1,228975160,256,1119,228974904,228975160
4683,5,12,149,5745,-78,-96,18,56:68:e2:c2:8d:d5,228975792,280,352,228975512,228975792
4684,5,12,149,5745,-72,-96,24,fa:44:8d:e1:c7:1b,228982536,244,6500,228982292,228982536
4685,5,12,149,5745,-50,-96,46,5e:29:73:5b:30:00,228986154,272,3346,228985882,228986154
4686,5,24,149,5745,-89,-96,7,,228999827,28,13645,228999799,228999827
4687,5,6,149,5745,-76,-96,20,,229005045,52,5166,229004993,229005045
4688,5,6,149,5745,-89,-96,7,,229005113,44,24,229005069,229005113
4689,5,24,149,5745,-90,-96,6,,229024471,28,19330,229024443,229024471
4690,5,12,149,5745,-69,-96,27,22:ec:75:a8:8a:31,229028592,244,3877,229028348,229028592
4691,5,12,149,5745,-77,-96,19,9a:24:38:da:96:bb,229046503,272,17639,229046231,229046503
4692,5,12,149,5745,-55,-96,41,72:fd:09:2f:da:5f,229049041,284,2254,229048757,229049041
4693,5,6,149,5745,-89,-96,7,54:e4:3a:ec:fb:65,229052533,360,3132,229052173,229052533
4694,5,12,149,5745,-73,-96,23,a6:92:ad:b7:76:65,229075671,256,22882,229075415,229075671
4695,5,12,149,5745,-84,-96,12,72:d1:72:1d:22:a1,229077328,256,1401,229077072,229077328
4696,5,12,149,5745,-80,-96,16,56:68:e2:c2:8d:d5,229079346,280,1738,229079066,229079346
4697,5,12,149,5745,-56,-96,40,f2:da:61:dd:98:c5,229084862,268,5248,229084594,229084862
4698,5,12,149,5745,-61,-96,35,3e:d1:9b:c7:a4:de,229086947,272,1813,229086675,229086947
4699,5,12,149,5745,-75,-96,21,fa:44:8d:e1:c7:1b,229093088,244,5897,229092844,229093088
4700,5,12,149,5745,-50,-96,46,5e:29:73:5b:30:00,229100978,272,7618,229100706,229100978
4701,5,12,149,5745,-55,-96,41,72:fd:09:2f:da:5f,229108408,284,7146,229108124,229108408
4702,5,12,149,5745,-84,-96,12,72:d1:72:1d:22:a1,229118202,256,9538,229117946,229118202
4703,5,12,149,5745,-72,-96,24,a6:92:ad:b7:76:65,229130328,256,11870,229130072,229130328
4704,5,12,149,5745,-71,-96,25,f6:0a:5c:59:72:df,229131313,252,733,229131061,229131313
4705,5,12,149,5745,-54,-96,42,72:fd:09:2f:da:5f,229136900,480,5107,229136420,229136900
4706,5,12,149,5745,-71,-96,25,f6:0a:5c:59:72:df,229138889,252,1737,229138637,229138889
4707,5,12,149,5745,-76,-96,20,fa:44:8d:e1:c7:1b,229139609,440,280,229139169,229139609
4708,5,12,149,5745,-61,-96,35,3e:d1:9b:c7:a4:de,229140965,544,812,229140421,229140965
4709,5,12,149,5745,-54,-96,42,f2:da:61:dd:98:c5,229141545,268,312,229141277,229141545
4710,5,12,149,5745,-70,-96,26,22:ec:75:a8:8a:31,229145630,244,3841,229145386,229145630
4711,5,12,149,5745,-71,-96,25,a6:92:ad:b7:76:65,229150250,456,4164,229149794,229150250
4712,5,12,149,5745,-79,-96,17,56:68:e2:c2:8d:d5,229150794,476,68,229150318,229150794
4713,5,12,149,5745,-49,-96,47,5e:29:73:5b:30:00,229152267,540,933,229151727,229152267
4714,5,12,149,5745,-79,-96,17,9a:24:38:da:96:bb,229152878,824,-213,229152054,229152878
4715,5,12,149,5745,-70,-96,26,22:ec:75:a8:8a:31,229153726,516,332,229153210,229153726
4716,5,6,149,5745,-90,-96,6,54:e4:3a:ec:fb:65,229154934,360,848,229154574,229154934
4717,5,12,149,5745,-84,-96,12,72:d1:72:1d:22:a1,229156797,452,1411,229156345,229156797
4718,5,12,149,5745,-79,-96,17,9a:24:38:da:96:bb,229157656,272,587,229157384,229157656
4719,5,6,149,5745,-77,-96,19,,229160007,52,2299,229159955,229160007
4720,5,6,149,5745,-90,-96,6,,229160075,44,24,229160031,229160075
4721,5,12,149,5745,-80,-96,16,56:68:e2:c2:8d:d5,229164187,280,3832,229163907,229164187
4722,5,12,149,5745,-52,-96,44,f2:da:61:dd:98:c5,229197278,268,32823,229197010,229197278
4723,5,12,149,5745,-53,-96,43,f2:da:61:dd:98:c5,229202701,268,5155,229202433,229202701
4724,5,12,149,5745,-61,-96,35,3e:d1:9b:c7:a4:de,229203503,272,530,229203231,229203503
4725,5,12,149,5745,-76,-96,20,fa:44:8d:e1:c7:1b,229211134,244,7387,229210890,229211134
4726,5,12,149,5745,-50,-96,46,5e:29:73:5b:30:00,229214865,272,3459,229214593,229214865
4727,5,12,149,5745,-53,-96,43,72:fd:09:2f:da:5f,229218048,284,2899,229217764,229218048
4728,5,6,149,5745,-76,-96,20,,229219876,52,1776,229219824,229219876
4729,5,6,149,5745,-89,-96,7,,229219944,44,24,229219900,229219944
4730,5,6,149,5745,-76,-96,20,,229220223,52,227,229220171,229220223
4731,5,6,149,5745,-89,-96,7,,229220291,44,24,229220247,229220291
4732,5,12,149,5745,-68,-96,28,a6:92:ad:b7:76:65,229228552,256,8005,229228296,229228552
4733,5,12,149,5745,-83,-96,13,72:d1:72:1d:22:a1,229235645,256,6837,229235389,229235645
4734,5,12,149,5745,-79,-96,17,d2:00:04:7e:2c:ab,229251541,380,15516,229251161,229251541
4735,5,6,149,5745,-90,-96,6,54:e4:3a:ec:fb:65,229257334,360,5433,229256974,229257334
4736,5,12,149,5745,-71,-96,25,22:ec:75:a8:8a:31,229260353,244,2775,229260109,229260353
4737,5,12,149,5745,-52,-96,44,f2:da:61:dd:98:c5,229268216,268,7595,229267948,229268216
4738,5,12,149,5745,-62,-96,34,3e:d1:9b:c7:a4:de,229270732,544,1972,229270188,229270732
4739,5,12,149,5745,-77,-96,19,fa:44:8d:e1:c7:1b,229271519,440,347,229271079,229271519
4740,5,12,149,5745,-69,-96,27,f6:0a:5c:59:72:df,229277384,252,5613,229277132,229277384
4741,5,12,149,5745,-79,-96,17,56:68:e2:c2:8d:d5,229278865,280,1201,229278585,229278865
4742,5,12,149,5745,-68,-96,28,a6:92:ad:b7:76:65,229279881,456,560,229279425,229279881
4743,5,12,149,5745,-83,-96,13,9a:24:38:da:96:bb,229281118,824,413,229280294,229281118
4744,5,12,149,5745,-51,-96,45,5e:29:73:5b:30:00,229283800,540,2142,229283260,229283800
4745,5,12,149,5745,-67,-96,29,0a:b9:b7:b1:4d:fa,229285473,268,1405,229285205,229285473
4746,5,12,149,5745,-71,-96,25,22:ec:75:a8:8a:31,229286693,516,704,229286177,229286693
4747,5,12,149,5745,-79,-96,17,d2:00:04:7e:2c:ab,229288541,440,1408,229288101,229288541
4748,5,12,149,5745,-51,-96,45,f2:da:61:dd:98:c5,229295490,268,6681,229295222,229295490
4749,5,12,149,5745,-83,-96,13,9a:24:38:da:96:bb,229305353,272,9591,229305081,229305353
4750,5,12,149,5745,-78,-96,18,fa:44:8d:e1:c7:1b,229311776,244,6179,229311532,229311776
4751,5,12,149,5745,-62,-96,34,3e:d1:9b:c7:a4:de,229317558,272,5510,229317286,229317558
4752,5,12,149,5745,-52,-96,44,5e:29:73:5b:30:00,229328254,272,10424,229327982,229328254
4753,5,12,149,5745,-51,-96,45,f2:da:61:dd:98:c5,229334962,268,6440,229334694,229334962
4754,5,12,149,5745,-83,-96,13,72:d1:72:1d:22:a1,229349295,256,14077,229349039,229349295
4755,5,12,149,5745,-54,-96,42,72:fd:09:2f:da:5f,229356920,284,7341,229356636,229356920
4756,5,12,149,5745,-70,-96,26,a6:92:ad:b7:76:65,229357275,256,99,229357019,229357275
4757,5,6,149,5745,-90,-96,6,54:e4:3a:ec:fb:65,229359735,360,2100,229359375,229359735
4758,5,12,149,5745,-70,-96,26,22:ec:75:a8:8a:31,229366792,244,6813,229366548,229366792
4759,5,12,149,5745,-78,-96,18,56:68:e2:c2:8d:d5,229389943,280,22871,229389663,229389943
4760,5,12,149,5745,-51,-96,45,f2:da:61:dd:98:c5,229399261,268,9050,229398993,229399261
4761,5,12,149,5745,-51,-96,45,f2:da:61:dd:98:c5,229410183,268,10654,229409915,229410183
4762,5,12,149,5745,-62,-96,34,3e:d1:9b:c7:a4:de,229434704,272,24249,229434432,229434704
4763,5,12,149,5745,-53,-96,43,5e:29:73:5b:30:00,229445165,272,10189,229444893,229445165
4764,5,12,149,5745,-53,-96,43,72:fd:09:2f:da:5f,229459315,284,13866,229459031,229459315
4765,5,6,149,5745,-88,-96,8,54:e4:3a:ec:fb:65,229462135,360,2460,229461775,229462135
4766,5,12,149,5745,-51,-96,45,f2:da:61:dd:98:c5,229465531,268,3128,229465263,229465531
4767,5,12,149,5745,-70,-96,26,22:ec:75:a8:8a:31,229483886,244,18111,229483642,229483886
4768,5,12,149,5745,-69,-96,27,a6:92:ad:b7:76:65,229485251,256,1109,229484995,229485251
4769,5,12,149,5745,-76,-96,20,fa:44:8d:e1:c7:1b,229486931,244,1436,229486687,229486931
4770,5,12,149,5745,-84,-96,12,72:d1:72:1d:22:a1,229487231,256,44,229486975,229487231
4771,5,12,149,5745,-78,-96,18,56:68:e2:c2:8d:d5,229501159,280,13648,229500879,229501159
4772,5,24,149,5745,-88,-96,8,,229520484,28,19297,229520456,229520484
4773,5,24,149,5745,-88,-96,8,,229527775,32,7259,229527743,229527775
4774,5,24,149,5745,-88,-96,8,,229539508,28,11705,229539480,229539508
4775,5,12,149,5745,-61,-96,35,3e:d1:9b:c7:a4:de,229548347,272,8567,229548075,229548347
4776,5,12,149,5745,-53,-96,43,5e:29:73:5b:30:00,229560225,272,11606,229559953,229560225
4777,5,12,149,5745,-51,-96,45,72:fd:09:2f:da:5f,229561674,284,1165,229561390,229561674
4778,5,6,149,5745,-86,-96,10,54:e4:3a:ec:fb:65,229564535,360,2501,229564175,229564535
4779,5,6,149,5745,-76,-96,20,,229572840,52,8253,229572788,229572840
4780,5,6,149,5745,-88,-96,8,,229572908,44,24,229572864,229572908
4781,5,6,149,5745,-75,-96,21,,229573582,52,622,229573530,229573582
4782,5,6,149,5745,-87,-96,9,,229573650,44,24,229573606,229573650
4783,5,12,149,5745,-69,-96,27,a6:92:ad:b7:76:65,229587614,256,13708,229587358,229587614
4784,5,12,149,5745,-73,-96,23,fa:44:8d:e1:c7:1b,229589261,244,1403,229589017,229589261
4785,5,12,149,5745,-83,-96,13,72:d1:72:1d:22:a1,229589541,256,24,229589285,229589541
4786,5,24,149,5745,-77,-96,19,,229590010,28,441,229589982,229590010
4787,5,24,149,5745,-77,-96,19,,229590384,28,346,229590356,229590384
4788,5,6,149,5745,-75,-96,21,,229590692,52,256,229590640,229590692
4789,5,6,149,5745,-88,-96,8,,229590760,44,24,229590716,229590760
4790,5,6,149,5745,-75,-96,21,,229591083,52,271,229591031,229591083
4791,5,6,149,5745,-88,-96,8,,229591151,44,24,229591107,229591151
4792,5,12,149,5745,-70,-96,26,22:ec:75:a8:8a:31,229600945,244,9550,229600701,229600945
4793,5,12,149,5745,-71,-96,25,f6:0a:5c:59:72:df,229608738,252,7541,229608486,229608738
4794,5,24,149,5745,-87,-96,9,,229621192,28,12426,229621164,229621192
4795,5,12,149,5745,-60,-96,36,3e:d1:9b:c7:a4:de,229660487,272,39023,229660215,229660487
4796,5,6,149,5745,-85,-96,11,54:e4:3a:ec:fb:65,229666936,360,6089,229666576,229666936
4797,5,12,149,5745,-48,-96,48,f2:da:61:dd:98:c5,229668231,268,1027,229667963,229668231
4798,5,12,149,5745,-52,-96,44,5e:29:73:5b:30:00,229672024,272,3521,229671752,229672024
4799,5,12,149,5745,-49,-96,47,72:fd:09:2f:da:5f,229678019,284,5711,229677735,229678019
4800,5,12,149,5745,-70,-96,26,a6:92:ad:b7:76:65,229689458,256,11183,229689202,229689458
4801,5,12,149,5745,-74,-96,22,fa:44:8d:e1:c7:1b,229691152,244,1450,229690908,229691152
4802,5,12,149,5745,-81,-96,15,72:d1:72:1d:22:a1,229691682,256,274,229691426,229691682
4803,5,12,149,5745,-79,-96,17,56:68:e2:c2:8d:d5,229692079,280,117,229691799,229692079
4804,5,12,149,5745,-71,-96,25,f6:0a:5c:59:72:df,229708161,252,15830,229707909,229708161
4805,5,12,149,5745,-71,-96,25,22:ec:75:a8:8a:31,229719055,244,10650,229718811,229719055
4806,5,12,149,5745,-78,-96,18,56:68:e2:c2:8d:d5,229721215,280,1880,229720935,229721215
4807,5,12,149,5745,-72,-96,24,f6:0a:5c:59:72:df,229722311,252,844,229722059,229722311
4808,5,12,149,5745,-49,-96,47,72:fd:09:2f:da:5f,229725123,480,2332,229724643,229725123
4809,5,12,149,5745,-60,-96,36,3e:d1:9b:c7:a4:de,229727895,544,2228,229727351,229727895
4810,5,12,149,5745,-48,-96,48,f2:da:61:dd:98:c5,229729501,268,1338,229729233,229729501
4811,5,12,149,5745,-74,-96,22,fa:44:8d:e1:c7:1b,229729911,440,-30,229729471,229729911
4812,5,12,149,5745,-79,-96,17,56:68:e2:c2:8d:d5,229736599,476,6212,229736123,229736599
4813,5,12,149,5745,-70,-96,26,22:ec:75:a8:8a:31,229737683,516,568,229737167,229737683
4814,5,12,149,5745,-70,-96,26,a6:92:ad:b7:76:65,229738286,456,147,229737830,229738286
4815,5,12,149,5745,-51,-96,45,5e:29:73:5b:30:00,229742254,540,3428,229741714,229742254
4816,5,12,149,5745,-80,-96,16,72:d1:72:1d:22:a1,229744403,452,1697,229743951,229744403
4817,5,12,149,5745,-48,-96,48,f2:da:61:dd:98:c5,229754224,268,9553,229753956,229754224
4818,5,12,149,5745,-82,-96,14,9a:24:38:da:96:bb,229754932,272,436,229754660,229754932
4819,5,6,149,5745,-84,-96,12,54:e4:3a:ec:fb:65,229769337,360,14045,229768977,229769337
4820,5,12,149,5745,-72,-96,24,fa:44:8d:e1:c7:1b,229770380,244,799,229770136,229770380
4821,5,12,149,5745,-51,-96,45,72:fd:09:2f:da:5f,229771335,284,671,229771051,229771335
4822,5,12,149,5745,-60,-96,36,3e:d1:9b:c7:a4:de,229786827,272,15220,229786555,229786827
4823,5,12,149,5745,-73,-96,23,f6:0a:5c:59:72:df,229787787,252,708,229787535,229787787
4824,5,12,149,5745,-51,-96,45,72:fd:09:2f:da:5f,229790445,480,2178,229789965,229790445
4825,5,12,149,5745,-49,-96,47,f2:da:61:dd:98:c5,229792086,268,1373,229791818,229792086
4826,5,12,149,5745,-61,-96,35,3e:d1:9b:c7:a4:de,229793270,544,640,229792726,229793270
4827,5,12,149,5745,-72,-96,24,fa:44:8d:e1:c7:1b,229795236,440,1526,229794796,229795236
4828,5,12,149,5745,-79,-96,17,56:68:e2:c2:8d:d5,229802000,476,6288,229801524,229802000
4829,5,12,149,5745,-68,-96,28,a6:92:ad:b7:76:65,229802555,256,299,229802299,229802555
4830,5,12,149,5745,-70,-96,26,22:ec:75:a8:8a:31,229802873,516,-198,229802357,229802873
4831,5,12,149,5745,-52,-96,44,5e:29:73:5b:30:00,229804492,272,1347,229804220,229804492
4832,5,12,149,5745,-52,-96,44,5e:29:73:5b:30:00,229807166,540,2134,229806626,229807166
4833,5,12,149,5745,-66,-96,30,0a:b9:b7:b1:4d:fa,229808505,268,1071,229808237,229808505
4834,5,12,149,5745,-78,-96,18,72:d1:72:1d:22:a1,229809797,452,840,229809345,229809797
4835,5,12,149,5745,-79,-96,17,d2:00:04:7e:2c:ab,229810572,440,335,229810132,229810572
4836,5,12,149,5745,-73,-96,23,f6:0a:5c:59:72:df,229819912,252,9088,229819660,229819912
4837,5,12,149,5745,-70,-96,26,22:ec:75:a8:8a:31,229834085,244,13929,229833841,229834085
4838,5,12,149,5745,-79,-96,17,56:68:e2:c2:8d:d5,229837765,280,3400,229837485,229837765
4839,5,24,149,5745,-88,-96,8,,229857504,28,19711,229857476,229857504
4840,5,24,149,5745,-89,-96,7,,229859607,28,2075,229859579,229859607
4841,5,12,149,5745,-70,-96,26,22:ec:75:a8:8a:31,229868653,516,8530,229868137,229868653
4842,5,6,149,5745,-84,-96,12,54:e4:3a:ec:fb:65,229871737,360,2724,229871377,229871737
4843,5,12,149,5745,-50,-96,46,f2:da:61:dd:98:c5,229877557,268,5552,229877289,229877557
4844,5,12,149,5745,-72,-96,24,fa:44:8d:e1:c7:1b,229889680,244,11879,229889436,229889680
4845,5,12,149,5745,-62,-96,34,3e:d1:9b:c7:a4:de,229890110,272,158,229889838,229890110
4846,5,12,149,5745,-53,-96,43,5e:29:73:5b:30:00,229901645,272,11263,229901373,229901645
4847,5,6,149,5745,-74,-96,22,,229908929,52,7232,229908877,229908929
4848,5,6,149,5745,-88,-96,8,,229908997,44,24,229908953,229908997
4849,5,12,149,5745,-79,-96,17,72:d1:72:1d:22:a1,229909208,256,-45,229908952,229909208
4850,5,24,149,5745,-75,-96,21,,229911262,28,2026,229911234,229911262
4851,5,24,149,5745,-89,-96,7,,229928640,32,17346,229928608,229928640
4852,5,12,149,5745,-70,-96,26,22:ec:75:a8:8a:31,229933821,516,4665,229933305,229933821
4853,5,12,149,5745,-70,-96,26,22:ec:75:a8:8a:31,229949410,244,15345,229949166,229949410
4854,5,24,149,5745,-75,-96,21,,229970696,28,21258,229970668,229970696
4855,5,6,149,5745,-85,-96,11,54:e4:3a:ec:fb:65,229974165,360,3109,229973805,229974165
4856,5,12,149,5745,-84,-96,12,9a:24:38:da:96:bb,229979114,272,4677,229978842,229979114
4857,5,24,149,5745,-88,-96,8,,229986664,28,7522,229986636,229986664
4858,5,12,149,5745,-51,-96,45,f2:da:61:dd:98:c5,229987125,268,193,229986857,229987125
4859,5,12,149,5745,-69,-96,27,a6:92:ad:b7:76:65,229997810,256,10429,229997554,229997810
4860,5,12,149,5745,-70,-96,26,22:ec:75:a8:8a:31,229999765,516,1439,229999249,229999765
4861,5,12,149,5745,-62,-96,34,3e:d1:9b:c7:a4:de,230002571,272,2534,230002299,230002571
4862,5,12,149,5745,-70,-96,26,fa:44:8d:e1:c7:1b,230003481,244,666,230003237,230003481
4863,5,12,149,5745,-52,-96,44,5e:29:73:5b:30:00,230018556,272,14803,230018284,230018556
4864,5,24,149,5745,-88,-96,8,,230043186,28,24602,230043158,230043186
4865,5,12,149,5745,-70,-96,26,22:ec:75:a8:8a:31,230054754,244,11324,230054510,230054754
4866,5,12,149,5745,-70,-96,26,f6:0a:5c:59:72:df,230060544,252,5538,230060292,230060544
4867,5,12,149,5745,-49,-96,47,72:fd:09:2f:da:5f,230073702,284,12874,230073418,230073702
4868,5,6,149,5745,-87,-96,9,54:e4:3a:ec:fb:65,230076538,360,2476,230076178,230076538
4869,5,12,149,5745,-71,-96,25,a6:92:ad:b7:76:65,230096185,256,19391,230095929,230096185
4870,5,12,149,5745,-79,-96,17,72:d1:72:1d:22:a1,230100641,256,4200,230100385,230100641
4871,5,12,149,5745,-81,-96,15,56:68:e2:c2:8d:d5,230103926,280,3005,230103646,230103926
4872,5,12,149,5745,-82,-96,14,9a:24:38:da:96:bb,230107935,272,3737,230107663,230107935
4873,5,12,149,5745,-52,-96,44,f2:da:61:dd:98:c5,230108767,268,564,230108499,230108767
4874,5,12,149,5745,-71,-96,25,fa:44:8d:e1:c7:1b,230116704,244,7693,230116460,230116704
4875,5,12,149,5745,-63,-96,33,3e:d1:9b:c7:a4:de,230119567,272,2591,230119295,230119567
4876,5,12,149,5745,-50,-96,46,72:fd:09:2f:da:5f,230120359,284,508,230120075,230120359
4877,5,12,149,5745,-52,-96,44,5e:29:73:5b:30:00,230133057,272,12426,230132785,230133057
4878,5,12,149,5745,-70,-96,26,a6:92:ad:b7:76:65,230137342,256,4029,230137086,230137342
4879,5,12,149,5745,-79,-96,17,72:d1:72:1d:22:a1,230138508,256,910,230138252,230138508
4880,5,12,149,5745,-71,-96,25,f6:0a:5c:59:72:df,230162717,252,23957,230162465,230162717
4881,5,12,149,5745,-69,-96,27,22:ec:75:a8:8a:31,230177862,244,14901,230177618,230177862
4882,5,6,149,5745,-87,-96,9,54:e4:3a:ec:fb:65,230178939,360,717,230178579,230178939
4883,5,12,149,5745,-78,-96,18,56:68:e2:c2:8d:d5,230179967,280,748,230179687,230179967
4884,5,12,149,5745,-71,-96,25,f6:0a:5c:59:72:df,230180398,252,179,230180146,230180398
4885,5,12,149,5745,-51,-96,45,f2:da:61:dd:98:c5,230181503,268,837,230181235,230181503
4886,5,12,149,5745,-51,-96,45,72:fd:09:2f:da:5f,230187845,480,5862,230187365,230187845
4887,5,12,149,5745,-62,-96,34,3e:d1:9b:c7:a4:de,230188368,544,-21,230187824,230188368
4888,5,12,149,5745,-72,-96,24,fa:44:8d:e1:c7:1b,230189955,440,1147,230189515,230189955
4889,5,24,149,5745,-88,-96,8,,230192080,28,2097,230192052,230192080
4890,5,12,149,5745,-70,-96,26,a6:92:ad:b7:76:65,230197582,456,5046,230197126,230197582
4891,5,12,149,5745,-77,-96,19,56:68:e2:c2:8d:d5,230199397,476,1339,230198921,230199397
4892,5,12,149,5745,-52,-96,44,5e:29:73:5b:30:00,230203047,540,3110,230202507,230203047
4893,5,12,149,5745,-78,-96,18,72:d1:72:1d:22:a1,230203677,452,178,230203225,230203677
4894,5,12,149,5745,-84,-96,12,9a:24:38:da:96:bb,230204404,272,455,230204132,230204404
4895,5,12,149,5745,-51,-96,45,f2:da:61:dd:98:c5,230212961,268,8289,230212693,230212961
4896,5,12,149,5745,-72,-96,24,fa:44:8d:e1:c7:1b,230229274,244,16069,230229030,230229274
4897,5,12,149,5745,-51,-96,45,72:fd:09:2f:da:5f,230230579,284,1021,230230295,230230579
4898,5,12,149,5745,-61,-96,35,3e:d1:9b:c7:a4:de,230233962,272,3111,230233690,230233962
4899,5,12,149,5745,-69,-96,27,a6:92:ad:b7:76:65,230244321,256,10103,230244065,230244321
4900,5,12,149,5745,-53,-96,43,5e:29:73:5b:30:00,230247249,272,2656,230246977,230247249
4901,5,12,149,5745,-79,-96,17,72:d1:72:1d:22:a1,230257379,256,9874,230257123,230257379
4902,5,12,149,5745,-70,-96,26,22:ec:75:a8:8a:31,230261836,516,3941,230261320,230261836
4903,5,12,149,5745,-69,-96,27,a6:92:ad:b7:76:65,230263052,456,760,230262596,230263052
4904,5,24,149,5745,-88,-96,8,,230270024,28,6944,230269996,230270024
4905,5,6,149,5745,-87,-96,9,54:e4:3a:ec:fb:65,230281339,360,10955,230280979,230281339
4906,5,12,149,5745,-76,-96,20,56:68:e2:c2:8d:d5,230289994,280,8375,230289714,230289994
4907,5,12,149,5745,-70,-96,26,22:ec:75:a8:8a:31,230292802,244,2564,230292558,230292802
4908,5,12,149,5745,-70,-96,26,22:ec:75:a8:8a:31,230311911,516,18593,230311395,230311911
4909,5,12,149,5745,-55,-96,41,f2:da:61:dd:98:c5,230312461,268,282,230312193,230312461
4910,5,12,149,5745,-83,-96,13,9a:24:38:da:96:bb,230315689,272,2956,230315417,230315689
4911,5,12,149,5745,-61,-96,35,3e:d1:9b:c7:a4:de,230318371,544,2138,230317827,230318371
4912,5,12,149,5745,-72,-96,24,fa:44:8d:e1:c7:1b,230320166,440,1355,230319726,230320166
4913,5,12,149,5745,-72,-96,24,fa:44:8d:e1:c7:1b,230327048,244,6638,230326804,230327048
4914,5,12,149,5745,-55,-96,41,f2:da:61:dd:98:c5,230327650,268,334,230327382,230327650
4915,5,12,149,5745,-69,-96,27,a6:92:ad:b7:76:65,230328646,456,540,230328190,230328646
4916,5,12,149,5745,-83,-96,13,9a:24:38:da:96:bb,230330604,824,1134,230329780,230330604
4917,5,12,149,5745,-78,-96,18,d2:00:04:7e:2c:ab,230333233,440,2189,230332793,230333233
4918,5,12,149,5745,-67,-96,29,0a:b9:b7:b1:4d:fa,230334139,268,638,230333871,230334139
4919,5,12,149,5745,-53,-96,43,5e:29:73:5b:30:00,230334486,540,-193,230333946,230334486
4920,5,12,149,5745,-70,-96,26,a6:92:ad:b7:76:65,230359383,256,24641,230359127,230359383
4921,5,12,149,5745,-61,-96,35,3e:d1:9b:c7:a4:de,230361852,272,2197,230361580,230361852
4922,5,12,149,5745,-53,-96,43,5e:29:73:5b:30:00,230362364,272,240,230362092,230362364
4923,5,12,149,5745,-70,-96,26,22:ec:75:a8:8a:31,230377926,516,15046,230377410,230377926
4924,5,12,149,5745,-51,-96,45,72:fd:09:2f:da:5f,230380607,284,2397,230380323,230380607
4925,5,6,149,5745,-86,-96,10,54:e4:3a:ec:fb:65,230383740,360,2773,230383380,230383740
4926,5,12,149,5745,-76,-96,20,56:68:e2:c2:8d:d5,230403602,280,19582,230403322,230403602
4927,5,12,149,5745,-70,-96,26,22:ec:75:a8:8a:31,230407219,244,3373,230406975,230407219
4928,5,12,149,5745,-77,-96,19,72:d1:72:1d:22:a1,230408392,256,917,230408136,230408392
4929,5,24,149,5745,-89,-96,7,,230417186,28,8766,230417158,230417186
4930,5,12,149,5745,-70,-96,26,22:ec:75:a8:8a:31,230443530,516,25828,230443014,230443530
4931,5,12,149,5745,-60,-96,36,3e:d1:9b:c7:a4:de,230464198,272,20396,230463926,230464198
4932,5,12,149,5745,-54,-96,42,5e:29:73:5b:30:00,230475527,272,11057,230475255,230475527
4933,5,12,149,5745,-50,-96,46,72:fd:09:2f:da:5f,230483341,284,7530,230483057,230483341
4934,5,6,149,5745,-86,-96,10,54:e4:3a:ec:fb:65,230486140,360,2439,230485780,230486140
4935,5,12,149,5745,-55,-96,41,f2:da:61:dd:98:c5,230486805,268,397,230486537,230486805
4936,5,12,149,5745,-70,-96,26,22:ec:75:a8:8a:31,230508988,516,21667,230508472,230508988
4937,5,12,149,5745,-71,-96,25,a6:92:ad:b7:76:65,230509527,256,283,230509271,230509527
4938,5,12,149,5745,-72,-96,24,fa:44:8d:e1:c7:1b,230509827,244,56,230509583,230509827
4939,5,12,149,5745,-76,-96,20,72:d1:72:1d:22:a1,230510757,256,674,230510501,230510757
4940,5,12,149,5745,-78,-96,18,56:68:e2:c2:8d:d5,230515179,280,4142,230514899,230515179
4941,5,12,149,5745,-71,-96,25,f6:0a:5c:59:72:df,230521349,252,5918,230521097,230521349
4942,5,12,149,5745,-70,-96,26,22:ec:75:a8:8a:31,230522073,244,480,230521829,230522073
4943,5,12,149,5745,-80,-96,16,9a:24:38:da:96:bb,230540663,272,18318,230540391,230540663
4944,5,12,149,5745,-59,-96,37,3e:d1:9b:c7:a4:de,230580199,272,39264,230579927,230580199
4945,5,12,149,5745,-49,-96,47,72:fd:09:2f:da:5f,230585605,284,5122,230585321,230585605
4946,5,6,149,5745,-85,-96,11,54:e4:3a:ec:fb:65,230588541,360,2576,230588181,230588541
4947,5,12,149,5745,-55,-96,41,f2:da:61:dd:98:c5,230589243,268,434,230588975,230589243
4948,5,12,149,5745,-56,-96,40,5e:29:73:5b:30:00,230593402,272,3887,230593130,230593402
4949,5,12,149,5745,-71,-96,25,a6:92:ad:b7:76:65,230611703,256,18045,230611447,230611703
4950,5,12,149,5745,-72,-96,24,fa:44:8d:e1:c7:1b,230612735,244,788,230612491,230612735
4951,5,12,149,5745,-77,-96,19,72:d1:72:1d:22:a1,230613427,256,436,230613171,230613427
4952,5,12,149,5745,-71,-96,25,22:ec:75:a8:8a:31,230619537,244,5866,230619293,230619537
4953,5,12,149,5745,-76,-96,20,56:68:e2:c2:8d:d5,230626085,280,6268,230625805,230626085
4954,5,12,149,5745,-72,-96,24,f6:0a:5c:59:72:df,230641075,252,14738,230640823,230641075
4955,5,12,149,5745,-78,-96,18,9a:24:38:da:96:bb,230655456,272,14109,230655184,230655456
4956,5,12,149,5745,-49,-96,47,72:fd:09:2f:da:5f,230688094,284,32354,230687810,230688094
4957,5,6,149,5745,-84,-96,12,54:e4:3a:ec:fb:65,230690941,360,2487,230690581,230690941
4958,5,12,149,5745,-55,-96,41,f2:da:61:dd:98:c5,230691651,268,442,230691383,230691651
4959,5,12,149,5745,-60,-96,36,3e:d1:9b:c7:a4:de,230692134,272,211,230691862,230692134
4960,5,12,149,5745,-56,-96,40,5e:29:73:5b:30:00,230705343,272,12937,230705071,230705343
4961,5,12,149,5745,-70,-96,26,a6:92:ad:b7:76:65,230713606,256,8007,230713350,230713606
4962,5,12,149,5745,-72,-96,24,fa:44:8d:e1:c7:1b,230715588,244,1738,230715344,230715588
4963,5,12,149,5745,-77,-96,19,72:d1:72:1d:22:a1,230716066,256,222,230715810,230716066
4964,5,12,149,5745,-72,-96,24,22:ec:75:a8:8a:31,230731318,244,15008,230731074,230731318
4965,5,12,149,5745,-78,-96,18,56:68:e2:c2:8d:d5,230748129,280,16531,230747849,230748129
4966,5,12,149,5745,-54,-96,42,f2:da:61:dd:98:c5,230770655,268,22258,230770387,230770655
4967,5,12,149,5745,-73,-96,23,f6:0a:5c:59:72:df,230771056,252,149,230770804,230771056
4968,5,12,149,5745,-54,-96,42,f2:da:61:dd:98:c5,230773142,268,1818,230772874,230773142
4969,5,12,149,5745,-73,-96,23,22:ec:75:a8:8a:31,230775541,516,1883,230775025,230775541
4970,5,12,149,5745,-48,-96,48,72:fd:09:2f:da:5f,230776469,480,448,230775989,230776469
4971,5,12,149,5745,-73,-96,23,fa:44:8d:e1:c7:1b,230777411,440,502,230776971,230777411
4972,5,12,149,5745,-59,-96,37,3e:d1:9b:c7:a4:de,230777912,544,-43,230777368,230777912
4973,5,12,149,5745,-77,-96,19,56:68:e2:c2:8d:d5,230785186,476,6798,230784710,230785186
4974,5,12,149,5745,-73,-96,23,fa:44:8d:e1:c7:1b,230786363,244,933,230786119,230786363
4975,5,12,149,5745,-48,-96,48,72:fd:09:2f:da:5f,230786675,284,28,230786391,230786675
4976,5,12,149,5745,-53,-96,43,5e:29:73:5b:30:00,230790848,540,3633,230790308,230790848
4977,5,6,149,5745,-83,-96,13,54:e4:3a:ec:fb:65,230793342,360,2134,230792982,230793342
4978,5,12,149,5745,-78,-96,18,72:d1:72:1d:22:a1,230795290,452,1496,230794838,230795290
4979,5,12,149,5745,-78,-96,18,72:d1:72:1d:22:a1,230802541,256,6995,230802285,230802541
4980,5,24,149,5745,-88,-96,8,,230812802,28,10233,230812774,230812802
4981,5,12,149,5745,-59,-96,37,3e:d1:9b:c7:a4:de,230817328,272,4254,230817056,230817328
4982,5,12,149,5745,-70,-96,26,a6:92:ad:b7:76:65,230818291,256,707,230818035,230818291
4983,5,12,149,5745,-80,-96,16,56:68:e2:c2:8d:d5,230835420,280,16849,230835140,230835420
4984,5,12,149,5745,-52,-96,44,5e:29:73:5b:30:00,230836706,272,1014,230836434,230836706
4985,5,12,149,5745,-73,-96,23,f6:0a:5c:59:72:df,230839343,252,2385,230839091,230839343
4986,5,12,149,5745,-58,-96,38,3e:d1:9b:c7:a4:de,230840371,544,484,230839827,230840371
4987,5,12,149,5745,-73,-96,23,22:ec:75:a8:8a:31,230840949,516,62,230840433,230840949
4988,5,12,149,5745,-69,-96,27,a6:92:ad:b7:76:65,230841499,456,94,230841043,230841499
4989,5,24,149,5745,-87,-96,9,,230842187,32,656,230842155,230842187
4990,5,12,149,5745,-73,-96,23,fa:44:8d:e1:c7:1b,230843105,440,478,230842665,230843105
4991,5,12,149,5745,-53,-96,43,f2:da:61:dd:98:c5,230846488,268,3115,230846220,230846488
4992,5,12,149,5745,-80,-96,16,56:68:e2:c2:8d:d5,230848761,476,1797,230848285,230848761
4993,5,12,149,5745,-52,-96,44,5e:29:73:5b:30:00,230849272,540,-29,230848732,230849272
4994,5,12,149,5745,-75,-96,21,f6:0a:5c:59:72:df,230849899,252,375,230849647,230849899
4995,5,12,149,5745,-49,-96,47,72:fd:09:2f:da:5f,230853221,480,2842,230852741,230853221
4996,5,12,149,5745,-81,-96,15,9a:24:38:da:96:bb,230855209,824,1164,230854385,230855209
4997,5,12,149,5745,-67,-96,29,0a:b9:b7:b1:4d:fa,230856067,268,590,230855799,230856067
4998,5,24,149,5745,-87,-96,9,,230858056,32,1957,230858024,230858056
4999,5,12,149,5745,-76,-96,20,72:d1:72:1d:22:a1,230858381,452,-127,230857929,230858381
5000,5,12,149,5745,-73,-96,23,22:ec:75:a8:8a:31,230865954,244,7329,230865710,230865954
5001,5,12,149,5745,-81,-96,15,9a:24:38:da:96:bb,230873860,272,7634,230873588,230873860
5002,5,12,149,5745,-53,-96,43,f2:da:61:dd:98:c5,230885030,268,10902,230884762,230885030
5003,5,6,149,5745,-82,-96,14,54:e4:3a:ec:fb:65,230895742,360,10352,230895382,230895742
5004,5,12,149,5745,-74,-96,22,fa:44:8d:e1:c7:1b,230911312,244,15326,230911068,230911312
5005,5,12,149,5745,-47,-96,49,72:fd:09:2f:da:5f,230912410,284,814,230912126,230912410
5006,5,12,149,5745,-57,-96,39,3e:d1:9b:c7:a4:de,230921737,272,9055,230921465,230921737
5007,5,24,149,5745,-74,-96,22,,230924106,28,2341,230924078,230924106
5008,5,12,149,5745,-78,-96,18,72:d1:72:1d:22:a1,230928089,256,3727,230927833,230928089
5009,5,24,149,5745,-88,-96,8,,230928470,28,353,230928442,230928470
5010,5,12,149,5745,-71,-96,25,a6:92:ad:b7:76:65,230930639,256,1913,230930383,230930639
5011,5,12,149,5745,-52,-96,44,5e:29:73:5b:30:00,230934990,272,4079,230934718,230934990
5012,5,12,149,5745,-72,-96,24,22:ec:75:a8:8a:31,230958087,244,22853,230957843,230958087
5013,5,12,149,5745,-73,-96,23,f6:0a:5c:59:72:df,230972638,252,14299,230972386,230972638
5014,5,24,149,5745,-75,-96,21,,230984614,28,11948,230984586,230984614
5015,5,24,149,5745,-89,-96,7,,230984658,28,16,230984630,230984658
5016,5,12,149,5745,-80,-96,16,9a:24:38:da:96:bb,230986029,272,1099,230985757,230986029
5017,5,6,149,5745,-84,-96,12,54:e4:3a:ec:fb:65,230998143,360,11754,230997783,230998143
5018,5,12,149,5745,-52,-96,44,f2:da:61:dd:98:c5,231007202,268,8791,231006934,231007202
5019,5,12,149,5745,-73,-96,23,fa:44:8d:e1:c7:1b,231019210,244,11764,231018966,231019210
5020,5,12,149,5745,-78,-96,18,56:68:e2:c2:8d:d5,231024577,280,5087,231024297,231024577
5021,5,12,149,5745,-58,-96,38,3e:d1:9b:c7:a4:de,231038902,272,14053,231038630,231038902
5022,5,12,149,5745,-80,-96,16,72:d1:72:1d:22:a1,231039425,256,267,231039169,231039425
5023,5,12,149,5745,-56,-96,40,5e:29:73:5b:30:00,231050885,272,11188,231050613,231050885
5024,5,12,149,5745,-73,-96,23,22:ec:75:a8:8a:31,231075376,244,24247,231075132,231075376
5025,5,12,149,5745,-48,-96,48,72:fd:09:2f:da:5f,231097755,284,22095,231097471,231097755
5026,5,6,149,5745,-87,-96,9,54:e4:3a:ec:fb:65,231100543,360,2428,231100183,231100543
5027,5,12,149,5745,-75,-96,21,9a:24:38:da:96:bb,231102554,272,1739,231102282,231102554
5028,5,6,149,5745,-80,-96,16,fe:1f:10:c7:b2:4d,231117179,164,14461,231117015,231117179
5029,5,12,149,5745,-52,-96,44,f2:da:61:dd:98:c5,231117560,268,113,231117292,231117560
5030,5,6,149,5745,-80,-96,16,,231117861,44,257,231117817,231117861
5031,5,12,149,5745,-73,-96,23,a6:92:ad:b7:76:65,231123926,256,5809,231123670,231123926
5032,5,12,149,5745,-77,-96,19,56:68:e2:c2:8d:d5,231129016,280,4810,231128736,231129016
5033,5,12,149,5745,-74,-96,22,fa:44:8d:e1:c7:1b,231135938,244,6678,231135694,231135938
5034,5,6,149,5745,-79,-96,17,fe:1f:10:c7:b2:4d,231139459,164,3357,231139295,231139459
5035,5,6,149,5745,-87,-96,9,54:e4:3a:ec:fb:65,231139775,352,-36,231139423,231139775
5036,5,6,149,5745,-79,-96,17,,231140145,44,326,231140101,231140145
5037,5,12,149,5745,-59,-96,37,3e:d1:9b:c7:a4:de,231154623,272,14206,231154351,231154623
5038,5,12,149,5745,-78,-96,18,72:d1:72:1d:22:a1,231157074,256,2195,231156818,231157074
5039,5,12,149,5745,-74,-96,22,a6:92:ad:b7:76:65,231162355,256,5025,231162099,231162355
5040,5,12,149,5745,-51,-96,45,5e:29:73:5b:30:00,231167855,272,5228,231167583,231167855
5041,5,12,149,5745,-71,-96,25,22:ec:75:a8:8a:31,231188840,244,20741,231188596,231188840
5042,5,12,149,5745,-78,-96,18,56:68:e2:c2:8d:d5,231189816,280,696,231189536,231189816
5043,5,12,149,5745,-48,-96,48,72:fd:09:2f:da:5f,231200200,284,10100,231199916,231200200
5044,5,6,149,5745,-85,-96,11,54:e4:3a:ec:fb:65,231202944,360,2384,231202584,231202944
5045,5,12,149,5745,-83,-96,13,9a:24:38:da:96:bb,231210422,272,7206,231210150,231210422
5046,5,12,149,5745,-51,-96,45,f2:da:61:dd:98:c5,231228689,268,17999,231228421,231228689
5047,5,12,149,5745,-73,-96,23,f6:0a:5c:59:72:df,231232638,252,3697,231232386,231232638
5048,5,12,149,5745,-71,-96,25,a6:92:ad:b7:76:65,231234166,456,1072,231233710,231234166
5049,5,12,149,5745,-61,-96,35,3e:d1:9b:c7:a4:de,231235314,544,604,231234770,231235314
5050,5,12,149,5745,-74,-96,22,fa:44:8d:e1:c7:1b,231236082,440,328,231235642,231236082
5051,5,12,149,5745,-71,-96,25,22:ec:75:a8:8a:31,231236556,516,-42,231236040,231236556
5052,5,12,149,5745,-51,-96,45,f2:da:61:dd:98:c5,231240148,268,3324,231239880,231240148
5053,5,12,149,5745,-52,-96,44,5e:29:73:5b:30:00,231241893,540,1205,231241353,231241893
5054,5,12,149,5745,-49,-96,47,72:fd:09:2f:da:5f,231243239,284,1062,231242955,231243239
5055,5,12,149,5745,-80,-96,16,56:68:e2:c2:8d:d5,231243620,476,-95,231243144,231243620
5056,5,12,149,5745,-74,-96,22,fa:44:8d:e1:c7:1b,231245464,244,1600,231245220,231245464
5057,5,12,149,5745,-50,-96,46,72:fd:09:2f:da:5f,231245796,480,-148,231245316,231245796
5058,5,12,149,5745,-83,-96,13,9a:24:38:da:96:bb,231247770,824,1150,231246946,231247770
5059,5,12,149,5745,-77,-96,19,72:d1:72:1d:22:a1,231250288,452,2066,231249836,231250288
5060,5,12,149,5745,-72,-96,24,a6:92:ad:b7:76:65,231260161,256,9617,231259905,231260161
5061,5,12,149,5745,-78,-96,18,72:d1:72:1d:22:a1,231261506,256,1089,231261250,231261506
5062,5,12,149,5745,-62,-96,34,3e:d1:9b:c7:a4:de,231276534,272,14756,231276262,231276534
5063,5,12,149,5745,-52,-96,44,5e:29:73:5b:30:00,231283358,272,6552,231283086,231283358
5064,5,24,149,5745,-88,-96,8,,231296782,32,13392,231296750,231296782
5065,5,6,149,5745,-85,-96,11,54:e4:3a:ec:fb:65,231305344,360,8202,231304984,231305344
5066,5,12,149,5745,-70,-96,26,22:ec:75:a8:8a:31,231305917,244,329,231305673,231305917
5067,5,12,149,5745,-73,-96,23,f6:0a:5c:59:72:df,231307367,252,1198,231307115,231307367
5068,5,12,149,5745,-79,-96,17,56:68:e2:c2:8d:d5,231307698,280,51,231307418,231307698
5069,5,24,149,5745,-87,-96,9,,231331333,28,23607,231331305,231331333
5070,5,24,149,5745,-86,-96,10,,231333822,28,2461,231333794,231333822
5071,5,12,149,5745,-83,-96,13,9a:24:38:da:96:bb,231345211,272,11117,231344939,231345211
5072,5,12,149,5745,-73,-96,23,fa:44:8d:e1:c7:1b,231359131,244,13676,231358887,231359131
5073,5,12,149,5745,-75,-96,21,a6:92:ad:b7:76:65,231365052,456,5465,231364596,231365052
5074,5,12,149,5745,-72,-96,24,fa:44:8d:e1:c7:1b,231366893,440,1401,231366453,231366893
5075,5,12,149,5745,-72,-96,24,22:ec:75:a8:8a:31,231367368,516,-41,231366852,231367368
5076,5,12,149,5745,-65,-96,31,3e:d1:9b:c7:a4:de,231367945,544,33,231367401,231367945
5077,5,12,149,5745,-54,-96,42,f2:da:61:dd:98:c5,231372584,268,4371,231372316,231372584
5078,5,12,149,5745,-49,-96,47,5e:29:73:5b:30:00,231373777,540,653,231373237,231373777
5079,5,12,149,5745,-75,-96,21,a6:92:ad:b7:76:65,231375556,256,1523,231375300,231375556
5080,5,12,149,5745,-82,-96,14,9a:24:38:da:96:bb,231377283,824,903,231376459,231377283
5081,5,12,149,5745,-65,-96,31,0a:b9:b7:b1:4d:fa,231378185,268,634,231377917,231378185
5082,5,12,149,5745,-65,-96,31,3e:d1:9b:c7:a4:de,231390379,272,11922,231390107,231390379
5083,5,24,149,5745,-87,-96,9,,231396650,28,6243,231396622,231396650
5084,5,12,149,5745,-52,-96,44,72:fd:09:2f:da:5f,231403679,284,6745,231403395,231403679
5085,5,24,149,5745,-86,-96,10,,231404322,28,615,231404294,231404322
5086,5,24,149,5745,-86,-96,10,,231407205,28,2855,231407177,231407205
5087,5,24,149,5745,-87,-96,9,,231407314,32,77,231407282,231407314
5088,5,6,149,5745,-87,-96,9,54:e4:3a:ec:fb:65,231407745,360,71,231407385,231407745
5089,5,12,149,5745,-48,-96,48,5e:29:73:5b:30:00,231408476,272,459,231408204,231408476
5090,5,12,149,5745,-72,-96,24,f6:0a:5c:59:72:df,231419055,252,10327,231418803,231419055
5091,5,12,149,5745,-74,-96,22,22:ec:75:a8:8a:31,231420096,244,797,231419852,231420096
5092,5,12,149,5745,-81,-96,15,72:d1:72:1d:22:a1,231432707,256,12355,231432451,231432707
5093,5,12,149,5745,-78,-96,18,56:68:e2:c2:8d:d5,231435040,280,2053,231434760,231435040
5094,5,12,149,5745,-81,-96,15,9a:24:38:da:96:bb,231435625,272,313,231435353,231435625
5095,5,12,149,5745,-55,-96,41,f2:da:61:dd:98:c5,231463588,268,27695,231463320,231463588
5096,5,12,149,5745,-62,-96,34,3e:d1:9b:c7:a4:de,231493002,272,29142,231492730,231493002
5097,5,12,149,5745,-50,-96,46,72:fd:09:2f:da:5f,231507317,284,14031,231507033,231507317
5098,5,6,149,5745,-85,-96,11,54:e4:3a:ec:fb:65,231510145,360,2468,231509785,231510145
5099,5,12,149,5745,-48,-96,48,5e:29:73:5b:30:00,231511871,272,1454,231511599,231511871
5100,5,12,149,5745,-73,-96,23,a6:92:ad:b7:76:65,231533236,256,21109,231532980,231533236
5101,5,12,149,5745,-83,-96,13,72:d1:72:1d:22:a1,231534786,256,1294,231534530,231534786
5102,5,12,149,5745,-74,-96,22,fa:44:8d:e1:c7:1b,231535071,244,41,231534827,231535071
5103,5,12,149,5745,-79,-96,17,56:68:e2:c2:8d:d5,231535437,280,86,231535157,231535437
5104,5,12,149,5745,-71,-96,25,22:ec:75:a8:8a:31,231536010,244,329,231535766,231536010
5105,5,12,149,5745,-78,-96,18,9a:24:38:da:96:bb,231551483,272,15201,231551211,231551483
5106,5,24,149,5745,-78,-96,18,,231568234,28,16723,231568206,231568234
5107,5,24,149,5745,-88,-96,8,,231568278,28,16,231568250,231568278
5108,5,24,149,5745,-90,-96,6,,231568386,28,80,231568358,231568386
5109,5,24,149,5745,-89,-96,7,,231578630,32,10212,231578598,231578630
5110,5,24,149,5745,-89,-96,7,,231579201,32,539,231579169,231579201
5111,5,24,149,5745,-89,-96,7,,231579772,28,543,231579744,231579772
5112,5,12,149,5745,-60,-96,36,3e:d1:9b:c7:a4:de,231610247,272,30203,231609975,231610247
5113,5,12,149,5745,-53,-96,43,72:fd:09:2f:da:5f,231612218,284,1687,231611934,231612218
5114,5,6,149,5745,-83,-96,13,54:e4:3a:ec:fb:65,231612546,360,-32,231612186,231612546
5115,5,12,149,5745,-54,-96,42,f2:da:61:dd:98:c5,231614422,268,1608,231614154,231614422
5116,5,12,149,5745,-49,-96,47,5e:29:73:5b:30:00,231627789,272,13095,231627517,231627789
5117,5,12,149,5745,-73,-96,23,a6:92:ad:b7:76:65,231635879,256,7834,231635623,231635879
5118,5,12,149,5745,-73,-96,23,fa:44:8d:e1:c7:1b,231637119,244,996,231636875,231637119
5119,5,12,149,5745,-81,-96,15,72:d1:72:1d:22:a1,231637407,256,32,231637151,231637407
5120,5,12,149,5745,-76,-96,20,56:68:e2:c2:8d:d5,231640938,280,3251,231640658,231640938
5121,5,12,149,5745,-73,-96,23,22:ec:75:a8:8a:31,231653006,244,11824,231652762,231653006
5122,5,12,149,5745,-78,-96,18,9a:24:38:da:96:bb,231659612,272,6334,231659340,231659612
5123,5,24,149,5745,-91,-96,5,,231672911,28,13271,231672883,231672911
5124,5,24,149,5745,-89,-96,7,,231692802,28,19863,231692774,231692802
5125,5,12,149,5745,-51,-96,45,72:fd:09:2f:da:5f,231711308,284,18222,231711024,231711308
5126,5,6,149,5745,-89,-96,7,54:e4:3a:ec:fb:65,231714947,360,3279,231714587,231714947
5127,5,12,149,5745,-56,-96,40,f2:da:61:dd:98:c5,231715951,268,736,231715683,231715951
5128,5,12,149,5745,-60,-96,36,3e:d1:9b:c7:a4:de,231724139,272,7916,231723867,231724139
5129,5,12,149,5745,-75,-96,21,a6:92:ad:b7:76:65,231738368,256,13973,231738112,231738368
5130,5,12,149,5745,-70,-96,26,fa:44:8d:e1:c7:1b,231739461,244,849,231739217,231739461
5131,5,12,149,5745,-79,-96,17,72:d1:72:1d:22:a1,231739759,256,42,231739503,231739759
5132,5,12,149,5745,-50,-96,46,5e:29:73:5b:30:00,231740049,272,18,231739777,231740049
5133,5,12,149,5745,-77,-96,19,56:68:e2:c2:8d:d5,231756140,280,15811,231755860,231756140
5134,5,12,149,5745,-72,-96,24,22:ec:75:a8:8a:31,231764807,244,8423,231764563,231764807
5135,5,12,149,5745,-49,-96,47,72:fd:09:2f:da:5f,231803718,284,38627,231803434,231803718
5136,5,12,149,5745,-53,-96,43,f2:da:61:dd:98:c5,231804047,268,61,231803779,231804047
5137,5,6,149,5745,-90,-96,6,54:e4:3a:ec:fb:65,231817347,360,12940,231816987,231817347
5138,5,12,149,5745,-72,-96,24,fa:44:8d:e1:c7:1b,231818015,244,424,231817771,231818015
5139,5,12,149,5745,-79,-96,17,72:d1:72:1d:22:a1,231818312,256,41,231818056,231818312
5140,5,12,149,5745,-72,-96,24,22:ec:75:a8:8a:31,231823410,516,4582,231822894,231823410
5141,5,12,149,5745,-73,-96,23,f6:0a:5c:59:72:df,231824014,252,352,231823762,231824014
5142,5,12,149,5745,-72,-96,24,a6:92:ad:b7:76:65,231825398,456,928,231824942,231825398
5143,5,12,149,5745,-72,-96,24,fa:44:8d:e1:c7:1b,231826537,440,699,231826097,231826537
5144,5,12,149,5745,-52,-96,44,5e:29:73:5b:30:00,231829873,540,2796,231829333,231829873
5145,5,12,149,5745,-55,-96,41,3e:d1:9b:c7:a4:de,231830483,544,66,231829939,231830483
5146,5,12,149,5745,-55,-96,41,f2:da:61:dd:98:c5,231831063,268,312,231830795,231831063
5147,5,24,149,5745,-75,-96,21,,231831472,28,381,231831444,231831472
5148,5,12,149,5745,-71,-96,25,a6:92:ad:b7:76:65,231833651,256,1923,231833395,231833651
5149,5,12,149,5745,-76,-96,20,56:68:e2:c2:8d:d5,231834469,476,342,231833993,231834469
5150,5,12,149,5745,-50,-96,46,72:fd:09:2f:da:5f,231836794,480,1845,231836314,231836794
5151,5,12,149,5745,-80,-96,16,72:d1:72:1d:22:a1,231840521,452,3275,231840069,231840521
5152,5,12,149,5745,-56,-96,40,3e:d1:9b:c7:a4:de,231849092,272,8299,231848820,231849092
5153,5,12,149,5745,-77,-96,19,56:68:e2:c2:8d:d5,231851172,280,1800,231850892,231851172
5154,5,12,149,5745,-74,-96,22,f6:0a:5c:59:72:df,231861781,252,10357,231861529,231861781
5155,5,12,149,5745,-54,-96,42,5e:29:73:5b:30:00,231866694,272,4641,231866422,231866694
5156,5,12,149,5745,-80,-96,16,9a:24:38:da:96:bb,231882434,272,15468,231882162,231882434
5157,5,12,149,5745,-76,-96,20,f6:0a:5c:59:72:df,231888833,252,6147,231888581,231888833
5158,5,12,149,5745,-71,-96,25,22:ec:75:a8:8a:31,231889173,516,-176,231888657,231889173
5159,5,12,149,5745,-69,-96,27,a6:92:ad:b7:76:65,231890060,456,431,231889604,231890060
5160,5,12,149,5745,-70,-96,26,fa:44:8d:e1:c7:1b,231890552,440,52,231890112,231890552
5161,5,12,149,5745,-57,-96,39,5e:29:73:5b:30:00,231894789,540,3697,231894249,231894789
5162,5,12,149,5745,-57,-96,39,3e:d1:9b:c7:a4:de,231895363,544,30,231894819,231895363
5163,5,12,149,5745,-55,-96,41,f2:da:61:dd:98:c5,231895943,268,312,231895675,231895943
5164,5,12,149,5745,-79,-96,17,56:68:e2:c2:8d:d5,231897177,476,758,231896701,231897177
5165,5,12,149,5745,-72,-96,24,22:ec:75:a8:8a:31,231898326,244,905,231898082,231898326
5166,5,12,149,5745,-53,-96,43,72:fd:09:2f:da:5f,231899360,480,554,231898880,231899360
5167,5,12,149,5745,-55,-96,41,f2:da:61:dd:98:c5,231901055,268,1427,231900787,231901055
5168,5,12,149,5745,-65,-96,31,0a:b9:b7:b1:4d:fa,231902996,268,1673,231902728,231902996
5169,5,12,149,5745,-79,-96,17,72:d1:72:1d:22:a1,231903838,452,390,231903386,231903838
5170,5,12,149,5745,-52,-96,44,72:fd:09:2f:da:5f,231914899,284,10777,231914615,231914899
5171,5,12,149,5745,-79,-96,17,d2:00:04:7e:2c:ab,231917365,272,2194,231917093,231917365
5172,5,6,149,5745,-88,-96,8,54:e4:3a:ec:fb:65,231919748,360,2023,231919388,231919748
5173,5,24,149,5745,-71,-96,25,,231922979,28,3203,231922951,231922979
5174,5,24,149,5745,-90,-96,6,,231923023,28,16,231922995,231923023
5175,5,24,149,5745,-72,-96,24,,231923244,28,193,231923216,231923244
5176,5,24,149,5745,-71,-96,25,,231923524,28,252,231923496,231923524
5177,5,12,149,5745,-71,-96,25,fa:44:8d:e1:c7:1b,231932856,244,9088,231932612,231932856
5178,5,12,149,5745,-80,-96,16,72:d1:72:1d:22:a1,231934162,256,1050,231933906,231934162
5179,5,24,149,5745,-89,-96,7,,231940785,28,6595,231940757,231940785
5180,5,24,149,5745,-90,-96,6,,231941152,28,339,231941124,231941152
5181,5,12,149,5745,-78,-96,18,d2:00:04:7e:2c:ab,231951929,440,10337,231951489,231951929
5182,5,12,149,5745,-69,-96,27,a6:92:ad:b7:76:65,231957857,256,5672,231957601,231957857
5183,5,12,149,5745,-58,-96,38,3e:d1:9b:c7:a4:de,231961000,544,2599,231960456,231961000
5184,5,12,149,5745,-58,-96,38,3e:d1:9b:c7:a4:de,231963792,272,2520,231963520,231963792
5185,5,12,149,5745,-54,-96,42,5e:29:73:5b:30:00,231966001,272,1937,231965729,231966001
5186,5,12,149,5745,-75,-96,21,56:68:e2:c2:8d:d5,231975384,280,9103,231975104,231975384
5187,5,24,149,5745,-71,-96,25,,231983796,28,8384,231983768,231983796
5188,5,24,149,5745,-89,-96,7,,231984034,28,210,231984006,231984034
5189,5,24,149,5745,-71,-96,25,,231984328,28,266,231984300,231984328
5190,5,24,149,5745,-87,-96,9,,231984372,28,16,231984344,231984372
5191,5,24,149,5745,-88,-96,8,,231987116,32,2712,231987084,231987116
5192,5,12,149,5745,-82,-96,14,9a:24:38:da:96:bb,231994234,272,6846,231993962,231994234
5193,5,12,149,5745,-72,-96,24,22:ec:75:a8:8a:31,231997064,244,2586,231996820,231997064
5194,5,24,149,5745,-88,-96,8,,232008443,28,11351,232008415,232008443
5195,5,24,149,5745,-87,-96,9,,232008692,32,217,232008660,232008692
5196,5,6,149,5745,-88,-96,8,54:e4:3a:ec:fb:65,232022148,360,13096,232021788,232022148
5197,5,24,149,5745,-87,-96,9,,232022768,28,592,232022740,232022768
5198,5,24,149,5745,-89,-96,7,,232023094,28,298,232023066,232023094
5199,5,12,149,5745,-59,-96,37,3e:d1:9b:c7:a4:de,232026440,544,2802,232025896,232026440
5200,5,12,149,5745,-52,-96,44,f2:da:61:dd:98:c5,232027580,268,872,232027312,232027580
5201,5,24,149,5745,-87,-96,9,,232028079,28,471,232028051,232028079
5202,5,24,149,5745,-88,-96,8,,232028188,32,77,232028156,232028188
5203,5,24,149,5745,-88,-96,8,,232030624,28,2408,232030596,232030624
5204,5,12,149,5745,-47,-96,49,72:fd:09:2f:da:5f,232031149,284,241,232030865,232031149
5205,5,12,149,5745,-78,-96,18,d2:00:04:7e:2c:ab,232033408,244,2015,232033164,232033408
5206,5,12,149,5745,-72,-96,24,fa:44:8d:e1:c7:1b,232054195,244,20543,232053951,232054195
5207,5,12,149,5745,-78,-96,18,72:d1:72:1d:22:a1,232056163,256,1712,232055907,232056163
5208,5,12,149,5745,-58,-96,38,3e:d1:9b:c7:a4:de,232078553,272,22118,232078281,232078553
5209,5,12,149,5745,-55,-96,41,5e:29:73:5b:30:00,232083140,272,4315,232082868,232083140
5210,5,12,149,5745,-58,-96,38,3e:d1:9b:c7:a4:de,232092050,544,8366,232091506,232092050
5211,5,12,149,5745,-69,-96,27,f6:0a:5c:59:72:df,232099205,252,6903,232098953,232099205
5212,5,12,149,5745,-81,-96,15,9a:24:38:da:96:bb,232107021,272,7544,232106749,232107021
5213,5,12,149,5745,-74,-96,22,22:ec:75:a8:8a:31,232107608,244,343,232107364,232107608
5214,5,24,149,5745,-88,-96,8,,232121250,28,13614,232121222,232121250
5215,5,24,149,5745,-87,-96,9,,232122980,28,1702,232122952,232122980
5216,5,6,149,5745,-83,-96,13,54:e4:3a:ec:fb:65,232124549,360,1209,232124189,232124549
5217,5,12,149,5745,-57,-96,39,f2:da:61:dd:98:c5,232137425,268,12608,232137157,232137425
5218,5,24,149,5745,-87,-96,9,,232143889,28,6436,232143861,232143889
5219,5,12,149,5745,-81,-96,15,d2:00:04:7e:2c:ab,232144839,244,706,232144595,232144839
5220,5,12,149,5745,-70,-96,26,a6:92:ad:b7:76:65,232147992,256,2897,232147736,232147992
5221,5,12,149,5745,-75,-96,21,56:68:e2:c2:8d:d5,232152083,280,3811,232151803,232152083
5222,5,12,149,5745,-72,-96,24,fa:44:8d:e1:c7:1b,232164760,244,12433,232164516,232164760
5223,5,12,149,5745,-80,-96,16,72:d1:72:1d:22:a1,232165183,256,167,232164927,232165183
5224,5,12,149,5745,-58,-96,38,3e:d1:9b:c7:a4:de,232177561,272,12106,232177289,232177561
5225,5,12,149,5745,-56,-96,40,5e:29:73:5b:30:00,232199108,272,21275,232198836,232199108
5226,5,12,149,5745,-69,-96,27,f6:0a:5c:59:72:df,232209844,252,10484,232209592,232209844
5227,5,12,149,5745,-78,-96,18,9a:24:38:da:96:bb,232220748,272,10632,232220476,232220748
5228,5,12,149,5745,-56,-96,40,72:fd:09:2f:da:5f,232224131,284,3099,232223847,232224131
5229,5,12,149,5745,-76,-96,20,22:ec:75:a8:8a:31,232225649,244,1274,232225405,232225649
5230,5,6,149,5745,-84,-96,12,54:e4:3a:ec:fb:65,232226949,360,940,232226589,232226949
5231,5,24,149,5745,-87,-96,9,,232236271,28,9294,232236243,232236271
5232,5,12,149,5745,-72,-96,24,a6:92:ad:b7:76:65,232250058,256,13531,232249802,232250058
5233,5,12,149,5745,-74,-96,22,56:68:e2:c2:8d:d5,232253389,280,3051,232253109,232253389
5234,5,12,149,5745,-81,-96,15,d2:00:04:7e:2c:ab,232260974,244,7341,232260730,232260974
5235,5,12,149,5745,-57,-96,39,f2:da:61:dd:98:c5,232262623,268,1381,232262355,232262623
5236,5,12,149,5745,-54,-96,42,72:fd:09:2f:da:5f,232263591,284,684,232263307,232263591
5237,5,12,149,5745,-68,-96,28,fa:44:8d:e1:c7:1b,232276604,244,12769,232276360,232276604
5238,5,12,149,5745,-80,-96,16,72:d1:72:1d:22:a1,232277046,256,186,232276790,232277046
5239,5,12,149,5745,-70,-96,26,f6:0a:5c:59:72:df,232281278,252,3980,232281026,232281278
5240,5,12,149,5745,-68,-96,28,fa:44:8d:e1:c7:1b,232283950,440,2232,232283510,232283950
5241,5,12,149,5745,-77,-96,19,22:ec:75:a8:8a:31,232285280,516,814,232284764,232285280
5242,5,12,149,5745,-79,-96,17,9a:24:38:da:96:bb,232288315,824,2211,232287491,232288315
5243,5,24,149,5745,-85,-96,11,,232289885,28,1542,232289857,232289885
5244,5,12,149,5745,-57,-96,39,3e:d1:9b:c7:a4:de,232290078,544,-351,232289534,232290078
5245,5,12,149,5745,-52,-96,44,5e:29:73:5b:30:00,232290656,540,38,232290116,232290656
5246,5,12,149,5745,-74,-96,22,56:68:e2:c2:8d:d5,232292159,476,1027,232291683,232292159
5247,5,12,149,5745,-81,-96,15,d2:00:04:7e:2c:ab,232292725,380,186,232292345,232292725
5248,5,12,149,5745,-80,-96,16,d2:00:04:7e:2c:ab,232294203,440,1038,232293763,232294203
5249,5,12,149,5745,-52,-96,44,72:fd:09:2f:da:5f,232296702,480,2019,232296222,232296702
5250,5,12,149,5745,-81,-96,15,72:d1:72:1d:22:a1,232299151,452,1997,232298699,232299151
5251,5,12,149,5745,-56,-96,40,3e:d1:9b:c7:a4:de,232307878,272,8455,232307606,232307878
5252,5,12,149,5745,-74,-96,22,56:68:e2:c2:8d:d5,232309948,280,1790,232309668,232309948
5253,5,24,149,5745,-86,-96,10,,232310335,28,359,232310307,232310335
5254,5,24,149,5745,-85,-96,11,,232311105,28,742,232311077,232311105
5255,5,12,149,5745,-70,-96,26,f6:0a:5c:59:72:df,232311369,252,12,232311117,232311369
5256,5,24,149,5745,-84,-96,12,,232313298,28,1901,232313270,232313298
5257,5,24,149,5745,-85,-96,11,,232313406,32,76,232313374,232313406
5258,5,12,149,5745,-50,-96,46,5e:29:73:5b:30:00,232325958,272,12280,232325686,232325958
5259,5,6,149,5745,-87,-96,9,54:e4:3a:ec:fb:65,232329350,360,3032,232328990,232329350
5260,5,12,149,5745,-80,-96,16,9a:24:38:da:96:bb,232331135,272,1513,232330863,232331135
5261,5,12,149,5745,-80,-96,16,22:ec:75:a8:8a:31,232338046,244,6667,232337802,232338046
5262,5,24,149,5745,-86,-96,10,,232345948,28,7874,232345920,232345948
5263,5,24,149,5745,-88,-96,8,,232345992,28,16,232345964,232345992
5264,5,24,149,5745,-85,-96,11,,232346147,28,127,232346119,232346147
5265,5,24,149,5745,-89,-96,7,,232346191,28,16,232346163,232346191
5266,5,12,149,5745,-56,-96,40,3e:d1:9b:c7:a4:de,232354169,544,7434,232353625,232354169
5267,5,12,149,5745,-82,-96,14,d2:00:04:7e:2c:ab,232357528,244,3115,232357284,232357528
5268,5,12,149,5745,-82,-96,14,d2:00:04:7e:2c:ab,232358420,440,452,232357980,232358420
5269,5,12,149,5745,-49,-96,47,72:fd:09:2f:da:5f,232372910,284,14206,232372626,232372910
5270,5,12,149,5745,-66,-96,30,fa:44:8d:e1:c7:1b,232392607,244,19453,232392363,232392607
5271,5,12,149,5745,-56,-96,40,f2:da:61:dd:98:c5,232410632,268,17757,232410364,232410632
5272,5,12,149,5745,-78,-96,18,22:ec:75:a8:8a:31,232414283,516,3135,232413767,232414283
5273,5,12,149,5745,-73,-96,23,a6:92:ad:b7:76:65,232414887,456,148,232414431,232414887
5274,5,12,149,5745,-67,-96,29,fa:44:8d:e1:c7:1b,232415432,440,105,232414992,232415432
5275,5,12,149,5745,-81,-96,15,9a:24:38:da:96:bb,232418214,824,1958,232417390,232418214
5276,5,12,149,5745,-56,-96,40,3e:d1:9b:c7:a4:de,232419216,544,458,232418672,232419216
5277,5,12,149,5745,-49,-96,47,5e:29:73:5b:30:00,232422216,540,2460,232421676,232422216
5278,5,12,149,5745,-57,-96,39,3e:d1:9b:c7:a4:de,232422817,272,329,232422545,232422817
5279,5,12,149,5745,-84,-96,12,d2:00:04:7e:2c:ab,232424293,440,1036,232423853,232424293
5280,5,12,149,5745,-68,-96,28,0a:b9:b7:b1:4d:fa,232428082,268,3521,232427814,232428082
5281,5,6,149,5745,-86,-96,10,54:e4:3a:ec:fb:65,232431750,360,3308,232431390,232431750
5282,5,12,149,5745,-49,-96,47,5e:29:73:5b:30:00,232439797,272,7775,232439525,232439797
5283,5,12,149,5745,-81,-96,15,9a:24:38:da:96:bb,232443557,272,3488,232443285,232443557
5284,5,12,149,5745,-75,-96,21,22:ec:75:a8:8a:31,232456053,244,12252,232455809,232456053
5285,5,12,149,5745,-81,-96,15,72:d1:72:1d:22:a1,232456592,256,283,232456336,232456592
5286,5,12,149,5745,-76,-96,20,56:68:e2:c2:8d:d5,232457519,280,647,232457239,232457519
5287,5,12,149,5745,-83,-96,13,d2:00:04:7e:2c:ab,232472168,244,14405,232471924,232472168
5288,5,12,149,5745,-58,-96,38,3e:d1:9b:c7:a4:de,232485280,544,12568,232484736,232485280
5289,5,12,149,5745,-82,-96,14,d2:00:04:7e:2c:ab,232489557,440,3837,232489117,232489557
5290,5,12,149,5745,-66,-96,30,fa:44:8d:e1:c7:1b,232510669,244,20868,232510425,232510669
5291,5,12,149,5745,-59,-96,37,3e:d1:9b:c7:a4:de,232521215,272,10274,232520943,232521215
5292,5,24,149,5745,-86,-96,10,,232530276,28,9033,232530248,232530276
5293,5,24,149,5745,-87,-96,9,,232530385,32,77,232530353,232530385
5294,5,12,149,5745,-48,-96,48,72:fd:09:2f:da:5f,232531333,284,664,232531049,232531333
5295,5,6,149,5745,-86,-96,10,54:e4:3a:ec:fb:65,232534151,360,2458,232533791,232534151
5296,5,12,149,5745,-52,-96,44,5e:29:73:5b:30:00,232540499,272,6076,232540227,232540499
5297,5,12,149,5745,-59,-96,37,3e:d1:9b:c7:a4:de,232550822,544,9779,232550278,232550822
5298,5,12,149,5745,-78,-96,18,9a:24:38:da:96:bb,232555064,272,3970,232554792,232555064
5299,5,12,149,5745,-81,-96,15,72:d1:72:1d:22:a1,232559077,256,3757,232558821,232559077
5300,5,12,149,5745,-78,-96,18,56:68:e2:c2:8d:d5,232559925,280,568,232559645,232559925
5301,5,12,149,5745,-74,-96,22,22:ec:75:a8:8a:31,232567462,244,7293,232567218,232567462
5302,5,12,149,5745,-72,-96,24,f6:0a:5c:59:72:df,232570564,252,2850,232570312,232570564
5303,5,24,149,5745,-86,-96,10,,232587734,28,17142,232587706,232587734
5304,5,24,149,5745,-87,-96,9,,232612907,28,25145,232612879,232612907
5305,5,24,149,5745,-88,-96,8,,232612951,28,16,232612923,232612951
5306,5,24,149,5745,-86,-96,10,,232614578,28,1599,232614550,232614578
5307,5,24,149,5745,-88,-96,8,,232615775,28,1169,232615747,232615775
5308,5,24,149,5745,-87,-96,9,,232615819,28,16,232615791,232615819
5309,5,24,149,5745,-87,-96,9,,232615927,32,76,232615895,232615927
5310,5,12,149,5745,-61,-96,35,3e:d1:9b:c7:a4:de,232616029,544,-442,232615485,232616029
5311,5,24,149,5745,-87,-96,9,,232617567,28,1510,232617539,232617567
5312,5,24,149,5745,-87,-96,9,,232617675,32,76,232617643,232617675
5313,5,24,149,5745,-86,-96,10,,232618774,28,1071,232618746,232618774
5314,5,24,149,5745,-86,-96,10,,232628340,28,9538,232628312,232628340
5315,5,24,149,5745,-87,-96,9,,232628449,32,77,232628417,232628449
5316,5,12,149,5745,-48,-96,48,72:fd:09:2f:da:5f,232632090,284,3357,232631806,232632090
5317,5,12,149,5745,-61,-96,35,3e:d1:9b:c7:a4:de,232635612,272,3250,232635340,232635612
5318,5,6,149,5745,-86,-96,10,54:e4:3a:ec:fb:65,232636551,360,579,232636191,232636551
5319,5,24,149,5745,-87,-96,9,,232643739,28,7160,232643711,232643739
5320,5,24,149,5745,-87,-96,9,,232646484,28,2717,232646456,232646484
5321,5,24,149,5745,-89,-96,7,,232646528,28,16,232646500,232646528
5322,5,24,149,5745,-88,-96,8,,232646636,32,76,232646604,232646636
5323,5,24,149,5745,-88,-96,8,,232647204,28,540,232647176,232647204
5324,5,12,149,5745,-53,-96,43,5e:29:73:5b:30:00,232657801,272,10325,232657529,232657801
5325,5,12,149,5745,-78,-96,18,d2:00:04:7e:2c:ab,232660487,244,2442,232660243,232660487
5326,5,12,149,5745,-79,-96,17,72:d1:72:1d:22:a1,232661195,256,452,232660939,232661195
5327,5,12,149,5745,-69,-96,27,fa:44:8d:e1:c7:1b,232661541,244,102,232661297,232661541
5328,5,12,149,5745,-77,-96,19,56:68:e2:c2:8d:d5,232664132,280,2311,232663852,232664132
5329,5,12,149,5745,-81,-96,15,9a:24:38:da:96:bb,232668026,272,3622,232667754,232668026
5330,5,12,149,5745,-71,-96,25,f6:0a:5c:59:72:df,232672517,252,4239,232672265,232672517
5331,5,24,149,5745,-87,-96,9,,232673963,32,1414,232673931,232673963
5332,5,12,149,5745,-75,-96,21,22:ec:75:a8:8a:31,232684555,244,10348,232684311,232684555
5333,5,24,149,5745,-89,-96,7,,232693937,28,9354,232693909,232693937
5334,5,12,149,5745,-47,-96,49,72:fd:09:2f:da:5f,232734774,284,40553,232734490,232734774
5335,5,6,149,5745,-86,-96,10,54:e4:3a:ec:fb:65,232738952,360,3818,232738592,232738952
5336,5,12,149,5745,-64,-96,32,3e:d1:9b:c7:a4:de,232740201,272,977,232739929,232740201
5337,5,12,149,5745,-78,-96,18,d2:00:04:7e:2c:ab,232762845,244,22400,232762601,232762845
5338,5,12,149,5745,-66,-96,30,fa:44:8d:e1:c7:1b,232763545,244,456,232763301,232763545
5339,5,12,149,5745,-79,-96,17,72:d1:72:1d:22:a1,232763851,256,50,232763595,232763851
5340,5,12,149,5745,-78,-96,18,56:68:e2:c2:8d:d5,232768870,280,4739,232768590,232768870
5341,5,12,149,5745,-51,-96,45,5e:29:73:5b:30:00,232770041,272,899,232769769,232770041
5342,5,12,149,5745,-74,-96,22,22:ec:75:a8:8a:31,232796379,244,26094,232796135,232796379
5343,5,12,149,5745,-79,-96,17,d2:00:04:7e:2c:ab,232818941,244,22318,232818697,232818941
5344,5,12,149,5745,-47,-96,49,72:fd:09:2f:da:5f,232836532,284,17307,232836248,232836532
5345,5,6,149,5745,-87,-96,9,54:e4:3a:ec:fb:65,232841353,360,4461,232840993,232841353
5346,5,12,149,5745,-64,-96,32,fa:44:8d:e1:c7:1b,232849297,244,7700,232849053,232849297
5347,5,12,149,5745,-78,-96,18,72:d1:72:1d:22:a1,232853132,256,3579,232852876,232853132
5348,5,12,149,5745,-66,-96,30,3e:d1:9b:c7:a4:de,232864965,272,11561,232864693,232864965
5349,5,12,149,5745,-78,-96,18,56:68:e2:c2:8d:d5,232867000,280,1755,232866720,232867000
5350,5,12,149,5745,-65,-96,31,3e:d1:9b:c7:a4:de,232868655,544,1111,232868111,232868655
5351,5,12,149,5745,-72,-96,24,f6:0a:5c:59:72:df,232872554,252,3647,232872302,232872554
5352,5,12,149,5745,-74,-96,22,22:ec:75:a8:8a:31,232872894,516,-176,232872378,232872894
5353,5,12,149,5745,-64,-96,32,fa:44:8d:e1:c7:1b,232874193,440,859,232873753,232874193
5354,5,12,149,5745,-52,-96,44,5e:29:73:5b:30:00,232878600,540,3867,232878060,232878600
5355,5,12,149,5745,-47,-96,49,72:fd:09:2f:da:5f,232882783,480,3703,232882303,232882783
5356,5,12,149,5745,-79,-96,17,d2:00:04:7e:2c:ab,232883387,440,164,232882947,232883387
5357,5,12,149,5745,-77,-96,19,56:68:e2:c2:8d:d5,232883871,476,8,232883395,232883871
5358,5,12,149,5745,-73,-96,23,f6:0a:5c:59:72:df,232884380,252,257,232884128,232884380
5359,5,12,149,5745,-78,-96,18,72:d1:72:1d:22:a1,232888655,452,3823,232888203,232888655
5360,5,24,149,5745,-90,-96,6,,232890845,28,2162,232890817,232890845
5361,5,12,149,5745,-78,-96,18,9a:24:38:da:96:bb,232891901,272,784,232891629,232891901
5362,5,12,149,5745,-52,-96,44,5e:29:73:5b:30:00,232898573,272,6400,232898301,232898573
5363,5,24,149,5745,-76,-96,20,,232920359,28,21758,232920331,232920359
5364,5,12,149,5745,-72,-96,24,22:ec:75:a8:8a:31,232930374,244,9771,232930130,232930374
5365,5,12,149,5745,-48,-96,48,72:fd:09:2f:da:5f,232930787,284,129,232930503,232930787
5366,5,12,149,5745,-79,-96,17,d2:00:04:7e:2c:ab,232931160,244,129,232930916,232931160
5367,5,12,149,5745,-65,-96,31,3e:d1:9b:c7:a4:de,232933994,544,2290,232933450,232933994
5368,5,12,149,5745,-53,-96,43,f2:da:61:dd:98:c5,232935924,268,1662,232935656,232935924
5369,5,12,149,5745,-72,-96,24,22:ec:75:a8:8a:31,232937488,516,1048,232936972,232937488
5370,5,12,149,5745,-75,-96,21,f6:0a:5c:59:72:df,232938056,252,316,232937804,232938056
5371,5,12,149,5745,-61,-96,35,fa:44:8d:e1:c7:1b,232938416,440,-80,232937976,232938416
5372,5,12,149,5745,-73,-96,23,a6:92:ad:b7:76:65,232939012,456,140,232938556,232939012
5373,5,12,149,5745,-78,-96,18,9a:24:38:da:96:bb,232942371,824,2535,232941547,232942371
5374,5,6,149,5745,-88,-96,8,54:e4:3a:ec:fb:65,232943753,360,1022,232943393,232943753
5375,5,12,149,5745,-53,-96,43,5e:29:73:5b:30:00,232944176,540,-117,232943636,232944176
5376,5,12,149,5745,-79,-96,17,56:68:e2:c2:8d:d5,232945687,476,1035,232945211,232945687
5377,5,12,149,5745,-48,-96,48,72:fd:09:2f:da:5f,232947856,480,1689,232947376,232947856
5378,5,12,149,5745,-78,-96,18,d2:00:04:7e:2c:ab,232948621,440,325,232948181,232948621
5379,5,12,149,5745,-79,-96,17,72:d1:72:1d:22:a1,232949105,256,228,232948849,232949105
5380,5,12,149,5745,-61,-96,35,fa:44:8d:e1:c7:1b,232949406,244,57,232949162,232949406
5381,5,24,149,5745,-76,-96,20,,232950194,28,760,232950166,232950194
5382,5,12,149,5745,-69,-96,27,0a:b9:b7:b1:4d:fa,232951623,268,1161,232951355,232951623
5383,5,12,149,5745,-79,-96,17,72:d1:72:1d:22:a1,232955705,452,3630,232955253,232955705
5384,5,12,149,5745,-64,-96,32,3e:d1:9b:c7:a4:de,232980494,272,24517,232980222,232980494
5385,5,24,149,5745,-76,-96,20,,232980808,28,286,232980780,232980808
5386,5,12,149,5745,-78,-96,18,56:68:e2:c2:8d:d5,232982624,280,1536,232982344,232982624
5387,5,12,149,5745,-55,-96,41,5e:29:73:5b:30:00,232994821,272,11925,232994549,232994821
5388,5,12,149,5745,-79,-96,17,9a:24:38:da:96:bb,233005319,272,10226,233005047,233005319
5389,5,12,149,5745,-72,-96,24,f6:0a:5c:59:72:df,233008599,252,3028,233008347,233008599
5390,5,12,149,5745,-78,-96,18,d2:00:04:7e:2c:ab,233014626,440,5587,233014186,233014626
5391,5,12,149,5745,-70,-96,26,22:ec:75:a8:8a:31,233025488,244,10618,233025244,233025488
5392,5,12,149,5745,-78,-96,18,d2:00:04:7e:2c:ab,233029158,244,3426,233028914,233029158
5393,5,6,149,5745,-89,-96,7,54:e4:3a:ec:fb:65,233046153,360,16635,233045793,233046153
5394,5,12,149,5745,-49,-96,47,72:fd:09:2f:da:5f,233046973,284,536,233046689,233046973
5395,5,12,149,5745,-80,-96,16,72:d1:72:1d:22:a1,233076716,256,29487,233076460,233076716
5396,5,12,149,5745,-62,-96,34,fa:44:8d:e1:c7:1b,233077104,244,144,233076860,233077104
5397,5,12,149,5745,-63,-96,33,3e:d1:9b:c7:a4:de,233081675,272,4299,233081403,233081675
5398,5,12,149,5745,-58,-96,38,5e:29:73:5b:30:00,233110677,272,28730,233110405,233110677
5399,5,12,149,5745,-77,-96,19,9a:24:38:da:96:bb,233120333,272,9384,233120061,233120333
5400,5,12,149,5745,-70,-96,26,22:ec:75:a8:8a:31,233143217,244,22640,233142973,233143217
5401,5,6,149,5745,-87,-96,9,54:e4:3a:ec:fb:65,233148554,360,4977,233148194,233148554
5402,5,12,149,5745,-51,-96,45,72:fd:09:2f:da:5f,233157560,284,8722,233157276,233157560
5403,5,12,149,5745,-78,-96,18,d2:00:04:7e:2c:ab,233172839,244,15035,233172595,233172839
5404,5,12,149,5745,-76,-96,20,56:68:e2:c2:8d:d5,233173981,280,862,233173701,233173981
5405,5,12,149,5745,-80,-96,16,72:d1:72:1d:22:a1,233185529,256,11292,233185273,233185529
5406,5,12,149,5745,-63,-96,33,fa:44:8d:e1:c7:1b,233186235,244,462,233185991,233186235
5407,5,12,149,5745,-62,-96,34,3e:d1:9b:c7:a4:de,233198695,272,12188,233198423,233198695
5408,5,12,149,5745,-57,-96,39,5e:29:73:5b:30:00,233227583,272,28616,233227311,233227583
5409,5,12,149,5745,-79,-96,17,9a:24:38:da:96:bb,233228940,272,1085,233228668,233228940
5410,5,6,149,5745,-85,-96,11,54:e4:3a:ec:fb:65,233250955,360,21655,233250595,233250955
5411,5,12,149,5745,-71,-96,25,22:ec:75:a8:8a:31,233260231,244,9032,233259987,233260231
5412,5,12,149,5745,-79,-96,17,d2:00:04:7e:2c:ab,233275164,244,14689,233274920,233275164
5413,5,12,149,5745,-75,-96,21,56:68:e2:c2:8d:d5,233279294,280,3850,233279014,233279294
5414,5,12,149,5745,-50,-96,46,72:fd:09:2f:da:5f,233279663,284,85,233279379,233279663
5415,5,12,149,5745,-62,-96,34,fa:44:8d:e1:c7:1b,233307551,244,27644,233307307,233307551
5416,5,12,149,5745,-79,-96,17,72:d1:72:1d:22:a1,233312187,256,4380,233311931,233312187
5417,5,12,149,5745,-61,-96,35,3e:d1:9b:c7:a4:de,233323777,272,11318,233323505,233323777
5418,5,12,149,5745,-76,-96,20,56:68:e2:c2:8d:d5,233325730,280,1673,233325450,233325730
5419,5,12,149,5745,-61,-96,35,3e:d1:9b:c7:a4:de,233330062,544,3788,233329518,233330062
5420,5,12,149,5745,-70,-96,26,f6:0a:5c:59:72:df,233330676,252,362,233330424,233330676
5421,5,12,149,5745,-62,-96,34,fa:44:8d:e1:c7:1b,233332578,440,1462,233332138,233332578
5422,5,12,149,5745,-70,-96,26,22:ec:75:a8:8a:31,233333097,516,3,233332581,233333097
5423,5,12,149,5745,-70,-96,26,f6:0a:5c:59:72:df,233335034,252,1685,233334782,233335034
5424,5,12,149,5745,-82,-96,14,9a:24:38:da:96:bb,233336122,824,264,233335298,233336122
5425,5,12,149,5745,-57,-96,39,5e:29:73:5b:30:00,233339779,540,3117,233339239,233339779
5426,5,12,149,5745,-82,-96,14,9a:24:38:da:96:bb,233340623,272,572,233340351,233340623
5427,5,12,149,5745,-76,-96,20,56:68:e2:c2:8d:d5,233343098,476,1999,233342622,233343098
5428,5,12,149,5745,-78,-96,18,d2:00:04:7e:2c:ab,233343610,440,72,233343170,233343610
5429,5,12,149,5745,-50,-96,46,72:fd:09:2f:da:5f,233344120,480,30,233343640,233344120
5430,5,12,149,5745,-79,-96,17,72:d1:72:1d:22:a1,233347713,452,3141,233347261,233347713
5431,5,6,149,5745,-85,-96,11,54:e4:3a:ec:fb:65,233353355,360,5282,233352995,233353355
5432,5,12,149,5745,-57,-96,39,5e:29:73:5b:30:00,233357307,272,3680,233357035,233357307
5433,5,12,149,5745,-71,-96,25,22:ec:75:a8:8a:31,233373522,244,15971,233373278,233373522
5434,5,12,149,5745,-78,-96,18,d2:00:04:7e:2c:ab,233374306,244,540,233374062,233374306
5435,5,12,149,5745,-50,-96,46,72:fd:09:2f:da:5f,233374629,284,39,233374345,233374629
5436,5,12,149,5745,-55,-96,41,f2:da:61:dd:98:c5,233391700,268,16803,233391432,233391700
5437,5,12,149,5745,-77,-96,19,d2:00:04:7e:2c:ab,233407806,440,15666,233407366,233407806
5438,5,12,149,5745,-79,-96,17,72:d1:72:1d:22:a1,233415153,256,7091,233414897,233415153
5439,5,12,149,5745,-62,-96,34,fa:44:8d:e1:c7:1b,233416700,244,1303,233416456,233416700
5440,5,12,149,5745,-71,-96,25,a6:92:ad:b7:76:65,233424502,456,7346,233424046,233424502
5441,5,12,149,5745,-60,-96,36,3e:d1:9b:c7:a4:de,233429089,272,4315,233428817,233429089
5442,5,12,149,5745,-54,-96,42,f2:da:61:dd:98:c5,233438584,268,9227,233438316,233438584
5443,5,12,149,5745,-70,-96,26,a6:92:ad:b7:76:65,233440135,256,1295,233439879,233440135
5444,5,12,149,5745,-78,-96,18,56:68:e2:c2:8d:d5,233451863,280,11448,233451583,233451863
5445,5,12,149,5745,-82,-96,14,9a:24:38:da:96:bb,233452547,272,412,233452275,233452547
5446,5,6,149,5745,-85,-96,11,54:e4:3a:ec:fb:65,233455755,360,2848,233455395,233455755
5447,5,12,149,5745,-55,-96,41,f2:da:61:dd:98:c5,233456197,268,174,233455929,233456197
5448,5,12,149,5745,-60,-96,36,3e:d1:9b:c7:a4:de,233460028,544,3287,233459484,233460028
5449,5,12,149,5745,-71,-96,25,f6:0a:5c:59:72:df,233460941,252,661,233460689,233460941
5450,5,12,149,5745,-63,-96,33,fa:44:8d:e1:c7:1b,233462677,440,1296,233462237,233462677
5451,5,12,149,5745,-82,-96,14,9a:24:38:da:96:bb,233469112,824,5611,233468288,233469112
5452,5,12,149,5745,-57,-96,39,5e:29:73:5b:30:00,233470822,540,1170,233470282,233470822
5453,5,12,149,5745,-57,-96,39,5e:29:73:5b:30:00,233471973,272,879,233471701,233471973
5454,5,12,149,5745,-77,-96,19,d2:00:04:7e:2c:ab,233473530,440,1117,233473090,233473530
5455,5,12,149,5745,-70,-96,26,a6:92:ad:b7:76:65,233474202,456,216,233473746,233474202
5456,5,12,149,5745,-69,-96,27,0a:b9:b7:b1:4d:fa,233474746,268,276,233474478,233474746
5457,5,12,149,5745,-71,-96,25,22:ec:75:a8:8a:31,233479027,516,3765,233478511,233479027
5458,5,12,149,5745,-77,-96,19,d2:00:04:7e:2c:ab,233487904,244,8633,233487660,233487904
5459,5,12,149,5745,-70,-96,26,22:ec:75:a8:8a:31,233504670,244,16522,233504426,233504670
5460,5,12,149,5745,-62,-96,34,fa:44:8d:e1:c7:1b,233535515,244,30601,233535271,233535515
5461,5,12,149,5745,-77,-96,19,d2:00:04:7e:2c:ab,233538927,440,2972,233538487,233538927
5462,5,12,149,5745,-60,-96,36,3e:d1:9b:c7:a4:de,233543639,272,4440,233543367,233543639
5463,5,12,149,5745,-50,-96,46,72:fd:09:2f:da:5f,233555317,284,11394,233555033,233555317
5464,5,6,149,5745,-86,-96,10,54:e4:3a:ec:fb:65,233558156,360,2479,233557796,233558156
5465,5,12,149,5745,-54,-96,42,f2:da:61:dd:98:c5,233558658,268,234,233558390,233558658
5466,5,12,149,5745,-72,-96,24,a6:92:ad:b7:76:65,233558997,256,83,233558741,233558997
5467,5,12,149,5745,-80,-96,16,9a:24:38:da:96:bb,233565355,272,6086,233565083,233565355
5468,5,12,149,5745,-58,-96,38,5e:29:73:5b:30:00,233569073,272,3446,233568801,233569073
5469,5,12,149,5745,-76,-96,20,72:d1:72:1d:22:a1,233582960,256,13631,233582704,233582960
5470,5,12,149,5745,-79,-96,17,56:68:e2:c2:8d:d5,233584736,280,1496,233584456,233584736
5471,5,12,149,5745,-71,-96,25,22:ec:75:a8:8a:31,233601868,244,16888,233601624,233601868
5472,5,12,149,5745,-78,-96,18,d2:00:04:7e:2c:ab,233607952,244,5840,233607708,233607952
5473,5,12,149,5745,-48,-96,48,72:fd:09:2f:da:5f,233657733,284,49497,233657449,233657733
5474,5,12,149,5745,-60,-96,36,3e:d1:9b:c7:a4:de,233660885,272,2880,233660613,233660885
5475,5,12,149,5745,-53,-96,43,f2:da:61:dd:98:c5,233670839,268,9686,233670571,233670839
5476,5,12,149,5745,-71,-96,25,a6:92:ad:b7:76:65,233683763,256,12668,233683507,233683763
5477,5,12,149,5745,-63,-96,33,fa:44:8d:e1:c7:1b,233685124,244,1117,233684880,233685124
5478,5,12,149,5745,-76,-96,20,72:d1:72:1d:22:a1,233685609,256,229,233685353,233685609
5479,5,12,149,5745,-79,-96,17,56:68:e2:c2:8d:d5,233686005,280,116,233685725,233686005
5480,5,12,149,5745,-58,-96,38,5e:29:73:5b:30:00,233686373,272,96,233686101,233686373
5481,5,12,149,5745,-71,-96,25,22:ec:75:a8:8a:31,233718557,244,31940,233718313,233718557
5482,5,12,149,5745,-49,-96,47,72:fd:09:2f:da:5f,233760404,284,41563,233760120,233760404
5483,5,6,149,5745,-91,-96,5,54:e4:3a:ec:fb:65,233762957,360,2193,233762597,233762957
5484,5,12,149,5745,-60,-96,36,3e:d1:9b:c7:a4:de,233774662,272,11433,233774390,233774662
5485,5,12,149,5745,-57,-96,39,f2:da:61:dd:98:c5,233778875,268,3945,233778607,233778875
5486,5,12,149,5745,-71,-96,25,a6:92:ad:b7:76:65,233786185,256,7054,233785929,233786185
5487,5,12,149,5745,-62,-96,34,fa:44:8d:e1:c7:1b,233787489,244,1060,233787245,233787489
5488,5,12,149,5745,-78,-96,18,72:d1:72:1d:22:a1,233787823,256,78,233787567,233787823
5489,5,12,149,5745,-80,-96,16,d2:00:04:7e:2c:ab,233788121,244,54,233787877,233788121
5490,5,12,149,5745,-77,-96,19,56:68:e2:c2:8d:d5,233788724,280,323,233788444,233788724
5491,5,12,149,5745,-78,-96,18,9a:24:38:da:96:bb,233792612,272,3616,233792340,233792612
5492,5,12,149,5745,-55,-96,41,5e:29:73:5b:30:00,233803050,272,10166,233802778,233803050
5493,5,12,149,5745,-70,-96,26,f6:0a:5c:59:72:df,233805557,252,2255,233805305,233805557
5494,5,12,149,5745,-74,-96,22,22:ec:75:a8:8a:31,233832933,244,27132,233832689,233832933
5495,5,12,149,5745,-52,-96,44,72:fd:09:2f:da:5f,233861274,284,28057,233860990,233861274
5496,5,6,149,5745,-86,-96,10,54:e4:3a:ec:fb:65,233865357,360,3723,233864997,233865357
5497,5,12,149,5745,-58,-96,38,3e:d1:9b:c7:a4:de,233886585,272,20956,233886313,233886585
5498,5,12,149,5745,-71,-96,25,a6:92:ad:b7:76:65,233888009,256,1168,233887753,233888009
5499,5,12,149,5745,-80,-96,16,d2:00:04:7e:2c:ab,233889432,244,1179,233889188,233889432
5500,5,12,149,5745,-61,-96,35,fa:44:8d:e1:c7:1b,233889883,244,207,233889639,233889883
5501,5,12,149,5745,-78,-96,18,72:d1:72:1d:22:a1,233890277,256,138,233890021,233890277
5502,5,12,149,5745,-77,-96,19,56:68:e2:c2:8d:d5,233890817,280,260,233890537,233890817
5503,5,12,149,5745,-57,-96,39,f2:da:61:dd:98:c5,233899677,268,8592,233899409,233899677
5504,5,12,149,5745,-78,-96,18,9a:24:38:da:96:bb,233899989,272,40,233899717,233899989
5505,5,12,149,5745,-70,-96,26,f6:0a:5c:59:72:df,233905481,252,5240,233905229,233905481
5506,5,12,149,5745,-80,-96,16,d2:00:04:7e:2c:ab,233913940,440,8019,233913500,233913940
5507,5,6,149,5745,-77,-96,19,fe:1f:10:c7:b2:4d,233916128,164,2024,233915964,233916128
5508,5,6,149,5745,-86,-96,10,54:e4:3a:ec:fb:65,233916445,352,-35,233916093,233916445
5509,5,6,149,5745,-77,-96,19,,233916816,44,327,233916772,233916816
5510,5,12,149,5745,-57,-96,39,f2:da:61:dd:98:c5,233917328,268,244,233917060,233917328
5511,5,12,149,5745,-71,-96,25,a6:92:ad:b7:76:65,233920303,456,2519,233919847,233920303
5512,5,12,149,5745,-58,-96,38,3e:d1:9b:c7:a4:de,233920829,544,-18,233920285,233920829
5513,5,12,149,5745,-70,-96,26,f6:0a:5c:59:72:df,233921443,252,362,233921191,233921443
5514,5,12,149,5745,-61,-96,35,fa:44:8d:e1:c7:1b,233923567,440,1684,233923127,233923567
5515,5,12,149,5745,-55,-96,41,5e:29:73:5b:30:00,233927110,540,3003,233926570,233927110
5516,5,12,149,5745,-77,-96,19,56:68:e2:c2:8d:d5,233929036,476,1450,233928560,233929036
5517,5,12,149,5745,-51,-96,45,72:fd:09:2f:da:5f,233930212,284,892,233929928,233930212
5518,5,12,149,5745,-56,-96,40,5e:29:73:5b:30:00,233930749,272,265,233930477,233930749
5519,5,12,149,5745,-51,-96,45,72:fd:09:2f:da:5f,233933872,480,2643,233933392,233933872
5520,5,12,149,5745,-78,-96,18,72:d1:72:1d:22:a1,233935304,452,980,233934852,233935304
5521,5,12,149,5745,-73,-96,23,22:ec:75:a8:8a:31,233935809,516,-11,233935293,233935809
5522,5,12,149,5745,-78,-96,18,d2:00:04:7e:2c:ab,233946677,244,10624,233946433,233946677
5523,5,12,149,5745,-89,-96,7,40:e3:d6:de:16:10,233953085,960,5448,233952125,233953085
5524,5,12,149,5745,-73,-96,23,22:ec:75:a8:8a:31,233962912,244,9583,233962668,233962912
5525,5,12,149,5745,-77,-96,19,72:d1:72:1d:22:a1,233965109,256,1941,233964853,233965109
5526,5,6,149,5745,-86,-96,10,54:e4:3a:ec:fb:65,233967758,360,2289,233967398,233967758
5527,5,6,149,5745,-77,-96,19,fe:1f:10:c7:b2:4d,233971338,164,3416,233971174,233971338
5528,5,6,149,5745,-85,-96,11,54:e4:3a:ec:fb:65,233971647,352,-43,233971295,233971647
5529,5,6,149,5745,-78,-96,18,,233972017,44,326,233971973,233972017
5530,5,24,149,5745,-87,-96,9,,233978963,32,6914,233978931,233978963
5531,5,12,149,5745,-59,-96,37,fa:44:8d:e1:c7:1b,233980461,244,1254,233980217,233980461
5532,5,12,149,5745,-58,-96,38,3e:d1:9b:c7:a4:de,233985572,544,4567,233985028,233985572
5533,5,12,149,5745,-70,-96,26,a6:92:ad:b7:76:65,233986195,456,167,233985739,233986195
5534,5,12,149,5745,-79,-96,17,9a:24:38:da:96:bb,233986713,824,-306,233985889,233986713
5535,5,12,149,5745,-59,-96,37,fa:44:8d:e1:c7:1b,233989497,440,2344,233989057,233989497
5536,5,12,149,5745,-78,-96,18,d2:00:04:7e:2c:ab,233990611,440,674,233990171,233990611
5537,5,12,149,5745,-58,-96,38,f2:da:61:dd:98:c5,233991940,268,1061,233991672,233991940
5538,5,12,149,5745,-78,-96,18,56:68:e2:c2:8d:d5,233994285,476,1869,233993809,233994285
5539,5,12,149,5745,-58,-96,38,f2:da:61:dd:98:c5,233995830,268,1277,233995562,233995830
5540,5,12,149,5745,-70,-96,26,a6:92:ad:b7:76:65,233996321,256,235,233996065,233996321
5541,5,12,149,5745,-52,-96,44,72:fd:09:2f:da:5f,233996663,480,-138,233996183,233996663
5542,5,12,149,5745,-78,-96,18,56:68:e2:c2:8d:d5,233997666,280,723,233997386,233997666
5543,5,12,149,5745,-77,-96,19,72:d1:72:1d:22:a1,233999133,452,1015,233998681,233999133
5544,5,12,149,5745,-55,-96,41,5e:29:73:5b:30:00,234000892,540,1219,234000352,234000892
5545,5,12,149,5745,-73,-96,23,22:ec:75:a8:8a:31,234001484,516,76,234000968,234001484
5546,5,12,149,5745,-72,-96,24,f6:0a:5c:59:72:df,234002079,252,343,234001827,234002079
5547,5,12,149,5745,-64,-96,32,0a:b9:b7:b1:4d:fa,234008080,268,5733,234007812,234008080
5548,5,12,149,5745,-59,-96,37,3e:d1:9b:c7:a4:de,234011873,272,3521,234011601,234011873
5549,5,12,149,5745,-72,-96,24,f6:0a:5c:59:72:df,234018468,252,6343,234018216,234018468
5550,5,12,149,5745,-55,-96,41,5e:29:73:5b:30:00,234029881,272,11141,234029609,234029881
5551,5,24,149,5745,-88,-96,8,,234038333,28,8424,234038305,234038333
5552,5,24,149,5745,-87,-96,9,,234046388,28,8027,234046360,234046388
5553,5,24,149,5745,-87,-96,9,,234046497,32,77,234046465,234046497
5554,5,12,149,5745,-78,-96,18,d2:00:04:7e:2c:ab,234059527,244,12786,234059283,234059527
5555,5,12,149,5745,-49,-96,47,72:fd:09:2f:da:5f,234063010,284,3199,234062726,234063010
5556,5,12,149,5745,-73,-96,23,22:ec:75:a8:8a:31,234063400,244,146,234063156,234063400
5557,5,6,149,5745,-85,-96,11,54:e4:3a:ec:fb:65,234070158,360,6398,234069798,234070158
5558,5,24,149,5745,-87,-96,9,,234071082,28,896,234071054,234071082
5559,5,24,149,5745,-88,-96,8,,234071190,32,76,234071158,234071190
5560,5,12,149,5745,-80,-96,16,72:d1:72:1d:22:a1,234091091,256,19645,234090835,234091091
5561,5,12,149,5745,-62,-96,34,fa:44:8d:e1:c7:1b,234102066,244,10731,234101822,234102066
5562,5,12,149,5745,-63,-96,33,3e:d1:9b:c7:a4:de,234116414,272,14076,234116142,234116414
5563,5,12,149,5745,-83,-96,13,9a:24:38:da:96:bb,234131769,272,15083,234131497,234131769
5564,5,12,149,5745,-56,-96,40,5e:29:73:5b:30:00,234138910,272,6869,234138638,234138910
5565,5,6,149,5745,-87,-96,9,54:e4:3a:ec:fb:65,234172559,360,33289,234172199,234172559
5566,5,12,149,5745,-55,-96,41,f2:da:61:dd:98:c5,234173235,268,408,234172967,234173235
5567,5,12,149,5745,-48,-96,48,72:fd:09:2f:da:5f,234175031,284,1512,234174747,234175031
5568,5,12,149,5745,-73,-96,23,22:ec:75:a8:8a:31,234179139,244,3864,234178895,234179139
5569,5,12,149,5745,-70,-96,26,a6:92:ad:b7:76:65,234195796,256,16401,234195540,234195796
5570,5,12,149,5745,-78,-96,18,d2:00:04:7e:2c:ab,234197110,244,1070,234196866,234197110
5571,5,12,149,5745,-75,-96,21,56:68:e2:c2:8d:d5,234199851,280,2461,234199571,234199851
5572,5,12,149,5745,-78,-96,18,72:d1:72:1d:22:a1,234203497,256,3390,234203241,234203497
5573,5,12,149,5745,-61,-96,35,fa:44:8d:e1:c7:1b,234213745,244,10004,234213501,234213745
5574,5,12,149,5745,-60,-96,36,3e:d1:9b:c7:a4:de,234233534,272,19517,234233262,234233534
5575,5,12,149,5745,-78,-96,18,9a:24:38:da:96:bb,234248330,272,14524,234248058,234248330
5576,5,12,149,5745,-58,-96,38,5e:29:73:5b:30:00,234256882,272,8280,234256610,234256882
5577,5,12,149,5745,-72,-96,24,f6:0a:5c:59:72:df,234258743,252,1609,234258491,234258743
5578,5,6,149,5745,-86,-96,10,54:e4:3a:ec:fb:65,234274960,360,15857,234274600,234274960
5579,5,12,149,5745,-52,-96,44,f2:da:61:dd:98:c5,234275644,268,416,234275376,234275644
5580,5,12,149,5745,-48,-96,48,72:fd:09:2f:da:5f,234287572,284,11644,234287288,234287572
5581,5,12,149,5745,-71,-96,25,22:ec:75:a8:8a:31,234294904,244,7088,234294660,234294904
5582,5,12,149,5745,-72,-96,24,a6:92:ad:b7:76:65,234298452,256,3292,234298196,234298452
5583,5,12,149,5745,-76,-96,20,d2:00:04:7e:2c:ab,234299404,244,708,234299160,234299404
5584,5,12,149,5745,-75,-96,21,56:68:e2:c2:8d:d5,234301273,280,1589,234300993,234301273
5585,5,12,149,5745,-78,-96,18,72:d1:72:1d:22:a1,234311546,256,10017,234311290,234311546
5586,5,12,149,5745,-61,-96,35,fa:44:8d:e1:c7:1b,234331500,244,19710,234331256,234331500
5587,5,12,149,5745,-52,-96,44,f2:da:61:dd:98:c5,234348242,268,16474,234347974,234348242
5588,5,12,149,5745,-71,-96,25,a6:92:ad:b7:76:65,234352406,256,3908,234352150,234352406
5589,5,12,149,5745,-71,-96,25,f6:0a:5c:59:72:df,234360249,252,7591,234359997,234360249
5590,5,12,149,5745,-58,-96,38,3e:d1:9b:c7:a4:de,234372339,272,11818,234372067,234372339
5591,5,12,149,5745,-47,-96,49,72:fd:09:2f:da:5f,234377190,480,4371,234376710,234377190
5592,5,12,149,5745,-58,-96,38,3e:d1:9b:c7:a4:de,234378639,544,905,234378095,234378639
5593,5,12,149,5745,-71,-96,25,a6:92:ad:b7:76:65,234379244,456,149,234378788,234379244
5594,5,12,149,5745,-80,-96,16,9a:24:38:da:96:bb,234380339,824,271,234379515,234380339
5595,5,12,149,5745,-60,-96,36,fa:44:8d:e1:c7:1b,234382226,440,1447,234381786,234382226
5596,5,12,149,5745,-76,-96,20,d2:00:04:7e:2c:ab,234383943,440,1277,234383503,234383943
5597,5,12,149,5745,-53,-96,43,f2:da:61:dd:98:c5,234384633,268,422,234384365,234384633
5598,5,12,149,5745,-74,-96,22,56:68:e2:c2:8d:d5,234388103,476,2994,234387627,234388103
5599,5,12,149,5745,-47,-96,49,72:fd:09:2f:da:5f,234389054,284,667,234388770,234389054
5600,5,12,149,5745,-58,-96,38,5e:29:73:5b:30:00,234389588,272,262,234389316,234389588
5601,5,12,149,5745,-76,-96,20,d2:00:04:7e:2c:ab,234390237,244,405,234389993,234390237
5602,5,12,149,5745,-71,-96,25,f6:0a:5c:59:72:df,234394691,252,4202,234394439,234394691
5603,5,12,149,5745,-57,-96,39,5e:29:73:5b:30:00,234397371,540,2140,234396831,234397371
5604,5,12,149,5745,-71,-96,25,22:ec:75:a8:8a:31,234422194,244,24579,234421950,234422194
5605,5,12,149,5745,-78,-96,18,72:d1:72:1d:22:a1,234424211,256,1761,234423955,234424211
5606,5,12,149,5745,-55,-96,41,f2:da:61:dd:98:c5,234443066,268,18587,234442798,234443066
5607,5,12,149,5745,-73,-96,23,a6:92:ad:b7:76:65,234446266,456,2744,234445810,234446266
5608,5,12,149,5745,-60,-96,36,fa:44:8d:e1:c7:1b,234450141,244,3631,234449897,234450141
5609,5,12,149,5745,-55,-96,41,f2:da:61:dd:98:c5,234453945,268,3536,234453677,234453945
5610,5,12,149,5745,-73,-96,23,a6:92:ad:b7:76:65,234455158,256,957,234454902,234455158
5611,5,12,149,5745,-76,-96,20,d2:00:04:7e:2c:ab,234456692,440,1094,234456252,234456692
5612,5,12,149,5745,-75,-96,21,56:68:e2:c2:8d:d5,234462394,280,5422,234462114,234462394
5613,5,12,149,5745,-56,-96,40,3e:d1:9b:c7:a4:de,234464102,272,1436,234463830,234464102
5614,5,12,149,5745,-83,-96,13,9a:24:38:da:96:bb,234468136,272,3762,234467864,234468136
5615,5,6,149,5745,-88,-96,8,54:e4:3a:ec:fb:65,234479761,360,11265,234479401,234479761
5616,5,12,149,5745,-76,-96,20,d2:00:04:7e:2c:ab,234503644,244,23639,234503400,234503644
5617,5,12,149,5745,-56,-96,40,5e:29:73:5b:30:00,234504345,272,429,234504073,234504345
5618,5,12,149,5745,-54,-96,42,f2:da:61:dd:98:c5,234508571,268,3958,234508303,234508571
5619,5,12,149,5745,-57,-96,39,3e:d1:9b:c7:a4:de,234512038,544,2923,234511494,234512038
5620,5,12,149,5745,-66,-96,30,fa:44:8d:e1:c7:1b,234515158,440,2680,234514718,234515158
5621,5,12,149,5745,-77,-96,19,d2:00:04:7e:2c:ab,234521878,440,6280,234521438,234521878
5622,5,12,149,5745,-57,-96,39,5e:29:73:5b:30:00,234527456,540,5038,234526916,234527456
5623,5,12,149,5745,-72,-96,24,22:ec:75:a8:8a:31,234528030,516,58,234527514,234528030
5624,5,12,149,5745,-64,-96,32,0a:b9:b7:b1:4d:fa,234532423,268,4125,234532155,234532423
5625,5,12,149,5745,-71,-96,25,22:ec:75:a8:8a:31,234536010,244,3343,234535766,234536010
5626,5,12,149,5745,-66,-96,30,fa:44:8d:e1:c7:1b,234554281,244,18027,234554037,234554281
5627,5,12,149,5745,-55,-96,41,f2:da:61:dd:98:c5,234580121,268,25572,234579853,234580121
5628,5,12,149,5745,-58,-96,38,3e:d1:9b:c7:a4:de,234581209,272,816,234580937,234581209
5629,5,12,149,5745,-73,-96,23,a6:92:ad:b7:76:65,234581598,256,133,234581342,234581598
5630,5,6,149,5745,-85,-96,11,54:e4:3a:ec:fb:65,234582161,360,203,234581801,234582161
5631,5,12,149,5745,-47,-96,49,72:fd:09:2f:da:5f,234583422,284,977,234583138,234583422
5632,5,12,149,5745,-77,-96,19,9a:24:38:da:96:bb,234589110,272,5416,234588838,234589110
5633,5,12,149,5745,-58,-96,38,5e:29:73:5b:30:00,234601972,272,12590,234601700,234601972
5634,5,12,149,5745,-79,-96,17,72:d1:72:1d:22:a1,234606251,256,4023,234605995,234606251
5635,5,12,149,5745,-75,-96,21,56:68:e2:c2:8d:d5,234608987,280,2456,234608707,234608987
5636,5,12,149,5745,-77,-96,19,d2:00:04:7e:2c:ab,234618250,244,9019,234618006,234618250
5637,5,12,149,5745,-72,-96,24,22:ec:75:a8:8a:31,234636553,244,18059,234636309,234636553
5638,5,12,149,5745,-47,-96,49,72:fd:09:2f:da:5f,234681707,284,44870,234681423,234681707
5639,5,6,149,5745,-85,-96,11,54:e4:3a:ec:fb:65,234684562,360,2495,234684202,234684562
5640,5,12,149,5745,-57,-96,39,f2:da:61:dd:98:c5,234686421,268,1591,234686153,234686421
5641,5,12,149,5745,-78,-96,18,9a:24:38:da:96:bb,234693324,272,6631,234693052,234693324
5642,5,12,149,5745,-61,-96,35,3e:d1:9b:c7:a4:de,234694918,272,1322,234694646,234694918
5643,5,12,149,5745,-75,-96,21,a6:92:ad:b7:76:65,234707592,256,12418,234707336,234707592
5644,5,12,149,5745,-64,-96,32,fa:44:8d:e1:c7:1b,234709180,244,1344,234708936,234709180
5645,5,12,149,5745,-78,-96,18,72:d1:72:1d:22:a1,234709495,256,59,234709239,234709495
5646,5,12,149,5745,-75,-96,21,56:68:e2:c2:8d:d5,234713044,280,3269,234712764,234713044
5647,5,12,149,5745,-70,-96,26,f6:0a:5c:59:72:df,234715819,252,2523,234715567,234715819
5648,5,12,149,5745,-56,-96,40,5e:29:73:5b:30:00,234718876,272,2785,234718604,234718876
5649,5,12,149,5745,-73,-96,23,22:ec:75:a8:8a:31,234749985,244,30865,234749741,234749985
5650,5,12,149,5745,-47,-96,49,72:fd:09:2f:da:5f,234784140,284,33871,234783856,234784140
5651,5,6,149,5745,-85,-96,11,54:e4:3a:ec:fb:65,234786962,360,2462,234786602,234786962
5652,5,12,149,5745,-54,-96,42,f2:da:61:dd:98:c5,234799042,268,11812,234798774,234799042
5653,5,12,149,5745,-78,-96,18,9a:24:38:da:96:bb,234808779,272,9465,234808507,234808779
5654,5,12,149,5745,-73,-96,23,a6:92:ad:b7:76:65,234810107,256,1072,234809851,234810107
5655,5,12,149,5745,-67,-96,29,fa:44:8d:e1:c7:1b,234811548,244,1197,234811304,234811548
5656,5,12,149,5745,-60,-96,36,3e:d1:9b:c7:a4:de,234812141,272,321,234811869,234812141
5657,5,12,149,5745,-75,-96,21,56:68:e2:c2:8d:d5,234812505,280,84,234812225,234812505
5658,5,12,149,5745,-55,-96,41,5e:29:73:5b:30:00,234832774,272,19997,234832502,234832774
5659,5,12,149,5745,-70,-96,26,f6:0a:5c:59:72:df,234834063,252,1037,234833811,234834063
5660,5,12,149,5745,-74,-96,22,22:ec:75:a8:8a:31,234863668,244,29361,234863424,234863668
5661,5,24,149,5745,-88,-96,8,,234880863,28,17167,234880835,234880863
5662,5,12,149,5745,-47,-96,49,72:fd:09:2f:da:5f,234886224,284,5077,234885940,234886224
5663,5,6,149,5745,-85,-96,11,54:e4:3a:ec:fb:65,234889363,360,2779,234889003,234889363
5664,5,12,149,5745,-66,-96,30,fa:44:8d:e1:c7:1b,234913501,244,23894,234913257,234913501
5665,5,12,149,5745,-79,-96,17,72:d1:72:1d:22:a1,234914219,256,462,234913963,234914219
5666,5,12,149,5745,-75,-96,21,56:68:e2:c2:8d:d5,234915390,280,891,234915110,234915390
5667,5,12,149,5745,-52,-96,44,f2:da:61:dd:98:c5,234922699,268,7041,234922431,234922699
5668,5,12,149,5745,-61,-96,35,3e:d1:9b:c7:a4:de,234923903,272,932,234923631,234923903
5669,5,12,149,5745,-74,-96,22,a6:92:ad:b7:76:65,234929557,256,5398,234929301,234929557
5670,5,12,149,5745,-47,-96,49,72:fd:09:2f:da:5f,234962373,284,32532,234962089,234962373
5671,5,12,149,5745,-55,-96,41,5e:29:73:5b:30:00,234963195,272,550,234962923,234963195
5672,5,12,149,5745,-47,-96,49,72:fd:09:2f:da:5f,234967114,480,3439,234966634,234967114
5673,5,12,149,5745,-51,-96,45,f2:da:61:dd:98:c5,234967675,268,293,234967407,234967675
5674,5,12,149,5745,-78,-96,18,72:d1:72:1d:22:a1,234968130,452,3,234967678,234968130
5675,5,12,149,5745,-60,-96,36,3e:d1:9b:c7:a4:de,234969074,544,400,234968530,234969074
5676,5,12,149,5745,-74,-96,22,a6:92:ad:b7:76:65,234970858,456,1328,234970402,234970858
5677,5,12,149,5745,-74,-96,22,56:68:e2:c2:8d:d5,234980321,476,8987,234979845,234980321
5678,5,12,149,5745,-77,-96,19,72:d1:72:1d:22:a1,234980886,256,309,234980630,234980886
5679,5,12,149,5745,-73,-96,23,22:ec:75:a8:8a:31,234984409,516,3007,234983893,234984409
5680,5,12,149,5745,-71,-96,25,f6:0a:5c:59:72:df,234984959,252,298,234984707,234984959
5681,5,12,149,5745,-55,-96,41,5e:29:73:5b:30:00,234985254,540,-245,234984714,234985254
5682,5,12,149,5745,-66,-96,30,fa:44:8d:e1:c7:1b,234986332,440,638,234985892,234986332
5683,5,6,149,5745,-85,-96,11,54:e4:3a:ec:fb:65,234991763,360,5071,234991403,234991763
5684,5,12,149,5745,-72,-96,24,22:ec:75:a8:8a:31,234994797,244,2790,234994553,234994797
5685,5,12,149,5745,-68,-96,28,fa:44:8d:e1:c7:1b,234996554,244,1513,234996310,234996554
5686,5,12,149,5745,-51,-96,45,f2:da:61:dd:98:c5,235011361,268,14539,235011093,235011361
5687,5,24,149,5745,-86,-96,10,,235012738,28,1349,235012710,235012738
5688,5,24,149,5745,-85,-96,11,,235013073,28,307,235013045,235013073
5689,5,12,149,5745,-73,-96,23,56:68:e2:c2:8d:d5,235013844,280,491,235013564,235013844
5690,5,24,149,5745,-86,-96,10,,235017140,32,3264,235017108,235017140
5691,5,24,149,5745,-86,-96,10,,235018116,28,948,235018088,235018116
5692,5,24,149,5745,-86,-96,10,,235018225,32,77,235018193,235018225
5693,5,24,149,5745,-86,-96,10,,235019324,32,1067,235019292,235019324
5694,5,24,149,5745,-71,-96,25,,235020324,28,972,235020296,235020324
5695,5,24,149,5745,-85,-96,11,,235020368,28,16,235020340,235020368
5696,5,24,149,5745,-86,-96,10,,235020476,28,80,235020448,235020476
5697,5,12,149,5745,-49,-96,47,72:fd:09:2f:da:5f,235029105,480,8149,235028625,235029105
5698,5,12,149,5745,-76,-96,20,72:d1:72:1d:22:a1,235032292,452,2735,235031840,235032292
5699,5,12,149,5745,-51,-96,45,f2:da:61:dd:98:c5,235032912,268,352,235032644,235032912
5700,5,12,149,5745,-57,-96,39,3e:d1:9b:c7:a4:de,235034142,544,686,235033598,235034142
5701,5,12,149,5745,-83,-96,13,9a:24:38:da:96:bb,235034988,824,22,235034164,235034988
5702,5,12,149,5745,-74,-96,22,a6:92:ad:b7:76:65,235036007,456,563,235035551,235036007
5703,5,24,149,5745,-85,-96,11,,235038687,28,2652,235038659,235038687
5704,5,24,149,5745,-85,-96,11,,235039038,28,323,235039010,235039038
5705,5,24,149,5745,-86,-96,10,,235039477,28,411,235039449,235039477
5706,5,24,149,5745,-86,-96,10,,235042803,32,3294,235042771,235042803
5707,5,12,149,5745,-74,-96,22,56:68:e2:c2:8d:d5,235042942,476,-337,235042466,235042942
5708,5,12,149,5745,-71,-96,25,f6:0a:5c:59:72:df,235043470,252,276,235043218,235043470
5709,5,24,149,5745,-86,-96,10,,235044035,32,533,235044003,235044035
5710,5,12,149,5745,-57,-96,39,3e:d1:9b:c7:a4:de,235044380,272,73,235044108,235044380
5711,5,12,149,5745,-55,-96,41,5e:29:73:5b:30:00,235050097,540,5177,235049557,235050097
5712,5,12,149,5745,-73,-96,23,f6:0a:5c:59:72:df,235050734,252,385,235050482,235050734
5713,5,24,149,5745,-86,-96,10,,235055314,28,4552,235055286,235055314
5714,5,24,149,5745,-85,-96,11,,235055653,28,311,235055625,235055653
5715,5,12,149,5745,-64,-96,32,0a:b9:b7:b1:4d:fa,235056727,268,806,235056459,235056727
5716,5,24,149,5745,-86,-96,10,,235057029,28,274,235057001,235057029
5717,5,24,149,5745,-86,-96,10,,235058893,32,1832,235058861,235058893
5718,5,12,149,5745,-49,-96,47,72:fd:09:2f:da:5f,235060645,284,1468,235060361,235060645
5719,5,24,149,5745,-85,-96,11,,235061124,28,451,235061096,235061124
5720,5,24,149,5745,-85,-96,11,,235061233,32,77,235061201,235061233
5721,5,24,149,5745,-85,-96,11,,235073308,28,12047,235073280,235073308
5722,5,12,149,5745,-56,-96,40,5e:29:73:5b:30:00,235078453,272,4873,235078181,235078453
5723,5,12,149,5745,-72,-96,24,22:ec:75:a8:8a:31,235087838,244,9141,235087594,235087838
5724,5,6,149,5745,-84,-96,12,54:e4:3a:ec:fb:65,235094164,360,5966,235093804,235094164
5725,5,12,149,5745,-78,-96,18,72:d1:72:1d:22:a1,235110342,256,15922,235110086,235110342
5726,5,12,149,5745,-64,-96,32,fa:44:8d:e1:c7:1b,235111228,244,642,235110984,235111228
5727,5,12,149,5745,-66,-96,30,fa:44:8d:e1:c7:1b,235114980,440,3312,235114540,235114980
5728,5,12,149,5745,-73,-96,23,56:68:e2:c2:8d:d5,235133367,280,18107,235133087,235133367
5729,5,12,149,5745,-52,-96,44,f2:da:61:dd:98:c5,235137051,268,3416,235136783,235137051
5730,5,12,149,5745,-81,-96,15,9a:24:38:da:96:bb,235141187,272,3864,235140915,235141187
5731,5,12,149,5745,-57,-96,39,3e:d1:9b:c7:a4:de,235152392,272,10933,235152120,235152392
5732,5,6,149,5745,-89,-96,7,34:f6:4b:95:fe:d4,235165910,148,13370,235165762,235165910
5733,5,12,149,5745,-59,-96,37,5e:29:73:5b:30:00,235169962,272,3780,235169690,235169962
5734,5,12,149,5745,-71,-96,25,f6:0a:5c:59:72:df,235171422,252,1208,235171170,235171422
5735,5,12,149,5745,-66,-96,30,fa:44:8d:e1:c7:1b,235180562,440,8700,235180122,235180562
5736,5,12,149,5745,-48,-96,48,72:fd:09:2f:da:5f,235185244,284,4398,235184960,235185244
5737,5,6,149,5745,-87,-96,9,54:e4:3a:ec:fb:65,235196565,360,10961,235196205,235196565
5738,5,12,149,5745,-71,-96,25,22:ec:75:a8:8a:31,235200877,244,4068,235200633,235200877
5739,5,12,149,5745,-71,-96,25,a6:92:ad:b7:76:65,235219612,256,18479,235219356,235219612
5740,5,12,149,5745,-76,-96,20,72:d1:72:1d:22:a1,235223757,256,3889,235223501,235223757
5741,5,12,149,5745,-66,-96,30,fa:44:8d:e1:c7:1b,235225758,244,1757,235225514,235225758
5742,5,12,149,5745,-66,-96,30,fa:44:8d:e1:c7:1b,235246817,440,20619,235246377,235246817
5743,5,12,149,5745,-82,-96,14,9a:24:38:da:96:bb,235252902,272,5813,235252630,235252902
5744,5,12,149,5745,-59,-96,37,3e:d1:9b:c7:a4:de,235265410,272,12236,235265138,235265410
5745,5,24,149,5745,-72,-96,24,,235266370,28,932,235266342,235266370
5746,5,24,149,5745,-84,-96,12,,235266415,28,17,235266387,235266415
5747,5,24,149,5745,-85,-96,11,,235266522,28,79,235266494,235266522
5748,5,24,149,5745,-85,-96,11,,235283716,28,17166,235283688,235283716
5749,5,12,149,5745,-55,-96,41,5e:29:73:5b:30:00,235286458,272,2470,235286186,235286458
5750,5,12,149,5745,-46,-96,50,72:fd:09:2f:da:5f,235298278,284,11536,235297994,235298278
5751,5,6,149,5745,-87,-96,9,54:e4:3a:ec:fb:65,235298965,360,327,235298605,235298965
5752,5,12,149,5745,-55,-96,41,f2:da:61:dd:98:c5,235299622,268,389,235299354,235299622
5753,5,12,149,5745,-71,-96,25,22:ec:75:a8:8a:31,235317963,244,18097,235317719,235317963
5754,5,24,149,5745,-85,-96,11,,235320889,28,2898,235320861,235320889
5755,5,24,149,5745,-86,-96,10,,235320997,32,76,235320965,235320997
5756,5,12,149,5745,-73,-96,23,a6:92:ad:b7:76:65,235321486,256,233,235321230,235321486
5757,5,12,149,5745,-74,-96,22,56:68:e2:c2:8d:d5,235325682,280,3916,235325402,235325682
5758,5,12,149,5745,-77,-96,19,72:d1:72:1d:22:a1,235335826,256,9888,235335570,235335826
5759,5,24,149,5745,-86,-96,10,,235342007,28,6153,235341979,235342007
5760,5,24,149,5745,-85,-96,11,,235342378,28,343,235342350,235342378
5761,5,24,149,5745,-86,-96,10,,235345027,28,2621,235344999,235345027
5762,5,24,149,5745,-86,-96,10,,235345135,32,76,235345103,235345135
5763,5,24,149,5745,-86,-96,10,,235351227,28,6064,235351199,235351227
5764,5,12,149,5745,-67,-96,29,fa:44:8d:e1:c7:1b,235351494,244,23,235351250,235351494
5765,5,24,149,5745,-85,-96,11,,235354123,32,2597,235354091,235354123
5766,5,12,149,5745,-74,-96,22,56:68:e2:c2:8d:d5,235362635,280,8232,235362355,235362635
5767,5,12,149,5745,-79,-96,17,9a:24:38:da:96:bb,235368811,272,5904,235368539,235368811
5768,5,12,149,5745,-74,-96,22,a6:92:ad:b7:76:65,235371378,256,2311,235371122,235371378
5769,5,12,149,5745,-56,-96,40,3e:d1:9b:c7:a4:de,235382233,272,10583,235381961,235382233
5770,5,24,149,5745,-87,-96,9,,235401816,28,19555,235401788,235401816
5771,5,24,149,5745,-87,-96,9,,235401925,32,77,235401893,235401925
5772,5,12,149,5745,-56,-96,40,f2:da:61:dd:98:c5,235405990,268,3797,235405722,235405990
5773,5,12,149,5745,-45,-96,51,72:fd:09:2f:da:5f,235410031,284,3757,235409747,235410031
5774,5,12,149,5745,-51,-96,45,5e:29:73:5b:30:00,235421779,272,11476,235421507,235421779
5775,5,12,149,5745,-76,-96,20,72:d1:72:1d:22:a1,235426524,452,4293,235426072,235426524
5776,5,12,149,5745,-45,-96,51,72:fd:09:2f:da:5f,235427158,480,154,235426678,235427158
5777,5,12,149,5745,-55,-96,41,f2:da:61:dd:98:c5,235427683,268,257,235427415,235427683
5778,5,12,149,5745,-83,-96,13,9a:24:38:da:96:bb,235429234,824,727,235428410,235429234
5779,5,12,149,5745,-55,-96,41,3e:d1:9b:c7:a4:de,235430162,544,384,235429618,235430162
5780,5,24,149,5745,-86,-96,10,,235431057,28,867,235431029,235431057
5781,5,24,149,5745,-86,-96,10,,235433691,28,2606,235433663,235433691
5782,5,24,149,5745,-87,-96,9,,235433799,32,76,235433767,235433799
5783,5,12,149,5745,-70,-96,26,22:ec:75:a8:8a:31,235437128,244,3085,235436884,235437128
5784,5,12,149,5745,-76,-96,20,72:d1:72:1d:22:a1,235438917,256,1533,235438661,235438917
5785,5,12,149,5745,-74,-96,22,56:68:e2:c2:8d:d5,235440323,476,930,235439847,235440323
5786,5,12,149,5745,-51,-96,45,5e:29:73:5b:30:00,235443947,540,3084,235443407,235443947
5787,5,12,149,5745,-69,-96,27,f6:0a:5c:59:72:df,235444530,252,331,235444278,235444530
5788,5,12,149,5745,-67,-96,29,fa:44:8d:e1:c7:1b,235444871,440,-99,235444431,235444871
5789,5,12,149,5745,-69,-96,27,22:ec:75:a8:8a:31,235445805,516,418,235445289,235445805
5790,5,12,149,5745,-66,-96,30,fa:44:8d:e1:c7:1b,235454978,244,8929,235454734,235454978
5791,5,12,149,5745,-55,-96,41,f2:da:61:dd:98:c5,235470142,268,14896,235469874,235470142
5792,5,12,149,5745,-73,-96,23,56:68:e2:c2:8d:d5,235473010,280,2588,235472730,235473010
5793,5,12,149,5745,-82,-96,14,9a:24:38:da:96:bb,235476925,272,3643,235476653,235476925
5794,5,12,149,5745,-55,-96,41,f2:da:61:dd:98:c5,235491690,268,14497,235491422,235491690
5795,5,12,149,5745,-55,-96,41,3e:d1:9b:c7:a4:de,235499616,272,7654,235499344,235499616
5796,5,6,149,5745,-84,-96,12,54:e4:3a:ec:fb:65,235503766,360,3790,235503406,235503766
5797,5,12,149,5745,-63,-96,33,fa:44:8d:e1:c7:1b,235508563,440,4357,235508123,235508563
5798,5,12,149,5745,-69,-96,27,f6:0a:5c:59:72:df,235509480,252,665,235509228,235509480
5799,5,24,149,5745,-85,-96,11,,235513699,32,4187,235513667,235513699
5800,5,12,149,5745,-52,-96,44,5e:29:73:5b:30:00,235519994,272,6023,235519722,235519994
5801,5,24,149,5745,-86,-96,10,,235534058,28,14036,235534030,235534058
5802,5,24,149,5745,-87,-96,9,,235536495,28,2409,235536467,235536495
5803,5,24,149,5745,-85,-96,11,,235536965,32,438,235536933,235536965
5804,5,24,149,5745,-87,-96,9,,235538195,28,1202,235538167,235538195
5805,5,24,149,5745,-86,-96,10,,235538468,28,245,235538440,235538468
5806,5,24,149,5745,-86,-96,10,,235538921,32,421,235538889,235538921
5807,5,24,149,5745,-86,-96,10,,235540702,32,1749,235540670,235540702
5808,5,12,149,5745,-71,-96,25,22:ec:75:a8:8a:31,235551811,244,10865,235551567,235551811
5809,5,12,149,5745,-74,-96,22,a6:92:ad:b7:76:65,235555167,456,2900,235554711,235555167
5810,5,12,149,5745,-56,-96,40,f2:da:61:dd:98:c5,235556764,268,1329,235556496,235556764
5811,5,12,149,5745,-55,-96,41,3e:d1:9b:c7:a4:de,235560036,544,2728,235559492,235560036
5812,5,12,149,5745,-65,-96,31,fa:44:8d:e1:c7:1b,235569652,244,9372,235569408,235569652
5813,5,12,149,5745,-65,-96,31,fa:44:8d:e1:c7:1b,235573692,440,3600,235573252,235573692
5814,5,12,149,5745,-52,-96,44,5e:29:73:5b:30:00,235576119,540,1887,235575579,235576119
5815,5,12,149,5745,-72,-96,24,22:ec:75:a8:8a:31,235577037,516,402,235576521,235577037
5816,5,12,149,5745,-64,-96,32,0a:b9:b7:b1:4d:fa,235579207,268,1902,235578939,235579207
5817,5,12,149,5745,-57,-96,39,f2:da:61:dd:98:c5,235584399,268,4924,235584131,235584399
5818,5,12,149,5745,-82,-96,14,9a:24:38:da:96:bb,235588105,272,3434,235587833,235588105
5819,5,24,149,5745,-87,-96,9,,235594211,32,6074,235594179,235594211
5820,5,12,149,5745,-45,-96,51,72:fd:09:2f:da:5f,235602002,284,7507,235601718,235602002
5821,5,6,149,5745,-83,-96,13,54:e4:3a:ec:fb:65,235606167,360,3805,235605807,235606167
5822,5,24,149,5745,-86,-96,10,,235611957,28,5762,235611929,235611957
5823,5,12,149,5745,-55,-96,41,3e:d1:9b:c7:a4:de,235613623,272,1394,235613351,235613623
5824,5,24,149,5745,-87,-96,9,,235615039,28,1388,235615011,235615039
5825,5,24,149,5745,-87,-96,9,,235615147,32,76,235615115,235615147
5826,5,12,149,5745,-69,-96,27,f6:0a:5c:59:72:df,235623766,252,8367,235623514,235623766
5827,5,12,149,5745,-74,-96,22,72:d1:72:1d:22:a1,235631278,256,7256,235631022,235631278
5828,5,12,149,5745,-73,-96,23,56:68:e2:c2:8d:d5,235633998,280,2440,235633718,235633998
5829,5,12,149,5745,-53,-96,43,5e:29:73:5b:30:00,235636879,272,2609,235636607,235636879
5830,5,12,149,5745,-65,-96,31,fa:44:8d:e1:c7:1b,235639408,440,2089,235638968,235639408
5831,5,12,149,5745,-72,-96,24,22:ec:75:a8:8a:31,235659509,244,19857,235659265,235659509
5832,5,24,149,5745,-85,-96,11,,235684549,32,25008,235684517,235684549
5833,5,24,149,5745,-77,-96,19,66:48:51:4e:71:fa,235684666,328,-211,235684338,235684666
5834,5,24,149,5745,-86,-96,10,,235685182,28,488,235685154,235685182
5835,5,24,149,5745,-79,-96,17,,235685225,28,15,235685197,235685225
5836,5,24,149,5745,-78,-96,18,,235685333,32,76,235685301,235685333
5837,5,24,149,5745,-78,-96,18,,235686656,28,1295,235686628,235686656
5838,5,24,149,5745,-86,-96,10,,235686700,28,16,235686672,235686700
5839,5,24,149,5745,-86,-96,10,,235686808,32,76,235686776,235686808
5840,5,24,149,5745,-86,-96,10,,235687045,28,209,235687017,235687045
5841,5,24,149,5745,-85,-96,11,,235687153,32,76,235687121,235687153
5842,5,24,149,5745,-78,-96,18,,235687673,28,492,235687645,235687673
5843,5,24,149,5745,-87,-96,9,,235687717,28,16,235687689,235687717
5844,5,24,149,5745,-87,-96,9,,235687825,32,76,235687793,235687825
5845,5,12,149,5745,-67,-96,29,fa:44:8d:e1:c7:1b,235695469,244,7400,235695225,235695469
5846,5,12,149,5745,-58,-96,38,f2:da:61:dd:98:c5,235700682,268,4945,235700414,235700682
5847,5,12,149,5745,-81,-96,15,9a:24:38:da:96:bb,235701157,272,203,235700885,235701157
5848,5,24,149,5745,-86,-96,10,,235702023,28,838,235701995,235702023
5849,5,24,149,5745,-86,-96,10,,235702131,32,76,235702099,235702131
5850,5,12,149,5745,-47,-96,49,72:fd:09:2f:da:5f,235705731,284,3316,235705447,235705731
5851,5,24,149,5745,-86,-96,10,,235706085,28,326,235706057,235706085
5852,5,6,149,5745,-81,-96,15,54:e4:3a:ec:fb:65,235708567,360,2122,235708207,235708567
5853,5,24,149,5745,-86,-96,10,,235719448,28,10853,235719420,235719448
5854,5,24,149,5745,-86,-96,10,,235719794,28,318,235719766,235719794
5855,5,12,149,5745,-54,-96,42,5e:29:73:5b:30:00,235719992,540,-342,235719452,235719992
5856,5,24,149,5745,-86,-96,10,,235720620,28,600,235720592,235720620
5857,5,24,149,5745,-87,-96,9,,235722273,28,1625,235722245,235722273
5858,5,24,149,5745,-85,-96,11,,235722671,28,370,235722643,235722671
5859,5,24,149,5745,-86,-96,10,,235722779,32,76,235722747,235722779
5860,5,24,149,5745,-86,-96,10,,235723963,28,1156,235723935,235723963
5861,5,24,149,5745,-86,-96,10,,235724075,32,80,235724043,235724075
5862,5,12,149,5745,-55,-96,41,3e:d1:9b:c7:a4:de,235731125,272,6778,235730853,235731125
5863,5,12,149,5745,-75,-96,21,72:d1:72:1d:22:a1,235733161,256,1780,235732905,235733161
5864,5,12,149,5745,-73,-96,23,56:68:e2:c2:8d:d5,235733926,280,485,235733646,235733926
5865,5,24,149,5745,-86,-96,10,,235744428,28,10474,235744400,235744428
5866,5,24,149,5745,-86,-96,10,,235745426,32,966,235745394,235745426
5867,5,24,149,5745,-85,-96,11,,235748020,28,2566,235747992,235748020
5868,5,24,149,5745,-85,-96,11,,235751248,32,3196,235751216,235751248
5869,5,24,149,5745,-85,-96,11,,235755559,32,4279,235755527,235755559
5870,5,24,149,5745,-78,-96,18,66:48:51:4e:71:fa,235755676,328,-211,235755348,235755676
5871,5,24,149,5745,-86,-96,10,,235756191,28,487,235756163,235756191
5872,5,24,149,5745,-78,-96,18,,235756235,28,16,235756207,235756235
5873,5,24,149,5745,-78,-96,18,,235756343,32,76,235756311,235756343
5874,5,24,149,5745,-78,-96,18,,235757281,28,910,235757253,235757281
5875,5,24,149,5745,-86,-96,10,,235757324,28,15,235757296,235757324
5876,5,24,149,5745,-86,-96,10,,235757433,32,77,235757401,235757433
5877,5,12,149,5745,-55,-96,41,5e:29:73:5b:30:00,235765839,272,8134,235765567,235765839
5878,5,12,149,5745,-55,-96,41,5e:29:73:5b:30:00,235768431,540,2052,235767891,235768431
5879,5,12,149,5745,-72,-96,24,22:ec:75:a8:8a:31,235772810,244,4135,235772566,235772810
5880,5,24,149,5745,-86,-96,10,,235781007,28,8169,235780979,235781007
5881,5,24,149,5745,-85,-96,11,,235781115,32,76,235781083,235781115
5882,5,12,149,5745,-48,-96,48,72:fd:09:2f:da:5f,235808137,284,26738,235807853,235808137
5883,5,6,149,5745,-81,-96,15,54:e4:3a:ec:fb:65,235810967,360,2470,235810607,235810967
5884,5,24,149,5745,-85,-96,11,,235812297,28,1302,235812269,235812297
5885,5,12,149,5745,-57,-96,39,f2:da:61:dd:98:c5,235813803,268,1238,235813535,235813803
5886,5,24,149,5745,-86,-96,10,,235815435,28,1604,235815407,235815435
5887,5,24,149,5745,-86,-96,10,,235815543,32,76,235815511,235815543
5888,5,24,149,5745,-86,-96,10,,235818031,32,2456,235817999,235818031
5889,5,24,149,5745,-78,-96,18,66:48:51:4e:71:fa,235818149,328,-210,235817821,235818149
5890,5,24,149,5745,-87,-96,9,,235818538,28,361,235818510,235818538
5891,5,24,149,5745,-78,-96,18,,235818581,28,15,235818553,235818581
5892,5,24,149,5745,-78,-96,18,,235818689,32,76,235818657,235818689
5893,5,12,149,5745,-79,-96,17,9a:24:38:da:96:bb,235820378,272,1417,235820106,235820378
5894,5,12,149,5745,-66,-96,30,fa:44:8d:e1:c7:1b,235835246,244,14624,235835002,235835246
5895,5,12,149,5745,-75,-96,21,72:d1:72:1d:22:a1,235835929,256,427,235835673,235835929
5896,5,12,149,5745,-74,-96,22,56:68:e2:c2:8d:d5,235836399,280,190,235836119,235836399
5897,5,12,149,5745,-57,-96,39,3e:d1:9b:c7:a4:de,235846884,272,10213,235846612,235846884
5898,5,12,149,5745,-55,-96,41,5e:29:73:5b:30:00,235866157,272,19001,235865885,235866157
5899,5,12,149,5745,-72,-96,24,22:ec:75:a8:8a:31,235889877,244,23476,235889633,235889877
5900,5,12,149,5745,-48,-96,48,72:fd:09:2f:da:5f,235910173,284,20012,235909889,235910173
5901,5,6,149,5745,-83,-96,13,54:e4:3a:ec:fb:65,235913368,360,2835,235913008,235913368
5902,5,12,149,5745,-53,-96,43,f2:da:61:dd:98:c5,235925973,268,12337,235925705,235925973
5903,5,12,149,5745,-67,-96,29,fa:44:8d:e1:c7:1b,235937159,244,10942,235936915,235937159
5904,5,12,149,5745,-75,-96,21,72:d1:72:1d:22:a1,235938789,256,1374,235938533,235938789
5905,5,12,149,5745,-74,-96,22,56:68:e2:c2:8d:d5,235939187,280,118,235938907,235939187
5906,5,12,149,5745,-58,-96,38,3e:d1:9b:c7:a4:de,235958818,272,19359,235958546,235958818
5907,5,12,149,5745,-49,-96,47,72:fd:09:2f:da:5f,235977148,284,18046,235976864,235977148
5908,5,12,149,5745,-55,-96,41,5e:29:73:5b:30:00,235978057,272,637,235977785,235978057
5909,5,12,149,5745,-82,-96,14,9a:24:38:da:96:bb,235997662,272,19333,235997390,235997662
5910,5,12,149,5745,-71,-96,25,22:ec:75:a8:8a:31,236010546,244,12640,236010302,236010546
5911,5,12,149,5745,-50,-96,46,72:fd:09:2f:da:5f,236012372,480,1346,236011892,236012372
5912,5,6,149,5745,-82,-96,14,54:e4:3a:ec:fb:65,236015768,360,3036,236015408,236015768
5913,5,12,149,5745,-58,-96,38,3e:d1:9b:c7:a4:de,236017164,544,852,236016620,236017164
5914,5,12,149,5745,-66,-96,30,fa:44:8d:e1:c7:1b,236019913,440,2309,236019473,236019913
5915,5,12,149,5745,-54,-96,42,f2:da:61:dd:98:c5,236021323,268,1142,236021055,236021323
5916,5,12,149,5745,-74,-96,22,56:68:e2:c2:8d:d5,236028822,476,7023,236028346,236028822
5917,5,12,149,5745,-75,-96,21,56:68:e2:c2:8d:d5,236029316,280,214,236029036,236029316
5918,5,12,149,5745,-54,-96,42,f2:da:61:dd:98:c5,236029648,268,64,236029380,236029648
5919,5,12,149,5745,-55,-96,41,5e:29:73:5b:30:00,236031300,540,1112,236030760,236031300
5920,5,12,149,5745,-70,-96,26,f6:0a:5c:59:72:df,236033224,252,1672,236032972,236033224
5921,5,12,149,5745,-72,-96,24,22:ec:75:a8:8a:31,236033537,516,-203,236033021,236033537
5922,5,12,149,5745,-83,-96,13,9a:24:38:da:96:bb,236038588,272,4779,236038316,236038588
5923,5,24,149,5745,-87,-96,9,,236042040,28,3424,236042012,236042040
5924,5,24,149,5745,-86,-96,10,,236042149,32,77,236042117,236042149
5925,5,24,149,5745,-87,-96,9,,236056466,28,14289,236056438,236056466
5926,5,12,149,5745,-69,-96,27,f6:0a:5c:59:72:df,236058475,252,1757,236058223,236058475
5927,5,24,149,5745,-87,-96,9,,236068834,28,10331,236068806,236068834
5928,5,24,149,5745,-76,-96,20,,236069934,28,1072,236069906,236069934
5929,5,24,149,5745,-87,-96,9,,236069978,28,16,236069950,236069978
5930,5,24,149,5745,-87,-96,9,,236070086,28,80,236070058,236070086
5931,5,24,149,5745,-88,-96,8,,236070755,28,641,236070727,236070755
5932,5,24,149,5745,-87,-96,9,,236074648,32,3861,236074616,236074648
5933,5,12,149,5745,-54,-96,42,72:fd:09:2f:da:5f,236076523,284,1591,236076239,236076523
5934,5,12,149,5745,-54,-96,42,72:fd:09:2f:da:5f,236077652,480,649,236077172,236077652
5935,5,12,149,5745,-73,-96,23,a6:92:ad:b7:76:65,236079516,456,1408,236079060,236079516
5936,5,12,149,5745,-73,-96,23,72:d1:72:1d:22:a1,236080197,452,229,236079745,236080197
5937,5,12,149,5745,-57,-96,39,3e:d1:9b:c7:a4:de,236082796,544,2055,236082252,236082796
5938,5,12,149,5745,-57,-96,39,f2:da:61:dd:98:c5,236083898,268,834,236083630,236083898
5939,5,12,149,5745,-64,-96,32,fa:44:8d:e1:c7:1b,236084199,440,-139,236083759,236084199
5940,5,12,149,5745,-83,-96,13,9a:24:38:da:96:bb,236086006,824,983,236085182,236086006
5941,5,12,149,5745,-75,-96,21,56:68:e2:c2:8d:d5,236092433,476,5951,236091957,236092433
5942,5,12,149,5745,-57,-96,39,3e:d1:9b:c7:a4:de,236092998,272,293,236092726,236092998
5943,5,24,149,5745,-87,-96,9,,236095137,28,2111,236095109,236095137
5944,5,24,149,5745,-76,-96,20,,236095778,28,613,236095750,236095778
5945,5,24,149,5745,-87,-96,9,,236095822,28,16,236095794,236095822
5946,5,24,149,5745,-87,-96,9,,236095930,28,80,236095902,236095930
5947,5,12,149,5745,-54,-96,42,5e:29:73:5b:30:00,236096066,540,-404,236095526,236096066
5948,5,24,149,5745,-87,-96,9,,236096802,28,708,236096774,236096802
5949,5,24,149,5745,-87,-96,9,,236096911,32,77,236096879,236096911
5950,5,12,149,5745,-72,-96,24,22:ec:75:a8:8a:31,236098370,516,943,236097854,236098370
5951,5,12,149,5745,-71,-96,25,f6:0a:5c:59:72:df,236098947,252,325,236098695,236098947
5952,5,24,149,5745,-86,-96,10,,236103858,32,4879,236103826,236103858
5953,5,12,149,5745,-65,-96,31,0a:b9:b7:b1:4d:fa,236105337,268,1211,236105069,236105337
5954,5,12,149,5745,-54,-96,42,5e:29:73:5b:30:00,236109869,272,4260,236109597,236109869
5955,5,12,149,5745,-72,-96,24,72:d1:72:1d:22:a1,236111293,256,1168,236111037,236111293
5956,5,24,149,5745,-87,-96,9,,236113635,28,2314,236113607,236113635
5957,5,6,149,5745,-83,-96,13,54:e4:3a:ec:fb:65,236118169,360,4174,236117809,236118169
5958,5,12,149,5745,-72,-96,24,22:ec:75:a8:8a:31,236126112,244,7699,236125868,236126112
5959,5,12,149,5745,-65,-96,31,fa:44:8d:e1:c7:1b,236130656,244,4300,236130412,236130656
5960,5,12,149,5745,-74,-96,22,56:68:e2:c2:8d:d5,236155388,280,24452,236155108,236155388
5961,5,12,149,5745,-59,-96,37,f2:da:61:dd:98:c5,236158762,268,3106,236158494,236158762
5962,5,24,149,5745,-87,-96,9,,236159670,28,880,236159642,236159670
5963,5,12,149,5745,-54,-96,42,5e:29:73:5b:30:00,236161775,540,1565,236161235,236161775
5964,5,12,149,5745,-56,-96,40,3e:d1:9b:c7:a4:de,236188406,272,26359,236188134,236188406
5965,5,12,149,5745,-58,-96,38,72:fd:09:2f:da:5f,236201424,284,12734,236201140,236201424
5966,5,6,149,5745,-83,-96,13,54:e4:3a:ec:fb:65,236220569,360,18785,236220209,236220569
5967,5,12,149,5745,-55,-96,41,5e:29:73:5b:30:00,236224602,272,3761,236224330,236224602
5968,5,12,149,5745,-55,-96,41,5e:29:73:5b:30:00,236227177,540,2035,236226637,236227177
5969,5,12,149,5745,-74,-96,22,22:ec:75:a8:8a:31,236231536,244,4115,236231292,236231536
5970,5,24,149,5745,-86,-96,10,,236236024,28,4460,236235996,236236024
5971,5,24,149,5745,-86,-96,10,,236236270,28,218,236236242,236236270
5972,5,24,149,5745,-86,-96,10,,236236584,28,286,236236556,236236584
5973,5,24,149,5745,-86,-96,10,,236236902,28,290,236236874,236236902
5974,5,12,149,5745,-73,-96,23,72:d1:72:1d:22:a1,236238434,256,1276,236238178,236238434
5975,5,24,149,5745,-86,-96,10,,236239197,32,731,236239165,236239197
5976,5,12,149,5745,-67,-96,29,fa:44:8d:e1:c7:1b,236243819,244,4378,236243575,236243819
5977,5,12,149,5745,-73,-96,23,56:68:e2:c2:8d:d5,236257770,280,13671,236257490,236257770
5978,5,12,149,5745,-80,-96,16,9a:24:38:da:96:bb,236262461,272,4419,236262189,236262461
5979,5,12,149,5745,-55,-96,41,5e:29:73:5b:30:00,236293160,540,30159,236292620,236293160
5980,5,12,149,5745,-68,-96,28,f6:0a:5c:59:72:df,236294051,252,639,236293799,236294051
5981,5,24,149,5745,-87,-96,9,,236298970,32,4887,236298938,236298970
5982,5,12,149,5745,-56,-96,40,3e:d1:9b:c7:a4:de,236305236,272,5994,236304964,236305236
5983,5,12,149,5745,-58,-96,38,72:fd:09:2f:da:5f,236313107,284,7587,236312823,236313107
5984,5,24,149,5745,-85,-96,11,,236315192,28,2057,236315164,236315192
5985,5,6,149,5745,-83,-96,13,54:e4:3a:ec:fb:65,236322970,360,7418,236322610,236322970
5986,5,12,149,5745,-56,-96,40,5e:29:73:5b:30:00,236323739,272,497,236323467,236323739
5987,5,12,149,5745,-61,-96,35,f2:da:61:dd:98:c5,236324126,268,119,236323858,236324126
5988,5,24,149,5745,-86,-96,10,,236330350,28,6196,236330322,236330350
5989,5,24,149,5745,-87,-96,9,,236333452,32,3070,236333420,236333452
5990,5,12,149,5745,-73,-96,23,22:ec:75:a8:8a:31,236348396,244,14700,236348152,236348396
5991,5,12,149,5745,-72,-96,24,72:d1:72:1d:22:a1,236351420,256,2768,236351164,236351420
5992,5,12,149,5745,-67,-96,29,fa:44:8d:e1:c7:1b,236359337,244,7673,236359093,236359337
5993,5,12,149,5745,-69,-96,27,f6:0a:5c:59:72:df,236405635,252,46046,236405383,236405635
5994,5,12,149,5745,-61,-96,35,3e:d1:9b:c7:a4:de,236422526,272,16619,236422254,236422526
5995,5,6,149,5745,-84,-96,12,54:e4:3a:ec:fb:65,236425370,360,2484,236425010,236425370
5996,5,12,149,5745,-54,-96,42,72:fd:09:2f:da:5f,236425819,284,165,236425535,236425819
5997,5,12,149,5745,-57,-96,39,f2:da:61:dd:98:c5,236426762,268,675,236426494,236426762
5998,5,12,149,5745,-55,-96,41,5e:29:73:5b:30:00,236430623,272,3589,236430351,236430623
5999,5,12,149,5745,-63,-96,33,b6:90:18:f6:b1:d4,236455670,440,24607,236455230,236455670
6000,5,12,149,5745,-73,-96,23,56:68:e2:c2:8d:d5,236457593,280,1643,236457313,236457593
6001,5,12,149,5745,-73,-96,23,72:d1:72:1d:22:a1,236457926,256,77,236457670,236457926
6002,5,12,149,5745,-73,-96,23,56:68:e2:c2:8d:d5,236469251,280,11045,236468971,236469251
6003,5,12,149,5745,-73,-96,23,22:ec:75:a8:8a:31,236469583,244,88,236469339,236469583
6004,5,12,149,5745,-68,-96,28,fa:44:8d:e1:c7:1b,236471654,244,1827,236471410,236471654
6005,5,12,149,5745,-72,-96,24,72:d1:72:1d:22:a1,236474918,452,2812,236474466,236474918
6006,5,12,149,5745,-51,-96,45,72:fd:09:2f:da:5f,236476053,480,655,236475573,236476053
6007,5,12,149,5745,-62,-96,34,3e:d1:9b:c7:a4:de,236477323,544,726,236476779,236477323
6008,5,12,149,5745,-84,-96,12,9a:24:38:da:96:bb,236478082,824,-65,236477258,236478082
6009,5,12,149,5745,-70,-96,26,f6:0a:5c:59:72:df,236478915,360,473,236478555,236478915
6010,5,12,149,5745,-57,-96,39,f2:da:61:dd:98:c5,236479327,268,144,236479059,236479327
6011,5,12,149,5745,-68,-96,28,fa:44:8d:e1:c7:1b,236482175,180,2668,236481995,236482175
6012,5,12,149,5745,-66,-96,30,fa:44:8d:e1:c7:1b,236482724,48,501,236482676,236482724
6013,5,12,149,5745,-63,-96,33,,236482788,32,32,236482756,236482788
6014,5,12,149,5745,-66,-96,30,fa:44:8d:e1:c7:1b,236484046,440,818,236483606,236484046
6015,5,12,149,5745,-74,-96,22,56:68:e2:c2:8d:d5,236486662,476,2140,236486186,236486662
6016,5,12,149,5745,-57,-96,39,f2:da:61:dd:98:c5,236487962,268,1032,236487694,236487962
6017,5,12,149,5745,-55,-96,41,5e:29:73:5b:30:00,236491621,540,3119,236491081,236491621
6018,5,12,149,5745,-70,-96,26,f6:0a:5c:59:72:df,236492285,448,216,236491837,236492285
6019,5,12,149,5745,-74,-96,22,22:ec:75:a8:8a:31,236494504,516,1703,236493988,236494504
6020,5,12,149,5745,-72,-96,24,f6:0a:5c:59:72:df,236507261,252,12505,236507009,236507261
6021,5,24,149,5745,-86,-96,10,,236515931,28,8642,236515903,236515931
6022,5,24,149,5745,-86,-96,10,,236516040,32,77,236516008,236516040
6023,5,6,149,5745,-83,-96,13,54:e4:3a:ec:fb:65,236527771,360,11371,236527411,236527771
6024,5,12,149,5745,-61,-96,35,3e:d1:9b:c7:a4:de,236535755,272,7712,236535483,236535755
6025,5,12,149,5745,-63,-96,33,b6:90:18:f6:b1:d4,236542032,440,5837,236541592,236542032
6026,5,12,149,5745,-59,-96,37,f2:da:61:dd:98:c5,236542516,268,216,236542248,236542516
6027,5,6,149,5745,-90,-96,6,74:a2:e6:10:5e:20,236548051,168,5367,236547883,236548051
6028,5,12,149,5745,-49,-96,47,72:fd:09:2f:da:5f,236548247,284,-88,236547963,236548247
6029,5,24,149,5745,-86,-96,10,,236549354,32,1075,236549322,236549354
6030,5,12,149,5745,-66,-96,30,fa:44:8d:e1:c7:1b,236549447,440,-347,236549007,236549447
6031,5,12,149,5745,-55,-96,41,5e:29:73:5b:30:00,236552243,272,2524,236551971,236552243
6032,5,12,149,5745,-63,-96,33,b6:90:18:f6:b1:d4,236552596,244,109,236552352,236552596
6033,5,12,149,5745,-73,-96,23,f6:0a:5c:59:72:df,236553251,448,207,236552803,236553251
6034,5,24,149,5745,-87,-96,9,,236554558,28,1279,236554530,236554558
6035,5,12,149,5745,-54,-96,42,5e:29:73:5b:30:00,236555363,540,265,236554823,236555363
6036,5,24,149,5745,-86,-96,10,,236557105,32,1710,236557073,236557105
6037,5,6,149,5745,-89,-96,7,74:a2:e6:10:5e:20,236561652,132,4415,236561520,236561652
6038,5,12,149,5745,-73,-96,23,22:ec:75:a8:8a:31,236577868,244,15972,236577624,236577868
6039,5,12,149,5745,-74,-96,22,a6:92:ad:b7:76:65,236585165,256,7041,236584909,236585165
6040,5,12,149,5745,-69,-96,27,fa:44:8d:e1:c7:1b,236585817,244,408,236585573,236585817
6041,5,12,149,5745,-82,-96,14,9a:24:38:da:96:bb,236599935,272,13846,236599663,236599935
6042,5,12,149,5745,-60,-96,36,f2:da:61:dd:98:c5,236602689,268,2486,236602421,236602689
6043,5,24,149,5745,-88,-96,8,,236606739,28,4022,236606711,236606739
6044,5,24,149,5745,-88,-96,8,,236606848,32,77,236606816,236606848
6045,5,12,149,5745,-62,-96,34,b6:90:18:f6:b1:d4,236607634,440,346,236607194,236607634
6046,5,12,149,5745,-60,-96,36,f2:da:61:dd:98:c5,236608639,268,737,236608371,236608639
6047,5,12,149,5745,-82,-96,14,9a:24:38:da:96:bb,236609062,824,-401,236608238,236609062
6048,5,12,149,5745,-60,-96,36,3e:d1:9b:c7:a4:de,236609981,544,375,236609437,236609981
6049,5,12,149,5745,-69,-96,27,fa:44:8d:e1:c7:1b,236614305,440,3884,236613865,236614305
6050,5,12,149,5745,-73,-96,23,f6:0a:5c:59:72:df,236619162,448,4409,236618714,236619162
6051,5,12,149,5745,-73,-96,23,f6:0a:5c:59:72:df,236619627,252,213,236619375,236619627
6052,5,12,149,5745,-74,-96,22,a6:92:ad:b7:76:65,236620012,456,-71,236619556,236620012
6053,5,12,149,5745,-55,-96,41,5e:29:73:5b:30:00,236620530,540,-22,236619990,236620530
6054,5,12,149,5745,-73,-96,23,22:ec:75:a8:8a:31,236623903,516,2857,236623387,236623903
6055,5,12,149,5745,-63,-96,33,0a:b9:b7:b1:4d:fa,236629637,268,5466,236629369,236629637
6056,5,6,149,5745,-83,-96,13,54:e4:3a:ec:fb:65,236630172,360,175,236629812,236630172
6057,5,24,149,5745,-88,-96,8,,236638905,28,8705,236638877,236638905
6058,5,24,149,5745,-86,-96,10,,236643638,32,4701,236643606,236643638
6059,5,12,149,5745,-59,-96,37,3e:d1:9b:c7:a4:de,236650643,272,6733,236650371,236650643
6060,5,12,149,5745,-75,-96,21,72:d1:72:1d:22:a1,236655157,256,4258,236654901,236655157
6061,5,12,149,5745,-73,-96,23,56:68:e2:c2:8d:d5,236657013,280,1576,236656733,236657013
6062,5,12,149,5745,-54,-96,42,5e:29:73:5b:30:00,236666903,272,9618,236666631,236666903
6063,5,12,149,5745,-70,-96,26,fa:44:8d:e1:c7:1b,236680313,440,12970,236679873,236680313
6064,5,12,149,5745,-64,-96,32,b6:90:18:f6:b1:d4,236682648,244,2091,236682404,236682648
6065,5,12,149,5745,-73,-96,23,f6:0a:5c:59:72:df,236685113,448,2017,236684665,236685113
6066,5,12,149,5745,-54,-96,42,5e:29:73:5b:30:00,236686495,540,842,236685955,236686495
6067,5,12,149,5745,-73,-96,23,22:ec:75:a8:8a:31,236691631,244,4892,236691387,236691631
6068,5,12,149,5745,-72,-96,24,a6:92:ad:b7:76:65,236697026,256,5139,236696770,236697026
6069,5,12,149,5745,-70,-96,26,fa:44:8d:e1:c7:1b,236700107,244,2837,236699863,236700107
6070,5,24,149,5745,-87,-96,9,,236711188,32,11049,236711156,236711188
6071,5,12,149,5745,-58,-96,38,f2:da:61:dd:98:c5,236723794,268,12338,236723526,236723794
6072,5,12,149,5745,-46,-96,50,72:fd:09:2f:da:5f,236729788,284,5710,236729504,236729788
6073,5,6,149,5745,-83,-96,13,54:e4:3a:ec:fb:65,236732572,360,2424,236732212,236732572
6074,5,12,149,5745,-71,-96,25,f6:0a:5c:59:72:df,236744478,252,11654,236744226,236744478
6075,5,12,149,5745,-75,-96,21,72:d1:72:1d:22:a1,236757239,256,12505,236756983,236757239
6076,5,12,149,5745,-73,-96,23,56:68:e2:c2:8d:d5,236758041,280,522,236757761,236758041
6077,5,12,149,5745,-58,-96,38,3e:d1:9b:c7:a4:de,236764479,272,6166,236764207,236764479
6078,5,12,149,5745,-54,-96,42,5e:29:73:5b:30:00,236766261,272,1510,236765989,236766261
6079,5,24,149,5745,-86,-96,10,,236780502,28,14213,236780474,236780502
6080,5,12,149,5745,-71,-96,25,22:ec:75:a8:8a:31,236808991,244,28245,236808747,236808991
6081,5,24,149,5745,-86,-96,10,,236822901,28,13882,236822873,236822901
6082,5,24,149,5745,-87,-96,9,,236825983,32,3050,236825951,236825983
6083,5,12,149,5745,-48,-96,48,72:fd:09:2f:da:5f,236830974,284,4707,236830690,236830974
6084,5,6,149,5745,-83,-96,13,54:e4:3a:ec:fb:65,236834973,360,3639,236834613,236834973
6085,5,12,149,5745,-54,-96,42,f2:da:61:dd:98:c5,236839889,268,4648,236839621,236839889
6086,5,24,149,5745,-86,-96,10,,236851706,28,11789,236851678,236851706
6087,5,24,149,5745,-85,-96,11,,236854402,32,2664,236854370,236854402
6088,5,12,149,5745,-65,-96,31,b6:90:18:f6:b1:d4,236858253,244,3607,236858009,236858253
6089,5,12,149,5745,-74,-96,22,a6:92:ad:b7:76:65,236858609,256,100,236858353,236858609
6090,5,12,149,5745,-70,-96,26,fa:44:8d:e1:c7:1b,236859186,244,333,236858942,236859186
6091,5,12,149,5745,-76,-96,20,72:d1:72:1d:22:a1,236859636,256,194,236859380,236859636
6092,5,12,149,5745,-73,-96,23,56:68:e2:c2:8d:d5,236860125,280,209,236859845,236860125
6093,5,12,149,5745,-59,-96,37,5e:29:73:5b:30:00,236878528,272,18131,236878256,236878528
6094,5,12,149,5745,-59,-96,37,3e:d1:9b:c7:a4:de,236881600,272,2800,236881328,236881600
6095,5,24,149,5745,-85,-96,11,,236882685,32,1053,236882653,236882685
6096,5,24,149,5745,-86,-96,10,,236898909,28,16196,236898881,236898909
6097,5,24,149,5745,-86,-96,10,,236901201,28,2264,236901173,236901201
6098,5,24,149,5745,-86,-96,10,,236904240,32,3007,236904208,236904240
6099,5,12,149,5745,-72,-96,24,22:ec:75:a8:8a:31,236922704,244,18220,236922460,236922704
6100,5,12,149,5745,-52,-96,44,72:fd:09:2f:da:5f,236932206,284,9218,236931922,236932206
6101,5,6,149,5745,-83,-96,13,54:e4:3a:ec:fb:65,236937373,360,4807,236937013,236937373
6102,5,24,149,5745,-85,-96,11,,236939040,28,1639,236939012,236939040
6103,5,24,149,5745,-85,-96,11,,236939149,32,77,236939117,236939149
6104,5,12,149,5745,-81,-96,15,9a:24:38:da:96:bb,236940094,272,673,236939822,236940094
6105,5,12,149,5745,-55,-96,41,f2:da:61:dd:98:c5,236952508,268,12146,236952240,236952508
6106,5,12,149,5745,-75,-96,21,a6:92:ad:b7:76:65,236956992,256,4228,236956736,236956992
6107,5,24,149,5745,-86,-96,10,,236957925,28,905,236957897,236957925
6108,5,24,149,5745,-85,-96,11,,236958266,28,313,236958238,236958266
6109,5,24,149,5745,-86,-96,10,,236960972,32,2674,236960940,236960972
6110,5,12,149,5745,-66,-96,30,b6:90:18:f6:b1:d4,236961176,244,-40,236960932,236961176
6111,5,12,149,5745,-70,-96,26,fa:44:8d:e1:c7:1b,236961573,244,153,236961329,236961573
6112,5,12,149,5745,-77,-96,19,72:d1:72:1d:22:a1,236961900,256,71,236961644,236961900
6113,5,12,149,5745,-74,-96,22,56:68:e2:c2:8d:d5,236962701,280,521,236962421,236962701
6114,5,12,149,5745,-54,-96,42,5e:29:73:5b:30:00,236991567,272,28594,236991295,236991567
6115,5,12,149,5745,-62,-96,34,3e:d1:9b:c7:a4:de,236993359,272,1520,236993087,236993359
6116,5,12,149,5745,-80,-96,16,3e:ef:29:c7:4b:17,237012379,244,18776,237012135,237012379
6117,5,24,149,5745,-86,-96,10,,237015652,32,3241,237015620,237015652
6118,5,12,149,5745,-67,-96,29,b6:90:18:f6:b1:d4,237019193,244,3297,237018949,237019193
6119,5,12,149,5745,-78,-96,18,72:d1:72:1d:22:a1,237028266,256,8817,237028010,237028266
6120,5,12,149,5745,-71,-96,25,22:ec:75:a8:8a:31,237034869,244,6359,237034625,237034869
6121,5,12,149,5745,-57,-96,39,72:fd:09:2f:da:5f,237035705,284,552,237035421,237035705
6122,5,6,149,5745,-84,-96,12,54:e4:3a:ec:fb:65,237039774,360,3709,237039414,237039774
6123,5,12,149,5745,-71,-96,25,fa:44:8d:e1:c7:1b,237042921,244,2903,237042677,237042921
6124,5,24,149,5745,-86,-96,10,,237043803,28,854,237043775,237043803
6125,5,12,149,5745,-74,-96,22,56:68:e2:c2:8d:d5,237045687,280,1604,237045407,237045687
6126,5,12,149,5745,-76,-96,20,a6:92:ad:b7:76:65,237046001,256,58,237045745,237046001
6127,5,24,149,5745,-85,-96,11,,237046425,28,396,237046397,237046425
6128,5,24,149,5745,-86,-96,10,,237046534,32,77,237046502,237046534
6129,5,12,149,5745,-80,-96,16,9a:24:38:da:96:bb,237048102,272,1296,237047830,237048102
6130,5,24,149,5745,-86,-96,10,,237052992,28,4862,237052964,237052992
6131,5,24,149,5745,-85,-96,11,,237053319,28,299,237053291,237053319
6132,5,24,149,5745,-86,-96,10,,237055961,28,2614,237055933,237055961
6133,5,24,149,5745,-85,-96,11,,237056070,32,77,237056038,237056070
6134,5,12,149,5745,-57,-96,39,72:fd:09:2f:da:5f,237060951,480,4401,237060471,237060951
6135,5,12,149,5745,-79,-96,17,3e:ef:29:c7:4b:17,237061951,244,756,237061707,237061951
6136,5,12,149,5745,-59,-96,37,f2:da:61:dd:98:c5,237062508,268,289,237062240,237062508
6137,5,12,149,5745,-79,-96,17,72:d1:72:1d:22:a1,237062810,452,-150,237062358,237062810
6138,5,12,149,5745,-52,-96,44,5e:29:73:5b:30:00,237065449,540,2099,237064909,237065449
6139,5,12,149,5745,-71,-96,25,f6:0a:5c:59:72:df,237067526,252,1825,237067274,237067526
6140,5,12,149,5745,-59,-96,37,f2:da:61:dd:98:c5,237068739,268,945,237068471,237068739
6141,5,12,149,5745,-74,-96,22,56:68:e2:c2:8d:d5,237074766,476,5551,237074290,237074766
6142,5,12,149,5745,-71,-96,25,fa:44:8d:e1:c7:1b,237075277,440,71,237074837,237075277
6143,5,12,149,5745,-71,-96,25,f6:0a:5c:59:72:df,237079111,448,3386,237078663,237079111
6144,5,12,149,5745,-78,-96,18,3e:ef:29:c7:4b:17,237080108,412,585,237079696,237080108
6145,5,12,149,5745,-70,-96,26,22:ec:75:a8:8a:31,237083497,516,2873,237082981,237083497
6146,5,12,149,5745,-76,-96,20,a6:92:ad:b7:76:65,237084047,456,94,237083591,237084047
6147,5,12,149,5745,-58,-96,38,72:fd:09:2f:da:5f,237092309,284,7978,237092025,237092309
6148,5,12,149,5745,-59,-96,37,3e:d1:9b:c7:a4:de,237124887,272,32306,237124615,237124887
6149,5,12,149,5745,-53,-96,43,5e:29:73:5b:30:00,237125832,272,673,237125560,237125832
6150,5,12,149,5745,-65,-96,31,b6:90:18:f6:b1:d4,237126176,244,100,237125932,237126176
6151,5,12,149,5745,-79,-96,17,72:d1:72:1d:22:a1,237126689,256,257,237126433,237126689
6152,5,24,149,5745,-77,-96,19,,237127273,28,556,237127245,237127273
6153,5,24,149,5745,-85,-96,11,,237127317,28,16,237127289,237127317
6154,5,24,149,5745,-86,-96,10,,237127426,28,81,237127398,237127426
6155,5,12,149,5745,-80,-96,16,72:d1:72:1d:22:a1,237128702,452,824,237128250,237128702
6156,5,12,149,5745,-65,-96,31,b6:90:18:f6:b1:d4,237129226,440,84,237128786,237129226
6157,5,12,149,5745,-58,-96,38,3e:d1:9b:c7:a4:de,237129700,544,-70,237129156,237129700
6158,5,12,149,5745,-74,-96,22,56:68:e2:c2:8d:d5,237130818,476,642,237130342,237130818
6159,5,12,149,5745,-53,-96,43,5e:29:73:5b:30:00,237131435,540,77,237130895,237131435
6160,5,12,149,5745,-73,-96,23,f6:0a:5c:59:72:df,237134471,360,2676,237134111,237134471
6161,5,12,149,5745,-69,-96,27,fa:44:8d:e1:c7:1b,237137356,124,2761,237137232,237137356
6162,5,12,149,5745,-69,-96,27,fa:44:8d:e1:c7:1b,237138100,440,304,237137660,237138100
6163,5,12,149,5745,-58,-96,38,f2:da:61:dd:98:c5,237139546,268,1178,237139278,237139546
6164,5,12,149,5745,-74,-96,22,56:68:e2:c2:8d:d5,237141000,280,1174,237140720,237141000
6165,5,12,149,5745,-69,-96,27,fa:44:8d:e1:c7:1b,237142704,244,1460,237142460,237142704
6166,5,12,149,5745,-80,-96,16,3e:ef:29:c7:4b:17,237143109,104,301,237143005,237143109
6167,5,12,149,5745,-73,-96,23,f6:0a:5c:59:72:df,237143256,448,-301,237142808,237143256
6168,5,12,149,5745,-80,-96,16,3e:ef:29:c7:4b:17,237143839,364,219,237143475,237143839
6169,5,12,149,5745,-83,-96,13,9a:24:38:da:96:bb,237144552,824,-111,237143728,237144552
6170,5,12,149,5745,-55,-96,41,72:fd:09:2f:da:5f,237146207,480,1175,237145727,237146207
6171,5,12,149,5745,-80,-96,16,3e:ef:29:c7:4b:17,237146757,440,110,237146317,237146757
6172,5,12,149,5745,-62,-96,34,0a:b9:b7:b1:4d:fa,237147276,268,251,237147008,237147276
6173,5,12,149,5745,-71,-96,25,22:ec:75:a8:8a:31,237148514,516,722,237147998,237148514
6174,5,12,149,5745,-70,-96,26,22:ec:75:a8:8a:31,237157488,244,8730,237157244,237157488
6175,5,12,149,5745,-80,-96,16,3e:ef:29:c7:4b:17,237159919,244,2187,237159675,237159919
6176,5,12,149,5745,-83,-96,13,9a:24:38:da:96:bb,237163939,272,3748,237163667,237163939
6177,5,12,149,5745,-57,-96,39,f2:da:61:dd:98:c5,237176692,268,12485,237176424,237176692
6178,5,12,149,5745,-74,-96,22,f6:0a:5c:59:72:df,237179438,252,2494,237179186,237179438
6179,5,12,149,5745,-69,-96,27,fa:44:8d:e1:c7:1b,237204220,440,24342,237203780,237204220
6180,5,12,149,5745,-74,-96,22,f6:0a:5c:59:72:df,237210037,448,5369,237209589,237210037
6181,5,12,149,5745,-81,-96,15,3e:ef:29:c7:4b:17,237211651,440,1174,237211211,237211651
6182,5,12,149,5745,-50,-96,46,72:fd:09:2f:da:5f,237214431,284,2496,237214147,237214431
6183,5,12,149,5745,-58,-96,38,5e:29:73:5b:30:00,237221057,272,6354,237220785,237221057
6184,5,12,149,5745,-54,-96,42,3e:d1:9b:c7:a4:de,237222720,272,1391,237222448,237222720
6185,5,12,149,5745,-66,-96,30,b6:90:18:f6:b1:d4,237244468,244,21504,237244224,237244468
6186,5,12,149,5745,-79,-96,17,72:d1:72:1d:22:a1,237253631,256,8907,237253375,237253631
6187,5,12,149,5745,-71,-96,25,22:ec:75:a8:8a:31,237264607,244,10732,237264363,237264607
6188,5,12,149,5745,-75,-96,21,56:68:e2:c2:8d:d5,237270233,280,5346,237269953,237270233
6189,5,12,149,5745,-69,-96,27,fa:44:8d:e1:c7:1b,237270926,244,449,237270682,237270926
6190,5,12,149,5745,-76,-96,20,a6:92:ad:b7:76:65,237272316,256,1134,237272060,237272316
6191,5,12,149,5745,-81,-96,15,9a:24:38:da:96:bb,237277723,272,5135,237277451,237277723
6192,5,12,149,5745,-77,-96,19,3e:ef:29:c7:4b:17,237283413,244,5446,237283169,237283413
6193,5,24,149,5745,-86,-96,10,,237318951,32,35506,237318919,237318951
6194,5,12,149,5745,-55,-96,41,5e:29:73:5b:30:00,237336181,272,16958,237335909,237336181
6195,5,12,149,5745,-54,-96,42,3e:d1:9b:c7:a4:de,237340005,272,3552,237339733,237340005
6196,5,12,149,5745,-50,-96,46,72:fd:09:2f:da:5f,237343454,284,3165,237343170,237343454
6197,5,6,149,5745,-85,-96,11,54:e4:3a:ec:fb:65,237346975,360,3161,237346615,237346975
6198,5,12,149,5745,-62,-96,34,f2:da:61:dd:98:c5,237347372,268,129,237347104,237347372
6199,5,6,149,5745,-81,-96,15,60:dd:8e:b5:da:79,237351900,216,4312,237351684,237351900
6200,5,6,149,5745,-85,-96,11,54:e4:3a:ec:fb:65,237352266,352,14,237351914,237352266
6201,5,6,149,5745,-85,-96,11,54:e4:3a:ec:fb:65,237352850,352,232,237352498,237352850
6202,5,6,149,5745,-82,-96,14,,237353218,44,324,237353174,237353218
6203,5,12,149,5745,-78,-96,18,72:d1:72:1d:22:a1,237366459,256,12985,237366203,237366459
6204,5,12,149,5745,-66,-96,30,b6:90:18:f6:b1:d4,237372259,244,5556,237372015,237372259
6205,5,12,149,5745,-74,-96,22,22:ec:75:a8:8a:31,237381924,244,9421,237381680,237381924
6206,5,12,149,5745,-74,-96,22,56:68:e2:c2:8d:d5,237382202,280,-2,237381922,237382202
6207,5,12,149,5745,-77,-96,19,a6:92:ad:b7:76:65,237382755,256,297,237382499,237382755
6208,5,12,149,5745,-71,-96,25,fa:44:8d:e1:c7:1b,237383496,244,497,237383252,237383496
6209,5,12,149,5745,-77,-96,19,9a:24:38:da:96:bb,237393178,272,9410,237392906,237393178
6210,5,12,149,5745,-81,-96,15,3e:ef:29:c7:4b:17,237424561,244,31139,237424317,237424561
6211,5,12,149,5745,-51,-96,45,72:fd:09:2f:da:5f,237446613,284,21768,237446329,237446613
6212,5,6,149,5745,-84,-96,12,54:e4:3a:ec:fb:65,237449376,360,2403,237449016,237449376
6213,5,12,149,5745,-57,-96,39,f2:da:61:dd:98:c5,237452119,268,2475,237451851,237452119
6214,5,12,149,5745,-61,-96,35,5e:29:73:5b:30:00,237453008,272,617,237452736,237453008
6215,5,12,149,5745,-56,-96,40,3e:d1:9b:c7:a4:de,237456378,272,3098,237456106,237456378
6216,5,12,149,5745,-68,-96,28,b6:90:18:f6:b1:d4,237473907,244,17285,237473663,237473907
6217,5,12,149,5745,-77,-96,19,72:d1:72:1d:22:a1,237478532,256,4369,237478276,237478532
6218,5,12,149,5745,-78,-96,18,a6:92:ad:b7:76:65,237488513,256,9725,237488257,237488513
6219,5,12,149,5745,-72,-96,24,fa:44:8d:e1:c7:1b,237489302,244,545,237489058,237489302
6220,5,12,149,5745,-77,-96,19,56:68:e2:c2:8d:d5,237492116,280,2534,237491836,237492116
6221,5,12,149,5745,-81,-96,15,9a:24:38:da:96:bb,237502298,272,9910,237502026,237502298
6222,5,12,149,5745,-73,-96,23,fa:44:8d:e1:c7:1b,237503496,48,1150,237503448,237503496
6223,5,12,149,5745,-71,-96,25,fa:44:8d:e1:c7:1b,237503641,48,97,237503593,237503641
6224,5,12,149,5745,-71,-96,25,fa:44:8d:e1:c7:1b,237503796,48,107,237503748,237503796
6225,5,12,149,5745,-71,-96,25,fa:44:8d:e1:c7:1b,237503932,48,88,237503884,237503932
6226,5,12,149,5745,-71,-96,25,fa:44:8d:e1:c7:1b,237504058,48,78,237504010,237504058
6227,5,12,149,5745,-71,-96,25,fa:44:8d:e1:c7:1b,237504221,48,115,237504173,237504221
6228,5,12,149,5745,-68,-96,28,,237504285,32,32,237504253,237504285
6229,5,12,149,5745,-80,-96,16,3e:ef:29:c7:4b:17,237505002,244,473,237504758,237505002
6230,5,12,149,5745,-75,-96,21,22:ec:75:a8:8a:31,237517982,244,12736,237517738,237517982
6231,5,12,149,5745,-56,-96,40,f2:da:61:dd:98:c5,237520132,268,1882,237519864,237520132
6232,5,12,149,5745,-73,-96,23,f6:0a:5c:59:72:df,237522666,252,2282,237522414,237522666
6233,5,12,149,5745,-58,-96,38,3e:d1:9b:c7:a4:de,237524572,544,1362,237524028,237524572
6234,5,12,149,5745,-78,-96,18,56:68:e2:c2:8d:d5,237526296,476,1248,237525820,237526296
6235,5,12,149,5745,-57,-96,39,5e:29:73:5b:30:00,237526967,540,131,237526427,237526967
6236,5,12,149,5745,-68,-96,28,b6:90:18:f6:b1:d4,237527579,440,172,237527139,237527579
6237,5,12,149,5745,-71,-96,25,fa:44:8d:e1:c7:1b,237529282,252,1451,237529030,237529282
6238,5,12,149,5745,-73,-96,23,f6:0a:5c:59:72:df,237529629,360,-13,237529269,237529629
6239,5,12,149,5745,-71,-96,25,fa:44:8d:e1:c7:1b,237532102,440,2033,237531662,237532102
6240,5,12,149,5745,-75,-96,21,72:d1:72:1d:22:a1,237532892,452,338,237532440,237532892
6241,5,12,149,5745,-50,-96,46,72:fd:09:2f:da:5f,237534673,284,1497,237534389,237534673
6242,5,12,149,5745,-56,-96,40,f2:da:61:dd:98:c5,237537243,268,2302,237536975,237537243
6243,5,12,149,5745,-79,-96,17,a6:92:ad:b7:76:65,237539703,456,2004,237539247,237539703
6244,5,12,149,5745,-75,-96,21,22:ec:75:a8:8a:31,237541103,516,884,237540587,237541103
6245,5,12,149,5745,-49,-96,47,72:fd:09:2f:da:5f,237543624,480,2041,237543144,237543624
6246,5,6,149,5745,-85,-96,11,54:e4:3a:ec:fb:65,237551777,360,7793,237551417,237551777
6247,5,12,149,5745,-80,-96,16,3e:ef:29:c7:4b:17,237556114,440,3897,237555674,237556114
6248,5,12,149,5745,-68,-96,28,b6:90:18:f6:b1:d4,237568514,244,12156,237568270,237568514
6249,5,12,149,5745,-56,-96,40,5e:29:73:5b:30:00,237569009,272,223,237568737,237569009
6250,5,12,149,5745,-60,-96,36,3e:d1:9b:c7:a4:de,237569870,272,589,237569598,237569870
6251,5,24,149,5745,-76,-96,20,,237583752,28,13854,237583724,237583752
6252,5,12,149,5745,-76,-96,20,a6:92:ad:b7:76:65,237591989,456,7781,237591533,237591989
6253,5,12,149,5745,-74,-96,22,72:d1:72:1d:22:a1,237596736,256,4491,237596480,237596736
6254,5,12,149,5745,-71,-96,25,fa:44:8d:e1:c7:1b,237597194,440,18,237596754,237597194
6255,5,12,149,5745,-55,-96,41,f2:da:61:dd:98:c5,237598388,268,926,237598120,237598388
6256,5,12,149,5745,-75,-96,21,a6:92:ad:b7:76:65,237600817,256,2173,237600561,237600817
6257,5,12,149,5745,-71,-96,25,fa:44:8d:e1:c7:1b,237601189,244,128,237600945,237601189
6258,5,12,149,5745,-74,-96,22,f6:0a:5c:59:72:df,237603107,448,1470,237602659,237603107
6259,5,12,149,5745,-69,-96,27,b6:90:18:f6:b1:d4,237604707,440,1160,237604267,237604707
6260,5,12,149,5745,-79,-96,17,3e:ef:29:c7:4b:17,237605768,440,621,237605328,237605768
6261,5,12,149,5745,-79,-96,17,56:68:e2:c2:8d:d5,237606261,280,213,237605981,237606261
6262,5,12,149,5745,-76,-96,20,22:ec:75:a8:8a:31,237613976,244,7471,237613732,237613976
6263,5,12,149,5745,-79,-96,17,3e:ef:29:c7:4b:17,237618639,244,4419,237618395,237618639
6264,5,12,149,5745,-74,-96,22,f6:0a:5c:59:72:df,237634280,252,15389,237634028,237634280
6265,5,12,149,5745,-55,-96,41,f2:da:61:dd:98:c5,237635214,268,666,237634946,237635214
6266,5,12,149,5745,-83,-96,13,9a:24:38:da:96:bb,237635906,272,420,237635634,237635906
6267,5,6,149,5745,-86,-96,10,54:e4:3a:ec:fb:65,237654177,360,17911,237653817,237654177
6268,5,12,149,5745,-61,-96,35,3e:d1:9b:c7:a4:de,237654574,544,-147,237654030,237654574
6269,5,12,149,5745,-76,-96,20,a6:92:ad:b7:76:65,237657771,456,2741,237657315,237657771
6270,5,12,149,5745,-56,-96,40,5e:29:73:5b:30:00,237658261,540,-50,237657721,237658261
6271,5,12,149,5745,-72,-96,24,fa:44:8d:e1:c7:1b,237662813,440,4112,237662373,237662813
6272,5,12,149,5745,-50,-96,46,72:fd:09:2f:da:5f,237663375,284,278,237663091,237663375
6273,5,12,149,5745,-56,-96,40,f2:da:61:dd:98:c5,237663767,268,124,237663499,237663767
6274,5,12,149,5745,-73,-96,23,f6:0a:5c:59:72:df,237667758,448,3543,237667310,237667758
6275,5,12,149,5745,-67,-96,29,0a:b9:b7:b1:4d:fa,237669500,268,1474,237669232,237669500
6276,5,12,149,5745,-82,-96,14,9a:24:38:da:96:bb,237669821,824,-503,237668997,237669821
6277,5,12,149,5745,-68,-96,28,b6:90:18:f6:b1:d4,237670684,440,423,237670244,237670684
6278,5,12,149,5745,-78,-96,18,3e:ef:29:c7:4b:17,237671160,440,36,237670720,237671160
6279,5,12,149,5745,-76,-96,20,22:ec:75:a8:8a:31,237674946,516,3270,237674430,237674946
6280,5,12,149,5745,-68,-96,28,b6:90:18:f6:b1:d4,237682828,244,7638,237682584,237682828
6281,5,12,149,5745,-60,-96,36,3e:d1:9b:c7:a4:de,237699180,272,16080,237698908,237699180
6282,5,12,149,5745,-55,-96,41,5e:29:73:5b:30:00,237700044,272,592,237699772,237700044
6283,5,12,149,5745,-72,-96,24,fa:44:8d:e1:c7:1b,237715886,244,15598,237715642,237715886
6284,5,12,149,5745,-80,-96,16,9a:24:38:da:96:bb,237727622,272,11464,237727350,237727622
6285,5,12,149,5745,-76,-96,20,a6:92:ad:b7:76:65,237728007,256,129,237727751,237728007
6286,5,12,149,5745,-72,-96,24,fa:44:8d:e1:c7:1b,237729722,440,1275,237729282,237729722
6287,5,12,149,5745,-74,-96,22,22:ec:75:a8:8a:31,237731864,244,1898,237731620,237731864
6288,5,12,149,5745,-74,-96,22,f6:0a:5c:59:72:df,237733092,448,780,237732644,237733092
6289,5,12,149,5745,-80,-96,16,3e:ef:29:c7:4b:17,237733575,244,239,237733331,237733575
6290,5,12,149,5745,-79,-96,17,3e:ef:29:c7:4b:17,237736248,440,2233,237735808,237736248
6291,5,12,149,5745,-74,-96,22,f6:0a:5c:59:72:df,237746468,252,9968,237746216,237746468
6292,5,12,149,5745,-55,-96,41,f2:da:61:dd:98:c5,237749938,268,3202,237749670,237749938
6293,5,6,149,5745,-85,-96,11,54:e4:3a:ec:fb:65,237756577,360,6279,237756217,237756577
6294,5,12,149,5745,-75,-96,21,72:d1:72:1d:22:a1,237781284,256,24451,237781028,237781284
6295,5,12,149,5745,-76,-96,20,56:68:e2:c2:8d:d5,237783369,280,1805,237783089,237783369
6296,5,12,149,5745,-53,-96,43,5e:29:73:5b:30:00,237794340,272,10699,237794068,237794340
6297,5,12,149,5745,-58,-96,38,3e:d1:9b:c7:a4:de,237798044,272,3432,237797772,237798044
6298,5,24,149,5745,-89,-96,7,,237803714,32,5638,237803682,237803714
6299,5,24,149,5745,-88,-96,8,,237822504,28,18762,237822476,237822504
6300,5,12,149,5745,-72,-96,24,fa:44:8d:e1:c7:1b,237834943,244,12195,237834699,237834943
6301,5,12,149,5745,-79,-96,17,3e:ef:29:c7:4b:17,237844613,244,9426,237844369,237844613
6302,5,12,149,5745,-75,-96,21,22:ec:75:a8:8a:31,237844918,244,61,237844674,237844918
6303,5,12,149,5745,-79,-96,17,9a:24:38:da:96:bb,237845647,272,457,237845375,237845647
6304,5,12,149,5745,-52,-96,44,72:fd:09:2f:da:5f,237854472,284,8541,237854188,237854472
6305,5,6,149,5745,-85,-96,11,54:e4:3a:ec:fb:65,237858978,360,4146,237858618,237858978
6306,5,12,149,5745,-58,-96,38,f2:da:61:dd:98:c5,237863177,268,3931,237862909,237863177
6307,5,12,149,5745,-75,-96,21,a6:92:ad:b7:76:65,237882072,256,18639,237881816,237882072
6308,5,12,149,5745,-67,-96,29,b6:90:18:f6:b1:d4,237883527,244,1211,237883283,237883527
6309,5,12,149,5745,-75,-96,21,72:d1:72:1d:22:a1,237883867,256,84,237883611,237883867
6310,5,12,149,5745,-77,-96,19,56:68:e2:c2:8d:d5,237887557,280,3410,237887277,237887557
6311,5,12,149,5745,-56,-96,40,5e:29:73:5b:30:00,237907503,272,19674,237907231,237907503
6312,5,24,149,5745,-78,-96,18,,237912229,28,4698,237912201,237912229
6313,5,12,149,5745,-61,-96,35,3e:d1:9b:c7:a4:de,237915165,272,2664,237914893,237915165
6314,5,12,149,5745,-82,-96,14,9a:24:38:da:96:bb,237952526,272,37089,237952254,237952526
6315,5,12,149,5745,-49,-96,47,72:fd:09:2f:da:5f,237957802,284,4992,237957518,237957802
6316,5,6,149,5745,-85,-96,11,54:e4:3a:ec:fb:65,237961379,360,3217,237961019,237961379
6317,5,12,149,5745,-74,-96,22,22:ec:75:a8:8a:31,237961862,244,239,237961618,237961862
6318,5,12,149,5745,-57,-96,39,f2:da:61:dd:98:c5,237974314,268,12184,237974046,237974314
6319,5,12,149,5745,-75,-96,21,a6:92:ad:b7:76:65,237984506,256,9936,237984250,237984506
6320,5,12,149,5745,-74,-96,22,fa:44:8d:e1:c7:1b,237985959,244,1209,237985715,237985959
6321,5,12,149,5745,-74,-96,22,72:d1:72:1d:22:a1,237986255,256,40,237985999,237986255
6322,5,12,149,5745,-67,-96,29,b6:90:18:f6:b1:d4,237986540,244,41,237986296,237986540
6323,5,12,149,5745,-78,-96,18,56:68:e2:c2:8d:d5,237986874,280,54,237986594,237986874
6324,5,12,149,5745,-73,-96,23,f6:0a:5c:59:72:df,237989444,252,2318,237989192,237989444
6325,5,12,149,5745,-52,-96,44,5e:29:73:5b:30:00,238025192,272,35476,238024920,238025192
6326,5,12,149,5745,-64,-96,32,3e:d1:9b:c7:a4:de,238027759,272,2295,238027487,238027759
6327,5,12,149,5745,-79,-96,17,3e:ef:29:c7:4b:17,238038870,244,10867,238038626,238038870
6328,5,6,149,5745,-86,-96,10,60:dd:8e:b5:da:79,238052590,216,13504,238052374,238052590
6329,5,6,149,5745,-85,-96,11,54:e4:3a:ec:fb:65,238052999,352,57,238052647,238052999
6330,5,6,149,5745,-86,-96,10,,238053367,44,324,238053323,238053367
6331,5,12,149,5745,-46,-96,50,72:fd:09:2f:da:5f,238059688,284,6037,238059404,238059688
6332,5,24,149,5745,-78,-96,18,,238063328,28,3612,238063300,238063328
6333,5,6,149,5745,-84,-96,12,54:e4:3a:ec:fb:65,238063779,360,91,238063419,238063779
6334,5,12,149,5745,-76,-96,20,22:ec:75:a8:8a:31,238073686,244,9663,238073442,238073686
6335,5,12,149,5745,-80,-96,16,3e:ef:29:c7:4b:17,238074200,244,270,238073956,238074200
6336,5,12,149,5745,-59,-96,37,f2:da:61:dd:98:c5,238081389,268,6921,238081121,238081389
6337,5,12,149,5745,-74,-96,22,a6:92:ad:b7:76:65,238086227,256,4582,238085971,238086227
6338,5,12,149,5745,-75,-96,21,fa:44:8d:e1:c7:1b,238088186,244,1715,238087942,238088186
6339,5,12,149,5745,-73,-96,23,72:d1:72:1d:22:a1,238088562,256,120,238088306,238088562
6340,5,12,149,5745,-67,-96,29,b6:90:18:f6:b1:d4,238088960,244,154,238088716,238088960
6341,5,12,149,5745,-75,-96,21,f6:0a:5c:59:72:df,238093777,252,4565,238093525,238093777
6342,5,12,149,5745,-78,-96,18,56:68:e2:c2:8d:d5,238094306,280,249,238094026,238094306
6343,5,12,149,5745,-46,-96,50,72:fd:09:2f:da:5f,238108130,284,13540,238107846,238108130
6344,5,12,149,5745,-59,-96,37,3e:d1:9b:c7:a4:de,238112656,544,3982,238112112,238112656
6345,5,12,149,5745,-53,-96,43,5e:29:73:5b:30:00,238114170,540,974,238113630,238114170
6346,5,12,149,5745,-73,-96,23,a6:92:ad:b7:76:65,238115897,456,1271,238115441,238115897
6347,5,12,149,5745,-78,-96,18,56:68:e2:c2:8d:d5,238116414,476,41,238115938,238116414
6348,5,12,149,5745,-59,-96,37,f2:da:61:dd:98:c5,238122774,268,6092,238122506,238122774
6349,5,12,149,5745,-76,-96,20,f6:0a:5c:59:72:df,238127212,448,3990,238126764,238127212
6350,5,12,149,5745,-79,-96,17,3e:ef:29:c7:4b:17,238129550,440,1898,238129110,238129550
6351,5,12,149,5745,-72,-96,24,22:ec:75:a8:8a:31,238132094,516,2028,238131578,238132094
6352,5,12,149,5745,-45,-96,51,72:fd:09:2f:da:5f,238132680,480,106,238132200,238132680
6353,5,12,149,5745,-74,-96,22,fa:44:8d:e1:c7:1b,238138579,440,5459,238138139,238138579
6354,5,12,149,5745,-74,-96,22,72:d1:72:1d:22:a1,238139062,452,31,238138610,238139062
6355,5,12,149,5745,-66,-96,30,b6:90:18:f6:b1:d4,238141534,244,2228,238141290,238141534
6356,5,12,149,5745,-73,-96,23,72:d1:72:1d:22:a1,238142462,256,672,238142206,238142462
6357,5,12,149,5745,-66,-96,30,b6:90:18:f6:b1:d4,238146110,440,3208,238145670,238146110
6358,5,12,149,5745,-78,-96,18,56:68:e2:c2:8d:d5,238157349,280,10959,238157069,238157349
6359,5,12,149,5745,-58,-96,38,3e:d1:9b:c7:a4:de,238157663,272,42,238157391,238157663
6360,5,12,149,5745,-55,-96,41,5e:29:73:5b:30:00,238158221,272,286,238157949,238158221
6361,5,12,149,5745,-71,-96,25,fa:44:8d:e1:c7:1b,238160616,244,2151,238160372,238160616
6362,5,6,149,5745,-86,-96,10,54:e4:3a:ec:fb:65,238166180,360,5204,238165820,238166180
6363,5,12,149,5745,-71,-96,25,a6:92:ad:b7:76:65,238174267,256,7831,238174011,238174267
6364,5,12,149,5745,-83,-96,13,9a:24:38:da:96:bb,238175460,272,921,238175188,238175460
6365,5,12,149,5745,-79,-96,17,3e:ef:29:c7:4b:17,238176161,244,457,238175917,238176161
6366,5,12,149,5745,-59,-96,37,3e:d1:9b:c7:a4:de,238178077,544,1372,238177533,238178077
6367,5,12,149,5745,-79,-96,17,56:68:e2:c2:8d:d5,238179420,476,867,238178944,238179420
6368,5,12,149,5745,-55,-96,41,5e:29:73:5b:30:00,238179976,540,16,238179436,238179976
6369,5,12,149,5745,-71,-96,25,a6:92:ad:b7:76:65,238181549,456,1117,238181093,238181549
6370,5,12,149,5745,-77,-96,19,f6:0a:5c:59:72:df,238182998,360,1089,238182638,238182998
6371,5,12,149,5745,-80,-96,16,3e:ef:29:c7:4b:17,238184281,364,919,238183917,238184281
6372,5,12,149,5745,-75,-96,21,72:d1:72:1d:22:a1,238188282,452,3549,238187830,238188282
6373,5,12,149,5745,-56,-96,40,f2:da:61:dd:98:c5,238188804,268,254,238188536,238188804
6374,5,12,149,5745,-56,-96,40,f2:da:61:dd:98:c5,238191861,268,2789,238191593,238191861
6375,5,12,149,5745,-77,-96,19,f6:0a:5c:59:72:df,238193056,448,747,238192608,238193056
6376,5,12,149,5745,-82,-96,14,9a:24:38:da:96:bb,238193613,824,-267,238192789,238193613
6377,5,12,149,5745,-67,-96,29,b6:90:18:f6:b1:d4,238194683,440,630,238194243,238194683
6378,5,12,149,5745,-46,-96,50,72:fd:09:2f:da:5f,238195202,480,39,238194722,238195202
6379,5,12,149,5745,-79,-96,17,3e:ef:29:c7:4b:17,238195715,440,73,238195275,238195715
6380,5,12,149,5745,-72,-96,24,22:ec:75:a8:8a:31,238196199,516,-32,238195683,238196199
6381,5,12,149,5745,-62,-96,34,0a:b9:b7:b1:4d:fa,238196803,268,336,238196535,238196803
6382,5,12,149,5745,-71,-96,25,fa:44:8d:e1:c7:1b,238203568,440,6325,238203128,238203568
6383,5,12,149,5745,-78,-96,18,f6:0a:5c:59:72:df,238205410,252,1590,238205158,238205410
6384,5,12,149,5745,-73,-96,23,22:ec:75:a8:8a:31,238206317,244,663,238206073,238206317
6385,5,12,149,5745,-47,-96,49,72:fd:09:2f:da:5f,238223710,284,17109,238223426,238223710
6386,5,12,149,5745,-72,-96,24,fa:44:8d:e1:c7:1b,238252754,440,28604,238252314,238252754
6387,5,12,149,5745,-54,-96,42,5e:29:73:5b:30:00,238253227,272,201,238252955,238253227
6388,5,12,149,5745,-59,-96,37,3e:d1:9b:c7:a4:de,238253588,272,89,238253316,238253588
6389,5,12,149,5745,-66,-96,30,b6:90:18:f6:b1:d4,238257408,244,3576,238257164,238257408
6390,5,12,149,5745,-78,-96,18,f6:0a:5c:59:72:df,238257721,448,-135,238257273,238257721
6391,5,12,149,5745,-79,-96,17,3e:ef:29:c7:4b:17,238261649,440,3488,238261209,238261649
6392,5,12,149,5745,-76,-96,20,72:d1:72:1d:22:a1,238268175,256,6270,238267919,238268175
6393,5,6,149,5745,-84,-96,12,54:e4:3a:ec:fb:65,238268580,360,45,238268220,238268580
6394,5,12,149,5745,-72,-96,24,fa:44:8d:e1:c7:1b,238272920,244,4096,238272676,238272920
6395,5,12,149,5745,-81,-96,15,56:68:e2:c2:8d:d5,238280993,280,7793,238280713,238280993
6396,5,12,149,5745,-83,-96,13,9a:24:38:da:96:bb,238287901,272,6636,238287629,238287901
6397,5,12,149,5745,-79,-96,17,3e:ef:29:c7:4b:17,238290652,244,2507,238290408,238290652
6398,5,12,149,5745,-74,-96,22,a6:92:ad:b7:76:65,238291271,256,363,238291015,238291271
6399,5,12,149,5745,-73,-96,23,22:ec:75:a8:8a:31,238303433,244,11918,238303189,238303433
6400,5,12,149,5745,-53,-96,43,72:fd:09:2f:da:5f,238368183,284,64466,238367899,238368183
6401,5,12,149,5745,-62,-96,34,3e:d1:9b:c7:a4:de,238370252,272,1797,238369980,238370252
6402,5,12,149,5745,-59,-96,37,5e:29:73:5b:30:00,238370702,272,178,238370430,238370702
6403,5,6,149,5745,-84,-96,12,54:e4:3a:ec:fb:65,238371005,360,-57,238370645,238371005
6404,5,12,149,5745,-59,-96,37,f2:da:61:dd:98:c5,238371465,268,192,238371197,238371465
6405,5,12,149,5745,-80,-96,16,d2:00:04:7e:2c:ab,238380840,244,9131,238380596,238380840
6406,5,12,149,5745,-79,-96,17,56:68:e2:c2:8d:d5,238392455,280,11335,238392175,238392455
6407,5,12,149,5745,-64,-96,32,b6:90:18:f6:b1:d4,238395489,244,2790,238395245,238395489
6408,5,12,149,5745,-79,-96,17,72:d1:72:1d:22:a1,238395981,256,236,238395725,238395981
6409,5,12,149,5745,-75,-96,21,fa:44:8d:e1:c7:1b,238400342,244,4117,238400098,238400342
6410,5,12,149,5745,-71,-96,25,a6:92:ad:b7:76:65,238403662,256,3064,238403406,238403662
6411,5,12,149,5745,-70,-96,26,22:ec:75:a8:8a:31,238420555,244,16649,238420311,238420555
6412,5,12,149,5745,-79,-96,17,3e:ef:29:c7:4b:17,238447758,244,26959,238447514,238447758
6413,5,12,149,5745,-76,-96,20,f6:0a:5c:59:72:df,238448374,252,364,238448122,238448374
6414,5,12,149,5745,-53,-96,43,72:fd:09:2f:da:5f,238468498,284,19840,238468214,238468498
6415,5,6,149,5745,-82,-96,14,54:e4:3a:ec:fb:65,238473381,360,4523,238473021,238473381
6416,5,12,149,5745,-52,-96,44,f2:da:61:dd:98:c5,238474237,268,588,238473969,238474237
6417,5,12,149,5745,-58,-96,38,5e:29:73:5b:30:00,238482803,272,8294,238482531,238482803
6418,5,12,149,5745,-62,-96,34,3e:d1:9b:c7:a4:de,238483951,272,876,238483679,238483951
6419,5,12,149,5745,-80,-96,16,d2:00:04:7e:2c:ab,238492301,244,8106,238492057,238492301
6420,5,12,149,5745,-79,-96,17,72:d1:72:1d:22:a1,238498042,256,5485,238497786,238498042
6421,5,12,149,5745,-65,-96,31,b6:90:18:f6:b1:d4,238498514,244,228,238498270,238498514
6422,5,12,149,5745,-81,-96,15,56:68:e2:c2:8d:d5,238503522,280,4728,238503242,238503522
6423,5,12,149,5745,-75,-96,21,fa:44:8d:e1:c7:1b,238510464,244,6698,238510220,238510464
6424,5,12,149,5745,-73,-96,23,a6:92:ad:b7:76:65,238512678,256,1958,238512422,238512678
6425,5,12,149,5745,-77,-96,19,9a:24:38:da:96:bb,238529812,272,16862,238529540,238529812
6426,5,12,149,5745,-71,-96,25,22:ec:75:a8:8a:31,238535618,244,5562,238535374,238535618
6427,5,12,149,5745,-53,-96,43,f2:da:61:dd:98:c5,238540168,268,4282,238539900,238540168
6428,5,12,149,5745,-74,-96,22,f6:0a:5c:59:72:df,238551625,252,11205,238551373,238551625
6429,5,12,149,5745,-80,-96,16,3e:ef:29:c7:4b:17,238552552,244,683,238552308,238552552
6430,5,12,149,5745,-73,-96,23,fa:44:8d:e1:c7:1b,238553164,48,564,238553116,238553164
6431,5,12,149,5745,-73,-96,23,fa:44:8d:e1:c7:1b,238553288,48,76,238553240,238553288
6432,5,12,149,5745,-71,-96,25,fa:44:8d:e1:c7:1b,238553424,48,88,238553376,238553424
6433,5,12,149,5745,-68,-96,28,,238553488,32,32,238553456,238553488
6434,5,12,149,5745,-52,-96,44,72:fd:09:2f:da:5f,238566846,284,13074,238566562,238566846
6435,5,12,149,5745,-63,-96,33,3e:d1:9b:c7:a4:de,238573869,544,6479,238573325,238573869
6436,5,12,149,5745,-58,-96,38,5e:29:73:5b:30:00,238575428,540,1019,238574888,238575428
6437,5,6,149,5745,-83,-96,13,54:e4:3a:ec:fb:65,238576000,360,212,238575640,238576000
6438,5,12,149,5745,-76,-96,20,56:68:e2:c2:8d:d5,238576877,476,401,238576401,238576877
6439,5,12,149,5745,-84,-96,12,d2:00:04:7e:2c:ab,238579054,440,1737,238578614,238579054
6440,5,12,149,5745,-54,-96,42,f2:da:61:dd:98:c5,238581500,268,2178,238581232,238581500
6441,5,12,149,5745,-71,-96,25,fa:44:8d:e1:c7:1b,238581838,440,-102,238581398,238581838
6442,5,12,149,5745,-52,-96,44,72:fd:09:2f:da:5f,238582465,116,511,238582349,238582465
6443,5,12,149,5745,-84,-96,12,d2:00:04:7e:2c:ab,238585421,104,2852,238585317,238585421
6444,5,12,149,5745,-83,-96,13,d2:00:04:7e:2c:ab,238585615,380,-186,238585235,238585615
6445,5,12,149,5745,-72,-96,24,f6:0a:5c:59:72:df,238586055,448,-8,238585607,238586055
6446,5,12,149,5745,-80,-96,16,9a:24:38:da:96:bb,238586904,824,25,238586080,238586904
6447,5,12,149,5745,-79,-96,17,3e:ef:29:c7:4b:17,238589562,440,2218,238589122,238589562
6448,5,12,149,5745,-54,-96,42,72:fd:09:2f:da:5f,238592223,480,2181,238591743,238592223
6449,5,12,149,5745,-73,-96,23,22:ec:75:a8:8a:31,238592773,516,34,238592257,238592773
6450,5,12,149,5745,-75,-96,21,56:68:e2:c2:8d:d5,238599273,280,6220,238598993,238599273
6451,5,12,149,5745,-81,-96,15,72:d1:72:1d:22:a1,238600956,256,1427,238600700,238600956
6452,5,12,149,5745,-83,-96,13,d2:00:04:7e:2c:ab,238601390,244,190,238601146,238601390
6453,5,12,149,5745,-63,-96,33,3e:d1:9b:c7:a4:de,238616717,272,15055,238616445,238616717
6454,5,12,149,5745,-58,-96,38,5e:29:73:5b:30:00,238617549,272,560,238617277,238617549
6455,5,12,149,5745,-80,-96,16,9a:24:38:da:96:bb,238625258,272,7437,238624986,238625258
6456,5,12,149,5745,-79,-96,17,3e:ef:29:c7:4b:17,238634404,244,8902,238634160,238634404
6457,5,12,149,5745,-83,-96,13,d2:00:04:7e:2c:ab,238643198,440,8354,238642758,238643198
6458,5,12,149,5745,-73,-96,23,fa:44:8d:e1:c7:1b,238646022,440,2384,238645582,238646022
6459,5,12,149,5745,-57,-96,39,f2:da:61:dd:98:c5,238647072,268,782,238646804,238647072
6460,5,12,149,5745,-57,-96,39,f2:da:61:dd:98:c5,238650534,268,3194,238650266,238650534
6461,5,12,149,5745,-74,-96,22,f6:0a:5c:59:72:df,238650880,448,-102,238650432,238650880
6462,5,12,149,5745,-75,-96,21,22:ec:75:a8:8a:31,238653013,244,1889,238652769,238653013
6463,5,12,149,5745,-78,-96,18,3e:ef:29:c7:4b:17,238654620,440,1167,238654180,238654620
6464,5,12,149,5745,-73,-96,23,f6:0a:5c:59:72:df,238662624,252,7752,238662372,238662624
6465,5,24,149,5745,-77,-96,19,,238673040,28,10388,238673012,238673040
6466,5,24,149,5745,-88,-96,8,,238673084,28,16,238673056,238673084
6467,5,24,149,5745,-91,-96,5,,238673192,28,80,238673164,238673192
6468,5,6,149,5745,-82,-96,14,54:e4:3a:ec:fb:65,238678182,360,4630,238677822,238678182
6469,5,12,149,5745,-51,-96,45,72:fd:09:2f:da:5f,238683702,284,5236,238683418,238683702
6470,5,24,149,5745,-88,-96,8,,238688016,28,4286,238687988,238688016
6471,5,12,149,5745,-68,-96,28,b6:90:18:f6:b1:d4,238700855,440,12399,238700415,238700855
6472,5,12,149,5745,-73,-96,23,a6:92:ad:b7:76:65,238702562,456,1251,238702106,238702562
6473,5,12,149,5745,-61,-96,35,3e:d1:9b:c7:a4:de,238703601,544,495,238703057,238703601
6474,5,12,149,5745,-57,-96,39,5e:29:73:5b:30:00,238706906,540,2765,238706366,238706906
6475,5,12,149,5745,-83,-96,13,d2:00:04:7e:2c:ab,238708578,440,1232,238708138,238708578
6476,5,12,149,5745,-61,-96,35,f2:da:61:dd:98:c5,238712247,268,3401,238711979,238712247
6477,5,12,149,5745,-79,-96,17,72:d1:72:1d:22:a1,238714558,256,2055,238714302,238714558
6478,5,12,149,5745,-57,-96,39,5e:29:73:5b:30:00,238715001,272,171,238714729,238715001
6479,5,12,149,5745,-83,-96,13,d2:00:04:7e:2c:ab,238715965,244,720,238715721,238715965
6480,5,12,149,5745,-74,-96,22,f6:0a:5c:59:72:df,238716323,448,-90,238715875,238716323
6481,5,12,149,5745,-82,-96,14,9a:24:38:da:96:bb,238718446,824,1299,238717622,238718446
6482,5,12,149,5745,-78,-96,18,3e:ef:29:c7:4b:17,238719786,440,900,238719346,238719786
6483,5,12,149,5745,-62,-96,34,0a:b9:b7:b1:4d:fa,238720296,268,242,238720028,238720296
6484,5,12,149,5745,-75,-96,21,fa:44:8d:e1:c7:1b,238721894,440,1158,238721454,238721894
6485,5,12,149,5745,-74,-96,22,22:ec:75:a8:8a:31,238723277,516,867,238722761,238723277
6486,5,12,149,5745,-60,-96,36,3e:d1:9b:c7:a4:de,238730532,272,6983,238730260,238730532
6487,5,12,149,5745,-76,-96,20,fa:44:8d:e1:c7:1b,238732298,244,1522,238732054,238732298
6488,5,12,149,5745,-83,-96,13,9a:24:38:da:96:bb,238736716,272,4146,238736444,238736716
6489,5,12,149,5745,-77,-96,19,3e:ef:29:c7:4b:17,238749443,244,12483,238749199,238749443
6490,5,12,149,5745,-74,-96,22,22:ec:75:a8:8a:31,238769110,516,19151,238768594,238769110
6491,5,12,149,5745,-83,-96,13,d2:00:04:7e:2c:ab,238773802,440,4252,238773362,238773802
6492,5,12,149,5745,-74,-96,22,f6:0a:5c:59:72:df,238774716,252,662,238774464,238774716
6493,5,12,149,5745,-61,-96,35,f2:da:61:dd:98:c5,238776485,268,1501,238776217,238776485
6494,5,12,149,5745,-74,-96,22,22:ec:75:a8:8a:31,238779523,244,2794,238779279,238779523
6495,5,6,149,5745,-83,-96,13,54:e4:3a:ec:fb:65,238780583,360,700,238780223,238780583
6496,5,12,149,5745,-74,-96,22,f6:0a:5c:59:72:df,238781898,448,867,238781450,238781898
6497,5,12,149,5745,-77,-96,19,3e:ef:29:c7:4b:17,238785369,440,3031,238784929,238785369
6498,5,12,149,5745,-49,-96,47,72:fd:09:2f:da:5f,238793179,284,7526,238792895,238793179
6499,5,12,149,5745,-79,-96,17,56:68:e2:c2:8d:d5,238807371,280,13912,238807091,238807371
6500,5,24,149,5745,-87,-96,9,,238807940,32,537,238807908,238807940
6501,5,24,149,5745,-86,-96,10,,238808743,32,771,238808711,238808743
6502,5,12,149,5745,-56,-96,40,5e:29:73:5b:30:00,238823116,272,14101,238822844,238823116
6503,5,24,149,5745,-87,-96,9,,238824681,28,1537,238824653,238824681
6504,5,12,149,5745,-57,-96,39,3e:d1:9b:c7:a4:de,238825644,272,691,238825372,238825644
6505,5,24,149,5745,-85,-96,11,,238826505,28,833,238826477,238826505
6506,5,12,149,5745,-74,-96,22,22:ec:75:a8:8a:31,238835140,516,8119,238834624,238835140
6507,5,12,149,5745,-84,-96,12,d2:00:04:7e:2c:ab,238840829,244,5445,238840585,238840829
6508,5,12,149,5745,-81,-96,15,9a:24:38:da:96:bb,238849247,272,8146,238848975,238849247
6509,5,12,149,5745,-77,-96,19,3e:ef:29:c7:4b:17,238866633,244,17142,238866389,238866633
6510,5,12,149,5745,-57,-96,39,f2:da:61:dd:98:c5,238877354,268,10453,238877086,238877354
6511,5,6,149,5745,-84,-96,12,54:e4:3a:ec:fb:65,238882983,360,5269,238882623,238882983
6512,5,12,149,5745,-72,-96,24,22:ec:75:a8:8a:31,238894199,244,10972,238893955,238894199
6513,5,12,149,5745,-71,-96,25,f6:0a:5c:59:72:df,238900006,252,5555,238899754,238900006
6514,5,12,149,5745,-72,-96,24,22:ec:75:a8:8a:31,238900293,516,-229,238899777,238900293
6515,5,12,149,5745,-65,-96,31,b6:90:18:f6:b1:d4,238903922,440,3189,238903482,238903922
6516,5,12,149,5745,-74,-96,22,fa:44:8d:e1:c7:1b,238907514,244,3348,238907270,238907514
6517,5,12,149,5745,-79,-96,17,72:d1:72:1d:22:a1,238907982,256,212,238907726,238907982
6518,5,12,149,5745,-78,-96,18,56:68:e2:c2:8d:d5,238909718,280,1456,238909438,238909718
6519,5,12,149,5745,-57,-96,39,5e:29:73:5b:30:00,238940406,272,30416,238940134,238940406
6520,5,12,149,5745,-55,-96,41,3e:d1:9b:c7:a4:de,238942613,272,1935,238942341,238942613
6521,5,12,149,5745,-82,-96,14,9a:24:38:da:96:bb,238964550,272,21665,238964278,238964550
6522,5,12,149,5745,-77,-96,19,3e:ef:29:c7:4b:17,238975847,244,11053,238975603,238975847
6523,5,12,149,5745,-46,-96,50,72:fd:09:2f:da:5f,238981276,284,5145,238980992,238981276
6524,5,6,149,5745,-86,-96,10,54:e4:3a:ec:fb:65,238985384,360,3748,238985024,238985384
6525,5,12,149,5745,-57,-96,39,f2:da:61:dd:98:c5,238990520,268,4868,238990252,238990520
6526,5,12,149,5745,-74,-96,22,22:ec:75:a8:8a:31,238994573,244,3809,238994329,238994573
6527,5,12,149,5745,-83,-96,13,d2:00:04:7e:2c:ab,239009399,244,14582,239009155,239009399
6528,5,12,149,5745,-74,-96,22,fa:44:8d:e1:c7:1b,239009914,244,271,239009670,239009914
6529,5,12,149,5745,-76,-96,20,72:d1:72:1d:22:a1,239010400,256,230,239010144,239010400
6530,5,12,149,5745,-74,-96,22,56:68:e2:c2:8d:d5,239012095,280,1415,239011815,239012095
6531,5,12,149,5745,-61,-96,35,5e:29:73:5b:30:00,239057482,272,45115,239057210,239057482
6532,5,12,149,5745,-57,-96,39,3e:d1:9b:c7:a4:de,239059609,272,1855,239059337,239059609
6533,5,24,149,5745,-75,-96,21,,239060640,28,1003,239060612,239060640
6534,5,24,149,5745,-75,-96,21,,239062936,28,2268,239062908,239062936
6535,5,24,149,5745,-85,-96,11,,239062980,28,16,239062952,239062980
6536,5,24,149,5745,-75,-96,21,,239063630,28,622,239063602,239063630
6537,5,24,149,5745,-85,-96,11,,239063674,28,16,239063646,239063674
6538,5,24,149,5745,-86,-96,10,,239063782,28,80,239063754,239063782
6539,5,12,149,5745,-47,-96,49,72:fd:09:2f:da:5f,239084050,284,19984,239083766,239084050
6540,5,6,149,5745,-82,-96,14,54:e4:3a:ec:fb:65,239087784,360,3374,239087424,239087784
6541,5,12,149,5745,-78,-96,18,3e:ef:29:c7:4b:17,239093239,244,5211,239092995,239093239
6542,5,12,149,5745,-57,-96,39,f2:da:61:dd:98:c5,239100392,268,6885,239100124,239100392
6543,5,12,149,5745,-76,-96,20,22:ec:75:a8:8a:31,239106413,244,5777,239106169,239106413
6544,5,12,149,5745,-82,-96,14,d2:00:04:7e:2c:ab,239111870,244,5213,239111626,239111870
6545,5,12,149,5745,-73,-96,23,fa:44:8d:e1:c7:1b,239112195,244,81,239111951,239112195
6546,5,12,149,5745,-77,-96,19,72:d1:72:1d:22:a1,239112475,256,24,239112219,239112475
6547,5,12,149,5745,-76,-96,20,56:68:e2:c2:8d:d5,239113768,280,1013,239113488,239113768
6548,5,12,149,5745,-47,-96,49,72:fd:09:2f:da:5f,239131191,284,17139,239130907,239131191
6549,5,12,149,5745,-81,-96,15,d2:00:04:7e:2c:ab,239157693,244,26258,239157449,239157693
6550,5,12,149,5745,-78,-96,18,72:d1:72:1d:22:a1,239158035,256,86,239157779,239158035
6551,5,12,149,5745,-68,-96,28,f6:0a:5c:59:72:df,239159990,448,1507,239159542,239159990
6552,5,12,149,5745,-55,-96,41,3e:d1:9b:c7:a4:de,239161400,544,866,239160856,239161400
6553,5,12,149,5745,-56,-96,40,5e:29:73:5b:30:00,239162625,540,685,239162085,239162625
6554,5,12,149,5745,-76,-96,20,56:68:e2:c2:8d:d5,239163372,476,271,239162896,239163372
6555,5,12,149,5745,-55,-96,41,f2:da:61:dd:98:c5,239167898,268,4258,239167630,239167898
6556,5,12,149,5745,-80,-96,16,d2:00:04:7e:2c:ab,239169020,440,682,239168580,239169020
6557,5,12,149,5745,-76,-96,20,56:68:e2:c2:8d:d5,239172671,280,3371,239172391,239172671
6558,5,12,149,5745,-78,-96,18,72:d1:72:1d:22:a1,239173949,452,826,239173497,239173949
6559,5,12,149,5745,-48,-96,48,72:fd:09:2f:da:5f,239178153,480,3724,239177673,239178153
6560,5,12,149,5745,-77,-96,19,3e:ef:29:c7:4b:17,239179737,440,1144,239179297,239179737
6561,5,12,149,5745,-71,-96,25,fa:44:8d:e1:c7:1b,239183948,440,3771,239183508,239183948
6562,5,12,149,5745,-83,-96,13,9a:24:38:da:96:bb,239186738,272,2518,239186466,239186738
6563,5,12,149,5745,-57,-96,39,3e:d1:9b:c7:a4:de,239189366,272,2356,239189094,239189366
6564,5,6,149,5745,-83,-96,13,54:e4:3a:ec:fb:65,239190185,360,459,239189825,239190185
6565,5,12,149,5745,-58,-96,38,5e:29:73:5b:30:00,239190609,272,152,239190337,239190609
6566,5,12,149,5745,-71,-96,25,fa:44:8d:e1:c7:1b,239191122,244,269,239190878,239191122
6567,5,12,149,5745,-77,-96,19,3e:ef:29:c7:4b:17,239192489,244,1123,239192245,239192489
6568,5,12,149,5745,-54,-96,42,f2:da:61:dd:98:c5,239207968,268,15211,239207700,239207968
6569,5,12,149,5745,-68,-96,28,f6:0a:5c:59:72:df,239225411,448,16995,239224963,239225411
6570,5,12,149,5745,-72,-96,24,56:68:e2:c2:8d:d5,239227986,476,2099,239227510,239227986
6571,5,12,149,5745,-57,-96,39,5e:29:73:5b:30:00,239228504,540,-22,239227964,239228504
6572,5,12,149,5745,-70,-96,26,f6:0a:5c:59:72:df,239229078,252,322,239228826,239229078
6573,5,12,149,5745,-71,-96,25,22:ec:75:a8:8a:31,239229364,516,-230,239228848,239229364
6574,5,12,149,5745,-80,-96,16,3e:ef:29:c7:4b:17,239229916,440,112,239229476,239229916
6575,5,12,149,5745,-54,-96,42,f2:da:61:dd:98:c5,239230435,268,251,239230167,239230435
6576,5,12,149,5745,-60,-96,36,b6:90:18:f6:b1:d4,239232528,440,1653,239232088,239232528
6577,5,12,149,5745,-77,-96,19,d2:00:04:7e:2c:ab,239233013,440,45,239232573,239233013
6578,5,12,149,5745,-53,-96,43,72:fd:09:2f:da:5f,239233533,116,404,239233417,239233533
6579,5,12,149,5745,-80,-96,16,3e:ef:29:c7:4b:17,239235368,104,1731,239235264,239235368
6580,5,12,149,5745,-74,-96,22,72:d1:72:1d:22:a1,239236822,452,1002,239236370,239236822
6581,5,12,149,5745,-71,-96,25,22:ec:75:a8:8a:31,239238192,244,1126,239237948,239238192
6582,5,12,149,5745,-53,-96,43,72:fd:09:2f:da:5f,239238578,284,102,239238294,239238578
6583,5,12,149,5745,-80,-96,16,9a:24:38:da:96:bb,239241358,824,1956,239240534,239241358
6584,5,12,149,5745,-53,-96,43,72:fd:09:2f:da:5f,239243359,480,1521,239242879,239243359
6585,5,12,149,5745,-63,-96,33,0a:b9:b7:b1:4d:fa,239244323,268,696,239244055,239244323
6586,5,12,149,5745,-73,-96,23,fa:44:8d:e1:c7:1b,239246731,440,1968,239246291,239246731
6587,5,12,149,5745,-77,-96,19,d2:00:04:7e:2c:ab,239273455,244,26480,239273211,239273455
6588,5,12,149,5745,-73,-96,23,72:d1:72:1d:22:a1,239273726,256,15,239273470,239273726
6589,5,12,149,5745,-58,-96,38,5e:29:73:5b:30:00,239282682,272,8684,239282410,239282682
6590,5,12,149,5745,-58,-96,38,3e:d1:9b:c7:a4:de,239284536,272,1582,239284264,239284536
6591,5,6,149,5745,-85,-96,11,54:e4:3a:ec:fb:65,239292585,360,7689,239292225,239292585
6592,5,12,149,5745,-75,-96,21,22:ec:75:a8:8a:31,239293410,516,309,239292894,239293410
6593,5,12,149,5745,-70,-96,26,56:68:e2:c2:8d:d5,239300583,280,6893,239300303,239300583
6594,5,12,149,5745,-73,-96,23,fa:44:8d:e1:c7:1b,239304808,244,3981,239304564,239304808
6595,5,12,149,5745,-80,-96,16,3e:ef:29:c7:4b:17,239319096,244,14044,239318852,239319096
6596,5,12,149,5745,-75,-96,21,22:ec:75:a8:8a:31,239352933,244,33593,239352689,239352933
6597,5,12,149,5745,-51,-96,45,72:fd:09:2f:da:5f,239355560,284,2343,239355276,239355560
6598,5,12,149,5745,-68,-96,28,f6:0a:5c:59:72:df,239356212,252,400,239355960,239356212
6599,5,12,149,5745,-75,-96,21,22:ec:75:a8:8a:31,239359354,516,2626,239358838,239359354
6600,5,12,149,5745,-78,-96,18,d2:00:04:7e:2c:ab,239392877,244,33279,239392633,239392877
6601,5,6,149,5745,-86,-96,10,54:e4:3a:ec:fb:65,239394986,360,1749,239394626,239394986
6602,5,12,149,5745,-55,-96,41,f2:da:61:dd:98:c5,239395643,268,389,239395375,239395643
6603,5,12,149,5745,-57,-96,39,5e:29:73:5b:30:00,239398675,272,2760,239398403,239398675
6604,5,12,149,5745,-58,-96,38,3e:d1:9b:c7:a4:de,239400378,272,1431,239400106,239400378
6605,5,12,149,5745,-71,-96,25,56:68:e2:c2:8d:d5,239405429,280,4771,239405149,239405429
6606,5,12,149,5745,-80,-96,16,9a:24:38:da:96:bb,239414211,272,8510,239413939,239414211
6607,5,12,149,5745,-75,-96,21,fa:44:8d:e1:c7:1b,239418050,244,3595,239417806,239418050
6608,5,12,149,5745,-75,-96,21,72:d1:72:1d:22:a1,239419502,256,1196,239419246,239419502
6609,5,12,149,5745,-74,-96,22,22:ec:75:a8:8a:31,239424835,516,4817,239424319,239424835
6610,5,12,149,5745,-61,-96,35,b6:90:18:f6:b1:d4,239430904,440,5629,239430464,239430904
6611,5,12,149,5745,-80,-96,16,3e:ef:29:c7:4b:17,239432414,244,1266,239432170,239432414
6612,5,12,149,5745,-74,-96,22,22:ec:75:a8:8a:31,239451223,244,18565,239450979,239451223
6613,5,12,149,5745,-51,-96,45,72:fd:09:2f:da:5f,239494044,284,42537,239493760,239494044
6614,5,6,149,5745,-88,-96,8,54:e4:3a:ec:fb:65,239497386,360,2982,239497026,239497386
6615,5,12,149,5745,-54,-96,42,f2:da:61:dd:98:c5,239498060,268,406,239497792,239498060
6616,5,12,149,5745,-56,-96,40,5e:29:73:5b:30:00,239515643,272,17311,239515371,239515643
6617,5,12,149,5745,-58,-96,38,3e:d1:9b:c7:a4:de,239518057,272,2142,239517785,239518057
6618,5,12,149,5745,-77,-96,19,d2:00:04:7e:2c:ab,239521929,244,3628,239521685,239521929
6619,5,12,149,5745,-73,-96,23,72:d1:72:1d:22:a1,239522325,256,140,239522069,239522325
6620,5,12,149,5745,-81,-96,15,9a:24:38:da:96:bb,239522925,272,328,239522653,239522925
6621,5,12,149,5745,-73,-96,23,fa:44:8d:e1:c7:1b,239530777,244,7608,239530533,239530777
6622,5,12,149,5745,-76,-96,20,22:ec:75:a8:8a:31,239559614,244,28593,239559370,239559614
6623,5,12,149,5745,-76,-96,20,3e:ef:29:c7:4b:17,239574278,244,14420,239574034,239574278
6624,5,12,149,5745,-53,-96,43,72:fd:09:2f:da:5f,239596244,284,21682,239595960,239596244
6625,5,6,149,5745,-87,-96,9,54:e4:3a:ec:fb:65,239599787,360,3183,239599427,239599787
6626,5,12,149,5745,-73,-96,23,fa:44:8d:e1:c7:1b,239602088,48,2253,239602040,239602088
6627,5,12,149,5745,-73,-96,23,fa:44:8d:e1:c7:1b,239602359,48,223,239602311,239602359
6628,5,12,149,5745,-71,-96,25,fa:44:8d:e1:c7:1b,239602487,48,80,239602439,239602487
6629,5,12,149,5745,-72,-96,24,fa:44:8d:e1:c7:1b,239602611,48,76,239602563,239602611
6630,5,12,149,5745,-71,-96,25,fa:44:8d:e1:c7:1b,239602793,48,134,239602745,239602793
6631,5,12,149,5745,-72,-96,24,fa:44:8d:e1:c7:1b,239602956,48,115,239602908,239602956
6632,5,12,149,5745,-72,-96,24,fa:44:8d:e1:c7:1b,239603101,48,97,239603053,239603101
6633,5,12,149,5745,-56,-96,40,f2:da:61:dd:98:c5,239603232,268,-137,239602964,239603232
6634,5,12,149,5745,-72,-96,24,56:68:e2:c2:8d:d5,239615009,280,11497,239614729,239615009
6635,5,12,149,5745,-79,-96,17,d2:00:04:7e:2c:ab,239616666,244,1413,239616422,239616666
6636,5,12,149,5745,-73,-96,23,72:d1:72:1d:22:a1,239616999,256,77,239616743,239616999
6637,5,12,149,5745,-68,-96,28,f6:0a:5c:59:72:df,239618963,448,1516,239618515,239618963
6638,5,12,149,5745,-71,-96,25,fa:44:8d:e1:c7:1b,239619690,440,287,239619250,239619690
6639,5,12,149,5745,-56,-96,40,3e:d1:9b:c7:a4:de,239621298,544,1064,239620754,239621298
6640,5,12,149,5745,-57,-96,39,5e:29:73:5b:30:00,239624369,540,2531,239623829,239624369
6641,5,12,149,5745,-72,-96,24,56:68:e2:c2:8d:d5,239625366,476,521,239624890,239625366
6642,5,12,149,5745,-79,-96,17,d2:00:04:7e:2c:ab,239628065,440,2259,239627625,239628065
6643,5,12,149,5745,-77,-96,19,3e:ef:29:c7:4b:17,239630025,440,1520,239629585,239630025
6644,5,12,149,5745,-74,-96,22,72:d1:72:1d:22:a1,239631461,452,984,239631009,239631461
6645,5,12,149,5745,-79,-96,17,d2:00:04:7e:2c:ab,239632874,380,1033,239632494,239632874
6646,5,12,149,5745,-72,-96,24,fa:44:8d:e1:c7:1b,239633299,244,181,239633055,239633299
6647,5,12,149,5745,-83,-96,13,9a:24:38:da:96:bb,239634198,272,627,239633926,239634198
6648,5,12,149,5745,-82,-96,14,9a:24:38:da:96:bb,239634931,824,-91,239634107,239634931
6649,5,12,149,5745,-52,-96,44,72:fd:09:2f:da:5f,239636995,480,1584,239636515,239636995
6650,5,12,149,5745,-55,-96,41,3e:d1:9b:c7:a4:de,239648075,272,10808,239647803,239648075
6651,5,12,149,5745,-55,-96,41,5e:29:73:5b:30:00,239649020,272,673,239648748,239649020
6652,5,12,149,5745,-77,-96,19,3e:ef:29:c7:4b:17,239650236,244,972,239649992,239650236
6653,5,12,149,5745,-74,-96,22,22:ec:75:a8:8a:31,239680602,244,30122,239680358,239680602
6654,5,12,149,5745,-70,-96,26,f6:0a:5c:59:72:df,239681320,252,466,239681068,239681320
6655,5,12,149,5745,-71,-96,25,fa:44:8d:e1:c7:1b,239684254,440,2494,239683814,239684254
6656,5,12,149,5745,-70,-96,26,f6:0a:5c:59:72:df,239684872,448,170,239684424,239684872
6657,5,12,149,5745,-61,-96,35,b6:90:18:f6:b1:d4,239685751,440,439,239685311,239685751
6658,5,12,149,5745,-74,-96,22,22:ec:75:a8:8a:31,239686766,516,499,239686250,239686766
6659,5,12,149,5745,-78,-96,18,d2:00:04:7e:2c:ab,239692205,440,4999,239691765,239692205
6660,5,12,149,5745,-78,-96,18,3e:ef:29:c7:4b:17,239694274,440,1629,239693834,239694274
6661,5,12,149,5745,-49,-96,47,72:fd:09:2f:da:5f,239699360,284,4802,239699076,239699360
6662,5,6,149,5745,-84,-96,12,54:e4:3a:ec:fb:65,239702188,360,2468,239701828,239702188
6663,5,12,149,5745,-61,-96,35,b6:90:18:f6:b1:d4,239731097,244,28665,239730853,239731097
6664,5,12,149,5745,-78,-96,18,d2:00:04:7e:2c:ab,239732258,244,917,239732014,239732258
6665,5,12,149,5745,-73,-96,23,72:d1:72:1d:22:a1,239739270,256,6756,239739014,239739270
6666,5,12,149,5745,-71,-96,25,56:68:e2:c2:8d:d5,239741504,280,1954,239741224,239741504
6667,5,12,149,5745,-84,-96,12,9a:24:38:da:96:bb,239746408,272,4632,239746136,239746408
6668,5,12,149,5745,-55,-96,41,5e:29:73:5b:30:00,239747228,272,548,239746956,239747228
6669,5,12,149,5745,-71,-96,25,fa:44:8d:e1:c7:1b,239747561,244,89,239747317,239747561
6670,5,12,149,5745,-71,-96,25,fa:44:8d:e1:c7:1b,239748802,440,801,239748362,239748802
6671,5,12,149,5745,-61,-96,35,b6:90:18:f6:b1:d4,239749278,440,36,239748838,239749278
6672,5,12,149,5745,-70,-96,26,f6:0a:5c:59:72:df,239750165,448,439,239749717,239750165
6673,5,12,149,5745,-77,-96,19,a6:92:ad:b7:76:65,239752078,456,1457,239751622,239752078
6674,5,12,149,5745,-57,-96,39,3e:d1:9b:c7:a4:de,239753454,544,832,239752910,239753454
6675,5,12,149,5745,-55,-96,41,5e:29:73:5b:30:00,239755059,540,1065,239754519,239755059
6676,5,12,149,5745,-78,-96,18,d2:00:04:7e:2c:ab,239757811,440,2312,239757371,239757811
6677,5,12,149,5745,-78,-96,18,3e:ef:29:c7:4b:17,239761436,440,3185,239760996,239761436
6678,5,12,149,5745,-57,-96,39,3e:d1:9b:c7:a4:de,239762774,272,1066,239762502,239762774
6679,5,12,149,5745,-78,-96,18,3e:ef:29:c7:4b:17,239764783,244,1765,239764539,239764783
6680,5,12,149,5745,-71,-96,25,0a:b9:b7:b1:4d:fa,239769229,268,4178,239768961,239769229
6681,5,12,149,5745,-53,-96,43,f2:da:61:dd:98:c5,239774474,268,4977,239774206,239774474
6682,5,12,149,5745,-70,-96,26,f6:0a:5c:59:72:df,239794078,252,19352,239793826,239794078
6683,5,12,149,5745,-71,-96,25,22:ec:75:a8:8a:31,239796164,244,1842,239795920,239796164
6684,5,6,149,5745,-85,-96,11,54:e4:3a:ec:fb:65,239804588,360,8064,239804228,239804588
6685,5,12,149,5745,-49,-96,47,72:fd:09:2f:da:5f,239817222,284,12350,239816938,239817222
6686,5,12,149,5745,-79,-96,17,d2:00:04:7e:2c:ab,239829438,244,11972,239829194,239829438
6687,5,12,149,5745,-79,-96,17,d2:00:04:7e:2c:ab,239832589,440,2711,239832149,239832589
6688,5,12,149,5745,-57,-96,39,5e:29:73:5b:30:00,239854574,272,21713,239854302,239854574
6689,5,12,149,5745,-82,-96,14,9a:24:38:da:96:bb,239858730,272,3884,239858458,239858730
6690,5,12,149,5745,-60,-96,36,3e:d1:9b:c7:a4:de,239859771,272,769,239859499,239859771
6691,5,12,149,5745,-79,-96,17,3e:ef:29:c7:4b:17,239884643,244,24628,239884399,239884643
6692,5,12,149,5745,-71,-96,25,22:ec:75:a8:8a:31,239901690,244,16803,239901446,239901690
6693,5,6,149,5745,-87,-96,9,54:e4:3a:ec:fb:65,239906989,360,4939,239906629,239906989
6694,5,12,149,5745,-49,-96,47,72:fd:09:2f:da:5f,239919587,284,12314,239919303,239919587
6695,5,24,149,5745,-75,-96,21,,239924258,28,4643,239924230,239924258
6696,5,24,149,5745,-88,-96,8,,239924302,28,16,239924274,239924302
6697,5,24,149,5745,-89,-96,7,,239924410,28,80,239924382,239924410
6698,5,12,149,5745,-69,-96,27,fa:44:8d:e1:c7:1b,239931143,244,6489,239930899,239931143
6699,5,12,149,5745,-61,-96,35,b6:90:18:f6:b1:d4,239931633,244,246,239931389,239931633
6700,5,12,149,5745,-77,-96,19,72:d1:72:1d:22:a1,239932084,256,195,239931828,239932084
6701,5,12,149,5745,-70,-96,26,56:68:e2:c2:8d:d5,239934399,280,2035,239934119,239934399
6702,5,24,149,5745,-88,-96,8,,239941866,32,7435,239941834,239941866
6703,5,24,149,5745,-88,-96,8,,239942437,32,539,239942405,239942437
6704,5,24,149,5745,-89,-96,7,,239943009,28,544,239942981,239943009
6705,5,24,149,5745,-79,-96,17,,239943053,28,16,239943025,239943053
6706,5,24,149,5745,-89,-96,7,,239952923,32,9838,239952891,239952923
6707,5,24,149,5745,-75,-96,21,,239969157,28,16206,239969129,239969157
6708,5,24,149,5745,-89,-96,7,,239969201,28,16,239969173,239969201
6709,5,24,149,5745,-87,-96,9,,239969309,28,80,239969281,239969309
6710,5,24,149,5745,-88,-96,8,,239970424,28,1087,239970396,239970424
6711,5,24,149,5745,-89,-96,7,,239971026,28,574,239970998,239971026
6712,5,12,149,5745,-57,-96,39,5e:29:73:5b:30:00,239971508,272,210,239971236,239971508
6713,5,24,149,5745,-89,-96,7,,239973486,28,1950,239973458,239973486
6714,5,24,149,5745,-89,-96,7,,239973595,32,77,239973563,239973595
6715,5,12,149,5745,-55,-96,41,3e:d1:9b:c7:a4:de,239976676,272,2809,239976404,239976676
6716,5,24,149,5745,-75,-96,21,,239985768,28,9064,239985740,239985768
6717,5,24,149,5745,-88,-96,8,,239985812,28,16,239985784,239985812
6718,5,24,149,5745,-88,-96,8,,239985920,28,80,239985892,239985920
6719,5,24,149,5745,-89,-96,7,,239986108,28,160,239986080,239986108
6720,5,24,149,5745,-89,-96,7,,239986500,28,364,239986472,239986500
6721,5,24,149,5745,-89,-96,7,,239992486,28,5958,239992458,239992486
6722,5,12,149,5745,-79,-96,17,3e:ef:29:c7:4b:17,239994577,244,1847,239994333,239994577
6723,5,24,149,5745,-87,-96,9,,240001732,28,7127,240001704,240001732
6724,5,6,149,5745,-85,-96,11,54:e4:3a:ec:fb:65,240009389,360,7297,240009029,240009389
6725,5,24,149,5745,-87,-96,9,,240015187,28,5770,240015159,240015187
6726,5,24,149,5745,-88,-96,8,,240016479,28,1264,240016451,240016479
6727,5,24,149,5745,-87,-96,9,,240016818,28,311,240016790,240016818
6728,5,24,149,5745,-89,-96,7,,240018237,28,1391,240018209,240018237
6729,5,24,149,5745,-89,-96,7,,240018518,28,253,240018490,240018518
6730,5,24,149,5745,-88,-96,8,,240018627,32,77,240018595,240018627
6731,5,24,149,5745,-89,-96,7,,240018765,28,110,240018737,240018765
6732,5,24,149,5745,-88,-96,8,,240019055,28,262,240019027,240019055
6733,5,24,149,5745,-89,-96,7,,240019164,32,77,240019132,240019164
6734,5,12,149,5745,-72,-96,24,22:ec:75:a8:8a:31,240019230,244,-178,240018986,240019230
6735,5,24,149,5745,-88,-96,8,,240020471,28,1213,240020443,240020471
6736,5,24,149,5745,-88,-96,8,,240020580,32,77,240020548,240020580
6737,5,24,149,5745,-88,-96,8,,240024719,32,4107,240024687,240024719
6738,5,12,149,5745,-69,-96,27,fa:44:8d:e1:c7:1b,240033287,244,8324,240033043,240033287
6739,5,12,149,5745,-78,-96,18,72:d1:72:1d:22:a1,240034163,256,620,240033907,240034163
6740,5,12,149,5745,-60,-96,36,b6:90:18:f6:b1:d4,240034475,244,68,240034231,240034475
6741,5,12,149,5745,-82,-96,14,d2:00:04:7e:2c:ab,240035583,244,864,240035339,240035583
6742,5,12,149,5745,-70,-96,26,56:68:e2:c2:8d:d5,240036148,280,285,240035868,240036148
6743,5,24,149,5745,-88,-96,8,,240049667,28,13491,240049639,240049667
6744,5,24,149,5745,-89,-96,7,,240052857,32,3158,240052825,240052857
6745,5,12,149,5745,-80,-96,16,9a:24:38:da:96:bb,240086769,272,33640,240086497,240086769
6746,5,12,149,5745,-56,-96,40,5e:29:73:5b:30:00,240088574,272,1533,240088302,240088574
6747,5,12,149,5745,-54,-96,42,3e:d1:9b:c7:a4:de,240090906,272,2060,240090634,240090906
6748,5,24,149,5745,-88,-96,8,,240095723,32,4785,240095691,240095723
6749,5,24,149,5745,-88,-96,8,,240097129,28,1378,240097101,240097129
6750,5,24,149,5745,-88,-96,8,,240097474,28,317,240097446,240097474
6751,5,24,149,5745,-88,-96,8,,240100547,28,3045,240100519,240100547
6752,5,24,149,5745,-89,-96,7,,240100656,32,77,240100624,240100656
6753,5,12,149,5745,-49,-96,47,72:fd:09:2f:da:5f,240109018,284,8078,240108734,240109018
6754,5,6,149,5745,-85,-96,11,54:e4:3a:ec:fb:65,240111790,360,2412,240111430,240111790
6755,5,24,149,5745,-88,-96,8,,240114722,28,2904,240114694,240114722
6756,5,24,149,5745,-88,-96,8,,240117601,28,2851,240117573,240117601
6757,5,24,149,5745,-86,-96,10,,240117717,32,84,240117685,240117717
6758,5,12,149,5745,-70,-96,26,22:ec:75:a8:8a:31,240130611,244,12650,240130367,240130611
6759,5,24,149,5745,-89,-96,7,,240131058,32,415,240131026,240131058
6760,5,24,149,5745,-87,-96,9,,240131946,28,860,240131918,240131946
6761,5,24,149,5745,-88,-96,8,,240134692,28,2718,240134664,240134692
6762,5,24,149,5745,-87,-96,9,,240135017,28,297,240134989,240135017
6763,5,12,149,5745,-69,-96,27,fa:44:8d:e1:c7:1b,240135385,244,124,240135141,240135385
6764,5,12,149,5745,-80,-96,16,d2:00:04:7e:2c:ab,240135726,244,97,240135482,240135726
6765,5,12,149,5745,-60,-96,36,b6:90:18:f6:b1:d4,240136051,244,81,240135807,240136051
6766,5,24,149,5745,-87,-96,9,,240137228,28,1149,240137200,240137228
6767,5,24,149,5745,-88,-96,8,,240137340,32,80,240137308,240137340
6768,5,12,149,5745,-77,-96,19,72:d1:72:1d:22:a1,240137505,256,-91,240137249,240137505
6769,5,12,149,5745,-70,-96,26,56:68:e2:c2:8d:d5,240137796,280,11,240137516,240137796
6770,5,24,149,5745,-87,-96,9,,240139421,28,1597,240139393,240139421
6771,5,24,149,5745,-87,-96,9,,240139542,32,89,240139510,240139542
6772,5,24,149,5745,-88,-96,8,,240148636,28,9066,240148608,240148636
6773,5,12,149,5745,-49,-96,47,72:fd:09:2f:da:5f,240148833,284,-87,240148549,240148833
6774,5,24,149,5745,-87,-96,9,,240149241,28,380,240149213,240149241
6775,5,24,149,5745,-87,-96,9,,240149541,28,272,240149513,240149541
6776,5,24,149,5745,-87,-96,9,,240149867,28,298,240149839,240149867
6777,5,24,149,5745,-88,-96,8,,240151125,28,1230,240151097,240151125
6778,5,24,149,5745,-87,-96,9,,240151232,32,75,240151200,240151232
6779,5,24,149,5745,-87,-96,9,,240152638,28,1378,240152610,240152638
6780,5,24,149,5745,-86,-96,10,,240152747,32,77,240152715,240152747
6781,5,24,149,5745,-87,-96,9,,240153774,28,999,240153746,240153774
6782,5,24,149,5745,-87,-96,9,,240154104,28,302,240154076,240154104
6783,5,24,149,5745,-87,-96,9,,240156379,28,2247,240156351,240156379
6784,5,24,149,5745,-87,-96,9,,240156491,32,80,240156459,240156491
6785,5,24,149,5745,-87,-96,9,,240175342,28,18823,240175314,240175342
6786,5,12,149,5745,-80,-96,16,d2:00:04:7e:2c:ab,240182488,244,6902,240182244,240182488
6787,5,24,149,5745,-86,-96,10,,240183032,28,516,240183004,240183032
6788,5,24,149,5745,-86,-96,10,,240185984,28,2924,240185956,240185984
6789,5,24,149,5745,-88,-96,8,,240186093,32,77,240186061,240186093
6790,5,24,149,5745,-87,-96,9,,240189710,28,3589,240189682,240189710
6791,5,24,149,5745,-86,-96,10,,240189850,32,108,240189818,240189850
6792,5,12,149,5745,-60,-96,36,b6:90:18:f6:b1:d4,240190564,244,470,240190320,240190564
6793,5,12,149,5745,-78,-96,18,3e:ef:29:c7:4b:17,240191708,244,900,240191464,240191708
6794,5,12,149,5745,-70,-96,26,56:68:e2:c2:8d:d5,240191995,280,7,240191715,240191995
6795,5,12,149,5745,-75,-96,21,72:d1:72:1d:22:a1,240192742,256,491,240192486,240192742
6796,5,12,149,5745,-81,-96,15,9a:24:38:da:96:bb,240193789,272,775,240193517,240193789
6797,5,24,149,5745,-87,-96,9,,240203833,28,10016,240203805,240203833
6798,5,12,149,5745,-69,-96,27,fa:44:8d:e1:c7:1b,240206589,244,2512,240206345,240206589
6799,5,24,149,5745,-87,-96,9,,240206948,28,331,240206920,240206948
6800,5,24,149,5745,-87,-96,9,,240207056,32,76,240207024,240207056
6801,5,24,149,5745,-88,-96,8,,240207176,28,92,240207148,240207176
6802,5,24,149,5745,-87,-96,9,,240207516,28,312,240207488,240207516
6803,5,24,149,5745,-87,-96,9,,240210346,28,2802,240210318,240210346
6804,5,24,149,5745,-87,-96,9,,240210455,32,77,240210423,240210455
6805,5,12,149,5745,-67,-96,29,f6:0a:5c:59:72:df,240210952,448,49,240210504,240210952
6806,5,12,149,5745,-55,-96,41,5e:29:73:5b:30:00,240211452,540,-40,240210912,240211452
6807,5,24,149,5745,-86,-96,10,,240212143,28,663,240212115,240212143
6808,5,24,149,5745,-88,-96,8,,240212252,32,77,240212220,240212252
6809,5,12,149,5745,-70,-96,26,56:68:e2:c2:8d:d5,240213938,476,1210,240213462,240213938
6810,5,12,149,5745,-60,-96,36,b6:90:18:f6:b1:d4,240219120,440,4742,240218680,240219120
6811,5,12,149,5745,-57,-96,39,3e:d1:9b:c7:a4:de,240220450,544,786,240219906,240220450
6812,5,12,149,5745,-76,-96,20,72:d1:72:1d:22:a1,240221038,452,136,240220586,240221038
6813,5,12,149,5745,-58,-96,38,3e:d1:9b:c7:a4:de,240221523,272,213,240221251,240221523
6814,5,12,149,5745,-56,-96,40,5e:29:73:5b:30:00,240222513,272,718,240222241,240222513
6815,5,12,149,5745,-79,-96,17,3e:ef:29:c7:4b:17,240223539,244,782,240223295,240223539
6816,5,24,149,5745,-88,-96,8,,240224310,28,743,240224282,240224310
6817,5,24,149,5745,-87,-96,9,,240224568,28,230,240224540,240224568
6818,5,12,149,5745,-79,-96,17,d2:00:04:7e:2c:ab,240225335,440,327,240224895,240225335
6819,5,24,149,5745,-88,-96,8,,240227328,28,1965,240227300,240227328
6820,5,24,149,5745,-87,-96,9,,240227437,32,77,240227405,240227437
6821,5,12,149,5745,-74,-96,22,22:ec:75:a8:8a:31,240227521,516,-432,240227005,240227521
6822,5,24,149,5745,-87,-96,9,,240228215,28,666,240228187,240228215
6823,5,24,149,5745,-88,-96,8,,240228323,32,76,240228291,240228323
6824,5,24,149,5745,-87,-96,9,,240229422,28,1071,240229394,240229422
6825,5,24,149,5745,-87,-96,9,,240229530,32,76,240229498,240229530
6826,5,12,149,5745,-51,-96,45,72:fd:09:2f:da:5f,240229651,480,-359,240229171,240229651
6827,5,12,149,5745,-80,-96,16,3e:ef:29:c7:4b:17,240231395,440,1304,240230955,240231395
6828,5,24,149,5745,-87,-96,9,,240239179,28,7756,240239151,240239179
6829,5,24,149,5745,-88,-96,8,,240242171,28,2964,240242143,240242171
6830,5,24,149,5745,-88,-96,8,,240242280,32,77,240242248,240242280
6831,5,24,149,5745,-88,-96,8,,240242454,28,146,240242426,240242454
6832,5,24,149,5745,-88,-96,8,,240242990,32,504,240242958,240242990
6833,5,24,149,5745,-88,-96,8,,240244744,28,1726,240244716,240244744
6834,5,12,149,5745,-67,-96,29,f6:0a:5c:59:72:df,240248987,252,3991,240248735,240248987
6835,5,12,149,5745,-74,-96,22,22:ec:75:a8:8a:31,240254376,244,5145,240254132,240254376
6836,5,12,149,5745,-52,-96,44,72:fd:09:2f:da:5f,240254888,284,228,240254604,240254888
6837,5,24,149,5745,-87,-96,9,,240256859,28,1943,240256831,240256859
6838,5,12,149,5745,-84,-96,12,9a:24:38:da:96:bb,240273053,824,15370,240272229,240273053
6839,5,12,149,5745,-69,-96,27,f6:0a:5c:59:72:df,240276013,448,2512,240275565,240276013
6840,5,12,149,5745,-71,-96,25,56:68:e2:c2:8d:d5,240276603,476,114,240276127,240276603
6841,5,12,149,5745,-69,-96,27,f6:0a:5c:59:72:df,240280072,360,3109,240279712,240280072
6842,5,12,149,5745,-60,-96,36,b6:90:18:f6:b1:d4,240283860,440,3348,240283420,240283860
6843,5,12,149,5745,-79,-96,17,3e:ef:29:c7:4b:17,240284471,364,247,240284107,240284471
6844,5,12,149,5745,-77,-96,19,a6:92:ad:b7:76:65,240284941,456,14,240284485,240284941
6845,5,12,149,5745,-64,-96,32,0a:b9:b7:b1:4d:fa,240285808,268,599,240285540,240285808
6846,5,12,149,5745,-59,-96,37,3e:d1:9b:c7:a4:de,240286146,544,-206,240285602,240286146
6847,5,12,149,5745,-56,-96,40,5e:29:73:5b:30:00,240286751,540,65,240286211,240286751
6848,5,12,149,5745,-60,-96,36,b6:90:18:f6:b1:d4,240287849,244,854,240287605,240287849
6849,5,12,149,5745,-79,-96,17,d2:00:04:7e:2c:ab,240288317,244,224,240288073,240288317
6850,5,12,149,5745,-75,-96,21,72:d1:72:1d:22:a1,240288597,256,24,240288341,240288597
6851,5,12,149,5745,-74,-96,22,72:d1:72:1d:22:a1,240289877,452,828,240289425,240289877
6852,5,12,149,5745,-53,-96,43,72:fd:09:2f:da:5f,240292164,480,1807,240291684,240292164
6853,5,12,149,5745,-55,-96,41,f2:da:61:dd:98:c5,240292806,268,374,240292538,240292806
6854,5,12,149,5745,-67,-96,29,fa:44:8d:e1:c7:1b,240293513,440,267,240293073,240293513
6855,5,12,149,5745,-79,-96,17,3e:ef:29:c7:4b:17,240296733,440,2780,240296293,240296733
6856,5,12,149,5745,-71,-96,25,56:68:e2:c2:8d:d5,240303184,280,6171,240302904,240303184
6857,5,12,149,5745,-85,-96,11,9a:24:38:da:96:bb,240309097,272,5641,240308825,240309097
6858,5,24,149,5745,-88,-96,8,,240313151,28,4026,240313123,240313151
6859,5,6,149,5745,-82,-96,14,54:e4:3a:ec:fb:65,240316591,360,3080,240316231,240316591
6860,5,12,149,5745,-59,-96,37,3e:d1:9b:c7:a4:de,240320156,272,3293,240319884,240320156
6861,5,12,149,5745,-56,-96,40,5e:29:73:5b:30:00,240321533,272,1105,240321261,240321533
6862,5,12,149,5745,-67,-96,29,fa:44:8d:e1:c7:1b,240321839,244,62,240321595,240321839
6863,5,12,149,5745,-78,-96,18,3e:ef:29:c7:4b:17,240350898,244,28815,240350654,240350898
6864,5,12,149,5745,-73,-96,23,22:ec:75:a8:8a:31,240360373,244,9231,240360129,240360373
6865,5,12,149,5745,-53,-96,43,72:fd:09:2f:da:5f,240372226,284,11569,240371942,240372226
6866,5,12,149,5745,-73,-96,23,72:d1:72:1d:22:a1,240415963,256,43481,240415707,240415963
6867,5,6,149,5745,-83,-96,13,54:e4:3a:ec:fb:65,240418991,360,2668,240418631,240418991
6868,5,12,149,5745,-86,-96,10,9a:24:38:da:96:bb,240421873,272,2610,240421601,240421873
6869,5,12,149,5745,-59,-96,37,3e:d1:9b:c7:a4:de,240429369,272,7224,240429097,240429369
6870,5,12,149,5745,-58,-96,38,5e:29:73:5b:30:00,240430052,272,411,240429780,240430052
6871,5,24,149,5745,-89,-96,7,,240438136,32,8052,240438104,240438136
6872,5,12,149,5745,-68,-96,28,fa:44:8d:e1:c7:1b,240443125,244,4745,240442881,240443125
6873,5,12,149,5745,-59,-96,37,b6:90:18:f6:b1:d4,240443470,244,101,240443226,240443470
6874,5,12,149,5745,-80,-96,16,d2:00:04:7e:2c:ab,240444007,244,293,240443763,240444007
6875,5,12,149,5745,-72,-96,24,56:68:e2:c2:8d:d5,240445779,280,1492,240445499,240445779
6876,5,24,149,5745,-88,-96,8,,240446264,32,453,240446232,240446264
6877,5,24,149,5745,-89,-96,7,,240462980,28,16688,240462952,240462980
6878,5,24,149,5745,-88,-96,8,,240463331,28,323,240463303,240463331
6879,5,24,149,5745,-88,-96,8,,240465980,28,2621,240465952,240465980
6880,5,12,149,5745,-69,-96,27,22:ec:75:a8:8a:31,240477081,244,10857,240476837,240477081
6881,5,12,149,5745,-64,-96,32,f6:0a:5c:59:72:df,240491228,252,13895,240490976,240491228
6882,5,12,149,5745,-76,-96,20,3e:ef:29:c7:4b:17,240497497,244,6025,240497253,240497497
6883,5,24,149,5745,-87,-96,9,,240507046,28,9521,240507018,240507046
6884,5,24,149,5745,-89,-96,7,,240507930,28,856,240507902,240507930
6885,5,12,149,5745,-51,-96,45,72:fd:09:2f:da:5f,240518810,284,10596,240518526,240518810
6886,5,6,149,5745,-84,-96,12,54:e4:3a:ec:fb:65,240521391,360,2221,240521031,240521391
6887,5,12,149,5745,-80,-96,16,9a:24:38:da:96:bb,240538175,272,16512,240537903,240538175
6888,5,24,149,5745,-88,-96,8,,240545155,32,6948,240545123,240545155
6889,5,12,149,5745,-59,-96,37,b6:90:18:f6:b1:d4,240545780,244,381,240545536,240545780
6890,5,12,149,5745,-72,-96,24,72:d1:72:1d:22:a1,240546213,256,177,240545957,240546213
6891,5,12,149,5745,-59,-96,37,3e:d1:9b:c7:a4:de,240546620,272,135,240546348,240546620
6892,5,12,149,5745,-72,-96,24,56:68:e2:c2:8d:d5,240546953,280,53,240546673,240546953
6893,5,12,149,5745,-60,-96,36,5e:29:73:5b:30:00,240547327,272,102,240547055,240547327
6894,5,24,149,5745,-87,-96,9,,240547704,28,349,240547676,240547704
6895,5,12,149,5745,-84,-96,12,d2:00:04:7e:2c:ab,240547879,244,-69,240547635,240547879
6896,5,12,149,5745,-67,-96,29,fa:44:8d:e1:c7:1b,240561259,244,13136,240561015,240561259
6897,5,24,149,5745,-89,-96,7,,240563065,28,1778,240563037,240563065
6898,5,12,149,5745,-69,-96,27,22:ec:75:a8:8a:31,240593158,244,29849,240592914,240593158
6899,5,12,149,5745,-77,-96,19,3e:ef:29:c7:4b:17,240599665,244,6263,240599421,240599665
6900,5,12,149,5745,-65,-96,31,f6:0a:5c:59:72:df,240601021,252,1104,240600769,240601021
6901,5,24,149,5745,-88,-96,8,,240603097,28,2048,240603069,240603097
6902,5,24,149,5745,-88,-96,8,,240603427,28,302,240603399,240603427
6903,5,24,149,5745,-88,-96,8,,240606067,28,2612,240606039,240606067
6904,5,24,149,5745,-88,-96,8,,240620502,28,14407,240620474,240620502
6905,5,24,149,5745,-87,-96,9,,240620610,32,76,240620578,240620610
6906,5,12,149,5745,-51,-96,45,72:fd:09:2f:da:5f,240620803,284,-91,240620519,240620803
6907,5,6,149,5745,-87,-96,9,54:e4:3a:ec:fb:65,240623792,360,2629,240623432,240623792
6908,5,24,149,5745,-88,-96,8,,240631206,28,7386,240631178,240631206
6909,5,24,149,5745,-88,-96,8,,240634347,32,3109,240634315,240634347
6910,5,12,149,5745,-83,-96,13,9a:24:38:da:96:bb,240647247,272,12628,240646975,240647247
6911,5,24,149,5745,-88,-96,8,,240647570,28,295,240647542,240647570
6912,5,12,149,5745,-66,-96,30,fa:44:8d:e1:c7:1b,240649819,48,2201,240649771,240649819
6913,5,12,149,5745,-60,-96,36,,240649883,32,32,240649851,240649883
6914,5,12,149,5745,-60,-96,36,b6:90:18:f6:b1:d4,240649958,244,-169,240649714,240649958
6915,5,24,149,5745,-88,-96,8,,240650542,32,552,240650510,240650542
6916,5,12,149,5745,-83,-96,13,d2:00:04:7e:2c:ab,240651185,244,399,240650941,240651185
6917,5,12,149,5745,-72,-96,24,72:d1:72:1d:22:a1,240651779,256,338,240651523,240651779
6918,5,12,149,5745,-72,-96,24,56:68:e2:c2:8d:d5,240652627,280,568,240652347,240652627
6919,5,12,149,5745,-61,-96,35,3e:d1:9b:c7:a4:de,240663876,272,10977,240663604,240663876
6920,5,12,149,5745,-68,-96,28,fa:44:8d:e1:c7:1b,240665480,244,1360,240665236,240665480
6921,5,12,149,5745,-77,-96,19,3e:ef:29:c7:4b:17,240666192,244,468,240665948,240666192
6922,5,12,149,5745,-85,-96,11,9a:24:38:da:96:bb,240667048,824,32,240666224,240667048
6923,5,12,149,5745,-66,-96,30,f6:0a:5c:59:72:df,240668783,448,1287,240668335,240668783
6924,5,12,149,5745,-60,-96,36,b6:90:18:f6:b1:d4,240678356,440,9133,240677916,240678356
6925,5,12,149,5745,-66,-96,30,fa:44:8d:e1:c7:1b,240679778,252,1170,240679526,240679778
6926,5,12,149,5745,-56,-96,40,5e:29:73:5b:30:00,240681090,272,1040,240680818,240681090
6927,5,12,149,5745,-61,-96,35,3e:d1:9b:c7:a4:de,240681586,544,-48,240681042,240681586
6928,5,12,149,5745,-56,-96,40,5e:29:73:5b:30:00,240683047,540,921,240682507,240683047
6929,5,12,149,5745,-72,-96,24,72:d1:72:1d:22:a1,240684496,452,997,240684044,240684496
6930,5,12,149,5745,-66,-96,30,fa:44:8d:e1:c7:1b,240686055,440,1119,240685615,240686055
6931,5,12,149,5745,-56,-96,40,f2:da:61:dd:98:c5,240687171,268,848,240686903,240687171
6932,5,12,149,5745,-73,-96,23,56:68:e2:c2:8d:d5,240688725,476,1078,240688249,240688725
6933,5,12,149,5745,-72,-96,24,22:ec:75:a8:8a:31,240689262,516,21,240688746,240689262
6934,5,12,149,5745,-49,-96,47,72:fd:09:2f:da:5f,240689866,480,124,240689386,240689866
6935,5,12,149,5745,-83,-96,13,d2:00:04:7e:2c:ab,240691038,440,732,240690598,240691038
6936,5,12,149,5745,-76,-96,20,3e:ef:29:c7:4b:17,240691514,440,36,240691074,240691514
6937,5,12,149,5745,-65,-96,31,f6:0a:5c:59:72:df,240702365,252,10599,240702113,240702365
6938,5,6,149,5745,-88,-96,8,54:e4:3a:ec:fb:65,240713297,352,10580,240712945,240713297
6939,5,12,149,5745,-72,-96,24,22:ec:75:a8:8a:31,240713668,244,127,240713424,240713668
6940,5,6,149,5745,-87,-96,9,54:e4:3a:ec:fb:65,240713937,352,-83,240713585,240713937
6941,5,6,149,5745,-87,-96,9,54:e4:3a:ec:fb:65,240723584,352,9295,240723232,240723584
6942,5,6,149,5745,-88,-96,8,54:e4:3a:ec:fb:65,240726193,360,2249,240725833,240726193
6943,5,24,149,5745,-88,-96,8,,240729050,32,2825,240729018,240729050
6944,5,12,149,5745,-69,-96,27,f6:0a:5c:59:72:df,240734605,448,5107,240734157,240734605
6945,5,12,149,5745,-56,-96,40,f2:da:61:dd:98:c5,240738587,268,3714,240738319,240738587
6946,5,12,149,5745,-60,-96,36,b6:90:18:f6:b1:d4,240743532,440,4505,240743092,240743532
6947,5,24,149,5745,-89,-96,7,,240746422,28,2862,240746394,240746422
6948,5,12,149,5745,-60,-96,36,b6:90:18:f6:b1:d4,240746658,244,-8,240746414,240746658
6949,5,12,149,5745,-82,-96,14,d2:00:04:7e:2c:ab,240746956,244,54,240746712,240746956
6950,5,24,149,5745,-88,-96,8,,240747795,28,811,240747767,240747795
6951,5,24,149,5745,-87,-96,9,,240748108,28,285,240748080,240748108
6952,5,24,149,5745,-87,-96,9,,240749121,32,981,240749089,240749121
6953,5,12,149,5745,-66,-96,30,fa:44:8d:e1:c7:1b,240750775,440,1214,240750335,240750775
6954,5,12,149,5745,-72,-96,24,72:d1:72:1d:22:a1,240751260,256,229,240751004,240751260
6955,5,12,149,5745,-62,-96,34,3e:d1:9b:c7:a4:de,240752959,544,1155,240752415,240752959
6956,5,12,149,5745,-72,-96,24,56:68:e2:c2:8d:d5,240753547,280,308,240753267,240753547
6957,5,12,149,5745,-83,-96,13,d2:00:04:7e:2c:ab,240755114,440,1127,240754674,240755114
6958,5,12,149,5745,-77,-96,19,3e:ef:29:c7:4b:17,240755643,440,89,240755203,240755643
6959,5,12,149,5745,-55,-96,41,5e:29:73:5b:30:00,240773595,272,17680,240773323,240773595
6960,5,12,149,5745,-62,-96,34,3e:d1:9b:c7:a4:de,240778912,272,5045,240778640,240778912
6961,5,12,149,5745,-65,-96,31,fa:44:8d:e1:c7:1b,240780349,244,1193,240780105,240780349
6962,5,12,149,5745,-57,-96,39,f2:da:61:dd:98:c5,240781131,268,514,240780863,240781131
6963,5,12,149,5745,-68,-96,28,f6:0a:5c:59:72:df,240799388,448,17809,240798940,240799388
6964,5,12,149,5745,-57,-96,39,f2:da:61:dd:98:c5,240804002,268,4346,240803734,240804002
6965,5,12,149,5745,-82,-96,14,9a:24:38:da:96:bb,240805500,824,674,240804676,240805500
6966,5,24,149,5745,-89,-96,7,,240807266,32,1734,240807234,240807266
6967,5,12,149,5745,-72,-96,24,a6:92:ad:b7:76:65,240808975,456,1253,240808519,240808975
6968,5,12,149,5745,-60,-96,36,b6:90:18:f6:b1:d4,240809466,440,51,240809026,240809466
6969,5,24,149,5745,-88,-96,8,,240810562,32,1064,240810530,240810562
6970,5,12,149,5745,-66,-96,30,0a:b9:b7:b1:4d:fa,240812007,268,1177,240811739,240812007
6971,5,12,149,5745,-55,-96,41,5e:29:73:5b:30:00,240813196,540,649,240812656,240813196
6972,5,12,149,5745,-69,-96,27,f6:0a:5c:59:72:df,240814085,252,637,240813833,240814085
6973,5,12,149,5745,-66,-96,30,fa:44:8d:e1:c7:1b,240816937,440,2412,240816497,240816937
6974,5,12,149,5745,-63,-96,33,3e:d1:9b:c7:a4:de,240818357,544,876,240817813,240818357
6975,5,12,149,5745,-81,-96,15,d2:00:04:7e:2c:ab,240820024,440,1227,240819584,240820024
6976,5,12,149,5745,-72,-96,24,22:ec:75:a8:8a:31,240820543,516,3,240820027,240820543
6977,5,12,149,5745,-78,-96,18,3e:ef:29:c7:4b:17,240821762,440,779,240821322,240821762
6978,5,12,149,5745,-48,-96,48,72:fd:09:2f:da:5f,240822902,284,856,240822618,240822902
6979,5,24,149,5745,-88,-96,8,,240824220,28,1290,240824192,240824220
6980,5,24,149,5745,-89,-96,7,,240826459,28,2211,240826431,240826459
6981,5,24,149,5745,-89,-96,7,,240827368,32,877,240827336,240827368
6982,5,12,149,5745,-72,-96,24,22:ec:75:a8:8a:31,240827497,244,-115,240827253,240827497
6983,5,6,149,5745,-87,-96,9,54:e4:3a:ec:fb:65,240828616,360,759,240828256,240828616
6984,5,24,149,5745,-88,-96,8,,240865548,28,36904,240865520,240865548
6985,5,12,149,5745,-72,-96,24,72:d1:72:1d:22:a1,240868799,256,2995,240868543,240868799
6986,5,12,149,5745,-82,-96,14,9a:24:38:da:96:bb,240870872,272,1801,240870600,240870872
6987,5,12,149,5745,-72,-96,24,56:68:e2:c2:8d:d5,240871397,280,245,240871117,240871397
6988,5,12,149,5745,-82,-96,14,d2:00:04:7e:2c:ab,240872422,244,781,240872178,240872422
6989,5,12,149,5745,-60,-96,36,b6:90:18:f6:b1:d4,240872756,244,90,240872512,240872756
6990,5,24,149,5745,-87,-96,9,,240874251,32,1463,240874219,240874251
6991,5,12,149,5745,-63,-96,33,3e:d1:9b:c7:a4:de,240883578,544,8783,240883034,240883578
6992,5,12,149,5745,-55,-96,41,5e:29:73:5b:30:00,240890478,272,6628,240890206,240890478
6993,5,12,149,5745,-63,-96,33,3e:d1:9b:c7:a4:de,240893267,272,2517,240892995,240893267
6994,5,12,149,5745,-72,-96,24,fa:44:8d:e1:c7:1b,240898880,244,5369,240898636,240898880
6995,5,12,149,5745,-56,-96,40,f2:da:61:dd:98:c5,240903853,268,4705,240903585,240903853
6996,5,12,149,5745,-79,-96,17,3e:ef:29:c7:4b:17,240909084,244,4987,240908840,240909084
6997,5,24,149,5745,-75,-96,21,,240921981,28,12869,240921953,240921981
6998,5,6,149,5745,-86,-96,10,54:e4:3a:ec:fb:65,240930994,360,8653,240930634,240930994
6999,5,12,149,5745,-74,-96,22,22:ec:75:a8:8a:31,240934724,244,3486,240934480,240934724
7000,5,12,149,5745,-48,-96,48,72:fd:09:2f:da:5f,240935930,284,922,240935646,240935930
7001,5,12,149,5745,-63,-96,33,3e:d1:9b:c7:a4:de,240949206,544,12732,240948662,240949206
7002,5,12,149,5745,-66,-96,30,f6:0a:5c:59:72:df,240955952,252,6494,240955700,240955952
7003,5,24,149,5745,-74,-96,22,,240982997,28,27017,240982969,240982997
7004,5,12,149,5745,-82,-96,14,9a:24:38:da:96:bb,240983569,272,300,240983297,240983569
7005,5,12,149,5745,-58,-96,38,5e:29:73:5b:30:00,241007543,272,23702,241007271,241007543
7006,5,12,149,5745,-62,-96,34,3e:d1:9b:c7:a4:de,241008048,272,233,241007776,241008048
7007,5,12,149,5745,-62,-96,34,3e:d1:9b:c7:a4:de,241014456,544,5864,241013912,241014456
7008,5,12,149,5745,-78,-96,18,3e:ef:29:c7:4b:17,241021182,244,6482,241020938,241021182
7009,5,6,149,5745,-84,-96,12,54:e4:3a:ec:fb:65,241033394,360,11852,241033034,241033394
7010,5,12,149,5745,-55,-96,41,f2:da:61:dd:98:c5,241034070,268,408,241033802,241034070
7011,5,12,149,5745,-49,-96,47,72:fd:09:2f:da:5f,241046098,284,11744,241045814,241046098
7012,5,12,149,5745,-75,-96,21,22:ec:75:a8:8a:31,241051790,244,5448,241051546,241051790
7013,5,12,149,5745,-84,-96,12,d2:00:04:7e:2c:ab,241057561,244,5527,241057317,241057561
7014,5,12,149,5745,-71,-96,25,fa:44:8d:e1:c7:1b,241057920,244,115,241057676,241057920
7015,5,12,149,5745,-60,-96,36,b6:90:18:f6:b1:d4,241058406,244,242,241058162,241058406
7016,5,12,149,5745,-75,-96,21,72:d1:72:1d:22:a1,241058740,256,78,241058484,241058740
7017,5,12,149,5745,-73,-96,23,56:68:e2:c2:8d:d5,241060143,280,1123,241059863,241060143
7018,5,12,149,5745,-66,-96,30,f6:0a:5c:59:72:df,241063820,252,3425,241063568,241063820
7019,5,6,149,5745,-85,-96,11,54:e4:3a:ec:fb:65,241069071,352,4899,241068719,241069071
7020,5,12,149,5745,-84,-96,12,9a:24:38:da:96:bb,241096550,272,27207,241096278,241096550
7021,5,6,149,5745,-85,-96,11,54:e4:3a:ec:fb:65,241106182,352,9280,241105830,241106182
7022,5,12,149,5745,-60,-96,36,3e:d1:9b:c7:a4:de,241111405,272,4951,241111133,241111405
7023,5,12,149,5745,-60,-96,36,5e:29:73:5b:30:00,241124053,272,12376,241123781,241124053
7024,5,6,149,5745,-85,-96,11,54:e4:3a:ec:fb:65,241135795,360,11382,241135435,241135795
7025,5,12,149,5745,-55,-96,41,f2:da:61:dd:98:c5,241136885,268,822,241136617,241136885
7026,5,12,149,5745,-61,-96,35,b6:90:18:f6:b1:d4,241159871,244,22742,241159627,241159871
7027,5,12,149,5745,-73,-96,23,fa:44:8d:e1:c7:1b,241160260,244,145,241160016,241160260
7028,5,12,149,5745,-74,-96,22,72:d1:72:1d:22:a1,241160627,256,111,241160371,241160627
7029,5,12,149,5745,-73,-96,23,56:68:e2:c2:8d:d5,241160987,280,80,241160707,241160987
7030,5,12,149,5745,-73,-96,23,22:ec:75:a8:8a:31,241167279,244,6048,241167035,241167279
7031,5,12,149,5745,-61,-96,35,b6:90:18:f6:b1:d4,241205471,244,37948,241205227,241205471
7032,5,12,149,5745,-74,-96,22,72:d1:72:1d:22:a1,241205958,256,231,241205702,241205958
7033,5,12,149,5745,-73,-96,23,56:68:e2:c2:8d:d5,241208228,280,1990,241207948,241208228
7034,5,12,149,5745,-79,-96,17,3e:ef:29:c7:4b:17,241211739,244,3267,241211495,241211739
7035,5,12,149,5745,-58,-96,38,3e:d1:9b:c7:a4:de,241223355,272,11344,241223083,241223355
7036,5,12,149,5745,-78,-96,18,3e:ef:29:c7:4b:17,241229993,244,6394,241229749,241229993
7037,5,12,149,5745,-47,-96,49,72:fd:09:2f:da:5f,241233356,284,3079,241233072,241233356
7038,5,6,149,5745,-83,-96,13,54:e4:3a:ec:fb:65,241238195,360,4479,241237835,241238195
7039,5,12,149,5745,-73,-96,23,fa:44:8d:e1:c7:1b,241240510,244,2071,241240266,241240510
7040,5,12,149,5745,-55,-96,41,f2:da:61:dd:98:c5,241241067,268,289,241240799,241241067
7041,5,12,149,5745,-46,-96,50,72:fd:09:2f:da:5f,241253819,284,12468,241253535,241253819
7042,5,12,149,5745,-56,-96,40,5e:29:73:5b:30:00,241254723,272,632,241254451,241254723
7043,5,12,149,5745,-65,-96,31,f6:0a:5c:59:72:df,241259849,448,4678,241259401,241259849
7044,5,12,149,5745,-56,-96,40,f2:da:61:dd:98:c5,241263652,268,3535,241263384,241263652
7045,5,12,149,5745,-56,-96,40,5e:29:73:5b:30:00,241270497,540,6305,241269957,241270497
7046,5,12,149,5745,-61,-96,35,b6:90:18:f6:b1:d4,241271085,440,148,241270645,241271085
7047,5,24,149,5745,-75,-96,21,,241274836,28,3723,241274808,241274836
7048,5,12,149,5745,-76,-96,20,72:d1:72:1d:22:a1,241275077,452,-211,241274625,241275077
7049,5,12,149,5745,-48,-96,48,72:fd:09:2f:da:5f,241275572,480,15,241275092,241275572
7050,5,12,149,5745,-73,-96,23,22:ec:75:a8:8a:31,241276096,516,8,241275580,241276096
7051,5,12,149,5745,-74,-96,22,56:68:e2:c2:8d:d5,241276682,476,110,241276206,241276682
7052,5,12,149,5745,-73,-96,23,fa:44:8d:e1:c7:1b,241277473,440,351,241277033,241277473
7053,5,12,149,5745,-55,-96,41,3e:d1:9b:c7:a4:de,241277956,544,-61,241277412,241277956
7054,5,12,149,5745,-77,-96,19,3e:ef:29:c7:4b:17,241280105,440,1709,241279665,241280105
7055,5,12,149,5745,-73,-96,23,22:ec:75:a8:8a:31,241286303,244,5954,241286059,241286303
7056,5,12,149,5745,-61,-96,35,b6:90:18:f6:b1:d4,241303908,244,17361,241303664,241303908
7057,5,12,149,5745,-75,-96,21,72:d1:72:1d:22:a1,241305376,256,1212,241305120,241305376
7058,5,12,149,5745,-76,-96,20,56:68:e2:c2:8d:d5,241319044,280,13388,241318764,241319044
7059,5,12,149,5745,-67,-96,29,f6:0a:5c:59:72:df,241323520,448,4028,241323072,241323520
7060,5,12,149,5745,-56,-96,40,f2:da:61:dd:98:c5,241328064,268,4276,241327796,241328064
7061,5,12,149,5745,-81,-96,15,9a:24:38:da:96:bb,241328488,824,-400,241327664,241328488
7062,5,12,149,5745,-61,-96,35,b6:90:18:f6:b1:d4,241333433,440,4505,241332993,241333433
7063,5,12,149,5745,-72,-96,24,a6:92:ad:b7:76:65,241333925,456,36,241333469,241333925
7064,5,12,149,5745,-55,-96,41,5e:29:73:5b:30:00,241335549,540,1084,241335009,241335549
7065,5,12,149,5745,-65,-96,31,0a:b9:b7:b1:4d:fa,241336267,268,450,241335999,241336267
7066,5,12,149,5745,-71,-96,25,fa:44:8d:e1:c7:1b,241336659,244,148,241336415,241336659
7067,5,12,149,5745,-73,-96,23,72:d1:72:1d:22:a1,241337639,452,528,241337187,241337639
7068,5,12,149,5745,-76,-96,20,56:68:e2:c2:8d:d5,241339287,476,1172,241338811,241339287
7069,5,12,149,5745,-49,-96,47,72:fd:09:2f:da:5f,241340499,480,732,241340019,241340499
7070,5,12,149,5745,-74,-96,22,22:ec:75:a8:8a:31,241341523,516,508,241341007,241341523
7071,5,12,149,5745,-56,-96,40,3e:d1:9b:c7:a4:de,241342317,544,250,241341773,241342317
7072,5,12,149,5745,-78,-96,18,3e:ef:29:c7:4b:17,241346047,440,3290,241345607,241346047
7073,5,12,149,5745,-56,-96,40,3e:d1:9b:c7:a4:de,241352056,272,5737,241351784,241352056
7074,5,12,149,5745,-56,-96,40,f2:da:61:dd:98:c5,241353903,268,1579,241353635,241353903
7075,5,12,149,5745,-49,-96,47,72:fd:09:2f:da:5f,241369476,284,15289,241369192,241369476
7076,5,12,149,5745,-55,-96,41,5e:29:73:5b:30:00,241370072,272,324,241369800,241370072
7077,5,12,149,5745,-66,-96,30,f6:0a:5c:59:72:df,241394722,252,24398,241394470,241394722
7078,5,12,149,5745,-73,-96,23,22:ec:75:a8:8a:31,241396444,244,1478,241396200,241396444
7079,5,12,149,5745,-56,-96,40,3e:d1:9b:c7:a4:de,241408269,544,11281,241407725,241408269
7080,5,12,149,5745,-62,-96,34,b6:90:18:f6:b1:d4,241429871,244,21358,241429627,241429871
7081,5,12,149,5745,-77,-96,19,72:d1:72:1d:22:a1,241431057,256,930,241430801,241431057
7082,5,12,149,5745,-83,-96,13,9a:24:38:da:96:bb,241431418,272,89,241431146,241431418
7083,5,12,149,5745,-74,-96,22,56:68:e2:c2:8d:d5,241433358,280,1660,241433078,241433358
7084,5,6,149,5745,-87,-96,9,54:e4:3a:ec:fb:65,241442997,360,9279,241442637,241442997
7085,5,12,149,5745,-72,-96,24,fa:44:8d:e1:c7:1b,241464289,244,21048,241464045,241464289
7086,5,12,149,5745,-54,-96,42,5e:29:73:5b:30:00,241466044,272,1483,241465772,241466044
7087,5,12,149,5745,-55,-96,41,3e:d1:9b:c7:a4:de,241467017,272,701,241466745,241467017
7088,5,12,149,5745,-55,-96,41,3e:d1:9b:c7:a4:de,241473362,544,5801,241472818,241473362
7089,5,12,149,5745,-73,-96,23,22:ec:75:a8:8a:31,241513437,244,39831,241513193,241513437
7090,5,12,149,5745,-81,-96,15,3e:ef:29:c7:4b:17,241520060,244,6379,241519816,241520060
7091,5,12,149,5745,-56,-96,40,3e:d1:9b:c7:a4:de,241539362,544,18758,241538818,241539362
7092,5,12,149,5745,-47,-96,49,72:fd:09:2f:da:5f,241542741,284,3095,241542457,241542741
7093,5,6,149,5745,-83,-96,13,54:e4:3a:ec:fb:65,241545397,360,2296,241545037,241545397
7094,5,12,149,5745,-57,-96,39,f2:da:61:dd:98:c5,241547214,268,1549,241546946,241547214
7095,5,12,149,5745,-56,-96,40,3e:d1:9b:c7:a4:de,241565876,272,18390,241565604,241565876
7096,5,12,149,5745,-76,-96,20,72:d1:72:1d:22:a1,241570040,256,3908,241569784,241570040
7097,5,12,149,5745,-64,-96,32,b6:90:18:f6:b1:d4,241570546,244,262,241570302,241570546
7098,5,12,149,5745,-72,-96,24,56:68:e2:c2:8d:d5,241571229,280,403,241570949,241571229
7099,5,12,149,5745,-73,-96,23,fa:44:8d:e1:c7:1b,241578402,244,6929,241578158,241578402
7100,5,12,149,5745,-54,-96,42,5e:29:73:5b:30:00,241583077,272,4403,241582805,241583077
7101,5,12,149,5745,-77,-96,19,3e:ef:29:c7:4b:17,241623635,244,40314,241623391,241623635
7102,5,12,149,5745,-71,-96,25,22:ec:75:a8:8a:31,241629857,244,5978,241629613,241629857
7103,5,12,149,5745,-51,-96,45,72:fd:09:2f:da:5f,241644973,284,14832,241644689,241644973
7104,5,6,149,5745,-83,-96,13,54:e4:3a:ec:fb:65,241647797,360,2464,241647437,241647797
7105,5,12,149,5745,-56,-96,40,f2:da:61:dd:98:c5,241649546,268,1481,241649278,241649546
7106,5,12,149,5745,-84,-96,12,9a:24:38:da:96:bb,241655699,272,5881,241655427,241655699
7107,5,12,149,5745,-65,-96,31,b6:90:18:f6:b1:d4,241672202,244,16259,241671958,241672202
7108,5,12,149,5745,-73,-96,23,56:68:e2:c2:8d:d5,241672804,280,322,241672524,241672804
7109,5,12,149,5745,-72,-96,24,72:d1:72:1d:22:a1,241673140,256,80,241672884,241673140
7110,5,12,149,5745,-71,-96,25,fa:44:8d:e1:c7:1b,241688342,244,14958,241688098,241688342
7111,5,12,149,5745,-74,-96,22,fa:44:8d:e1:c7:1b,241697469,48,9079,241697421,241697469
7112,5,12,149,5745,-65,-96,31,,241697533,32,32,241697501,241697533
7113,5,12,149,5745,-58,-96,38,f2:da:61:dd:98:c5,241699568,268,1767,241699300,241699568
7114,5,12,149,5745,-78,-96,18,3e:ef:29:c7:4b:17,241701532,244,1720,241701288,241701532
7115,5,12,149,5745,-49,-96,47,72:fd:09:2f:da:5f,241712664,284,10848,241712380,241712664
7116,5,12,149,5745,-56,-96,40,5e:29:73:5b:30:00,241713433,272,497,241713161,241713433
7117,5,12,149,5745,-69,-96,27,f6:0a:5c:59:72:df,241717364,448,3483,241716916,241717364
7118,5,12,149,5745,-56,-96,40,3e:d1:9b:c7:a4:de,241719818,544,1910,241719274,241719818
7119,5,12,149,5745,-81,-96,15,9a:24:38:da:96:bb,241720956,824,314,241720132,241720956
7120,5,12,149,5745,-59,-96,37,f2:da:61:dd:98:c5,241721868,268,644,241721600,241721868
7121,5,12,149,5745,-69,-96,27,f6:0a:5c:59:72:df,241722619,252,499,241722367,241722619
7122,5,12,149,5745,-66,-96,30,b6:90:18:f6:b1:d4,241726542,440,3483,241726102,241726542
7123,5,12,149,5745,-73,-96,23,72:d1:72:1d:22:a1,241730496,452,3502,241730044,241730496
7124,5,12,149,5745,-57,-96,39,5e:29:73:5b:30:00,241730982,540,-54,241730442,241730982
7125,5,12,149,5745,-73,-96,23,fa:44:8d:e1:c7:1b,241734022,440,2600,241733582,241734022
7126,5,12,149,5745,-72,-96,24,56:68:e2:c2:8d:d5,241735162,476,664,241734686,241735162
7127,5,12,149,5745,-47,-96,49,72:fd:09:2f:da:5f,241736347,480,705,241735867,241736347
7128,5,12,149,5745,-73,-96,23,22:ec:75:a8:8a:31,241736997,516,134,241736481,241736997
7129,5,6,149,5745,-85,-96,11,54:e4:3a:ec:fb:65,241750198,360,12841,241749838,241750198
7130,5,12,149,5745,-76,-96,20,3e:ef:29:c7:4b:17,241754891,440,4253,241754451,241754891
7131,5,12,149,5745,-73,-96,23,56:68:e2:c2:8d:d5,241761638,280,6467,241761358,241761638
7132,5,12,149,5745,-73,-96,23,22:ec:75:a8:8a:31,241762243,244,361,241761999,241762243
7133,5,12,149,5745,-66,-96,30,b6:90:18:f6:b1:d4,241762577,244,90,241762333,241762577
7134,5,12,149,5745,-72,-96,24,72:d1:72:1d:22:a1,241763882,256,1049,241763626,241763882
7135,5,12,149,5745,-80,-96,16,9a:24:38:da:96:bb,241767520,272,3366,241767248,241767520
7136,5,12,149,5745,-71,-96,25,f6:0a:5c:59:72:df,241782397,448,14429,241781949,241782397
7137,5,12,149,5745,-58,-96,38,3e:d1:9b:c7:a4:de,241790469,272,7800,241790197,241790469
7138,5,12,149,5745,-60,-96,36,f2:da:61:dd:98:c5,241791911,268,1174,241791643,241791911
7139,5,12,149,5745,-65,-96,31,b6:90:18:f6:b1:d4,241792222,440,-129,241791782,241792222
7140,5,12,149,5745,-72,-96,24,fa:44:8d:e1:c7:1b,241795336,244,2870,241795092,241795336
7141,5,12,149,5745,-60,-96,36,f2:da:61:dd:98:c5,241796713,268,1109,241796445,241796713
7142,5,12,149,5745,-72,-96,24,fa:44:8d:e1:c7:1b,241801079,440,3926,241800639,241801079
7143,5,12,149,5745,-76,-96,20,3e:ef:29:c7:4b:17,241804453,440,2934,241804013,241804453
7144,5,12,149,5745,-58,-96,38,5e:29:73:5b:30:00,241811973,272,7248,241811701,241811973
7145,5,12,149,5745,-77,-96,19,3e:ef:29:c7:4b:17,241812774,244,557,241812530,241812774
7146,5,24,149,5745,-79,-96,17,,241827763,28,14961,241827735,241827763
7147,5,24,149,5745,-78,-96,18,,241828088,28,297,241828060,241828088
7148,5,12,149,5745,-72,-96,24,f6:0a:5c:59:72:df,241834390,252,6050,241834138,241834390
7149,5,12,149,5745,-47,-96,49,72:fd:09:2f:da:5f,241836647,284,1973,241836363,241836647
7150,5,12,149,5745,-79,-96,17,9a:24:38:da:96:bb,241846502,824,9031,241845678,241846502
7151,5,12,149,5745,-73,-96,23,f6:0a:5c:59:72:df,241849023,448,2073,241848575,241849023
7152,5,12,149,5745,-58,-96,38,3e:d1:9b:c7:a4:de,241851310,544,1743,241850766,241851310
7153,5,6,149,5745,-84,-96,12,54:e4:3a:ec:fb:65,241852599,360,929,241852239,241852599
7154,5,12,149,5745,-66,-96,30,b6:90:18:f6:b1:d4,241857595,440,4556,241857155,241857595
7155,5,12,149,5745,-76,-96,20,a6:92:ad:b7:76:65,241858096,456,45,241857640,241858096
7156,5,12,149,5745,-59,-96,37,f2:da:61:dd:98:c5,241858586,268,222,241858318,241858586
7157,5,12,149,5745,-64,-96,32,0a:b9:b7:b1:4d:fa,241859644,268,790,241859376,241859644
7158,5,12,149,5745,-55,-96,41,5e:29:73:5b:30:00,241861675,540,1491,241861135,241861675
7159,5,12,149,5745,-73,-96,23,fa:44:8d:e1:c7:1b,241864886,440,2771,241864446,241864886
7160,5,12,149,5745,-72,-96,24,22:ec:75:a8:8a:31,241868528,516,3126,241868012,241868528
7161,5,12,149,5745,-78,-96,18,3e:ef:29:c7:4b:17,241869440,440,472,241869000,241869440
7162,5,12,149,5745,-72,-96,24,22:ec:75:a8:8a:31,241876106,244,6422,241875862,241876106
7163,5,12,149,5745,-66,-96,30,b6:90:18:f6:b1:d4,241877736,244,1386,241877492,241877736
7164,5,12,149,5745,-80,-96,16,9a:24:38:da:96:bb,241879494,272,1486,241879222,241879494
7165,5,12,149,5745,-74,-96,22,56:68:e2:c2:8d:d5,241881604,280,1830,241881324,241881604
7166,5,12,149,5745,-75,-96,21,72:d1:72:1d:22:a1,241882145,256,285,241881889,241882145
7167,5,12,149,5745,-57,-96,39,3e:d1:9b:c7:a4:de,241906084,272,23667,241905812,241906084
7168,5,24,149,5745,-75,-96,21,,241919445,28,13333,241919417,241919445
7169,5,24,149,5745,-75,-96,21,,241920098,28,625,241920070,241920098
7170,5,24,149,5745,-76,-96,20,,241920395,28,269,241920367,241920395
7171,5,12,149,5745,-73,-96,23,fa:44:8d:e1:c7:1b,241922947,244,2308,241922703,241922947
7172,5,12,149,5745,-57,-96,39,f2:da:61:dd:98:c5,241927785,268,4570,241927517,241927785
7173,5,12,149,5745,-54,-96,42,5e:29:73:5b:30:00,241929032,272,975,241928760,241929032
7174,5,12,149,5745,-78,-96,18,3e:ef:29:c7:4b:17,241934797,244,5521,241934553,241934797
7175,5,12,149,5745,-47,-96,49,72:fd:09:2f:da:5f,241947859,284,12778,241947575,241947859
7176,5,6,149,5745,-83,-96,13,54:e4:3a:ec:fb:65,241954999,360,6780,241954639,241954999
7177,5,12,149,5745,-71,-96,25,22:ec:75:a8:8a:31,241972017,244,16774,241971773,241972017
7178,5,24,149,5745,-73,-96,23,,241980066,28,8021,241980038,241980066
7179,5,24,149,5745,-90,-96,6,,241980110,28,16,241980082,241980110
7180,5,24,149,5745,-74,-96,22,,241980334,28,196,241980306,241980334
7181,5,24,149,5745,-90,-96,6,,241980486,28,124,241980458,241980486
7182,5,12,149,5745,-66,-96,30,b6:90:18:f6:b1:d4,241991429,244,10699,241991185,241991429
7183,5,12,149,5745,-82,-96,14,9a:24:38:da:96:bb,241992211,272,510,241991939,241992211
7184,5,12,149,5745,-79,-96,17,72:d1:72:1d:22:a1,241993069,256,602,241992813,241993069
7185,5,12,149,5745,-78,-96,18,d2:00:04:7e:2c:ab,241993611,244,298,241993367,241993611
7186,5,12,149,5745,-76,-96,20,56:68:e2:c2:8d:d5,241994066,280,175,241993786,241994066
7187,5,12,149,5745,-57,-96,39,3e:d1:9b:c7:a4:de,242021564,272,27226,242021292,242021564
7188,5,24,149,5745,-89,-96,7,,242032728,32,11132,242032696,242032728
7189,5,12,149,5745,-72,-96,24,fa:44:8d:e1:c7:1b,242037358,244,4386,242037114,242037358
7190,5,12,149,5745,-78,-96,18,3e:ef:29:c7:4b:17,242045168,244,7566,242044924,242045168
7191,5,12,149,5745,-55,-96,41,5e:29:73:5b:30:00,242045437,272,-3,242045165,242045437
7192,5,24,149,5745,-88,-96,8,,242051519,28,6054,242051491,242051519
7193,5,6,149,5745,-83,-96,13,54:e4:3a:ec:fb:65,242057400,360,5521,242057040,242057400
7194,5,24,149,5745,-88,-96,8,,242059785,28,2357,242059757,242059785
7195,5,12,149,5745,-57,-96,39,f2:da:61:dd:98:c5,242060204,268,151,242059936,242060204
7196,5,12,149,5745,-45,-96,51,72:fd:09:2f:da:5f,242060641,284,153,242060357,242060641
7197,5,12,149,5745,-76,-96,20,22:ec:75:a8:8a:31,242087852,244,26967,242087608,242087852
7198,5,12,149,5745,-80,-96,16,9a:24:38:da:96:bb,242132608,272,44484,242132336,242132608
7199,5,12,149,5745,-57,-96,39,3e:d1:9b:c7:a4:de,242134707,272,1827,242134435,242134707
7200,5,6,149,5745,-85,-96,11,54:e4:3a:ec:fb:65,242159800,360,24733,242159440,242159800
7201,5,12,149,5745,-59,-96,37,f2:da:61:dd:98:c5,242160594,268,526,242160326,242160594
7202,5,12,149,5745,-55,-96,41,5e:29:73:5b:30:00,242165897,272,5031,242165625,242165897
7203,5,12,149,5745,-46,-96,50,72:fd:09:2f:da:5f,242171361,284,5180,242171077,242171361
7204,5,24,149,5745,-89,-96,7,,242182766,28,11377,242182738,242182766
7205,5,12,149,5745,-66,-96,30,b6:90:18:f6:b1:d4,242184563,244,1553,242184319,242184563
7206,5,12,149,5745,-79,-96,17,72:d1:72:1d:22:a1,242184897,256,78,242184641,242184897
7207,5,12,149,5745,-71,-96,25,fa:44:8d:e1:c7:1b,242185297,244,156,242185053,242185297
7208,5,12,149,5745,-80,-96,16,d2:00:04:7e:2c:ab,242186003,244,462,242185759,242186003
7209,5,12,149,5745,-76,-96,20,56:68:e2:c2:8d:d5,242186524,280,241,242186244,242186524
7210,5,12,149,5745,-74,-96,22,f6:0a:5c:59:72:df,242192856,252,6080,242192604,242192856
7211,5,12,149,5745,-73,-96,23,22:ec:75:a8:8a:31,242204788,244,11688,242204544,242204788
7212,5,12,149,5745,-79,-96,17,9a:24:38:da:96:bb,242215382,272,10322,242215110,242215382
7213,5,12,149,5745,-79,-96,17,3e:ef:29:c7:4b:17,242237334,244,21708,242237090,242237334
7214,5,12,149,5745,-59,-96,37,3e:d1:9b:c7:a4:de,242246512,272,8906,242246240,242246512
7215,5,6,149,5745,-85,-96,11,54:e4:3a:ec:fb:65,242262201,360,15329,242261841,242262201
7216,5,12,149,5745,-60,-96,36,f2:da:61:dd:98:c5,242262748,268,279,242262480,242262748
7217,5,12,149,5745,-48,-96,48,72:fd:09:2f:da:5f,242273368,284,10336,242273084,242273368
7218,5,12,149,5745,-56,-96,40,5e:29:73:5b:30:00,242274943,272,1303,242274671,242274943
7219,5,12,149,5745,-79,-96,17,3e:ef:29:c7:4b:17,242276017,244,830,242275773,242276017
7220,5,12,149,5745,-70,-96,26,fa:44:8d:e1:c7:1b,242286463,244,10202,242286219,242286463
7221,5,12,149,5745,-66,-96,30,b6:90:18:f6:b1:d4,242288332,244,1625,242288088,242288332
7222,5,12,149,5745,-78,-96,18,56:68:e2:c2:8d:d5,242289193,280,581,242288913,242289193
7223,5,12,149,5745,-79,-96,17,72:d1:72:1d:22:a1,242289932,256,483,242289676,242289932
7224,5,12,149,5745,-81,-96,15,d2:00:04:7e:2c:ab,242291003,244,827,242290759,242291003
7225,5,12,149,5745,-75,-96,21,f6:0a:5c:59:72:df,242292946,252,1691,242292694,242292946
7226,5,12,149,5745,-60,-96,36,3e:d1:9b:c7:a4:de,242307571,544,14081,242307027,242307571
7227,5,12,149,5745,-74,-96,22,f6:0a:5c:59:72:df,242308194,448,175,242307746,242308194
7228,5,12,149,5745,-80,-96,16,d2:00:04:7e:2c:ab,242308723,440,89,242308283,242308723
7229,5,12,149,5745,-63,-96,33,f2:da:61:dd:98:c5,242316837,268,7846,242316569,242316837
7230,5,12,149,5745,-66,-96,30,b6:90:18:f6:b1:d4,242318084,440,807,242317644,242318084
7231,5,12,149,5745,-78,-96,18,56:68:e2:c2:8d:d5,242318576,280,212,242318296,242318576
7232,5,12,149,5745,-56,-96,40,5e:29:73:5b:30:00,242318982,540,-134,242318442,242318982
7233,5,12,149,5745,-66,-96,30,b6:90:18:f6:b1:d4,242319557,244,331,242319313,242319557
7234,5,12,149,5745,-80,-96,16,72:d1:72:1d:22:a1,242320602,256,789,242320346,242320602
7235,5,12,149,5745,-79,-96,17,72:d1:72:1d:22:a1,242322288,452,1234,242321836,242322288
7236,5,12,149,5745,-79,-96,17,d2:00:04:7e:2c:ab,242322774,244,242,242322530,242322774
7237,5,12,149,5745,-49,-96,47,72:fd:09:2f:da:5f,242323907,480,653,242323427,242323907
7238,5,12,149,5745,-74,-96,22,22:ec:75:a8:8a:31,242324457,516,34,242323941,242324457
7239,5,12,149,5745,-70,-96,26,fa:44:8d:e1:c7:1b,242325008,440,111,242324568,242325008
7240,5,12,149,5745,-79,-96,17,56:68:e2:c2:8d:d5,242325536,476,52,242325060,242325536
7241,5,12,149,5745,-83,-96,13,9a:24:38:da:96:bb,242326895,272,1087,242326623,242326895
7242,5,12,149,5745,-79,-96,17,3e:ef:29:c7:4b:17,242328829,440,1494,242328389,242328829
7243,5,12,149,5745,-74,-96,22,22:ec:75:a8:8a:31,242334842,244,5769,242334598,242334842
7244,5,6,149,5745,-86,-96,10,54:e4:3a:ec:fb:65,242364601,360,29399,242364241,242364601
7245,5,12,149,5745,-60,-96,36,3e:d1:9b:c7:a4:de,242367923,272,3050,242367651,242367923
7246,5,12,149,5745,-68,-96,28,fa:44:8d:e1:c7:1b,242368914,244,747,242368670,242368914
7247,5,12,149,5745,-65,-96,31,f2:da:61:dd:98:c5,242369660,268,478,242369392,242369660
7248,5,12,149,5745,-84,-96,12,9a:24:38:da:96:bb,242370084,824,-400,242369260,242370084
7249,5,12,149,5745,-74,-96,22,f6:0a:5c:59:72:df,242372612,448,2080,242372164,242372612
7250,5,12,149,5745,-59,-96,37,3e:d1:9b:c7:a4:de,242373122,544,-34,242372578,242373122
7251,5,12,149,5745,-77,-96,19,d2:00:04:7e:2c:ab,242380054,440,6492,242379614,242380054
7252,5,12,149,5745,-66,-96,30,b6:90:18:f6:b1:d4,242381718,440,1224,242381278,242381718
7253,5,12,149,5745,-72,-96,24,a6:92:ad:b7:76:65,242382210,456,36,242381754,242382210
7254,5,12,149,5745,-65,-96,31,f2:da:61:dd:98:c5,242382754,268,276,242382486,242382754
7255,5,12,149,5745,-56,-96,40,5e:29:73:5b:30:00,242383902,540,608,242383362,242383902
7256,5,12,149,5745,-51,-96,45,72:fd:09:2f:da:5f,242384494,284,308,242384210,242384494
7257,5,12,149,5745,-64,-96,32,0a:b9:b7:b1:4d:fa,242385298,268,536,242385030,242385298
7258,5,12,149,5745,-81,-96,15,72:d1:72:1d:22:a1,242386041,452,291,242385589,242386041
7259,5,12,149,5745,-80,-96,16,3e:ef:29:c7:4b:17,242386529,244,244,242386285,242386529
7260,5,12,149,5745,-76,-96,20,56:68:e2:c2:8d:d5,242387761,476,756,242387285,242387761
7261,5,12,149,5745,-51,-96,45,72:fd:09:2f:da:5f,242389077,480,836,242388597,242389077
7262,5,12,149,5745,-69,-96,27,fa:44:8d:e1:c7:1b,242389591,440,74,242389151,242389591
7263,5,12,149,5745,-73,-96,23,22:ec:75:a8:8a:31,242390084,516,-23,242389568,242390084
7264,5,12,149,5745,-76,-96,20,d2:00:04:7e:2c:ab,242390993,380,529,242390613,242390993
7265,5,12,149,5745,-80,-96,16,3e:ef:29:c7:4b:17,242393731,440,2298,242393291,242393731
7266,5,12,149,5745,-56,-96,40,5e:29:73:5b:30:00,242401486,272,7483,242401214,242401486
7267,5,12,149,5745,-73,-96,23,f6:0a:5c:59:72:df,242405248,252,3510,242404996,242405248
7268,5,12,149,5745,-71,-96,25,22:ec:75:a8:8a:31,242432052,244,26560,242431808,242432052
7269,5,12,149,5745,-76,-96,20,d2:00:04:7e:2c:ab,242433897,244,1601,242433653,242433897
7270,5,12,149,5745,-85,-96,11,9a:24:38:da:96:bb,242440712,272,6543,242440440,242440712
7271,5,12,149,5745,-75,-96,21,d2:00:04:7e:2c:ab,242442950,440,1798,242442510,242442950
7272,5,12,149,5745,-66,-96,30,b6:90:18:f6:b1:d4,242448573,244,5379,242448329,242448573
7273,5,12,149,5745,-81,-96,15,72:d1:72:1d:22:a1,242450683,256,1854,242450427,242450683
7274,5,12,149,5745,-76,-96,20,56:68:e2:c2:8d:d5,242452251,280,1288,242451971,242452251
7275,5,6,149,5745,-86,-96,10,54:e4:3a:ec:fb:65,242467002,360,14391,242466642,242467002
7276,5,12,149,5745,-59,-96,37,3e:d1:9b:c7:a4:de,242475290,272,8016,242475018,242475290
7277,5,12,149,5745,-72,-96,24,fa:44:8d:e1:c7:1b,242490375,244,14841,242490131,242490375
7278,5,12,149,5745,-57,-96,39,5e:29:73:5b:30:00,242504500,272,13853,242504228,242504500
7279,5,12,149,5745,-82,-96,14,3e:ef:29:c7:4b:17,242544356,244,39612,242544112,242544356
7280,5,12,149,5745,-72,-96,24,22:ec:75:a8:8a:31,242548584,244,3984,242548340,242548584
7281,5,12,149,5745,-78,-96,18,9a:24:38:da:96:bb,242556262,272,7406,242555990,242556262
7282,5,12,149,5745,-75,-96,21,d2:00:04:7e:2c:ab,242557380,244,874,242557136,242557380
7283,5,12,149,5745,-49,-96,47,72:fd:09:2f:da:5f,242566529,284,8865,242566245,242566529
7284,5,6,149,5745,-85,-96,11,54:e4:3a:ec:fb:65,242569402,360,2513,242569042,242569402
7285,5,12,149,5745,-66,-96,30,f2:da:61:dd:98:c5,242572082,268,2412,242571814,242572082
7286,5,12,149,5745,-58,-96,38,3e:d1:9b:c7:a4:de,242591993,272,19639,242591721,242591993
7287,5,12,149,5745,-68,-96,28,b6:90:18:f6:b1:d4,242594181,244,1944,242593937,242594181
7288,5,12,149,5745,-79,-96,17,72:d1:72:1d:22:a1,242594685,256,248,242594429,242594685
7289,5,12,149,5745,-73,-96,23,56:68:e2:c2:8d:d5,242596156,280,1191,242595876,242596156
7290,5,12,149,5745,-72,-96,24,fa:44:8d:e1:c7:1b,242603138,244,6738,242602894,242603138
7291,5,12,149,5745,-55,-96,41,5e:29:73:5b:30:00,242616943,272,13533,242616671,242616943
7292,5,12,149,5745,-70,-96,26,f6:0a:5c:59:72:df,242646778,252,29583,242646526,242646778
7293,5,12,149,5745,-81,-96,15,3e:ef:29:c7:4b:17,242647786,244,764,242647542,242647786
7294,5,12,149,5745,-77,-96,19,9a:24:38:da:96:bb,242664789,272,16731,242664517,242664789
7295,5,12,149,5745,-74,-96,22,22:ec:75:a8:8a:31,242666341,244,1308,242666097,242666341
7296,5,12,149,5745,-49,-96,47,72:fd:09:2f:da:5f,242668122,284,1497,242667838,242668122
7297,5,6,149,5745,-86,-96,10,54:e4:3a:ec:fb:65,242671803,360,3321,242671443,242671803
7298,5,12,149,5745,-62,-96,34,f2:da:61:dd:98:c5,242672305,268,234,242672037,242672305
7299,5,24,149,5745,-90,-96,6,,242673357,28,1024,242673329,242673357
7300,5,24,149,5745,-88,-96,8,,242694992,28,21607,242694964,242694992
7301,5,24,149,5745,-88,-96,8,,242695101,32,77,242695069,242695101
7302,5,12,149,5745,-67,-96,29,b6:90:18:f6:b1:d4,242695890,244,545,242695646,242695890
7303,5,12,149,5745,-80,-96,16,d2:00:04:7e:2c:ab,242696275,244,141,242696031,242696275
7304,5,12,149,5745,-71,-96,25,56:68:e2:c2:8d:d5,242697218,280,663,242696938,242697218
7305,5,24,149,5745,-88,-96,8,,242705964,28,8718,242705936,242705964
7306,5,24,149,5745,-88,-96,8,,242708175,28,2183,242708147,242708175
7307,5,12,149,5745,-58,-96,38,3e:d1:9b:c7:a4:de,242709233,272,786,242708961,242709233
7308,5,12,149,5745,-74,-96,22,fa:44:8d:e1:c7:1b,242712390,244,2913,242712146,242712390
7309,5,12,149,5745,-61,-96,35,f2:da:61:dd:98:c5,242718754,268,6096,242718486,242718754
7310,5,12,149,5745,-54,-96,42,5e:29:73:5b:30:00,242733876,272,14850,242733604,242733876
7311,5,12,149,5745,-80,-96,16,3e:ef:29:c7:4b:17,242734371,244,251,242734127,242734371
7312,5,12,149,5745,-49,-96,47,72:fd:09:2f:da:5f,242736018,284,1363,242735734,242736018
7313,5,12,149,5745,-70,-96,26,f6:0a:5c:59:72:df,242746088,252,9818,242745836,242746088
7314,5,12,149,5745,-75,-96,21,fa:44:8d:e1:c7:1b,242748381,48,2245,242748333,242748381
7315,5,12,149,5745,-75,-96,21,fa:44:8d:e1:c7:1b,242748516,48,87,242748468,242748516
7316,5,12,149,5745,-67,-96,29,,242748580,32,32,242748548,242748580
7317,5,12,149,5745,-80,-96,16,9a:24:38:da:96:bb,242764645,824,15241,242763821,242764645
7318,5,12,149,5745,-70,-96,26,f6:0a:5c:59:72:df,242766466,448,1373,242766018,242766466
7319,5,12,149,5745,-57,-96,39,3e:d1:9b:c7:a4:de,242768370,544,1360,242767826,242768370
7320,5,12,149,5745,-81,-96,15,d2:00:04:7e:2c:ab,242771784,440,2974,242771344,242771784
7321,5,12,149,5745,-48,-96,48,72:fd:09:2f:da:5f,242773543,132,1627,242773411,242773543
7322,5,12,149,5745,-49,-96,47,72:fd:09:2f:da:5f,242774106,284,279,242773822,242774106
7323,5,6,149,5745,-87,-96,9,54:e4:3a:ec:fb:65,242774422,360,-44,242774062,242774422
7324,5,12,149,5745,-61,-96,35,f2:da:61:dd:98:c5,242775565,268,875,242775297,242775565
7325,5,12,149,5745,-81,-96,15,9a:24:38:da:96:bb,242776016,272,179,242775744,242776016
7326,5,12,149,5745,-67,-96,29,b6:90:18:f6:b1:d4,242776830,440,374,242776390,242776830
7327,5,12,149,5745,-72,-96,24,56:68:e2:c2:8d:d5,242777304,280,194,242777024,242777304
7328,5,12,149,5745,-68,-96,28,b6:90:18:f6:b1:d4,242778322,244,774,242778078,242778322
7329,5,12,149,5745,-81,-96,15,d2:00:04:7e:2c:ab,242778629,244,63,242778385,242778629
7330,5,12,149,5745,-78,-96,18,72:d1:72:1d:22:a1,242778916,256,31,242778660,242778916
7331,5,12,149,5745,-54,-96,42,5e:29:73:5b:30:00,242780104,540,648,242779564,242780104
7332,5,12,149,5745,-81,-96,15,d2:00:04:7e:2c:ab,242780759,104,551,242780655,242780759
7333,5,12,149,5745,-78,-96,18,72:d1:72:1d:22:a1,242781113,452,-98,242780661,242781113
7334,5,24,149,5745,-87,-96,9,,242782621,32,1476,242782589,242782621
7335,5,12,149,5745,-72,-96,24,56:68:e2:c2:8d:d5,242783453,476,356,242782977,242783453
7336,5,12,149,5745,-73,-96,23,fa:44:8d:e1:c7:1b,242784568,440,675,242784128,242784568
7337,5,12,149,5745,-74,-96,22,22:ec:75:a8:8a:31,242785563,516,479,242785047,242785563
7338,5,12,149,5745,-79,-96,17,3e:ef:29:c7:4b:17,242787205,440,1202,242786765,242787205
7339,5,12,149,5745,-74,-96,22,22:ec:75:a8:8a:31,242793602,244,6153,242793358,242793602
7340,5,24,149,5745,-88,-96,8,,242795634,28,2004,242795606,242795634
7341,5,24,149,5745,-87,-96,9,,242801085,28,5423,242801057,242801085
7342,5,12,149,5745,-57,-96,39,3e:d1:9b:c7:a4:de,242823335,272,21978,242823063,242823335
7343,5,12,149,5745,-73,-96,23,fa:44:8d:e1:c7:1b,242827467,244,3888,242827223,242827467
7344,5,12,149,5745,-61,-96,35,f2:da:61:dd:98:c5,242828852,268,1117,242828584,242828852
7345,5,12,149,5745,-71,-96,25,f6:0a:5c:59:72:df,242831477,448,2177,242831029,242831477
7346,5,12,149,5745,-80,-96,16,d2:00:04:7e:2c:ab,242836181,440,4264,242835741,242836181
7347,5,12,149,5745,-68,-96,28,b6:90:18:f6:b1:d4,242840592,440,3971,242840152,242840592
7348,5,12,149,5745,-61,-96,35,f2:da:61:dd:98:c5,242841084,268,224,242840816,242841084
7349,5,24,149,5745,-87,-96,9,,242844409,32,3293,242844377,242844409
7350,5,12,149,5745,-79,-96,17,3e:ef:29:c7:4b:17,242844890,244,237,242844646,242844890
7351,5,12,149,5745,-47,-96,49,72:fd:09:2f:da:5f,242847409,284,2235,242847125,242847409
7352,5,12,149,5745,-72,-96,24,fa:44:8d:e1:c7:1b,242847871,440,22,242847431,242847871
7353,5,12,149,5745,-53,-96,43,5e:29:73:5b:30:00,242850868,272,2725,242850596,242850868
7354,5,12,149,5745,-80,-96,16,3e:ef:29:c7:4b:17,242852377,440,1069,242851937,242852377
7355,5,12,149,5745,-71,-96,25,f6:0a:5c:59:72:df,242858539,252,5910,242858287,242858539
7356,5,6,149,5745,-86,-96,10,54:e4:3a:ec:fb:65,242876603,360,17704,242876243,242876603
7357,5,12,149,5745,-83,-96,13,9a:24:38:da:96:bb,242888184,272,11309,242887912,242888184
7358,5,12,149,5745,-79,-96,17,d2:00:04:7e:2c:ab,242892555,244,4127,242892311,242892555
7359,5,12,149,5745,-69,-96,27,b6:90:18:f6:b1:d4,242892853,244,54,242892609,242892853
7360,5,12,149,5745,-71,-96,25,f6:0a:5c:59:72:df,242896497,448,3196,242896049,242896497
7361,5,12,149,5745,-84,-96,12,9a:24:38:da:96:bb,242897574,824,253,242896750,242897574
7362,5,12,149,5745,-71,-96,25,56:68:e2:c2:8d:d5,242899589,280,1735,242899309,242899589
7363,5,12,149,5745,-58,-96,38,3e:d1:9b:c7:a4:de,242899958,544,-175,242899414,242899958
7364,5,12,149,5745,-77,-96,19,72:d1:72:1d:22:a1,242900972,256,758,242900716,242900972
7365,5,12,149,5745,-78,-96,18,d2:00:04:7e:2c:ab,242901478,440,66,242901038,242901478
7366,5,12,149,5745,-74,-96,22,22:ec:75:a8:8a:31,242901961,516,-33,242901445,242901961
7367,5,12,149,5745,-74,-96,22,a6:92:ad:b7:76:65,242906307,456,3890,242905851,242906307
7368,5,12,149,5745,-69,-96,27,b6:90:18:f6:b1:d4,242906799,440,52,242906359,242906799
7369,5,12,149,5745,-60,-96,36,f2:da:61:dd:98:c5,242907272,268,205,242907004,242907272
7370,5,12,149,5745,-74,-96,22,22:ec:75:a8:8a:31,242908312,244,796,242908068,242908312
7371,5,12,149,5745,-63,-96,33,0a:b9:b7:b1:4d:fa,242910139,268,1559,242909871,242910139
7372,5,12,149,5745,-53,-96,43,5e:29:73:5b:30:00,242911269,540,590,242910729,242911269
7373,5,12,149,5745,-72,-96,24,fa:44:8d:e1:c7:1b,242912968,440,1259,242912528,242912968
7374,5,24,149,5745,-76,-96,20,,242915939,28,2943,242915911,242915939
7375,5,12,149,5745,-80,-96,16,3e:ef:29:c7:4b:17,242917872,440,1493,242917432,242917872
7376,5,24,149,5745,-88,-96,8,,242920752,32,2848,242920720,242920752
7377,5,24,149,5745,-89,-96,7,,242934066,28,13286,242934038,242934066
7378,5,12,149,5745,-58,-96,38,3e:d1:9b:c7:a4:de,242942228,272,7890,242941956,242942228
7379,5,12,149,5745,-72,-96,24,fa:44:8d:e1:c7:1b,242942721,244,249,242942477,242942721
7380,5,12,149,5745,-61,-96,35,f2:da:61:dd:98:c5,242943846,268,857,242943578,242943846
7381,5,12,149,5745,-77,-96,19,d2:00:04:7e:2c:ab,242967287,440,23001,242966847,242967287
7382,5,12,149,5745,-53,-96,43,5e:29:73:5b:30:00,242967788,272,229,242967516,242967788
7383,5,12,149,5745,-80,-96,16,3e:ef:29:c7:4b:17,242970465,244,2433,242970221,242970465
7384,5,12,149,5745,-46,-96,50,72:fd:09:2f:da:5f,242976280,284,5531,242975996,242976280
7385,5,24,149,5745,-77,-96,19,,242976625,28,317,242976597,242976625
7386,5,6,149,5745,-87,-96,9,54:e4:3a:ec:fb:65,242979004,360,2019,242978644,242979004
7387,5,24,149,5745,-89,-96,7,,242983698,32,4662,242983666,242983698
7388,5,12,149,5745,-84,-96,12,9a:24:38:da:96:bb,243001567,272,17597,243001295,243001567
7389,5,12,149,5745,-74,-96,22,22:ec:75:a8:8a:31,243007877,244,6066,243007633,243007877
7390,5,12,149,5745,-77,-96,19,d2:00:04:7e:2c:ab,243008204,244,83,243007960,243008204
7391,5,12,149,5745,-71,-96,25,56:68:e2:c2:8d:d5,243014023,280,5539,243013743,243014023
7392,5,12,149,5745,-76,-96,20,72:d1:72:1d:22:a1,243014838,256,559,243014582,243014838
7393,5,12,149,5745,-70,-96,26,b6:90:18:f6:b1:d4,243019772,244,4690,243019528,243019772
7394,5,12,149,5745,-59,-96,37,3e:d1:9b:c7:a4:de,243052714,272,32670,243052442,243052714
7395,5,12,149,5745,-79,-96,17,3e:ef:29:c7:4b:17,243073465,244,20507,243073221,243073465
7396,5,12,149,5745,-46,-96,50,72:fd:09:2f:da:5f,243079171,284,5422,243078887,243079171
7397,5,6,149,5745,-86,-96,10,54:e4:3a:ec:fb:65,243081405,360,1874,243081045,243081405
7398,5,12,149,5745,-61,-96,35,f2:da:61:dd:98:c5,243083330,268,1657,243083062,243083330
7399,5,12,149,5745,-56,-96,40,5e:29:73:5b:30:00,243085003,272,1401,243084731,243085003
7400,5,12,149,5745,-73,-96,23,f6:0a:5c:59:72:df,243101623,252,16368,243101371,243101623
7401,5,12,149,5745,-75,-96,21,fa:44:8d:e1:c7:1b,243106100,244,4233,243105856,243106100
7402,5,12,149,5745,-77,-96,19,d2:00:04:7e:2c:ab,243117854,244,11510,243117610,243117854
7403,5,12,149,5745,-75,-96,21,72:d1:72:1d:22:a1,243121772,256,3662,243121516,243121772
7404,5,12,149,5745,-69,-96,27,b6:90:18:f6:b1:d4,243122231,244,215,243121987,243122231
7405,5,12,149,5745,-71,-96,25,56:68:e2:c2:8d:d5,243124166,280,1655,243123886,243124166
7406,5,12,149,5745,-75,-96,21,22:ec:75:a8:8a:31,243124938,244,528,243124694,243124938
7407,5,12,149,5745,-59,-96,37,3e:d1:9b:c7:a4:de,243166451,272,41241,243166179,243166451
7408,5,12,149,5745,-47,-96,49,72:fd:09:2f:da:5f,243181083,284,14348,243180799,243181083
7409,5,6,149,5745,-86,-96,10,54:e4:3a:ec:fb:65,243183805,360,2362,243183445,243183805
7410,5,12,149,5745,-61,-96,35,f2:da:61:dd:98:c5,243186450,268,2377,243186182,243186450
7411,5,12,149,5745,-59,-96,37,5e:29:73:5b:30:00,243198781,272,12059,243198509,243198781
7412,5,12,149,5745,-73,-96,23,fa:44:8d:e1:c7:1b,243208920,244,9895,243208676,243208920
7413,5,12,149,5745,-73,-96,23,f6:0a:5c:59:72:df,243223034,252,13862,243222782,243223034
7414,5,12,149,5745,-80,-96,16,9a:24:38:da:96:bb,243229335,272,6029,243229063,243229335
7415,5,12,149,5745,-75,-96,21,22:ec:75:a8:8a:31,243240586,244,11007,243240342,243240586
7416,5,12,149,5745,-77,-96,19,3e:ef:29:c7:4b:17,243262360,244,21530,243262116,243262360
7417,5,12,149,5745,-59,-96,37,3e:d1:9b:c7:a4:de,243278585,272,15953,243278313,243278585
7418,5,6,149,5745,-86,-96,10,54:e4:3a:ec:fb:65,243286206,360,7261,243285846,243286206
7419,5,12,149,5745,-60,-96,36,f2:da:61:dd:98:c5,243287613,268,1139,243287345,243287613
7420,5,12,149,5745,-47,-96,49,72:fd:09:2f:da:5f,243297332,284,9435,243297048,243297332
7421,5,12,149,5745,-78,-96,18,3e:ef:29:c7:4b:17,243307385,244,9809,243307141,243307385
7422,5,12,149,5745,-79,-96,17,d2:00:04:7e:2c:ab,243310272,244,2643,243310028,243310272
7423,5,12,149,5745,-58,-96,38,5e:29:73:5b:30:00,243310939,272,395,243310667,243310939
7424,5,12,149,5745,-76,-96,20,72:d1:72:1d:22:a1,243311256,256,61,243311000,243311256
7425,5,12,149,5745,-69,-96,27,b6:90:18:f6:b1:d4,243311618,244,118,243311374,243311618
7426,5,12,149,5745,-76,-96,20,fa:44:8d:e1:c7:1b,243311915,244,53,243311671,243311915
7427,5,12,149,5745,-72,-96,24,56:68:e2:c2:8d:d5,243312254,280,59,243311974,243312254
7428,5,12,149,5745,-78,-96,18,d2:00:04:7e:2c:ab,243324181,244,11683,243323937,243324181
7429,5,12,149,5745,-72,-96,24,56:68:e2:c2:8d:d5,243325971,280,1510,243325691,243325971
7430,5,12,149,5745,-69,-96,27,b6:90:18:f6:b1:d4,243327556,244,1341,243327312,243327556
7431,5,12,149,5745,-81,-96,15,9a:24:38:da:96:bb,243336738,272,8910,243336466,243336738
7432,5,12,149,5745,-75,-96,21,72:d1:72:1d:22:a1,243352103,256,15109,243351847,243352103
7433,5,12,149,5745,-60,-96,36,3e:d1:9b:c7:a4:de,243356684,544,4037,243356140,243356684
7434,5,12,149,5745,-76,-96,20,22:ec:75:a8:8a:31,243359439,516,2239,243358923,243359439
7435,5,12,149,5745,-75,-96,21,fa:44:8d:e1:c7:1b,243364049,440,4170,243363609,243364049
7436,5,12,149,5745,-69,-96,27,b6:90:18:f6:b1:d4,243364561,440,72,243364121,243364561
7437,5,12,149,5745,-48,-96,48,72:fd:09:2f:da:5f,243365081,284,236,243364797,243365081
7438,5,12,149,5745,-78,-96,18,3e:ef:29:c7:4b:17,243366209,440,688,243365769,243366209
7439,5,12,149,5745,-56,-96,40,5e:29:73:5b:30:00,243367520,540,771,243366980,243367520
7440,5,12,149,5745,-60,-96,36,f2:da:61:dd:98:c5,243368130,268,342,243367862,243368130
7441,5,12,149,5745,-75,-96,21,72:d1:72:1d:22:a1,243369161,452,579,243368709,243369161
7442,5,12,149,5745,-72,-96,24,56:68:e2:c2:8d:d5,243371699,476,2062,243371223,243371699
7443,5,12,149,5745,-75,-96,21,f6:0a:5c:59:72:df,243372254,448,107,243371806,243372254
7444,5,12,149,5745,-78,-96,18,d2:00:04:7e:2c:ab,243372738,440,44,243372298,243372738
7445,5,12,149,5745,-74,-96,22,fa:44:8d:e1:c7:1b,243384742,244,11760,243384498,243384742
7446,5,12,149,5745,-60,-96,36,f2:da:61:dd:98:c5,243385326,268,316,243385058,243385326
7447,5,6,149,5745,-86,-96,10,54:e4:3a:ec:fb:65,243388606,360,2920,243388246,243388606
7448,5,12,149,5745,-60,-96,36,3e:d1:9b:c7:a4:de,243400424,272,11546,243400152,243400424
7449,5,12,149,5745,-48,-96,48,72:fd:09:2f:da:5f,243400730,284,22,243400446,243400730
7450,5,12,149,5745,-55,-96,41,5e:29:73:5b:30:00,243416832,540,15562,243416292,243416832
7451,5,12,149,5745,-70,-96,26,a6:92:ad:b7:76:65,243418659,456,1371,243418203,243418659
7452,5,12,149,5745,-78,-96,18,3e:ef:29:c7:4b:17,243419150,244,247,243418906,243419150
7453,5,12,149,5745,-81,-96,15,9a:24:38:da:96:bb,243420166,824,192,243419342,243420166
7454,5,12,149,5745,-60,-96,36,3e:d1:9b:c7:a4:de,243422050,544,1340,243421506,243422050
7455,5,12,149,5745,-76,-96,20,22:ec:75:a8:8a:31,243424689,516,2123,243424173,243424689
7456,5,12,149,5745,-67,-96,29,0a:b9:b7:b1:4d:fa,243427399,268,2442,243427131,243427399
7457,5,12,149,5745,-49,-96,47,72:fd:09:2f:da:5f,243427828,132,297,243427696,243427828
7458,5,12,149,5745,-73,-96,23,fa:44:8d:e1:c7:1b,243428912,440,644,243428472,243428912
7459,5,12,149,5745,-74,-96,22,f6:0a:5c:59:72:df,243429385,252,221,243429133,243429385
7460,5,12,149,5745,-49,-96,47,72:fd:09:2f:da:5f,243429836,284,167,243429552,243429836
7461,5,12,149,5745,-78,-96,18,3e:ef:29:c7:4b:17,243431468,440,1192,243431028,243431468
7462,5,12,149,5745,-55,-96,41,5e:29:73:5b:30:00,243433665,272,1925,243433393,243433665
7463,5,12,149,5745,-78,-96,18,d2:00:04:7e:2c:ab,243434125,380,80,243433745,243434125
7464,5,12,149,5745,-75,-96,21,72:d1:72:1d:22:a1,243435026,452,449,243434574,243435026
7465,5,12,149,5745,-73,-96,23,56:68:e2:c2:8d:d5,243436430,476,928,243435954,243436430
7466,5,12,149,5745,-75,-96,21,f6:0a:5c:59:72:df,243437039,448,161,243436591,243437039
7467,5,12,149,5745,-78,-96,18,d2:00:04:7e:2c:ab,243438018,440,539,243437578,243438018
7468,5,12,149,5745,-59,-96,37,f2:da:61:dd:98:c5,243438501,268,215,243438233,243438501
7469,5,12,149,5745,-73,-96,23,56:68:e2:c2:8d:d5,243448946,280,10165,243448666,243448946
7470,5,12,149,5745,-78,-96,18,d2:00:04:7e:2c:ab,243449955,244,765,243449711,243449955
7471,5,12,149,5745,-72,-96,24,b6:90:18:f6:b1:d4,243450280,244,81,243450036,243450280
7472,5,12,149,5745,-75,-96,21,72:d1:72:1d:22:a1,243450577,256,41,243450321,243450577
7473,5,12,149,5745,-77,-96,19,22:ec:75:a8:8a:31,243466897,244,16076,243466653,243466897
7474,5,6,149,5745,-87,-96,9,54:e4:3a:ec:fb:65,243491007,360,23750,243490647,243491007
7475,5,12,149,5745,-59,-96,37,f2:da:61:dd:98:c5,243503593,268,12318,243503325,243503593
7476,5,12,149,5745,-79,-96,17,d2:00:04:7e:2c:ab,243503913,440,-120,243503473,243503913
7477,5,12,149,5745,-62,-96,34,3e:d1:9b:c7:a4:de,243506977,272,2792,243506705,243506977
7478,5,12,149,5745,-73,-96,23,fa:44:8d:e1:c7:1b,243507630,244,409,243507386,243507630
7479,5,12,149,5745,-76,-96,20,3e:ef:29:c7:4b:17,243536006,244,28132,243535762,243536006
7480,5,12,149,5745,-54,-96,42,5e:29:73:5b:30:00,243537319,272,1041,243537047,243537319
7481,5,12,149,5745,-72,-96,24,f6:0a:5c:59:72:df,243556214,252,18643,243555962,243556214
7482,5,12,149,5745,-79,-96,17,9a:24:38:da:96:bb,243561971,272,5485,243561699,243561971
7483,5,12,149,5745,-78,-96,18,d2:00:04:7e:2c:ab,243572294,244,10079,243572050,243572294
7484,5,12,149,5745,-74,-96,22,22:ec:75:a8:8a:31,243579370,244,6832,243579126,243579370
7485,5,12,149,5745,-48,-96,48,72:fd:09:2f:da:5f,243589236,284,9582,243588952,243589236
7486,5,6,149,5745,-88,-96,8,54:e4:3a:ec:fb:65,243593408,360,3812,243593048,243593408
7487,5,12,149,5745,-79,-96,17,72:d1:72:1d:22:a1,243618046,256,24382,243617790,243618046
7488,5,12,149,5745,-68,-96,28,b6:90:18:f6:b1:d4,243618668,244,378,243618424,243618668
7489,5,12,149,5745,-73,-96,23,56:68:e2:c2:8d:d5,243620189,280,1241,243619909,243620189
7490,5,12,149,5745,-75,-96,21,fa:44:8d:e1:c7:1b,243622284,244,1851,243622040,243622284
7491,5,12,149,5745,-64,-96,32,3e:d1:9b:c7:a4:de,243624119,272,1563,243623847,243624119
7492,5,12,149,5745,-57,-96,39,5e:29:73:5b:30:00,243654533,272,30142,243654261,243654533
7493,5,12,149,5745,-75,-96,21,3e:ef:29:c7:4b:17,243671745,244,16968,243671501,243671745
7494,5,12,149,5745,-76,-96,20,9a:24:38:da:96:bb,243677855,272,5838,243677583,243677855
7495,5,12,149,5745,-48,-96,48,72:fd:09:2f:da:5f,243693005,284,14866,243692721,243693005
7496,5,6,149,5745,-88,-96,8,54:e4:3a:ec:fb:65,243695808,360,2443,243695448,243695808
7497,5,12,149,5745,-73,-96,23,22:ec:75:a8:8a:31,243696401,244,349,243696157,243696401
7498,5,12,149,5745,-59,-96,37,f2:da:61:dd:98:c5,243698513,268,1844,243698245,243698513
7499,5,12,149,5745,-75,-96,21,d2:00:04:7e:2c:ab,243720188,244,21431,243719944,243720188
7500,5,12,149,5745,-79,-96,17,72:d1:72:1d:22:a1,243720598,256,154,243720342,243720598
7501,5,12,149,5745,-76,-96,20,56:68:e2:c2:8d:d5,243721135,280,257,243720855,243721135
7502,5,12,149,5745,-66,-96,30,b6:90:18:f6:b1:d4,243722524,244,1145,243722280,243722524
7503,5,12,149,5745,-60,-96,36,f2:da:61:dd:98:c5,243732293,268,9501,243732025,243732293
7504,5,12,149,5745,-72,-96,24,fa:44:8d:e1:c7:1b,243732872,244,335,243732628,243732872
7505,5,24,149,5745,-88,-96,8,,243738933,28,6033,243738905,243738933
7506,5,12,149,5745,-65,-96,31,3e:d1:9b:c7:a4:de,243741254,272,2049,243740982,243741254
7507,5,12,149,5745,-56,-96,40,5e:29:73:5b:30:00,243771557,272,30031,243771285,243771557
7508,5,12,149,5745,-75,-96,21,3e:ef:29:c7:4b:17,243773564,244,1763,243773320,243773564
7509,5,24,149,5745,-87,-96,9,,243779897,32,6301,243779865,243779897
7510,5,12,149,5745,-77,-96,19,9a:24:38:da:96:bb,243785628,272,5459,243785356,243785628
7511,5,12,149,5745,-66,-96,30,b6:90:18:f6:b1:d4,243795456,244,9584,243795212,243795456
7512,5,12,149,5745,-76,-96,20,d2:00:04:7e:2c:ab,243795742,244,42,243795498,243795742
7513,5,12,149,5745,-75,-96,21,fa:44:8d:e1:c7:1b,243796246,48,456,243796198,243796246
7514,5,12,149,5745,-66,-96,30,,243796310,32,32,243796278,243796310
7515,5,12,149,5745,-78,-96,18,72:d1:72:1d:22:a1,243797264,256,698,243797008,243797264
7516,5,12,149,5745,-76,-96,20,56:68:e2:c2:8d:d5,243797572,280,28,243797292,243797572
7517,5,12,149,5745,-47,-96,49,72:fd:09:2f:da:5f,243798093,284,237,243797809,243798093
7518,5,6,149,5745,-85,-96,11,54:e4:3a:ec:fb:65,243798409,360,-44,243798049,243798409
7519,5,24,149,5745,-87,-96,9,,243800309,32,1868,243800277,243800309
7520,5,12,149,5745,-55,-96,41,5e:29:73:5b:30:00,243811811,540,10962,243811271,243811811
7521,5,12,149,5745,-80,-96,16,9a:24:38:da:96:bb,243813023,824,388,243812199,243813023
7522,5,24,149,5745,-87,-96,9,,243814441,28,1390,243814413,243814441
7523,5,24,149,5745,-87,-96,9,,243814695,28,226,243814667,243814695
7524,5,12,149,5745,-63,-96,33,3e:d1:9b:c7:a4:de,243817083,544,1844,243816539,243817083
7525,5,12,149,5745,-76,-96,20,22:ec:75:a8:8a:31,243820181,516,2582,243819665,243820181
7526,5,12,149,5745,-73,-96,23,f6:0a:5c:59:72:df,243820794,360,253,243820434,243820794
7527,5,24,149,5745,-88,-96,8,,243822374,32,1548,243822342,243822374
7528,5,12,149,5745,-75,-96,21,3e:ef:29:c7:4b:17,243822485,440,-329,243822045,243822485
7529,5,12,149,5745,-76,-96,20,fa:44:8d:e1:c7:1b,243824103,440,1178,243823663,243824103
7530,5,12,149,5745,-76,-96,20,22:ec:75:a8:8a:31,243825784,244,1437,243825540,243825784
7531,5,12,149,5745,-47,-96,49,72:fd:09:2f:da:5f,243827142,284,1074,243826858,243827142
7532,5,12,149,5745,-74,-96,22,f6:0a:5c:59:72:df,243831479,448,3889,243831031,243831479
7533,5,12,149,5745,-61,-96,35,f2:da:61:dd:98:c5,243835315,268,3568,243835047,243835315
7534,5,24,149,5745,-88,-96,8,,243837106,28,1763,243837078,243837106
7535,5,12,149,5745,-78,-96,18,72:d1:72:1d:22:a1,243838433,452,875,243837981,243838433
7536,5,12,149,5745,-66,-96,30,b6:90:18:f6:b1:d4,243838939,440,66,243838499,243838939
7537,5,12,149,5745,-48,-96,48,72:fd:09:2f:da:5f,243842546,284,3323,243842262,243842546
7538,5,12,149,5745,-73,-96,23,fa:44:8d:e1:c7:1b,243843409,244,619,243843165,243843409
7539,5,12,149,5745,-61,-96,35,f2:da:61:dd:98:c5,243844642,268,965,243844374,243844642
7540,5,12,149,5745,-75,-96,21,56:68:e2:c2:8d:d5,243846825,476,1707,243846349,243846825
7541,5,12,149,5745,-77,-96,19,d2:00:04:7e:2c:ab,243847580,440,315,243847140,243847580
7542,5,24,149,5745,-87,-96,9,,243851528,28,3920,243851500,243851528
7543,5,12,149,5745,-61,-96,35,3e:d1:9b:c7:a4:de,243859720,272,7920,243859448,243859720
7544,5,24,149,5745,-87,-96,9,,243866189,28,6441,243866161,243866189
7545,5,24,149,5745,-87,-96,9,,243866621,28,404,243866593,243866621
7546,5,24,149,5745,-87,-96,9,,243869397,32,2744,243869365,243869397
7547,5,24,149,5745,-88,-96,8,,243871787,32,2358,243871755,243871787
7548,5,12,149,5745,-75,-96,21,3e:ef:29:c7:4b:17,243875065,244,3034,243874821,243875065
7549,5,12,149,5745,-76,-96,20,fa:44:8d:e1:c7:1b,243887395,440,11890,243886955,243887395
7550,5,12,149,5745,-54,-96,42,5e:29:73:5b:30:00,243888061,272,394,243887789,243888061
7551,5,12,149,5745,-67,-96,29,b6:90:18:f6:b1:d4,243888362,440,-139,243887922,243888362
7552,5,12,149,5745,-69,-96,27,a6:92:ad:b7:76:65,243889386,456,568,243888930,243889386
7553,5,24,149,5745,-87,-96,9,,243895162,28,5748,243895134,243895162
7554,5,24,149,5745,-87,-96,9,,243895271,32,77,243895239,243895271
7555,5,12,149,5745,-60,-96,36,f2:da:61:dd:98:c5,243897161,268,1622,243896893,243897161
7556,5,12,149,5745,-77,-96,19,d2:00:04:7e:2c:ab,243899578,440,1977,243899138,243899578
7557,5,6,149,5745,-86,-96,10,54:e4:3a:ec:fb:65,243900609,360,671,243900249,243900609
7558,5,24,149,5745,-87,-96,9,,243901374,28,737,243901346,243901374
7559,5,12,149,5745,-74,-96,22,f6:0a:5c:59:72:df,243901918,252,292,243901666,243901918
7560,5,24,149,5745,-88,-96,8,,243904575,32,2625,243904543,243904575
7561,5,12,149,5745,-79,-96,17,d2:00:04:7e:2c:ab,243908367,244,3548,243908123,243908367
7562,5,12,149,5745,-67,-96,29,b6:90:18:f6:b1:d4,243908673,244,62,243908429,243908673
7563,5,24,149,5745,-89,-96,7,,243908979,28,278,243908951,243908979
7564,5,12,149,5745,-74,-96,22,56:68:e2:c2:8d:d5,243910698,280,1439,243910418,243910698
7565,5,12,149,5745,-79,-96,17,72:d1:72:1d:22:a1,243916028,256,5074,243915772,243916028
7566,5,24,149,5745,-88,-96,8,,243922900,28,6844,243922872,243922900
7567,5,12,149,5745,-68,-96,28,a6:92:ad:b7:76:65,243925206,256,2050,243924950,243925206
7568,5,12,149,5745,-75,-96,21,22:ec:75:a8:8a:31,243940492,244,15042,243940248,243940492
7569,5,12,149,5745,-54,-96,42,5e:29:73:5b:30:00,243942922,540,1890,243942382,243942922
7570,5,12,149,5745,-60,-96,36,3e:d1:9b:c7:a4:de,243946982,544,3516,243946438,243946982
7571,5,12,149,5745,-75,-96,21,22:ec:75:a8:8a:31,243949099,516,1601,243948583,243949099
7572,5,12,149,5745,-64,-96,32,0a:b9:b7:b1:4d:fa,243952646,268,3279,243952378,243952646
7573,5,12,149,5745,-78,-96,18,fa:44:8d:e1:c7:1b,243952984,440,-102,243952544,243952984
7574,5,12,149,5745,-75,-96,21,3e:ef:29:c7:4b:17,243953513,440,89,243953073,243953513
7575,5,12,149,5745,-67,-96,29,b6:90:18:f6:b1:d4,243954103,440,150,243953663,243954103
7576,5,12,149,5745,-67,-96,29,a6:92:ad:b7:76:65,243954577,456,18,243954121,243954577
7577,5,12,149,5745,-78,-96,18,fa:44:8d:e1:c7:1b,243957842,244,3021,243957598,243957842
7578,5,12,149,5745,-60,-96,36,f2:da:61:dd:98:c5,243959172,268,1062,243958904,243959172
7579,5,24,149,5745,-90,-96,6,,243960226,32,1022,243960194,243960226
7580,5,24,149,5745,-88,-96,8,,243960344,32,86,243960312,243960344
7581,5,24,149,5745,-90,-96,6,,243960462,32,86,243960430,243960462
7582,5,12,149,5745,-60,-96,36,f2:da:61:dd:98:c5,243961920,268,1190,243961652,243961920
7583,5,12,149,5745,-78,-96,18,d2:00:04:7e:2c:ab,243962217,440,-143,243961777,243962217
7584,5,24,149,5745,-88,-96,8,,243963545,28,1300,243963517,243963545
7585,5,12,149,5745,-82,-96,14,9a:24:38:da:96:bb,243966436,824,2067,243965612,243966436
7586,5,12,149,5745,-60,-96,36,3e:d1:9b:c7:a4:de,243973567,272,6859,243973295,243973567
7587,5,12,149,5745,-82,-96,14,9a:24:38:da:96:bb,243985300,272,11461,243985028,243985300
7588,5,12,149,5745,-75,-96,21,3e:ef:29:c7:4b:17,243990136,244,4592,243989892,243990136
7589,5,12,149,5745,-46,-96,50,72:fd:09:2f:da:5f,244000210,284,9790,243999926,244000210
7590,5,6,149,5745,-88,-96,8,54:e4:3a:ec:fb:65,244003010,360,2440,244002650,244003010
7591,5,12,149,5745,-55,-96,41,5e:29:73:5b:30:00,244003841,272,559,244003569,244003841
7592,5,12,149,5745,-76,-96,20,f6:0a:5c:59:72:df,244008905,252,4812,244008653,244008905
7593,5,12,149,5745,-76,-96,20,d2:00:04:7e:2c:ab,244023583,244,14434,244023339,244023583
7594,5,12,149,5745,-72,-96,24,56:68:e2:c2:8d:d5,244023897,280,34,244023617,244023897
7595,5,12,149,5745,-68,-96,28,b6:90:18:f6:b1:d4,244026877,244,2736,244026633,244026877
7596,5,12,149,5745,-77,-96,19,72:d1:72:1d:22:a1,244029502,256,2369,244029246,244029502
7597,5,12,149,5745,-71,-96,25,a6:92:ad:b7:76:65,244037991,256,8233,244037735,244037991
7598,5,12,149,5745,-76,-96,20,22:ec:75:a8:8a:31,244042350,244,4115,244042106,244042350
7599,5,12,149,5745,-58,-96,38,3e:d1:9b:c7:a4:de,244077783,272,35161,244077511,244077783
7600,5,12,149,5745,-60,-96,36,f2:da:61:dd:98:c5,244078100,268,49,244077832,244078100
7601,5,12,149,5745,-46,-96,50,72:fd:09:2f:da:5f,244102023,284,23639,244101739,244102023
7602,5,6,149,5745,-87,-96,9,54:e4:3a:ec:fb:65,244105410,360,3027,244105050,244105410
7603,5,12,149,5745,-57,-96,39,5e:29:73:5b:30:00,244120677,272,14995,244120405,244120677
7604,5,12,149,5745,-76,-96,20,fa:44:8d:e1:c7:1b,244129966,244,9045,244129722,244129966
7605,5,12,149,5745,-72,-96,24,56:68:e2:c2:8d:d5,244135268,280,5022,244134988,244135268
7606,5,12,149,5745,-77,-96,19,d2:00:04:7e:2c:ab,244136252,244,740,244136008,244136252
7607,5,12,149,5745,-68,-96,28,b6:90:18:f6:b1:d4,244139784,244,3288,244139540,244139784
7608,5,12,149,5745,-74,-96,22,72:d1:72:1d:22:a1,244142182,256,2142,244141926,244142182
7609,5,24,149,5745,-88,-96,8,,244146176,28,3966,244146148,244146176
7610,5,12,149,5745,-74,-96,22,22:ec:75:a8:8a:31,244159446,244,13026,244159202,244159446
7611,5,12,149,5745,-76,-96,20,3e:ef:29:c7:4b:17,244182227,244,22537,244181983,244182227
7612,5,24,149,5745,-87,-96,9,,244188446,28,6191,244188418,244188446
7613,5,24,149,5745,-86,-96,10,,244188554,32,76,244188522,244188554
7614,5,24,149,5745,-88,-96,8,,244189103,28,521,244189075,244189103
7615,5,24,149,5745,-86,-96,10,,244189255,32,120,244189223,244189255
7616,5,12,149,5745,-56,-96,40,3e:d1:9b:c7:a4:de,244191769,272,2242,244191497,244191769
7617,5,12,149,5745,-46,-96,50,72:fd:09:2f:da:5f,244205363,284,13310,244205079,244205363
7618,5,6,149,5745,-82,-96,14,54:e4:3a:ec:fb:65,244207810,360,2087,244207450,244207810
7619,5,12,149,5745,-60,-96,36,f2:da:61:dd:98:c5,244208579,268,501,244208311,244208579
7620,5,12,149,5745,-82,-96,14,9a:24:38:da:96:bb,244214008,272,5157,244213736,244214008
7621,5,12,149,5745,-70,-96,26,a6:92:ad:b7:76:65,244231052,256,16788,244230796,244231052
7622,5,12,149,5745,-78,-96,18,fa:44:8d:e1:c7:1b,244232953,244,1657,244232709,244232953
7623,5,12,149,5745,-56,-96,40,5e:29:73:5b:30:00,244237701,272,4476,244237429,244237701
7624,5,12,149,5745,-73,-96,23,56:68:e2:c2:8d:d5,244246851,280,8870,244246571,244246851
7625,5,12,149,5745,-75,-96,21,d2:00:04:7e:2c:ab,244247748,244,653,244247504,244247748
7626,5,12,149,5745,-67,-96,29,b6:90:18:f6:b1:d4,244248685,244,693,244248441,244248685
7627,5,12,149,5745,-70,-96,26,22:ec:75:a8:8a:31,244272056,244,23127,244271812,244272056
7628,5,12,149,5745,-74,-96,22,3e:ef:29:c7:4b:17,244286117,244,13817,244285873,244286117
7629,5,12,149,5745,-57,-96,39,3e:d1:9b:c7:a4:de,244304992,272,18603,244304720,244304992
7630,5,12,149,5745,-46,-96,50,72:fd:09:2f:da:5f,244307485,284,2209,244307201,244307485
7631,5,6,149,5745,-86,-96,10,54:e4:3a:ec:fb:65,244310211,360,2366,244309851,244310211
7632,5,12,149,5745,-59,-96,37,f2:da:61:dd:98:c5,244310743,268,264,244310475,244310743
7633,5,12,149,5745,-76,-96,20,fa:44:8d:e1:c7:1b,244334468,244,23481,244334224,244334468
7634,5,12,149,5745,-67,-96,29,a6:92:ad:b7:76:65,244334764,256,40,244334508,244334764
7635,5,12,149,5745,-73,-96,23,3e:ef:29:c7:4b:17,244335083,244,75,244334839,244335083
7636,5,12,149,5745,-76,-96,20,72:d1:72:1d:22:a1,244335353,256,14,244335097,244335353
7637,5,12,149,5745,-55,-96,41,5e:29:73:5b:30:00,244349569,272,13944,244349297,244349569
7638,5,12,149,5745,-68,-96,28,b6:90:18:f6:b1:d4,244366205,244,16392,244365961,244366205
7639,5,12,149,5745,-77,-96,19,d2:00:04:7e:2c:ab,244366503,244,54,244366259,244366503
7640,5,12,149,5745,-72,-96,24,56:68:e2:c2:8d:d5,244367340,280,557,244367060,244367340
7641,5,12,149,5745,-76,-96,20,72:d1:72:1d:22:a1,244368947,256,1351,244368691,244368947
7642,5,12,149,5745,-69,-96,27,a6:92:ad:b7:76:65,244383889,256,14686,244383633,244383889
7643,5,12,149,5745,-72,-96,24,22:ec:75:a8:8a:31,244399249,244,15116,244399005,244399249
7644,5,12,149,5745,-56,-96,40,5e:29:73:5b:30:00,244400102,540,313,244399562,244400102
7645,5,12,149,5745,-77,-96,19,d2:00:04:7e:2c:ab,244401234,440,692,244400794,244401234
7646,5,12,149,5745,-75,-96,21,fa:44:8d:e1:c7:1b,244401710,244,232,244401466,244401710
7647,5,12,149,5745,-57,-96,39,f2:da:61:dd:98:c5,244401997,268,19,244401729,244401997
7648,5,12,149,5745,-53,-96,43,3e:d1:9b:c7:a4:de,244404768,544,2227,244404224,244404768
7649,5,12,149,5745,-76,-96,20,f6:0a:5c:59:72:df,244407722,448,2506,244407274,244407722
7650,5,12,149,5745,-72,-96,24,22:ec:75:a8:8a:31,244408222,516,-16,244407706,244408222
7651,5,12,149,5745,-75,-96,21,3e:ef:29:c7:4b:17,244409727,440,1065,244409287,244409727
7652,5,12,149,5745,-74,-96,22,72:d1:72:1d:22:a1,244411337,452,1158,244410885,244411337
7653,5,12,149,5745,-66,-96,30,b6:90:18:f6:b1:d4,244412869,440,1092,244412429,244412869
7654,5,12,149,5745,-70,-96,26,a6:92:ad:b7:76:65,244413388,456,63,244412932,244413388
7655,5,12,149,5745,-74,-96,22,fa:44:8d:e1:c7:1b,244414672,440,844,244414232,244414672
7656,5,12,149,5745,-52,-96,44,72:fd:09:2f:da:5f,244415794,284,838,244415510,244415794
7657,5,12,149,5745,-52,-96,44,72:fd:09:2f:da:5f,244416095,284,17,244415811,244416095
7658,5,12,149,5745,-72,-96,24,56:68:e2:c2:8d:d5,244418634,476,2063,244418158,244418634
7659,5,12,149,5745,-61,-96,35,f2:da:61:dd:98:c5,244423536,268,4634,244423268,244423536
7660,5,12,149,5745,-75,-96,21,3e:ef:29:c7:4b:17,244431897,244,8117,244431653,244431897
7661,5,12,149,5745,-56,-96,40,3e:d1:9b:c7:a4:de,244432329,272,160,244432057,244432329
7662,5,12,149,5745,-84,-96,12,9a:24:38:da:96:bb,244432784,272,183,244432512,244432784
7663,5,12,149,5745,-76,-96,20,f6:0a:5c:59:72:df,244451973,252,18937,244451721,244451973
7664,5,12,149,5745,-72,-96,24,56:68:e2:c2:8d:d5,244464805,280,12552,244464525,244464805
7665,5,12,149,5745,-75,-96,21,d2:00:04:7e:2c:ab,244465328,244,279,244465084,244465328
7666,5,12,149,5745,-59,-96,37,5e:29:73:5b:30:00,244465633,540,-235,244465093,244465633
7667,5,12,149,5745,-76,-96,20,d2:00:04:7e:2c:ab,244466975,440,902,244466535,244466975
7668,5,12,149,5745,-75,-96,21,72:d1:72:1d:22:a1,244467504,256,273,244467248,244467504
7669,5,12,149,5745,-58,-96,38,3e:d1:9b:c7:a4:de,244470575,544,2527,244470031,244470575
7670,5,12,149,5745,-78,-96,18,f6:0a:5c:59:72:df,244471153,448,130,244470705,244471153
7671,5,12,149,5745,-75,-96,21,3e:ef:29:c7:4b:17,244472987,440,1394,244472547,244472987
7672,5,12,149,5745,-72,-96,24,22:ec:75:a8:8a:31,244473479,516,-24,244472963,244473479
7673,5,12,149,5745,-78,-96,18,f6:0a:5c:59:72:df,244474534,360,695,244474174,244474534
7674,5,12,149,5745,-62,-96,34,0a:b9:b7:b1:4d:fa,244476125,268,1323,244475857,244476125
7675,5,12,149,5745,-75,-96,21,3e:ef:29:c7:4b:17,244476544,364,55,244476180,244476544
7676,5,12,149,5745,-71,-96,25,fa:44:8d:e1:c7:1b,244477376,440,392,244476936,244477376
7677,5,12,149,5745,-51,-96,45,72:fd:09:2f:da:5f,244478246,284,586,244477962,244478246
7678,5,12,149,5745,-75,-96,21,a6:92:ad:b7:76:65,244479196,456,494,244478740,244479196
7679,5,12,149,5745,-75,-96,21,a6:92:ad:b7:76:65,244482018,256,2566,244481762,244482018
7680,5,12,149,5745,-58,-96,38,5e:29:73:5b:30:00,244482308,272,18,244482036,244482308
7681,5,12,149,5745,-71,-96,25,56:68:e2:c2:8d:d5,244484684,476,1900,244484208,244484684
7682,5,12,149,5745,-58,-96,38,f2:da:61:dd:98:c5,244486131,268,1179,244485863,244486131
7683,5,12,149,5745,-80,-96,16,9a:24:38:da:96:bb,244490646,824,3691,244489822,244490646
7684,5,12,149,5745,-74,-96,22,22:ec:75:a8:8a:31,244514775,244,23885,244514531,244514775
7685,5,12,149,5745,-49,-96,47,72:fd:09:2f:da:5f,244515285,284,226,244515001,244515285
7686,5,12,149,5745,-58,-96,38,f2:da:61:dd:98:c5,244516496,268,943,244516228,244516496
7687,5,12,149,5745,-56,-96,40,3e:d1:9b:c7:a4:de,244531291,272,14523,244531019,244531291
7688,5,12,149,5745,-83,-96,13,9a:24:38:da:96:bb,244545897,272,14334,244545625,244545897
7689,5,12,149,5745,-75,-96,21,3e:ef:29:c7:4b:17,244559755,244,13614,244559511,244559755
7690,5,12,149,5745,-60,-96,36,5e:29:73:5b:30:00,244579166,272,19139,244578894,244579166
7691,5,12,149,5745,-74,-96,22,22:ec:75:a8:8a:31,244613584,244,34174,244613340,244613584
7692,5,6,149,5745,-85,-96,11,54:e4:3a:ec:fb:65,244617412,360,3468,244617052,244617412
7693,5,6,149,5745,-82,-96,14,10:f6:0a:d6:ae:16,244637436,236,19788,244637200,244637436
7694,5,12,149,5745,-74,-96,22,a6:92:ad:b7:76:65,244640514,256,2822,244640258,244640514
7695,5,12,149,5745,-73,-96,23,fa:44:8d:e1:c7:1b,244641085,244,327,244640841,244641085
7696,5,12,149,5745,-78,-96,18,d2:00:04:7e:2c:ab,244641852,244,523,244641608,244641852
7697,5,12,149,5745,-77,-96,19,72:d1:72:1d:22:a1,244642329,256,221,244642073,244642329
7698,5,12,149,5745,-68,-96,28,b6:90:18:f6:b1:d4,244642639,244,66,244642395,244642639
7699,5,12,149,5745,-74,-96,22,56:68:e2:c2:8d:d5,244642971,280,52,244642691,244642971
7700,5,12,149,5745,-59,-96,37,3e:d1:9b:c7:a4:de,244647134,272,3891,244646862,244647134
7701,5,12,149,5745,-81,-96,15,9a:24:38:da:96:bb,244662001,272,14595,244661729,244662001
7702,5,12,149,5745,-78,-96,18,3e:ef:29:c7:4b:17,244696099,244,33854,244695855,244696099
7703,5,6,149,5745,-84,-96,12,54:e4:3a:ec:fb:65,244719813,360,23354,244719453,244719813
7704,5,12,149,5745,-58,-96,38,f2:da:61:dd:98:c5,244720710,268,629,244720442,244720710
7705,5,12,149,5745,-73,-96,23,22:ec:75:a8:8a:31,244729385,244,8431,244729141,244729385
7706,5,12,149,5745,-77,-96,19,a6:92:ad:b7:76:65,244742953,256,13312,244742697,244742953
7707,5,12,149,5745,-77,-96,19,72:d1:72:1d:22:a1,244744006,256,797,244743750,244744006
7708,5,12,149,5745,-69,-96,27,b6:90:18:f6:b1:d4,244744325,244,75,244744081,244744325
7709,5,12,149,5745,-75,-96,21,d2:00:04:7e:2c:ab,244744623,244,54,244744379,244744623
7710,5,12,149,5745,-72,-96,24,56:68:e2:c2:8d:d5,244746629,280,1726,244746349,244746629
7711,5,12,149,5745,-73,-96,23,fa:44:8d:e1:c7:1b,244760380,244,13507,244760136,244760380
7712,5,24,149,5745,-87,-96,9,,244762841,28,2433,244762813,244762841
7713,5,24,149,5745,-90,-96,6,,244762885,28,16,244762857,244762885
7714,5,24,149,5745,-89,-96,7,,244762994,32,77,244762962,244762994
7715,5,24,149,5745,-87,-96,9,,244763978,28,956,244763950,244763978
7716,5,24,149,5745,-90,-96,6,,244764023,28,17,244763995,244764023
7717,5,24,149,5745,-89,-96,7,,244764131,32,76,244764099,244764131
7718,5,12,149,5745,-59,-96,37,3e:d1:9b:c7:a4:de,244764215,272,-188,244763943,244764215
7719,5,12,149,5745,-81,-96,15,9a:24:38:da:96:bb,244771508,272,7021,244771236,244771508
7720,5,24,149,5745,-90,-96,6,,244776966,28,5430,244776938,244776966
7721,5,24,149,5745,-87,-96,9,,244779967,28,2973,244779939,244779967
7722,5,24,149,5745,-89,-96,7,,244780012,28,17,244779984,244780012
7723,5,24,149,5745,-91,-96,5,,244780267,28,227,244780239,244780267
7724,5,24,149,5745,-88,-96,8,,244780312,28,17,244780284,244780312
7725,5,24,149,5745,-90,-96,6,,244783190,28,2850,244783162,244783190
7726,5,12,149,5745,-77,-96,19,3e:ef:29:c7:4b:17,244798193,244,14759,244797949,244798193
7727,5,24,149,5745,-87,-96,9,,244803900,28,5679,244803872,244803900
7728,5,24,149,5745,-90,-96,6,,244803945,28,17,244803917,244803945
7729,5,12,149,5745,-72,-96,24,f6:0a:5c:59:72:df,244805392,252,1195,244805140,244805392
7730,5,12,149,5745,-73,-96,23,56:68:e2:c2:8d:d5,244808117,280,2445,244807837,244808117
7731,5,12,149,5745,-59,-96,37,5e:29:73:5b:30:00,244810439,272,2050,244810167,244810439
7732,5,12,149,5745,-76,-96,20,d2:00:04:7e:2c:ab,244812225,244,1542,244811981,244812225
7733,5,12,149,5745,-70,-96,26,b6:90:18:f6:b1:d4,244816717,244,4248,244816473,244816717
7734,5,24,149,5745,-86,-96,10,,244820031,28,3286,244820003,244820031
7735,5,12,149,5745,-76,-96,20,72:d1:72:1d:22:a1,244821323,256,1036,244821067,244821323
7736,5,24,149,5745,-89,-96,7,,244821810,28,459,244821782,244821810
7737,5,6,149,5745,-87,-96,9,54:e4:3a:ec:fb:65,244822214,360,44,244821854,244822214
7738,5,12,149,5745,-56,-96,40,f2:da:61:dd:98:c5,244823246,268,764,244822978,244823246
7739,5,6,149,5745,-89,-96,7,70:bc:10:5f:b5:61,244826440,124,3070,244826316,244826440
7740,5,6,149,5745,-88,-96,8,70:bc:10:5f:b5:61,244826648,124,84,244826524,244826648
7741,5,6,149,5745,-87,-96,9,54:e4:3a:ec:fb:65,244826834,352,-166,244826482,244826834
7742,5,6,149,5745,-89,-96,7,,244827202,44,324,244827158,244827202
7743,5,6,149,5745,-87,-96,9,54:e4:3a:ec:fb:65,244828365,352,811,244828013,244828365
7744,5,6,149,5745,-88,-96,8,,244828732,44,323,244828688,244828732
7745,5,12,149,5745,-77,-96,19,a6:92:ad:b7:76:65,244833636,256,4648,244833380,244833636
7746,5,24,149,5745,-90,-96,6,,244838108,28,4444,244838080,244838108
7747,5,24,149,5745,-88,-96,8,,244838152,28,16,244838124,244838152
7748,5,12,149,5745,-75,-96,21,fa:44:8d:e1:c7:1b,244845242,48,7042,244845194,244845242
7749,5,12,149,5745,-70,-96,26,,244845306,32,32,244845274,244845306
7750,5,12,149,5745,-69,-96,27,22:ec:75:a8:8a:31,244858008,244,12458,244857764,244858008
7751,5,12,149,5745,-74,-96,22,fa:44:8d:e1:c7:1b,244859764,244,1512,244859520,244859764
7752,5,12,149,5745,-57,-96,39,f2:da:61:dd:98:c5,244860078,268,46,244859810,244860078
7753,5,12,149,5745,-58,-96,38,5e:29:73:5b:30:00,244861298,540,680,244860758,244861298
7754,5,12,149,5745,-71,-96,25,f6:0a:5c:59:72:df,244864554,448,2808,244864106,244864554
7755,5,12,149,5745,-61,-96,35,3e:d1:9b:c7:a4:de,244866044,544,946,244865500,244866044
7756,5,12,149,5745,-79,-96,17,3e:ef:29:c7:4b:17,244868244,440,1760,244867804,244868244
7757,5,12,149,5745,-70,-96,26,22:ec:75:a8:8a:31,244868871,516,111,244868355,244868871
7758,5,12,149,5745,-76,-96,20,72:d1:72:1d:22:a1,244870107,452,784,244869655,244870107
7759,5,12,149,5745,-71,-96,25,b6:90:18:f6:b1:d4,244871422,440,875,244870982,244871422
7760,5,12,149,5745,-74,-96,22,a6:92:ad:b7:76:65,244871950,456,72,244871494,244871950
7761,5,12,149,5745,-72,-96,24,fa:44:8d:e1:c7:1b,244872973,440,583,244872533,244872973
7762,5,12,149,5745,-58,-96,38,f2:da:61:dd:98:c5,244879228,268,5987,244878960,244879228
7763,5,12,149,5745,-74,-96,22,56:68:e2:c2:8d:d5,244880682,476,978,244880206,244880682
7764,5,12,149,5745,-83,-96,13,9a:24:38:da:96:bb,244882753,824,1247,244881929,244882753
7765,5,12,149,5745,-83,-96,13,9a:24:38:da:96:bb,244883594,272,569,244883322,244883594
7766,5,12,149,5745,-80,-96,16,3e:ef:29:c7:4b:17,244890662,244,6824,244890418,244890662
7767,5,12,149,5745,-62,-96,34,3e:d1:9b:c7:a4:de,244891102,272,168,244890830,244891102
7768,5,12,149,5745,-72,-96,24,f6:0a:5c:59:72:df,244907148,252,15794,244906896,244907148
7769,5,12,149,5745,-74,-96,22,56:68:e2:c2:8d:d5,244907500,280,72,244907220,244907500
7770,5,12,149,5745,-71,-96,25,b6:90:18:f6:b1:d4,244924071,244,16327,244923827,244924071
7771,5,6,149,5745,-85,-96,11,54:e4:3a:ec:fb:65,244924614,360,183,244924254,244924614
7772,5,12,149,5745,-57,-96,39,5e:29:73:5b:30:00,244925648,272,762,244925376,244925648
7773,5,12,149,5745,-71,-96,25,fa:44:8d:e1:c7:1b,244937015,440,10927,244936575,244937015
7774,5,12,149,5745,-71,-96,25,b6:90:18:f6:b1:d4,244937526,440,71,244937086,244937526
7775,5,12,149,5745,-76,-96,20,72:d1:72:1d:22:a1,244940401,256,2619,244940145,244940401
7776,5,12,149,5745,-75,-96,21,a6:92:ad:b7:76:65,244940799,256,142,244940543,244940799
7777,5,12,149,5745,-60,-96,36,f2:da:61:dd:98:c5,244944789,268,3722,244944521,244944789
7778,5,12,149,5745,-73,-96,23,a6:92:ad:b7:76:65,244949636,456,4391,244949180,244949636
7779,5,12,149,5745,-70,-96,26,22:ec:75:a8:8a:31,244962822,244,12942,244962578,244962822
7780,5,12,149,5745,-72,-96,24,fa:44:8d:e1:c7:1b,244973982,244,10916,244973738,244973982
7781,5,12,149,5745,-60,-96,36,f2:da:61:dd:98:c5,244974908,268,658,244974640,244974908
7782,5,12,149,5745,-58,-96,38,5e:29:73:5b:30:00,244991227,540,15779,244990687,244991227
7783,5,12,149,5745,-57,-96,39,3e:d1:9b:c7:a4:de,244997228,544,5457,244996684,244997228
7784,5,12,149,5745,-62,-96,34,0a:b9:b7:b1:4d:fa,244998301,268,805,244998033,244998301
7785,5,12,149,5745,-80,-96,16,3e:ef:29:c7:4b:17,244999188,440,447,244998748,244999188
7786,5,12,149,5745,-70,-96,26,22:ec:75:a8:8a:31,245001226,516,1522,245000710,245001226
7787,5,12,149,5745,-73,-96,23,fa:44:8d:e1:c7:1b,245002304,440,638,245001864,245002304
7788,5,12,149,5745,-72,-96,24,b6:90:18:f6:b1:d4,245002789,440,45,245002349,245002789
7789,5,12,149,5745,-80,-96,16,3e:ef:29:c7:4b:17,245005298,244,2265,245005054,245005298
7790,5,12,149,5745,-58,-96,38,3e:d1:9b:c7:a4:de,245005811,272,241,245005539,245005811
7791,5,12,149,5745,-58,-96,38,f2:da:61:dd:98:c5,245010429,268,4350,245010161,245010429
7792,5,12,149,5745,-71,-96,25,a6:92:ad:b7:76:65,245014357,456,3472,245013901,245014357
7793,5,12,149,5745,-80,-96,16,9a:24:38:da:96:bb,245016167,824,986,245015343,245016167
7794,5,6,149,5745,-84,-96,12,54:e4:3a:ec:fb:65,245027014,360,10487,245026654,245027014
7795,5,12,149,5745,-80,-96,16,9a:24:38:da:96:bb,245032619,272,5333,245032347,245032619
7796,5,12,149,5745,-70,-96,26,b6:90:18:f6:b1:d4,245039221,244,6358,245038977,245039221
7797,5,12,149,5745,-58,-96,38,5e:29:73:5b:30:00,245039634,272,141,245039362,245039634
7798,5,12,149,5745,-74,-96,22,56:68:e2:c2:8d:d5,245053765,280,13851,245053485,245053765
7799,5,12,149,5745,-77,-96,19,72:d1:72:1d:22:a1,245054099,256,78,245053843,245054099
7800,5,12,149,5745,-76,-96,20,a6:92:ad:b7:76:65,245065680,256,11325,245065424,245065680
7801,5,24,149,5745,-88,-96,8,,245079878,32,14166,245079846,245079878
7802,5,12,149,5745,-71,-96,25,22:ec:75:a8:8a:31,245079944,244,-178,245079700,245079944
7803,5,12,149,5745,-55,-96,41,f2:da:61:dd:98:c5,245090984,268,10772,245090716,245090984
7804,5,12,149,5745,-75,-96,21,fa:44:8d:e1:c7:1b,245095572,244,4344,245095328,245095572
7805,5,12,149,5745,-59,-96,37,3e:d1:9b:c7:a4:de,245105656,272,9812,245105384,245105656
7806,5,6,149,5745,-84,-96,12,54:e4:3a:ec:fb:65,245129415,360,23399,245129055,245129415
7807,5,12,149,5745,-54,-96,42,5e:29:73:5b:30:00,245154804,272,25117,245154532,245154804
7808,5,12,149,5745,-70,-96,26,b6:90:18:f6:b1:d4,245155319,244,271,245155075,245155319
7809,5,12,149,5745,-78,-96,18,72:d1:72:1d:22:a1,245166356,256,10781,245166100,245166356
7810,5,12,149,5745,-72,-96,24,22:ec:75:a8:8a:31,245193602,244,27002,245193358,245193602
7811,5,12,149,5745,-79,-96,17,3e:ef:29:c7:4b:17,245207723,244,13877,245207479,245207723
7812,5,12,149,5745,-59,-96,37,3e:d1:9b:c7:a4:de,245222637,272,14642,245222365,245222637
7813,5,6,149,5745,-85,-96,11,54:e4:3a:ec:fb:65,245231816,360,8819,245231456,245231816
7814,5,12,149,5745,-57,-96,39,f2:da:61:dd:98:c5,245232509,268,425,245232241,245232509
7815,5,24,149,5745,-87,-96,9,,245254358,28,21821,245254330,245254358
7816,5,12,149,5745,-78,-96,18,a6:92:ad:b7:76:65,245254982,256,368,245254726,245254982
7817,5,12,149,5745,-74,-96,22,fa:44:8d:e1:c7:1b,245257182,244,1956,245256938,245257182
7818,5,12,149,5745,-76,-96,20,56:68:e2:c2:8d:d5,245257461,280,-1,245257181,245257461
7819,5,12,149,5745,-81,-96,15,9a:24:38:da:96:bb,245261806,272,4073,245261534,245261806
7820,5,12,149,5745,-72,-96,24,f6:0a:5c:59:72:df,245267630,252,5572,245267378,245267630
7821,5,12,149,5745,-72,-96,24,b6:90:18:f6:b1:d4,245268107,244,233,245267863,245268107
7822,5,12,149,5745,-57,-96,39,5e:29:73:5b:30:00,245271879,272,3500,245271607,245271879
7823,5,24,149,5745,-89,-96,7,,245309876,28,37969,245309848,245309876
7824,5,24,149,5745,-89,-96,7,,245309984,32,76,245309952,245309984
7825,5,12,149,5745,-78,-96,18,3e:ef:29:c7:4b:17,245310113,244,-115,245309869,245310113
7826,5,12,149,5745,-72,-96,24,22:ec:75:a8:8a:31,245310919,244,562,245310675,245310919
7827,5,24,149,5745,-90,-96,6,,245328406,28,17459,245328378,245328406
7828,5,24,149,5745,-87,-96,9,,245328450,28,16,245328422,245328450
7829,5,24,149,5745,-90,-96,6,,245328750,28,272,245328722,245328750
7830,5,24,149,5745,-87,-96,9,,245328795,28,17,245328767,245328795
7831,5,24,149,5745,-88,-96,8,,245328903,32,76,245328871,245328903
7832,5,24,149,5745,-91,-96,5,,245331486,32,2551,245331454,245331486
7833,5,6,149,5745,-87,-96,9,54:e4:3a:ec:fb:65,245334216,360,2370,245333856,245334216
7834,5,12,149,5745,-56,-96,40,f2:da:61:dd:98:c5,245334910,268,426,245334642,245334910
7835,5,12,149,5745,-57,-96,39,3e:d1:9b:c7:a4:de,245338902,272,3720,245338630,245338902
7836,5,24,149,5745,-87,-96,9,,245345374,28,6444,245345346,245345374
7837,5,24,149,5745,-86,-96,10,,245345482,32,76,245345450,245345482
7838,5,24,149,5745,-87,-96,9,,245348257,28,2747,245348229,245348257
7839,5,24,149,5745,-87,-96,9,,245348301,28,16,245348273,245348301
7840,5,12,149,5745,-80,-96,16,a6:92:ad:b7:76:65,245357483,256,8926,245357227,245357483
7841,5,12,149,5745,-74,-96,22,fa:44:8d:e1:c7:1b,245358842,244,1115,245358598,245358842
7842,5,12,149,5745,-79,-96,17,72:d1:72:1d:22:a1,245359164,256,66,245358908,245359164
7843,5,12,149,5745,-76,-96,20,56:68:e2:c2:8d:d5,245375409,280,15965,245375129,245375409
7844,5,12,149,5745,-59,-96,37,5e:29:73:5b:30:00,245383840,272,8159,245383568,245383840
7845,5,24,149,5745,-87,-96,9,,245384218,28,350,245384190,245384218
7846,5,12,149,5745,-72,-96,24,b6:90:18:f6:b1:d4,245390158,244,5696,245389914,245390158
7847,5,12,149,5745,-78,-96,18,72:d1:72:1d:22:a1,245391704,256,1290,245391448,245391704
7848,5,12,149,5745,-78,-96,18,a6:92:ad:b7:76:65,245396354,256,4394,245396098,245396354
7849,5,24,149,5745,-87,-96,9,,245411639,28,15257,245411611,245411639
7850,5,24,149,5745,-86,-96,10,,245411747,32,76,245411715,245411747
7851,5,12,149,5745,-78,-96,18,3e:ef:29:c7:4b:17,245411822,244,-169,245411578,245411822
7852,5,24,149,5745,-88,-96,8,,245414069,28,2219,245414041,245414069
7853,5,12,149,5745,-73,-96,23,22:ec:75:a8:8a:31,245422760,244,8447,245422516,245422760
7854,5,12,149,5745,-55,-96,41,f2:da:61:dd:98:c5,245428711,268,5683,245428443,245428711
7855,5,12,149,5745,-73,-96,23,fa:44:8d:e1:c7:1b,245434307,244,5352,245434063,245434307
7856,5,12,149,5745,-73,-96,23,f6:0a:5c:59:72:df,245435008,252,449,245434756,245435008
7857,5,6,149,5745,-86,-96,10,54:e4:3a:ec:fb:65,245436617,360,1249,245436257,245436617
7858,5,12,149,5745,-60,-96,36,5e:29:73:5b:30:00,245448695,540,11538,245448155,245448695
7859,5,12,149,5745,-57,-96,39,3e:d1:9b:c7:a4:de,245453851,544,4612,245453307,245453851
7860,5,12,149,5745,-73,-96,23,f6:0a:5c:59:72:df,245455797,448,1498,245455349,245455797
7861,5,12,149,5745,-74,-96,22,22:ec:75:a8:8a:31,245457143,516,830,245456627,245457143
7862,5,12,149,5745,-78,-96,18,3e:ef:29:c7:4b:17,245458349,440,766,245457909,245458349
7863,5,12,149,5745,-77,-96,19,72:d1:72:1d:22:a1,245462218,452,3417,245461766,245462218
7864,5,12,149,5745,-70,-96,26,b6:90:18:f6:b1:d4,245462714,440,56,245462274,245462714
7865,5,12,149,5745,-57,-96,39,3e:d1:9b:c7:a4:de,245464539,272,1553,245464267,245464539
7866,5,12,149,5745,-78,-96,18,3e:ef:29:c7:4b:17,245466313,244,1530,245466069,245466313
7867,5,12,149,5745,-54,-96,42,f2:da:61:dd:98:c5,245469418,268,2837,245469150,245469418
7868,5,12,149,5745,-77,-96,19,56:68:e2:c2:8d:d5,245469909,476,15,245469433,245469909
7869,5,12,149,5745,-73,-96,23,a6:92:ad:b7:76:65,245473631,456,3266,245473175,245473631
7870,5,12,149,5745,-74,-96,22,fa:44:8d:e1:c7:1b,245477633,440,3562,245477193,245477633
7871,5,12,149,5745,-74,-96,22,f6:0a:5c:59:72:df,245478431,252,546,245478179,245478431
7872,5,12,149,5745,-77,-96,19,56:68:e2:c2:8d:d5,245480598,280,1887,245480318,245480598
7873,5,12,149,5745,-82,-96,14,9a:24:38:da:96:bb,245480882,272,12,245480610,245480882
7874,5,12,149,5745,-70,-96,26,b6:90:18:f6:b1:d4,245481202,244,76,245480958,245481202
7875,5,12,149,5745,-73,-96,23,a6:92:ad:b7:76:65,245498313,256,16855,245498057,245498313
7876,5,12,149,5745,-78,-96,18,72:d1:72:1d:22:a1,245499450,256,881,245499194,245499450
7877,5,12,149,5745,-61,-96,35,5e:29:73:5b:30:00,245513482,540,13492,245512942,245513482
7878,5,12,149,5745,-61,-96,35,5e:29:73:5b:30:00,245514494,272,740,245514222,245514494
7879,5,12,149,5745,-56,-96,40,3e:d1:9b:c7:a4:de,245519192,544,4154,245518648,245519192
7880,5,12,149,5745,-74,-96,22,f6:0a:5c:59:72:df,245520049,448,409,245519601,245520049
7881,5,12,149,5745,-67,-96,29,0a:b9:b7:b1:4d:fa,245521372,268,1055,245521104,245521372
7882,5,12,149,5745,-79,-96,17,3e:ef:29:c7:4b:17,245524998,440,3186,245524558,245524998
7883,5,12,149,5745,-72,-96,24,fa:44:8d:e1:c7:1b,245525662,440,224,245525222,245525662
7884,5,12,149,5745,-76,-96,20,72:d1:72:1d:22:a1,245526138,452,24,245525686,245526138
7885,5,12,149,5745,-71,-96,25,b6:90:18:f6:b1:d4,245527004,440,426,245526564,245527004
7886,5,12,149,5745,-55,-96,41,f2:da:61:dd:98:c5,245531554,268,4282,245531286,245531554
7887,5,12,149,5745,-78,-96,18,56:68:e2:c2:8d:d5,245532541,476,511,245532065,245532541
7888,5,12,149,5745,-55,-96,41,f2:da:61:dd:98:c5,245534977,268,2168,245534709,245534977
7889,5,12,149,5745,-81,-96,15,9a:24:38:da:96:bb,245537722,824,1921,245536898,245537722
7890,5,12,149,5745,-76,-96,20,a6:92:ad:b7:76:65,245538906,456,728,245538450,245538906
7891,5,12,149,5745,-74,-96,22,22:ec:75:a8:8a:31,245546164,244,7014,245545920,245546164
7892,5,12,149,5745,-72,-96,24,fa:44:8d:e1:c7:1b,245547911,244,1503,245547667,245547911
7893,5,12,149,5745,-57,-96,39,3e:d1:9b:c7:a4:de,245563903,272,15720,245563631,245563903
7894,5,24,149,5745,-89,-96,7,,245585800,28,21869,245585772,245585800
7895,5,12,149,5745,-78,-96,18,3e:ef:29:c7:4b:17,245593518,244,7474,245593274,245593518
7896,5,12,149,5745,-76,-96,20,56:68:e2:c2:8d:d5,245598413,280,4615,245598133,245598413
7897,5,24,149,5745,-89,-96,7,,245603227,28,4786,245603199,245603227
7898,5,12,149,5745,-90,-96,6,,245603481,36,218,245603445,245603481
7899,5,12,149,5745,-83,-96,13,,245603535,32,22,245603503,245603535
7900,5,12,149,5745,-83,-96,13,,245603652,44,73,245603608,245603652
7901,5,12,149,5745,-71,-96,25,b6:90:18:f6:b1:d4,245606135,244,2239,245605891,245606135
7902,5,12,149,5745,-61,-96,35,5e:29:73:5b:30:00,245613380,272,6973,245613108,245613380
7903,5,12,149,5745,-76,-96,20,72:d1:72:1d:22:a1,245617875,256,4239,245617619,245617875
7904,5,12,149,5745,-73,-96,23,a6:92:ad:b7:76:65,245622905,256,4774,245622649,245622905
7905,5,6,149,5745,-87,-96,9,54:e4:3a:ec:fb:65,245641418,360,18153,245641058,245641418
7906,5,12,149,5745,-72,-96,24,22:ec:75:a8:8a:31,245652621,244,10959,245652377,245652621
7907,5,24,149,5745,-88,-96,8,,245653113,28,464,245653085,245653113
7908,5,24,149,5745,-88,-96,8,,245653222,32,77,245653190,245653222
7909,5,12,149,5745,-56,-96,40,f2:da:61:dd:98:c5,245654342,268,852,245654074,245654342
7910,5,12,149,5745,-73,-96,23,fa:44:8d:e1:c7:1b,245661660,244,7074,245661416,245661660
7911,5,24,149,5745,-90,-96,6,,245671549,28,9861,245671521,245671549
7912,5,24,149,5745,-86,-96,10,,245671593,28,16,245671565,245671593
7913,5,24,149,5745,-87,-96,9,,245671701,32,76,245671669,245671701
7914,5,24,149,5745,-86,-96,10,,245678256,28,6527,245678228,245678256
7915,5,24,149,5745,-88,-96,8,,245678300,28,16,245678272,245678300
7916,5,12,149,5745,-57,-96,39,3e:d1:9b:c7:a4:de,245681352,272,2780,245681080,245681352
7917,5,24,149,5745,-87,-96,9,,245696024,28,14644,245695996,245696024
7918,5,24,149,5745,-86,-96,10,,245696069,28,17,245696041,245696069
7919,5,24,149,5745,-87,-96,9,,245696177,32,76,245696145,245696177
7920,5,24,149,5745,-88,-96,8,,245707974,28,11769,245707946,245707974
7921,5,12,149,5745,-79,-96,17,9a:24:38:da:96:bb,245709858,272,1612,245709586,245709858
7922,5,12,149,5745,-79,-96,17,3e:ef:29:c7:4b:17,245719739,244,9637,245719495,245719739
7923,5,12,149,5745,-71,-96,25,f6:0a:5c:59:72:df,245725886,252,5895,245725634,245725886
7924,5,12,149,5745,-62,-96,34,5e:29:73:5b:30:00,245729628,540,3202,245729088,245729628
7925,5,24,149,5745,-87,-96,9,,245734037,28,4381,245734009,245734037
7926,5,24,149,5745,-87,-96,9,,245735448,28,1383,245735420,245735448
7927,5,24,149,5745,-89,-96,7,,245736391,28,915,245736363,245736391
7928,5,24,149,5745,-89,-96,7,,245736499,32,76,245736467,245736499
7929,5,6,149,5745,-86,-96,10,54:e4:3a:ec:fb:65,245743818,360,6959,245743458,245743818
7930,5,12,149,5745,-62,-96,34,5e:29:73:5b:30:00,245744215,272,125,245743943,245744215
7931,5,24,149,5745,-89,-96,7,,245745308,28,1065,245745280,245745308
7932,5,12,149,5745,-76,-96,20,a6:92:ad:b7:76:65,245767006,256,21442,245766750,245767006
7933,5,12,149,5745,-73,-96,23,b6:90:18:f6:b1:d4,245768406,244,1156,245768162,245768406
7934,5,12,149,5745,-75,-96,21,72:d1:72:1d:22:a1,245768848,256,186,245768592,245768848
7935,5,12,149,5745,-72,-96,24,22:ec:75:a8:8a:31,245769699,244,607,245769455,245769699
7936,5,12,149,5745,-78,-96,18,56:68:e2:c2:8d:d5,245770553,280,574,245770273,245770553
7937,5,12,149,5745,-73,-96,23,fa:44:8d:e1:c7:1b,245774216,244,3419,245773972,245774216
7938,5,12,149,5745,-72,-96,24,d2:00:04:7e:2c:ab,245793312,244,18852,245793068,245793312
7939,5,12,149,5745,-59,-96,37,3e:d1:9b:c7:a4:de,245798432,272,4848,245798160,245798432
7940,5,24,149,5745,-89,-96,7,,245812813,28,14353,245812785,245812813
7941,5,12,149,5745,-78,-96,18,9a:24:38:da:96:bb,245817976,272,4891,245817704,245817976
7942,5,12,149,5745,-77,-96,19,3e:ef:29:c7:4b:17,245822112,244,3892,245821868,245822112
7943,5,12,149,5745,-61,-96,35,5e:29:73:5b:30:00,245838425,272,16041,245838153,245838425
7944,5,6,149,5745,-86,-96,10,54:e4:3a:ec:fb:65,245846219,360,7434,245845859,245846219
7945,5,12,149,5745,-58,-96,38,f2:da:61:dd:98:c5,245847037,268,550,245846769,245847037
7946,5,12,149,5745,-72,-96,24,a6:92:ad:b7:76:65,245869429,256,22136,245869173,245869429
7947,5,12,149,5745,-72,-96,24,b6:90:18:f6:b1:d4,245871045,244,1372,245870801,245871045
7948,5,12,149,5745,-75,-96,21,72:d1:72:1d:22:a1,245871550,256,249,245871294,245871550
7949,5,12,149,5745,-77,-96,19,56:68:e2:c2:8d:d5,245871894,280,64,245871614,245871894
7950,5,12,149,5745,-58,-96,38,f2:da:61:dd:98:c5,245880025,268,7863,245879757,245880025
7951,5,12,149,5745,-74,-96,22,fa:44:8d:e1:c7:1b,245883409,244,3140,245883165,245883409
7952,5,12,149,5745,-73,-96,23,fa:44:8d:e1:c7:1b,245891649,48,8192,245891601,245891649
7953,5,12,149,5745,-72,-96,24,,245891713,32,32,245891681,245891713
7954,5,24,149,5745,-89,-96,7,,245897859,32,6114,245897827,245897859
7955,5,12,149,5745,-73,-96,23,22:ec:75:a8:8a:31,245906567,244,8464,245906323,245906567
7956,5,12,149,5745,-72,-96,24,d2:00:04:7e:2c:ab,245908512,244,1701,245908268,245908512
7957,5,12,149,5745,-58,-96,38,f2:da:61:dd:98:c5,245909744,268,964,245909476,245909744
7958,5,12,149,5745,-71,-96,25,f6:0a:5c:59:72:df,245913985,448,3793,245913537,245913985
7959,5,12,149,5745,-59,-96,37,3e:d1:9b:c7:a4:de,245915289,544,760,245914745,245915289
7960,5,12,149,5745,-73,-96,23,22:ec:75:a8:8a:31,245916868,516,1063,245916352,245916868
7961,5,12,149,5745,-71,-96,25,fa:44:8d:e1:c7:1b,245918760,440,1452,245918320,245918760
7962,5,12,149,5745,-74,-96,22,72:d1:72:1d:22:a1,245919561,452,349,245919109,245919561
7963,5,12,149,5745,-77,-96,19,3e:ef:29:c7:4b:17,245921235,440,1234,245920795,245921235
7964,5,12,149,5745,-72,-96,24,d2:00:04:7e:2c:ab,245922589,440,914,245922149,245922589
7965,5,12,149,5745,-59,-96,37,3e:d1:9b:c7:a4:de,245924217,272,1356,245923945,245924217
7966,5,12,149,5745,-76,-96,20,56:68:e2:c2:8d:d5,245924523,280,26,245924243,245924523
7967,5,12,149,5745,-62,-96,34,5e:29:73:5b:30:00,245926133,540,1070,245925593,245926133
7968,5,12,149,5745,-77,-96,19,3e:ef:29:c7:4b:17,245926734,244,357,245926490,245926734
7969,5,12,149,5745,-76,-96,20,56:68:e2:c2:8d:d5,245927444,476,234,245926968,245927444
7970,5,12,149,5745,-72,-96,24,f6:0a:5c:59:72:df,245929034,252,1338,245928782,245929034
7971,5,12,149,5745,-71,-96,25,d2:00:04:7e:2c:ab,245929457,380,43,245929077,245929457
7972,5,12,149,5745,-80,-96,16,9a:24:38:da:96:bb,245929932,272,203,245929660,245929932
7973,5,12,149,5745,-80,-96,16,9a:24:38:da:96:bb,245930926,824,170,245930102,245930926
7974,5,12,149,5745,-72,-96,24,a6:92:ad:b7:76:65,245932692,456,1310,245932236,245932692
7975,5,12,149,5745,-73,-96,23,72:d1:72:1d:22:a1,245940871,256,7923,245940615,245940871
7976,5,6,149,5745,-86,-96,10,54:e4:3a:ec:fb:65,245948619,360,7388,245948259,245948619
7977,5,12,149,5745,-72,-96,24,a6:92:ad:b7:76:65,245956928,256,8053,245956672,245956928
7978,5,12,149,5745,-61,-96,35,5e:29:73:5b:30:00,245957227,272,27,245956955,245957227
7979,5,24,149,5745,-88,-96,8,,245975844,32,18585,245975812,245975844
7980,5,12,149,5745,-72,-96,24,fa:44:8d:e1:c7:1b,245984433,440,8149,245983993,245984433
7981,5,12,149,5745,-72,-96,24,fa:44:8d:e1:c7:1b,245989409,244,4732,245989165,245989409
7982,5,12,149,5745,-61,-96,35,5e:29:73:5b:30:00,245991802,540,1853,245991262,245991802
7983,5,12,149,5745,-60,-96,36,f2:da:61:dd:98:c5,245993099,268,1029,245992831,245993099
7984,5,12,149,5745,-70,-96,26,d2:00:04:7e:2c:ab,245996155,440,2616,245995715,245996155
7985,5,12,149,5745,-74,-96,22,a6:92:ad:b7:76:65,245997790,456,1179,245997334,245997790
7986,5,12,149,5745,-74,-96,22,22:ec:75:a8:8a:31,246000031,244,1997,245999787,246000031
7987,5,12,149,5745,-70,-96,26,d2:00:04:7e:2c:ab,246005909,244,5634,246005665,246005909
7988,5,12,149,5745,-58,-96,38,3e:d1:9b:c7:a4:de,246037948,272,31767,246037676,246037948
7989,5,12,149,5745,-78,-96,18,3e:ef:29:c7:4b:17,246039712,244,1520,246039468,246039712
7990,5,12,149,5745,-72,-96,24,22:ec:75:a8:8a:31,246039990,516,-238,246039474,246039990
7991,5,12,149,5745,-81,-96,15,9a:24:38:da:96:bb,246040689,272,427,246040417,246040689
7992,5,12,149,5745,-60,-96,36,f2:da:61:dd:98:c5,246042489,268,1532,246042221,246042489
7993,5,12,149,5745,-58,-96,38,3e:d1:9b:c7:a4:de,246043008,544,-25,246042464,246043008
7994,5,12,149,5745,-68,-96,28,0a:b9:b7:b1:4d:fa,246044891,268,1615,246044623,246044891
7995,5,12,149,5745,-73,-96,23,56:68:e2:c2:8d:d5,246047029,280,1858,246046749,246047029
7996,5,12,149,5745,-69,-96,27,fa:44:8d:e1:c7:1b,246050018,440,2549,246049578,246050018
7997,5,12,149,5745,-78,-96,18,3e:ef:29:c7:4b:17,246051015,440,557,246050575,246051015
7998,5,12,149,5745,-70,-96,26,a6:92:ad:b7:76:65,246054879,256,3608,246054623,246054879
7999,5,12,149,5745,-61,-96,35,5e:29:73:5b:30:00,246057282,540,1863,246056742,246057282
8000,5,12,149,5745,-70,-96,26,b6:90:18:f6:b1:d4,246060531,440,2809,246060091,246060531
8001,5,12,149,5745,-70,-96,26,d2:00:04:7e:2c:ab,246061007,440,36,246060567,246061007
8002,5,12,149,5745,-70,-96,26,a6:92:ad:b7:76:65,246063551,456,2088,246063095,246063551
8003,5,12,149,5745,-81,-96,15,9a:24:38:da:96:bb,246064419,824,44,246063595,246064419
8004,5,12,149,5745,-71,-96,25,f6:0a:5c:59:72:df,246066651,252,1980,246066399,246066651
8005,5,12,149,5745,-60,-96,36,5e:29:73:5b:30:00,246071602,272,4679,246071330,246071602
8006,5,12,149,5745,-74,-96,22,72:d1:72:1d:22:a1,246076124,256,4266,246075868,246076124
8007,5,12,149,5745,-73,-96,23,22:ec:75:a8:8a:31,246114019,244,37651,246113775,246114019
8008,5,12,149,5745,-60,-96,36,f2:da:61:dd:98:c5,246116385,268,2098,246116117,246116385
8009,5,12,149,5745,-73,-96,23,fa:44:8d:e1:c7:1b,246117394,244,765,246117150,246117394
8010,5,12,149,5745,-71,-96,25,d2:00:04:7e:2c:ab,246120876,244,3238,246120632,246120876
8011,5,12,149,5745,-71,-96,25,d2:00:04:7e:2c:ab,246122092,440,776,246121652,246122092
8012,5,12,149,5745,-62,-96,34,5e:29:73:5b:30:00,246122612,540,-20,246122072,246122612
8013,5,12,149,5745,-57,-96,39,3e:d1:9b:c7:a4:de,246137341,272,14457,246137069,246137341
8014,5,24,149,5745,-88,-96,8,,246140307,28,2938,246140279,246140307
8015,5,24,149,5745,-88,-96,8,,246140351,28,16,246140323,246140351
8016,5,6,149,5745,-86,-96,10,54:e4:3a:ec:fb:65,246153421,360,12710,246153061,246153421
8017,5,24,149,5745,-88,-96,8,,246161116,28,7667,246161088,246161116
8018,5,24,149,5745,-88,-96,8,,246161269,32,121,246161237,246161269
8019,5,24,149,5745,-89,-96,7,,246170393,28,9096,246170365,246170393
8020,5,12,149,5745,-71,-96,25,f6:0a:5c:59:72:df,246173129,252,2484,246172877,246173129
8021,5,24,149,5745,-89,-96,7,,246173860,28,703,246173832,246173860
8022,5,12,149,5745,-74,-96,22,72:d1:72:1d:22:a1,246178103,256,3987,246177847,246178103
8023,5,12,149,5745,-72,-96,24,56:68:e2:c2:8d:d5,246179194,280,811,246178914,246179194
8024,5,24,149,5745,-88,-96,8,,246184518,28,5296,246184490,246184518
8025,5,12,149,5745,-61,-96,35,5e:29:73:5b:30:00,246186249,272,1459,246185977,246186249
8026,5,24,149,5745,-89,-96,7,,246187081,28,804,246187053,246187081
8027,5,24,149,5745,-88,-96,8,,246187125,28,16,246187097,246187125
8028,5,12,149,5745,-61,-96,35,5e:29:73:5b:30:00,246187857,540,192,246187317,246187857
8029,5,24,149,5745,-89,-96,7,,246192733,32,4844,246192701,246192733
8030,5,24,149,5745,-88,-96,8,,246195766,32,3001,246195734,246195766
8031,5,24,149,5745,-88,-96,8,,246196648,32,850,246196616,246196648
8032,5,24,149,5745,-87,-96,9,,246198331,28,1655,246198303,246198331
8033,5,24,149,5745,-89,-96,7,,246209976,28,11617,246209948,246209976
8034,5,24,149,5745,-88,-96,8,,246225704,28,15700,246225676,246225704
8035,5,24,149,5745,-89,-96,7,,246226029,28,297,246226001,246226029
8036,5,12,149,5745,-74,-96,22,22:ec:75:a8:8a:31,246231194,244,4921,246230950,246231194
8037,5,12,149,5745,-78,-96,18,3e:ef:29:c7:4b:17,246231726,244,288,246231482,246231726
8038,5,24,149,5745,-90,-96,6,,246233939,28,2185,246233911,246233939
8039,5,24,149,5745,-88,-96,8,,246233983,28,16,246233955,246233983
8040,5,12,149,5745,-61,-96,35,5e:29:73:5b:30:00,246238363,540,3840,246237823,246238363
8041,5,12,149,5745,-71,-96,25,b6:90:18:f6:b1:d4,246252012,440,13209,246251572,246252012
8042,5,6,149,5745,-87,-96,9,54:e4:3a:ec:fb:65,246255821,360,3449,246255461,246255821
8043,5,12,149,5745,-60,-96,36,f2:da:61:dd:98:c5,246256358,268,269,246256090,246256358
8044,5,12,149,5745,-80,-96,16,9a:24:38:da:96:bb,246265591,272,8961,246265319,246265591
8045,5,12,149,5745,-72,-96,24,d2:00:04:7e:2c:ab,246280028,244,14193,246279784,246280028
8046,5,12,149,5745,-67,-96,29,fa:44:8d:e1:c7:1b,246280485,244,213,246280241,246280485
8047,5,12,149,5745,-72,-96,24,56:68:e2:c2:8d:d5,246282588,280,1823,246282308,246282588
8048,5,24,149,5745,-74,-96,22,,246283901,28,1285,246283873,246283901
8049,5,12,149,5745,-61,-96,35,5e:29:73:5b:30:00,246287366,272,3193,246287094,246287366
8050,5,12,149,5745,-68,-96,28,a6:92:ad:b7:76:65,246295147,256,7525,246294891,246295147
8051,5,12,149,5745,-72,-96,24,72:d1:72:1d:22:a1,246296571,256,1168,246296315,246296571
8052,5,12,149,5745,-79,-96,17,3e:ef:29:c7:4b:17,246332926,244,36111,246332682,246332926
8053,5,12,149,5745,-73,-96,23,22:ec:75:a8:8a:31,246343768,244,10598,246343524,246343768
8054,5,6,149,5745,-86,-96,10,54:e4:3a:ec:fb:65,246358222,360,14094,246357862,246358222
8055,5,12,149,5745,-60,-96,36,f2:da:61:dd:98:c5,246358975,268,485,246358707,246358975
8056,5,24,149,5745,-73,-96,23,,246360409,28,1406,246360381,246360409
8057,5,24,149,5745,-73,-96,23,,246360739,28,302,246360711,246360739
8058,5,24,149,5745,-89,-96,7,,246360891,28,124,246360863,246360891
8059,5,12,149,5745,-78,-96,18,9a:24:38:da:96:bb,246381817,272,20654,246381545,246381817
8060,5,12,149,5745,-71,-96,25,d2:00:04:7e:2c:ab,246382442,244,381,246382198,246382442
8061,5,12,149,5745,-69,-96,27,fa:44:8d:e1:c7:1b,246382837,244,151,246382593,246382837
8062,5,12,149,5745,-72,-96,24,56:68:e2:c2:8d:d5,246383115,280,-2,246382835,246383115
8063,5,12,149,5745,-59,-96,37,5e:29:73:5b:30:00,246401154,272,17767,246400882,246401154
8064,5,12,149,5745,-70,-96,26,a6:92:ad:b7:76:65,246413233,256,11823,246412977,246413233
8065,5,12,149,5745,-75,-96,21,72:d1:72:1d:22:a1,246414632,256,1143,246414376,246414632
8066,5,12,149,5745,-78,-96,18,3e:ef:29:c7:4b:17,246434835,244,19959,246434591,246434835
8067,5,24,149,5745,-89,-96,7,,246453859,28,18996,246453831,246453859
8068,5,12,149,5745,-74,-96,22,22:ec:75:a8:8a:31,246455818,244,1715,246455574,246455818
8069,5,12,149,5745,-69,-96,27,fa:44:8d:e1:c7:1b,246457260,244,1198,246457016,246457260
8070,5,6,149,5745,-82,-96,14,54:e4:3a:ec:fb:65,246460622,360,3002,246460262,246460622
8071,5,12,149,5745,-60,-96,36,f2:da:61:dd:98:c5,246461990,268,1100,246461722,246461990
8072,5,12,149,5745,-71,-96,25,d2:00:04:7e:2c:ab,246467795,244,5561,246467551,246467795
8073,5,24,149,5745,-89,-96,7,,246472568,28,4745,246472540,246472568
8074,5,24,149,5745,-87,-96,9,,246472612,28,16,246472584,246472612
8075,5,24,149,5745,-90,-96,6,,246473010,28,370,246472982,246473010
8076,5,24,149,5745,-87,-96,9,,246473054,28,16,246473026,246473054
8077,5,24,149,5745,-87,-96,9,,246473162,32,76,246473130,246473162
8078,5,12,149,5745,-82,-96,14,9a:24:38:da:96:bb,246488980,272,15546,246488708,246488980
8079,5,12,149,5745,-72,-96,24,22:ec:75:a8:8a:31,246495636,516,6140,246495120,246495636
8080,5,12,149,5745,-74,-96,22,56:68:e2:c2:8d:d5,246496429,280,513,246496149,246496429
8081,5,12,149,5745,-78,-96,18,3e:ef:29:c7:4b:17,246498346,244,1673,246498102,246498346
8082,5,12,149,5745,-60,-96,36,f2:da:61:dd:98:c5,246499534,268,920,246499266,246499534
8083,5,12,149,5745,-72,-96,24,f6:0a:5c:59:72:df,246500074,252,288,246499822,246500074
8084,5,12,149,5745,-57,-96,39,5e:29:73:5b:30:00,246501318,540,704,246500778,246501318
8085,5,24,149,5745,-90,-96,6,,246504222,28,2876,246504194,246504222
8086,5,12,149,5745,-71,-96,25,f6:0a:5c:59:72:df,246504414,448,-256,246503966,246504414
8087,5,12,149,5745,-68,-96,28,fa:44:8d:e1:c7:1b,246506202,440,1348,246505762,246506202
8088,5,12,149,5745,-58,-96,38,3e:d1:9b:c7:a4:de,246510040,544,3294,246509496,246510040
8089,5,12,149,5745,-74,-96,22,72:d1:72:1d:22:a1,246510799,452,307,246510347,246510799
8090,5,12,149,5745,-69,-96,27,a6:92:ad:b7:76:65,246512640,456,1385,246512184,246512640
8091,5,12,149,5745,-69,-96,27,a6:92:ad:b7:76:65,246513620,256,724,246513364,246513620
8092,5,12,149,5745,-75,-96,21,72:d1:72:1d:22:a1,246514407,256,531,246514151,246514407
8093,5,12,149,5745,-71,-96,25,d2:00:04:7e:2c:ab,246514924,440,77,246514484,246514924
8094,5,12,149,5745,-78,-96,18,3e:ef:29:c7:4b:17,246517793,440,2429,246517353,246517793
8095,5,12,149,5745,-74,-96,22,56:68:e2:c2:8d:d5,246518456,476,187,246517980,246518456
8096,5,24,149,5745,-89,-96,7,,246522539,28,4055,246522511,246522539
8097,5,24,149,5745,-87,-96,9,,246522691,32,120,246522659,246522691
8098,5,12,149,5745,-57,-96,39,5e:29:73:5b:30:00,246530321,272,7358,246530049,246530321
8099,5,12,149,5745,-62,-96,34,f2:da:61:dd:98:c5,246547683,268,17094,246547415,246547683
8100,5,12,149,5745,-72,-96,24,22:ec:75:a8:8a:31,246561413,516,13214,246560897,246561413
8101,5,6,149,5745,-82,-96,14,54:e4:3a:ec:fb:65,246563023,360,1250,246562663,246563023
8102,5,12,149,5745,-67,-96,29,fa:44:8d:e1:c7:1b,246563403,244,136,246563159,246563403
8103,5,12,149,5745,-64,-96,32,f2:da:61:dd:98:c5,246564842,268,1171,246564574,246564842
8104,5,12,149,5745,-57,-96,39,5e:29:73:5b:30:00,246566575,540,1193,246566035,246566575
8105,5,12,149,5745,-73,-96,23,f6:0a:5c:59:72:df,246567239,448,216,246566791,246567239
8106,5,12,149,5745,-64,-96,32,0a:b9:b7:b1:4d:fa,246570908,268,3401,246570640,246570908
8107,5,12,149,5745,-68,-96,28,fa:44:8d:e1:c7:1b,246571453,440,105,246571013,246571453
8108,5,12,149,5745,-73,-96,23,72:d1:72:1d:22:a1,246574466,452,2561,246574014,246574466
8109,5,12,149,5745,-60,-96,36,3e:d1:9b:c7:a4:de,246575752,544,742,246575208,246575752
8110,5,12,149,5745,-67,-96,29,a6:92:ad:b7:76:65,246577608,456,1400,246577152,246577608
8111,5,12,149,5745,-71,-96,25,22:ec:75:a8:8a:31,246578305,244,453,246578061,246578305
8112,5,12,149,5745,-70,-96,26,d2:00:04:7e:2c:ab,246579359,244,810,246579115,246579359
8113,5,12,149,5745,-69,-96,27,d2:00:04:7e:2c:ab,246580917,440,1118,246580477,246580917
8114,5,12,149,5745,-75,-96,21,56:68:e2:c2:8d:d5,246581409,476,16,246580933,246581409
8115,5,12,149,5745,-78,-96,18,3e:ef:29:c7:4b:17,246581948,440,99,246581508,246581948
8116,5,12,149,5745,-70,-96,26,b6:90:18:f6:b1:d4,246585033,440,2645,246584593,246585033
8117,5,12,149,5745,-88,-96,8,9a:24:38:da:96:bb,246586078,824,221,246585254,246586078
8118,5,12,149,5745,-75,-96,21,56:68:e2:c2:8d:d5,246594733,280,8375,246594453,246594733
8119,5,12,149,5745,-88,-96,8,9a:24:38:da:96:bb,246601156,272,6151,246600884,246601156
8120,5,12,149,5745,-78,-96,18,3e:ef:29:c7:4b:17,246613633,244,12233,246613389,246613633
8121,5,12,149,5745,-58,-96,38,5e:29:73:5b:30:00,246632081,540,17908,246631541,246632081
8122,5,12,149,5745,-72,-96,24,f6:0a:5c:59:72:df,246633818,252,1485,246633566,246633818
8123,5,12,149,5745,-70,-96,26,a6:92:ad:b7:76:65,246640748,256,6674,246640492,246640748
8124,5,12,149,5745,-75,-96,21,72:d1:72:1d:22:a1,246641038,256,34,246640782,246641038
8125,5,12,149,5745,-59,-96,37,5e:29:73:5b:30:00,246645050,272,3740,246644778,246645050
8126,5,12,149,5745,-69,-96,27,d2:00:04:7e:2c:ab,246646445,440,955,246646005,246646445
8127,5,6,149,5745,-84,-96,12,54:e4:3a:ec:fb:65,246665423,360,18618,246665063,246665423
8128,5,12,149,5745,-64,-96,32,f2:da:61:dd:98:c5,246666360,268,669,246666092,246666360
8129,5,24,149,5745,-89,-96,7,,246677985,28,11597,246677957,246677985
8130,5,12,149,5745,-68,-96,28,fa:44:8d:e1:c7:1b,246682576,244,4347,246682332,246682576
8131,5,12,149,5745,-71,-96,25,22:ec:75:a8:8a:31,246685681,244,2861,246685437,246685681
8132,5,12,149,5745,-70,-96,26,d2:00:04:7e:2c:ab,246704765,244,18840,246704521,246704765
8133,5,12,149,5745,-81,-96,15,9a:24:38:da:96:bb,246713661,272,8624,246713389,246713661
8134,5,12,149,5745,-60,-96,36,5e:29:73:5b:30:00,246742931,272,28998,246742659,246742931
8135,5,12,149,5745,-79,-96,17,3e:ef:29:c7:4b:17,246743961,244,786,246743717,246743961
8136,5,24,149,5745,-87,-96,9,,246747021,28,3032,246746993,246747021
8137,5,24,149,5745,-90,-96,6,,246747130,32,77,246747098,246747130
8138,5,6,149,5745,-86,-96,10,54:e4:3a:ec:fb:65,246767824,360,20334,246767464,246767824
8139,5,12,149,5745,-60,-96,36,f2:da:61:dd:98:c5,246784587,268,16495,246784319,246784587
8140,5,12,149,5745,-69,-96,27,a6:92:ad:b7:76:65,246791521,256,6678,246791265,246791521
8141,5,12,149,5745,-76,-96,20,72:d1:72:1d:22:a1,246792885,256,1108,246792629,246792885
8142,5,12,149,5745,-74,-96,22,56:68:e2:c2:8d:d5,246794184,280,1019,246793904,246794184
8143,5,12,149,5745,-67,-96,29,fa:44:8d:e1:c7:1b,246796576,244,2148,246796332,246796576
8144,5,12,149,5745,-72,-96,24,22:ec:75:a8:8a:31,246802736,244,5916,246802492,246802736
8145,5,12,149,5745,-70,-96,26,d2:00:04:7e:2c:ab,246804250,244,1270,246804006,246804250
8146,5,12,149,5745,-54,-96,42,3e:d1:9b:c7:a4:de,246820634,272,16112,246820362,246820634
8147,5,12,149,5745,-82,-96,14,9a:24:38:da:96:bb,246829186,272,8280,246828914,246829186
8148,5,12,149,5745,-77,-96,19,3e:ef:29:c7:4b:17,246845284,244,15854,246845040,246845284
8149,5,12,149,5745,-55,-96,41,5e:29:73:5b:30:00,246859141,272,13585,246858869,246859141
8150,5,6,149,5745,-88,-96,8,54:e4:3a:ec:fb:65,246870224,360,10723,246869864,246870224
8151,5,12,149,5745,-74,-96,22,a6:92:ad:b7:76:65,246889861,256,19381,246889605,246889861
8152,5,12,149,5745,-78,-96,18,72:d1:72:1d:22:a1,246894178,256,4061,246893922,246894178
8153,5,12,149,5745,-75,-96,21,56:68:e2:c2:8d:d5,246895278,280,820,246894998,246895278
8154,5,24,149,5745,-89,-96,7,,246900766,28,5460,246900738,246900766
8155,5,12,149,5745,-59,-96,37,f2:da:61:dd:98:c5,246902853,268,1819,246902585,246902853
8156,5,12,149,5745,-69,-96,27,fa:44:8d:e1:c7:1b,246906446,244,3349,246906202,246906446
8157,5,12,149,5745,-74,-96,22,22:ec:75:a8:8a:31,246913952,244,7262,246913708,246913952
8158,5,24,149,5745,-89,-96,7,,246918813,28,4833,246918785,246918813
8159,5,12,149,5745,-71,-96,25,d2:00:04:7e:2c:ab,246926415,244,7358,246926171,246926415
8160,5,24,149,5745,-88,-96,8,,246931379,28,4936,246931351,246931379
8161,5,24,149,5745,-86,-96,10,,246931488,32,77,246931456,246931488
8162,5,12,149,5745,-81,-96,15,9a:24:38:da:96:bb,246938299,272,6539,246938027,246938299
8163,5,12,149,5745,-76,-96,20,56:68:e2:c2:8d:d5,246941712,280,3133,246941432,246941712
8164,5,12,149,5745,-72,-96,24,f6:0a:5c:59:72:df,246952449,252,10485,246952197,246952449
8165,5,12,149,5745,-55,-96,41,3e:d1:9b:c7:a4:de,246955516,272,2795,246955244,246955516
8166,5,12,149,5745,-73,-96,23,22:ec:75:a8:8a:31,246956141,516,109,246955625,246956141
8167,5,12,149,5745,-77,-96,19,72:d1:72:1d:22:a1,246957395,256,998,246957139,246957395
8168,5,12,149,5745,-76,-96,20,3e:ef:29:c7:4b:17,246957694,244,55,246957450,246957694
8169,5,24,149,5745,-87,-96,9,,246958818,28,1096,246958790,246958818
8170,5,24,149,5745,-87,-96,9,,246960061,28,1215,246960033,246960061
8171,5,12,149,5745,-72,-96,24,f6:0a:5c:59:72:df,246960486,448,-23,246960038,246960486
8172,5,24,149,5745,-87,-96,9,,246962190,28,1676,246962162,246962190
8173,5,24,149,5745,-86,-96,10,,246962302,32,80,246962270,246962302
8174,5,12,149,5745,-76,-96,20,72:d1:72:1d:22:a1,246964210,452,1456,246963758,246964210
8175,5,12,149,5745,-61,-96,35,f2:da:61:dd:98:c5,246965245,268,767,246964977,246965245
8176,5,12,149,5745,-60,-96,36,5e:29:73:5b:30:00,246965574,540,-211,246965034,246965574
8177,5,12,149,5745,-69,-96,27,fa:44:8d:e1:c7:1b,246966175,440,161,246965735,246966175
8178,5,12,149,5745,-54,-96,42,3e:d1:9b:c7:a4:de,246969403,544,2684,246968859,246969403
8179,5,12,149,5745,-71,-96,25,a6:92:ad:b7:76:65,246971106,456,1247,246970650,246971106
8180,5,12,149,5745,-72,-96,24,a6:92:ad:b7:76:65,246972352,256,990,246972096,246972352
8181,5,6,149,5745,-85,-96,11,54:e4:3a:ec:fb:65,246972624,360,-88,246972264,246972624
8182,5,12,149,5745,-71,-96,25,d2:00:04:7e:2c:ab,246973568,380,564,246973188,246973568
8183,5,12,149,5745,-54,-96,42,9e:1f:b0:a7:b8:90,246974028,416,44,246973612,246974028
8184,5,12,149,5745,-76,-96,20,3e:ef:29:c7:4b:17,246976063,440,1595,246975623,246976063
8185,5,12,149,5745,-59,-96,37,5e:29:73:5b:30:00,246989038,272,12703,246988766,246989038
8186,5,24,149,5745,-86,-96,10,,246990384,28,1318,246990356,246990384
8187,5,24,149,5745,-86,-96,10,,246990493,32,77,246990461,246990493
8188,5,12,149,5745,-59,-96,37,f2:da:61:dd:98:c5,247006577,268,15816,247006309,247006577
8189,5,24,149,5745,-86,-96,10,,247009543,28,2938,247009515,247009543
8190,5,24,149,5745,-85,-96,11,,247012500,28,2929,247012472,247012500
8191,5,24,149,5745,-87,-96,9,,247012609,32,77,247012577,247012609
8192,5,12,149,5745,-69,-96,27,d2:00:04:7e:2c:ab,247021219,244,8366,247020975,247021219
8193,5,12,149,5745,-68,-96,28,fa:44:8d:e1:c7:1b,247021517,244,54,247021273,247021517
8194,5,12,149,5745,-54,-96,42,9e:1f:b0:a7:b8:90,247021795,456,-178,247021339,247021795
8195,5,12,149,5745,-66,-96,30,fa:44:8d:e1:c7:1b,247030007,440,7772,247029567,247030007
8196,5,12,149,5745,-71,-96,25,22:ec:75:a8:8a:31,247031825,244,1574,247031581,247031825
8197,5,12,149,5745,-70,-96,26,a6:92:ad:b7:76:65,247036243,456,3962,247035787,247036243
8198,5,24,149,5745,-88,-96,8,,247037761,28,1490,247037733,247037761
8199,5,24,149,5745,-89,-96,7,,247037805,28,16,247037777,247037805
8200,5,12,149,5745,-69,-96,27,b6:90:18:f6:b1:d4,247038146,440,-99,247037706,247038146
8201,5,12,149,5745,-69,-96,27,d2:00:04:7e:2c:ab,247039891,440,1305,247039451,247039891
8202,5,12,149,5745,-54,-96,42,9e:1f:b0:a7:b8:90,247040968,288,789,247040680,247040968
8203,5,24,149,5745,-88,-96,8,,247052891,32,11891,247052859,247052891
8204,5,12,149,5745,-54,-96,42,3e:d1:9b:c7:a4:de,247052976,272,-187,247052704,247052976
8205,5,12,149,5745,-75,-96,21,56:68:e2:c2:8d:d5,247057575,280,4319,247057295,247057575
8206,5,12,149,5745,-77,-96,19,3e:ef:29:c7:4b:17,247063935,244,6116,247063691,247063935
8207,5,12,149,5745,-70,-96,26,b6:90:18:f6:b1:d4,247070723,244,6544,247070479,247070723
8208,5,6,149,5745,-85,-96,11,54:e4:3a:ec:fb:65,247075025,360,3942,247074665,247075025
8209,5,24,149,5745,-88,-96,8,,247077478,28,2425,247077450,247077478
8210,5,12,149,5745,-72,-96,24,72:d1:72:1d:22:a1,247084399,256,6665,247084143,247084399
8211,5,12,149,5745,-73,-96,23,a6:92:ad:b7:76:65,247087083,256,2428,247086827,247087083
8212,5,12,149,5745,-72,-96,24,22:ec:75:a8:8a:31,247088417,516,818,247087901,247088417
8213,5,12,149,5745,-58,-96,38,9e:1f:b0:a7:b8:90,247095209,424,6368,247094785,247095209
8214,5,12,149,5745,-68,-96,28,fa:44:8d:e1:c7:1b,247095685,440,36,247095245,247095685
8215,5,12,149,5745,-59,-96,37,5e:29:73:5b:30:00,247096214,540,-11,247095674,247096214
8216,5,12,149,5745,-62,-96,34,f2:da:61:dd:98:c5,247096825,268,343,247096557,247096825
8217,5,12,149,5745,-66,-96,30,0a:b9:b7:b1:4d:fa,247098073,268,980,247097805,247098073
8218,5,12,149,5745,-54,-96,42,3e:d1:9b:c7:a4:de,247100186,544,1569,247099642,247100186
8219,5,12,149,5745,-72,-96,24,a6:92:ad:b7:76:65,247101772,456,1130,247101316,247101772
8220,5,12,149,5745,-60,-96,36,5e:29:73:5b:30:00,247103792,272,1748,247103520,247103792
8221,5,12,149,5745,-69,-96,27,d2:00:04:7e:2c:ab,247105106,440,874,247104666,247105106
8222,5,12,149,5745,-79,-96,17,3e:ef:29:c7:4b:17,247105771,440,225,247105331,247105771
8223,5,24,149,5745,-90,-96,6,,247113246,32,7443,247113214,247113246
8224,5,24,149,5745,-90,-96,6,,247117215,28,3941,247117187,247117215
8225,5,12,149,5745,-69,-96,27,fa:44:8d:e1:c7:1b,247119862,244,2403,247119618,247119862
8226,5,12,149,5745,-61,-96,35,f2:da:61:dd:98:c5,247121166,268,1036,247120898,247121166
8227,5,24,149,5745,-90,-96,6,,247122196,28,1002,247122168,247122196
8228,5,12,149,5745,-80,-96,16,9a:24:38:da:96:bb,247129943,272,7475,247129671,247129943
8229,5,24,149,5745,-89,-96,7,,247132457,28,2486,247132429,247132457
8230,5,24,149,5745,-89,-96,7,,247132565,32,76,247132533,247132565
8231,5,12,149,5745,-69,-96,27,d2:00:04:7e:2c:ab,247136961,244,4152,247136717,247136961
8232,5,12,149,5745,-74,-96,22,22:ec:75:a8:8a:31,247146324,244,9119,247146080,247146324
8233,5,24,149,5745,-89,-96,7,,247147481,28,1129,247147453,247147481
8234,5,12,149,5745,-61,-96,35,9e:1f:b0:a7:b8:90,247155585,256,7848,247155329,247155585
8235,5,12,149,5745,-56,-96,40,3e:d1:9b:c7:a4:de,247170272,272,14415,247170000,247170272
8236,5,12,149,5745,-71,-96,25,d2:00:04:7e:2c:ab,247170615,440,-97,247170175,247170615
8237,5,6,149,5745,-85,-96,11,54:e4:3a:ec:fb:65,247177426,360,6451,247177066,247177426
8238,5,12,149,5745,-61,-96,35,9e:1f:b0:a7:b8:90,247180431,452,2553,247179979,247180431
8239,5,24,149,5745,-90,-96,6,,247187579,28,7120,247187551,247187579
8240,5,12,149,5745,-73,-96,23,b6:90:18:f6:b1:d4,247190928,244,3105,247190684,247190928
8241,5,12,149,5745,-74,-96,22,72:d1:72:1d:22:a1,247197170,256,5986,247196914,247197170
8242,5,12,149,5745,-81,-96,15,3e:ef:29:c7:4b:17,247197487,244,73,247197243,247197487
8243,5,24,149,5745,-88,-96,8,,247199447,32,1928,247199415,247199447
8244,5,12,149,5745,-73,-96,23,56:68:e2:c2:8d:d5,247204023,280,4296,247203743,247204023
8245,5,12,149,5745,-57,-96,39,5e:29:73:5b:30:00,247204355,272,60,247204083,247204355
8246,5,12,149,5745,-72,-96,24,a6:92:ad:b7:76:65,247204669,256,58,247204413,247204669
8247,5,12,149,5745,-83,-96,13,9a:24:38:da:96:bb,247242904,272,37963,247242632,247242904
8248,5,12,149,5745,-73,-96,23,d2:00:04:7e:2c:ab,247257030,244,13882,247256786,247257030
8249,5,12,149,5745,-71,-96,25,22:ec:75:a8:8a:31,247262407,244,5133,247262163,247262407
8250,5,6,149,5745,-81,-96,15,54:e4:3a:ec:fb:65,247279826,360,17059,247279466,247279826
8251,5,12,149,5745,-58,-96,38,9e:1f:b0:a7:b8:90,247280275,256,193,247280019,247280275
8252,5,12,149,5745,-57,-96,39,f2:da:61:dd:98:c5,247280687,268,144,247280419,247280687
8253,5,12,149,5745,-56,-96,40,3e:d1:9b:c7:a4:de,247286565,272,5606,247286293,247286565
8254,5,24,149,5745,-90,-96,6,,247294983,28,8390,247294955,247294983
8255,5,12,149,5745,-70,-96,26,b6:90:18:f6:b1:d4,247303464,244,8237,247303220,247303464
8256,5,12,149,5745,-73,-96,23,fa:44:8d:e1:c7:1b,247304988,244,1280,247304744,247304988
8257,5,12,149,5745,-76,-96,20,56:68:e2:c2:8d:d5,247306571,280,1303,247306291,247306571
8258,5,12,149,5745,-77,-96,19,72:d1:72:1d:22:a1,247309452,256,2625,247309196,247309452
8259,5,24,149,5745,-90,-96,6,,247312843,28,3363,247312815,247312843
8260,5,12,149,5745,-72,-96,24,a6:92:ad:b7:76:65,247315420,256,2321,247315164,247315420
8261,5,12,149,5745,-61,-96,35,5e:29:73:5b:30:00,247321984,272,6292,247321712,247321984
8262,5,24,149,5745,-89,-96,7,,247330824,28,8812,247330796,247330824
8263,5,24,149,5745,-89,-96,7,,247330932,32,76,247330900,247330932
8264,5,24,149,5745,-88,-96,8,,247357779,28,26819,247357751,247357779
8265,5,12,149,5745,-78,-96,18,3e:ef:29:c7:4b:17,247358123,244,100,247357879,247358123
8266,5,12,149,5745,-77,-96,19,9a:24:38:da:96:bb,247358484,272,89,247358212,247358484
8267,5,24,149,5745,-87,-96,9,,247361141,28,2629,247361113,247361141
8268,5,24,149,5745,-89,-96,7,,247361249,32,76,247361217,247361249
8269,5,24,149,5745,-87,-96,9,,247362911,28,1634,247362883,247362911
8270,5,24,149,5745,-88,-96,8,,247363019,32,76,247362987,247363019
8271,5,12,149,5745,-71,-96,25,22:ec:75:a8:8a:31,247380557,244,17294,247380313,247380557
8272,5,6,149,5745,-86,-96,10,54:e4:3a:ec:fb:65,247382227,360,1310,247381867,247382227
8273,5,12,149,5745,-58,-96,38,f2:da:61:dd:98:c5,247383013,268,518,247382745,247383013
8274,5,12,149,5745,-57,-96,39,9e:1f:b0:a7:b8:90,247393470,256,10201,247393214,247393470
8275,5,12,149,5745,-61,-96,35,3e:d1:9b:c7:a4:de,247404211,272,10469,247403939,247404211
8276,5,12,149,5745,-72,-96,24,fa:44:8d:e1:c7:1b,247406794,244,2339,247406550,247406794
8277,5,12,149,5745,-74,-96,22,d2:00:04:7e:2c:ab,247407152,244,114,247406908,247407152
8278,5,12,149,5745,-81,-96,15,56:68:e2:c2:8d:d5,247407431,280,-1,247407151,247407431
8279,5,12,149,5745,-68,-96,28,b6:90:18:f6:b1:d4,247416318,244,8643,247416074,247416318
8280,5,12,149,5745,-78,-96,18,72:d1:72:1d:22:a1,247419225,256,2651,247418969,247419225
8281,5,24,149,5745,-89,-96,7,,247419731,32,474,247419699,247419731
8282,5,12,149,5745,-76,-96,20,f6:0a:5c:59:72:df,247425351,252,5368,247425099,247425351
8283,5,12,149,5745,-60,-96,36,5e:29:73:5b:30:00,247437699,272,12076,247437427,247437699
8284,5,24,149,5745,-89,-96,7,,247442891,28,5164,247442863,247442891
8285,5,24,149,5745,-89,-96,7,,247452534,28,9615,247452506,247452534
8286,5,12,149,5745,-78,-96,18,3e:ef:29:c7:4b:17,247460514,244,7736,247460270,247460514
8287,5,12,149,5745,-89,-96,7,40:e3:d6:de:16:10,247471001,960,9527,247470041,247471001
8288,5,6,149,5745,-85,-96,11,54:e4:3a:ec:fb:65,247484627,360,13266,247484267,247484627
8289,5,12,149,5745,-60,-96,36,f2:da:61:dd:98:c5,247486007,268,1112,247485739,247486007
8290,5,12,149,5745,-71,-96,25,22:ec:75:a8:8a:31,247492460,244,6209,247492216,247492460
8291,5,12,149,5745,-73,-96,23,a6:92:ad:b7:76:65,247507266,256,14550,247507010,247507266
8292,5,12,149,5745,-72,-96,24,fa:44:8d:e1:c7:1b,247509016,244,1506,247508772,247509016
8293,5,12,149,5745,-73,-96,23,d2:00:04:7e:2c:ab,247509384,244,124,247509140,247509384
8294,5,12,149,5745,-75,-96,21,56:68:e2:c2:8d:d5,247510488,280,824,247510208,247510488
8295,5,12,149,5745,-58,-96,38,3e:d1:9b:c7:a4:de,247516231,272,5471,247515959,247516231
8296,5,24,149,5745,-88,-96,8,,247520556,28,4297,247520528,247520556
8297,5,24,149,5745,-87,-96,9,,247520664,32,76,247520632,247520664
8298,5,12,149,5745,-73,-96,23,a6:92:ad:b7:76:65,247522129,256,1209,247521873,247522129
8299,5,12,149,5745,-78,-96,18,72:d1:72:1d:22:a1,247525427,256,3042,247525171,247525427
8300,5,12,149,5745,-67,-96,29,b6:90:18:f6:b1:d4,247525808,244,137,247525564,247525808
8301,5,24,149,5745,-89,-96,7,,247530612,32,4772,247530580,247530612
8302,5,12,149,5745,-79,-96,17,3e:ef:29:c7:4b:17,247531886,244,1030,247531642,247531886
8303,5,24,149,5745,-87,-96,9,,247538807,28,6893,247538779,247538807
8304,5,12,149,5745,-58,-96,38,9e:1f:b0:a7:b8:90,247539321,356,158,247538965,247539321
8305,5,12,149,5745,-72,-96,24,22:ec:75:a8:8a:31,247544674,516,4837,247544158,247544674
8306,5,24,149,5745,-87,-96,9,,247548877,28,4175,247548849,247548877
8307,5,12,149,5745,-72,-96,24,f6:0a:5c:59:72:df,247551327,448,2002,247550879,247551327
8308,5,24,149,5745,-86,-96,10,,247552106,32,747,247552074,247552106
8309,5,12,149,5745,-59,-96,37,5e:29:73:5b:30:00,247552855,540,209,247552315,247552855
8310,5,12,149,5745,-70,-96,26,fa:44:8d:e1:c7:1b,247554635,440,1340,247554195,247554635
8311,5,12,149,5745,-60,-96,36,f2:da:61:dd:98:c5,247555582,268,679,247555314,247555582
8312,5,12,149,5745,-56,-96,40,3e:d1:9b:c7:a4:de,247559700,544,3574,247559156,247559700
8313,5,12,149,5745,-70,-96,26,a6:92:ad:b7:76:65,247561994,456,1838,247561538,247561994
8314,5,12,149,5745,-59,-96,37,5e:29:73:5b:30:00,247562957,272,691,247562685,247562957
8315,5,12,149,5745,-60,-96,36,f2:da:61:dd:98:c5,247563814,268,589,247563546,247563814
8316,5,12,149,5745,-73,-96,23,d2:00:04:7e:2c:ab,247564116,440,-138,247563676,247564116
8317,5,12,149,5745,-74,-96,22,56:68:e2:c2:8d:d5,247568514,476,3922,247568038,247568514
8318,5,12,149,5745,-79,-96,17,72:d1:72:1d:22:a1,247569025,452,59,247568573,247569025
8319,5,12,149,5745,-57,-96,39,9e:1f:b0:a7:b8:90,247572914,452,3437,247572462,247572914
8320,5,12,149,5745,-66,-96,30,b6:90:18:f6:b1:d4,247576865,440,3511,247576425,247576865
8321,5,24,149,5745,-87,-96,9,,247580275,28,3382,247580247,247580275
8322,5,12,149,5745,-80,-96,16,3e:ef:29:c7:4b:17,247580772,440,57,247580332,247580772
8323,5,24,149,5745,-87,-96,9,,247585026,32,4222,247584994,247585026
8324,5,6,149,5745,-85,-96,11,54:e4:3a:ec:fb:65,247587028,360,1642,247586668,247587028
8325,5,12,149,5745,-73,-96,23,d2:00:04:7e:2c:ab,247595630,244,8358,247595386,247595630
8326,5,12,149,5745,-71,-96,25,22:ec:75:a8:8a:31,247609998,516,13852,247609482,247609998
8327,5,12,149,5745,-74,-96,22,56:68:e2:c2:8d:d5,247610576,280,298,247610296,247610576
8328,5,24,149,5745,-88,-96,8,,247612866,28,2262,247612838,247612866
8329,5,12,149,5745,-56,-96,40,9e:1f:b0:a7:b8:90,247614305,256,1183,247614049,247614305
8330,5,12,149,5745,-70,-96,26,f6:0a:5c:59:72:df,247615145,448,392,247614697,247615145
8331,5,24,149,5745,-89,-96,7,,247615816,32,639,247615784,247615816
8332,5,12,149,5745,-78,-96,18,72:d1:72:1d:22:a1,247618060,452,1792,247617608,247618060
8333,5,12,149,5745,-58,-96,38,5e:29:73:5b:30:00,247618582,540,-18,247618042,247618582
8334,5,12,149,5745,-56,-96,40,9e:1f:b0:a7:b8:90,247619195,356,257,247618839,247619195
8335,5,12,149,5745,-60,-96,36,f2:da:61:dd:98:c5,247619613,268,150,247619345,247619613
8336,5,12,149,5745,-69,-96,27,fa:44:8d:e1:c7:1b,247619924,440,-129,247619484,247619924
8337,5,12,149,5745,-65,-96,31,0a:b9:b7:b1:4d:fa,247621811,268,1619,247621543,247621811
8338,5,12,149,5745,-56,-96,40,3e:d1:9b:c7:a4:de,247624381,544,2026,247623837,247624381
8339,5,24,149,5745,-87,-96,9,,247625218,28,809,247625190,247625218
8340,5,12,149,5745,-65,-96,31,b6:90:18:f6:b1:d4,247625545,440,-113,247625105,247625545
8341,5,12,149,5745,-69,-96,27,a6:92:ad:b7:76:65,247626091,456,90,247625635,247626091
8342,5,12,149,5745,-71,-96,25,22:ec:75:a8:8a:31,247627184,244,849,247626940,247627184
8343,5,12,149,5745,-66,-96,30,b6:90:18:f6:b1:d4,247628377,244,949,247628133,247628377
8344,5,12,149,5745,-73,-96,23,d2:00:04:7e:2c:ab,247628774,440,-43,247628334,247628774
8345,5,12,149,5745,-81,-96,15,3e:ef:29:c7:4b:17,247630096,440,882,247629656,247630096
8346,5,12,149,5745,-73,-96,23,56:68:e2:c2:8d:d5,247634620,476,4048,247634144,247634620
8347,5,12,149,5745,-72,-96,24,f6:0a:5c:59:72:df,247636075,252,1203,247635823,247636075
8348,5,12,149,5745,-55,-96,41,9e:1f:b0:a7:b8:90,247636693,452,166,247636241,247636693
8349,5,12,149,5745,-58,-96,38,3e:d1:9b:c7:a4:de,247643623,272,6658,247643351,247643623
8350,5,12,149,5745,-70,-96,26,a6:92:ad:b7:76:65,247644231,256,352,247643975,247644231
8351,5,12,149,5745,-78,-96,18,72:d1:72:1d:22:a1,247645153,256,666,247644897,247645153
8352,5,12,149,5745,-80,-96,16,3e:ef:29:c7:4b:17,247645642,244,245,247645398,247645642
8353,5,12,149,5745,-58,-96,38,5e:29:73:5b:30:00,247661866,272,15952,247661594,247661866
8354,5,12,149,5745,-58,-96,38,f2:da:61:dd:98:c5,247689534,268,27400,247689266,247689534
8355,5,12,149,5745,-82,-96,14,9a:24:38:da:96:bb,247690577,272,771,247690305,247690577
8356,5,12,149,5745,-72,-96,24,d2:00:04:7e:2c:ab,247694724,440,3707,247694284,247694724
8357,5,12,149,5745,-54,-96,42,9e:1f:b0:a7:b8:90,247700099,452,4923,247699647,247700099
8358,5,12,149,5745,-71,-96,25,fa:44:8d:e1:c7:1b,247700774,244,431,247700530,247700774
8359,5,12,149,5745,-72,-96,24,d2:00:04:7e:2c:ab,247709289,244,8271,247709045,247709289
8360,5,12,149,5745,-69,-96,27,22:ec:75:a8:8a:31,247725542,244,16009,247725298,247725542
8361,5,12,149,5745,-54,-96,42,9e:1f:b0:a7:b8:90,247727341,256,1543,247727085,247727341
8362,5,12,149,5745,-71,-96,25,56:68:e2:c2:8d:d5,247728486,280,865,247728206,247728486
8363,5,12,149,5745,-57,-96,39,3e:d1:9b:c7:a4:de,247745908,272,17150,247745636,247745908
8364,5,12,149,5745,-68,-96,28,22:ec:75:a8:8a:31,247761055,516,14631,247760539,247761055
8365,5,12,149,5745,-76,-96,20,3e:ef:29:c7:4b:17,247769490,244,8191,247769246,247769490
8366,5,12,149,5745,-58,-96,38,5e:29:73:5b:30:00,247778567,272,8805,247778295,247778567
8367,5,6,149,5745,-87,-96,9,54:e4:3a:ec:fb:65,247791829,360,12902,247791469,247791829
8368,5,12,149,5745,-72,-96,24,f6:0a:5c:59:72:df,247796207,252,4126,247795955,247796207
8369,5,12,149,5745,-57,-96,39,f2:da:61:dd:98:c5,247797446,268,971,247797178,247797446
8370,5,12,149,5745,-83,-96,13,9a:24:38:da:96:bb,247807998,272,10280,247807726,247807998
8371,5,24,149,5745,-88,-96,8,,247812809,28,4783,247812781,247812809
8372,5,12,149,5745,-67,-96,29,fa:44:8d:e1:c7:1b,247814438,244,1385,247814194,247814438
8373,5,24,149,5745,-89,-96,7,,247814728,28,262,247814700,247814728
8374,5,12,149,5745,-69,-96,27,a6:92:ad:b7:76:65,247815019,256,35,247814763,247815019
8375,5,12,149,5745,-80,-96,16,72:d1:72:1d:22:a1,247816802,256,1527,247816546,247816802
8376,5,12,149,5745,-66,-96,30,b6:90:18:f6:b1:d4,247818352,244,1306,247818108,247818352
8377,5,12,149,5745,-74,-96,22,d2:00:04:7e:2c:ab,247822467,244,3871,247822223,247822467
8378,5,12,149,5745,-67,-96,29,22:ec:75:a8:8a:31,247826615,516,3632,247826099,247826615
8379,5,12,149,5745,-68,-96,28,22:ec:75:a8:8a:31,247839897,244,13038,247839653,247839897
8380,5,24,149,5745,-88,-96,8,,247857604,32,17675,247857572,247857604
8381,5,12,149,5745,-53,-96,43,3e:d1:9b:c7:a4:de,247862876,272,5000,247862604,247862876
8382,5,24,149,5745,-88,-96,8,,247870219,28,7315,247870191,247870219
8383,5,12,149,5745,-73,-96,23,f6:0a:5c:59:72:df,247874032,252,3561,247873780,247874032
8384,5,12,149,5745,-75,-96,21,3e:ef:29:c7:4b:17,247882654,244,8378,247882410,247882654
8385,5,24,149,5745,-89,-96,7,,247888624,28,5942,247888596,247888624
8386,5,6,149,5745,-85,-96,11,54:e4:3a:ec:fb:65,247894229,360,5245,247893869,247894229
8387,5,12,149,5745,-56,-96,40,9e:1f:b0:a7:b8:90,247895100,256,615,247894844,247895100
8388,5,12,149,5745,-60,-96,36,5e:29:73:5b:30:00,247896144,272,772,247895872,247896144
8389,5,12,149,5745,-54,-96,42,f2:da:61:dd:98:c5,247907590,268,11178,247907322,247907590
8390,5,12,149,5745,-82,-96,14,9a:24:38:da:96:bb,247914688,272,6826,247914416,247914688
8391,5,12,149,5745,-73,-96,23,a6:92:ad:b7:76:65,247917268,256,2324,247917012,247917268
8392,5,12,149,5745,-69,-96,27,b6:90:18:f6:b1:d4,247918413,244,901,247918169,247918413
8393,5,12,149,5745,-75,-96,21,72:d1:72:1d:22:a1,247918952,256,283,247918696,247918952
8394,5,12,149,5745,-73,-96,23,56:68:e2:c2:8d:d5,247919978,280,746,247919698,247919978
8395,5,12,149,5745,-67,-96,29,fa:44:8d:e1:c7:1b,247927633,244,7411,247927389,247927633
8396,5,12,149,5745,-76,-96,20,d2:00:04:7e:2c:ab,247935504,244,7627,247935260,247935504
8397,5,12,149,5745,-69,-96,27,22:ec:75:a8:8a:31,247946727,244,10979,247946483,247946727
8398,5,12,149,5745,-56,-96,40,9e:1f:b0:a7:b8:90,247954215,256,7232,247953959,247954215
8399,5,12,149,5745,-72,-96,24,56:68:e2:c2:8d:d5,247954991,280,496,247954711,247954991
8400,5,24,149,5745,-90,-96,6,,247957364,28,2345,247957336,247957364
8401,5,24,149,5745,-90,-96,6,,247957637,28,245,247957609,247957637
8402,5,24,149,5745,-88,-96,8,,247957681,28,16,247957653,247957681
8403,5,24,149,5745,-88,-96,8,,247960505,28,2796,247960477,247960505
8404,5,24,149,5745,-90,-96,6,,247960550,28,17,247960522,247960550
8405,5,24,149,5745,-89,-96,7,,247972365,32,11783,247972333,247972365
8406,5,12,149,5745,-54,-96,42,3e:d1:9b:c7:a4:de,247978886,272,6249,247978614,247978886
8407,5,24,149,5745,-90,-96,6,,247979885,28,971,247979857,247979885
8408,5,24,149,5745,-88,-96,8,,247982865,28,2952,247982837,247982865
8409,5,24,149,5745,-90,-96,6,,247982974,32,77,247982942,247982974
8410,5,12,149,5745,-70,-96,26,a6:92:ad:b7:76:65,247989179,256,5949,247988923,247989179
8411,5,12,149,5745,-71,-96,25,b6:90:18:f6:b1:d4,247989515,244,92,247989271,247989515
8412,5,12,149,5745,-75,-96,21,3e:ef:29:c7:4b:17,247989985,244,226,247989741,247989985
8413,5,12,149,5745,-75,-96,21,72:d1:72:1d:22:a1,247992386,256,2145,247992130,247992386
8414,5,6,149,5745,-86,-96,10,54:e4:3a:ec:fb:65,247996630,360,3884,247996270,247996630
8415,5,12,149,5745,-75,-96,21,f6:0a:5c:59:72:df,248008210,448,11132,248007762,248008210
8416,5,12,149,5745,-57,-96,39,9e:1f:b0:a7:b8:90,248011829,356,3263,248011473,248011829
8417,5,12,149,5745,-56,-96,40,9e:1f:b0:a7:b8:90,248012292,156,307,248012136,248012292
8418,5,12,149,5745,-57,-96,39,5e:29:73:5b:30:00,248012842,540,10,248012302,248012842
8419,5,12,149,5745,-56,-96,40,f2:da:61:dd:98:c5,248013471,268,361,248013203,248013471
8420,5,12,149,5745,-75,-96,21,72:d1:72:1d:22:a1,248013932,452,9,248013480,248013932
8421,5,12,149,5745,-68,-96,28,fa:44:8d:e1:c7:1b,248014931,440,559,248014491,248014931
8422,5,12,149,5745,-68,-96,28,fa:44:8d:e1:c7:1b,248019905,128,4846,248019777,248019905
8423,5,12,149,5745,-71,-96,25,b6:90:18:f6:b1:d4,248020069,440,-276,248019629,248020069
8424,5,12,149,5745,-54,-96,42,3e:d1:9b:c7:a4:de,248020579,544,-34,248020035,248020579
8425,5,12,149,5745,-57,-96,39,5e:29:73:5b:30:00,248021292,272,441,248021020,248021292
8426,5,12,149,5745,-56,-96,40,f2:da:61:dd:98:c5,248022337,268,777,248022069,248022337
8427,5,12,149,5745,-74,-96,22,3e:ef:29:c7:4b:17,248024286,440,1509,248023846,248024286
8428,5,12,149,5745,-70,-96,26,22:ec:75:a8:8a:31,248024787,516,-15,248024271,248024787
8429,5,12,149,5745,-83,-96,13,9a:24:38:da:96:bb,248026663,272,1604,248026391,248026663
8430,5,12,149,5745,-57,-96,39,9e:1f:b0:a7:b8:90,248029418,452,2303,248028966,248029418
8431,5,12,149,5745,-71,-96,25,56:68:e2:c2:8d:d5,248030480,476,586,248030004,248030480
8432,5,12,149,5745,-66,-96,30,fa:44:8d:e1:c7:1b,248037290,244,6566,248037046,248037290
8433,5,12,149,5745,-71,-96,25,56:68:e2:c2:8d:d5,248053832,280,16262,248053552,248053832
8434,5,12,149,5745,-57,-96,39,9e:1f:b0:a7:b8:90,248055684,256,1596,248055428,248055684
8435,5,12,149,5745,-69,-96,27,22:ec:75:a8:8a:31,248069294,244,13366,248069050,248069294
8436,5,12,149,5745,-71,-96,25,b6:90:18:f6:b1:d4,248074840,440,5106,248074400,248074840
8437,5,12,149,5745,-66,-96,30,fa:44:8d:e1:c7:1b,248078555,440,3275,248078115,248078555
8438,5,12,149,5745,-71,-96,25,b6:90:18:f6:b1:d4,248086186,244,7387,248085942,248086186
8439,5,12,149,5745,-69,-96,27,22:ec:75:a8:8a:31,248088732,516,2030,248088216,248088732
8440,5,12,149,5745,-57,-96,39,9e:1f:b0:a7:b8:90,248094502,452,5318,248094050,248094502
8441,5,12,149,5745,-74,-96,22,72:d1:72:1d:22:a1,248099005,256,4247,248098749,248099005
8442,5,12,149,5745,-72,-96,24,3e:ef:29:c7:4b:17,248112137,244,12888,248111893,248112137
8443,5,24,149,5745,-90,-96,6,,248124131,28,11966,248124103,248124131
8444,5,12,149,5745,-56,-96,40,5e:29:73:5b:30:00,248135988,272,11585,248135716,248135988
8445,5,12,149,5745,-58,-96,38,f2:da:61:dd:98:c5,248136465,268,209,248136197,248136465
8446,5,12,149,5745,-71,-96,25,b6:90:18:f6:b1:d4,248138737,440,1832,248138297,248138737
8447,5,12,149,5745,-79,-96,17,d2:00:04:7e:2c:ab,248139573,440,396,248139133,248139573
8448,5,12,149,5745,-65,-96,31,fa:44:8d:e1:c7:1b,248144092,440,4079,248143652,248144092
8449,5,12,149,5745,-56,-96,40,5e:29:73:5b:30:00,248144566,540,-66,248144026,248144566
8450,5,12,149,5745,-58,-96,38,f2:da:61:dd:98:c5,248145540,268,706,248145272,248145540
8451,5,12,149,5745,-64,-96,32,0a:b9:b7:b1:4d:fa,248146697,268,889,248146429,248146697
8452,5,12,149,5745,-53,-96,43,3e:d1:9b:c7:a4:de,248150447,544,3206,248149903,248150447
8453,5,12,149,5745,-65,-96,31,fa:44:8d:e1:c7:1b,248152484,244,1793,248152240,248152484
8454,5,12,149,5745,-70,-96,26,22:ec:75:a8:8a:31,248154236,516,1236,248153720,248154236
8455,5,12,149,5745,-73,-96,23,3e:ef:29:c7:4b:17,248154823,440,147,248154383,248154823
8456,5,12,149,5745,-57,-96,39,9e:1f:b0:a7:b8:90,248159672,452,4397,248159220,248159672
8457,5,12,149,5745,-79,-96,17,9a:24:38:da:96:bb,248161609,824,1113,248160785,248161609
8458,5,12,149,5745,-57,-96,39,9e:1f:b0:a7:b8:90,248169271,256,7406,248169015,248169271
8459,5,12,149,5745,-78,-96,18,9a:24:38:da:96:bb,248176530,272,6987,248176258,248176530
8460,5,12,149,5745,-70,-96,26,22:ec:75:a8:8a:31,248184259,244,7485,248184015,248184259
8461,5,6,149,5745,-87,-96,9,54:e4:3a:ec:fb:65,248201431,360,16812,248201071,248201431
8462,5,12,149,5745,-53,-96,43,3e:d1:9b:c7:a4:de,248210216,272,8513,248209944,248210216
8463,5,12,149,5745,-71,-96,25,b6:90:18:f6:b1:d4,248214102,244,3642,248213858,248214102
8464,5,12,149,5745,-71,-96,25,22:ec:75:a8:8a:31,248219803,516,5185,248219287,248219803
8465,5,12,149,5745,-74,-96,22,f6:0a:5c:59:72:df,248222854,252,2799,248222602,248222854
8466,5,12,149,5745,-56,-96,40,9e:1f:b0:a7:b8:90,248224247,452,941,248223795,248224247
8467,5,12,149,5745,-73,-96,23,3e:ef:29:c7:4b:17,248225929,244,1438,248225685,248225929
8468,5,12,149,5745,-75,-96,21,72:d1:72:1d:22:a1,248226389,256,204,248226133,248226389
8469,5,12,149,5745,-75,-96,21,56:68:e2:c2:8d:d5,248228254,280,1585,248227974,248228254
8470,5,12,149,5745,-58,-96,38,5e:29:73:5b:30:00,248239403,272,10877,248239131,248239403
8471,5,12,149,5745,-57,-96,39,f2:da:61:dd:98:c5,248249539,268,9868,248249271,248249539
8472,5,12,149,5745,-70,-96,26,22:ec:75:a8:8a:31,248285409,516,35354,248284893,248285409
8473,5,12,149,5745,-78,-96,18,9a:24:38:da:96:bb,248289430,272,3749,248289158,248289430
8474,5,12,149,5745,-56,-96,40,9e:1f:b0:a7:b8:90,248292743,256,3057,248292487,248292743
8475,5,12,149,5745,-70,-96,26,22:ec:75:a8:8a:31,248298676,244,5689,248298432,248298676
8476,5,6,149,5745,-88,-96,8,54:e4:3a:ec:fb:65,248303831,360,4795,248303471,248303831
8477,5,12,149,5745,-56,-96,40,3e:d1:9b:c7:a4:de,248327592,272,23489,248327320,248327592
8478,5,12,149,5745,-72,-96,24,b6:90:18:f6:b1:d4,248328048,244,212,248327804,248328048
8479,5,12,149,5745,-66,-96,30,fa:44:8d:e1:c7:1b,248328458,244,166,248328214,248328458
8480,5,12,149,5745,-75,-96,21,72:d1:72:1d:22:a1,248328927,256,213,248328671,248328927
8481,5,12,149,5745,-78,-96,18,56:68:e2:c2:8d:d5,248329296,280,89,248329016,248329296
8482,5,12,149,5745,-75,-96,21,f6:0a:5c:59:72:df,248340485,252,10937,248340233,248340485
8483,5,12,149,5745,-70,-96,26,22:ec:75:a8:8a:31,248350882,516,9881,248350366,248350882
8484,5,12,149,5745,-56,-96,40,5e:29:73:5b:30:00,248353942,272,2788,248353670,248353942
8485,5,12,149,5745,-74,-96,22,3e:ef:29:c7:4b:17,248382121,244,27935,248381877,248382121
8486,5,12,149,5745,-70,-96,26,22:ec:75:a8:8a:31,248400606,244,18241,248400362,248400606
8487,5,12,149,5745,-74,-96,22,9a:24:38:da:96:bb,248404711,272,3833,248404439,248404711
8488,5,12,149,5745,-57,-96,39,9e:1f:b0:a7:b8:90,248405325,256,358,248405069,248405325
8489,5,6,149,5745,-85,-96,11,54:e4:3a:ec:fb:65,248406232,360,547,248405872,248406232
8490,5,12,149,5745,-60,-96,36,f2:da:61:dd:98:c5,248406899,268,399,248406631,248406899
8491,5,12,149,5745,-66,-96,30,fa:44:8d:e1:c7:1b,248430797,244,23654,248430553,248430797
8492,5,12,149,5745,-80,-96,16,56:68:e2:c2:8d:d5,248431985,280,908,248431705,248431985
8493,5,12,149,5745,-70,-96,26,b6:90:18:f6:b1:d4,248440878,244,8649,248440634,248440878
8494,5,12,149,5745,-58,-96,38,3e:d1:9b:c7:a4:de,248445533,272,4383,248445261,248445533
8495,5,12,149,5745,-77,-96,19,72:d1:72:1d:22:a1,248446899,256,1110,248446643,248446899
8496,5,12,149,5745,-56,-96,40,5e:29:73:5b:30:00,248470834,272,23663,248470562,248470834
8497,5,12,149,5745,-74,-96,22,3e:ef:29:c7:4b:17,248484509,244,13431,248484265,248484509
8498,5,6,149,5745,-85,-96,11,54:e4:3a:ec:fb:65,248508632,360,23763,248508272,248508632
8499,5,12,149,5745,-58,-96,38,f2:da:61:dd:98:c5,248509317,268,417,248509049,248509317
8500,5,12,149,5745,-72,-96,24,22:ec:75:a8:8a:31,248515523,244,5962,248515279,248515523
8501,5,12,149,5745,-57,-96,39,9e:1f:b0:a7:b8:90,248518138,256,2359,248517882,248518138
8502,5,12,149,5745,-69,-96,27,fa:44:8d:e1:c7:1b,248532838,244,14456,248532594,248532838
8503,5,12,149,5745,-78,-96,18,56:68:e2:c2:8d:d5,248534628,280,1510,248534348,248534628
8504,5,12,149,5745,-79,-96,17,72:d1:72:1d:22:a1,248549369,256,14485,248549113,248549369
8505,5,12,149,5745,-72,-96,24,b6:90:18:f6:b1:d4,248549832,244,219,248549588,248549832
8506,5,12,149,5745,-60,-96,36,3e:d1:9b:c7:a4:de,248557303,272,7199,248557031,248557303
8507,5,24,149,5745,-89,-96,7,,248562596,28,5265,248562568,248562596
8508,5,24,149,5745,-88,-96,8,,248562640,28,16,248562612,248562640
8509,5,12,149,5745,-74,-96,22,3e:ef:29:c7:4b:17,248566742,244,3858,248566498,248566742
8510,5,12,149,5745,-82,-96,14,9a:24:38:da:96:bb,248580225,272,13211,248579953,248580225
8511,5,12,149,5745,-58,-96,38,f2:da:61:dd:98:c5,248580766,268,273,248580498,248580766
8512,5,12,149,5745,-67,-96,29,fa:44:8d:e1:c7:1b,248594339,244,13329,248594095,248594339
8513,5,12,149,5745,-59,-96,37,5e:29:73:5b:30:00,248594770,272,159,248594498,248594770
8514,5,12,149,5745,-69,-96,27,b6:90:18:f6:b1:d4,248597778,440,2568,248597338,248597778
8515,5,12,149,5745,-75,-96,21,f6:0a:5c:59:72:df,248598738,448,512,248598290,248598738
8516,5,12,149,5745,-58,-96,38,5e:29:73:5b:30:00,248601447,540,2169,248600907,248601447
8517,5,12,149,5745,-79,-96,17,72:d1:72:1d:22:a1,248603004,452,1105,248602552,248603004
8518,5,12,149,5745,-68,-96,28,fa:44:8d:e1:c7:1b,248604687,440,1243,248604247,248604687
8519,5,12,149,5745,-58,-96,38,3e:d1:9b:c7:a4:de,248608293,544,3062,248607749,248608293
8520,5,6,149,5745,-83,-96,13,54:e4:3a:ec:fb:65,248611033,360,2380,248610673,248611033
8521,5,12,149,5745,-71,-96,25,22:ec:75:a8:8a:31,248612760,516,1211,248612244,248612760
8522,5,12,149,5745,-75,-96,21,3e:ef:29:c7:4b:17,248613977,440,777,248613537,248613977
8523,5,12,149,5745,-57,-96,39,f2:da:61:dd:98:c5,248618960,268,4715,248618692,248618960
8524,5,12,149,5745,-76,-96,20,56:68:e2:c2:8d:d5,248619721,476,285,248619245,248619721
8525,5,12,149,5745,-55,-96,41,9e:1f:b0:a7:b8:90,248620501,452,328,248620049,248620501
8526,5,12,149,5745,-81,-96,15,9a:24:38:da:96:bb,248623683,272,2910,248623411,248623683
8527,5,12,149,5745,-76,-96,20,56:68:e2:c2:8d:d5,248626324,280,2361,248626044,248626324
8528,5,12,149,5745,-55,-96,41,9e:1f:b0:a7:b8:90,248627979,256,1399,248627723,248627979
8529,5,12,149,5745,-70,-96,26,22:ec:75:a8:8a:31,248643066,244,14843,248642822,248643066
8530,5,12,149,5745,-69,-96,27,b6:90:18:f6:b1:d4,248659518,244,16208,248659274,248659518
8531,5,12,149,5745,-79,-96,17,72:d1:72:1d:22:a1,248660437,256,663,248660181,248660437
8532,5,12,149,5745,-74,-96,22,f6:0a:5c:59:72:df,248661050,252,361,248660798,248661050
8533,5,12,149,5745,-69,-96,27,b6:90:18:f6:b1:d4,248663435,440,1945,248662995,248663435
8534,5,12,149,5745,-76,-96,20,f6:0a:5c:59:72:df,248664026,448,143,248663578,248664026
8535,5,12,149,5745,-55,-96,41,9e:1f:b0:a7:b8:90,248665694,156,1512,248665538,248665694
8536,5,12,149,5745,-56,-96,40,9e:1f:b0:a7:b8:90,248666019,356,-31,248665663,248666019
8537,5,12,149,5745,-59,-96,37,5e:29:73:5b:30:00,248666455,540,-104,248665915,248666455
8538,5,12,149,5745,-77,-96,19,72:d1:72:1d:22:a1,248667066,452,159,248666614,248667066
8539,5,12,149,5745,-57,-96,39,f2:da:61:dd:98:c5,248667552,268,218,248667284,248667552
8540,5,12,149,5745,-76,-96,20,f6:0a:5c:59:72:df,248668744,188,1004,248668556,248668744
8541,5,12,149,5745,-66,-96,30,fa:44:8d:e1:c7:1b,248668977,440,-207,248668537,248668977
8542,5,12,149,5745,-71,-96,25,a6:92:ad:b7:76:65,248669819,456,386,248669363,248669819
8543,5,12,149,5745,-64,-96,32,0a:b9:b7:b1:4d:fa,248671228,268,1141,248670960,248671228
8544,5,12,149,5745,-56,-96,40,3e:d1:9b:c7:a4:de,248672565,544,793,248672021,248672565
8545,5,12,149,5745,-57,-96,39,3e:d1:9b:c7:a4:de,248675879,272,3042,248675607,248675879
8546,5,12,149,5745,-74,-96,22,3e:ef:29:c7:4b:17,248677663,244,1540,248677419,248677663
8547,5,12,149,5745,-69,-96,27,22:ec:75:a8:8a:31,248678553,516,374,248678037,248678553
8548,5,12,149,5745,-74,-96,22,3e:ef:29:c7:4b:17,248679366,440,373,248678926,248679366
8549,5,12,149,5745,-56,-96,40,9e:1f:b0:a7:b8:90,248683546,452,3728,248683094,248683546
8550,5,12,149,5745,-57,-96,39,f2:da:61:dd:98:c5,248693638,268,9824,248693370,248693638
8551,5,12,149,5745,-66,-96,30,fa:44:8d:e1:c7:1b,248709564,244,15682,248709320,248709564
8552,5,12,149,5745,-60,-96,36,5e:29:73:5b:30:00,248710283,272,447,248710011,248710283
8553,5,6,149,5745,-81,-96,15,54:e4:3a:ec:fb:65,248713434,360,2791,248713074,248713434
8554,5,12,149,5745,-82,-96,14,9a:24:38:da:96:bb,248736766,272,23060,248736494,248736766
8555,5,12,149,5745,-58,-96,38,9e:1f:b0:a7:b8:90,248742689,256,5667,248742433,248742689
8556,5,12,149,5745,-78,-96,18,56:68:e2:c2:8d:d5,248744320,280,1351,248744040,248744320
8557,5,12,149,5745,-68,-96,28,22:ec:75:a8:8a:31,248745088,244,524,248744844,248745088
8558,5,12,149,5745,-57,-96,39,9e:1f:b0:a7:b8:90,248749441,452,3901,248748989,248749441
8559,5,12,149,5745,-76,-96,20,72:d1:72:1d:22:a1,248775705,256,26008,248775449,248775705
8560,5,12,149,5745,-59,-96,37,3e:d1:9b:c7:a4:de,248786575,272,10598,248786303,248786575
8561,5,12,149,5745,-76,-96,20,3e:ef:29:c7:4b:17,248794464,244,7645,248794220,248794464
8562,5,24,149,5745,-88,-96,8,,248794850,32,354,248794818,248794850
8563,5,12,149,5745,-60,-96,36,5e:29:73:5b:30:00,248808098,272,12976,248807826,248808098
8564,5,24,149,5745,-88,-96,8,,248808592,28,466,248808564,248808592
8565,5,24,149,5745,-85,-96,11,,248808638,28,18,248808610,248808638
8566,5,24,149,5745,-84,-96,12,,248808751,32,81,248808719,248808751
8567,5,24,149,5745,-84,-96,12,,248809074,32,291,248809042,248809074
8568,5,12,149,5745,-58,-96,38,f2:da:61:dd:98:c5,248812744,268,3402,248812476,248812744
8569,5,12,149,5745,-72,-96,24,f6:0a:5c:59:72:df,248814180,252,1184,248813928,248814180
8570,5,6,149,5745,-83,-96,13,54:e4:3a:ec:fb:65,248815834,360,1294,248815474,248815834
8571,5,12,149,5745,-71,-96,25,b6:90:18:f6:b1:d4,248840290,244,24212,248840046,248840290
8572,5,12,149,5745,-67,-96,29,fa:44:8d:e1:c7:1b,248840705,244,171,248840461,248840705
8573,5,12,149,5745,-78,-96,18,9a:24:38:da:96:bb,248852316,272,11339,248852044,248852316
8574,5,24,149,5745,-88,-96,8,,248854104,32,1756,248854072,248854104
8575,5,12,149,5745,-76,-96,20,56:68:e2:c2:8d:d5,248854827,280,443,248854547,248854827
8576,5,24,149,5745,-89,-96,7,,248856130,32,1271,248856098,248856130
8577,5,24,149,5745,-90,-96,6,,248862079,28,5921,248862051,248862079
8578,5,12,149,5745,-67,-96,29,22:ec:75:a8:8a:31,248862281,244,-42,248862037,248862281
8579,5,24,149,5745,-89,-96,7,,248880302,28,17993,248880274,248880302
8580,5,12,149,5745,-60,-96,36,3e:d1:9b:c7:a4:de,248900604,272,20030,248900332,248900604
8581,5,12,149,5745,-77,-96,19,3e:ef:29:c7:4b:17,248906480,244,5632,248906236,248906480
8582,5,6,149,5745,-84,-96,12,54:e4:3a:ec:fb:65,248918235,360,11395,248917875,248918235
8583,5,12,149,5745,-59,-96,37,9e:1f:b0:a7:b8:90,248918622,256,131,248918366,248918622
8584,5,12,149,5745,-58,-96,38,5e:29:73:5b:30:00,248924976,272,6082,248924704,248924976
8585,5,12,149,5745,-57,-96,39,f2:da:61:dd:98:c5,248926452,268,1208,248926184,248926452
8586,5,24,149,5745,-87,-96,9,,248940851,28,14371,248940823,248940851
8587,5,24,149,5745,-86,-96,10,,248940960,32,77,248940928,248940960
8588,5,24,149,5745,-88,-96,8,,248941163,28,175,248941135,248941163
8589,5,24,149,5745,-87,-96,9,,248941273,32,78,248941241,248941273
8590,5,12,149,5745,-72,-96,24,b6:90:18:f6:b1:d4,248942668,244,1151,248942424,248942668
8591,5,12,149,5745,-70,-96,26,fa:44:8d:e1:c7:1b,248943073,244,161,248942829,248943073
8592,5,12,149,5745,-79,-96,17,72:d1:72:1d:22:a1,248943413,256,84,248943157,248943413
8593,5,12,149,5745,-81,-96,15,9a:24:38:da:96:bb,248960969,272,17284,248960697,248960969
8594,5,24,149,5745,-88,-96,8,,248970650,32,9649,248970618,248970650
8595,5,12,149,5745,-77,-96,19,56:68:e2:c2:8d:d5,248976681,280,5751,248976401,248976681
8596,5,12,149,5745,-69,-96,27,22:ec:75:a8:8a:31,248979078,244,2153,248978834,248979078
8597,5,12,149,5745,-77,-96,19,72:d1:72:1d:22:a1,248999868,256,20534,248999612,248999868
8598,5,12,149,5745,-68,-96,28,b6:90:18:f6:b1:d4,249004182,244,4070,249003938,249004182
8599,5,24,149,5745,-90,-96,6,,249005388,32,1174,249005356,249005388
8600,5,12,149,5745,-62,-96,34,3e:d1:9b:c7:a4:de,249017886,272,12226,249017614,249017886
8601,5,24,149,5745,-89,-96,7,,249020026,28,2112,249019998,249020026
8602,5,6,149,5745,-83,-96,13,54:e4:3a:ec:fb:65,249020635,360,249,249020275,249020635
8603,5,12,149,5745,-53,-96,43,9e:1f:b0:a7:b8:90,249021156,256,265,249020900,249021156
8604,5,12,149,5745,-77,-96,19,3e:ef:29:c7:4b:17,249026943,244,5543,249026699,249026943
8605,5,24,149,5745,-88,-96,8,,249035322,28,8351,249035294,249035322
8606,5,24,149,5745,-89,-96,7,,249035643,28,293,249035615,249035643
8607,5,24,149,5745,-88,-96,8,,249038417,32,2742,249038385,249038417
8608,5,12,149,5745,-57,-96,39,f2:da:61:dd:98:c5,249039302,268,617,249039034,249039302
8609,5,12,149,5745,-73,-96,23,fa:44:8d:e1:c7:1b,249053095,244,13549,249052851,249053095
8610,5,12,149,5745,-57,-96,39,5e:29:73:5b:30:00,249053571,272,204,249053299,249053571
8611,5,12,149,5745,-67,-96,29,b6:90:18:f6:b1:d4,249057441,440,3430,249057001,249057441
8612,5,12,149,5745,-70,-96,26,f6:0a:5c:59:72:df,249057969,448,80,249057521,249057969
8613,5,12,149,5745,-53,-96,43,9e:1f:b0:a7:b8:90,249059610,356,1285,249059254,249059610
8614,5,12,149,5745,-53,-96,43,9e:1f:b0:a7:b8:90,249060045,156,279,249059889,249060045
8615,5,12,149,5745,-76,-96,20,72:d1:72:1d:22:a1,249061225,452,728,249060773,249061225
8616,5,12,149,5745,-57,-96,39,f2:da:61:dd:98:c5,249061846,268,353,249061578,249061846
8617,5,12,149,5745,-59,-96,37,5e:29:73:5b:30:00,249062274,540,-112,249061734,249062274
8618,5,12,149,5745,-70,-96,26,f6:0a:5c:59:72:df,249062965,188,503,249062777,249062965
8619,5,12,149,5745,-58,-96,38,3e:d1:9b:c7:a4:de,249067915,544,4406,249067371,249067915
8620,5,24,149,5745,-87,-96,9,,249068673,28,730,249068645,249068673
8621,5,24,149,5745,-89,-96,7,,249068781,32,76,249068749,249068781
8622,5,12,149,5745,-77,-96,19,56:68:e2:c2:8d:d5,249068902,280,-159,249068622,249068902
8623,5,12,149,5745,-73,-96,23,fa:44:8d:e1:c7:1b,249070225,440,883,249069785,249070225
8624,5,12,149,5745,-71,-96,25,22:ec:75:a8:8a:31,249075066,516,4325,249074550,249075066
8625,5,12,149,5745,-80,-96,16,9a:24:38:da:96:bb,249075808,824,-82,249074984,249075808
8626,5,12,149,5745,-53,-96,43,9e:1f:b0:a7:b8:90,249076667,452,407,249076215,249076667
8627,5,24,149,5745,-89,-96,7,,249078139,28,1444,249078111,249078139
8628,5,12,149,5745,-77,-96,19,56:68:e2:c2:8d:d5,249079743,476,1128,249079267,249079743
8629,5,24,149,5745,-89,-96,7,,249081761,28,1990,249081733,249081761
8630,5,24,149,5745,-89,-96,7,,249084627,32,2834,249084595,249084627
8631,5,24,149,5745,-77,-96,19,,249097146,28,12491,249097118,249097146
8632,5,24,149,5745,-77,-96,19,,249097285,28,111,249097257,249097285
8633,5,6,149,5745,-76,-96,20,,249097791,52,454,249097739,249097791
8634,5,6,149,5745,-76,-96,20,,249099979,52,2136,249099927,249099979
8635,5,6,149,5745,-89,-96,7,,249100047,44,24,249100003,249100047
8636,5,24,149,5745,-88,-96,8,,249100165,28,90,249100137,249100165
8637,5,12,149,5745,-71,-96,25,22:ec:75:a8:8a:31,249101793,244,1384,249101549,249101793
8638,5,12,149,5745,-67,-96,29,b6:90:18:f6:b1:d4,249102262,244,225,249102018,249102262
8639,5,12,149,5745,-77,-96,19,72:d1:72:1d:22:a1,249103837,256,1319,249103581,249103837
8640,5,24,149,5745,-90,-96,6,,249118223,32,14354,249118191,249118223
8641,5,24,149,5745,-89,-96,7,,249118723,28,472,249118695,249118723
8642,5,12,149,5745,-67,-96,29,b6:90:18:f6:b1:d4,249121817,440,2654,249121377,249121817
8643,5,6,149,5745,-85,-96,11,54:e4:3a:ec:fb:65,249123036,360,859,249122676,249123036
8644,5,12,149,5745,-57,-96,39,3e:d1:9b:c7:a4:de,249131857,272,8549,249131585,249131857
8645,5,12,149,5745,-77,-96,19,3e:ef:29:c7:4b:17,249140003,244,7902,249139759,249140003
8646,5,12,149,5745,-68,-96,28,f6:0a:5c:59:72:df,249151632,252,11377,249151380,249151632
8647,5,12,149,5745,-59,-96,37,f2:da:61:dd:98:c5,249151990,268,90,249151722,249151990
8648,5,12,149,5745,-70,-96,26,fa:44:8d:e1:c7:1b,249159497,244,7263,249159253,249159497
8649,5,24,149,5745,-73,-96,23,,249173775,28,14250,249173747,249173775
8650,5,24,149,5745,-89,-96,7,,249173819,28,16,249173791,249173819
8651,5,12,149,5745,-82,-96,14,9a:24:38:da:96:bb,249184790,272,10699,249184518,249184790
8652,5,12,149,5745,-67,-96,29,b6:90:18:f6:b1:d4,249187255,440,2025,249186815,249187255
8653,5,12,149,5745,-56,-96,40,5e:29:73:5b:30:00,249191149,540,3354,249190609,249191149
8654,5,12,149,5745,-59,-96,37,f2:da:61:dd:98:c5,249191770,268,353,249191502,249191770
8655,5,12,149,5745,-71,-96,25,a6:92:ad:b7:76:65,249192981,456,755,249192525,249192981
8656,5,12,149,5745,-66,-96,30,0a:b9:b7:b1:4d:fa,249196495,268,3246,249196227,249196495
8657,5,12,149,5745,-72,-96,24,fa:44:8d:e1:c7:1b,249199634,440,2699,249199194,249199634
8658,5,12,149,5745,-59,-96,37,3e:d1:9b:c7:a4:de,249200327,544,149,249199783,249200327
8659,5,12,149,5745,-71,-96,25,22:ec:75:a8:8a:31,249201272,516,429,249200756,249201272
8660,5,12,149,5745,-76,-96,20,3e:ef:29:c7:4b:17,249203488,440,1776,249203048,249203488
8661,5,12,149,5745,-82,-96,14,9a:24:38:da:96:bb,249209103,824,4791,249208279,249209103
8662,5,12,149,5745,-71,-96,25,22:ec:75:a8:8a:31,249216196,244,6849,249215952,249216196
8663,5,12,149,5745,-67,-96,29,b6:90:18:f6:b1:d4,249216557,244,117,249216313,249216557
8664,5,6,149,5745,-85,-96,11,54:e4:3a:ec:fb:65,249225436,360,8519,249225076,249225436
8665,5,12,149,5745,-56,-96,40,3e:d1:9b:c7:a4:de,249245915,272,20207,249245643,249245915
8666,5,12,149,5745,-77,-96,19,72:d1:72:1d:22:a1,249249958,256,3787,249249702,249249958
8667,5,12,149,5745,-77,-96,19,56:68:e2:c2:8d:d5,249252136,280,1898,249251856,249252136
8668,5,12,149,5745,-75,-96,21,3e:ef:29:c7:4b:17,249261789,244,9409,249261545,249261789
8669,5,12,149,5745,-60,-96,36,f2:da:61:dd:98:c5,249265405,268,3348,249265137,249265405
8670,5,12,149,5745,-80,-96,16,9a:24:38:da:96:bb,249297625,272,31948,249297353,249297625
8671,5,12,149,5745,-72,-96,24,22:ec:75:a8:8a:31,249321084,244,23215,249320840,249321084
8672,5,6,149,5745,-86,-96,10,54:e4:3a:ec:fb:65,249327837,360,6393,249327477,249327837
8673,5,24,149,5745,-88,-96,8,,249338670,32,10801,249338638,249338670
8674,5,12,149,5745,-68,-96,28,fa:44:8d:e1:c7:1b,249352484,244,13570,249352240,249352484
8675,5,12,149,5745,-64,-96,32,b6:90:18:f6:b1:d4,249352794,244,66,249352550,249352794
8676,5,12,149,5745,-76,-96,20,72:d1:72:1d:22:a1,249353127,256,77,249352871,249353127
8677,5,12,149,5745,-76,-96,20,56:68:e2:c2:8d:d5,249354639,280,1232,249354359,249354639
8678,5,12,149,5745,-56,-96,40,3e:d1:9b:c7:a4:de,249359398,272,4487,249359126,249359398
8679,5,24,149,5745,-89,-96,7,,249369529,32,10099,249369497,249369529
8680,5,12,149,5745,-72,-96,24,3e:ef:29:c7:4b:17,249406335,244,36562,249406091,249406335
8681,5,6,149,5745,-84,-96,12,54:e4:3a:ec:fb:65,249430238,360,23543,249429878,249430238
8682,5,12,149,5745,-57,-96,39,f2:da:61:dd:98:c5,249431181,268,675,249430913,249431181
8683,5,12,149,5745,-74,-96,22,22:ec:75:a8:8a:31,249438135,244,6710,249437891,249438135
8684,5,12,149,5745,-66,-96,30,b6:90:18:f6:b1:d4,249454741,244,16362,249454497,249454741
8685,5,12,149,5745,-68,-96,28,fa:44:8d:e1:c7:1b,249455120,244,135,249454876,249455120
8686,5,12,149,5745,-75,-96,21,72:d1:72:1d:22:a1,249455505,256,129,249455249,249455505
8687,5,12,149,5745,-77,-96,19,56:68:e2:c2:8d:d5,249456954,280,1169,249456674,249456954
8688,5,12,149,5745,-59,-96,37,3e:d1:9b:c7:a4:de,249476486,272,19260,249476214,249476486
8689,5,12,149,5745,-74,-96,22,3e:ef:29:c7:4b:17,249508687,244,31957,249508443,249508687
8690,5,12,149,5745,-83,-96,13,9a:24:38:da:96:bb,249526167,272,17208,249525895,249526167
8691,5,24,149,5745,-90,-96,6,,249529948,28,3753,249529920,249529948
8692,5,6,149,5745,-85,-96,11,54:e4:3a:ec:fb:65,249532638,360,2330,249532278,249532638
8693,5,12,149,5745,-55,-96,41,f2:da:61:dd:98:c5,249533620,268,714,249533352,249533620
8694,5,12,149,5745,-74,-96,22,d2:00:04:7e:2c:ab,249533949,412,-83,249533537,249533949
8695,5,24,149,5745,-88,-96,8,,249550030,28,16053,249550002,249550030
8696,5,24,149,5745,-88,-96,8,,249550595,28,537,249550567,249550595
8697,5,24,149,5745,-87,-96,9,,249552881,32,2254,249552849,249552881
8698,5,12,149,5745,-71,-96,25,22:ec:75:a8:8a:31,249553865,244,740,249553621,249553865
8699,5,12,149,5745,-66,-96,30,fa:44:8d:e1:c7:1b,249556286,244,2177,249556042,249556286
8700,5,12,149,5745,-77,-96,19,56:68:e2:c2:8d:d5,249557932,280,1366,249557652,249557932
8701,5,24,149,5745,-88,-96,8,,249572261,28,14301,249572233,249572261
8702,5,12,149,5745,-76,-96,20,72:d1:72:1d:22:a1,249573700,256,1183,249573444,249573700
8703,5,12,149,5745,-68,-96,28,b6:90:18:f6:b1:d4,249574217,244,273,249573973,249574217
8704,5,24,149,5745,-88,-96,8,,249574522,28,277,249574494,249574522
8705,5,24,149,5745,-86,-96,10,,249575000,32,446,249574968,249575000
8706,5,24,149,5745,-87,-96,9,,249576594,28,1566,249576566,249576594
8707,5,24,149,5745,-87,-96,9,,249576703,32,77,249576671,249576703
8708,5,12,149,5745,-56,-96,40,3e:d1:9b:c7:a4:de,249588467,272,11492,249588195,249588467
8709,5,12,149,5745,-59,-96,37,f2:da:61:dd:98:c5,249603885,268,15150,249603617,249603885
8710,5,12,149,5745,-56,-96,40,5e:29:73:5b:30:00,249607165,272,3008,249606893,249607165
8711,5,12,149,5745,-75,-96,21,3e:ef:29:c7:4b:17,249609366,244,1957,249609122,249609366
8712,5,24,149,5745,-88,-96,8,,249610954,28,1560,249610926,249610954
8713,5,24,149,5745,-87,-96,9,,249611063,32,77,249611031,249611063
8714,5,12,149,5745,-66,-96,30,fa:44:8d:e1:c7:1b,249628259,244,16952,249628015,249628259
8715,5,24,149,5745,-88,-96,8,,249629974,28,1687,249629946,249629974
8716,5,24,149,5745,-88,-96,8,,249633038,28,3036,249633010,249633038
8717,5,24,149,5745,-89,-96,7,,249633147,32,77,249633115,249633147
8718,5,6,149,5745,-85,-96,11,54:e4:3a:ec:fb:65,249635038,360,1531,249634678,249635038
8719,5,12,149,5745,-74,-96,22,56:68:e2:c2:8d:d5,249640889,280,5571,249640609,249640889
8720,5,12,149,5745,-73,-96,23,f6:0a:5c:59:72:df,249647682,448,6345,249647234,249647682
8721,5,12,149,5745,-68,-96,28,b6:90:18:f6:b1:d4,249649363,440,1241,249648923,249649363
8722,5,12,149,5745,-59,-96,37,f2:da:61:dd:98:c5,249650237,268,606,249649969,249650237
8723,5,12,149,5745,-60,-96,36,5e:29:73:5b:30:00,249650585,540,-192,249650045,249650585
8724,5,12,149,5745,-75,-96,21,72:d1:72:1d:22:a1,249651493,452,456,249651041,249651493
8725,5,12,149,5745,-73,-96,23,22:ec:75:a8:8a:31,249657866,516,5857,249657350,249657866
8726,5,12,149,5745,-57,-96,39,3e:d1:9b:c7:a4:de,249660328,544,1918,249659784,249660328
8727,5,12,149,5745,-65,-96,31,fa:44:8d:e1:c7:1b,249663284,440,2516,249662844,249663284
8728,5,12,149,5745,-75,-96,21,3e:ef:29:c7:4b:17,249665181,440,1457,249664741,249665181
8729,5,12,149,5745,-73,-96,23,22:ec:75:a8:8a:31,249674949,244,9524,249674705,249674949
8730,5,12,149,5745,-67,-96,29,b6:90:18:f6:b1:d4,249675264,244,71,249675020,249675264
8731,5,12,149,5745,-76,-96,20,72:d1:72:1d:22:a1,249676813,256,1293,249676557,249676813
8732,5,12,149,5745,-75,-96,21,56:68:e2:c2:8d:d5,249680019,476,2730,249679543,249680019
8733,5,12,149,5745,-72,-96,24,f6:0a:5c:59:72:df,249685949,252,5678,249685697,249685949
8734,5,12,149,5745,-74,-96,22,3e:ef:29:c7:4b:17,249691331,244,5138,249691087,249691331
8735,5,24,149,5745,-90,-96,6,,249701912,28,10553,249701884,249701912
8736,5,12,149,5745,-55,-96,41,3e:d1:9b:c7:a4:de,249708133,272,5949,249707861,249708133
8737,5,12,149,5745,-59,-96,37,f2:da:61:dd:98:c5,249709665,268,1264,249709397,249709665
8738,5,12,149,5745,-68,-96,28,b6:90:18:f6:b1:d4,249712603,440,2498,249712163,249712603
8739,5,12,149,5745,-75,-96,21,f6:0a:5c:59:72:df,249713094,448,43,249712646,249713094
8740,5,12,149,5745,-75,-96,21,72:d1:72:1d:22:a1,249714676,452,1130,249714224,249714676
8741,5,12,149,5745,-56,-96,40,9e:1f:b0:a7:b8:90,249717946,156,3114,249717790,249717946
8742,5,12,149,5745,-56,-96,40,9e:1f:b0:a7:b8:90,249718145,452,-253,249717693,249718145
8743,5,12,149,5745,-74,-96,22,56:68:e2:c2:8d:d5,249718895,476,274,249718419,249718895
8744,5,12,149,5745,-68,-96,28,a6:92:ad:b7:76:65,249719423,456,72,249718967,249719423
8745,5,12,149,5745,-61,-96,35,5e:29:73:5b:30:00,249721317,540,1354,249720777,249721317
8746,5,12,149,5745,-64,-96,32,fa:44:8d:e1:c7:1b,249723008,232,1459,249722776,249723008
8747,5,12,149,5745,-72,-96,24,22:ec:75:a8:8a:31,249723310,516,-214,249722794,249723310
8748,5,12,149,5745,-55,-96,41,3e:d1:9b:c7:a4:de,249725786,544,1932,249725242,249725786
8749,5,12,149,5745,-76,-96,20,d2:00:04:7e:2c:ab,249726402,380,236,249726022,249726402
8750,5,12,149,5745,-73,-96,23,3e:ef:29:c7:4b:17,249727808,440,966,249727368,249727808
8751,5,12,149,5745,-61,-96,35,0a:b9:b7:b1:4d:fa,249729767,268,1691,249729499,249729767
8752,5,12,149,5745,-76,-96,20,d2:00:04:7e:2c:ab,249734722,440,4515,249734282,249734722
8753,5,6,149,5745,-85,-96,11,54:e4:3a:ec:fb:65,249737439,360,2357,249737079,249737439
8754,5,12,149,5745,-64,-96,32,fa:44:8d:e1:c7:1b,249741150,244,3467,249740906,249741150
8755,5,12,149,5745,-60,-96,36,5e:29:73:5b:30:00,249741671,272,249,249741399,249741671
8756,5,12,149,5745,-75,-96,21,56:68:e2:c2:8d:d5,249742023,280,72,249741743,249742023
8757,5,12,149,5745,-84,-96,12,9a:24:38:da:96:bb,249746622,272,4327,249746350,249746622
8758,5,24,149,5745,-88,-96,8,,249757168,28,10518,249757140,249757168
8759,5,24,149,5745,-88,-96,8,,249759693,28,2497,249759665,249759693
8760,5,12,149,5745,-72,-96,24,22:ec:75:a8:8a:31,249783266,244,23329,249783022,249783266
8761,5,12,149,5745,-76,-96,20,72:d1:72:1d:22:a1,249789608,256,6086,249789352,249789608
8762,5,24,149,5745,-88,-96,8,,249793847,28,4211,249793819,249793847
8763,5,12,149,5745,-71,-96,25,b6:90:18:f6:b1:d4,249795190,244,1099,249794946,249795190
8764,5,24,149,5745,-90,-96,6,,249815387,28,20169,249815359,249815387
8765,5,12,149,5745,-53,-96,43,3e:d1:9b:c7:a4:de,249817995,272,2336,249817723,249817995
8766,5,12,149,5745,-75,-96,21,3e:ef:29:c7:4b:17,249823288,244,5049,249823044,249823288
8767,5,12,149,5745,-60,-96,36,f2:da:61:dd:98:c5,249828547,268,4991,249828279,249828547
8768,5,12,149,5745,-57,-96,39,5e:29:73:5b:30:00,249833592,272,4773,249833320,249833592
8769,5,6,149,5745,-86,-96,10,54:e4:3a:ec:fb:65,249839840,360,5888,249839480,249839840
8770,5,12,149,5745,-68,-96,28,fa:44:8d:e1:c7:1b,249854385,244,14301,249854141,249854385
8771,5,12,149,5745,-86,-96,10,9a:24:38:da:96:bb,249859505,272,4848,249859233,249859505
8772,5,12,149,5745,-75,-96,21,56:68:e2:c2:8d:d5,249866977,280,7192,249866697,249866977
8773,5,24,149,5745,-89,-96,7,,249898398,28,31393,249898370,249898398
8774,5,12,149,5745,-71,-96,25,22:ec:75:a8:8a:31,249900023,244,1381,249899779,249900023
8775,5,24,149,5745,-77,-96,19,,249912486,28,12435,249912458,249912486
8776,5,24,149,5745,-88,-96,8,,249912530,28,16,249912502,249912530
8777,5,24,149,5745,-89,-96,7,,249912638,28,80,249912610,249912638
8778,5,24,149,5745,-88,-96,8,,249918089,28,5423,249918061,249918089
8779,5,24,149,5745,-88,-96,8,,249918809,28,692,249918781,249918809
8780,5,24,149,5745,-89,-96,7,,249919120,28,283,249919092,249919120
8781,5,24,149,5745,-88,-96,8,,249930151,32,10999,249930119,249930151
8782,5,24,149,5745,-90,-96,6,,249930623,32,440,249930591,249930623
8783,5,24,149,5745,-87,-96,9,,249931095,28,444,249931067,249931095
8784,5,12,149,5745,-72,-96,24,f6:0a:5c:59:72:df,249931729,252,382,249931477,249931729
8785,5,12,149,5745,-74,-96,22,3e:ef:29:c7:4b:17,249933314,244,1341,249933070,249933314
8786,5,12,149,5745,-56,-96,40,3e:d1:9b:c7:a4:de,249935493,272,1907,249935221,249935493
8787,5,12,149,5745,-58,-96,38,f2:da:61:dd:98:c5,249941545,268,5784,249941277,249941545
8788,5,6,149,5745,-84,-96,12,54:e4:3a:ec:fb:65,249942240,360,335,249941880,249942240
8789,5,12,149,5745,-56,-96,40,5e:29:73:5b:30:00,249948990,272,6478,249948718,249948990
8790,5,12,149,5745,-80,-96,16,72:d1:72:1d:22:a1,249966861,256,17615,249966605,249966861
8791,5,12,149,5745,-71,-96,25,b6:90:18:f6:b1:d4,249967368,244,263,249967124,249967368
8792,5,12,149,5745,-68,-96,28,fa:44:8d:e1:c7:1b,249969245,244,1633,249969001,249969245
8793,5,12,149,5745,-83,-96,13,9a:24:38:da:96:bb,249972190,272,2673,249971918,249972190
8794,5,24,149,5745,-77,-96,19,,249972533,28,315,249972505,249972533
8795,5,24,149,5745,-87,-96,9,,249972577,28,16,249972549,249972577
8796,5,24,149,5745,-88,-96,8,,249972685,28,80,249972657,249972685
8797,5,12,149,5745,-75,-96,21,56:68:e2:c2:8d:d5,249978770,280,5805,249978490,249978770
8798,5,24,149,5745,-88,-96,8,,249997448,28,18650,249997420,249997448
8799,5,24,149,5745,-88,-96,8,,250000400,28,2924,250000372,250000400
8800,5,12,149,5745,-69,-96,27,22:ec:75:a8:8a:31,250017724,244,17080,250017480,250017724
8801,5,6,149,5745,-85,-96,11,54:e4:3a:ec:fb:65,250044641,360,26557,250044281,250044641
8802,5,12,149,5745,-57,-96,39,3e:d1:9b:c7:a4:de,250048802,272,3889,250048530,250048802
8803,5,12,149,5745,-75,-96,21,3e:ef:29:c7:4b:17,250050881,244,1835,250050637,250050881
8804,5,12,149,5745,-57,-96,39,f2:da:61:dd:98:c5,250054108,268,2959,250053840,250054108
8805,5,12,149,5745,-72,-96,24,f6:0a:5c:59:72:df,250064039,252,9679,250063787,250064039
8806,5,12,149,5745,-58,-96,38,5e:29:73:5b:30:00,250065377,272,1066,250065105,250065377
8807,5,12,149,5745,-70,-96,26,b6:90:18:f6:b1:d4,250069161,244,3540,250068917,250069161
8808,5,12,149,5745,-77,-96,19,72:d1:72:1d:22:a1,250069900,256,483,250069644,250069900
8809,5,12,149,5745,-68,-96,28,fa:44:8d:e1:c7:1b,250081777,244,11633,250081533,250081777
8810,5,12,149,5745,-84,-96,12,9a:24:38:da:96:bb,250084452,272,2403,250084180,250084452
8811,5,12,149,5745,-74,-96,22,56:68:e2:c2:8d:d5,250089211,280,4479,250088931,250089211
8812,5,12,149,5745,-69,-96,27,fa:44:8d:e1:c7:1b,250102122,48,12863,250102074,250102122
8813,5,12,149,5745,-70,-96,26,,250102186,32,32,250102154,250102186
8814,5,12,149,5745,-73,-96,23,56:68:e2:c2:8d:d5,250104322,476,1660,250103846,250104322
8815,5,12,149,5745,-70,-96,26,b6:90:18:f6:b1:d4,250104834,440,72,250104394,250104834
8816,5,12,149,5745,-57,-96,39,f2:da:61:dd:98:c5,250105992,268,890,250105724,250105992
8817,5,12,149,5745,-73,-96,23,f6:0a:5c:59:72:df,250110546,268,4286,250110278,250110546
8818,5,12,149,5745,-55,-96,41,9e:1f:b0:a7:b8:90,250111325,452,327,250110873,250111325
8819,5,12,149,5745,-73,-96,23,f6:0a:5c:59:72:df,250111884,448,111,250111436,250111884
8820,5,12,149,5745,-58,-96,38,5e:29:73:5b:30:00,250115394,540,2970,250114854,250115394
8821,5,12,149,5745,-69,-96,27,b6:90:18:f6:b1:d4,250117625,244,1987,250117381,250117625
8822,5,12,149,5745,-70,-96,26,22:ec:75:a8:8a:31,250118833,516,692,250118317,250118833
8823,5,12,149,5745,-66,-96,30,fa:44:8d:e1:c7:1b,250120512,440,1239,250120072,250120512
8824,5,12,149,5745,-57,-96,39,3e:d1:9b:c7:a4:de,250121059,544,3,250120515,250121059
8825,5,12,149,5745,-77,-96,19,72:d1:72:1d:22:a1,250122550,452,1039,250122098,250122550
8826,5,12,149,5745,-75,-96,21,3e:ef:29:c7:4b:17,250123047,440,57,250122607,250123047
8827,5,24,149,5745,-89,-96,7,,250136734,28,13659,250136706,250136734
8828,5,6,149,5745,-83,-96,13,54:e4:3a:ec:fb:65,250147041,360,9947,250146681,250147041
8829,5,12,149,5745,-74,-96,22,3e:ef:29:c7:4b:17,250150319,244,3034,250150075,250150319
8830,5,12,149,5745,-70,-96,26,22:ec:75:a8:8a:31,250150886,244,323,250150642,250150886
8831,5,12,149,5745,-56,-96,40,f2:da:61:dd:98:c5,250152397,268,1243,250152129,250152397
8832,5,24,149,5745,-90,-96,6,,250157153,28,4728,250157125,250157153
8833,5,24,149,5745,-90,-96,6,,250157197,28,16,250157169,250157197
8834,5,12,149,5745,-56,-96,40,3e:d1:9b:c7:a4:de,250163221,272,5752,250162949,250163221
8835,5,12,149,5745,-71,-96,25,b6:90:18:f6:b1:d4,250170296,440,6635,250169856,250170296
8836,5,12,149,5745,-58,-96,38,5e:29:73:5b:30:00,250181268,272,10700,250180996,250181268
8837,5,12,149,5745,-67,-96,29,a6:92:ad:b7:76:65,250191681,456,9957,250191225,250191681
8838,5,12,149,5745,-85,-96,11,9a:24:38:da:96:bb,250196187,272,4234,250195915,250196187
8839,5,12,149,5745,-69,-96,27,fa:44:8d:e1:c7:1b,250199940,244,3509,250199696,250199940
8840,5,12,149,5745,-74,-96,22,56:68:e2:c2:8d:d5,250202018,280,1798,250201738,250202018
8841,5,24,149,5745,-89,-96,7,,250206816,28,4770,250206788,250206816
8842,5,24,149,5745,-91,-96,5,,250210094,32,3246,250210062,250210094
8843,5,12,149,5745,-68,-96,28,a6:92:ad:b7:76:65,250216578,256,6228,250216322,250216578
8844,5,12,149,5745,-78,-96,18,d2:00:04:7e:2c:ab,250225083,104,8401,250224979,250225083
8845,5,12,149,5745,-70,-96,26,b6:90:18:f6:b1:d4,250232337,244,7010,250232093,250232337
8846,5,12,149,5745,-69,-96,27,fa:44:8d:e1:c7:1b,250235325,440,2548,250234885,250235325
8847,5,12,149,5745,-71,-96,25,b6:90:18:f6:b1:d4,250235810,440,45,250235370,250235810
8848,5,12,149,5745,-57,-96,39,f2:da:61:dd:98:c5,250236941,268,863,250236673,250236941
8849,5,12,149,5745,-76,-96,20,72:d1:72:1d:22:a1,250241080,256,3883,250240824,250241080
8850,5,12,149,5745,-57,-96,39,5e:29:73:5b:30:00,250245214,540,3594,250244674,250245214
8851,5,12,149,5745,-71,-96,25,22:ec:75:a8:8a:31,250248324,244,2866,250248080,250248324
8852,5,6,149,5745,-83,-96,13,54:e4:3a:ec:fb:65,250249441,360,757,250249081,250249441
8853,5,12,149,5745,-55,-96,41,3e:d1:9b:c7:a4:de,250251620,544,1635,250251076,250251620
8854,5,12,149,5745,-61,-96,35,0a:b9:b7:b1:4d:fa,250252658,268,770,250252390,250252658
8855,5,12,149,5745,-74,-96,22,3e:ef:29:c7:4b:17,250253761,440,663,250253321,250253761
8856,5,12,149,5745,-67,-96,29,a6:92:ad:b7:76:65,250257466,456,3249,250257010,250257466
8857,5,12,149,5745,-77,-96,19,d2:00:04:7e:2c:ab,250262800,440,4894,250262360,250262800
8858,5,12,149,5745,-74,-96,22,3e:ef:29:c7:4b:17,250264975,244,1931,250264731,250264975
8859,5,12,149,5745,-58,-96,38,f2:da:61:dd:98:c5,250266288,268,1045,250266020,250266288
8860,5,12,149,5745,-54,-96,42,3e:d1:9b:c7:a4:de,250282403,272,15843,250282131,250282403
8861,5,12,149,5745,-57,-96,39,5e:29:73:5b:30:00,250293394,272,10719,250293122,250293394
8862,5,12,149,5745,-82,-96,14,9a:24:38:da:96:bb,250307909,272,14243,250307637,250307909
8863,5,12,149,5745,-69,-96,27,fa:44:8d:e1:c7:1b,250310687,244,2534,250310443,250310687
8864,5,12,149,5745,-68,-96,28,a6:92:ad:b7:76:65,250336333,256,25390,250336077,250336333
8865,5,6,149,5745,-83,-96,13,54:e4:3a:ec:fb:65,250351842,360,15149,250351482,250351842
8866,5,12,149,5745,-70,-96,26,22:ec:75:a8:8a:31,250357721,244,5635,250357477,250357721
8867,5,12,149,5745,-72,-96,24,b6:90:18:f6:b1:d4,250358117,244,152,250357873,250358117
8868,5,12,149,5745,-75,-96,21,72:d1:72:1d:22:a1,250376860,256,18487,250376604,250376860
8869,5,12,149,5745,-75,-96,21,56:68:e2:c2:8d:d5,250378589,280,1449,250378309,250378589
8870,5,12,149,5745,-58,-96,38,3e:d1:9b:c7:a4:de,250392427,272,13566,250392155,250392427
8871,5,12,149,5745,-76,-96,20,f6:0a:5c:59:72:df,250393068,252,389,250392816,250393068
8872,5,12,149,5745,-57,-96,39,5e:29:73:5b:30:00,250410685,272,17345,250410413,250410685
8873,5,12,149,5745,-80,-96,16,9a:24:38:da:96:bb,250419745,272,8788,250419473,250419745
8874,5,12,149,5745,-69,-96,27,fa:44:8d:e1:c7:1b,250425284,244,5295,250425040,250425284
8875,5,12,149,5745,-74,-96,22,3e:ef:29:c7:4b:17,250429098,244,3570,250428854,250429098
8876,5,6,149,5745,-83,-96,13,54:e4:3a:ec:fb:65,250454243,360,24785,250453883,250454243
8877,5,12,149,5745,-57,-96,39,f2:da:61:dd:98:c5,250454945,268,434,250454677,250454945
8878,5,12,149,5745,-72,-96,24,b6:90:18:f6:b1:d4,250471273,244,16084,250471029,250471273
8879,5,6,149,5745,-65,-96,31,,250473617,44,2300,250473573,250473617
8880,5,12,149,5745,-69,-96,27,22:ec:75:a8:8a:31,250474787,244,926,250474543,250474787
8881,5,12,149,5745,-68,-96,28,a6:92:ad:b7:76:65,250477437,256,2394,250477181,250477437
8882,5,12,149,5745,-75,-96,21,72:d1:72:1d:22:a1,250478957,256,1264,250478701,250478957
8883,5,12,149,5745,-75,-96,21,56:68:e2:c2:8d:d5,250481000,280,1763,250480720,250481000
8884,5,12,149,5745,-78,-96,18,f6:0a:5c:59:72:df,250505261,252,24009,250505009,250505261
8885,5,12,149,5745,-58,-96,38,3e:d1:9b:c7:a4:de,250508106,272,2573,250507834,250508106
8886,5,6,149,5745,-77,-96,19,24:f6:77:10:02:c8,250514132,176,5850,250513956,250514132
8887,5,6,149,5745,-77,-96,19,24:f6:77:10:02:c8,250524235,176,9927,250524059,250524235
8888,5,12,149,5745,-58,-96,38,5e:29:73:5b:30:00,250526620,272,2113,250526348,250526620
8889,5,12,149,5745,-75,-96,21,3e:ef:29:c7:4b:17,250531559,244,4695,250531315,250531559
8890,5,12,149,5745,-82,-96,14,9a:24:38:da:96:bb,250532466,272,635,250532194,250532466
8891,5,24,149,5745,-89,-96,7,,250532949,28,455,250532921,250532949
8892,5,24,149,5745,-88,-96,8,,250533057,32,76,250533025,250533057
8893,5,24,149,5745,-88,-96,8,,250551268,28,18183,250551240,250551268
8894,5,6,149,5745,-83,-96,13,54:e4:3a:ec:fb:65,250556643,360,5015,250556283,250556643
8895,5,12,149,5745,-56,-96,40,f2:da:61:dd:98:c5,250557586,268,675,250557318,250557586
8896,5,12,149,5745,-45,-96,51,0e:ae:b4:1e:a1:11,250577682,240,19856,250577442,250577682
8897,5,12,149,5745,-67,-96,29,a6:92:ad:b7:76:65,250579978,256,2040,250579722,250579978
8898,5,12,149,5745,-75,-96,21,56:68:e2:c2:8d:d5,250581871,280,1613,250581591,250581871
8899,5,24,149,5745,-89,-96,7,,250582548,28,649,250582520,250582548
8900,5,12,149,5745,-71,-96,25,b6:90:18:f6:b1:d4,250584409,244,1617,250584165,250584409
8901,5,24,149,5745,-89,-96,7,,250585849,28,1412,250585821,250585849
8902,5,24,149,5745,-89,-96,7,,250585958,32,77,250585926,250585958
8903,5,12,149,5745,-70,-96,26,22:ec:75:a8:8a:31,250591757,244,5555,250591513,250591757
8904,5,24,149,5745,-88,-96,8,,250611441,28,19656,250611413,250611441
8905,5,24,149,5745,-88,-96,8,,250611549,32,76,250611517,250611549
8906,5,12,149,5745,-59,-96,37,3e:d1:9b:c7:a4:de,250620074,272,8253,250619802,250620074
8907,5,24,149,5745,-88,-96,8,,250628686,28,8584,250628658,250628686
8908,5,12,149,5745,-75,-96,21,3e:ef:29:c7:4b:17,250633466,244,4536,250633222,250633466
8909,5,24,149,5745,-90,-96,6,,250635341,28,1847,250635313,250635341
8910,5,24,149,5745,-87,-96,9,,250635449,32,76,250635417,250635449
8911,5,12,149,5745,-59,-96,37,5e:29:73:5b:30:00,250638335,272,2614,250638063,250638335
8912,5,12,149,5745,-45,-96,51,0e:ae:b4:1e:a1:11,250645171,268,6568,250644903,250645171
8913,5,12,149,5745,-74,-96,22,56:68:e2:c2:8d:d5,250650884,280,5433,250650604,250650884
8914,5,12,149,5745,-69,-96,27,fa:44:8d:e1:c7:1b,250652076,244,948,250651832,250652076
8915,5,6,149,5745,-84,-96,12,54:e4:3a:ec:fb:65,250659044,360,6608,250658684,250659044
8916,5,12,149,5745,-55,-96,41,f2:da:61:dd:98:c5,250660432,268,1120,250660164,250660432
8917,5,12,149,5745,-68,-96,28,a6:92:ad:b7:76:65,250673907,256,13219,250673651,250673907
8918,5,12,149,5745,-44,-96,52,0e:ae:b4:1e:a1:11,250690277,268,16102,250690009,250690277
8919,5,12,149,5745,-71,-96,25,b6:90:18:f6:b1:d4,250691102,244,581,250690858,250691102
8920,5,12,149,5745,-74,-96,22,56:68:e2:c2:8d:d5,250691417,476,-161,250690941,250691417
8921,5,12,149,5745,-75,-96,21,72:d1:72:1d:22:a1,250691964,256,291,250691708,250691964
8922,5,12,149,5745,-56,-96,40,f2:da:61:dd:98:c5,250694414,268,2182,250694146,250694414
8923,5,12,149,5745,-69,-96,27,fa:44:8d:e1:c7:1b,250694995,440,141,250694555,250694995
8924,5,12,149,5745,-71,-96,25,b6:90:18:f6:b1:d4,250696209,440,774,250695769,250696209
8925,5,12,149,5745,-59,-96,37,3e:d1:9b:c7:a4:de,250701920,544,5167,250701376,250701920
8926,5,12,149,5745,-75,-96,21,f6:0a:5c:59:72:df,250702852,448,484,250702404,250702852
8927,5,12,149,5745,-61,-96,35,5e:29:73:5b:30:00,250704659,540,1267,250704119,250704659
8928,5,12,149,5745,-70,-96,26,22:ec:75:a8:8a:31,250706465,516,1290,250705949,250706465
8929,5,12,149,5745,-75,-96,21,f6:0a:5c:59:72:df,250707383,252,666,250707131,250707383
8930,5,12,149,5745,-74,-96,22,3e:ef:29:c7:4b:17,250712369,440,4546,250711929,250712369
8931,5,12,149,5745,-75,-96,21,72:d1:72:1d:22:a1,250713789,452,968,250713337,250713789
8932,5,12,149,5745,-68,-96,28,a6:92:ad:b7:76:65,250715652,456,1407,250715196,250715652
8933,5,12,149,5745,-74,-96,22,3e:ef:29:c7:4b:17,250723173,244,7277,250722929,250723173
8934,5,12,149,5745,-70,-96,26,22:ec:75:a8:8a:31,250723541,244,124,250723297,250723541
8935,5,12,149,5745,-57,-96,39,f2:da:61:dd:98:c5,250725070,268,1261,250724802,250725070
8936,5,12,149,5745,-60,-96,36,3e:d1:9b:c7:a4:de,250740634,272,15292,250740362,250740634
8937,5,12,149,5745,-84,-96,12,9a:24:38:da:96:bb,250756197,272,15291,250755925,250756197
8938,5,12,149,5745,-75,-96,21,56:68:e2:c2:8d:d5,250756933,476,260,250756457,250756933
8939,5,12,149,5745,-67,-96,29,fa:44:8d:e1:c7:1b,250757445,244,268,250757201,250757445
8940,5,12,149,5745,-75,-96,21,56:68:e2:c2:8d:d5,250757723,280,-2,250757443,250757723
8941,5,12,149,5745,-62,-96,34,5e:29:73:5b:30:00,250758037,272,42,250757765,250758037
8942,5,12,149,5745,-66,-96,30,fa:44:8d:e1:c7:1b,250759486,440,1009,250759046,250759486
8943,5,12,149,5745,-71,-96,25,b6:90:18:f6:b1:d4,250760016,440,90,250759576,250760016
8944,5,12,149,5745,-57,-96,39,f2:da:61:dd:98:c5,250760508,268,224,250760240,250760508
8945,5,6,149,5745,-83,-96,13,54:e4:3a:ec:fb:65,250761444,360,576,250761084,250761444
8946,5,12,149,5745,-45,-96,51,0e:ae:b4:1e:a1:11,250761858,240,174,250761618,250761858
8947,5,12,149,5745,-77,-96,19,f6:0a:5c:59:72:df,250764597,268,2471,250764329,250764597
8948,5,12,149,5745,-54,-96,42,9e:1f:b0:a7:b8:90,250765845,380,868,250765465,250765845
8949,5,12,149,5745,-54,-96,42,9e:1f:b0:a7:b8:90,250766359,152,362,250766207,250766359
8950,5,12,149,5745,-54,-96,42,9e:1f:b0:a7:b8:90,250766572,424,-211,250766148,250766572
8951,5,12,149,5745,-61,-96,35,3e:d1:9b:c7:a4:de,250767084,544,-32,250766540,250767084
8952,5,12,149,5745,-83,-96,13,9a:24:38:da:96:bb,250767699,824,-209,250766875,250767699
8953,5,12,149,5745,-45,-96,51,0e:ae:b4:1e:a1:11,250769452,104,1649,250769348,250769452
8954,5,12,149,5745,-46,-96,50,0e:ae:b4:1e:a1:11,250769573,116,5,250769457,250769573
8955,5,12,149,5745,-62,-96,34,5e:29:73:5b:30:00,250769733,540,-380,250769193,250769733
8956,5,12,149,5745,-70,-96,26,22:ec:75:a8:8a:31,250771828,516,1579,250771312,250771828
8957,5,12,149,5745,-68,-96,28,a6:92:ad:b7:76:65,250773539,256,1455,250773283,250773539
8958,5,12,149,5745,-62,-96,34,0a:b9:b7:b1:4d:fa,250776592,268,2785,250776324,250776592
8959,5,12,149,5745,-75,-96,21,3e:ef:29:c7:4b:17,250776925,440,-107,250776485,250776925
8960,5,12,149,5745,-74,-96,22,72:d1:72:1d:22:a1,250777779,452,402,250777327,250777779
8961,5,12,149,5745,-79,-96,17,d2:00:04:7e:2c:ab,250781262,380,3103,250780882,250781262
8962,5,12,149,5745,-68,-96,28,a6:92:ad:b7:76:65,250781694,456,-24,250781238,250781694
8963,5,12,149,5745,-78,-96,18,d2:00:04:7e:2c:ab,250786036,440,3902,250785596,250786036
8964,5,12,149,5745,-74,-96,22,72:d1:72:1d:22:a1,250790066,256,3774,250789810,250790066
8965,5,24,149,5745,-89,-96,7,,250799817,32,9719,250799785,250799817
8966,5,12,149,5745,-46,-96,50,0e:ae:b4:1e:a1:11,250802389,240,2332,250802149,250802389
8967,5,12,149,5745,-71,-96,25,b6:90:18:f6:b1:d4,250806242,244,3609,250805998,250806242
8968,5,24,149,5745,-90,-96,6,,250816956,28,10686,250816928,250816956
8969,5,12,149,5745,-70,-96,26,22:ec:75:a8:8a:31,250818327,244,1127,250818083,250818327
8970,5,12,149,5745,-60,-96,36,3e:d1:9b:c7:a4:de,250832447,544,13576,250831903,250832447
8971,5,12,149,5745,-73,-96,23,f6:0a:5c:59:72:df,250840423,252,7724,250840171,250840423
8972,5,12,149,5745,-57,-96,39,f2:da:61:dd:98:c5,250844269,268,3578,250844001,250844269
8973,5,12,149,5745,-74,-96,22,3e:ef:29:c7:4b:17,250847244,244,2731,250847000,250847244
8974,5,12,149,5745,-62,-96,34,3e:d1:9b:c7:a4:de,250855010,272,7494,250854738,250855010
8975,5,6,149,5745,-84,-96,12,54:e4:3a:ec:fb:65,250863845,360,8475,250863485,250863845
8976,5,12,149,5745,-63,-96,33,5e:29:73:5b:30:00,250867934,272,3817,250867662,250867934
8977,5,12,149,5745,-85,-96,11,9a:24:38:da:96:bb,250868942,272,736,250868670,250868942
8978,5,12,149,5745,-68,-96,28,fa:44:8d:e1:c7:1b,250877934,244,8748,250877690,250877934
8979,5,12,149,5745,-75,-96,21,56:68:e2:c2:8d:d5,250879688,280,1474,250879408,250879688
8980,5,12,149,5745,-61,-96,35,3e:d1:9b:c7:a4:de,250898236,544,18004,250897692,250898236
8981,5,12,149,5745,-69,-96,27,a6:92:ad:b7:76:65,250899394,256,902,250899138,250899394
8982,5,24,149,5745,-76,-96,20,,250910984,28,11562,250910956,250910984
8983,5,12,149,5745,-70,-96,26,22:ec:75:a8:8a:31,250933369,244,22141,250933125,250933369
8984,5,12,149,5745,-74,-96,22,3e:ef:29:c7:4b:17,250956489,244,22876,250956245,250956489
8985,5,24,149,5745,-85,-96,11,,250958541,28,2024,250958513,250958541
8986,5,24,149,5745,-85,-96,11,,250958654,32,81,250958622,250958654
8987,5,24,149,5745,-89,-96,7,,250962944,28,4262,250962916,250962944
8988,5,12,149,5745,-60,-96,36,3e:d1:9b:c7:a4:de,250963747,544,259,250963203,250963747
8989,5,6,149,5745,-83,-96,13,54:e4:3a:ec:fb:65,250966245,360,2138,250965885,250966245
8990,5,12,149,5745,-58,-96,38,f2:da:61:dd:98:c5,250967200,268,687,250966932,250967200
8991,5,12,149,5745,-60,-96,36,3e:d1:9b:c7:a4:de,250969608,272,2136,250969336,250969608
8992,5,12,149,5745,-62,-96,34,5e:29:73:5b:30:00,250984996,272,15116,250984724,250984996
8993,5,24,149,5745,-74,-96,22,,250987250,28,2226,250987222,250987250
8994,5,24,149,5745,-90,-96,6,,250987294,28,16,250987266,250987294
8995,5,12,149,5745,-74,-96,22,56:68:e2:c2:8d:d5,250987741,280,167,250987461,250987741
8996,5,12,149,5745,-75,-96,21,72:d1:72:1d:22:a1,250990847,256,2850,250990591,250990847
8997,5,12,149,5745,-70,-96,26,b6:90:18:f6:b1:d4,250991186,244,95,250990942,250991186
8998,5,12,149,5745,-67,-96,29,fa:44:8d:e1:c7:1b,250991770,244,340,250991526,250991770
8999,5,24,149,5745,-88,-96,8,,251021263,28,29465,251021235,251021263
9000,5,24,149,5745,-88,-96,8,,251021372,32,77,251021340,251021372
9001,5,24,149,5745,-85,-96,11,,251023001,32,1597,251022969,251023001
9002,5,24,149,5745,-90,-96,6,,251023707,32,674,251023675,251023707
9003,5,24,149,5745,-90,-96,6,,251038686,28,14951,251038658,251038686
9004,5,24,149,5745,-89,-96,7,,251043681,28,4967,251043653,251043681
9005,5,24,149,5745,-88,-96,8,,251043790,32,77,251043758,251043790
9006,5,12,149,5745,-44,-96,52,0e:ae:b4:1e:a1:11,251047632,240,3602,251047392,251047632
9007,5,12,149,5745,-71,-96,25,22:ec:75:a8:8a:31,251050563,244,2687,251050319,251050563
9008,5,24,149,5745,-89,-96,7,,251050847,28,256,251050819,251050847
9009,5,24,149,5745,-85,-96,11,,251050893,28,18,251050865,251050893
9010,5,24,149,5745,-85,-96,11,,251051003,32,78,251050971,251051003
9011,5,6,149,5745,-85,-96,11,54:e4:3a:ec:fb:65,251068646,360,17283,251068286,251068646
9012,5,12,149,5745,-59,-96,37,f2:da:61:dd:98:c5,251069357,268,443,251069089,251069357
9013,5,12,149,5745,-63,-96,33,3e:d1:9b:c7:a4:de,251073670,272,4041,251073398,251073670
9014,5,12,149,5745,-74,-96,22,3e:ef:29:c7:4b:17,251074526,244,612,251074282,251074526
9015,5,12,149,5745,-68,-96,28,a6:92:ad:b7:76:65,251091880,256,17098,251091624,251091880
9016,5,12,149,5745,-70,-96,26,b6:90:18:f6:b1:d4,251093143,244,1019,251092899,251093143
9017,5,12,149,5745,-75,-96,21,72:d1:72:1d:22:a1,251093909,256,510,251093653,251093909
9018,5,12,149,5745,-79,-96,17,9a:24:38:da:96:bb,251096579,272,2398,251096307,251096579
9019,5,12,149,5745,-74,-96,22,56:68:e2:c2:8d:d5,251099876,280,3017,251099596,251099876
9020,5,12,149,5745,-62,-96,34,5e:29:73:5b:30:00,251101969,272,1821,251101697,251101969
9021,5,12,149,5745,-67,-96,29,fa:44:8d:e1:c7:1b,251104505,244,2292,251104261,251104505
9022,5,24,149,5745,-90,-96,6,,251105867,32,1330,251105835,251105867
9023,5,24,149,5745,-90,-96,6,,251107310,32,1411,251107278,251107310
9024,5,12,149,5745,-69,-96,27,a6:92:ad:b7:76:65,251126178,256,18612,251125922,251126178
9025,5,12,149,5745,-67,-96,29,fa:44:8d:e1:c7:1b,251136231,48,10005,251136183,251136231
9026,5,12,149,5745,-70,-96,26,,251136295,32,32,251136263,251136295
9027,5,12,149,5745,-75,-96,21,72:d1:72:1d:22:a1,251137344,256,793,251137088,251137344
9028,5,12,149,5745,-44,-96,52,0e:ae:b4:1e:a1:11,251137940,240,356,251137700,251137940
9029,5,12,149,5745,-69,-96,27,b6:90:18:f6:b1:d4,251149732,244,11548,251149488,251149732
9030,5,12,149,5745,-74,-96,22,56:68:e2:c2:8d:d5,251152908,476,2700,251152432,251152908
9031,5,12,149,5745,-58,-96,38,f2:da:61:dd:98:c5,251154345,268,1169,251154077,251154345
9032,5,12,149,5745,-67,-96,29,fa:44:8d:e1:c7:1b,251154666,440,-119,251154226,251154666
9033,5,12,149,5745,-69,-96,27,b6:90:18:f6:b1:d4,251155569,440,463,251155129,251155569
9034,5,12,149,5745,-73,-96,23,f6:0a:5c:59:72:df,251159288,448,3271,251158840,251159288
9035,5,12,149,5745,-56,-96,40,9e:1f:b0:a7:b8:90,251160908,380,1240,251160528,251160908
9036,5,12,149,5745,-57,-96,39,9e:1f:b0:a7:b8:90,251161377,152,317,251161225,251161377
9037,5,12,149,5745,-82,-96,14,9a:24:38:da:96:bb,251161701,824,-500,251160877,251161701
9038,5,12,149,5745,-63,-96,33,3e:d1:9b:c7:a4:de,251162569,544,324,251162025,251162569
9039,5,12,149,5745,-62,-96,34,5e:29:73:5b:30:00,251164950,540,1841,251164410,251164950
9040,5,12,149,5745,-71,-96,25,22:ec:75:a8:8a:31,251166735,516,1269,251166219,251166735
9041,5,12,149,5745,-59,-96,37,f2:da:61:dd:98:c5,251167393,268,390,251167125,251167393
9042,5,12,149,5745,-75,-96,21,3e:ef:29:c7:4b:17,251170898,440,3065,251170458,251170898
9043,5,12,149,5745,-75,-96,21,72:d1:72:1d:22:a1,251172310,452,960,251171858,251172310
9044,5,12,149,5745,-57,-96,39,9e:1f:b0:a7:b8:90,251173309,424,575,251172885,251173309
9045,5,12,149,5745,-68,-96,28,a6:92:ad:b7:76:65,251174397,456,632,251173941,251174397
9046,5,12,149,5745,-71,-96,25,22:ec:75:a8:8a:31,251182239,244,7598,251181995,251182239
9047,5,12,149,5745,-74,-96,22,3e:ef:29:c7:4b:17,251184130,244,1647,251183886,251184130
9048,5,12,149,5745,-62,-96,34,3e:d1:9b:c7:a4:de,251199356,272,14954,251199084,251199356
9049,5,12,149,5745,-74,-96,22,56:68:e2:c2:8d:d5,251201049,280,1413,251200769,251201049
9050,5,12,149,5745,-80,-96,16,9a:24:38:da:96:bb,251204770,272,3449,251204498,251204770
9051,5,12,149,5745,-62,-96,34,5e:29:73:5b:30:00,251217047,272,12005,251216775,251217047
9052,5,12,149,5745,-68,-96,28,a6:92:ad:b7:76:65,251217794,456,291,251217338,251217794
9053,5,12,149,5745,-69,-96,27,b6:90:18:f6:b1:d4,251218367,440,133,251217927,251218367
9054,5,12,149,5745,-61,-96,35,3e:d1:9b:c7:a4:de,251225903,544,6992,251225359,251225903
9055,5,12,149,5745,-57,-96,39,9e:1f:b0:a7:b8:90,251226492,424,165,251226068,251226492
9056,5,12,149,5745,-68,-96,28,a6:92:ad:b7:76:65,251232082,256,5334,251231826,251232082
9057,5,12,149,5745,-75,-96,21,72:d1:72:1d:22:a1,251257509,256,25171,251257253,251257509
9058,5,12,149,5745,-69,-96,27,b6:90:18:f6:b1:d4,251264866,244,7113,251264622,251264866
9059,5,12,149,5745,-58,-96,38,9e:1f:b0:a7:b8:90,251266359,256,1237,251266103,251266359
9060,5,6,149,5745,-86,-96,10,54:e4:3a:ec:fb:65,251273447,360,6728,251273087,251273447
9061,5,12,149,5745,-58,-96,38,f2:da:61:dd:98:c5,251282069,268,8354,251281801,251282069
9062,5,12,149,5745,-67,-96,29,a6:92:ad:b7:76:65,251283118,456,593,251282662,251283118
9063,5,12,149,5745,-69,-96,27,b6:90:18:f6:b1:d4,251284789,440,1231,251284349,251284789
9064,5,12,149,5745,-58,-96,38,f2:da:61:dd:98:c5,251285523,268,466,251285255,251285523
9065,5,12,149,5745,-58,-96,38,9e:1f:b0:a7:b8:90,251290920,424,4973,251290496,251290920
9066,5,12,149,5745,-59,-96,37,3e:d1:9b:c7:a4:de,251291414,544,-50,251290870,251291414
9067,5,12,149,5745,-81,-96,15,9a:24:38:da:96:bb,251295166,824,2928,251294342,251295166
9068,5,12,149,5745,-62,-96,34,5e:29:73:5b:30:00,251296034,540,328,251295494,251296034
9069,5,12,149,5745,-70,-96,26,22:ec:75:a8:8a:31,251297103,244,825,251296859,251297103
9070,5,12,149,5745,-44,-96,52,0e:ae:b4:1e:a1:11,251297669,240,326,251297429,251297669
9071,5,12,149,5745,-75,-96,21,3e:ef:29:c7:4b:17,251298859,244,946,251298615,251298859
9072,5,12,149,5745,-70,-96,26,22:ec:75:a8:8a:31,251299191,516,-184,251298675,251299191
9073,5,12,149,5745,-61,-96,35,0a:b9:b7:b1:4d:fa,251302649,268,3190,251302381,251302649
9074,5,12,149,5745,-75,-96,21,3e:ef:29:c7:4b:17,251303530,440,441,251303090,251303530
9075,5,24,149,5745,-88,-96,8,,251307598,28,4040,251307570,251307598
9076,5,12,149,5745,-77,-96,19,d2:00:04:7e:2c:ab,251308340,440,302,251307900,251308340
9077,5,12,149,5745,-72,-96,24,f6:0a:5c:59:72:df,251308826,252,234,251308574,251308826
9078,5,12,149,5745,-59,-96,37,3e:d1:9b:c7:a4:de,251313710,272,4612,251313438,251313710
9079,5,12,149,5745,-81,-96,15,9a:24:38:da:96:bb,251316106,272,2124,251315834,251316106
9080,5,24,149,5745,-89,-96,7,,251325708,28,9574,251325680,251325708
9081,5,12,149,5745,-62,-96,34,5e:29:73:5b:30:00,251331767,272,5787,251331495,251331767
9082,5,12,149,5745,-58,-96,38,3e:d1:9b:c7:a4:de,251356505,544,24194,251355961,251356505
9083,5,12,149,5745,-68,-96,28,a6:92:ad:b7:76:65,251357128,256,367,251356872,251357128
9084,5,24,149,5745,-89,-96,7,,251361665,28,4509,251361637,251361665
9085,5,24,149,5745,-89,-96,7,,251370168,32,8471,251370136,251370168
9086,5,6,149,5745,-85,-96,11,54:e4:3a:ec:fb:65,251375847,360,5319,251375487,251375847
9087,5,12,149,5745,-68,-96,28,b6:90:18:f6:b1:d4,251376784,244,693,251376540,251376784
9088,5,6,149,5745,-67,-96,29,f8:89:d2:65:d2:3b,251382311,160,5367,251382151,251382311
9089,5,24,149,5745,-89,-96,7,,251384465,28,2126,251384437,251384465
9090,5,24,149,5745,-88,-96,8,,251384802,28,309,251384774,251384802
9091,5,24,149,5745,-89,-96,7,,251387768,28,2938,251387740,251387768
9092,5,24,149,5745,-87,-96,9,,251388063,28,267,251388035,251388063
9093,5,24,149,5745,-87,-96,9,,251388171,32,76,251388139,251388171
9094,5,12,149,5745,-56,-96,40,9e:1f:b0:a7:b8:90,251391045,256,2618,251390789,251391045
9095,5,12,149,5745,-70,-96,26,22:ec:75:a8:8a:31,251393217,244,1928,251392973,251393217
9096,5,12,149,5745,-74,-96,22,72:d1:72:1d:22:a1,251400478,256,7005,251400222,251400478
9097,5,12,149,5745,-74,-96,22,56:68:e2:c2:8d:d5,251402577,280,1819,251402297,251402577
9098,5,24,149,5745,-88,-96,8,,251408514,32,5905,251408482,251408514
9099,5,12,149,5745,-59,-96,37,3e:d1:9b:c7:a4:de,251422538,544,13480,251421994,251422538
9100,5,12,149,5745,-59,-96,37,3e:d1:9b:c7:a4:de,251428408,272,5598,251428136,251428408
9101,5,6,149,5745,-66,-96,30,f8:89:d2:65:d2:3b,251432517,160,3949,251432357,251432517
9102,5,6,149,5745,-86,-96,10,54:e4:3a:ec:fb:65,251432823,352,-46,251432471,251432823
9103,5,6,149,5745,-86,-96,10,54:e4:3a:ec:fb:65,251433273,352,98,251432921,251433273
9104,5,6,149,5745,-86,-96,10,54:e4:3a:ec:fb:65,251433830,352,205,251433478,251433830
9105,5,24,149,5745,-89,-96,7,,251434676,28,818,251434648,251434676
9106,5,6,149,5745,-85,-96,11,54:e4:3a:ec:fb:65,251434920,352,-108,251434568,251434920
9107,5,24,149,5745,-88,-96,8,,251437811,32,2859,251437779,251437811
9108,5,24,149,5745,-89,-96,7,,251437868,28,29,251437840,251437868
9109,5,12,149,5745,-60,-96,36,5e:29:73:5b:30:00,251443147,272,5007,251442875,251443147
9110,5,12,149,5745,-75,-96,21,3e:ef:29:c7:4b:17,251452581,244,9190,251452337,251452581
9111,5,6,149,5745,-86,-96,10,54:e4:3a:ec:fb:65,251478248,360,25307,251477888,251478248
9112,5,12,149,5745,-56,-96,40,f2:da:61:dd:98:c5,251478951,268,435,251478683,251478951
9113,5,12,149,5745,-57,-96,39,3e:d1:9b:c7:a4:de,251487988,544,8493,251487444,251487988
9114,5,12,149,5745,-68,-96,28,a6:92:ad:b7:76:65,251501386,256,13142,251501130,251501386
9115,5,12,149,5745,-44,-96,52,0e:ae:b4:1e:a1:11,251502572,240,946,251502332,251502572
9116,5,12,149,5745,-74,-96,22,72:d1:72:1d:22:a1,251502909,256,81,251502653,251502909
9117,5,12,149,5745,-68,-96,28,b6:90:18:f6:b1:d4,251503408,244,255,251503164,251503408
9118,5,12,149,5745,-73,-96,23,56:68:e2:c2:8d:d5,251505025,280,1337,251504745,251505025
9119,5,12,149,5745,-70,-96,26,22:ec:75:a8:8a:31,251510306,244,5037,251510062,251510306
9120,5,12,149,5745,-57,-96,39,3e:d1:9b:c7:a4:de,251527558,272,16980,251527286,251527558
9121,5,12,149,5745,-79,-96,17,9a:24:38:da:96:bb,251544749,272,16919,251544477,251544749
9122,5,12,149,5745,-75,-96,21,3e:ef:29:c7:4b:17,251555855,244,10862,251555611,251555855
9123,5,12,149,5745,-60,-96,36,5e:29:73:5b:30:00,251560063,272,3936,251559791,251560063
9124,5,6,149,5745,-88,-96,8,54:e4:3a:ec:fb:65,251580648,360,20225,251580288,251580648
9125,5,12,149,5745,-56,-96,40,f2:da:61:dd:98:c5,251581546,268,630,251581278,251581546
9126,5,12,149,5745,-56,-96,40,9e:1f:b0:a7:b8:90,251581930,256,128,251581674,251581930
9127,5,24,149,5745,-89,-96,7,,251595001,32,13039,251594969,251595001
9128,5,12,149,5745,-68,-96,28,a6:92:ad:b7:76:65,251603754,256,8497,251603498,251603754
9129,5,12,149,5745,-68,-96,28,b6:90:18:f6:b1:d4,251605093,244,1095,251604849,251605093
9130,5,12,149,5745,-73,-96,23,56:68:e2:c2:8d:d5,251605461,280,88,251605181,251605461
9131,5,12,149,5745,-74,-96,22,72:d1:72:1d:22:a1,251605983,256,266,251605727,251605983
9132,5,12,149,5745,-70,-96,26,22:ec:75:a8:8a:31,251626078,244,19851,251625834,251626078
9133,5,12,149,5745,-72,-96,24,f6:0a:5c:59:72:df,251630579,252,4249,251630327,251630579
9134,5,12,149,5745,-57,-96,39,3e:d1:9b:c7:a4:de,251640479,272,9628,251640207,251640479
9135,5,12,149,5745,-81,-96,15,9a:24:38:da:96:bb,251652693,272,11942,251652421,251652693
9136,5,12,149,5745,-76,-96,20,3e:ef:29:c7:4b:17,251658149,244,5212,251657905,251658149
9137,5,12,149,5745,-61,-96,35,5e:29:73:5b:30:00,251671366,272,12945,251671094,251671366
9138,5,6,149,5745,-87,-96,9,54:e4:3a:ec:fb:65,251683049,360,11323,251682689,251683049
9139,5,12,149,5745,-56,-96,40,f2:da:61:dd:98:c5,251684362,268,1045,251684094,251684362
9140,5,12,149,5745,-56,-96,40,9e:1f:b0:a7:b8:90,251684711,256,93,251684455,251684711
9141,5,12,149,5745,-44,-96,52,0e:ae:b4:1e:a1:11,251704320,240,19369,251704080,251704320
9142,5,12,149,5745,-68,-96,28,a6:92:ad:b7:76:65,251705901,256,1325,251705645,251705901
9143,5,12,149,5745,-70,-96,26,56:68:e2:c2:8d:d5,251708126,280,1945,251707846,251708126
9144,5,12,149,5745,-74,-96,22,72:d1:72:1d:22:a1,251708444,256,62,251708188,251708444
9145,5,12,149,5745,-69,-96,27,b6:90:18:f6:b1:d4,251725042,244,16354,251724798,251725042
9146,5,12,149,5745,-56,-96,40,9e:1f:b0:a7:b8:90,251728096,256,2798,251727840,251728096
9147,5,12,149,5745,-73,-96,23,f6:0a:5c:59:72:df,251730662,252,2314,251730410,251730662
9148,5,12,149,5745,-70,-96,26,56:68:e2:c2:8d:d5,251740056,476,8918,251739580,251740056
9149,5,12,149,5745,-57,-96,39,f2:da:61:dd:98:c5,251740873,268,549,251740605,251740873
9150,5,12,149,5745,-75,-96,21,3e:ef:29:c7:4b:17,251741175,244,58,251740931,251741175
9151,5,12,149,5745,-68,-96,28,a6:92:ad:b7:76:65,251742326,456,695,251741870,251742326
9152,5,12,149,5745,-69,-96,27,b6:90:18:f6:b1:d4,251744949,440,2183,251744509,251744949
9153,5,12,149,5745,-57,-96,39,f2:da:61:dd:98:c5,251745423,268,206,251745155,251745423
9154,5,12,149,5745,-72,-96,24,f6:0a:5c:59:72:df,251751800,448,5929,251751352,251751800
9155,5,12,149,5745,-56,-96,40,9e:1f:b0:a7:b8:90,251752444,424,220,251752020,251752444
9156,5,12,149,5745,-61,-96,35,5e:29:73:5b:30:00,251752921,540,-63,251752381,251752921
9157,5,12,149,5745,-69,-96,27,22:ec:75:a8:8a:31,251755025,516,1588,251754509,251755025
9158,5,12,149,5745,-69,-96,27,22:ec:75:a8:8a:31,251755711,244,442,251755467,251755711
9159,5,12,149,5745,-71,-96,25,56:68:e2:c2:8d:d5,251757096,280,1105,251756816,251757096
9160,5,12,149,5745,-57,-96,39,3e:d1:9b:c7:a4:de,251761046,544,3406,251760502,251761046
9161,5,24,149,5745,-90,-96,6,,251762038,28,964,251762010,251762038
9162,5,24,149,5745,-90,-96,6,,251762129,28,63,251762101,251762129
9163,5,12,149,5745,-75,-96,21,3e:ef:29:c7:4b:17,251763236,440,667,251762796,251763236
9164,5,12,149,5745,-85,-96,11,9a:24:38:da:96:bb,251765035,272,1527,251764763,251765035
9165,5,12,149,5745,-58,-96,38,3e:d1:9b:c7:a4:de,251772480,272,7173,251772208,251772480
9166,5,6,149,5745,-86,-96,10,54:e4:3a:ec:fb:65,251785450,360,12610,251785090,251785450
9167,5,12,149,5745,-68,-96,28,a6:92:ad:b7:76:65,251789436,256,3730,251789180,251789436
9168,5,12,149,5745,-71,-96,25,56:68:e2:c2:8d:d5,251805446,476,15534,251804970,251805446
9169,5,12,149,5745,-72,-96,24,72:d1:72:1d:22:a1,251805957,256,255,251805701,251805957
9170,5,12,149,5745,-60,-96,36,5e:29:73:5b:30:00,251806302,272,73,251806030,251806302
9171,5,12,149,5745,-68,-96,28,a6:92:ad:b7:76:65,251807562,456,804,251807106,251807562
9172,5,12,149,5745,-58,-96,38,f2:da:61:dd:98:c5,251808063,268,233,251807795,251808063
9173,5,12,149,5745,-69,-96,27,b6:90:18:f6:b1:d4,251808518,440,15,251808078,251808518
9174,5,12,149,5745,-44,-96,52,0e:ae:b4:1e:a1:11,251810594,240,1836,251810354,251810594
9175,5,12,149,5745,-75,-96,21,f6:0a:5c:59:72:df,251814095,448,3053,251813647,251814095
9176,5,12,149,5745,-56,-96,40,9e:1f:b0:a7:b8:90,251815468,424,949,251815044,251815468
9177,5,12,149,5745,-61,-96,35,5e:29:73:5b:30:00,251818539,540,2531,251817999,251818539
9178,5,12,149,5745,-85,-96,11,9a:24:38:da:96:bb,251819123,824,-240,251818299,251819123
9179,5,24,149,5745,-90,-96,6,,251820187,32,1032,251820155,251820187
9180,5,12,149,5745,-69,-96,27,22:ec:75:a8:8a:31,251820271,516,-432,251819755,251820271
9181,5,12,149,5745,-69,-96,27,b6:90:18:f6:b1:d4,251822160,244,1645,251821916,251822160
9182,5,24,149,5745,-90,-96,6,,251825701,32,3509,251825669,251825701
9183,5,12,149,5745,-72,-96,24,72:d1:72:1d:22:a1,251826154,452,1,251825702,251826154
9184,5,12,149,5745,-58,-96,38,3e:d1:9b:c7:a4:de,251826649,544,-49,251826105,251826649
9185,5,12,149,5745,-77,-96,19,d2:00:04:7e:2c:ab,251827228,440,139,251826788,251827228
9186,5,12,149,5745,-75,-96,21,3e:ef:29:c7:4b:17,251827748,440,80,251827308,251827748
9187,5,12,149,5745,-63,-96,33,0a:b9:b7:b1:4d:fa,251828223,268,207,251827955,251828223
9188,5,24,149,5745,-91,-96,5,,251828623,28,372,251828595,251828623
9189,5,24,149,5745,-71,-96,25,,251831611,28,2960,251831583,251831611
9190,5,24,149,5745,-90,-96,6,,251831763,28,124,251831735,251831763
9191,5,24,149,5745,-70,-96,26,,251832000,28,209,251831972,251832000
9192,5,24,149,5745,-90,-96,6,,251832153,28,125,251832125,251832153
9193,5,12,149,5745,-44,-96,52,0e:ae:b4:1e:a1:11,251836289,160,3976,251836129,251836289
9194,5,12,149,5745,-55,-96,41,9e:1f:b0:a7:b8:90,251839126,256,2581,251838870,251839126
9195,5,12,149,5745,-74,-96,22,f6:0a:5c:59:72:df,251842037,252,2659,251841785,251842037
9196,5,12,149,5745,-69,-96,27,22:ec:75:a8:8a:31,251854915,244,12634,251854671,251854915
9197,5,12,149,5745,-61,-96,35,f2:da:61:dd:98:c5,251855967,268,784,251855699,251855967
9198,5,12,149,5745,-75,-96,21,3e:ef:29:c7:4b:17,251857187,244,976,251856943,251857187
9199,5,12,149,5745,-58,-96,38,3e:d1:9b:c7:a4:de,251866385,272,8926,251866113,251866385
9200,5,12,149,5745,-83,-96,13,9a:24:38:da:96:bb,251878115,272,11458,251877843,251878115
9201,5,24,149,5745,-88,-96,8,,251883630,28,5487,251883602,251883630
9202,5,6,149,5745,-84,-96,12,54:e4:3a:ec:fb:65,251887850,360,3860,251887490,251887850
9203,5,24,149,5745,-71,-96,25,,251888340,28,462,251888312,251888340
9204,5,24,149,5745,-90,-96,6,,251888384,28,16,251888356,251888384
9205,5,24,149,5745,-90,-96,6,,251888492,28,80,251888464,251888492
9206,5,12,149,5745,-71,-96,25,56:68:e2:c2:8d:d5,251890651,280,1879,251890371,251890651
9207,5,12,149,5745,-60,-96,36,5e:29:73:5b:30:00,251901561,272,10638,251901289,251901561
9208,5,12,149,5745,-69,-96,27,a6:92:ad:b7:76:65,251916473,256,14656,251916217,251916473
9209,5,24,149,5745,-69,-96,27,,251923358,28,6857,251923330,251923358
9210,5,24,149,5745,-90,-96,6,,251923402,28,16,251923374,251923402
9211,5,24,149,5745,-69,-96,27,,251923701,28,271,251923673,251923701
9212,5,24,149,5745,-90,-96,6,,251923745,28,16,251923717,251923745
9213,5,24,149,5745,-90,-96,6,,251923852,28,79,251923824,251923852
9214,5,24,149,5745,-69,-96,27,,251924052,28,172,251924024,251924052
9215,5,24,149,5745,-90,-96,6,,251924096,28,16,251924068,251924096
9216,5,24,149,5745,-89,-96,7,,251940684,32,16556,251940652,251940684
9217,5,24,149,5745,-91,-96,5,,251942235,28,1523,251942207,251942235
9218,5,24,149,5745,-87,-96,9,,251942280,28,17,251942252,251942280
9219,5,24,149,5745,-88,-96,8,,251942388,32,76,251942356,251942388
9220,5,24,149,5745,-86,-96,10,,251942981,32,561,251942949,251942981
9221,5,12,149,5745,-44,-96,52,0e:ae:b4:1e:a1:11,251946379,240,3158,251946139,251946379
9222,5,24,149,5745,-87,-96,9,,251950052,28,3645,251950024,251950052
9223,5,24,149,5745,-88,-96,8,,251950160,32,76,251950128,251950160
9224,5,24,149,5745,-87,-96,9,,251965655,28,15467,251965627,251965655
9225,5,24,149,5745,-87,-96,9,,251965762,32,75,251965730,251965762
9226,5,12,149,5745,-69,-96,27,22:ec:75:a8:8a:31,251965847,244,-159,251965603,251965847
9227,5,24,149,5745,-90,-96,6,,251966251,28,376,251966223,251966251
9228,5,24,149,5745,-90,-96,6,,251968627,28,2348,251968599,251968627
9229,5,12,149,5745,-73,-96,23,3e:ef:29:c7:4b:17,251976322,244,7451,251976078,251976322
9230,5,12,149,5745,-57,-96,39,3e:d1:9b:c7:a4:de,251982353,272,5759,251982081,251982353
9231,5,24,149,5745,-70,-96,26,,251984183,28,1802,251984155,251984183
9232,5,24,149,5745,-69,-96,27,,251984453,28,242,251984425,251984453
9233,5,24,149,5745,-86,-96,10,,251988156,32,3671,251988124,251988156
9234,5,6,149,5745,-84,-96,12,54:e4:3a:ec:fb:65,251990251,360,1735,251989891,251990251
9235,5,24,149,5745,-86,-96,10,,251990936,28,657,251990908,251990936
9236,5,24,149,5745,-91,-96,5,,251990980,28,16,251990952,251990980
9237,5,12,149,5745,-57,-96,39,9e:1f:b0:a7:b8:90,251991230,256,-6,251990974,251991230
9238,5,12,149,5745,-60,-96,36,f2:da:61:dd:98:c5,251991525,268,27,251991257,251991525
9239,5,12,149,5745,-78,-96,18,9a:24:38:da:96:bb,251993401,272,1604,251993129,251993401
9240,5,12,149,5745,-69,-96,27,b6:90:18:f6:b1:d4,252014248,244,20603,252014004,252014248
9241,5,12,149,5745,-74,-96,22,72:d1:72:1d:22:a1,252014951,256,447,252014695,252014951
9242,5,12,149,5745,-71,-96,25,56:68:e2:c2:8d:d5,252017059,280,1828,252016779,252017059
9243,5,12,149,5745,-57,-96,39,5e:29:73:5b:30:00,252017490,272,159,252017218,252017490
9244,5,24,149,5745,-86,-96,10,,252024570,28,7052,252024542,252024570
9245,5,12,149,5745,-69,-96,27,a6:92:ad:b7:76:65,252029324,256,4498,252029068,252029324
9246,5,24,149,5745,-86,-96,10,,252042038,32,12682,252042006,252042038
9247,5,24,149,5745,-87,-96,9,,252044877,28,2811,252044849,252044877
9248,5,12,149,5745,-70,-96,26,22:ec:75:a8:8a:31,252078567,244,33446,252078323,252078567
9249,5,12,149,5745,-73,-96,23,f6:0a:5c:59:72:df,252081038,252,2219,252080786,252081038
9250,5,6,149,5745,-84,-96,12,54:e4:3a:ec:fb:65,252092651,360,11253,252092291,252092651
9251,5,12,149,5745,-58,-96,38,f2:da:61:dd:98:c5,252093389,268,470,252093121,252093389
9252,5,12,149,5745,-57,-96,39,9e:1f:b0:a7:b8:90,252093713,256,68,252093457,252093713
9253,5,12,149,5745,-56,-96,40,3e:d1:9b:c7:a4:de,252097490,272,3505,252097218,252097490
9254,5,12,149,5745,-78,-96,18,9a:24:38:da:96:bb,252101977,272,4215,252101705,252101977
9255,5,12,149,5745,-69,-96,27,b6:90:18:f6:b1:d4,252117044,244,14823,252116800,252117044
9256,5,12,149,5745,-74,-96,22,72:d1:72:1d:22:a1,252117501,256,201,252117245,252117501
9257,5,12,149,5745,-71,-96,25,56:68:e2:c2:8d:d5,252119209,280,1428,252118929,252119209
9258,5,12,149,5745,-57,-96,39,5e:29:73:5b:30:00,252134173,272,14692,252133901,252134173
9259,5,12,149,5745,-69,-96,27,a6:92:ad:b7:76:65,252144171,256,9742,252143915,252144171
9260,5,12,149,5745,-75,-96,21,72:d1:72:1d:22:a1,252163827,256,19400,252163571,252163827
9261,5,12,149,5745,-69,-96,27,b6:90:18:f6:b1:d4,252166602,244,2531,252166358,252166602
9262,5,12,149,5745,-73,-96,23,3e:ef:29:c7:4b:17,252169573,244,2727,252169329,252169573
9263,5,12,149,5745,-73,-96,23,f6:0a:5c:59:72:df,252182167,252,12342,252181915,252182167
9264,5,12,149,5745,-58,-96,38,9e:1f:b0:a7:b8:90,252187784,256,5361,252187528,252187784
9265,5,6,149,5745,-84,-96,12,54:e4:3a:ec:fb:65,252195051,360,6907,252194691,252195051
9266,5,12,149,5745,-70,-96,26,22:ec:75:a8:8a:31,252198065,244,2770,252197821,252198065
9267,5,12,149,5745,-60,-96,36,f2:da:61:dd:98:c5,252199567,268,1234,252199299,252199567
9268,5,12,149,5745,-73,-96,23,3e:ef:29:c7:4b:17,252200085,244,274,252199841,252200085
9269,5,12,149,5745,-60,-96,36,f2:da:61:dd:98:c5,252202874,268,2521,252202606,252202874
9270,5,12,149,5745,-72,-96,24,a6:92:ad:b7:76:65,252203230,456,-100,252202774,252203230
9271,5,12,149,5745,-72,-96,24,56:68:e2:c2:8d:d5,252203720,476,14,252203244,252203720
9272,5,12,149,5745,-58,-96,38,9e:1f:b0:a7:b8:90,252212272,424,8128,252211848,252212272
9273,5,12,149,5745,-81,-96,15,9a:24:38:da:96:bb,252212767,824,-329,252211943,252212767
9274,5,12,149,5745,-58,-96,38,5e:29:73:5b:30:00,252213657,540,350,252213117,252213657
9275,5,12,149,5745,-70,-96,26,22:ec:75:a8:8a:31,252215269,516,1096,252214753,252215269
9276,5,12,149,5745,-72,-96,24,56:68:e2:c2:8d:d5,252215855,280,306,252215575,252215855
9277,5,12,149,5745,-75,-96,21,72:d1:72:1d:22:a1,252219284,452,2977,252218832,252219284
9278,5,12,149,5745,-73,-96,23,3e:ef:29:c7:4b:17,252221134,440,1410,252220694,252221134
9279,5,12,149,5745,-55,-96,41,3e:d1:9b:c7:a4:de,252221617,544,-61,252221073,252221617
9280,5,12,149,5745,-56,-96,40,3e:d1:9b:c7:a4:de,252231250,272,9361,252230978,252231250
9281,5,12,149,5745,-70,-96,26,a6:92:ad:b7:76:65,252248250,256,16744,252247994,252248250
9282,5,12,149,5745,-60,-96,36,5e:29:73:5b:30:00,252249314,272,792,252249042,252249314
9283,5,12,149,5745,-71,-96,25,a6:92:ad:b7:76:65,252267746,456,17976,252267290,252267746
9284,5,24,149,5745,-88,-96,8,,252273325,28,5551,252273297,252273325
9285,5,24,149,5745,-88,-96,8,,252273433,32,76,252273401,252273433
9286,5,12,149,5745,-59,-96,37,9e:1f:b0:a7:b8:90,252274346,424,489,252273922,252274346
9287,5,12,149,5745,-76,-96,20,72:d1:72:1d:22:a1,252280359,256,5757,252280103,252280359
9288,5,6,149,5745,-86,-96,10,54:e4:3a:ec:fb:65,252297452,360,16733,252297092,252297452
9289,5,12,149,5745,-60,-96,36,9e:1f:b0:a7:b8:90,252297875,256,167,252297619,252297875
9290,5,12,149,5745,-60,-96,36,f2:da:61:dd:98:c5,252310368,268,12225,252310100,252310368
9291,5,12,149,5745,-44,-96,52,0e:ae:b4:1e:a1:11,252316597,240,5989,252316357,252316597
9292,5,12,149,5745,-75,-96,21,d2:00:04:7e:2c:ab,252317904,104,1203,252317800,252317904
9293,5,12,149,5745,-73,-96,23,3e:ef:29:c7:4b:17,252318061,244,-87,252317817,252318061
9294,5,12,149,5745,-75,-96,21,d2:00:04:7e:2c:ab,252318413,152,200,252318261,252318413
9295,5,12,149,5745,-83,-96,13,9a:24:38:da:96:bb,252324914,272,6229,252324642,252324914
9296,5,12,149,5745,-71,-96,25,22:ec:75:a8:8a:31,252329139,244,3981,252328895,252329139
9297,5,12,149,5745,-55,-96,41,3e:d1:9b:c7:a4:de,252329633,272,222,252329361,252329633
9298,5,12,149,5745,-70,-96,26,a6:92:ad:b7:76:65,252333017,456,2928,252332561,252333017
9299,5,12,149,5745,-71,-96,25,22:ec:75:a8:8a:31,252336292,516,2759,252335776,252336292
9300,5,12,149,5745,-72,-96,24,56:68:e2:c2:8d:d5,252336842,280,270,252336562,252336842
9301,5,12,149,5745,-60,-96,36,9e:1f:b0:a7:b8:90,252339802,424,2536,252339378,252339802
9302,5,12,149,5745,-70,-96,26,b6:90:18:f6:b1:d4,252340341,440,99,252339901,252340341
9303,5,12,149,5745,-61,-96,35,5e:29:73:5b:30:00,252344598,540,3717,252344058,252344598
9304,5,12,149,5745,-82,-96,14,9a:24:38:da:96:bb,252345209,824,-213,252344385,252345209
9305,5,12,149,5745,-44,-96,52,0e:ae:b4:1e:a1:11,252348776,240,3327,252348536,252348776
9306,5,12,149,5745,-58,-96,38,f2:da:61:dd:98:c5,252349088,268,44,252348820,252349088
9307,5,12,149,5745,-60,-96,36,0a:b9:b7:b1:4d:fa,252350130,268,774,252349862,252350130
9308,5,12,149,5745,-55,-96,41,3e:d1:9b:c7:a4:de,252352881,544,2207,252352337,252352881
9309,5,12,149,5745,-73,-96,23,3e:ef:29:c7:4b:17,252354720,440,1399,252354280,252354720
9310,5,12,149,5745,-69,-96,27,a6:92:ad:b7:76:65,252362738,256,7762,252362482,252362738
9311,5,12,149,5745,-45,-96,51,0e:ae:b4:1e:a1:11,252371543,240,8565,252371303,252371543
9312,5,12,149,5745,-60,-96,36,5e:29:73:5b:30:00,252380377,272,8562,252380105,252380377
9313,5,6,149,5745,-84,-96,12,54:e4:3a:ec:fb:65,252399853,360,19116,252399493,252399853
9314,5,12,149,5745,-61,-96,35,9e:1f:b0:a7:b8:90,252412456,256,12347,252412200,252412456
9315,5,12,149,5745,-74,-96,22,3e:ef:29:c7:4b:17,252437644,244,24944,252437400,252437644
9316,5,12,149,5745,-54,-96,42,3e:d1:9b:c7:a4:de,252439742,272,1826,252439470,252439742
9317,5,12,149,5745,-62,-96,34,5e:29:73:5b:30:00,252475889,272,35875,252475617,252475889
9318,5,6,149,5745,-85,-96,11,54:e4:3a:ec:fb:65,252502253,360,26004,252501893,252502253
9319,5,12,149,5745,-61,-96,35,f2:da:61:dd:98:c5,252502941,268,420,252502673,252502941
9320,5,24,149,5745,-88,-96,8,,252519881,28,16912,252519853,252519881
9321,5,12,149,5745,-71,-96,25,a6:92:ad:b7:76:65,252525464,256,5327,252525208,252525464
9322,5,12,149,5745,-75,-96,21,72:d1:72:1d:22:a1,252527224,256,1504,252526968,252527224
9323,5,12,149,5745,-73,-96,23,56:68:e2:c2:8d:d5,252528963,280,1459,252528683,252528963
9324,5,24,149,5745,-88,-96,8,,252537554,28,8563,252537526,252537554
9325,5,24,149,5745,-87,-96,9,,252540658,28,3076,252540630,252540658
9326,5,24,149,5745,-88,-96,8,,252540767,32,77,252540735,252540767
9327,5,12,149,5745,-67,-96,29,22:ec:75:a8:8a:31,252540860,244,-151,252540616,252540860
9328,5,24,149,5745,-88,-96,8,,252542549,28,1661,252542521,252542549
9329,5,12,149,5745,-75,-96,21,f6:0a:5c:59:72:df,252544044,252,1243,252543792,252544044
9330,5,24,149,5745,-88,-96,8,,252545565,32,1489,252545533,252545565
9331,5,12,149,5745,-52,-96,44,3e:d1:9b:c7:a4:de,252556868,272,11031,252556596,252556868
9332,5,12,149,5745,-60,-96,36,5e:29:73:5b:30:00,252592522,272,35382,252592250,252592522
9333,5,24,149,5745,-89,-96,7,,252596934,28,4384,252596906,252596934
9334,5,24,149,5745,-89,-96,7,,252597042,32,76,252597010,252597042
9335,5,6,149,5745,-86,-96,10,54:e4:3a:ec:fb:65,252604654,360,7252,252604294,252604654
9336,5,12,149,5745,-61,-96,35,f2:da:61:dd:98:c5,252605440,268,518,252605172,252605440
9337,5,12,149,5745,-60,-96,36,9e:1f:b0:a7:b8:90,252605825,256,129,252605569,252605825
9338,5,24,149,5745,-90,-96,6,,252615160,28,9307,252615132,252615160
9339,5,24,149,5745,-89,-96,7,,252618251,32,3059,252618219,252618251
9340,5,12,149,5745,-71,-96,25,a6:92:ad:b7:76:65,252627718,256,9211,252627462,252627718
9341,5,12,149,5745,-78,-96,18,72:d1:72:1d:22:a1,252629344,256,1370,252629088,252629344
9342,5,12,149,5745,-44,-96,52,0e:ae:b4:1e:a1:11,252630122,240,538,252629882,252630122
9343,5,12,149,5745,-73,-96,23,56:68:e2:c2:8d:d5,252631477,280,1075,252631197,252631477
9344,5,12,149,5745,-69,-96,27,22:ec:75:a8:8a:31,252657868,244,26147,252657624,252657868
9345,5,12,149,5745,-77,-96,19,9a:24:38:da:96:bb,252662258,272,4118,252661986,252662258
9346,5,12,149,5745,-53,-96,43,3e:d1:9b:c7:a4:de,252674051,272,11521,252673779,252674051
9347,5,12,149,5745,-73,-96,23,3e:ef:29:c7:4b:17,252682391,244,8096,252682147,252682391
9348,5,6,149,5745,-87,-96,9,54:e4:3a:ec:fb:65,252707054,360,24303,252706694,252707054
9349,5,12,149,5745,-59,-96,37,f2:da:61:dd:98:c5,252707991,268,669,252707723,252707991
9350,5,12,149,5745,-58,-96,38,9e:1f:b0:a7:b8:90,252708438,256,191,252708182,252708438
9351,5,12,149,5745,-58,-96,38,5e:29:73:5b:30:00,252709247,272,537,252708975,252709247
9352,5,24,149,5745,-88,-96,8,,252713074,28,3799,252713046,252713074
9353,5,24,149,5745,-86,-96,10,,252713118,28,16,252713090,252713118
9354,5,24,149,5745,-86,-96,10,,252713226,32,76,252713194,252713226
9355,5,12,149,5745,-69,-96,27,a6:92:ad:b7:76:65,252729854,256,16372,252729598,252729854
9356,5,12,149,5745,-40,-96,56,0e:ae:b4:1e:a1:11,252730653,240,559,252730413,252730653
9357,5,12,149,5745,-77,-96,19,72:d1:72:1d:22:a1,252731916,256,1007,252731660,252731916
9358,5,12,149,5745,-73,-96,23,56:68:e2:c2:8d:d5,252733088,280,892,252732808,252733088
9359,5,24,149,5745,-91,-96,5,,252750499,28,17383,252750471,252750499
9360,5,24,149,5745,-86,-96,10,,252750544,28,17,252750516,252750544
9361,5,24,149,5745,-86,-96,10,,252750655,32,79,252750623,252750655
9362,5,24,149,5745,-86,-96,10,,252753553,28,2870,252753525,252753553
9363,5,12,149,5745,-56,-96,40,9e:1f:b0:a7:b8:90,252759143,256,5334,252758887,252759143
9364,5,12,149,5745,-81,-96,15,9a:24:38:da:96:bb,252773838,272,14423,252773566,252773838
9365,5,12,149,5745,-73,-96,23,3e:ef:29:c7:4b:17,252774708,244,626,252774464,252774708
9366,5,12,149,5745,-61,-96,35,f2:da:61:dd:98:c5,252775103,268,127,252774835,252775103
9367,5,12,149,5745,-71,-96,25,22:ec:75:a8:8a:31,252787898,244,12551,252787654,252787898
9368,5,12,149,5745,-74,-96,22,56:68:e2:c2:8d:d5,252789211,280,1033,252788931,252789211
9369,5,12,149,5745,-56,-96,40,3e:d1:9b:c7:a4:de,252791205,544,1450,252790661,252791205
9370,5,12,149,5745,-74,-96,22,56:68:e2:c2:8d:d5,252791783,476,102,252791307,252791783
9371,5,12,149,5745,-61,-96,35,f2:da:61:dd:98:c5,252793895,268,1844,252793627,252793895
9372,5,12,149,5745,-72,-96,24,22:ec:75:a8:8a:31,252795224,516,813,252794708,252795224
9373,5,24,149,5745,-89,-96,7,,252797390,32,2134,252797358,252797390
9374,5,12,149,5745,-75,-96,21,f6:0a:5c:59:72:df,252797836,448,-2,252797388,252797836
9375,5,12,149,5745,-55,-96,41,9e:1f:b0:a7:b8:90,252798336,424,76,252797912,252798336
9376,5,24,149,5745,-89,-96,7,,252798821,32,453,252798789,252798821
9377,5,24,149,5745,-89,-96,7,,252799266,28,417,252799238,252799266
9378,5,12,149,5745,-70,-96,26,a6:92:ad:b7:76:65,252800597,456,875,252800141,252800597
9379,5,12,149,5745,-60,-96,36,5e:29:73:5b:30:00,252801906,540,769,252801366,252801906
9380,5,12,149,5745,-55,-96,41,3e:d1:9b:c7:a4:de,252804694,272,2516,252804422,252804694
9381,5,12,149,5745,-70,-96,26,a6:92:ad:b7:76:65,252805000,256,50,252804744,252805000
9382,5,6,149,5745,-90,-96,6,54:e4:3a:ec:fb:65,252809455,360,4095,252809095,252809455
9383,5,12,149,5745,-73,-96,23,72:d1:72:1d:22:a1,252811340,452,1433,252810888,252811340
9384,5,12,149,5745,-74,-96,22,3e:ef:29:c7:4b:17,252812627,440,847,252812187,252812627
9385,5,12,149,5745,-62,-96,34,5e:29:73:5b:30:00,252838634,272,25735,252838362,252838634
9386,5,12,149,5745,-74,-96,22,72:d1:72:1d:22:a1,252839203,256,313,252838947,252839203
9387,5,24,149,5745,-73,-96,23,,252843266,28,4035,252843238,252843266
9388,5,24,149,5745,-88,-96,8,,252843310,28,16,252843282,252843310
9389,5,24,149,5745,-88,-96,8,,252843417,28,79,252843389,252843417
9390,5,12,149,5745,-56,-96,40,3e:d1:9b:c7:a4:de,252856407,544,12446,252855863,252856407
9391,5,12,149,5745,-71,-96,25,22:ec:75:a8:8a:31,252859898,516,2975,252859382,252859898
9392,5,12,149,5745,-70,-96,26,a6:92:ad:b7:76:65,252863678,456,3324,252863222,252863678
9393,5,12,149,5745,-75,-96,21,f6:0a:5c:59:72:df,252864177,252,247,252863925,252864177
9394,5,12,149,5745,-57,-96,39,f2:da:61:dd:98:c5,252865329,268,884,252865061,252865329
9395,5,12,149,5745,-80,-96,16,9a:24:38:da:96:bb,252865753,824,-400,252864929,252865753
9396,5,12,149,5745,-37,-96,59,0e:ae:b4:1e:a1:11,252866646,240,653,252866406,252866646
9397,5,12,149,5745,-64,-96,32,0a:b9:b7:b1:4d:fa,252869675,268,2761,252869407,252869675
9398,5,12,149,5745,-57,-96,39,f2:da:61:dd:98:c5,252871193,268,1250,252870925,252871193
9399,5,12,149,5745,-72,-96,24,56:68:e2:c2:8d:d5,252873917,476,2248,252873441,252873917
9400,5,12,149,5745,-76,-96,20,72:d1:72:1d:22:a1,252874692,452,323,252874240,252874692
9401,5,12,149,5745,-69,-96,27,b6:90:18:f6:b1:d4,252876070,440,938,252875630,252876070
9402,5,12,149,5745,-58,-96,38,5e:29:73:5b:30:00,252876553,540,-57,252876013,252876553
9403,5,12,149,5745,-75,-96,21,f6:0a:5c:59:72:df,252877127,448,126,252876679,252877127
9404,5,12,149,5745,-76,-96,20,3e:ef:29:c7:4b:17,252879158,440,1591,252878718,252879158
9405,5,12,149,5745,-72,-96,24,56:68:e2:c2:8d:d5,252887573,280,8135,252887293,252887573
9406,5,12,149,5745,-76,-96,20,3e:ef:29:c7:4b:17,252887898,244,81,252887654,252887898
9407,5,24,149,5745,-72,-96,24,,252890031,28,2105,252890003,252890031
9408,5,24,149,5745,-89,-96,7,,252890076,28,17,252890048,252890076
9409,5,24,149,5745,-88,-96,8,,252890184,28,80,252890156,252890184
9410,5,12,149,5745,-82,-96,14,9a:24:38:da:96:bb,252895016,272,4560,252894744,252895016
9411,5,12,149,5745,-69,-96,27,22:ec:75:a8:8a:31,252903467,244,8207,252903223,252903467
9412,5,12,149,5745,-58,-96,38,3e:d1:9b:c7:a4:de,252903872,272,133,252903600,252903872
9413,5,6,149,5745,-85,-96,11,54:e4:3a:ec:fb:65,252911855,360,7623,252911495,252911855
9414,5,24,149,5745,-72,-96,24,,252921394,28,9511,252921366,252921394
9415,5,24,149,5745,-89,-96,7,,252921546,28,124,252921518,252921546
9416,5,24,149,5745,-90,-96,6,,252931219,28,9645,252931191,252931219
9417,5,24,149,5745,-88,-96,8,,252931484,28,237,252931456,252931484
9418,5,24,149,5745,-87,-96,9,,252931529,28,17,252931501,252931529
9419,5,12,149,5745,-71,-96,25,a6:92:ad:b7:76:65,252932081,256,296,252931825,252932081
9420,5,24,149,5745,-88,-96,8,,252932536,32,423,252932504,252932536
9421,5,24,149,5745,-89,-96,7,,252932696,28,132,252932668,252932696
9422,5,24,149,5745,-89,-96,7,,252932740,28,16,252932712,252932740
9423,5,24,149,5745,-89,-96,7,,252934437,28,1669,252934409,252934437
9424,5,12,149,5745,-55,-96,41,5e:29:73:5b:30:00,252936537,272,1828,252936265,252936537
9425,5,24,149,5745,-88,-96,8,,252940350,32,3781,252940318,252940350
9426,5,12,149,5745,-71,-96,25,22:ec:75:a8:8a:31,252995163,244,54569,252994919,252995163
9427,5,24,149,5745,-69,-96,27,,252997271,28,2080,252997243,252997271
9428,5,12,149,5745,-56,-96,40,f2:da:61:dd:98:c5,252998350,268,811,252998082,252998350
9429,5,12,149,5745,-75,-96,21,3e:ef:29:c7:4b:17,253000423,244,1829,253000179,253000423
9430,5,12,149,5745,-83,-96,13,9a:24:38:da:96:bb,253007614,272,6919,253007342,253007614
9431,5,6,149,5745,-87,-96,9,54:e4:3a:ec:fb:65,253014256,360,6282,253013896,253014256
9432,5,12,149,5745,-72,-96,24,f6:0a:5c:59:72:df,253015462,252,954,253015210,253015462
9433,5,12,149,5745,-56,-96,40,3e:d1:9b:c7:a4:de,253015802,272,68,253015530,253015802
9434,5,12,149,5745,-72,-96,24,72:d1:72:1d:22:a1,253039367,256,23309,253039111,253039367
9435,5,12,149,5745,-74,-96,22,56:68:e2:c2:8d:d5,253040998,280,1351,253040718,253040998
9436,5,12,149,5745,-74,-96,22,a6:92:ad:b7:76:65,253043800,256,2546,253043544,253043800
9437,5,12,149,5745,-57,-96,39,5e:29:73:5b:30:00,253053415,272,9343,253053143,253053415
9438,5,12,149,5745,-40,-96,56,0e:ae:b4:1e:a1:11,253059768,240,6113,253059528,253059768
9439,5,12,149,5745,-59,-96,37,f2:da:61:dd:98:c5,253110755,268,50719,253110487,253110755
9440,5,12,149,5745,-70,-96,26,22:ec:75:a8:8a:31,253111974,244,975,253111730,253111974
9441,5,6,149,5745,-86,-96,10,54:e4:3a:ec:fb:65,253116656,360,4322,253116296,253116656
9442,5,12,149,5745,-77,-96,19,9a:24:38:da:96:bb,253123000,272,6072,253122728,253123000
9443,5,12,149,5745,-58,-96,38,3e:d1:9b:c7:a4:de,253128343,272,5071,253128071,253128343
9444,5,12,149,5745,-74,-96,22,72:d1:72:1d:22:a1,253141269,256,12670,253141013,253141269
9445,5,12,149,5745,-75,-96,21,56:68:e2:c2:8d:d5,253141751,280,202,253141471,253141751
9446,5,12,149,5745,-75,-96,21,a6:92:ad:b7:76:65,253155925,256,13918,253155669,253155925
9447,5,12,149,5745,-59,-96,37,5e:29:73:5b:30:00,253170657,272,14460,253170385,253170657
9448,5,12,149,5745,-75,-96,21,72:d1:72:1d:22:a1,253184723,256,13810,253184467,253184723
9449,5,12,149,5745,-73,-96,23,3e:ef:29:c7:4b:17,253194184,244,9217,253193940,253194184
9450,5,24,149,5745,-88,-96,8,,253210290,28,16078,253210262,253210290
9451,5,6,149,5745,-83,-96,13,54:e4:3a:ec:fb:65,253219057,360,8407,253218697,253219057
9452,5,12,149,5745,-63,-96,33,f2:da:61:dd:98:c5,253223807,268,4482,253223539,253223807
9453,5,24,149,5745,-89,-96,7,,253226485,28,2650,253226457,253226485
9454,5,12,149,5745,-81,-96,15,9a:24:38:da:96:bb,253231227,272,4470,253230955,253231227
9455,5,12,149,5745,-74,-96,22,3e:ef:29:c7:4b:17,253232665,244,1194,253232421,253232665
9456,5,12,149,5745,-73,-96,23,56:68:e2:c2:8d:d5,253234860,280,1915,253234580,253234860
9457,5,24,149,5745,-88,-96,8,,253238578,28,3690,253238550,253238578
9458,5,24,149,5745,-88,-96,8,,253238622,28,16,253238594,253238622
9459,5,24,149,5745,-88,-96,8,,253240643,28,1993,253240615,253240643
9460,5,24,149,5745,-88,-96,8,,253240687,28,16,253240659,253240687
9461,5,24,149,5745,-89,-96,7,,253240803,32,84,253240771,253240803
9462,5,12,149,5745,-71,-96,25,22:ec:75:a8:8a:31,253246675,244,5628,253246431,253246675
9463,5,12,149,5745,-56,-96,40,3e:d1:9b:c7:a4:de,253247078,272,131,253246806,253247078
9464,5,12,149,5745,-74,-96,22,3e:ef:29:c7:4b:17,253248609,440,1091,253248169,253248609
9465,5,12,149,5745,-56,-96,40,3e:d1:9b:c7:a4:de,253251291,544,2138,253250747,253251291
9466,5,12,149,5745,-78,-96,18,72:d1:72:1d:22:a1,253251906,452,163,253251454,253251906
9467,5,24,149,5745,-89,-96,7,,253252554,28,620,253252526,253252554
9468,5,12,149,5745,-70,-96,26,22:ec:75:a8:8a:31,253252782,516,-288,253252266,253252782
9469,5,12,149,5745,-73,-96,23,a6:92:ad:b7:76:65,253257762,456,4524,253257306,253257762
9470,5,12,149,5745,-62,-96,34,f2:da:61:dd:98:c5,253258508,268,478,253258240,253258508
9471,5,12,149,5745,-85,-96,11,9a:24:38:da:96:bb,253260476,824,1144,253259652,253260476
9472,5,12,149,5745,-73,-96,23,a6:92:ad:b7:76:65,253263770,256,3038,253263514,253263770
9473,5,12,149,5745,-56,-96,40,5e:29:73:5b:30:00,253269379,540,5069,253268839,253269379
9474,5,12,149,5745,-73,-96,23,56:68:e2:c2:8d:d5,253269973,476,118,253269497,253269973
9475,5,12,149,5745,-72,-96,24,f6:0a:5c:59:72:df,253270537,448,116,253270089,253270537
9476,5,12,149,5745,-78,-96,18,72:d1:72:1d:22:a1,253297769,256,26976,253297513,253297769
9477,5,12,149,5745,-58,-96,38,5e:29:73:5b:30:00,253298059,272,18,253297787,253298059
9478,5,12,149,5745,-74,-96,22,3e:ef:29:c7:4b:17,253313647,440,15148,253313207,253313647
9479,5,12,149,5745,-48,-96,48,0e:ae:b4:1e:a1:11,253320504,240,6617,253320264,253320504
9480,5,6,149,5745,-84,-96,12,54:e4:3a:ec:fb:65,253321457,360,593,253321097,253321457
9481,5,12,149,5745,-72,-96,24,a6:92:ad:b7:76:65,253321901,456,-12,253321445,253321901
9482,5,12,149,5745,-74,-96,22,3e:ef:29:c7:4b:17,253330168,244,8023,253329924,253330168
9483,5,12,149,5745,-71,-96,25,f6:0a:5c:59:72:df,253331627,252,1207,253331375,253331627
9484,5,12,149,5745,-61,-96,35,f2:da:61:dd:98:c5,253334442,268,2547,253334174,253334442
9485,5,12,149,5745,-70,-96,26,22:ec:75:a8:8a:31,253346190,244,11504,253345946,253346190
9486,5,12,149,5745,-75,-96,21,d2:00:04:7e:2c:ab,253347829,244,1395,253347585,253347829
9487,5,12,149,5745,-72,-96,24,56:68:e2:c2:8d:d5,253351881,280,3772,253351601,253351881
9488,5,12,149,5745,-55,-96,41,3e:d1:9b:c7:a4:de,253353149,272,996,253352877,253353149
9489,5,12,149,5745,-80,-96,16,9a:24:38:da:96:bb,253366551,272,13130,253366279,253366551
9490,5,12,149,5745,-72,-96,24,a6:92:ad:b7:76:65,253378501,256,11694,253378245,253378501
9491,5,12,149,5745,-73,-96,23,3e:ef:29:c7:4b:17,253379179,440,238,253378739,253379179
9492,5,12,149,5745,-57,-96,39,3e:d1:9b:c7:a4:de,253380202,544,479,253379658,253380202
9493,5,12,149,5745,-47,-96,49,0e:ae:b4:1e:a1:11,253381104,240,662,253380864,253381104
9494,5,12,149,5745,-70,-96,26,22:ec:75:a8:8a:31,253387085,516,5465,253386569,253387085
9495,5,12,149,5745,-72,-96,24,a6:92:ad:b7:76:65,253388328,456,787,253387872,253388328
9496,5,12,149,5745,-81,-96,15,9a:24:38:da:96:bb,253391115,824,1963,253390291,253391115
9497,5,12,149,5745,-60,-96,36,0a:b9:b7:b1:4d:fa,253392010,268,627,253391742,253392010
9498,5,12,149,5745,-62,-96,34,f2:da:61:dd:98:c5,253392367,268,89,253392099,253392367
9499,5,12,149,5745,-75,-96,21,d2:00:04:7e:2c:ab,253399351,412,6572,253398939,253399351
9500,5,12,149,5745,-70,-96,26,b6:90:18:f6:b1:d4,253400301,440,510,253399861,253400301
9501,5,12,149,5745,-58,-96,38,5e:29:73:5b:30:00,253400829,540,-12,253400289,253400829
9502,5,12,149,5745,-58,-96,38,5e:29:73:5b:30:00,253411732,272,10631,253411460,253411732
9503,5,6,149,5745,-82,-96,14,54:e4:3a:ec:fb:65,253423858,360,11766,253423498,253423858
9504,5,12,149,5745,-73,-96,23,3e:ef:29:c7:4b:17,253444690,440,20392,253444250,253444690
9505,5,12,149,5745,-73,-96,23,3e:ef:29:c7:4b:17,253445150,244,216,253444906,253445150
9506,5,12,149,5745,-75,-96,21,d2:00:04:7e:2c:ab,253446825,440,1235,253446385,253446825
9507,5,12,149,5745,-76,-96,20,d2:00:04:7e:2c:ab,253447285,244,216,253447041,253447285
9508,5,12,149,5745,-77,-96,19,72:d1:72:1d:22:a1,253448498,256,957,253448242,253448498
9509,5,12,149,5745,-45,-96,51,0e:ae:b4:1e:a1:11,253453120,240,4382,253452880,253453120
9510,5,12,149,5745,-61,-96,35,f2:da:61:dd:98:c5,253456102,268,2714,253455834,253456102
9511,5,12,149,5745,-82,-96,14,9a:24:38:da:96:bb,253456844,272,470,253456572,253456844
9512,5,12,149,5745,-72,-96,24,56:68:e2:c2:8d:d5,253462883,280,5759,253462603,253462883
9513,5,12,149,5745,-71,-96,25,22:ec:75:a8:8a:31,253463264,244,137,253463020,253463264
9514,5,12,149,5745,-60,-96,36,3e:d1:9b:c7:a4:de,253470634,272,7098,253470362,253470634
9515,5,12,149,5745,-70,-96,26,f6:0a:5c:59:72:df,253472669,252,1783,253472417,253472669
9516,5,12,149,5745,-44,-96,52,0e:ae:b4:1e:a1:11,253492968,240,20059,253492728,253492968
9517,5,12,149,5745,-57,-96,39,5e:29:73:5b:30:00,253509601,272,16361,253509329,253509601
9518,5,12,149,5745,-74,-96,22,3e:ef:29:c7:4b:17,253510884,440,843,253510444,253510884
9519,5,12,149,5745,-44,-96,52,0e:ae:b4:1e:a1:11,253522241,240,11117,253522001,253522241
9520,5,6,149,5745,-81,-96,15,54:e4:3a:ec:fb:65,253526258,360,3657,253525898,253526258
9521,5,24,149,5745,-88,-96,8,,253528299,32,2009,253528267,253528299
9522,5,24,149,5745,-89,-96,7,,253546599,28,18272,253546571,253546599
9523,5,24,149,5745,-89,-96,7,,253547554,28,927,253547526,253547554
9524,5,24,149,5745,-88,-96,8,,253548032,28,450,253548004,253548032
9525,5,12,149,5745,-70,-96,26,a6:92:ad:b7:76:65,253548827,256,539,253548571,253548827
9526,5,12,149,5745,-76,-96,20,72:d1:72:1d:22:a1,253550913,256,1830,253550657,253550913
9527,5,12,149,5745,-74,-96,22,3e:ef:29:c7:4b:17,253559879,244,8722,253559635,253559879
9528,5,12,149,5745,-78,-96,18,9a:24:38:da:96:bb,253572171,272,12020,253571899,253572171
9529,5,12,149,5745,-74,-96,22,3e:ef:29:c7:4b:17,253575844,440,3233,253575404,253575844
9530,5,12,149,5745,-72,-96,24,22:ec:75:a8:8a:31,253580296,244,4208,253580052,253580296
9531,5,12,149,5745,-45,-96,51,0e:ae:b4:1e:a1:11,253584705,240,4169,253584465,253584705
9532,5,24,149,5745,-73,-96,23,,253586340,28,1607,253586312,253586340
9533,5,12,149,5745,-61,-96,35,3e:d1:9b:c7:a4:de,253587792,272,1180,253587520,253587792
9534,5,12,149,5745,-46,-96,50,0e:ae:b4:1e:a1:11,253605116,240,17084,253604876,253605116
9535,5,12,149,5745,-59,-96,37,5e:29:73:5b:30:00,253624401,272,19013,253624129,253624401
9536,5,12,149,5745,-59,-96,37,f2:da:61:dd:98:c5,253628759,268,4090,253628491,253628759
9537,5,12,149,5745,-70,-96,26,a6:92:ad:b7:76:65,253652088,256,23073,253651832,253652088
9538,5,12,149,5745,-75,-96,21,72:d1:72:1d:22:a1,253653330,256,986,253653074,253653330
9539,5,12,149,5745,-76,-96,20,d2:00:04:7e:2c:ab,253653747,244,173,253653503,253653747
9540,5,12,149,5745,-71,-96,25,56:68:e2:c2:8d:d5,253654395,280,368,253654115,253654395
9541,5,12,149,5745,-78,-96,18,9a:24:38:da:96:bb,253680423,272,25756,253680151,253680423
9542,5,12,149,5745,-73,-96,23,3e:ef:29:c7:4b:17,253682131,244,1464,253681887,253682131
9543,5,12,149,5745,-71,-96,25,22:ec:75:a8:8a:31,253692796,244,10421,253692552,253692796
9544,5,12,149,5745,-63,-96,33,3e:d1:9b:c7:a4:de,253703463,272,10395,253703191,253703463
9545,5,6,149,5745,-84,-96,12,54:e4:3a:ec:fb:65,253731060,360,27237,253730700,253731060
9546,5,12,149,5745,-45,-96,51,0e:ae:b4:1e:a1:11,253731476,240,176,253731236,253731476
9547,5,12,149,5745,-62,-96,34,f2:da:61:dd:98:c5,253731761,268,17,253731493,253731761
9548,5,12,149,5745,-58,-96,38,5e:29:73:5b:30:00,253741504,272,9471,253741232,253741504
9549,5,12,149,5745,-73,-96,23,a6:92:ad:b7:76:65,253754234,256,12474,253753978,253754234
9550,5,12,149,5745,-77,-96,19,d2:00:04:7e:2c:ab,253755384,244,906,253755140,253755384
9551,5,12,149,5745,-78,-96,18,72:d1:72:1d:22:a1,253755880,256,240,253755624,253755880
9552,5,12,149,5745,-71,-96,25,56:68:e2:c2:8d:d5,253756515,280,355,253756235,253756515
9553,5,12,149,5745,-64,-96,32,f2:da:61:dd:98:c5,253788900,268,32117,253788632,253788900
9554,5,12,149,5745,-78,-96,18,d2:00:04:7e:2c:ab,253799645,244,10501,253799401,253799645
9555,5,12,149,5745,-72,-96,24,56:68:e2:c2:8d:d5,253802326,280,2401,253802046,253802326
9556,5,12,149,5745,-72,-96,24,22:ec:75:a8:8a:31,253804774,244,2204,253804530,253804774
9557,5,12,149,5745,-72,-96,24,3e:ef:29:c7:4b:17,253807390,244,2372,253807146,253807390
9558,5,12,149,5745,-72,-96,24,a6:92:ad:b7:76:65,253821297,256,13651,253821041,253821297
9559,5,12,149,5745,-45,-96,51,0e:ae:b4:1e:a1:11,253830034,240,8497,253829794,253830034
9560,5,6,149,5745,-84,-96,12,54:e4:3a:ec:fb:65,253833460,360,3066,253833100,253833460
9561,5,12,149,5745,-58,-96,38,3e:d1:9b:c7:a4:de,253836953,272,3221,253836681,253836953
9562,5,12,149,5745,-72,-96,24,3e:ef:29:c7:4b:17,253838250,440,857,253837810,253838250
9563,5,12,149,5745,-78,-96,18,d2:00:04:7e:2c:ab,253839995,440,1305,253839555,253839995
9564,5,12,149,5745,-57,-96,39,3e:d1:9b:c7:a4:de,253840469,544,-70,253839925,253840469
9565,5,12,149,5745,-79,-96,17,72:d1:72:1d:22:a1,253841724,452,803,253841272,253841724
9566,5,12,149,5745,-72,-96,24,22:ec:75:a8:8a:31,253843799,516,1559,253843283,253843799
9567,5,12,149,5745,-72,-96,24,a6:92:ad:b7:76:65,253849177,456,4922,253848721,253849177
9568,5,12,149,5745,-64,-96,32,f2:da:61:dd:98:c5,253851341,268,1896,253851073,253851341
9569,5,12,149,5745,-79,-96,17,72:d1:72:1d:22:a1,253853767,256,2170,253853511,253853767
9570,5,12,149,5745,-71,-96,25,56:68:e2:c2:8d:d5,253857300,476,3057,253856824,253857300
9571,5,12,149,5745,-57,-96,39,5e:29:73:5b:30:00,253859448,540,1608,253858908,253859448
9572,5,12,149,5745,-72,-96,24,f6:0a:5c:59:72:df,253860076,448,180,253859628,253860076
9573,5,12,149,5745,-57,-96,39,5e:29:73:5b:30:00,253870500,272,10152,253870228,253870500
9574,5,12,149,5745,-72,-96,24,f6:0a:5c:59:72:df,253886813,252,16061,253886561,253886813
9575,5,12,149,5745,-64,-96,32,f2:da:61:dd:98:c5,253887387,268,306,253887119,253887387
9576,5,24,149,5745,-72,-96,24,,253902216,28,14801,253902188,253902216
9577,5,24,149,5745,-91,-96,5,,253902368,28,124,253902340,253902368
9578,5,12,149,5745,-72,-96,24,56:68:e2:c2:8d:d5,253903366,280,718,253903086,253903366
9579,5,12,149,5745,-73,-96,23,3e:ef:29:c7:4b:17,253903691,440,-115,253903251,253903691
9580,5,12,149,5745,-73,-96,23,3e:ef:29:c7:4b:17,253904149,244,214,253903905,253904149
9581,5,12,149,5745,-56,-96,40,3e:d1:9b:c7:a4:de,253904559,544,-134,253904015,253904559
9582,5,12,149,5745,-77,-96,19,d2:00:04:7e:2c:ab,253905137,440,138,253904697,253905137
9583,5,12,149,5745,-77,-96,19,72:d1:72:1d:22:a1,253905658,452,69,253905206,253905658
9584,5,12,149,5745,-77,-96,19,d2:00:04:7e:2c:ab,253906146,244,244,253905902,253906146
9585,5,12,149,5745,-72,-96,24,22:ec:75:a8:8a:31,253908936,516,2274,253908420,253908936
9586,5,12,149,5745,-45,-96,51,0e:ae:b4:1e:a1:11,253911513,240,2337,253911273,253911513
9587,5,12,149,5745,-74,-96,22,f6:0a:5c:59:72:df,253911798,128,157,253911670,253911798
9588,5,12,149,5745,-45,-96,51,0e:ae:b4:1e:a1:11,253912199,204,197,253911995,253912199
9589,5,12,149,5745,-71,-96,25,a6:92:ad:b7:76:65,253912464,456,-191,253912008,253912464
9590,5,12,149,5745,-64,-96,32,f2:da:61:dd:98:c5,253914088,268,1356,253913820,253914088
9591,5,12,149,5745,-78,-96,18,9a:24:38:da:96:bb,253914512,824,-400,253913688,253914512
9592,5,12,149,5745,-65,-96,31,0a:b9:b7:b1:4d:fa,253915559,268,779,253915291,253915559
9593,5,12,149,5745,-72,-96,24,56:68:e2:c2:8d:d5,253922491,476,6456,253922015,253922491
9594,5,12,149,5745,-73,-96,23,b6:90:18:f6:b1:d4,253924217,440,1286,253923777,253924217
9595,5,12,149,5745,-56,-96,40,5e:29:73:5b:30:00,253924692,540,-65,253924152,253924692
9596,5,12,149,5745,-77,-96,19,d2:00:04:7e:2c:ab,253925347,380,275,253924967,253925347
9597,5,12,149,5745,-74,-96,22,f6:0a:5c:59:72:df,253925815,448,20,253925367,253925815
9598,5,24,149,5745,-87,-96,9,,253927906,28,2063,253927878,253927906
9599,5,24,149,5745,-87,-96,9,,253928019,32,81,253927987,253928019
9600,5,24,149,5745,-91,-96,5,,253931962,28,3915,253931934,253931962
9601,5,12,149,5745,-74,-96,22,22:ec:75:a8:8a:31,253934833,244,2627,253934589,253934833
9602,5,12,149,5745,-58,-96,38,3e:d1:9b:c7:a4:de,253935246,272,141,253934974,253935246
9603,5,12,149,5745,-72,-96,24,a6:92:ad:b7:76:65,253936314,256,812,253936058,253936314
9604,5,12,149,5745,-46,-96,50,0e:ae:b4:1e:a1:11,253942122,240,5568,253941882,253942122
9605,5,12,149,5745,-56,-96,40,5e:29:73:5b:30:00,253966550,272,24156,253966278,253966550
9606,5,12,149,5745,-73,-96,23,3e:ef:29:c7:4b:17,253968206,440,1216,253967766,253968206
9607,5,12,149,5745,-77,-96,19,d2:00:04:7e:2c:ab,253970959,440,2313,253970519,253970959
9608,5,24,149,5745,-90,-96,6,,253976699,28,5712,253976671,253976699
9609,5,12,149,5745,-78,-96,18,72:d1:72:1d:22:a1,253979854,256,2899,253979598,253979854
9610,5,24,149,5745,-90,-96,6,,254003640,28,23758,254003612,254003640
9611,5,12,149,5745,-64,-96,32,f2:da:61:dd:98:c5,254012752,268,8844,254012484,254012752
9612,5,24,149,5745,-92,-96,4,,254014665,32,1881,254014633,254014665
9613,5,24,149,5745,-91,-96,5,,254015573,28,880,254015545,254015573
9614,5,24,149,5745,-87,-96,9,,254015619,28,18,254015591,254015619
9615,5,24,149,5745,-87,-96,9,,254015729,32,78,254015697,254015729
9616,5,12,149,5745,-78,-96,18,9a:24:38:da:96:bb,254017124,272,1123,254016852,254017124
9617,5,12,149,5745,-73,-96,23,3e:ef:29:c7:4b:17,254018621,244,1253,254018377,254018621
9618,5,12,149,5745,-76,-96,20,d2:00:04:7e:2c:ab,254020763,244,1898,254020519,254020763
9619,5,24,149,5745,-89,-96,7,,254021167,28,376,254021139,254021167
9620,5,12,149,5745,-72,-96,24,56:68:e2:c2:8d:d5,254027360,280,5913,254027080,254027360
9621,5,12,149,5745,-74,-96,22,22:ec:75:a8:8a:31,254033139,244,5535,254032895,254033139
9622,5,12,149,5745,-72,-96,24,3e:ef:29:c7:4b:17,254034813,440,1234,254034373,254034813
9623,5,6,149,5745,-85,-96,11,54:e4:3a:ec:fb:65,254038261,360,3088,254037901,254038261
9624,5,12,149,5745,-56,-96,40,3e:d1:9b:c7:a4:de,254041238,272,2705,254040966,254041238
9625,5,12,149,5745,-45,-96,51,0e:ae:b4:1e:a1:11,254042101,240,623,254041861,254042101
9626,5,12,149,5745,-45,-96,51,0e:ae:b4:1e:a1:11,254053678,240,11337,254053438,254053678
9627,5,12,149,5745,-73,-96,23,a6:92:ad:b7:76:65,254060513,256,6579,254060257,254060513
9628,5,24,149,5745,-92,-96,4,,254078149,28,17608,254078121,254078149
9629,5,12,149,5745,-56,-96,40,5e:29:73:5b:30:00,254083475,272,5054,254083203,254083475
9630,5,12,149,5745,-72,-96,24,3e:ef:29:c7:4b:17,254100019,440,16104,254099579,254100019
9631,5,12,149,5745,-45,-96,51,0e:ae:b4:1e:a1:11,254107421,240,7162,254107181,254107421
9632,5,6,149,5745,-84,-96,12,54:e4:3a:ec:fb:65,254128849,352,21076,254128497,254128849
9633,5,24,149,5745,-90,-96,6,,254129462,28,585,254129434,254129462
9634,5,24,149,5745,-91,-96,5,,254129570,32,76,254129538,254129570
9635,5,12,149,5745,-72,-96,24,3e:ef:29:c7:4b:17,254132921,244,3107,254132677,254132921
9636,5,24,149,5745,-90,-96,6,,254138384,32,5431,254138352,254138384
9637,5,6,149,5745,-84,-96,12,54:e4:3a:ec:fb:65,254139072,352,336,254138720,254139072
9638,5,6,149,5745,-83,-96,13,54:e4:3a:ec:fb:65,254140661,360,1229,254140301,254140661
9639,5,12,149,5745,-63,-96,33,f2:da:61:dd:98:c5,254141346,268,417,254141078,254141346
9640,5,12,149,5745,-74,-96,22,22:ec:75:a8:8a:31,254147131,244,5541,254146887,254147131
9641,5,12,149,5745,-56,-96,40,3e:d1:9b:c7:a4:de,254158482,272,11079,254158210,254158482
9642,5,24,149,5745,-90,-96,6,,254161066,28,2556,254161038,254161066
9643,5,24,149,5745,-90,-96,6,,254163524,32,2426,254163492,254163524
9644,5,12,149,5745,-76,-96,20,d2:00:04:7e:2c:ab,254165094,244,1326,254164850,254165094
9645,5,12,149,5745,-77,-96,19,72:d1:72:1d:22:a1,254165419,256,69,254165163,254165419
9646,5,12,149,5745,-73,-96,23,56:68:e2:c2:8d:d5,254167403,280,1704,254167123,254167403
9647,5,12,149,5745,-72,-96,24,a6:92:ad:b7:76:65,254172995,256,5336,254172739,254172995
9648,5,24,149,5745,-90,-96,6,,254179588,32,6561,254179556,254179588
9649,5,24,149,5745,-91,-96,5,,254189741,28,10125,254189713,254189741
9650,5,12,149,5745,-56,-96,40,5e:29:73:5b:30:00,254200703,272,10690,254200431,254200703
9651,5,12,149,5745,-73,-96,23,f6:0a:5c:59:72:df,254235787,252,34832,254235535,254235787
9652,5,12,149,5745,-44,-96,52,0e:ae:b4:1e:a1:11,254238278,240,2251,254238038,254238278
9653,5,6,149,5745,-83,-96,13,54:e4:3a:ec:fb:65,254243062,360,4424,254242702,254243062
9654,5,12,149,5745,-62,-96,34,f2:da:61:dd:98:c5,254244032,268,702,254243764,254244032
9655,5,12,149,5745,-77,-96,19,9a:24:38:da:96:bb,254244416,272,112,254244144,254244416
9656,5,12,149,5745,-72,-96,24,3e:ef:29:c7:4b:17,254247176,244,2516,254246932,254247176
9657,5,12,149,5745,-75,-96,21,22:ec:75:a8:8a:31,254264168,244,16748,254263924,254264168
9658,5,12,149,5745,-76,-96,20,d2:00:04:7e:2c:ab,254267704,244,3292,254267460,254267704
9659,5,12,149,5745,-76,-96,20,72:d1:72:1d:22:a1,254268209,256,249,254267953,254268209
9660,5,12,149,5745,-73,-96,23,56:68:e2:c2:8d:d5,254269327,280,838,254269047,254269327
9661,5,12,149,5745,-72,-96,24,a6:92:ad:b7:76:65,254270046,256,463,254269790,254270046
9662,5,12,149,5745,-44,-96,52,0e:ae:b4:1e:a1:11,254281842,240,11556,254281602,254281842
9663,5,24,149,5745,-91,-96,5,,254282813,28,943,254282785,254282813
9664,5,12,149,5745,-56,-96,40,3e:d1:9b:c7:a4:de,254295741,272,12656,254295469,254295741
9665,5,12,149,5745,-76,-96,20,d2:00:04:7e:2c:ab,254298146,440,1965,254297706,254298146
9666,5,12,149,5745,-75,-96,21,72:d1:72:1d:22:a1,254298639,452,41,254298187,254298639
9667,5,12,149,5745,-56,-96,40,3e:d1:9b:c7:a4:de,254299533,544,350,254298989,254299533
9668,5,12,149,5745,-75,-96,21,22:ec:75:a8:8a:31,254304364,516,4315,254303848,254304364
9669,5,12,149,5745,-73,-96,23,56:68:e2:c2:8d:d5,254306286,116,1806,254306170,254306286
9670,5,12,149,5745,-73,-96,23,3e:ef:29:c7:4b:17,254306500,440,-226,254306060,254306500
9671,5,12,149,5745,-79,-96,17,9a:24:38:da:96:bb,254308466,824,1142,254307642,254308466
9672,5,12,149,5745,-63,-96,33,f2:da:61:dd:98:c5,254309369,268,635,254309101,254309369
9673,5,24,149,5745,-92,-96,4,,254310433,28,1036,254310405,254310433
9674,5,12,149,5745,-44,-96,52,0e:ae:b4:1e:a1:11,254310682,240,9,254310442,254310682
9675,5,12,149,5745,-75,-96,21,72:d1:72:1d:22:a1,254312460,256,1522,254312204,254312460
9676,5,24,149,5745,-92,-96,4,,254313295,28,807,254313267,254313295
9677,5,12,149,5745,-73,-96,23,56:68:e2:c2:8d:d5,254316817,476,3046,254316341,254316817
9678,5,12,149,5745,-55,-96,41,5e:29:73:5b:30:00,254320563,540,3206,254320023,254320563
9679,5,12,149,5745,-55,-96,41,5e:29:73:5b:30:00,254329255,272,8420,254328983,254329255
9680,5,12,149,5745,-75,-96,21,f6:0a:5c:59:72:df,254336068,252,6561,254335816,254336068
9681,5,6,149,5745,-83,-96,13,54:e4:3a:ec:fb:65,254345463,360,9035,254345103,254345463
9682,5,12,149,5745,-63,-96,33,f2:da:61:dd:98:c5,254346120,268,389,254345852,254346120
9683,5,12,149,5745,-73,-96,23,3e:ef:29:c7:4b:17,254346481,244,117,254346237,254346481
9684,5,12,149,5745,-79,-96,17,9a:24:38:da:96:bb,254353227,272,6474,254352955,254353227
9685,5,12,149,5745,-75,-96,21,d2:00:04:7e:2c:ab,254363577,244,10106,254363333,254363577
9686,5,12,149,5745,-75,-96,21,d2:00:04:7e:2c:ab,254364376,440,359,254363936,254364376
9687,5,12,149,5745,-44,-96,52,0e:ae:b4:1e:a1:11,254369552,240,4936,254369312,254369552
9688,5,12,149,5745,-73,-96,23,56:68:e2:c2:8d:d5,254375524,280,5692,254375244,254375524
9689,5,12,149,5745,-75,-96,21,22:ec:75:a8:8a:31,254381161,244,5393,254380917,254381161
9690,5,12,149,5745,-56,-96,40,3e:d1:9b:c7:a4:de,254392553,272,11120,254392281,254392553
9691,5,12,149,5745,-45,-96,51,0e:ae:b4:1e:a1:11,254393199,240,406,254392959,254393199
9692,5,24,149,5745,-87,-96,9,,254401248,32,8017,254401216,254401248
9693,5,24,149,5745,-87,-96,9,,254401729,28,453,254401701,254401729
9694,5,24,149,5745,-88,-96,8,,254402014,32,253,254401982,254402014
9695,5,24,149,5745,-90,-96,6,,254402495,28,453,254402467,254402495
9696,5,24,149,5745,-71,-96,25,,254402540,28,17,254402512,254402540
9697,5,24,149,5745,-89,-96,7,,254402870,28,302,254402842,254402870
9698,5,24,149,5745,-90,-96,6,,254404072,28,1174,254404044,254404072
9699,5,24,149,5745,-89,-96,7,,254407227,28,3127,254407199,254407227
9700,5,24,149,5745,-89,-96,7,,254407343,32,84,254407311,254407343
9701,5,24,149,5745,-88,-96,8,,254407462,32,87,254407430,254407462
9702,5,24,149,5745,-89,-96,7,,254420775,28,13285,254420747,254420775
9703,5,12,149,5745,-71,-96,25,a6:92:ad:b7:76:65,254428576,456,7345,254428120,254428576
9704,5,12,149,5745,-75,-96,21,d2:00:04:7e:2c:ab,254429262,440,246,254428822,254429262
9705,5,12,149,5745,-56,-96,40,3e:d1:9b:c7:a4:de,254431086,544,1280,254430542,254431086
9706,5,12,149,5745,-75,-96,21,22:ec:75:a8:8a:31,254434562,516,2960,254434046,254434562
9707,5,24,149,5745,-90,-96,6,,254435569,28,979,254435541,254435569
9708,5,12,149,5745,-73,-96,23,3e:ef:29:c7:4b:17,254438288,440,2279,254437848,254438288
9709,5,12,149,5745,-62,-96,34,f2:da:61:dd:98:c5,254439867,268,1311,254439599,254439867
9710,5,12,149,5745,-60,-96,36,0a:b9:b7:b1:4d:fa,254442332,268,2197,254442064,254442332
9711,5,12,149,5745,-56,-96,40,5e:29:73:5b:30:00,254443994,272,1390,254443722,254443994
9712,5,6,149,5745,-82,-96,14,54:e4:3a:ec:fb:65,254447863,360,3509,254447503,254447863
9713,5,12,149,5745,-72,-96,24,b6:90:18:f6:b1:d4,254449332,440,1029,254448892,254449332
9714,5,12,149,5745,-56,-96,40,5e:29:73:5b:30:00,254451813,540,1941,254451273,254451813
9715,5,24,149,5745,-72,-96,24,,254454498,28,2657,254454470,254454498
9716,5,24,149,5745,-91,-96,5,,254454649,28,123,254454621,254454649
9717,5,12,149,5745,-62,-96,34,f2:da:61:dd:98:c5,254460457,268,5540,254460189,254460457
9718,5,12,149,5745,-73,-96,23,3e:ef:29:c7:4b:17,254460813,244,112,254460569,254460813
9719,5,12,149,5745,-76,-96,20,d2:00:04:7e:2c:ab,254462470,244,1413,254462226,254462470
9720,5,12,149,5745,-80,-96,16,9a:24:38:da:96:bb,254464259,272,1517,254463987,254464259
9721,5,24,149,5745,-92,-96,4,,254466636,28,2349,254466608,254466636
9722,5,24,149,5745,-90,-96,6,,254469693,28,3029,254469665,254469693
9723,5,12,149,5745,-76,-96,20,72:d1:72:1d:22:a1,254472523,256,2574,254472267,254472523
9724,5,12,149,5745,-73,-96,23,56:68:e2:c2:8d:d5,254474620,280,1817,254474340,254474620
9725,5,24,149,5745,-91,-96,5,,254483174,28,8526,254483146,254483174
9726,5,12,149,5745,-75,-96,21,d2:00:04:7e:2c:ab,254494825,440,11211,254494385,254494825
9727,5,12,149,5745,-75,-96,21,22:ec:75:a8:8a:31,254498322,244,3253,254498078,254498322
9728,5,12,149,5745,-41,-96,55,0e:ae:b4:1e:a1:11,254500707,240,2145,254500467,254500707
9729,5,24,149,5745,-90,-96,6,,254503467,32,2728,254503435,254503467
9730,5,12,149,5745,-41,-96,55,0e:ae:b4:1e:a1:11,254506089,240,2382,254505849,254506089
9731,5,12,149,5745,-57,-96,39,3e:d1:9b:c7:a4:de,254509555,272,3194,254509283,254509555
9732,5,24,149,5745,-90,-96,6,,254510672,28,1089,254510644,254510672
9733,5,24,149,5745,-90,-96,6,,254510780,32,76,254510748,254510780
9734,5,24,149,5745,-90,-96,6,,254534760,32,23948,254534728,254534760
9735,5,12,149,5745,-57,-96,39,5e:29:73:5b:30:00,254538573,272,3541,254538301,254538573
9736,5,24,149,5745,-91,-96,5,,254549306,28,10705,254549278,254549306
9737,5,6,149,5745,-83,-96,13,54:e4:3a:ec:fb:65,254550263,360,597,254549903,254550263
9738,5,24,149,5745,-90,-96,6,,254551592,28,1301,254551564,254551592
9739,5,24,149,5745,-91,-96,5,,254563175,28,11555,254563147,254563175
9740,5,24,149,5745,-90,-96,6,,254566159,28,2956,254566131,254566159
9741,5,12,149,5745,-41,-96,55,0e:ae:b4:1e:a1:11,254566693,240,294,254566453,254566693
9742,5,12,149,5745,-77,-96,19,72:d1:72:1d:22:a1,254575241,256,8292,254574985,254575241
9743,5,12,149,5745,-81,-96,15,9a:24:38:da:96:bb,254577219,272,1706,254576947,254577219
9744,5,12,149,5745,-74,-96,22,f6:0a:5c:59:72:df,254577768,252,297,254577516,254577768
9745,5,12,149,5745,-77,-96,19,d2:00:04:7e:2c:ab,254586841,244,8829,254586597,254586841
9746,5,12,149,5745,-73,-96,23,56:68:e2:c2:8d:d5,254592986,280,5865,254592706,254592986
9747,5,24,149,5745,-90,-96,6,,254601136,28,8122,254601108,254601136
9748,5,24,149,5745,-90,-96,6,,254604114,28,2950,254604086,254604114
9749,5,24,149,5745,-91,-96,5,,254604222,32,76,254604190,254604222
9750,5,12,149,5745,-76,-96,20,22:ec:75:a8:8a:31,254611927,244,7461,254611683,254611927
9751,5,24,149,5745,-91,-96,5,,254613026,28,1071,254612998,254613026
9752,5,12,149,5745,-40,-96,56,0e:ae:b4:1e:a1:11,254617483,240,4217,254617243,254617483
9753,5,12,149,5745,-56,-96,40,3e:d1:9b:c7:a4:de,254624407,272,6652,254624135,254624407
9754,5,12,149,5745,-73,-96,23,3e:ef:29:c7:4b:17,254627659,244,3008,254627415,254627659
9755,5,24,149,5745,-91,-96,5,,254640605,28,12918,254640577,254640605
9756,5,24,149,5745,-92,-96,4,,254640713,32,76,254640681,254640713
9757,5,6,149,5745,-84,-96,12,54:e4:3a:ec:fb:65,254652664,360,11591,254652304,254652664
9758,5,12,149,5745,-63,-96,33,f2:da:61:dd:98:c5,254653412,268,480,254653144,254653412
9759,5,24,149,5745,-91,-96,5,,254655737,28,2297,254655709,254655737
9760,5,12,149,5745,-57,-96,39,5e:29:73:5b:30:00,254656141,272,132,254655869,254656141
9761,5,24,149,5745,-90,-96,6,,254659011,28,2842,254658983,254659011
9762,5,12,149,5745,-77,-96,19,72:d1:72:1d:22:a1,254677116,256,17849,254676860,254677116
9763,5,24,149,5745,-92,-96,4,,254680685,28,3541,254680657,254680685
9764,5,24,149,5745,-90,-96,6,,254681028,28,315,254681000,254681028
9765,5,24,149,5745,-90,-96,6,,254684151,32,3091,254684119,254684151
9766,5,12,149,5745,-74,-96,22,f6:0a:5c:59:72:df,254689827,252,5424,254689575,254689827
9767,5,12,149,5745,-79,-96,17,9a:24:38:da:96:bb,254692330,272,2231,254692058,254692330
9768,5,24,149,5745,-91,-96,5,,254726298,28,33940,254726270,254726298
9769,5,24,149,5745,-90,-96,6,,254726407,32,77,254726375,254726407
9770,5,12,149,5745,-76,-96,20,22:ec:75:a8:8a:31,254729362,244,2711,254729118,254729362
9771,5,12,149,5745,-74,-96,22,3e:ef:29:c7:4b:17,254731246,244,1640,254731002,254731246
9772,5,12,149,5745,-56,-96,40,3e:d1:9b:c7:a4:de,254738174,272,6656,254737902,254738174
9773,5,6,149,5745,-83,-96,13,54:e4:3a:ec:fb:65,254755064,360,16530,254754704,254755064
9774,5,12,149,5745,-64,-96,32,f2:da:61:dd:98:c5,254755776,268,444,254755508,254755776
9775,5,24,149,5745,-92,-96,4,,254762261,28,6457,254762233,254762261
9776,5,12,149,5745,-57,-96,39,5e:29:73:5b:30:00,254773210,272,10677,254772938,254773210
9777,5,12,149,5745,-79,-96,17,d2:00:04:7e:2c:ab,254779213,244,5759,254778969,254779213
9778,5,12,149,5745,-76,-96,20,72:d1:72:1d:22:a1,254780130,256,661,254779874,254780130
9779,5,12,149,5745,-73,-96,23,56:68:e2:c2:8d:d5,254782740,280,2330,254782460,254782740
9780,5,12,149,5745,-73,-96,23,56:68:e2:c2:8d:d5,254811355,280,28335,254811075,254811355
9781,5,12,149,5745,-80,-96,16,d2:00:04:7e:2c:ab,254811957,244,358,254811713,254811957
9782,5,24,149,5745,-90,-96,6,,254818166,28,6181,254818138,254818166
9783,5,24,149,5745,-91,-96,5,,254820851,32,2653,254820819,254820851
9784,5,12,149,5745,-73,-96,23,3e:ef:29:c7:4b:17,254832409,244,11314,254832165,254832409
9785,5,12,149,5745,-74,-96,22,22:ec:75:a8:8a:31,254841189,244,8536,254840945,254841189
9786,5,12,149,5745,-56,-96,40,3e:d1:9b:c7:a4:de,254850173,272,8712,254849901,254850173
9787,5,12,149,5745,-43,-96,53,0e:ae:b4:1e:a1:11,254854364,240,3951,254854124,254854364
9788,5,6,149,5745,-84,-96,12,54:e4:3a:ec:fb:65,254857465,360,2741,254857105,254857465
9789,5,12,149,5745,-65,-96,31,f2:da:61:dd:98:c5,254859036,268,1303,254858768,254859036
9790,5,12,149,5745,-76,-96,20,72:d1:72:1d:22:a1,254872601,256,13309,254872345,254872601
9791,5,12,149,5745,-80,-96,16,9a:24:38:da:96:bb,254873537,272,664,254873265,254873537
9792,5,12,149,5745,-56,-96,40,3e:d1:9b:c7:a4:de,254888669,544,14588,254888125,254888669
9793,5,12,149,5745,-82,-96,14,d2:00:04:7e:2c:ab,254889321,440,212,254888881,254889321
9794,5,12,149,5745,-76,-96,20,72:d1:72:1d:22:a1,254890391,452,618,254889939,254890391
9795,5,12,149,5745,-74,-96,22,22:ec:75:a8:8a:31,254891948,516,1041,254891432,254891948
9796,5,12,149,5745,-43,-96,53,0e:ae:b4:1e:a1:11,254896530,240,4342,254896290,254896530
9797,5,12,149,5745,-74,-96,22,3e:ef:29:c7:4b:17,254897047,440,77,254896607,254897047
9798,5,24,149,5745,-72,-96,24,,254902485,28,5410,254902457,254902485
9799,5,12,149,5745,-57,-96,39,5e:29:73:5b:30:00,254902726,272,-31,254902454,254902726
9800,5,12,149,5745,-66,-96,30,f2:da:61:dd:98:c5,254903043,268,49,254902775,254903043
9801,5,12,149,5745,-72,-96,24,f6:0a:5c:59:72:df,254903390,252,95,254903138,254903390
9802,5,12,149,5745,-66,-96,30,f2:da:61:dd:98:c5,254905590,268,1932,254905322,254905590
9803,5,12,149,5745,-57,-96,39,5e:29:73:5b:30:00,254908013,540,1883,254907473,254908013
9804,5,12,149,5745,-72,-96,24,56:68:e2:c2:8d:d5,254908606,476,117,254908130,254908606
9805,5,12,149,5745,-72,-96,24,f6:0a:5c:59:72:df,254912161,448,3107,254911713,254912161
9806,5,12,149,5745,-80,-96,16,9a:24:38:da:96:bb,254914573,272,2140,254914301,254914573
9807,5,24,149,5745,-71,-96,25,,254915224,28,623,254915196,254915224
9808,5,24,149,5745,-91,-96,5,,254915268,28,16,254915240,254915268
9809,5,12,149,5745,-72,-96,24,56:68:e2:c2:8d:d5,254919249,280,3701,254918969,254919249
9810,5,12,149,5745,-74,-96,22,3e:ef:29:c7:4b:17,254919573,244,80,254919329,254919573
9811,5,12,149,5745,-82,-96,14,d2:00:04:7e:2c:ab,254921458,244,1641,254921214,254921458
9812,5,24,149,5745,-71,-96,25,,254923464,28,1978,254923436,254923464
9813,5,24,149,5745,-71,-96,25,,254924313,28,821,254924285,254924313
9814,5,24,149,5745,-90,-96,6,,254924357,28,16,254924329,254924357
9815,5,24,149,5745,-71,-96,25,,254924620,28,235,254924592,254924620
9816,5,24,149,5745,-71,-96,25,,254942632,28,17984,254942604,254942632
9817,5,24,149,5745,-71,-96,25,,254946548,28,3888,254946520,254946548
9818,5,24,149,5745,-90,-96,6,,254946592,28,16,254946564,254946592
9819,5,24,149,5745,-72,-96,24,,254946973,28,353,254946945,254946973
9820,5,24,149,5745,-71,-96,25,,254947229,28,228,254947201,254947229
9821,5,24,149,5745,-91,-96,5,,254947273,28,16,254947245,254947273
9822,5,12,149,5745,-68,-96,28,a6:92:ad:b7:76:65,254952870,456,5141,254952414,254952870
9823,5,12,149,5745,-44,-96,52,0e:ae:b4:1e:a1:11,254953369,240,259,254953129,254953369
9824,5,12,149,5745,-55,-96,41,3e:d1:9b:c7:a4:de,254953670,544,-243,254953126,254953670
9825,5,12,149,5745,-80,-96,16,d2:00:04:7e:2c:ab,254954250,440,140,254953810,254954250
9826,5,12,149,5745,-74,-96,22,72:d1:72:1d:22:a1,254954744,452,42,254954292,254954744
9827,5,6,149,5745,-77,-96,19,fe:2b:99:12:5f:01,254957578,164,2670,254957414,254957578
9828,5,12,149,5745,-73,-96,23,22:ec:75:a8:8a:31,254957797,516,-297,254957281,254957797
9829,5,6,149,5745,-83,-96,13,54:e4:3a:ec:fb:65,254958381,352,232,254958029,254958381
9830,5,6,149,5745,-76,-96,20,,254958751,44,326,254958707,254958751
9831,5,6,149,5745,-84,-96,12,54:e4:3a:ec:fb:65,254959866,360,755,254959506,254959866
9832,5,12,149,5745,-75,-96,21,3e:ef:29:c7:4b:17,254960581,440,275,254960141,254960581
9833,5,12,149,5745,-58,-96,38,0a:b9:b7:b1:4d:fa,254964437,268,3588,254964169,254964437
9834,5,12,149,5745,-45,-96,51,0e:ae:b4:1e:a1:11,254966434,204,1793,254966230,254966434
9835,5,12,149,5745,-73,-96,23,22:ec:75:a8:8a:31,254967024,244,346,254966780,254967024
9836,5,12,149,5745,-79,-96,17,d2:00:04:7e:2c:ab,254969011,380,1607,254968631,254969011
9837,5,12,149,5745,-68,-96,28,f2:da:61:dd:98:c5,254970361,268,1082,254970093,254970361
9838,5,12,149,5745,-73,-96,23,56:68:e2:c2:8d:d5,254971114,476,277,254970638,254971114
9839,5,12,149,5745,-69,-96,27,b6:90:18:f6:b1:d4,254972859,440,1305,254972419,254972859
9840,5,12,149,5745,-58,-96,38,5e:29:73:5b:30:00,254973378,540,-21,254972838,254973378
9841,5,24,149,5745,-71,-96,25,,254974756,28,1350,254974728,254974756
9842,5,24,149,5745,-71,-96,25,,254975044,28,260,254975016,254975044
9843,5,24,149,5745,-90,-96,6,,254975088,28,16,254975060,254975088
9844,5,12,149,5745,-74,-96,22,f6:0a:5c:59:72:df,254975618,448,82,254975170,254975618
9845,5,24,149,5745,-71,-96,25,,254976163,28,517,254976135,254976163
9846,5,24,149,5745,-71,-96,25,,254976767,28,576,254976739,254976767
9847,5,24,149,5745,-89,-96,7,,254979634,28,2839,254979606,254979634
9848,5,12,149,5745,-55,-96,41,3e:d1:9b:c7:a4:de,254983841,272,3935,254983569,254983841
9849,5,12,149,5745,-74,-96,22,72:d1:72:1d:22:a1,254986660,256,2563,254986404,254986660
9850,5,24,149,5745,-71,-96,25,,254990122,28,3434,254990094,254990122
9851,5,24,149,5745,-88,-96,8,,254996030,28,5880,254996002,254996030
9852,5,12,149,5745,-58,-96,38,5e:29:73:5b:30:00,255001817,272,5515,255001545,255001817
9853,5,24,149,5745,-89,-96,7,,255002465,28,620,255002437,255002465
9854,5,24,149,5745,-70,-96,26,,255002836,28,343,255002808,255002836
9855,5,24,149,5745,-88,-96,8,,255002880,28,16,255002852,255002880
9856,5,24,149,5745,-89,-96,7,,255002989,28,81,255002961,255002989
9857,5,6,149,5745,-76,-96,20,fe:2b:99:12:5f:01,255014848,164,11695,255014684,255014848
9858,5,6,149,5745,-84,-96,12,54:e4:3a:ec:fb:65,255015160,352,-40,255014808,255015160
9859,5,6,149,5745,-76,-96,20,,255015530,44,326,255015486,255015530
9860,5,12,149,5745,-65,-96,31,f2:da:61:dd:98:c5,255017419,268,1621,255017151,255017419
9861,5,12,149,5745,-78,-96,18,d2:00:04:7e:2c:ab,255019133,440,1274,255018693,255019133
9862,5,24,149,5745,-70,-96,26,,255019675,28,514,255019647,255019675
9863,5,24,149,5745,-89,-96,7,,255019828,28,125,255019800,255019828
9864,5,12,149,5745,-45,-96,51,0e:ae:b4:1e:a1:11,255023929,240,3861,255023689,255023929
9865,5,12,149,5745,-79,-96,17,9a:24:38:da:96:bb,255027484,272,3283,255027212,255027484
9866,5,12,149,5745,-65,-96,31,f2:da:61:dd:98:c5,255036038,268,8286,255035770,255036038
9867,5,12,149,5745,-71,-96,25,56:68:e2:c2:8d:d5,255040804,280,4486,255040524,255040804
9868,5,12,149,5745,-77,-96,19,3e:ef:29:c7:4b:17,255042821,244,1773,255042577,255042821
9869,5,12,149,5745,-74,-96,22,f6:0a:5c:59:72:df,255055822,252,12749,255055570,255055822
9870,5,6,149,5745,-84,-96,12,54:e4:3a:ec:fb:65,255062266,360,6084,255061906,255062266
9871,5,12,149,5745,-48,-96,48,0e:ae:b4:1e:a1:11,255065678,240,3172,255065438,255065678
9872,5,12,149,5745,-72,-96,24,22:ec:75:a8:8a:31,255070938,244,5016,255070694,255070938
9873,5,24,149,5745,-70,-96,26,,255074977,28,4011,255074949,255074977
9874,5,12,149,5745,-54,-96,42,3e:d1:9b:c7:a4:de,255080004,272,4755,255079732,255080004
9875,5,12,149,5745,-48,-96,48,0e:ae:b4:1e:a1:11,255091788,240,11544,255091548,255091788
9876,5,24,149,5745,-91,-96,5,,255095605,28,3789,255095577,255095605
9877,5,12,149,5745,-74,-96,22,72:d1:72:1d:22:a1,255099247,256,3386,255098991,255099247
9878,5,12,149,5745,-62,-96,34,f2:da:61:dd:98:c5,255102022,268,2507,255101754,255102022
9879,5,12,149,5745,-57,-96,39,5e:29:73:5b:30:00,255112376,272,10082,255112104,255112376
9880,5,24,149,5745,-91,-96,5,,255116663,28,4259,255116635,255116663
9881,5,24,149,5745,-90,-96,6,,255117441,28,750,255117413,255117441
9882,5,24,149,5745,-72,-96,24,,255130560,28,13091,255130532,255130560
9883,5,24,149,5745,-89,-96,7,,255130712,28,124,255130684,255130712
9884,5,24,149,5745,-89,-96,7,,255132383,28,1643,255132355,255132383
9885,5,12,149,5745,-61,-96,35,f2:da:61:dd:98:c5,255132608,268,-43,255132340,255132608
9886,5,12,149,5745,-76,-96,20,9a:24:38:da:96:bb,255143058,272,10178,255142786,255143058
9887,5,24,149,5745,-71,-96,25,,255146310,28,3224,255146282,255146310
9888,5,24,149,5745,-89,-96,7,,255146462,28,124,255146434,255146462
9889,5,24,149,5745,-92,-96,4,,255149045,28,2555,255149017,255149045
9890,5,12,149,5745,-78,-96,18,3e:ef:29:c7:4b:17,255149716,244,427,255149472,255149716
9891,5,24,149,5745,-91,-96,5,,255153710,28,3966,255153682,255153710
9892,5,24,149,5745,-90,-96,6,,255160749,28,7011,255160721,255160749
9893,5,6,149,5745,-87,-96,9,54:e4:3a:ec:fb:65,255164667,360,3558,255164307,255164667
9894,5,12,149,5745,-61,-96,35,f2:da:61:dd:98:c5,255167023,268,2088,255166755,255167023
9895,5,24,149,5745,-89,-96,7,,255171872,28,4821,255171844,255171872
9896,5,12,149,5745,-45,-96,51,0e:ae:b4:1e:a1:11,255177681,240,5569,255177441,255177681
9897,5,24,149,5745,-90,-96,6,,255181229,28,3520,255181201,255181229
9898,5,12,149,5745,-73,-96,23,22:ec:75:a8:8a:31,255187837,244,6364,255187593,255187837
9899,5,12,149,5745,-78,-96,18,d2:00:04:7e:2c:ab,255188865,244,784,255188621,255188865
9900,5,12,149,5745,-66,-96,30,fa:44:8d:e1:c7:1b,255190234,244,1125,255189990,255190234
9901,5,12,149,5745,-73,-96,23,56:68:e2:c2:8d:d5,255191394,280,880,255191114,255191394
9902,5,12,149,5745,-54,-96,42,3e:d1:9b:c7:a4:de,255197001,272,5335,255196729,255197001
9903,5,24,149,5745,-92,-96,4,,255211446,28,14417,255211418,255211446
9904,5,24,149,5745,-91,-96,5,,255214346,28,2872,255214318,255214346
9905,5,12,149,5745,-58,-96,38,5e:29:73:5b:30:00,255229275,272,14657,255229003,255229275
9906,5,12,149,5745,-76,-96,20,9a:24:38:da:96:bb,255251809,272,22262,255251537,255251809
9907,5,12,149,5745,-59,-96,37,f2:da:61:dd:98:c5,255253368,268,1291,255253100,255253368
9908,5,6,149,5745,-88,-96,8,54:e4:3a:ec:fb:65,255267067,360,13339,255266707,255267067
9909,5,12,149,5745,-75,-96,21,3e:ef:29:c7:4b:17,255272936,244,5625,255272692,255272936
9910,5,12,149,5745,-77,-96,19,d2:00:04:7e:2c:ab,255291455,244,18275,255291211,255291455
9911,5,12,149,5745,-76,-96,20,72:d1:72:1d:22:a1,255291951,256,240,255291695,255291951
9912,5,12,149,5745,-76,-96,20,56:68:e2:c2:8d:d5,255292700,280,469,255292420,255292700
9913,5,12,149,5745,-72,-96,24,22:ec:75:a8:8a:31,255304991,244,12047,255304747,255304991
9914,5,12,149,5745,-46,-96,50,0e:ae:b4:1e:a1:11,255306905,240,1674,255306665,255306905
9915,5,12,149,5745,-71,-96,25,fa:44:8d:e1:c7:1b,255307305,244,156,255307061,255307305
9916,5,12,149,5745,-54,-96,42,3e:d1:9b:c7:a4:de,255313956,272,6379,255313684,255313956
9917,5,12,149,5745,-76,-96,20,72:d1:72:1d:22:a1,255327003,256,12791,255326747,255327003
9918,5,12,149,5745,-54,-96,42,3e:d1:9b:c7:a4:de,255349387,544,21840,255348843,255349387
9919,5,12,149,5745,-73,-96,23,22:ec:75:a8:8a:31,255350811,516,908,255350295,255350811
9920,5,12,149,5745,-74,-96,22,f6:0a:5c:59:72:df,255351820,252,757,255351568,255351820
9921,5,12,149,5745,-46,-96,50,0e:ae:b4:1e:a1:11,255354590,240,2530,255354350,255354590
9922,5,12,149,5745,-76,-96,20,3e:ef:29:c7:4b:17,255355735,440,705,255355295,255355735
9923,5,12,149,5745,-78,-96,18,9a:24:38:da:96:bb,255356247,824,-312,255355423,255356247
9924,5,12,149,5745,-72,-96,24,fa:44:8d:e1:c7:1b,255360027,412,3368,255359615,255360027
9925,5,12,149,5745,-58,-96,38,f2:da:61:dd:98:c5,255361797,268,1502,255361529,255361797
9926,5,12,149,5745,-78,-96,18,9a:24:38:da:96:bb,255362650,272,581,255362378,255362650
9927,5,12,149,5745,-76,-96,20,72:d1:72:1d:22:a1,255365417,452,2315,255364965,255365417
9928,5,12,149,5745,-58,-96,38,f2:da:61:dd:98:c5,255365948,268,263,255365680,255365948
9929,5,12,149,5745,-57,-96,39,5e:29:73:5b:30:00,255367852,540,1364,255367312,255367852
9930,5,12,149,5745,-73,-96,23,f6:0a:5c:59:72:df,255368462,448,162,255368014,255368462
9931,5,12,149,5745,-76,-96,20,56:68:e2:c2:8d:d5,255368999,476,61,255368523,255368999
9932,5,24,149,5745,-92,-96,4,,255374814,32,5783,255374782,255374814
9933,5,12,149,5745,-77,-96,19,3e:ef:29:c7:4b:17,255378084,244,3026,255377840,255378084
9934,5,24,149,5745,-91,-96,5,,255381057,28,2945,255381029,255381057
9935,5,24,149,5745,-91,-96,5,,255396393,28,15308,255396365,255396393
9936,5,12,149,5745,-46,-96,50,0e:ae:b4:1e:a1:11,255401383,240,4750,255401143,255401383
9937,5,12,149,5745,-67,-96,29,b6:90:18:f6:b1:d4,255410963,440,9140,255410523,255410963
9938,5,12,149,5745,-71,-96,25,fa:44:8d:e1:c7:1b,255411475,244,268,255411231,255411475
9939,5,12,149,5745,-75,-96,21,22:ec:75:a8:8a:31,255418855,244,7136,255418611,255418855
9940,5,24,149,5745,-90,-96,6,,255420322,28,1439,255420294,255420322
9941,5,12,149,5745,-70,-96,26,fa:44:8d:e1:c7:1b,255425057,412,4323,255424645,255425057
9942,5,24,149,5745,-90,-96,6,,255427177,32,2088,255427145,255427177
9943,5,12,149,5745,-59,-96,37,f2:da:61:dd:98:c5,255429130,268,1685,255428862,255429130
9944,5,12,149,5745,-55,-96,41,3e:d1:9b:c7:a4:de,255430969,272,1567,255430697,255430969
9945,5,12,149,5745,-76,-96,20,72:d1:72:1d:22:a1,255440469,256,9244,255440213,255440469
9946,5,24,149,5745,-89,-96,7,,255448660,28,8163,255448632,255448660
9947,5,24,149,5745,-89,-96,7,,255455836,28,7148,255455808,255455836
9948,5,12,149,5745,-66,-96,30,b6:90:18:f6:b1:d4,255458897,244,2817,255458653,255458897
9949,5,24,149,5745,-89,-96,7,,255467848,28,8923,255467820,255467848
9950,5,6,149,5745,-87,-96,9,54:e4:3a:ec:fb:65,255471868,360,3660,255471508,255471868
9951,5,12,149,5745,-67,-96,29,b6:90:18:f6:b1:d4,255474001,440,1693,255473561,255474001
9952,5,24,149,5745,-90,-96,6,,255474663,28,634,255474635,255474663
9953,5,24,149,5745,-90,-96,6,,255474772,32,77,255474740,255474772
9954,5,12,149,5745,-78,-96,18,9a:24:38:da:96:bb,255474878,272,-166,255474606,255474878
9955,5,12,149,5745,-59,-96,37,f2:da:61:dd:98:c5,255476166,268,1020,255475898,255476166
9956,5,12,149,5745,-59,-96,37,5e:29:73:5b:30:00,255476513,272,75,255476241,255476513
9957,5,12,149,5745,-71,-96,25,a6:92:ad:b7:76:65,255477287,456,318,255476831,255477287
9958,5,12,149,5745,-56,-96,40,3e:d1:9b:c7:a4:de,255479911,544,2080,255479367,255479911
9959,5,12,149,5745,-73,-96,23,f6:0a:5c:59:72:df,255480546,252,383,255480294,255480546
9960,5,24,149,5745,-89,-96,7,,255481792,28,1218,255481764,255481792
9961,5,12,149,5745,-45,-96,51,0e:ae:b4:1e:a1:11,255484948,240,2916,255484708,255484948
9962,5,12,149,5745,-78,-96,18,3e:ef:29:c7:4b:17,255485654,440,266,255485214,255485654
9963,5,12,149,5745,-79,-96,17,9a:24:38:da:96:bb,255488897,824,2419,255488073,255488897
9964,5,12,149,5745,-61,-96,35,0a:b9:b7:b1:4d:fa,255489816,268,651,255489548,255489816
9965,5,12,149,5745,-76,-96,20,56:68:e2:c2:8d:d5,255490256,280,160,255489976,255490256
9966,5,12,149,5745,-67,-96,29,fa:44:8d:e1:c7:1b,255491714,412,1046,255491302,255491714
9967,5,12,149,5745,-75,-96,21,22:ec:75:a8:8a:31,255492169,516,-61,255491653,255492169
9968,5,12,149,5745,-78,-96,18,3e:ef:29:c7:4b:17,255493954,244,1541,255493710,255493954
9969,5,12,149,5745,-59,-96,37,f2:da:61:dd:98:c5,255494799,268,577,255494531,255494799
9970,5,12,149,5745,-80,-96,16,d2:00:04:7e:2c:ab,255498000,440,2761,255497560,255498000
9971,5,12,149,5745,-59,-96,37,5e:29:73:5b:30:00,255498483,540,-57,255497943,255498483
9972,5,24,149,5745,-90,-96,6,,255503160,28,4649,255503132,255503160
9973,5,24,149,5745,-90,-96,6,,255503268,32,76,255503236,255503268
9974,5,12,149,5745,-45,-96,51,0e:ae:b4:1e:a1:11,255513861,240,10353,255513621,255513861
9975,5,24,149,5745,-89,-96,7,,255517494,28,3605,255517466,255517494
9976,5,24,149,5745,-89,-96,7,,255524746,28,7224,255524718,255524746
9977,5,24,149,5745,-88,-96,8,,255524854,32,76,255524822,255524854
9978,5,12,149,5745,-67,-96,29,fa:44:8d:e1:c7:1b,255526072,244,974,255525828,255526072
9979,5,24,149,5745,-89,-96,7,,255528478,28,2378,255528450,255528478
9980,5,12,149,5745,-75,-96,21,22:ec:75:a8:8a:31,255532472,244,3750,255532228,255532472
9981,5,24,149,5745,-90,-96,6,,255535774,32,3270,255535742,255535774
9982,5,12,149,5745,-55,-96,41,3e:d1:9b:c7:a4:de,255543060,272,7014,255542788,255543060
9983,5,24,149,5745,-88,-96,8,,255545315,28,2227,255545287,255545315
9984,5,24,149,5745,-89,-96,7,,255552536,28,7193,255552508,255552536
9985,5,24,149,5745,-90,-96,6,,255552644,32,76,255552612,255552644
9986,5,12,149,5745,-67,-96,29,fa:44:8d:e1:c7:1b,255557174,440,4090,255556734,255557174
9987,5,12,149,5745,-62,-96,34,f2:da:61:dd:98:c5,255560169,268,2727,255559901,255560169
9988,5,6,149,5745,-86,-96,10,54:e4:3a:ec:fb:65,255574269,360,13740,255573909,255574269
9989,5,12,149,5745,-59,-96,37,5e:29:73:5b:30:00,255575516,272,975,255575244,255575516
9990,5,24,149,5745,-90,-96,6,,255578444,28,2900,255578416,255578444
9991,5,24,149,5745,-91,-96,5,,255579973,32,1497,255579941,255579973
9992,5,12,149,5745,-67,-96,29,b6:90:18:f6:b1:d4,255582901,244,2684,255582657,255582901
9993,5,24,149,5745,-89,-96,7,,255585690,32,2757,255585658,255585690
9994,5,12,149,5745,-81,-96,15,9a:24:38:da:96:bb,255587613,272,1651,255587341,255587613
9995,5,24,149,5745,-89,-96,7,,255589961,32,2316,255589929,255589961
9996,5,12,149,5745,-64,-96,32,f2:da:61:dd:98:c5,255591168,268,939,255590900,255591168
9997,5,24,149,5745,-90,-96,6,,255593270,28,2074,255593242,255593270
9998,5,12,149,5745,-76,-96,20,72:d1:72:1d:22:a1,255599167,256,5641,255598911,255599167
9999,5,24,149,5745,-91,-96,5,,255600195,32,996,255600163,255600195
10000,5,24,149,5745,-90,-96,6,,255600688,28,465,255600660,255600688
10001,5,24,149,5745,-90,-96,6,,255608499,28,7783,255608471,255608499
10002,5,24,149,5745,-92,-96,4,,255624717,28,16190,255624689,255624717
10003,5,12,149,5745,-40,-96,56,0e:ae:b4:1e:a1:11,255625261,240,304,255625021,255625261
10004,5,12,149,5745,-65,-96,31,f2:da:61:dd:98:c5,255625702,268,173,255625434,255625702
10005,5,24,149,5745,-88,-96,8,,255631954,32,6220,255631922,255631954
10006,5,12,149,5745,-67,-96,29,fa:44:8d:e1:c7:1b,255639232,244,7034,255638988,255639232
10007,5,24,149,5745,-88,-96,8,,255640765,28,1505,255640737,255640765
10008,5,24,149,5745,-88,-96,8,,255648076,32,7279,255648044,255648076
10009,5,12,149,5745,-73,-96,23,22:ec:75:a8:8a:31,255650191,244,1871,255649947,255650191
10010,5,12,149,5745,-78,-96,18,3e:ef:29:c7:4b:17,255651121,244,686,255650877,255651121
10011,5,12,149,5745,-55,-96,41,3e:d1:9b:c7:a4:de,255659005,272,7612,255658733,255659005
10012,5,24,149,5745,-91,-96,5,,255659469,28,436,255659441,255659469
10013,5,24,149,5745,-90,-96,6,,255666203,28,6706,255666175,255666203
10014,5,24,149,5745,-90,-96,6,,255666311,32,76,255666279,255666311
10015,5,24,149,5745,-89,-96,7,,255674974,28,8635,255674946,255674974
10016,5,6,149,5745,-85,-96,11,54:e4:3a:ec:fb:65,255676670,360,1336,255676310,255676670
10017,5,24,149,5745,-90,-96,6,,255682216,28,5518,255682188,255682216
10018,5,24,149,5745,-88,-96,8,,255682324,32,76,255682292,255682324
10019,5,12,149,5745,-61,-96,35,f2:da:61:dd:98:c5,255685244,268,2652,255684976,255685244
10020,5,12,149,5745,-61,-96,35,f2:da:61:dd:98:c5,255689182,268,3670,255688914,255689182
10021,5,24,149,5745,-90,-96,6,,255690844,28,1634,255690816,255690844
10022,5,12,149,5745,-38,-96,58,0e:ae:b4:1e:a1:11,255693845,240,2761,255693605,255693845
10023,5,12,149,5745,-55,-96,41,5e:29:73:5b:30:00,255694290,540,-95,255693750,255694290
10024,5,12,149,5745,-67,-96,29,b6:90:18:f6:b1:d4,255694963,244,429,255694719,255694963
10025,5,24,149,5745,-90,-96,6,,255698091,28,3100,255698063,255698091
10026,5,24,149,5745,-90,-96,6,,255698199,32,76,255698167,255698199
10027,5,12,149,5745,-77,-96,19,72:d1:72:1d:22:a1,255701503,256,3048,255701247,255701503
10028,5,12,149,5745,-55,-96,41,5e:29:73:5b:30:00,255705555,272,3780,255705283,255705555
10029,5,12,149,5745,-76,-96,20,56:68:e2:c2:8d:d5,255716773,280,10938,255716493,255716773
10030,5,24,149,5745,-88,-96,8,,255719848,28,3047,255719820,255719848
10031,5,24,149,5745,-90,-96,6,,255729241,32,9361,255729209,255729241
10032,5,24,149,5745,-89,-96,7,,255735383,28,6114,255735355,255735383
10033,5,24,149,5745,-89,-96,7,,255742444,28,7033,255742416,255742444
10034,5,24,149,5745,-88,-96,8,,255742552,32,76,255742520,255742552
10035,5,24,149,5745,-89,-96,7,,255750788,28,8208,255750760,255750788
10036,5,12,149,5745,-80,-96,16,3e:ef:29:c7:4b:17,255753299,244,2267,255753055,255753299
10037,5,12,149,5745,-36,-96,60,0e:ae:b4:1e:a1:11,255753983,240,444,255753743,255753983
10038,5,24,149,5745,-88,-96,8,,255757389,28,3378,255757361,255757389
10039,5,24,149,5745,-90,-96,6,,255757497,32,76,255757465,255757497
10040,5,12,149,5745,-70,-96,26,22:ec:75:a8:8a:31,255763539,244,5798,255763295,255763539
10041,5,24,149,5745,-89,-96,7,,255774769,28,11202,255774741,255774769
10042,5,12,149,5745,-55,-96,41,3e:d1:9b:c7:a4:de,255776356,272,1315,255776084,255776356
10043,5,6,149,5745,-83,-96,13,54:e4:3a:ec:fb:65,255779070,360,2354,255778710,255779070
10044,5,24,149,5745,-89,-96,7,,255784048,28,4950,255784020,255784048
10045,5,24,149,5745,-89,-96,7,,255791298,32,7218,255791266,255791298
10046,5,12,149,5745,-66,-96,30,fa:44:8d:e1:c7:1b,255802709,244,11167,255802465,255802709
10047,5,12,149,5745,-79,-96,17,72:d1:72:1d:22:a1,255803858,256,893,255803602,255803858
10048,5,12,149,5745,-59,-96,37,5e:29:73:5b:30:00,255804832,272,702,255804560,255804832
10049,5,24,149,5745,-87,-96,9,,255806347,28,1487,255806319,255806347
10050,5,24,149,5745,-88,-96,8,,255806829,32,450,255806797,255806829
10051,5,12,149,5745,-66,-96,30,b6:90:18:f6:b1:d4,255808283,244,1210,255808039,255808283
10052,5,24,149,5745,-89,-96,7,,255814879,28,6568,255814851,255814879
10053,5,12,149,5745,-79,-96,17,9a:24:38:da:96:bb,255815332,272,181,255815060,255815332
10054,5,24,149,5745,-88,-96,8,,255817564,28,2204,255817536,255817564
10055,5,12,149,5745,-60,-96,36,f2:da:61:dd:98:c5,255818715,268,883,255818447,255818715
10056,5,24,149,5745,-87,-96,9,,255822104,32,3357,255822072,255822104
10057,5,24,149,5745,-88,-96,8,,255831302,28,9170,255831274,255831302
10058,5,24,149,5745,-87,-96,9,,255838481,28,7151,255838453,255838481
10059,5,24,149,5745,-89,-96,7,,255849003,28,10494,255848975,255849003
10060,5,12,149,5745,-78,-96,18,3e:ef:29:c7:4b:17,255855748,244,6501,255855504,255855748
10061,5,12,149,5745,-72,-96,24,22:ec:75:a8:8a:31,255875649,244,19657,255875405,255875649
10062,5,12,149,5745,-40,-96,56,0e:ae:b4:1e:a1:11,255877899,240,2010,255877659,255877899
10063,5,24,149,5745,-90,-96,6,,255879697,28,1770,255879669,255879697
10064,5,6,149,5745,-86,-96,10,54:e4:3a:ec:fb:65,255881471,360,1414,255881111,255881471
10065,5,12,149,5745,-54,-96,42,3e:d1:9b:c7:a4:de,255887899,272,6156,255887627,255887899
10066,5,12,149,5745,-76,-96,20,72:d1:72:1d:22:a1,255906032,256,17877,255905776,255906032
10067,5,12,149,5745,-68,-96,28,fa:44:8d:e1:c7:1b,255906369,244,93,255906125,255906369
10068,5,12,149,5745,-77,-96,19,56:68:e2:c2:8d:d5,255907437,280,788,255907157,255907437
10069,5,24,149,5745,-88,-96,8,,255910977,28,3512,255910949,255910977
10070,5,24,149,5745,-89,-96,7,,255911085,32,76,255911053,255911085
10071,5,24,149,5745,-71,-96,25,,255915307,28,4194,255915279,255915307
10072,5,24,149,5745,-88,-96,8,,255915351,28,16,255915323,255915351
10073,5,24,149,5745,-89,-96,7,,255915460,28,81,255915432,255915460
10074,5,12,149,5745,-72,-96,24,f6:0a:5c:59:72:df,255918679,252,2967,255918427,255918679
10075,5,24,149,5745,-89,-96,7,,255919103,28,396,255919075,255919103
10076,5,24,149,5745,-87,-96,9,,255919494,28,363,255919466,255919494
10077,5,12,149,5745,-66,-96,30,b6:90:18:f6:b1:d4,255919749,244,11,255919505,255919749
10078,5,12,149,5745,-68,-96,28,fa:44:8d:e1:c7:1b,255920191,360,82,255919831,255920191
10079,5,12,149,5745,-67,-96,29,fa:44:8d:e1:c7:1b,255920621,216,214,255920405,255920621
10080,5,12,149,5745,-81,-96,15,9a:24:38:da:96:bb,255922855,272,1962,255922583,255922855
10081,5,24,149,5745,-88,-96,8,,255926270,28,3387,255926242,255926270
10082,5,24,149,5745,-87,-96,9,,255926378,32,76,255926346,255926378
10083,5,24,149,5745,-87,-96,9,,255930513,28,4107,255930485,255930513
10084,5,24,149,5745,-88,-96,8,,255930895,28,354,255930867,255930895
10085,5,12,149,5745,-61,-96,35,f2:da:61:dd:98:c5,255934911,268,3748,255934643,255934911
10086,5,12,149,5745,-74,-96,22,3e:ef:29:c7:4b:17,255936696,440,1345,255936256,255936696
10087,5,24,149,5745,-89,-96,7,,255937278,28,554,255937250,255937278
10088,5,24,149,5745,-88,-96,8,,255937386,32,76,255937354,255937386
10089,5,12,149,5745,-78,-96,18,72:d1:72:1d:22:a1,255939342,452,1504,255938890,255939342
10090,5,12,149,5745,-59,-96,37,5e:29:73:5b:30:00,255940764,540,882,255940224,255940764
10091,5,24,149,5745,-89,-96,7,,255942446,28,1654,255942418,255942446
10092,5,24,149,5745,-89,-96,7,,255942728,28,254,255942700,255942728
10093,5,12,149,5745,-67,-96,29,b6:90:18:f6:b1:d4,255946007,440,2839,255945567,255946007
10094,5,12,149,5745,-74,-96,22,22:ec:75:a8:8a:31,255949352,516,2829,255948836,255949352
10095,5,24,149,5745,-88,-96,8,,255950181,32,797,255950149,255950181
10096,5,12,149,5745,-68,-96,28,fa:44:8d:e1:c7:1b,255950859,440,238,255950419,255950859
10097,5,12,149,5745,-57,-96,39,3e:d1:9b:c7:a4:de,255954771,544,3368,255954227,255954771
10098,5,12,149,5745,-62,-96,34,f2:da:61:dd:98:c5,255955369,268,330,255955101,255955369
10099,5,12,149,5745,-45,-96,51,0e:ae:b4:1e:a1:11,255958303,240,2694,255958063,255958303
10100,5,12,149,5745,-71,-96,25,f6:0a:5c:59:72:df,255958725,448,-26,255958277,255958725
10101,5,12,149,5745,-69,-96,27,fa:44:8d:e1:c7:1b,255968103,244,9134,255967859,255968103
10102,5,12,149,5745,-46,-96,50,0e:ae:b4:1e:a1:11,255968732,240,389,255968492,255968732
10103,5,24,149,5745,-89,-96,7,,255973000,28,4240,255972972,255973000
10104,5,24,149,5745,-90,-96,6,,255975354,28,2326,255975326,255975354
10105,5,24,149,5745,-91,-96,5,,255975736,28,354,255975708,255975736
10106,5,24,149,5745,-90,-96,6,,255980225,28,4461,255980197,255980225
10107,5,6,149,5745,-86,-96,10,54:e4:3a:ec:fb:65,255984056,360,3471,255983696,255984056
10108,5,24,149,5745,-89,-96,7,,255990566,28,6482,255990538,255990566
10109,5,24,149,5745,-89,-96,7,,255990858,28,264,255990830,255990858
10110,5,24,149,5745,-90,-96,6,,255997798,28,6912,255997770,255997798
10111,5,24,149,5745,-89,-96,7,,255997907,32,77,255997875,255997907
10112,5,12,149,5745,-72,-96,24,22:ec:75:a8:8a:31,255999227,244,1076,255998983,255999227
10113,5,12,149,5745,-72,-96,24,3e:ef:29:c7:4b:17,256000550,440,883,256000110,256000550
10114,5,12,149,5745,-77,-96,19,72:d1:72:1d:22:a1,256002448,256,1642,256002192,256002448
10115,5,12,149,5745,-77,-96,19,72:d1:72:1d:22:a1,256004412,452,1512,256003960,256004412
10116,5,24,149,5745,-90,-96,6,,256007465,28,3025,256007437,256007465
10117,5,24,149,5745,-91,-96,5,,256007748,28,255,256007720,256007748
10118,5,12,149,5745,-69,-96,27,b6:90:18:f6:b1:d4,256009620,440,1432,256009180,256009620
10119,5,12,149,5745,-71,-96,25,fa:44:8d:e1:c7:1b,256013757,104,4033,256013653,256013757
10120,5,12,149,5745,-71,-96,25,fa:44:8d:e1:c7:1b,256013976,360,-141,256013616,256013976
10121,5,12,149,5745,-72,-96,24,22:ec:75:a8:8a:31,256014379,516,-113,256013863,256014379
10122,5,24,149,5745,-89,-96,7,,256015100,32,689,256015068,256015100
10123,5,12,149,5745,-71,-96,25,fa:44:8d:e1:c7:1b,256015220,216,-96,256015004,256015220
10124,5,12,149,5745,-71,-96,25,fa:44:8d:e1:c7:1b,256015921,440,261,256015481,256015921
10125,5,12,149,5745,-55,-96,41,3e:d1:9b:c7:a4:de,256016441,272,248,256016169,256016441
10126,5,12,149,5745,-61,-96,35,f2:da:61:dd:98:c5,256016938,268,229,256016670,256016938
10127,5,12,149,5745,-72,-96,24,a6:92:ad:b7:76:65,256017750,456,356,256017294,256017750
10128,5,12,149,5745,-72,-96,24,d2:00:04:7e:2c:ab,256018314,440,124,256017874,256018314
10129,5,12,149,5745,-78,-96,18,56:68:e2:c2:8d:d5,256019697,476,907,256019221,256019697
10130,5,12,149,5745,-55,-96,41,3e:d1:9b:c7:a4:de,256020225,544,-16,256019681,256020225
10131,5,12,149,5745,-56,-96,40,5e:29:73:5b:30:00,256020831,540,66,256020291,256020831
10132,5,12,149,5745,-49,-96,47,0e:ae:b4:1e:a1:11,256021423,240,352,256021183,256021423
10133,5,24,149,5745,-89,-96,7,,256022311,32,856,256022279,256022311
10134,5,12,149,5745,-72,-96,24,f6:0a:5c:59:72:df,256022755,448,-4,256022307,256022755
10135,5,12,149,5745,-63,-96,33,0a:b9:b7:b1:4d:fa,256024253,268,1230,256023985,256024253
10136,5,12,149,5745,-72,-96,24,f6:0a:5c:59:72:df,256031674,252,7169,256031422,256031674
10137,5,12,149,5745,-69,-96,27,b6:90:18:f6:b1:d4,256031979,244,61,256031735,256031979
10138,5,12,149,5745,-61,-96,35,f2:da:61:dd:98:c5,256033230,268,983,256032962,256033230
10139,5,24,149,5745,-90,-96,6,,256033551,28,293,256033523,256033551
10140,5,12,149,5745,-82,-96,14,9a:24:38:da:96:bb,256040116,272,6293,256039844,256040116
10141,5,12,149,5745,-56,-96,40,5e:29:73:5b:30:00,256049894,272,9506,256049622,256049894
10142,5,12,149,5745,-72,-96,24,3e:ef:29:c7:4b:17,256050288,244,150,256050044,256050288
10143,5,12,149,5745,-78,-96,18,56:68:e2:c2:8d:d5,256050651,280,83,256050371,256050651
10144,5,24,149,5745,-90,-96,6,,256051136,28,457,256051108,256051136
10145,5,24,149,5745,-89,-96,7,,256051244,32,76,256051212,256051244
10146,5,24,149,5745,-87,-96,9,,256061508,28,10236,256061480,256061508
10147,5,24,149,5745,-89,-96,7,,256061552,28,16,256061524,256061552
10148,5,24,149,5745,-88,-96,8,,256061870,28,290,256061842,256061870
10149,5,24,149,5745,-88,-96,8,,256068993,32,7091,256068961,256068993
10150,5,24,149,5745,-88,-96,8,,256073349,28,4328,256073321,256073349
10151,5,24,149,5745,-87,-96,9,,256073715,28,338,256073687,256073715
10152,5,24,149,5745,-88,-96,8,,256080340,28,6597,256080312,256080340
10153,5,24,149,5745,-87,-96,9,,256080493,32,121,256080461,256080493
10154,5,12,149,5745,-50,-96,46,0e:ae:b4:1e:a1:11,256080874,240,141,256080634,256080874
10155,5,12,149,5745,-69,-96,27,fa:44:8d:e1:c7:1b,256082824,244,1706,256082580,256082824
10156,5,12,149,5745,-70,-96,26,fa:44:8d:e1:c7:1b,256084614,440,1350,256084174,256084614
10157,5,12,149,5745,-58,-96,38,5e:29:73:5b:30:00,256085124,540,-30,256084584,256085124
10158,5,6,149,5745,-82,-96,14,54:e4:3a:ec:fb:65,256086272,360,788,256085912,256086272
10159,5,24,149,5745,-86,-96,10,,256090930,28,4630,256090902,256090930
10160,5,24,149,5745,-87,-96,9,,256091271,28,313,256091243,256091271
10161,5,12,149,5745,-50,-96,46,0e:ae:b4:1e:a1:11,256092494,240,983,256092254,256092494
10162,5,24,149,5745,-87,-96,9,,256098278,32,5752,256098246,256098278
10163,5,24,149,5745,-86,-96,10,,256103453,28,5147,256103425,256103453
10164,5,24,149,5745,-86,-96,10,,256103815,28,334,256103787,256103815
10165,5,12,149,5745,-74,-96,22,22:ec:75:a8:8a:31,256105392,244,1333,256105148,256105392
10166,5,24,149,5745,-86,-96,10,,256110270,28,4850,256110242,256110270
10167,5,24,149,5745,-85,-96,11,,256110378,32,76,256110346,256110378
10168,5,12,149,5745,-76,-96,20,72:d1:72:1d:22:a1,256116363,256,5729,256116107,256116363
10169,5,12,149,5745,-56,-96,40,3e:d1:9b:c7:a4:de,256117835,272,1200,256117563,256117835
10170,5,24,149,5745,-87,-96,9,,256121026,28,3163,256120998,256121026
10171,5,24,149,5745,-86,-96,10,,256121372,28,318,256121344,256121372
10172,5,24,149,5745,-85,-96,11,,256128158,28,6758,256128130,256128158
10173,5,24,149,5745,-85,-96,11,,256128266,32,76,256128234,256128266
10174,5,12,149,5745,-62,-96,34,5e:29:73:5b:30:00,256147883,272,19345,256147611,256147883
10175,5,12,149,5745,-62,-96,34,5e:29:73:5b:30:00,256150448,540,2025,256149908,256150448
10176,5,12,149,5745,-47,-96,49,0e:ae:b4:1e:a1:11,256151724,240,1036,256151484,256151724
10177,5,12,149,5745,-82,-96,14,9a:24:38:da:96:bb,256152468,272,472,256152196,256152468
10178,5,24,149,5745,-85,-96,11,,256170807,28,18311,256170779,256170807
10179,5,24,149,5745,-85,-96,11,,256171162,28,327,256171134,256171162
10180,5,12,149,5745,-74,-96,22,3e:ef:29:c7:4b:17,256174039,244,2633,256173795,256174039
10181,5,24,149,5745,-86,-96,10,,256178203,32,4132,256178171,256178203
10182,5,6,149,5745,-82,-96,14,54:e4:3a:ec:fb:65,256188672,360,10109,256188312,256188672
10183,5,12,149,5745,-62,-96,34,f2:da:61:dd:98:c5,256189375,268,435,256189107,256189375
10184,5,24,149,5745,-85,-96,11,,256190860,28,1457,256190832,256190860
10185,5,24,149,5745,-85,-96,11,,256191304,28,416,256191276,256191304
10186,5,12,149,5745,-46,-96,50,0e:ae:b4:1e:a1:11,256192918,240,1374,256192678,256192918
10187,5,24,149,5745,-86,-96,10,,256198830,32,5880,256198798,256198830
10188,5,12,149,5745,-69,-96,27,fa:44:8d:e1:c7:1b,256201727,244,2653,256201483,256201727
10189,5,24,149,5745,-87,-96,9,,256211762,28,10007,256211734,256211762
10190,5,24,149,5745,-86,-96,10,,256212108,28,318,256212080,256212108
10191,5,12,149,5745,-67,-96,29,b6:90:18:f6:b1:d4,256213870,244,1518,256213626,256213870
10192,5,12,149,5745,-73,-96,23,56:68:e2:c2:8d:d5,256215084,280,934,256214804,256215084
10193,5,24,149,5745,-87,-96,9,,256215644,28,532,256215616,256215644
10194,5,24,149,5745,-87,-96,9,,256215975,28,303,256215947,256215975
10195,5,24,149,5745,-87,-96,9,,256218561,28,2558,256218533,256218561
10196,5,24,149,5745,-88,-96,8,,256218669,32,76,256218637,256218669
10197,5,12,149,5745,-74,-96,22,22:ec:75:a8:8a:31,256222402,244,3489,256222158,256222402
10198,5,24,149,5745,-87,-96,9,,256222951,32,517,256222919,256222951
10199,5,24,149,5745,-88,-96,8,,256225136,28,2157,256225108,256225136
10200,5,12,149,5745,-76,-96,20,72:d1:72:1d:22:a1,256225651,256,259,256225395,256225651
10201,5,24,149,5745,-88,-96,8,,256226176,32,493,256226144,256226176
10202,5,24,149,5745,-88,-96,8,,256231142,28,4938,256231114,256231142
10203,5,24,149,5745,-87,-96,9,,256231483,28,313,256231455,256231483
10204,5,12,149,5745,-56,-96,40,3e:d1:9b:c7:a4:de,256235020,272,3265,256234748,256235020
10205,5,24,149,5745,-87,-96,9,,256237129,32,2077,256237097,256237129
10206,5,24,149,5745,-88,-96,8,,256250973,28,13816,256250945,256250973
10207,5,24,149,5745,-87,-96,9,,256251345,28,344,256251317,256251345
10208,5,24,149,5745,-86,-96,10,,256254048,28,2675,256254020,256254048
10209,5,12,149,5745,-59,-96,37,5e:29:73:5b:30:00,256254599,272,279,256254327,256254599
10210,5,24,149,5745,-86,-96,10,,256257007,32,2376,256256975,256257007
10211,5,24,149,5745,-86,-96,10,,256261375,28,4340,256261347,256261375
10212,5,24,149,5745,-86,-96,10,,256261766,28,363,256261738,256261766
10213,5,12,149,5745,-82,-96,14,9a:24:38:da:96:bb,256268033,272,5995,256267761,256268033
10214,5,12,149,5745,-70,-96,26,f6:0a:5c:59:72:df,256279209,252,10924,256278957,256279209
10215,5,24,149,5745,-87,-96,9,,256284545,28,5308,256284517,256284545
10216,5,24,149,5745,-85,-96,11,,256284954,28,381,256284926,256284954
10217,5,6,149,5745,-84,-96,12,54:e4:3a:ec:fb:65,256291073,360,5759,256290713,256291073
10218,5,24,149,5745,-86,-96,10,,256291654,28,553,256291626,256291654
10219,5,24,149,5745,-86,-96,10,,256291763,32,77,256291731,256291763
10220,5,12,149,5745,-57,-96,39,f2:da:61:dd:98:c5,256291807,268,-224,256291539,256291807
10221,5,24,149,5745,-87,-96,9,,256297879,28,6044,256297851,256297879
10222,5,24,149,5745,-88,-96,8,,256298288,28,381,256298260,256298288
10223,5,24,149,5745,-88,-96,8,,256305715,28,7399,256305687,256305715
10224,5,24,149,5745,-86,-96,10,,256305823,32,76,256305791,256305823
10225,5,12,149,5745,-72,-96,24,fa:44:8d:e1:c7:1b,256314425,244,8358,256314181,256314425
10226,5,12,149,5745,-72,-96,24,56:68:e2:c2:8d:d5,256316449,280,1744,256316169,256316449
10227,5,12,149,5745,-66,-96,30,b6:90:18:f6:b1:d4,256317560,244,867,256317316,256317560
10228,5,24,149,5745,-87,-96,9,,256319847,28,2259,256319819,256319847
10229,5,24,149,5745,-87,-96,9,,256326862,28,6987,256326834,256326862
10230,5,24,149,5745,-86,-96,10,,256326971,32,77,256326939,256326971
10231,5,12,149,5745,-73,-96,23,22:ec:75:a8:8a:31,256339491,244,12276,256339247,256339491
10232,5,24,149,5745,-88,-96,8,,256346685,28,7166,256346657,256346685
10233,5,24,149,5745,-86,-96,10,,256347076,28,363,256347048,256347076
10234,5,12,149,5745,-73,-96,23,72:d1:72:1d:22:a1,256348518,256,1186,256348262,256348518
10235,5,12,149,5745,-58,-96,38,3e:d1:9b:c7:a4:de,256351941,272,3151,256351669,256351941
10236,5,24,149,5745,-87,-96,9,,256353798,32,1825,256353766,256353798
10237,5,12,149,5745,-72,-96,24,3e:ef:29:c7:4b:17,256369276,244,15234,256369032,256369276
10238,5,12,149,5745,-71,-96,25,f6:0a:5c:59:72:df,256375872,252,6344,256375620,256375872
10239,5,12,149,5745,-79,-96,17,9a:24:38:da:96:bb,256376143,272,-1,256375871,256376143
10240,5,12,149,5745,-67,-96,29,b6:90:18:f6:b1:d4,256377668,244,1281,256377424,256377668
10241,5,12,149,5745,-57,-96,39,f2:da:61:dd:98:c5,256379680,268,1744,256379412,256379680
10242,5,24,149,5745,-86,-96,10,,256392050,28,12342,256392022,256392050
10243,5,12,149,5745,-59,-96,37,5e:29:73:5b:30:00,256393906,272,1584,256393634,256393906
10244,5,12,149,5745,-73,-96,23,3e:ef:29:c7:4b:17,256394620,440,274,256394180,256394620
10245,5,24,149,5745,-88,-96,8,,256399147,28,4499,256399119,256399147
10246,5,24,149,5745,-87,-96,9,,256399255,32,76,256399223,256399255
10247,5,12,149,5745,-70,-96,26,f6:0a:5c:59:72:df,256404020,448,4317,256403572,256404020
10248,5,12,149,5745,-71,-96,25,56:68:e2:c2:8d:d5,256405231,476,735,256404755,256405231
10249,5,12,149,5745,-69,-96,27,22:ec:75:a8:8a:31,256409206,516,3459,256408690,256409206
10250,5,12,149,5745,-73,-96,23,fa:44:8d:e1:c7:1b,256411224,440,1578,256410784,256411224
10251,5,12,149,5745,-59,-96,37,5e:29:73:5b:30:00,256414182,540,2418,256413642,256414182
10252,5,12,149,5745,-40,-96,56,0e:ae:b4:1e:a1:11,256414845,240,423,256414605,256414845
10253,5,12,149,5745,-61,-96,35,3e:d1:9b:c7:a4:de,256415777,544,388,256415233,256415777
10254,5,12,149,5745,-40,-96,56,0e:ae:b4:1e:a1:11,256416840,240,823,256416600,256416840
10255,5,12,149,5745,-73,-96,23,72:d1:72:1d:22:a1,256420419,452,3127,256419967,256420419
10256,5,12,149,5745,-73,-96,23,fa:44:8d:e1:c7:1b,256426855,244,6192,256426611,256426855
10257,5,24,149,5745,-87,-96,9,,256434145,28,7262,256434117,256434145
10258,5,24,149,5745,-88,-96,8,,256441371,32,7194,256441339,256441371
10259,5,12,149,5745,-73,-96,23,72:d1:72:1d:22:a1,256445681,256,4054,256445425,256445681
10260,5,12,149,5745,-69,-96,27,22:ec:75:a8:8a:31,256452466,244,6541,256452222,256452466
10261,5,24,149,5745,-88,-96,8,,256460993,28,8499,256460965,256460993
10262,5,24,149,5745,-89,-96,7,,256461101,32,76,256461069,256461101
10263,5,12,149,5745,-61,-96,35,3e:d1:9b:c7:a4:de,256467692,272,6319,256467420,256467692
10264,5,24,149,5745,-89,-96,7,,256471763,28,4043,256471735,256471763
10265,5,12,149,5745,-71,-96,25,fa:44:8d:e1:c7:1b,256475077,440,2874,256474637,256475077
10266,5,12,149,5745,-56,-96,40,5e:29:73:5b:30:00,256478719,540,3102,256478179,256478719
10267,5,12,149,5745,-41,-96,55,0e:ae:b4:1e:a1:11,256479698,240,739,256479458,256479698
10268,5,24,149,5745,-89,-96,7,,256486202,28,6476,256486174,256486202
10269,5,24,149,5745,-88,-96,8,,256486539,28,309,256486511,256486539
10270,5,12,149,5745,-56,-96,40,5e:29:73:5b:30:00,256492027,272,5216,256491755,256492027
10271,5,24,149,5745,-88,-96,8,,256493640,32,1581,256493608,256493640
10272,5,6,149,5745,-86,-96,10,54:e4:3a:ec:fb:65,256495874,360,1874,256495514,256495874
10273,5,12,149,5745,-72,-96,24,56:68:e2:c2:8d:d5,256505597,280,9443,256505317,256505597
10274,5,12,149,5745,-82,-96,14,9a:24:38:da:96:bb,256510248,272,4379,256509976,256510248
10275,5,12,149,5745,-70,-96,26,3e:ef:29:c7:4b:17,256511764,244,1272,256511520,256511764
10276,5,12,149,5745,-70,-96,26,fa:44:8d:e1:c7:1b,256525165,244,13157,256524921,256525165
10277,5,12,149,5745,-70,-96,26,3e:ef:29:c7:4b:17,256526993,440,1388,256526553,256526993
10278,5,12,149,5745,-41,-96,55,0e:ae:b4:1e:a1:11,256529642,240,2409,256529402,256529642
10279,5,24,149,5745,-86,-96,10,,256530612,28,942,256530584,256530612
10280,5,24,149,5745,-87,-96,9,,256530964,28,324,256530936,256530964
10281,5,12,149,5745,-66,-96,30,b6:90:18:f6:b1:d4,256533756,440,2352,256533316,256533756
10282,5,24,149,5745,-86,-96,10,,256538019,32,4231,256537987,256538019
10283,5,12,149,5745,-85,-96,11,9a:24:38:da:96:bb,256539237,824,394,256538413,256539237
10284,5,12,149,5745,-70,-96,26,fa:44:8d:e1:c7:1b,256540602,440,925,256540162,256540602
10285,5,12,149,5745,-71,-96,25,a6:92:ad:b7:76:65,256541112,456,54,256540656,256541112
10286,5,12,149,5745,-70,-96,26,22:ec:75:a8:8a:31,256541620,516,-8,256541104,256541620
10287,5,12,149,5745,-56,-96,40,5e:29:73:5b:30:00,256544246,540,2086,256543706,256544246
10288,5,12,149,5745,-61,-96,35,f2:da:61:dd:98:c5,256544867,268,353,256544599,256544867
10289,5,12,149,5745,-43,-96,53,0e:ae:b4:1e:a1:11,256545617,240,510,256545377,256545617
10290,5,12,149,5745,-57,-96,39,3e:d1:9b:c7:a4:de,256545918,544,-243,256545374,256545918
10291,5,24,149,5745,-87,-96,9,,256547007,28,1061,256546979,256547007
10292,5,24,149,5745,-87,-96,9,,256547349,28,314,256547321,256547349
10293,5,12,149,5745,-62,-96,34,0a:b9:b7:b1:4d:fa,256547702,268,85,256547434,256547702
10294,5,24,149,5745,-86,-96,10,,256553360,28,5630,256553332,256553360
10295,5,24,149,5745,-87,-96,9,,256553469,32,77,256553437,256553469
10296,5,24,149,5745,-87,-96,9,,256564453,28,10956,256564425,256564453
10297,5,24,149,5745,-87,-96,9,,256564832,28,351,256564804,256564832
10298,5,12,149,5745,-72,-96,24,22:ec:75:a8:8a:31,256573557,244,8481,256573313,256573557
10299,5,12,149,5745,-57,-96,39,3e:d1:9b:c7:a4:de,256581465,272,7636,256581193,256581465
10300,5,24,149,5745,-87,-96,9,,256586863,28,5370,256586835,256586863
10301,5,24,149,5745,-87,-96,9,,256587202,28,311,256587174,256587202
10302,5,24,149,5745,-88,-96,8,,256594401,32,7167,256594369,256594401
10303,5,6,149,5745,-85,-96,11,54:e4:3a:ec:fb:65,256598274,360,3513,256597914,256598274
10304,5,12,149,5745,-81,-96,15,9a:24:38:da:96:bb,256600895,272,2349,256600623,256600895
10305,5,12,149,5745,-60,-96,36,5e:29:73:5b:30:00,256606681,272,5514,256606409,256606681
10306,5,12,149,5745,-73,-96,23,fa:44:8d:e1:c7:1b,256607086,440,-35,256606646,256607086
10307,5,12,149,5745,-60,-96,36,5e:29:73:5b:30:00,256609706,540,2080,256609166,256609706
10308,5,12,149,5745,-43,-96,53,0e:ae:b4:1e:a1:11,256612322,240,2376,256612082,256612322
10309,5,12,149,5745,-71,-96,25,56:68:e2:c2:8d:d5,256618617,280,6015,256618337,256618617
10310,5,12,149,5745,-73,-96,23,72:d1:72:1d:22:a1,256622913,256,4040,256622657,256622913
10311,5,24,149,5745,-88,-96,8,,256623640,28,699,256623612,256623640
10312,5,24,149,5745,-88,-96,8,,256623941,28,273,256623913,256623941
10313,5,24,149,5745,-89,-96,7,,256630723,28,6754,256630695,256630723
10314,5,24,149,5745,-87,-96,9,,256630832,32,77,256630800,256630832
10315,5,12,149,5745,-70,-96,26,3e:ef:29:c7:4b:17,256632043,244,967,256631799,256632043
10316,5,24,149,5745,-89,-96,7,,256639331,28,7260,256639303,256639331
10317,5,24,149,5745,-89,-96,7,,256639749,28,390,256639721,256639749
10318,5,12,149,5745,-72,-96,24,fa:44:8d:e1:c7:1b,256640350,244,357,256640106,256640350
10319,5,12,149,5745,-43,-96,53,0e:ae:b4:1e:a1:11,256640987,240,397,256640747,256640987
10320,5,24,149,5745,-88,-96,8,,256646547,28,5532,256646519,256646547
10321,5,24,149,5745,-89,-96,7,,256655839,28,9264,256655811,256655839
10322,5,24,149,5745,-88,-96,8,,256656258,28,391,256656230,256656258
10323,5,24,149,5745,-89,-96,7,,256663178,32,6888,256663146,256663178
10324,5,24,149,5745,-89,-96,7,,256664954,28,1748,256664926,256664954
10325,5,24,149,5745,-88,-96,8,,256672073,28,7091,256672045,256672073
10326,5,24,149,5745,-88,-96,8,,256672182,32,77,256672150,256672182
10327,5,12,149,5745,-60,-96,36,5e:29:73:5b:30:00,256674902,540,2180,256674362,256674902
10328,5,12,149,5745,-41,-96,55,0e:ae:b4:1e:a1:11,256676220,240,1078,256675980,256676220
10329,5,24,149,5745,-89,-96,7,,256676597,28,349,256676569,256676597
10330,5,12,149,5745,-74,-96,22,22:ec:75:a8:8a:31,256681438,244,4597,256681194,256681438
10331,5,24,149,5745,-88,-96,8,,256685887,28,4421,256685859,256685887
10332,5,12,149,5745,-60,-96,36,3e:d1:9b:c7:a4:de,256697456,272,11297,256697184,256697456
10333,5,6,149,5745,-83,-96,13,54:e4:3a:ec:fb:65,256700675,360,2859,256700315,256700675
10334,5,12,149,5745,-59,-96,37,5e:29:73:5b:30:00,256708226,272,7279,256707954,256708226
10335,5,12,149,5745,-79,-96,17,9a:24:38:da:96:bb,256716655,272,8157,256716383,256716655
10336,5,12,149,5745,-74,-96,22,72:d1:72:1d:22:a1,256725672,256,8761,256725416,256725672
10337,5,12,149,5745,-71,-96,25,56:68:e2:c2:8d:d5,256729009,280,3057,256728729,256729009
10338,5,12,149,5745,-40,-96,56,0e:ae:b4:1e:a1:11,256742038,240,12789,256741798,256742038
10339,5,12,149,5745,-69,-96,27,f6:0a:5c:59:72:df,256747473,252,5183,256747221,256747473
10340,5,24,149,5745,-90,-96,6,,256751645,28,4144,256751617,256751645
10341,5,24,149,5745,-89,-96,7,,256751974,28,301,256751946,256751974
10342,5,24,149,5745,-89,-96,7,,256752358,28,356,256752330,256752358
10343,5,12,149,5745,-43,-96,53,0e:ae:b4:1e:a1:11,256753534,240,936,256753294,256753534
10344,5,24,149,5745,-89,-96,7,,256758598,28,5036,256758570,256758598
10345,5,24,149,5745,-89,-96,7,,256759164,28,538,256759136,256759164
10346,5,24,149,5745,-88,-96,8,,256765127,32,5931,256765095,256765127
10347,5,12,149,5745,-70,-96,26,3e:ef:29:c7:4b:17,256779355,244,13984,256779111,256779355
10348,5,24,149,5745,-88,-96,8,,256779754,28,371,256779726,256779754
10349,5,24,149,5745,-90,-96,6,,256780129,28,347,256780101,256780129
10350,5,24,149,5745,-88,-96,8,,256786633,32,6472,256786601,256786633
10351,5,12,149,5745,-73,-96,23,22:ec:75:a8:8a:31,256799225,244,12348,256798981,256799225
10352,5,6,149,5745,-85,-96,11,54:e4:3a:ec:fb:65,256803075,360,3490,256802715,256803075
10353,5,12,149,5745,-59,-96,37,3e:d1:9b:c7:a4:de,256811712,272,8365,256811440,256811712
10354,5,12,149,5745,-63,-96,33,5e:29:73:5b:30:00,256820460,272,8476,256820188,256820460
10355,5,12,149,5745,-79,-96,17,9a:24:38:da:96:bb,256824343,272,3611,256824071,256824343
10356,5,12,149,5745,-73,-96,23,fa:44:8d:e1:c7:1b,256827208,244,2621,256826964,256827208
10357,5,12,149,5745,-74,-96,22,72:d1:72:1d:22:a1,256827707,256,243,256827451,256827707
10358,5,12,149,5745,-71,-96,25,56:68:e2:c2:8d:d5,256842032,280,14045,256841752,256842032
10359,5,24,149,5745,-87,-96,9,,256844711,28,2651,256844683,256844711
10360,5,24,149,5745,-87,-96,9,,256845069,28,330,256845041,256845069
10361,5,24,149,5745,-87,-96,9,,256846200,28,1103,256846172,256846200
10362,5,24,149,5745,-86,-96,10,,256846529,28,301,256846501,256846529
10363,5,24,149,5745,-87,-96,9,,256846861,28,304,256846833,256846861
10364,5,24,149,5745,-87,-96,9,,256847192,28,303,256847164,256847192
10365,5,24,149,5745,-87,-96,9,,256847508,28,288,256847480,256847508
10366,5,24,149,5745,-86,-96,10,,256847829,28,293,256847801,256847829
10367,5,24,149,5745,-87,-96,9,,256850882,28,3025,256850854,256850882
10368,5,24,149,5745,-87,-96,9,,256850990,32,76,256850958,256850990
10369,5,24,149,5745,-87,-96,9,,256856068,32,5046,256856036,256856068
10370,5,24,149,5745,-86,-96,10,,256859384,28,3288,256859356,256859384
10371,5,24,149,5745,-86,-96,10,,256859758,28,346,256859730,256859758
10372,5,24,149,5745,-86,-96,10,,256865713,28,5927,256865685,256865713
10373,5,24,149,5745,-86,-96,10,,256865822,32,77,256865790,256865822
10374,5,24,149,5745,-86,-96,10,,256876901,28,11051,256876873,256876901
10375,5,24,149,5745,-86,-96,10,,256877250,28,321,256877222,256877250
10376,5,12,149,5745,-70,-96,26,3e:ef:29:c7:4b:17,256880626,244,3132,256880382,256880626
10377,5,24,149,5745,-87,-96,9,,256884065,28,3411,256884037,256884065
10378,5,24,149,5745,-87,-96,9,,256884174,32,77,256884142,256884174
10379,5,24,149,5745,-86,-96,10,,256890790,32,6584,256890758,256890790
10380,5,24,149,5745,-87,-96,9,,256901515,28,10697,256901487,256901515
10381,5,6,149,5745,-86,-96,10,54:e4:3a:ec:fb:65,256905476,360,3601,256905116,256905476
10382,5,24,149,5745,-86,-96,10,,256910811,28,5307,256910783,256910811
10383,5,12,149,5745,-72,-96,24,22:ec:75:a8:8a:31,256911076,244,21,256910832,256911076
10384,5,24,149,5745,-87,-96,9,,256911480,28,376,256911452,256911480
10385,5,24,149,5745,-86,-96,10,,256918893,32,7381,256918861,256918893
10386,5,12,149,5745,-59,-96,37,3e:d1:9b:c7:a4:de,256924549,272,5384,256924277,256924549
10387,5,12,149,5745,-73,-96,23,fa:44:8d:e1:c7:1b,256930121,244,5328,256929877,256930121
10388,5,12,149,5745,-75,-96,21,72:d1:72:1d:22:a1,256930625,256,248,256930369,256930625
10389,5,24,149,5745,-87,-96,9,,256931068,28,415,256931040,256931068
10390,5,24,149,5745,-86,-96,10,,256931409,28,313,256931381,256931409
10391,5,24,149,5745,-87,-96,9,,256931763,28,326,256931735,256931763
10392,5,12,149,5745,-60,-96,36,5e:29:73:5b:30:00,256933482,272,1447,256933210,256933482
10393,5,24,149,5745,-86,-96,10,,256938382,28,4872,256938354,256938382
10394,5,24,149,5745,-87,-96,9,,256938490,32,76,256938458,256938490
10395,5,24,149,5745,-87,-96,9,,256952094,28,13576,256952066,256952094
10396,5,24,149,5745,-86,-96,10,,256952377,28,255,256952349,256952377
10397,5,24,149,5745,-87,-96,9,,256958649,28,6244,256958621,256958649
10398,5,24,149,5745,-86,-96,10,,256959058,32,377,256959026,256959058
10399,5,24,149,5745,-86,-96,10,,256959223,28,137,256959195,256959223
10400,5,12,149,5745,-70,-96,26,56:68:e2:c2:8d:d5,256962689,280,3186,256962409,256962689
10401,5,24,149,5745,-88,-96,8,,256964947,32,2226,256964915,256964947
10402,5,12,149,5745,-70,-96,26,3e:ef:29:c7:4b:17,256969047,244,3856,256968803,256969047
10403,5,12,149,5745,-45,-96,51,0e:ae:b4:1e:a1:11,256977172,240,7885,256976932,256977172
10404,5,12,149,5745,-73,-96,23,fa:44:8d:e1:c7:1b,256984076,244,6660,256983832,256984076
10405,5,12,149,5745,-70,-96,26,3e:ef:29:c7:4b:17,256984994,440,478,256984554,256984994
10406,5,12,149,5745,-70,-96,26,56:68:e2:c2:8d:d5,256991013,476,5543,256990537,256991013
10407,5,12,149,5745,-69,-96,27,f6:0a:5c:59:72:df,256994490,448,3029,256994042,256994490
10408,5,12,149,5745,-73,-96,23,22:ec:75:a8:8a:31,256997987,516,2981,256997471,256997987
10409,5,12,149,5745,-73,-96,23,fa:44:8d:e1:c7:1b,257000941,440,2514,257000501,257000941
10410,5,12,149,5745,-59,-96,37,3e:d1:9b:c7:a4:de,257003413,544,1928,257002869,257003413
10411,5,12,149,5745,-45,-96,51,0e:ae:b4:1e:a1:11,257006097,240,2444,257005857,257006097
10412,5,12,149,5745,-58,-96,38,5e:29:73:5b:30:00,257006407,540,-230,257005867,257006407
10413,5,6,149,5745,-85,-96,11,54:e4:3a:ec:fb:65,257007876,360,1109,257007516,257007876
10414,5,12,149,5745,-75,-96,21,72:d1:72:1d:22:a1,257010820,452,2492,257010368,257010820
10415,5,12,149,5745,-75,-96,21,72:d1:72:1d:22:a1,257018200,256,7124,257017944,257018200
10416,5,12,149,5745,-73,-96,23,22:ec:75:a8:8a:31,257031712,244,13268,257031468,257031712
10417,5,12,149,5745,-59,-96,37,3e:d1:9b:c7:a4:de,257048289,272,16305,257048017,257048289
10418,5,12,149,5745,-71,-96,25,3e:ef:29:c7:4b:17,257049883,440,1154,257049443,257049883
10419,5,12,149,5745,-68,-96,28,f6:0a:5c:59:72:df,257055829,252,5694,257055577,257055829
10420,5,12,149,5745,-70,-96,26,56:68:e2:c2:8d:d5,257056529,476,224,257056053,257056529
10421,5,12,149,5745,-70,-96,26,f6:0a:5c:59:72:df,257059260,448,2283,257058812,257059260
10422,5,12,149,5745,-64,-96,32,b6:90:18:f6:b1:d4,257060886,440,1186,257060446,257060886
10423,5,12,149,5745,-72,-96,24,fa:44:8d:e1:c7:1b,257063910,360,2664,257063550,257063910
10424,5,12,149,5745,-72,-96,24,fa:44:8d:e1:c7:1b,257064313,216,187,257064097,257064313
10425,5,24,149,5745,-87,-96,9,,257064626,28,285,257064598,257064626
10426,5,12,149,5745,-69,-96,27,a6:92:ad:b7:76:65,257065142,456,60,257064686,257065142
10427,5,12,149,5745,-70,-96,26,56:68:e2:c2:8d:d5,257065641,280,219,257065361,257065641
10428,5,12,149,5745,-58,-96,38,5e:29:73:5b:30:00,257065973,272,60,257065701,257065973
10429,5,12,149,5745,-72,-96,24,fa:44:8d:e1:c7:1b,257066306,440,-107,257065866,257066306
10430,5,12,149,5745,-63,-96,33,f2:da:61:dd:98:c5,257068454,268,1880,257068186,257068454
10431,5,12,149,5745,-59,-96,37,3e:d1:9b:c7:a4:de,257068757,544,-241,257068213,257068757
10432,5,12,149,5745,-46,-96,50,0e:ae:b4:1e:a1:11,257069379,240,382,257069139,257069379
10433,5,12,149,5745,-59,-96,37,5e:29:73:5b:30:00,257071526,540,1607,257070986,257071526
10434,5,24,149,5745,-88,-96,8,,257072188,28,634,257072160,257072188
10435,5,24,149,5745,-86,-96,10,,257072297,32,77,257072265,257072297
10436,5,12,149,5745,-58,-96,38,0a:b9:b7:b1:4d:fa,257072849,268,284,257072581,257072849
10437,5,12,149,5745,-73,-96,23,72:d1:72:1d:22:a1,257074050,452,749,257073598,257074050
10438,5,24,149,5745,-87,-96,9,,257079655,28,5577,257079627,257079655
10439,5,24,149,5745,-87,-96,9,,257080027,28,344,257079999,257080027
10440,5,24,149,5745,-87,-96,9,,257080465,28,410,257080437,257080465
10441,5,12,149,5745,-71,-96,25,3e:ef:29:c7:4b:17,257081934,244,1225,257081690,257081934
10442,5,24,149,5745,-87,-96,9,,257086746,32,4780,257086714,257086746
10443,5,12,149,5745,-47,-96,49,0e:ae:b4:1e:a1:11,257089706,240,2720,257089466,257089706
10444,5,24,149,5745,-87,-96,9,,257094155,28,4421,257094127,257094155
10445,5,24,149,5745,-88,-96,8,,257094510,28,327,257094482,257094510
10446,5,12,149,5745,-73,-96,23,fa:44:8d:e1:c7:1b,257098881,244,4127,257098637,257098881
10447,5,24,149,5745,-87,-96,9,,257101413,32,2500,257101381,257101413
10448,5,24,149,5745,-86,-96,10,,257105760,32,4315,257105728,257105760
10449,5,6,149,5745,-83,-96,13,54:e4:3a:ec:fb:65,257110277,360,4157,257109917,257110277
10450,5,24,149,5745,-88,-96,8,,257114292,28,3987,257114264,257114292
10451,5,24,149,5745,-88,-96,8,,257114640,28,320,257114612,257114640
10452,5,24,149,5745,-87,-96,9,,257116389,28,1721,257116361,257116389
10453,5,24,149,5745,-88,-96,8,,257123471,28,7054,257123443,257123471
10454,5,24,149,5745,-87,-96,9,,257123584,32,81,257123552,257123584
10455,5,12,149,5745,-73,-96,23,fa:44:8d:e1:c7:1b,257130391,440,6367,257129951,257130391
10456,5,12,149,5745,-74,-96,22,72:d1:72:1d:22:a1,257134079,256,3432,257133823,257134079
10457,5,12,149,5745,-46,-96,50,0e:ae:b4:1e:a1:11,257135701,240,1382,257135461,257135701
10458,5,12,149,5745,-74,-96,22,22:ec:75:a8:8a:31,257140745,244,4800,257140501,257140745
10459,5,24,149,5745,-87,-96,9,,257146183,28,5410,257146155,257146183
10460,5,24,149,5745,-87,-96,9,,257146601,28,390,257146573,257146601
10461,5,24,149,5745,-87,-96,9,,257150980,28,4351,257150952,257150980
10462,5,24,149,5745,-88,-96,8,,257151308,28,300,257151280,257151308
10463,5,24,149,5745,-87,-96,9,,257152816,28,1480,257152788,257152816
10464,5,24,149,5745,-87,-96,9,,257152925,32,77,257152893,257152925
10465,5,12,149,5745,-60,-96,36,3e:d1:9b:c7:a4:de,257154220,272,1023,257153948,257154220
10466,5,24,149,5745,-87,-96,9,,257157958,32,3706,257157926,257157958
10467,5,12,149,5745,-80,-96,16,9a:24:38:da:96:bb,257160758,272,2528,257160486,257160758
10468,5,12,149,5745,-59,-96,37,5e:29:73:5b:30:00,257161047,272,17,257160775,257161047
10469,5,24,149,5745,-88,-96,8,,257167154,28,6079,257167126,257167154
10470,5,24,149,5745,-88,-96,8,,257167500,28,318,257167472,257167500
10471,5,24,149,5745,-87,-96,9,,257173871,28,6343,257173843,257173871
10472,5,24,149,5745,-87,-96,9,,257173979,32,76,257173947,257173979
10473,5,12,149,5745,-71,-96,25,3e:ef:29:c7:4b:17,257200398,244,26175,257200154,257200398
10474,5,12,149,5745,-45,-96,51,0e:ae:b4:1e:a1:11,257201495,240,857,257201255,257201495
10475,5,12,149,5745,-47,-96,49,0e:ae:b4:1e:a1:11,257201851,240,116,257201611,257201851
10476,5,24,149,5745,-88,-96,8,,257202413,28,534,257202385,257202413
10477,5,24,149,5745,-87,-96,9,,257202805,28,364,257202777,257202805
10478,5,24,149,5745,-87,-96,9,,257203103,28,270,257203075,257203103
10479,5,24,149,5745,-88,-96,8,,257203512,28,381,257203484,257203512
10480,5,12,149,5745,-66,-96,30,f6:0a:5c:59:72:df,257208785,252,5021,257208533,257208785
10481,5,24,149,5745,-88,-96,8,,257209724,32,907,257209692,257209724
10482,5,6,149,5745,-83,-96,13,54:e4:3a:ec:fb:65,257212677,360,2593,257212317,257212677
10483,5,12,149,5745,-45,-96,51,0e:ae:b4:1e:a1:11,257213603,240,686,257213363,257213603
10484,5,12,149,5745,-74,-96,22,fa:44:8d:e1:c7:1b,257217565,244,3718,257217321,257217565
10485,5,12,149,5745,-68,-96,28,56:68:e2:c2:8d:d5,257238365,280,20520,257238085,257238365
10486,5,12,149,5745,-75,-96,21,72:d1:72:1d:22:a1,257246569,256,7948,257246313,257246569
10487,5,24,149,5745,-88,-96,8,,257256519,28,9922,257256491,257256519
10488,5,24,149,5745,-88,-96,8,,257256828,28,281,257256800,257256828
10489,5,24,149,5745,-87,-96,9,,257257171,28,315,257257143,257257171
10490,5,24,149,5745,-88,-96,8,,257257490,28,291,257257462,257257490
10491,5,24,149,5745,-87,-96,9,,257257793,28,275,257257765,257257793
10492,5,12,149,5745,-72,-96,24,22:ec:75:a8:8a:31,257258040,244,3,257257796,257258040
10493,5,24,149,5745,-87,-96,9,,257258444,28,376,257258416,257258444
10494,5,24,149,5745,-87,-96,9,,257264662,32,6186,257264630,257264662
10495,5,12,149,5745,-45,-96,51,0e:ae:b4:1e:a1:11,257266039,240,1137,257265799,257266039
10496,5,12,149,5745,-60,-96,36,3e:d1:9b:c7:a4:de,257271180,272,4869,257270908,257271180
10497,5,24,149,5745,-88,-96,8,,257274372,28,3164,257274344,257274372
10498,5,24,149,5745,-88,-96,8,,257281286,32,6882,257281254,257281286
10499,5,24,149,5745,-87,-96,9,,257292056,28,10742,257292028,257292056
10500,5,24,149,5745,-88,-96,8,,257299517,32,7429,257299485,257299517
10501,5,24,149,5745,-87,-96,9,,257310386,28,10841,257310358,257310386
10502,5,24,149,5745,-87,-96,9,,257310696,28,282,257310668,257310696
10503,5,12,149,5745,-73,-96,23,d2:00:04:7e:2c:ab,257310992,412,-116,257310580,257310992
10504,5,6,149,5745,-83,-96,13,54:e4:3a:ec:fb:65,257315078,360,3726,257314718,257315078
10505,5,24,149,5745,-87,-96,9,,257317680,32,2570,257317648,257317680
10506,5,24,149,5745,-88,-96,8,,257319872,32,2160,257319840,257319872
10507,5,12,149,5745,-45,-96,51,0e:ae:b4:1e:a1:11,257327828,240,7716,257327588,257327828
10508,5,24,149,5745,-89,-96,7,,257330566,28,2710,257330538,257330566
10509,5,24,149,5745,-89,-96,7,,257333353,28,2759,257333325,257333353
10510,5,24,149,5745,-88,-96,8,,257333707,28,326,257333679,257333707
10511,5,12,149,5745,-74,-96,22,fa:44:8d:e1:c7:1b,257339097,244,5146,257338853,257339097
10512,5,24,149,5745,-88,-96,8,,257340650,28,1525,257340622,257340650
10513,5,24,149,5745,-88,-96,8,,257340759,32,77,257340727,257340759
10514,5,12,149,5745,-68,-96,28,56:68:e2:c2:8d:d5,257340870,280,-169,257340590,257340870
10515,5,24,149,5745,-88,-96,8,,257349600,28,8702,257349572,257349600
10516,5,12,149,5745,-75,-96,21,72:d1:72:1d:22:a1,257355692,256,5836,257355436,257355692
10517,5,24,149,5745,-89,-96,7,,257356171,32,447,257356139,257356171
10518,5,24,149,5745,-89,-96,7,,257369892,28,13693,257369864,257369892
10519,5,24,149,5745,-88,-96,8,,257370274,28,354,257370246,257370274
10520,5,12,149,5745,-71,-96,25,22:ec:75:a8:8a:31,257374693,244,4175,257374449,257374693
10521,5,24,149,5745,-88,-96,8,,257377212,32,2487,257377180,257377212
10522,5,24,149,5745,-89,-96,7,,257378839,28,1599,257378811,257378839
10523,5,24,149,5745,-88,-96,8,,257379196,28,329,257379168,257379196
10524,5,12,149,5745,-57,-96,39,3e:d1:9b:c7:a4:de,257383342,272,3874,257383070,257383342
10525,5,24,149,5745,-88,-96,8,,257385996,32,2622,257385964,257385996
10526,5,12,149,5745,-60,-96,36,5e:29:73:5b:30:00,257391890,272,5622,257391618,257391890
10527,5,24,149,5745,-88,-96,8,,257399593,28,7675,257399565,257399593
10528,5,12,149,5745,-80,-96,16,9a:24:38:da:96:bb,257401226,272,1361,257400954,257401226
10529,5,12,149,5745,-69,-96,27,56:68:e2:c2:8d:d5,257404156,280,2650,257403876,257404156
10530,5,24,149,5745,-89,-96,7,,257406967,32,2779,257406935,257406967
10531,5,24,149,5745,-89,-96,7,,257413318,28,6323,257413290,257413318
10532,5,24,149,5745,-88,-96,8,,257413704,28,358,257413676,257413704
10533,5,6,149,5745,-86,-96,10,54:e4:3a:ec:fb:65,257417478,360,3414,257417118,257417478
10534,5,24,149,5745,-90,-96,6,,257420445,32,2935,257420413,257420445
10535,5,12,149,5745,-46,-96,50,0e:ae:b4:1e:a1:11,257427651,240,6966,257427411,257427651
10536,5,12,149,5745,-72,-96,24,3e:ef:29:c7:4b:17,257429224,244,1329,257428980,257429224
10537,5,24,149,5745,-89,-96,7,,257436912,28,7660,257436884,257436912
10538,5,12,149,5745,-74,-96,22,fa:44:8d:e1:c7:1b,257442561,244,5405,257442317,257442561
10539,5,24,149,5745,-89,-96,7,,257443824,28,1235,257443796,257443824
10540,5,24,149,5745,-89,-96,7,,257443932,32,76,257443900,257443932
10541,5,12,149,5745,-72,-96,24,3e:ef:29:c7:4b:17,257445600,440,1228,257445160,257445600
10542,5,12,149,5745,-69,-96,27,56:68:e2:c2:8d:d5,257450341,476,4265,257449865,257450341
10543,5,12,149,5745,-70,-96,26,f6:0a:5c:59:72:df,257451739,448,950,257451291,257451739
10544,5,24,149,5745,-87,-96,9,,257453910,28,2143,257453882,257453910
10545,5,24,149,5745,-88,-96,8,,257454273,28,335,257454245,257454273
10546,5,12,149,5745,-84,-96,12,9a:24:38:da:96:bb,257457268,824,2171,257456444,257457268
10547,5,12,149,5745,-68,-96,28,a6:92:ad:b7:76:65,257458920,456,1196,257458464,257458920
10548,5,12,149,5745,-72,-96,24,22:ec:75:a8:8a:31,257459437,516,1,257458921,257459437
10549,5,12,149,5745,-73,-96,23,fa:44:8d:e1:c7:1b,257459989,440,112,257459549,257459989
10550,5,24,149,5745,-89,-96,7,,257460640,32,619,257460608,257460640
10551,5,12,149,5745,-74,-96,22,72:d1:72:1d:22:a1,257461111,256,215,257460855,257461111
10552,5,12,149,5745,-56,-96,40,3e:d1:9b:c7:a4:de,257463667,544,2012,257463123,257463667
10553,5,12,149,5745,-47,-96,49,0e:ae:b4:1e:a1:11,257464245,240,338,257464005,257464245
10554,5,12,149,5745,-61,-96,35,5e:29:73:5b:30:00,257466562,540,1777,257466022,257466562
10555,5,24,149,5745,-91,-96,5,,257467253,28,663,257467225,257467253
10556,5,24,149,5745,-89,-96,7,,257467614,28,333,257467586,257467614
10557,5,12,149,5745,-74,-96,22,72:d1:72:1d:22:a1,257468988,452,922,257468536,257468988
10558,5,24,149,5745,-88,-96,8,,257474114,32,5094,257474082,257474114
10559,5,24,149,5745,-88,-96,8,,257483422,28,9280,257483394,257483422
10560,5,24,149,5745,-90,-96,6,,257490300,28,6850,257490272,257490300
10561,5,12,149,5745,-73,-96,23,22:ec:75:a8:8a:31,257490997,244,453,257490753,257490997
10562,5,12,149,5745,-56,-96,40,3e:d1:9b:c7:a4:de,257496641,272,5372,257496369,257496641
10563,5,12,149,5745,-86,-96,10,9a:24:38:da:96:bb,257497220,272,307,257496948,257497220
10564,5,24,149,5745,-90,-96,6,,257501633,28,4385,257501605,257501633
10565,5,24,149,5745,-89,-96,7,,257501997,28,336,257501969,257501997
10566,5,12,149,5745,-62,-96,34,5e:29:73:5b:30:00,257504439,272,2170,257504167,257504439
10567,5,24,149,5745,-91,-96,5,,257508912,32,4441,257508880,257508912
10568,5,12,149,5745,-68,-96,28,a6:92:ad:b7:76:65,257516970,456,7602,257516514,257516970
10569,5,6,149,5745,-89,-96,7,54:e4:3a:ec:fb:65,257519879,360,2549,257519519,257519879
10570,5,12,149,5745,-70,-96,26,56:68:e2:c2:8d:d5,257521826,280,1667,257521546,257521826
10571,5,12,149,5745,-69,-96,27,fa:44:8d:e1:c7:1b,257524563,440,2297,257524123,257524563
10572,5,12,149,5745,-69,-96,27,f6:0a:5c:59:72:df,257527985,252,3170,257527733,257527985
10573,5,12,149,5745,-64,-96,32,b6:90:18:f6:b1:d4,257528272,440,-153,257527832,257528272
10574,5,12,149,5745,-47,-96,49,0e:ae:b4:1e:a1:11,257528773,240,261,257528533,257528773
10575,5,24,149,5745,-88,-96,8,,257529147,28,346,257529119,257529147
10576,5,24,149,5745,-88,-96,8,,257529512,28,337,257529484,257529512
10577,5,12,149,5745,-58,-96,38,f2:da:61:dd:98:c5,257533655,268,3875,257533387,257533655
10578,5,24,149,5745,-88,-96,8,,257535327,28,1644,257535299,257535327
10579,5,24,149,5745,-89,-96,7,,257535676,28,321,257535648,257535676
10580,5,12,149,5745,-48,-96,48,0e:ae:b4:1e:a1:11,257539445,240,3529,257539205,257539445
10581,5,12,149,5745,-69,-96,27,fa:44:8d:e1:c7:1b,257540971,244,1282,257540727,257540971
10582,5,24,149,5745,-89,-96,7,,257542329,28,1330,257542301,257542329
10583,5,24,149,5745,-88,-96,8,,257542438,32,77,257542406,257542438
10584,5,12,149,5745,-73,-96,23,3e:ef:29:c7:4b:17,257545681,244,2999,257545437,257545681
10585,5,24,149,5745,-89,-96,7,,257546103,28,394,257546075,257546103
10586,5,24,149,5745,-88,-96,8,,257552340,28,6209,257552312,257552340
10587,5,24,149,5745,-88,-96,8,,257552704,28,336,257552676,257552704
10588,5,12,149,5745,-64,-96,32,b6:90:18:f6:b1:d4,257555964,244,3016,257555720,257555964
10589,5,12,149,5745,-68,-96,28,a6:92:ad:b7:76:65,257556512,256,292,257556256,257556512
10590,5,12,149,5745,-58,-96,38,f2:da:61:dd:98:c5,257557686,268,906,257557418,257557686
10591,5,24,149,5745,-90,-96,6,,257559652,32,1934,257559620,257559652
10592,5,24,149,5745,-89,-96,7,,257565333,28,5653,257565305,257565333
10593,5,24,149,5745,-90,-96,6,,257572316,28,6955,257572288,257572316
10594,5,24,149,5745,-88,-96,8,,257572617,28,273,257572589,257572617
10595,5,24,149,5745,-71,-96,25,,257572916,28,271,257572888,257572916
10596,5,24,149,5745,-88,-96,8,,257572960,28,16,257572932,257572960
10597,5,24,149,5745,-89,-96,7,,257573067,28,79,257573039,257573067
10598,5,12,149,5745,-73,-96,23,3e:ef:29:c7:4b:17,257573301,440,-206,257572861,257573301
10599,5,24,149,5745,-88,-96,8,,257576679,32,3346,257576647,257576679
10600,5,24,149,5745,-89,-96,7,,257577232,32,521,257577200,257577232
10601,5,24,149,5745,-88,-96,8,,257577785,28,525,257577757,257577785
10602,5,24,149,5745,-89,-96,7,,257579795,32,1978,257579763,257579795
10603,5,12,149,5745,-68,-96,28,a6:92:ad:b7:76:65,257582219,456,1968,257581763,257582219
10604,5,24,149,5745,-87,-96,9,,257588806,28,6559,257588778,257588806
10605,5,24,149,5745,-89,-96,7,,257589215,28,381,257589187,257589215
10606,5,12,149,5745,-73,-96,23,d2:00:04:7e:2c:ab,257589443,468,-240,257588975,257589443
10607,5,12,149,5745,-73,-96,23,22:ec:75:a8:8a:31,257589990,516,31,257589474,257589990
10608,5,12,149,5745,-68,-96,28,fa:44:8d:e1:c7:1b,257590559,440,129,257590119,257590559
10609,5,24,149,5745,-88,-96,8,,257591123,28,536,257591095,257591123
10610,5,24,149,5745,-85,-96,11,,257591169,28,18,257591141,257591169
10611,5,24,149,5745,-86,-96,10,,257591286,32,85,257591254,257591286
10612,5,12,149,5745,-64,-96,32,b6:90:18:f6:b1:d4,257593503,440,1777,257593063,257593503
10613,5,12,149,5745,-46,-96,50,0e:ae:b4:1e:a1:11,257594085,240,342,257593845,257594085
10614,5,24,149,5745,-88,-96,8,,257594431,28,318,257594403,257594431
10615,5,12,149,5745,-57,-96,39,3e:d1:9b:c7:a4:de,257594694,544,-281,257594150,257594694
10616,5,12,149,5745,-60,-96,36,0a:b9:b7:b1:4d:fa,257596189,268,1227,257595921,257596189
10617,5,24,149,5745,-89,-96,7,,257599226,32,3005,257599194,257599226
10618,5,24,149,5745,-88,-96,8,,257599340,32,82,257599308,257599340
10619,5,24,149,5745,-88,-96,8,,257603723,28,4355,257603695,257603723
10620,5,12,149,5745,-82,-96,14,9a:24:38:da:96:bb,257609206,272,5211,257608934,257609206
10621,5,24,149,5745,-89,-96,7,,257611022,32,1784,257610990,257611022
10622,5,24,149,5745,-88,-96,8,,257621204,28,10154,257621176,257621204
10623,5,12,149,5745,-73,-96,23,22:ec:75:a8:8a:31,257622084,244,636,257621840,257622084
10624,5,12,149,5745,-58,-96,38,3e:d1:9b:c7:a4:de,257622560,272,204,257622288,257622560
10625,5,12,149,5745,-61,-96,35,5e:29:73:5b:30:00,257623425,272,593,257623153,257623425
10626,5,24,149,5745,-88,-96,8,,257628061,28,4608,257628033,257628061
10627,5,24,149,5745,-87,-96,9,,257628169,32,76,257628137,257628169
10628,5,24,149,5745,-88,-96,8,,257632908,32,4707,257632876,257632908
10629,5,12,149,5745,-77,-96,19,72:d1:72:1d:22:a1,257647260,256,14096,257647004,257647260
10630,5,12,149,5745,-72,-96,24,56:68:e2:c2:8d:d5,257649045,280,1505,257648765,257649045
10631,5,12,149,5745,-73,-96,23,3e:ef:29:c7:4b:17,257656454,244,7165,257656210,257656454
10632,5,12,149,5745,-67,-96,29,fa:44:8d:e1:c7:1b,257657444,244,746,257657200,257657444
10633,5,12,149,5745,-67,-96,29,fa:44:8d:e1:c7:1b,257657706,440,-178,257657266,257657706
10634,5,24,149,5745,-88,-96,8,,257663954,28,6220,257663926,257663954
10635,5,24,149,5745,-88,-96,8,,257664273,28,291,257664245,257664273
10636,5,24,149,5745,-89,-96,7,,257671299,28,6998,257671271,257671299
10637,5,24,149,5745,-88,-96,8,,257676860,28,5533,257676832,257676860
10638,5,24,149,5745,-89,-96,7,,257677224,28,336,257677196,257677224
10639,5,24,149,5745,-89,-96,7,,257677873,28,621,257677845,257677873
10640,5,24,149,5745,-89,-96,7,,257678183,28,282,257678155,257678183
10641,5,12,149,5745,-59,-96,37,f2:da:61:dd:98:c5,257678478,268,27,257678210,257678478
10642,5,24,149,5745,-89,-96,7,,257683806,32,5296,257683774,257683806
10643,5,24,149,5745,-89,-96,7,,257685942,28,2108,257685914,257685942
10644,5,24,149,5745,-90,-96,6,,257693228,32,7254,257693196,257693228
10645,5,12,149,5745,-73,-96,23,22:ec:75:a8:8a:31,257703323,516,9579,257702807,257703323
10646,5,24,149,5745,-89,-96,7,,257703986,28,635,257703958,257703986
10647,5,24,149,5745,-88,-96,8,,257704278,28,264,257704250,257704278
10648,5,24,149,5745,-88,-96,8,,257711537,32,7227,257711505,257711537
10649,5,12,149,5745,-73,-96,23,22:ec:75:a8:8a:31,257719541,244,7760,257719297,257719541
10650,5,24,149,5745,-89,-96,7,,257722677,28,3108,257722649,257722677
10651,5,6,149,5745,-86,-96,10,54:e4:3a:ec:fb:65,257724680,360,1643,257724320,257724680
10652,5,12,149,5745,-60,-96,36,3e:d1:9b:c7:a4:de,257725972,272,1020,257725700,257725972
10653,5,24,149,5745,-89,-96,7,,257729289,32,3285,257729257,257729289
10654,5,12,149,5745,-61,-96,35,5e:29:73:5b:30:00,257732486,272,2925,257732214,257732486
10655,5,24,149,5745,-91,-96,5,,257736043,28,3529,257736015,257736043
10656,5,24,149,5745,-89,-96,7,,257736380,28,309,257736352,257736380
10657,5,24,149,5745,-90,-96,6,,257743369,32,6957,257743337,257743369
10658,5,12,149,5745,-68,-96,28,a6:92:ad:b7:76:65,257747771,256,4146,257747515,257747771
10659,5,12,149,5745,-77,-96,19,72:d1:72:1d:22:a1,257749337,256,1310,257749081,257749337
10660,5,12,149,5745,-64,-96,32,b6:90:18:f6:b1:d4,257749827,244,246,257749583,257749827
10661,5,24,149,5745,-90,-96,6,,257750248,28,393,257750220,257750248
10662,5,24,149,5745,-89,-96,7,,257750356,32,76,257750324,257750356
10663,5,12,149,5745,-73,-96,23,56:68:e2:c2:8d:d5,257751464,280,828,257751184,257751464
10664,5,24,149,5745,-88,-96,8,,257752006,28,514,257751978,257752006
10665,5,24,149,5745,-89,-96,7,,257752379,28,345,257752351,257752379
10666,5,24,149,5745,-88,-96,8,,257759169,28,6762,257759141,257759169
10667,5,24,149,5745,-88,-96,8,,257761002,28,1805,257760974,257761002
10668,5,12,149,5745,-73,-96,23,22:ec:75:a8:8a:31,257769367,516,7849,257768851,257769367
10669,5,24,149,5745,-89,-96,7,,257773939,28,4544,257773911,257773939
10670,5,24,149,5745,-90,-96,6,,257774310,28,343,257774282,257774310
10671,5,12,149,5745,-43,-96,53,0e:ae:b4:1e:a1:11,257776416,240,1866,257776176,257776416
10672,5,24,149,5745,-88,-96,8,,257783247,32,6799,257783215,257783247
10673,5,24,149,5745,-91,-96,5,,257784411,28,1136,257784383,257784411
10674,5,12,149,5745,-73,-96,23,3e:ef:29:c7:4b:17,257801747,244,17092,257801503,257801747
10675,5,24,149,5745,-89,-96,7,,257805883,28,4108,257805855,257805883
10676,5,24,149,5745,-89,-96,7,,257806239,28,328,257806211,257806239
10677,5,24,149,5745,-88,-96,8,,257808568,32,2297,257808536,257808568
10678,5,24,149,5745,-88,-96,8,,257809102,32,502,257809070,257809102
10679,5,24,149,5745,-88,-96,8,,257812180,28,3050,257812152,257812180
10680,5,24,149,5745,-89,-96,7,,257812529,28,321,257812501,257812529
10681,5,24,149,5745,-89,-96,7,,257813021,32,460,257812989,257813021
10682,5,24,149,5745,-90,-96,6,,257818928,32,5875,257818896,257818928
10683,5,12,149,5745,-73,-96,23,22:ec:75:a8:8a:31,257826110,244,6938,257825866,257826110
10684,5,24,149,5745,-89,-96,7,,257826522,28,384,257826494,257826522
10685,5,6,149,5745,-85,-96,11,54:e4:3a:ec:fb:65,257827080,360,198,257826720,257827080
10686,5,12,149,5745,-60,-96,36,f2:da:61:dd:98:c5,257827856,268,508,257827588,257827856
10687,5,24,149,5745,-89,-96,7,,257829456,28,1572,257829428,257829456
10688,5,24,149,5745,-88,-96,8,,257836481,32,6993,257836449,257836481
10689,5,12,149,5745,-60,-96,36,3e:d1:9b:c7:a4:de,257838571,272,1818,257838299,257838571
10690,5,12,149,5745,-59,-96,37,5e:29:73:5b:30:00,257849368,272,10525,257849096,257849368
10691,5,12,149,5745,-68,-96,28,a6:92:ad:b7:76:65,257850501,256,877,257850245,257850501
10692,5,12,149,5745,-66,-96,30,fa:44:8d:e1:c7:1b,257851624,244,879,257851380,257851624
10693,5,12,149,5745,-74,-96,22,56:68:e2:c2:8d:d5,257851990,280,86,257851710,257851990
10694,5,12,149,5745,-75,-96,21,72:d1:72:1d:22:a1,257852384,256,138,257852128,257852384
10695,5,12,149,5745,-64,-96,32,b6:90:18:f6:b1:d4,257852685,244,57,257852441,257852685
10696,5,24,149,5745,-89,-96,7,,257854417,28,1704,257854389,257854417
10697,5,24,149,5745,-89,-96,7,,257854766,28,321,257854738,257854766
10698,5,24,149,5745,-89,-96,7,,257861574,32,6776,257861542,257861574
10699,5,24,149,5745,-88,-96,8,,257861761,28,159,257861733,257861761
10700,5,24,149,5745,-88,-96,8,,257862108,28,319,257862080,257862108
10701,5,24,149,5745,-88,-96,8,,257868155,28,6019,257868127,257868155
10702,5,24,149,5745,-88,-96,8,,257868264,32,77,257868232,257868264
10703,5,24,149,5745,-88,-96,8,,257869548,32,1252,257869516,257869548
10704,5,24,149,5745,-89,-96,7,,257869674,32,94,257869642,257869674
10705,5,24,149,5745,-89,-96,7,,257881500,28,11798,257881472,257881500
10706,5,24,149,5745,-89,-96,7,,257881845,28,317,257881817,257881845
10707,5,24,149,5745,-89,-96,7,,257888826,32,6949,257888794,257888826
10708,5,24,149,5745,-89,-96,7,,257892493,28,3639,257892465,257892493
10709,5,24,149,5745,-89,-96,7,,257892843,28,322,257892815,257892843
10710,5,24,149,5745,-90,-96,6,,257892888,28,17,257892860,257892888
10711,5,12,149,5745,-73,-96,23,3e:ef:29:c7:4b:17,257904959,244,11827,257904715,257904959
10712,5,24,149,5745,-89,-96,7,,257905579,32,588,257905547,257905579
10713,5,24,149,5745,-88,-96,8,,257907250,28,1643,257907222,257907250
10714,5,24,149,5745,-87,-96,9,,257907358,32,76,257907326,257907358
10715,5,24,149,5745,-88,-96,8,,257909674,28,2288,257909646,257909674
10716,5,24,149,5745,-87,-96,9,,257912438,32,2732,257912406,257912438
10717,5,24,149,5745,-89,-96,7,,257912807,28,341,257912779,257912807
10718,5,24,149,5745,-88,-96,8,,257914138,32,1299,257914106,257914138
10719,5,24,149,5745,-88,-96,8,,257914870,32,700,257914838,257914870
10720,5,24,149,5745,-89,-96,7,,257920268,28,5370,257920240,257920268
10721,5,24,149,5745,-88,-96,8,,257921637,32,1337,257921605,257921637
10722,5,24,149,5745,-88,-96,8,,257922007,32,338,257921975,257922007
10723,5,24,149,5745,-89,-96,7,,257926089,28,4054,257926061,257926089
10724,5,24,149,5745,-88,-96,8,,257926444,28,327,257926416,257926444
10725,5,24,149,5745,-70,-96,26,,257926705,28,233,257926677,257926705
10726,5,24,149,5745,-88,-96,8,,257926749,28,16,257926721,257926749
10727,5,24,149,5745,-88,-96,8,,257926857,28,80,257926829,257926857
10728,5,24,149,5745,-88,-96,8,,257927045,28,160,257927017,257927045
10729,5,6,149,5745,-84,-96,12,54:e4:3a:ec:fb:65,257929481,360,2076,257929121,257929481
10730,5,12,149,5745,-64,-96,32,f2:da:61:dd:98:c5,257930184,268,435,257929916,257930184
10731,5,24,149,5745,-89,-96,7,,257933812,32,3596,257933780,257933812
10732,5,12,149,5745,-71,-96,25,22:ec:75:a8:8a:31,257943109,244,9053,257942865,257943109
10733,5,24,149,5745,-88,-96,8,,257944698,28,1561,257944670,257944698
10734,5,24,149,5745,-88,-96,8,,257945052,28,326,257945024,257945052
10735,5,12,149,5745,-80,-96,16,9a:24:38:da:96:bb,257946432,272,1108,257946160,257946432
10736,5,24,149,5745,-88,-96,8,,257951988,32,5524,257951956,257951988
10737,5,12,149,5745,-68,-96,28,a6:92:ad:b7:76:65,257952616,256,372,257952360,257952616
10738,5,12,149,5745,-62,-96,34,3e:d1:9b:c7:a4:de,257953154,272,266,257952882,257953154
10739,5,12,149,5745,-64,-96,32,b6:90:18:f6:b1:d4,257953480,244,82,257953236,257953480
10740,5,12,149,5745,-74,-96,22,72:d1:72:1d:22:a1,257953958,256,222,257953702,257953958
10741,5,12,149,5745,-65,-96,31,fa:44:8d:e1:c7:1b,257954276,244,74,257954032,257954276
10742,5,12,149,5745,-58,-96,38,5e:29:73:5b:30:00,257961266,272,6718,257960994,257961266
10743,5,24,149,5745,-88,-96,8,,257965224,28,3930,257965196,257965224
10744,5,24,149,5745,-88,-96,8,,257965333,32,77,257965301,257965333
10745,5,12,149,5745,-74,-96,22,56:68:e2:c2:8d:d5,257970668,280,5055,257970388,257970668
10746,5,24,149,5745,-87,-96,9,,257975972,28,5276,257975944,257975972
10747,5,24,149,5745,-87,-96,9,,257989983,28,13983,257989955,257989983
10748,5,24,149,5745,-87,-96,9,,257990347,28,336,257990319,257990347
10749,5,24,149,5745,-88,-96,8,,257990639,28,264,257990611,257990639
10750,5,24,149,5745,-87,-96,9,,257990950,28,283,257990922,257990950
10751,5,24,149,5745,-87,-96,9,,257997370,32,6388,257997338,257997370
10752,5,12,149,5745,-44,-96,52,0e:ae:b4:1e:a1:11,257998235,240,625,257997995,257998235
10753,5,24,149,5745,-86,-96,10,,258000742,28,2479,258000714,258000742
10754,5,24,149,5745,-87,-96,9,,258001070,28,300,258001042,258001070
10755,5,12,149,5745,-72,-96,24,3e:ef:29:c7:4b:17,258006105,244,4791,258005861,258006105
10756,5,24,149,5745,-87,-96,9,,258007811,32,1674,258007779,258007811
10757,5,12,149,5745,-65,-96,31,fa:44:8d:e1:c7:1b,258008140,244,85,258007896,258008140
10758,5,24,149,5745,-87,-96,9,,258012417,32,4245,258012385,258012417
10759,5,12,149,5745,-71,-96,25,a6:92:ad:b7:76:65,258014656,256,1983,258014400,258014656
10760,5,12,149,5745,-65,-96,31,b6:90:18:f6:b1:d4,258016417,244,1517,258016173,258016417
10761,5,24,149,5745,-87,-96,9,,258017275,28,830,258017247,258017275
10762,5,24,149,5745,-87,-96,9,,258017639,28,336,258017611,258017639
10763,5,12,149,5745,-63,-96,33,f2:da:61:dd:98:c5,258017743,268,-164,258017475,258017743
10764,5,24,149,5745,-87,-96,9,,258020248,28,2477,258020220,258020248
10765,5,24,149,5745,-87,-96,9,,258020360,32,80,258020328,258020360
10766,5,24,149,5745,-87,-96,9,,258024436,28,4048,258024408,258024436
10767,5,24,149,5745,-86,-96,10,,258024544,32,76,258024512,258024544
10768,5,24,149,5745,-87,-96,9,,258026895,28,2323,258026867,258026895
10769,5,12,149,5745,-72,-96,24,22:ec:75:a8:8a:31,258031523,544,4084,258030979,258031523
10770,5,12,149,5745,-44,-96,52,0e:ae:b4:1e:a1:11,258032493,240,730,258032253,258032493
10771,5,24,149,5745,-88,-96,8,,258034437,28,1916,258034409,258034437
10772,5,24,149,5745,-86,-96,10,,258034737,28,272,258034709,258034737
10773,5,24,149,5745,-87,-96,9,,258035077,28,312,258035049,258035077
10774,5,24,149,5745,-86,-96,10,,258035185,32,76,258035153,258035185
10775,5,12,149,5745,-73,-96,23,72:d1:72:1d:22:a1,258035926,248,493,258035678,258035926
10776,5,12,149,5745,-70,-96,26,a6:92:ad:b7:76:65,258040393,484,3983,258039909,258040393
10777,5,24,149,5745,-86,-96,10,,258041082,28,661,258041054,258041082
10778,5,24,149,5745,-86,-96,10,,258041190,32,76,258041158,258041190
10779,5,12,149,5745,-74,-96,22,56:68:e2:c2:8d:d5,258042228,476,562,258041752,258042228
10780,5,12,149,5745,-75,-96,21,f6:0a:5c:59:72:df,258042818,448,142,258042370,258042818
10781,5,12,149,5745,-64,-96,32,fa:44:8d:e1:c7:1b,258048026,440,4768,258047586,258048026
10782,5,24,149,5745,-87,-96,9,,258048600,28,546,258048572,258048600
10783,5,24,149,5745,-86,-96,10,,258049203,28,575,258049175,258049203
10784,5,24,149,5745,-85,-96,11,,258051370,32,2135,258051338,258051370
10785,5,24,149,5745,-87,-96,9,,258051817,28,419,258051789,258051817
10786,5,12,149,5745,-61,-96,35,3e:d1:9b:c7:a4:de,258052371,544,10,258051827,258052371
10787,5,24,149,5745,-87,-96,9,,258053093,28,694,258053065,258053093
10788,5,24,149,5745,-87,-96,9,,258053201,32,76,258053169,258053201
10789,5,24,149,5745,-86,-96,10,,258053375,28,146,258053347,258053375
10790,5,12,149,5745,-65,-96,31,b6:90:18:f6:b1:d4,258054101,440,286,258053661,258054101
10791,5,12,149,5745,-59,-96,37,5e:29:73:5b:30:00,258054620,540,-21,258054080,258054620
10792,5,24,149,5745,-86,-96,10,,258055974,32,1322,258055942,258055974
10793,5,12,149,5745,-63,-96,33,f2:da:61:dd:98:c5,258057252,268,1010,258056984,258057252
10794,5,24,149,5745,-86,-96,10,,258058326,32,1042,258058294,258058326
10795,5,12,149,5745,-81,-96,15,9a:24:38:da:96:bb,258059014,272,416,258058742,258059014
10796,5,12,149,5745,-73,-96,23,72:d1:72:1d:22:a1,258059804,444,346,258059360,258059804
10797,5,12,149,5745,-71,-96,25,22:ec:75:a8:8a:31,258063630,272,3554,258063358,258063630
10798,5,12,149,5745,-74,-96,22,56:68:e2:c2:8d:d5,258064927,280,1017,258064647,258064927
10799,5,24,149,5745,-86,-96,10,,258069862,28,4907,258069834,258069862
10800,5,24,149,5745,-86,-96,10,,258070198,28,308,258070170,258070198
10801,5,24,149,5745,-87,-96,9,,258070890,28,664,258070862,258070890
10802,5,12,149,5745,-74,-96,22,f6:0a:5c:59:72:df,258075148,252,4006,258074896,258075148
10803,5,24,149,5745,-86,-96,10,,258076730,32,1550,258076698,258076730
10804,5,12,149,5745,-60,-96,36,3e:d1:9b:c7:a4:de,258080753,272,3751,258080481,258080753
10805,5,12,149,5745,-60,-96,36,5e:29:73:5b:30:00,258081572,272,547,258081300,258081572
10806,5,24,149,5745,-85,-96,11,,258082023,28,423,258081995,258082023
10807,5,24,149,5745,-86,-96,10,,258082424,28,373,258082396,258082424
10808,5,24,149,5745,-86,-96,10,,258089172,32,6716,258089140,258089172
10809,5,24,149,5745,-86,-96,10,,258095493,28,6293,258095465,258095493
10810,5,24,149,5745,-86,-96,10,,258095884,28,363,258095856,258095884
10811,5,12,149,5745,-44,-96,52,0e:ae:b4:1e:a1:11,258096169,240,45,258095929,258096169
10812,5,12,149,5745,-72,-96,24,3e:ef:29:c7:4b:17,258097964,468,1327,258097496,258097964
10813,5,12,149,5745,-72,-96,24,3e:ef:29:c7:4b:17,258098451,272,215,258098179,258098451
10814,5,12,149,5745,-46,-96,50,0e:ae:b4:1e:a1:11,258098784,240,93,258098544,258098784
10815,5,12,149,5745,-71,-96,25,72:d1:72:1d:22:a1,258101030,452,1794,258100578,258101030
10816,5,24,149,5745,-86,-96,10,,258102691,32,1629,258102659,258102691
10817,5,12,149,5745,-71,-96,25,22:ec:75:a8:8a:31,258104855,544,1620,258104311,258104855
10818,5,12,149,5745,-75,-96,21,56:68:e2:c2:8d:d5,258105433,480,98,258104953,258105433
10819,5,12,149,5745,-70,-96,26,a6:92:ad:b7:76:65,258105974,484,57,258105490,258105974
10820,5,12,149,5745,-65,-96,31,b6:90:18:f6:b1:d4,258108460,440,2046,258108020,258108460
10821,5,12,149,5745,-63,-96,33,fa:44:8d:e1:c7:1b,258109034,104,470,258108930,258109034
10822,5,12,149,5745,-77,-96,19,f6:0a:5c:59:72:df,258110117,480,603,258109637,258110117
10823,5,12,149,5745,-59,-96,37,3e:d1:9b:c7:a4:de,258110686,544,25,258110142,258110686
10824,5,24,149,5745,-86,-96,10,,258111327,28,613,258111299,258111327
10825,5,12,149,5745,-64,-96,32,fa:44:8d:e1:c7:1b,258113822,440,2055,258113382,258113822
10826,5,12,149,5745,-63,-96,33,f2:da:61:dd:98:c5,258114323,268,233,258114055,258114323
10827,5,12,149,5745,-64,-96,32,fa:44:8d:e1:c7:1b,258114652,244,85,258114408,258114652
10828,5,12,149,5745,-70,-96,26,a6:92:ad:b7:76:65,258115994,284,1058,258115710,258115994
10829,5,12,149,5745,-65,-96,31,b6:90:18:f6:b1:d4,258116323,244,85,258116079,258116323
10830,5,24,149,5745,-86,-96,10,,258118458,32,2103,258118426,258118458
10831,5,12,149,5745,-72,-96,24,d2:00:04:7e:2c:ab,258118543,104,-19,258118439,258118543
10832,5,12,149,5745,-61,-96,35,0a:b9:b7:b1:4d:fa,258119221,268,410,258118953,258119221
10833,5,12,149,5745,-60,-96,36,5e:29:73:5b:30:00,258119748,540,-13,258119208,258119748
10834,5,12,149,5745,-64,-96,32,f2:da:61:dd:98:c5,258120792,268,776,258120524,258120792
10835,5,12,149,5745,-72,-96,24,d2:00:04:7e:2c:ab,258123795,440,2563,258123355,258123795
10836,5,24,149,5745,-86,-96,10,,258124618,28,795,258124590,258124618
10837,5,24,149,5745,-87,-96,9,,258126595,28,1949,258126567,258126595
10838,5,24,149,5745,-87,-96,9,,258127362,32,735,258127330,258127362
10839,5,24,149,5745,-87,-96,9,,258128537,32,1143,258128505,258128537
10840,5,24,149,5745,-87,-96,9,,258133148,28,4583,258133120,258133148
10841,5,24,149,5745,-86,-96,10,,258133256,32,76,258133224,258133256
10842,5,6,149,5745,-84,-96,12,54:e4:3a:ec:fb:65,258134282,360,666,258133922,258134282
10843,5,24,149,5745,-87,-96,9,,258144608,28,10298,258144580,258144608
10844,5,24,149,5745,-87,-96,9,,258144927,28,291,258144899,258144927
10845,5,12,149,5745,-70,-96,26,72:d1:72:1d:22:a1,258149523,256,4340,258149267,258149523
10846,5,24,149,5745,-86,-96,10,,258152126,32,2571,258152094,258152126
10847,5,24,149,5745,-87,-96,9,,258158112,28,5958,258158084,258158112
10848,5,24,149,5745,-86,-96,10,,258160517,28,2377,258160489,258160517
10849,5,24,149,5745,-86,-96,10,,258160962,32,413,258160930,258160962
10850,5,24,149,5745,-86,-96,10,,258161119,28,129,258161091,258161119
10851,5,24,149,5745,-87,-96,9,,258166925,32,5774,258166893,258166925
10852,5,12,149,5745,-73,-96,23,22:ec:75:a8:8a:31,258172967,544,5498,258172423,258172967
10853,5,24,149,5745,-87,-96,9,,258179131,28,6136,258179103,258179131
10854,5,24,149,5745,-86,-96,10,,258179240,32,77,258179208,258179240
10855,5,12,149,5745,-73,-96,23,22:ec:75:a8:8a:31,258180850,272,1338,258180578,258180850
10856,5,12,149,5745,-59,-96,37,3e:d1:9b:c7:a4:de,258182497,272,1375,258182225,258182497
10857,5,24,149,5745,-87,-96,9,,258189973,28,7448,258189945,258189973
10858,5,12,149,5745,-75,-96,21,56:68:e2:c2:8d:d5,258190363,284,106,258190079,258190363
10859,5,12,149,5745,-59,-96,37,5e:29:73:5b:30:00,258190899,272,264,258190627,258190899
10860,5,24,149,5745,-87,-96,9,,258206611,28,15684,258206583,258206611
10861,5,24,149,5745,-88,-96,8,,258206973,28,334,258206945,258206973
10862,5,24,149,5745,-87,-96,9,,258222900,28,15899,258222872,258222900
10863,5,24,149,5745,-88,-96,8,,258223251,28,323,258223223,258223251
10864,5,12,149,5745,-71,-96,25,3e:ef:29:c7:4b:17,258228663,272,5140,258228391,258228663
10865,5,12,149,5745,-65,-96,31,fa:44:8d:e1:c7:1b,258233929,244,5022,258233685,258233929
10866,5,6,149,5745,-84,-96,12,54:e4:3a:ec:fb:65,258236682,360,2393,258236322,258236682
10867,5,12,149,5745,-74,-96,22,22:ec:75:a8:8a:31,258238691,544,1465,258238147,258238691
10868,5,12,149,5745,-64,-96,32,b6:90:18:f6:b1:d4,258240038,244,1103,258239794,258240038
10869,5,12,149,5745,-68,-96,28,a6:92:ad:b7:76:65,258240596,284,274,258240312,258240596
10870,5,12,149,5745,-62,-96,34,f2:da:61:dd:98:c5,258241770,268,906,258241502,258241770
10871,5,24,149,5745,-88,-96,8,,258243494,28,1696,258243466,258243494
10872,5,24,149,5745,-88,-96,8,,258256547,28,13025,258256519,258256547
10873,5,12,149,5745,-72,-96,24,72:d1:72:1d:22:a1,258261748,256,4945,258261492,258261748
10874,5,24,149,5745,-88,-96,8,,258263782,32,2002,258263750,258263782
10875,5,12,149,5745,-81,-96,15,9a:24:38:da:96:bb,258270787,272,6733,258270515,258270787
10876,5,24,149,5745,-89,-96,7,,258278405,28,7590,258278377,258278405
10877,5,12,149,5745,-75,-96,21,22:ec:75:a8:8a:31,258295622,272,16945,258295350,258295622
10878,5,12,149,5745,-58,-96,38,3e:d1:9b:c7:a4:de,258299471,272,3577,258299199,258299471
10879,5,24,149,5745,-89,-96,7,,258300051,28,552,258300023,258300051
10880,5,24,149,5745,-89,-96,7,,258300442,28,363,258300414,258300442
10881,5,12,149,5745,-74,-96,22,22:ec:75:a8:8a:31,258304551,544,3565,258304007,258304551
10882,5,12,149,5745,-59,-96,37,5e:29:73:5b:30:00,258306122,272,1299,258305850,258306122
10883,5,24,149,5745,-88,-96,8,,258306617,28,467,258306589,258306617
10884,5,12,149,5745,-77,-96,19,f6:0a:5c:59:72:df,258321483,284,14582,258321199,258321483
10885,5,6,149,5745,-84,-96,12,54:e4:3a:ec:fb:65,258339083,360,17240,258338723,258339083
10886,5,12,149,5745,-63,-96,33,f2:da:61:dd:98:c5,258352034,268,12683,258351766,258352034
10887,5,24,149,5745,-89,-96,7,,258355135,28,3073,258355107,258355135
10888,5,12,149,5745,-68,-96,28,a6:92:ad:b7:76:65,258362256,284,6837,258361972,258362256
10889,5,24,149,5745,-90,-96,6,,258363205,28,921,258363177,258363205
10890,5,12,149,5745,-66,-96,30,fa:44:8d:e1:c7:1b,258363832,244,383,258363588,258363832
10891,5,12,149,5745,-66,-96,30,b6:90:18:f6:b1:d4,258364166,244,90,258363922,258364166
10892,5,12,149,5745,-74,-96,22,56:68:e2:c2:8d:d5,258365884,284,1434,258365600,258365884
10893,5,12,149,5745,-71,-96,25,72:d1:72:1d:22:a1,258374594,256,8454,258374338,258374594
10894,5,24,149,5745,-91,-96,5,,258375695,28,1073,258375667,258375695
10895,5,12,149,5745,-79,-96,17,9a:24:38:da:96:bb,258386732,272,10765,258386460,258386732
10896,5,24,149,5745,-89,-96,7,,258393889,28,7129,258393861,258393889
10897,5,12,149,5745,-72,-96,24,22:ec:75:a8:8a:31,258396627,272,2466,258396355,258396627
10898,5,24,149,5745,-88,-96,8,,258404161,28,7506,258404133,258404161
10899,5,12,149,5745,-56,-96,40,3e:d1:9b:c7:a4:de,258416576,272,12143,258416304,258416576
10900,5,12,149,5745,-72,-96,24,3e:ef:29:c7:4b:17,258417712,272,864,258417440,258417712
10901,5,12,149,5745,-59,-96,37,5e:29:73:5b:30:00,258423108,272,5124,258422836,258423108
10902,5,12,149,5745,-73,-96,23,f6:0a:5c:59:72:df,258436631,284,13239,258436347,258436631
10903,5,12,149,5745,-45,-96,51,0e:ae:b4:1e:a1:11,258449902,240,13031,258449662,258449902
10904,5,12,149,5745,-72,-96,24,3e:ef:29:c7:4b:17,258456496,272,6322,258456224,258456496
10905,5,12,149,5745,-65,-96,31,a6:92:ad:b7:76:65,258464672,284,7892,258464388,258464672
10906,5,12,149,5745,-68,-96,28,fa:44:8d:e1:c7:1b,258466037,244,1121,258465793,258466037
10907,5,12,149,5745,-68,-96,28,b6:90:18:f6:b1:d4,258466814,244,533,258466570,258466814
10908,5,12,149,5745,-71,-96,25,56:68:e2:c2:8d:d5,258468359,284,1261,258468075,258468359
10909,5,12,149,5745,-64,-96,32,f2:da:61:dd:98:c5,258476072,268,7445,258475804,258476072
10910,5,24,149,5745,-89,-96,7,,258490087,28,13987,258490059,258490087
10911,5,12,149,5745,-71,-96,25,72:d1:72:1d:22:a1,258492697,256,2354,258492441,258492697
10912,5,12,149,5745,-82,-96,14,9a:24:38:da:96:bb,258493651,824,130,258492827,258493651
10913,5,12,149,5745,-82,-96,14,9a:24:38:da:96:bb,258494492,272,569,258494220,258494492
10914,5,12,149,5745,-73,-96,23,f6:0a:5c:59:72:df,258496209,480,1237,258495729,258496209
10915,5,12,149,5745,-68,-96,28,b6:90:18:f6:b1:d4,258500915,440,4266,258500475,258500915
10916,5,12,149,5745,-71,-96,25,22:ec:75:a8:8a:31,258503364,544,1905,258502820,258503364
10917,5,12,149,5745,-45,-96,51,0e:ae:b4:1e:a1:11,258506068,240,2464,258505828,258506068
10918,5,12,149,5745,-68,-96,28,fa:44:8d:e1:c7:1b,258506542,440,34,258506102,258506542
10919,5,12,149,5745,-56,-96,40,3e:d1:9b:c7:a4:de,258508820,544,1734,258508276,258508820
10920,5,12,149,5745,-59,-96,37,5e:29:73:5b:30:00,258510857,540,1497,258510317,258510857
10921,5,12,149,5745,-70,-96,26,56:68:e2:c2:8d:d5,258511976,480,639,258511496,258511976
10922,5,12,149,5745,-72,-96,24,3e:ef:29:c7:4b:17,258514030,468,1586,258513562,258514030
10923,5,12,149,5745,-62,-96,34,f2:da:61:dd:98:c5,258514600,268,302,258514332,258514600
10924,5,12,149,5745,-71,-96,25,72:d1:72:1d:22:a1,258516749,452,1697,258516297,258516749
10925,5,12,149,5745,-73,-96,23,f6:0a:5c:59:72:df,258523773,284,6740,258523489,258523773
10926,5,12,149,5745,-70,-96,26,56:68:e2:c2:8d:d5,258524091,284,34,258523807,258524091
10927,5,12,149,5745,-72,-96,24,22:ec:75:a8:8a:31,258524986,272,623,258524714,258524986
10928,5,24,149,5745,-88,-96,8,,258537098,28,12084,258537070,258537098
10929,5,24,149,5745,-87,-96,9,,258537462,28,336,258537434,258537462
10930,5,12,149,5745,-56,-96,40,3e:d1:9b:c7:a4:de,258542674,272,4940,258542402,258542674
10931,5,6,149,5745,-84,-96,12,54:e4:3a:ec:fb:65,258543884,360,850,258543524,258543884
10932,5,24,149,5745,-87,-96,9,,258544297,32,381,258544265,258544297
10933,5,12,149,5745,-59,-96,37,5e:29:73:5b:30:00,258544447,272,-122,258544175,258544447
10934,5,12,149,5745,-47,-96,49,0e:ae:b4:1e:a1:11,258562241,240,17554,258562001,258562241
10935,5,12,149,5745,-74,-96,22,22:ec:75:a8:8a:31,258566206,544,3421,258565662,258566206
10936,5,12,149,5745,-69,-96,27,b6:90:18:f6:b1:d4,258567424,440,778,258566984,258567424
10937,5,12,149,5745,-72,-96,24,3e:ef:29:c7:4b:17,258570874,272,3178,258570602,258570874
10938,5,12,149,5745,-67,-96,29,fa:44:8d:e1:c7:1b,258572360,440,1046,258571920,258572360
10939,5,12,149,5745,-62,-96,34,f2:da:61:dd:98:c5,258572834,268,206,258572566,258572834
10940,5,12,149,5745,-67,-96,29,fa:44:8d:e1:c7:1b,258573172,244,94,258572928,258573172
10941,5,12,149,5745,-69,-96,27,b6:90:18:f6:b1:d4,258574694,244,1278,258574450,258574694
10942,5,12,149,5745,-63,-96,33,f2:da:61:dd:98:c5,258579677,268,4715,258579409,258579677
10943,5,24,149,5745,-87,-96,9,,258586936,28,7231,258586908,258586936
10944,5,24,149,5745,-89,-96,7,,258593385,32,6417,258593353,258593385
10945,5,24,149,5745,-87,-96,9,,258607387,28,13974,258607359,258607387
10946,5,24,149,5745,-87,-96,9,,258610488,28,3073,258610460,258610488
10947,5,24,149,5745,-89,-96,7,,258610596,32,76,258610564,258610596
10948,5,12,149,5745,-73,-96,23,d2:00:04:7e:2c:ab,258610707,380,-269,258610327,258610707
10949,5,12,149,5745,-78,-96,18,9a:24:38:da:96:bb,258626580,824,15049,258625756,258626580
10950,5,12,149,5745,-73,-96,23,22:ec:75:a8:8a:31,258631796,544,4672,258631252,258631796
10951,5,12,149,5745,-69,-96,27,b6:90:18:f6:b1:d4,258632969,440,733,258632529,258632969
10952,5,12,149,5745,-67,-96,29,fa:44:8d:e1:c7:1b,258637585,440,4176,258637145,258637585
10953,5,12,149,5745,-51,-96,45,0e:ae:b4:1e:a1:11,258638445,240,620,258638205,258638445
10954,5,24,149,5745,-87,-96,9,,258639463,28,990,258639435,258639463
10955,5,12,149,5745,-56,-96,40,3e:d1:9b:c7:a4:de,258639693,544,-314,258639149,258639693
10956,5,12,149,5745,-69,-96,27,a6:92:ad:b7:76:65,258641702,484,1525,258641218,258641702
10957,5,12,149,5745,-61,-96,35,0a:b9:b7:b1:4d:fa,258644786,268,2816,258644518,258644786
10958,5,12,149,5745,-58,-96,38,5e:29:73:5b:30:00,258645133,540,-193,258644593,258645133
10959,5,6,149,5745,-84,-96,12,54:e4:3a:ec:fb:65,258646285,360,792,258645925,258646285
10960,5,24,149,5745,-87,-96,9,,258646931,32,614,258646899,258646931
10961,5,12,149,5745,-64,-96,32,f2:da:61:dd:98:c5,258648174,268,975,258647906,258648174
10962,5,12,149,5745,-72,-96,24,3e:ef:29:c7:4b:17,258649853,468,1211,258649385,258649853
10963,5,12,149,5745,-56,-96,40,3e:d1:9b:c7:a4:de,258656502,272,6377,258656230,258656502
10964,5,12,149,5745,-58,-96,38,5e:29:73:5b:30:00,258658095,272,1321,258657823,258658095
10965,5,24,149,5745,-88,-96,8,,258659564,28,1441,258659536,258659564
10966,5,12,149,5745,-51,-96,45,0e:ae:b4:1e:a1:11,258659802,240,-2,258659562,258659802
10967,5,24,149,5745,-88,-96,8,,258666337,28,6507,258666309,258666337
10968,5,12,149,5745,-72,-96,24,72:d1:72:1d:22:a1,258671321,256,4728,258671065,258671321
10969,5,12,149,5745,-66,-96,30,fa:44:8d:e1:c7:1b,258671685,244,120,258671441,258671685
10970,5,12,149,5745,-71,-96,25,56:68:e2:c2:8d:d5,258672984,284,1015,258672700,258672984
10971,5,24,149,5745,-88,-96,8,,258673717,28,705,258673689,258673717
10972,5,24,149,5745,-87,-96,9,,258674066,28,321,258674038,258674066
10973,5,12,149,5745,-72,-96,24,3e:ef:29:c7:4b:17,258674522,272,184,258674250,258674522
10974,5,24,149,5745,-87,-96,9,,258680928,28,6378,258680900,258680928
10975,5,24,149,5745,-87,-96,9,,258681037,32,77,258681005,258681037
10976,5,24,149,5745,-88,-96,8,,258688801,28,7736,258688773,258688801
10977,5,24,149,5745,-87,-96,9,,258689155,28,326,258689127,258689155
10978,5,24,149,5745,-87,-96,9,,258696117,32,6930,258696085,258696117
10979,5,12,149,5745,-71,-96,25,22:ec:75:a8:8a:31,258697434,544,773,258696890,258697434
10980,5,12,149,5745,-69,-96,27,b6:90:18:f6:b1:d4,258700039,244,2361,258699795,258700039
10981,5,12,149,5745,-64,-96,32,f2:da:61:dd:98:c5,258701621,268,1314,258701353,258701621
10982,5,24,149,5745,-87,-96,9,,258711366,28,9717,258711338,258711366
10983,5,24,149,5745,-86,-96,10,,258711740,28,346,258711712,258711740
10984,5,12,149,5745,-80,-96,16,9a:24:38:da:96:bb,258719618,272,7606,258719346,258719618
10985,5,24,149,5745,-87,-96,9,,258719954,28,308,258719926,258719954
10986,5,24,149,5745,-87,-96,9,,258720066,32,80,258720034,258720066
10987,5,24,149,5745,-87,-96,9,,258724924,28,4830,258724896,258724924
10988,5,24,149,5745,-87,-96,9,,258725287,28,335,258725259,258725287
10989,5,24,149,5745,-87,-96,9,,258732052,28,6737,258732024,258732052
10990,5,12,149,5745,-72,-96,24,22:ec:75:a8:8a:31,258732460,272,136,258732188,258732460
10991,5,24,149,5745,-86,-96,10,,258738579,28,6091,258738551,258738579
10992,5,24,149,5745,-87,-96,9,,258740554,28,1947,258740526,258740554
10993,5,24,149,5745,-85,-96,11,,258740887,28,305,258740859,258740887
10994,5,24,149,5745,-86,-96,10,,258747706,28,6791,258747678,258747706
10995,5,24,149,5745,-87,-96,9,,258747815,32,77,258747783,258747815
10996,5,6,149,5745,-81,-96,15,54:e4:3a:ec:fb:65,258748685,360,510,258748325,258748685
10997,5,12,149,5745,-59,-96,37,3e:d1:9b:c7:a4:de,258756259,272,7302,258755987,258756259
10998,5,24,149,5745,-85,-96,11,,258762853,28,6566,258762825,258762853
10999,5,24,149,5745,-86,-96,10,,258763206,28,325,258763178,258763206
11000,5,12,149,5745,-56,-96,40,5e:29:73:5b:30:00,258764610,272,1132,258764338,258764610
11001,5,24,149,5745,-86,-96,10,,258769962,32,5320,258769930,258769962
11002,5,12,149,5745,-73,-96,23,72:d1:72:1d:22:a1,258773311,256,3093,258773055,258773311
11003,5,12,149,5745,-71,-96,25,56:68:e2:c2:8d:d5,258775444,284,1849,258775160,258775444
11004,5,24,149,5745,-86,-96,10,,258779125,28,3653,258779097,258779125
11005,5,24,149,5745,-85,-96,11,,258779481,28,328,258779453,258779481
11006,5,24,149,5745,-85,-96,11,,258786471,32,6958,258786439,258786471
11007,5,12,149,5745,-71,-96,25,f6:0a:5c:59:72:df,258790256,284,3501,258789972,258790256
11008,5,24,149,5745,-86,-96,10,,258796989,32,6701,258796957,258796989
11009,5,24,149,5745,-87,-96,9,,258814806,32,17785,258814774,258814806
11010,5,24,149,5745,-86,-96,10,,258815147,28,313,258815119,258815147
11011,5,24,149,5745,-86,-96,10,,258822580,28,7405,258822552,258822580
11012,5,24,149,5745,-87,-96,9,,258822933,28,325,258822905,258822933
11013,5,12,149,5745,-73,-96,23,3e:ef:29:c7:4b:17,258827106,272,3901,258826834,258827106
11014,5,24,149,5745,-87,-96,9,,258839651,28,12517,258839623,258839651
11015,5,24,149,5745,-86,-96,10,,258839961,28,282,258839933,258839961
11016,5,12,149,5745,-77,-96,19,22:ec:75:a8:8a:31,258844750,272,4517,258844478,258844750
11017,5,24,149,5745,-86,-96,10,,258846754,32,1972,258846722,258846754
11018,5,12,149,5745,-81,-96,15,9a:24:38:da:96:bb,258848235,272,1209,258847963,258848235
11019,5,6,149,5745,-84,-96,12,54:e4:3a:ec:fb:65,258851086,360,2491,258850726,258851086
11020,5,12,149,5745,-64,-96,32,f2:da:61:dd:98:c5,258851903,268,549,258851635,258851903
11021,5,24,149,5745,-86,-96,10,,258857988,28,6057,258857960,258857988
11022,5,24,149,5745,-86,-96,10,,258858416,32,396,258858384,258858416
11023,5,24,149,5745,-87,-96,9,,258858555,28,111,258858527,258858555
11024,5,24,149,5745,-86,-96,10,,258858815,28,232,258858787,258858815
11025,5,24,149,5745,-85,-96,11,,258864950,28,6107,258864922,258864950
11026,5,24,149,5745,-85,-96,11,,258865439,32,457,258865407,258865439
11027,5,24,149,5745,-86,-96,10,,258866867,28,1400,258866839,258866867
11028,5,24,149,5745,-86,-96,10,,258867177,28,282,258867149,258867177
11029,5,24,149,5745,-87,-96,9,,258871439,32,4230,258871407,258871439
11030,5,12,149,5745,-55,-96,41,3e:d1:9b:c7:a4:de,258873851,272,2140,258873579,258873851
11031,5,12,149,5745,-67,-96,29,fa:44:8d:e1:c7:1b,258875655,244,1560,258875411,258875655
11032,5,12,149,5745,-67,-96,29,b6:90:18:f6:b1:d4,258876049,244,150,258875805,258876049
11033,5,12,149,5745,-72,-96,24,72:d1:72:1d:22:a1,258876322,256,17,258876066,258876322
11034,5,12,149,5745,-76,-96,20,56:68:e2:c2:8d:d5,258876709,284,103,258876425,258876709
11035,5,12,149,5745,-63,-96,33,5e:29:73:5b:30:00,258881696,272,4715,258881424,258881696
11036,5,24,149,5745,-85,-96,11,,258890482,28,8758,258890454,258890482
11037,5,24,149,5745,-86,-96,10,,258890855,28,345,258890827,258890855
11038,5,24,149,5745,-86,-96,10,,258897256,32,6369,258897224,258897256
11039,5,24,149,5745,-85,-96,11,,258898282,28,998,258898254,258898282
11040,5,24,149,5745,-85,-96,11,,258898610,28,300,258898582,258898610
11041,5,24,149,5745,-86,-96,10,,258905698,32,7056,258905666,258905698
11042,5,12,149,5745,-47,-96,49,0e:ae:b4:1e:a1:11,258906018,240,80,258905778,258906018
11043,5,12,149,5745,-73,-96,23,3e:ef:29:c7:4b:17,258929801,272,23511,258929529,258929801
11044,5,24,149,5745,-88,-96,8,,258938328,28,8499,258938300,258938328
11045,5,24,149,5745,-87,-96,9,,258938693,28,337,258938665,258938693
11046,5,12,149,5745,-79,-96,17,9a:24:38:da:96:bb,258943940,272,4975,258943668,258943940
11047,5,24,149,5745,-88,-96,8,,258944516,28,548,258944488,258944516
11048,5,24,149,5745,-87,-96,9,,258944628,32,80,258944596,258944628
11049,5,24,149,5745,-88,-96,8,,258947958,28,3302,258947930,258947958
11050,5,24,149,5745,-87,-96,9,,258948269,28,283,258948241,258948269
11051,5,24,149,5745,-87,-96,9,,258950983,28,2686,258950955,258950983
11052,5,6,149,5745,-86,-96,10,54:e4:3a:ec:fb:65,258953486,360,2143,258953126,258953486
11053,5,12,149,5745,-65,-96,31,f2:da:61:dd:98:c5,258954178,268,424,258953910,258954178
11054,5,24,149,5745,-88,-96,8,,258956315,32,2105,258956283,258956315
11055,5,12,149,5745,-74,-96,22,22:ec:75:a8:8a:31,258957002,272,415,258956730,258957002
11056,5,24,149,5745,-87,-96,9,,258962314,28,5284,258962286,258962314
11057,5,12,149,5745,-69,-96,27,fa:44:8d:e1:c7:1b,258978016,244,15458,258977772,258978016
11058,5,12,149,5745,-75,-96,21,72:d1:72:1d:22:a1,258978374,256,102,258978118,258978374
11059,5,12,149,5745,-66,-96,30,b6:90:18:f6:b1:d4,258978669,244,51,258978425,258978669
11060,5,12,149,5745,-75,-96,21,56:68:e2:c2:8d:d5,258979044,284,91,258978760,258979044
11061,5,12,149,5745,-53,-96,43,3e:d1:9b:c7:a4:de,258990835,272,11519,258990563,258990835
11062,5,12,149,5745,-60,-96,36,5e:29:73:5b:30:00,258998642,272,7535,258998370,258998642
11063,5,12,149,5745,-46,-96,50,0e:ae:b4:1e:a1:11,259025558,240,26676,259025318,259025558
11064,5,12,149,5745,-71,-96,25,fa:44:8d:e1:c7:1b,259025931,244,129,259025687,259025931
11065,5,12,149,5745,-74,-96,22,3e:ef:29:c7:4b:17,259029443,272,3240,259029171,259029443
11066,5,12,149,5745,-66,-96,30,b6:90:18:f6:b1:d4,259030493,244,806,259030249,259030493
11067,5,24,149,5745,-90,-96,6,,259035408,28,4887,259035380,259035408
11068,5,12,149,5745,-73,-96,23,72:d1:72:1d:22:a1,259053271,256,17607,259053015,259053271
11069,5,24,149,5745,-89,-96,7,,259053678,28,379,259053650,259053678
11070,5,6,149,5745,-83,-96,13,54:e4:3a:ec:fb:65,259055887,360,1849,259055527,259055887
11071,5,12,149,5745,-63,-96,33,f2:da:61:dd:98:c5,259057308,268,1153,259057040,259057308
11072,5,24,149,5745,-88,-96,8,,259059515,28,2179,259059487,259059515
11073,5,24,149,5745,-74,-96,22,,259063398,28,3855,259063370,259063398
11074,5,24,149,5745,-88,-96,8,,259063442,28,16,259063414,259063442
11075,5,24,149,5745,-88,-96,8,,259063550,28,80,259063522,259063550
11076,5,24,149,5745,-89,-96,7,,259066724,28,3146,259066696,259066724
11077,5,24,149,5745,-89,-96,7,,259066832,32,76,259066800,259066832
11078,5,24,149,5745,-89,-96,7,,259066925,28,65,259066897,259066925
11079,5,24,149,5745,-88,-96,8,,259067136,28,183,259067108,259067136
11080,5,24,149,5745,-88,-96,8,,259067449,28,285,259067421,259067449
11081,5,24,149,5745,-88,-96,8,,259069476,28,1999,259069448,259069476
11082,5,24,149,5745,-89,-96,7,,259076565,32,7057,259076533,259076565
11083,5,12,149,5745,-76,-96,20,56:68:e2:c2:8d:d5,259080789,284,3940,259080505,259080789
11084,5,12,149,5745,-70,-96,26,22:ec:75:a8:8a:31,259082007,272,946,259081735,259082007
11085,5,24,149,5745,-89,-96,7,,259083831,28,1796,259083803,259083831
11086,5,12,149,5745,-70,-96,26,22:ec:75:a8:8a:31,259086257,544,1882,259085713,259086257
11087,5,12,149,5745,-72,-96,24,f6:0a:5c:59:72:df,259090271,480,3534,259089791,259090271
11088,5,24,149,5745,-89,-96,7,,259091019,32,716,259090987,259091019
11089,5,12,149,5745,-66,-96,30,b6:90:18:f6:b1:d4,259093560,440,2101,259093120,259093560
11090,5,12,149,5745,-72,-96,24,f6:0a:5c:59:72:df,259094545,284,701,259094261,259094545
11091,5,12,149,5745,-54,-96,42,3e:d1:9b:c7:a4:de,259096248,544,1159,259095704,259096248
11092,5,12,149,5745,-74,-96,22,fa:44:8d:e1:c7:1b,259098358,440,1670,259097918,259098358
11093,5,12,149,5745,-46,-96,50,0e:ae:b4:1e:a1:11,259098949,240,351,259098709,259098949
11094,5,12,149,5745,-59,-96,37,5e:29:73:5b:30:00,259101851,540,2362,259101311,259101851
11095,5,24,149,5745,-88,-96,8,,259102561,28,682,259102533,259102561
11096,5,24,149,5745,-88,-96,8,,259102927,28,338,259102899,259102927
11097,5,12,149,5745,-75,-96,21,56:68:e2:c2:8d:d5,259103701,480,294,259103221,259103701
11098,5,12,149,5745,-75,-96,21,72:d1:72:1d:22:a1,259104225,452,72,259103773,259104225
11099,5,12,149,5745,-61,-96,35,f2:da:61:dd:98:c5,259107201,268,2708,259106933,259107201
11100,5,12,149,5745,-74,-96,22,3e:ef:29:c7:4b:17,259107566,468,-103,259107098,259107566
11101,5,24,149,5745,-87,-96,9,,259109128,28,1534,259109100,259109128
11102,5,24,149,5745,-88,-96,8,,259109237,32,77,259109205,259109237
11103,5,12,149,5745,-45,-96,51,0e:ae:b4:1e:a1:11,259115045,240,5568,259114805,259115045
11104,5,12,149,5745,-55,-96,41,3e:d1:9b:c7:a4:de,259115364,272,47,259115092,259115364
11105,5,24,149,5745,-87,-96,9,,259118149,28,2757,259118121,259118149
11106,5,24,149,5745,-86,-96,10,,259118501,28,324,259118473,259118501
11107,5,24,149,5745,-87,-96,9,,259125040,28,6511,259125012,259125040
11108,5,24,149,5745,-86,-96,10,,259125148,32,76,259125116,259125148
11109,5,12,149,5745,-73,-96,23,fa:44:8d:e1:c7:1b,259130452,244,5060,259130208,259130452
11110,5,12,149,5745,-66,-96,30,b6:90:18:f6:b1:d4,259132861,244,2165,259132617,259132861
11111,5,12,149,5745,-61,-96,35,f2:da:61:dd:98:c5,259133140,268,11,259132872,259133140
11112,5,12,149,5745,-56,-96,40,5e:29:73:5b:30:00,259133577,272,165,259133305,259133577
11113,5,12,149,5745,-74,-96,22,3e:ef:29:c7:4b:17,259134488,272,639,259134216,259134488
11114,5,24,149,5745,-87,-96,9,,259138240,28,3724,259138212,259138240
11115,5,24,149,5745,-87,-96,9,,259138596,28,328,259138568,259138596
11116,5,24,149,5745,-86,-96,10,,259144865,28,6241,259144837,259144865
11117,5,24,149,5745,-86,-96,10,,259144973,32,76,259144941,259144973
11118,5,12,149,5745,-80,-96,16,9a:24:38:da:96:bb,259151124,824,5327,259150300,259151124
11119,5,12,149,5745,-70,-96,26,22:ec:75:a8:8a:31,259152127,544,459,259151583,259152127
11120,5,24,149,5745,-87,-96,9,,259152795,28,640,259152767,259152795
11121,5,24,149,5745,-86,-96,10,,259153154,28,331,259153126,259153154
11122,5,12,149,5745,-72,-96,24,f6:0a:5c:59:72:df,259153508,480,-126,259153028,259153508
11123,5,12,149,5745,-71,-96,25,fa:44:8d:e1:c7:1b,259157042,360,3174,259156682,259157042
11124,5,12,149,5745,-65,-96,31,b6:90:18:f6:b1:d4,259157887,440,405,259157447,259157887
11125,5,24,149,5745,-86,-96,10,,259159875,28,1960,259159847,259159875
11126,5,24,149,5745,-86,-96,10,,259159984,32,77,259159952,259159984
11127,5,12,149,5745,-58,-96,38,3e:d1:9b:c7:a4:de,259161155,544,627,259160611,259161155
11128,5,12,149,5745,-45,-96,51,0e:ae:b4:1e:a1:11,259161760,240,365,259161520,259161760
11129,5,12,149,5745,-71,-96,25,fa:44:8d:e1:c7:1b,259162081,440,-119,259161641,259162081
11130,5,12,149,5745,-77,-96,19,d2:00:04:7e:2c:ab,259163835,440,1314,259163395,259163835
11131,5,12,149,5745,-74,-96,22,72:d1:72:1d:22:a1,259164409,256,318,259164153,259164409
11132,5,12,149,5745,-71,-96,25,a6:92:ad:b7:76:65,259166040,484,1147,259165556,259166040
11133,5,12,149,5745,-81,-96,15,9a:24:38:da:96:bb,259166637,272,325,259166365,259166637
11134,5,24,149,5745,-88,-96,8,,259167225,28,560,259167197,259167225
11135,5,24,149,5745,-87,-96,9,,259167334,32,77,259167302,259167334
11136,5,12,149,5745,-56,-96,40,5e:29:73:5b:30:00,259167386,540,-488,259166846,259167386
11137,5,12,149,5745,-73,-96,23,56:68:e2:c2:8d:d5,259167988,480,122,259167508,259167988
11138,5,24,149,5745,-87,-96,9,,259168508,28,492,259168480,259168508
11139,5,24,149,5745,-87,-96,9,,259168863,28,327,259168835,259168863
11140,5,12,149,5745,-75,-96,21,72:d1:72:1d:22:a1,259169728,452,413,259169276,259169728
11141,5,12,149,5745,-74,-96,22,3e:ef:29:c7:4b:17,259171692,468,1496,259171224,259171692
11142,5,12,149,5745,-58,-96,38,0a:b9:b7:b1:4d:fa,259172230,268,270,259171962,259172230
11143,5,12,149,5745,-65,-96,31,f2:da:61:dd:98:c5,259172577,268,79,259172309,259172577
11144,5,24,149,5745,-86,-96,10,,259175770,32,3161,259175738,259175770
11145,5,24,149,5745,-87,-96,9,,259185322,28,9524,259185294,259185322
11146,5,24,149,5745,-88,-96,8,,259189129,28,3779,259189101,259189129
11147,5,24,149,5745,-87,-96,9,,259196325,28,7168,259196297,259196325
11148,5,24,149,5745,-87,-96,9,,259196433,32,76,259196401,259196433
11149,5,12,149,5745,-71,-96,25,22:ec:75:a8:8a:31,259197544,272,839,259197272,259197544
11150,5,12,149,5745,-71,-96,25,56:68:e2:c2:8d:d5,259198876,284,1048,259198592,259198876
11151,5,24,149,5745,-88,-96,8,,259204867,28,5963,259204839,259204867
11152,5,24,149,5745,-88,-96,8,,259205222,28,327,259205194,259205222
11153,5,24,149,5745,-89,-96,7,,259211527,32,6273,259211495,259211527
11154,5,24,149,5745,-88,-96,8,,259219319,28,7764,259219291,259219319
11155,5,12,149,5745,-54,-96,42,3e:d1:9b:c7:a4:de,259220283,272,692,259220011,259220283
11156,5,24,149,5745,-89,-96,7,,259226722,28,6411,259226694,259226722
11157,5,12,149,5745,-59,-96,37,5e:29:73:5b:30:00,259226881,272,-113,259226609,259226881
11158,5,24,149,5745,-89,-96,7,,259235577,28,8668,259235549,259235577
11159,5,24,149,5745,-89,-96,7,,259235929,28,324,259235901,259235929
11160,5,12,149,5745,-68,-96,28,f6:0a:5c:59:72:df,259237515,284,1302,259237231,259237515
11161,5,12,149,5745,-73,-96,23,3e:ef:29:c7:4b:17,259246934,272,9147,259246662,259246934
11162,5,24,149,5745,-72,-96,24,,259248125,28,1163,259248097,259248125
11163,5,24,149,5745,-88,-96,8,,259248169,28,16,259248141,259248169
11164,5,24,149,5745,-90,-96,6,,259248277,28,80,259248249,259248277
11165,5,12,149,5745,-72,-96,24,fa:44:8d:e1:c7:1b,259252528,244,4007,259252284,259252528
11166,5,12,149,5745,-64,-96,32,b6:90:18:f6:b1:d4,259254842,244,2070,259254598,259254842
11167,5,12,149,5745,-62,-96,34,f2:da:61:dd:98:c5,259256325,268,1215,259256057,259256325
11168,5,6,149,5745,-85,-96,11,54:e4:3a:ec:fb:65,259260688,360,4003,259260328,259260688
11169,5,24,149,5745,-89,-96,7,,259266633,28,5917,259266605,259266633
11170,5,24,149,5745,-90,-96,6,,259266920,28,259,259266892,259266920
11171,5,24,149,5745,-89,-96,7,,259267541,28,593,259267513,259267541
11172,5,12,149,5745,-73,-96,23,72:d1:72:1d:22:a1,259278574,256,10777,259278318,259278574
11173,5,12,149,5745,-80,-96,16,9a:24:38:da:96:bb,259279625,272,779,259279353,259279625
11174,5,24,149,5745,-88,-96,8,,259282058,28,2405,259282030,259282058
11175,5,24,149,5745,-92,-96,4,,259288388,32,6298,259288356,259288388
11176,5,12,149,5745,-72,-96,24,22:ec:75:a8:8a:31,259299789,272,11129,259299517,259299789
11177,5,24,149,5745,-90,-96,6,,259303645,28,3828,259303617,259303645
11178,5,24,149,5745,-89,-96,7,,259304097,28,424,259304069,259304097
11179,5,24,149,5745,-74,-96,22,,259308330,28,4205,259308302,259308330
11180,5,24,149,5745,-89,-96,7,,259308374,28,16,259308346,259308374
11181,5,24,149,5745,-89,-96,7,,259308482,28,80,259308454,259308482
11182,5,24,149,5745,-90,-96,6,,259310725,32,2211,259310693,259310725
11183,5,24,149,5745,-88,-96,8,,259315987,28,5234,259315959,259315987
11184,5,24,149,5745,-88,-96,8,,259316334,28,319,259316306,259316334
11185,5,24,149,5745,-88,-96,8,,259320820,32,4454,259320788,259320820
11186,5,24,149,5745,-90,-96,6,,259321310,32,458,259321278,259321310
11187,5,24,149,5745,-88,-96,8,,259322810,28,1472,259322782,259322810
11188,5,24,149,5745,-89,-96,7,,259322919,32,77,259322887,259322919
11189,5,24,149,5745,-89,-96,7,,259328502,28,5555,259328474,259328502
11190,5,24,149,5745,-90,-96,6,,259328849,28,319,259328821,259328849
11191,5,12,149,5745,-53,-96,43,3e:d1:9b:c7:a4:de,259335942,272,6821,259335670,259335942
11192,5,24,149,5745,-92,-96,4,,259338841,32,2867,259338809,259338841
11193,5,12,149,5745,-60,-96,36,5e:29:73:5b:30:00,259343807,272,4694,259343535,259343807
11194,5,24,149,5745,-89,-96,7,,259352910,28,9075,259352882,259352910
11195,5,12,149,5745,-45,-96,51,0e:ae:b4:1e:a1:11,259359018,240,5868,259358778,259359018
11196,5,6,149,5745,-84,-96,12,54:e4:3a:ec:fb:65,259363089,360,3711,259362729,259363089
11197,5,12,149,5745,-61,-96,35,f2:da:61:dd:98:c5,259369141,268,5784,259368873,259369141
11198,5,24,149,5745,-72,-96,24,,259369791,28,622,259369763,259369791
11199,5,24,149,5745,-90,-96,6,,259369835,28,16,259369807,259369835
11200,5,24,149,5745,-88,-96,8,,259369943,28,80,259369915,259369943
11201,5,12,149,5745,-64,-96,32,b6:90:18:f6:b1:d4,259387538,244,17351,259387294,259387538
11202,5,12,149,5745,-70,-96,26,fa:44:8d:e1:c7:1b,259387944,244,162,259387700,259387944
11203,5,12,149,5745,-72,-96,24,56:68:e2:c2:8d:d5,259389840,284,1612,259389556,259389840
11204,5,12,149,5745,-72,-96,24,72:d1:72:1d:22:a1,259391830,256,1734,259391574,259391830
11205,5,24,149,5745,-88,-96,8,,259400965,28,9107,259400937,259400965
11206,5,24,149,5745,-88,-96,8,,259407583,32,6586,259407551,259407583
11207,5,12,149,5745,-70,-96,26,22:ec:75:a8:8a:31,259415658,272,7803,259415386,259415658
11208,5,24,149,5745,-85,-96,11,,259441272,28,25586,259441244,259441272
11209,5,12,149,5745,-78,-96,18,3e:ef:29:c7:4b:17,259441512,272,-32,259441240,259441512
11210,5,24,149,5745,-88,-96,8,,259448285,28,6745,259448257,259448285
11211,5,24,149,5745,-86,-96,10,,259448393,32,76,259448361,259448393
11212,5,12,149,5745,-53,-96,43,3e:d1:9b:c7:a4:de,259449837,272,1172,259449565,259449837
11213,5,12,149,5745,-58,-96,38,5e:29:73:5b:30:00,259457745,272,7636,259457473,259457745
11214,5,24,149,5745,-87,-96,9,,259461122,28,3349,259461094,259461122
11215,5,6,149,5745,-85,-96,11,54:e4:3a:ec:fb:65,259465489,360,4007,259465129,259465489
11216,5,24,149,5745,-87,-96,9,,259468196,28,2679,259468168,259468196
11217,5,24,149,5745,-88,-96,8,,259468937,28,713,259468909,259468937
11218,5,24,149,5745,-88,-96,8,,259469339,32,370,259469307,259469339
11219,5,24,149,5745,-87,-96,9,,259469577,28,210,259469549,259469577
11220,5,12,149,5745,-61,-96,35,f2:da:61:dd:98:c5,259478544,268,8699,259478276,259478544
11221,5,24,149,5745,-88,-96,8,,259479969,28,1397,259479941,259479969
11222,5,12,149,5745,-78,-96,18,3e:ef:29:c7:4b:17,259483636,272,3395,259483364,259483636
11223,5,24,149,5745,-88,-96,8,,259488134,28,4470,259488106,259488134
11224,5,24,149,5745,-88,-96,8,,259488480,28,318,259488452,259488480
11225,5,12,149,5745,-73,-96,23,fa:44:8d:e1:c7:1b,259490090,244,1366,259489846,259490090
11226,5,12,149,5745,-63,-96,33,b6:90:18:f6:b1:d4,259490417,244,83,259490173,259490417
11227,5,12,149,5745,-73,-96,23,56:68:e2:c2:8d:d5,259490990,284,289,259490706,259490990
11228,5,12,149,5745,-72,-96,24,72:d1:72:1d:22:a1,259502724,256,11478,259502468,259502724
11229,5,24,149,5745,-88,-96,8,,259504429,28,1677,259504401,259504429
11230,5,24,149,5745,-88,-96,8,,259504779,28,322,259504751,259504779
11231,5,12,149,5745,-77,-96,19,9a:24:38:da:96:bb,259507479,272,2428,259507207,259507479
11232,5,24,149,5745,-90,-96,6,,259511493,32,3982,259511461,259511493
11233,5,12,149,5745,-72,-96,24,fa:44:8d:e1:c7:1b,259526396,48,14855,259526348,259526396
11234,5,12,149,5745,-64,-96,32,,259526460,32,32,259526428,259526460
11235,5,12,149,5745,-70,-96,26,22:ec:75:a8:8a:31,259540753,272,14021,259540481,259540753
11236,5,12,149,5745,-72,-96,24,56:68:e2:c2:8d:d5,259543056,284,2019,259542772,259543056
11237,5,12,149,5745,-82,-96,14,9a:24:38:da:96:bb,259544205,824,325,259543381,259544205
11238,5,12,149,5745,-67,-96,29,f6:0a:5c:59:72:df,259545696,284,1207,259545412,259545696
11239,5,12,149,5745,-70,-96,26,22:ec:75:a8:8a:31,259546068,544,-172,259545524,259546068
11240,5,12,149,5745,-67,-96,29,f6:0a:5c:59:72:df,259547564,480,1016,259547084,259547564
11241,5,12,149,5745,-64,-96,32,b6:90:18:f6:b1:d4,259552134,440,4130,259551694,259552134
11242,5,12,149,5745,-45,-96,51,0e:ae:b4:1e:a1:11,259557205,240,4831,259556965,259557205
11243,5,12,149,5745,-69,-96,27,fa:44:8d:e1:c7:1b,259557489,440,-156,259557049,259557489
11244,5,12,149,5745,-56,-96,40,3e:d1:9b:c7:a4:de,259557972,544,-61,259557428,259557972
11245,5,24,149,5745,-87,-96,9,,259558677,28,677,259558649,259558677
11246,5,24,149,5745,-88,-96,8,,259559043,28,338,259559015,259559043
11247,5,12,149,5745,-60,-96,36,5e:29:73:5b:30:00,259562070,540,2487,259561530,259562070
11248,5,12,149,5745,-73,-96,23,72:d1:72:1d:22:a1,259563590,452,1068,259563138,259563590
11249,5,12,149,5745,-72,-96,24,56:68:e2:c2:8d:d5,259564454,480,384,259563974,259564454
11250,5,24,149,5745,-87,-96,9,,259565475,32,989,259565443,259565475
11251,5,12,149,5745,-77,-96,19,3e:ef:29:c7:4b:17,259566036,468,93,259565568,259566036
11252,5,12,149,5745,-46,-96,50,0e:ae:b4:1e:a1:11,259566594,240,318,259566354,259566594
11253,5,12,149,5745,-61,-96,35,f2:da:61:dd:98:c5,259567500,268,638,259567232,259567500
11254,5,6,149,5745,-87,-96,9,54:e4:3a:ec:fb:65,259567889,360,29,259567529,259567889
11255,5,24,149,5745,-73,-96,23,,259569082,28,1165,259569054,259569082
11256,5,24,149,5745,-87,-96,9,,259569126,28,16,259569098,259569126
11257,5,24,149,5745,-87,-96,9,,259569235,28,81,259569207,259569235
11258,5,12,149,5745,-56,-96,40,3e:d1:9b:c7:a4:de,259574082,272,4575,259573810,259574082
11259,5,12,149,5745,-68,-96,28,fa:44:8d:e1:c7:1b,259589177,244,14851,259588933,259589177
11260,5,12,149,5745,-64,-96,32,b6:90:18:f6:b1:d4,259591121,244,1700,259590877,259591121
11261,5,12,149,5745,-78,-96,18,3e:ef:29:c7:4b:17,259591518,272,125,259591246,259591518
11262,5,12,149,5745,-63,-96,33,f2:da:61:dd:98:c5,259591824,268,38,259591556,259591824
11263,5,12,149,5745,-58,-96,38,5e:29:73:5b:30:00,259592297,272,201,259592025,259592297
11264,5,24,149,5745,-87,-96,9,,259605264,28,12939,259605236,259605264
11265,5,24,149,5745,-87,-96,9,,259605637,28,345,259605609,259605637
11266,5,24,149,5745,-86,-96,10,,259612444,28,6779,259612416,259612444
11267,5,24,149,5745,-88,-96,8,,259612553,32,77,259612521,259612553
11268,5,12,149,5745,-65,-96,31,b6:90:18:f6:b1:d4,259616651,440,3658,259616211,259616651
11269,5,12,149,5745,-79,-96,17,9a:24:38:da:96:bb,259617258,272,335,259616986,259617258
11270,5,12,149,5745,-68,-96,28,fa:44:8d:e1:c7:1b,259620645,440,2947,259620205,259620645
11271,5,12,149,5745,-74,-96,22,72:d1:72:1d:22:a1,259621211,256,310,259620955,259621211
11272,5,12,149,5745,-62,-96,34,f2:da:61:dd:98:c5,259631221,268,9742,259630953,259631221
11273,5,12,149,5745,-69,-96,27,22:ec:75:a8:8a:31,259645487,272,13994,259645215,259645487
11274,5,12,149,5745,-69,-96,27,56:68:e2:c2:8d:d5,259657599,284,11828,259657315,259657599
11275,5,6,149,5745,-85,-96,11,54:e4:3a:ec:fb:65,259670290,360,12331,259669930,259670290
11276,5,12,149,5745,-78,-96,18,9a:24:38:da:96:bb,259676218,824,5104,259675394,259676218
11277,5,12,149,5745,-70,-96,26,22:ec:75:a8:8a:31,259678175,544,1413,259677631,259678175
11278,5,12,149,5745,-48,-96,48,0e:ae:b4:1e:a1:11,259678762,240,347,259678522,259678762
11279,5,24,149,5745,-87,-96,9,,259679154,28,364,259679126,259679154
11280,5,24,149,5745,-88,-96,8,,259679514,28,332,259679486,259679514
11281,5,12,149,5745,-65,-96,31,b6:90:18:f6:b1:d4,259681535,440,1581,259681095,259681535
11282,5,12,149,5745,-73,-96,23,d2:00:04:7e:2c:ab,259682379,440,404,259681939,259682379
11283,5,12,149,5745,-71,-96,25,f6:0a:5c:59:72:df,259683170,284,507,259682886,259683170
11284,5,12,149,5745,-68,-96,28,fa:44:8d:e1:c7:1b,259686982,440,3372,259686542,259686982
11285,5,12,149,5745,-57,-96,39,3e:d1:9b:c7:a4:de,259687492,544,-34,259686948,259687492
11286,5,24,149,5745,-88,-96,8,,259688601,32,1077,259688569,259688601
11287,5,12,149,5745,-57,-96,39,3e:d1:9b:c7:a4:de,259688695,272,-178,259688423,259688695
11288,5,12,149,5745,-55,-96,41,5e:29:73:5b:30:00,259690306,272,1339,259690034,259690306
11289,5,12,149,5745,-69,-96,27,a6:92:ad:b7:76:65,259690693,484,-97,259690209,259690693
11290,5,12,149,5745,-49,-96,47,0e:ae:b4:1e:a1:11,259691597,240,664,259691357,259691597
11291,5,12,149,5745,-54,-96,42,5e:29:73:5b:30:00,259692780,540,643,259692240,259692780
11292,5,12,149,5745,-64,-96,32,f2:da:61:dd:98:c5,259696758,268,3710,259696490,259696758
11293,5,12,149,5745,-77,-96,19,3e:ef:29:c7:4b:17,259697132,468,-94,259696664,259697132
11294,5,12,149,5745,-66,-96,30,0a:b9:b7:b1:4d:fa,259697680,268,280,259697412,259697680
11295,5,24,149,5745,-87,-96,9,,259699328,28,1620,259699300,259699328
11296,5,12,149,5745,-68,-96,28,fa:44:8d:e1:c7:1b,259703452,244,3880,259703208,259703452
11297,5,12,149,5745,-66,-96,30,b6:90:18:f6:b1:d4,259705001,244,1305,259704757,259705001
11298,5,12,149,5745,-77,-96,19,3e:ef:29:c7:4b:17,259705784,272,511,259705512,259705784
11299,5,12,149,5745,-64,-96,32,f2:da:61:dd:98:c5,259706514,268,462,259706246,259706514
11300,5,12,149,5745,-78,-96,18,9a:24:38:da:96:bb,259729790,272,23004,259729518,259729790
11301,5,24,149,5745,-86,-96,10,,259748123,28,18305,259748095,259748123
11302,5,24,149,5745,-87,-96,9,,259748491,28,340,259748463,259748491
11303,5,24,149,5745,-87,-96,9,,259748947,28,428,259748919,259748947
11304,5,24,149,5745,-87,-96,9,,259755364,32,6385,259755332,259755364
11305,5,12,149,5745,-57,-96,39,3e:d1:9b:c7:a4:de,259755430,544,-478,259754886,259755430
11306,5,12,149,5745,-71,-96,25,22:ec:75:a8:8a:31,259758506,272,2804,259758234,259758506
11307,5,6,149,5745,-85,-96,11,54:e4:3a:ec:fb:65,259772691,360,13825,259772331,259772691
11308,5,12,149,5745,-72,-96,24,72:d1:72:1d:22:a1,259797402,256,24455,259797146,259797402
11309,5,12,149,5745,-70,-96,26,56:68:e2:c2:8d:d5,259799141,284,1455,259798857,259799141
11310,5,12,149,5745,-57,-96,39,5e:29:73:5b:30:00,259799459,272,46,259799187,259799459
11311,5,24,149,5745,-87,-96,9,,259803334,32,3843,259803302,259803334
11312,5,12,149,5745,-57,-96,39,3e:d1:9b:c7:a4:de,259803567,272,-39,259803295,259803567
11313,5,12,149,5745,-47,-96,49,0e:ae:b4:1e:a1:11,259804883,240,1076,259804643,259804883
11314,5,24,149,5745,-86,-96,10,,259819399,28,14488,259819371,259819399
11315,5,24,149,5745,-87,-96,9,,259819507,32,76,259819475,259819507
11316,5,12,149,5745,-58,-96,38,3e:d1:9b:c7:a4:de,259821013,544,962,259820469,259821013
11317,5,24,149,5745,-86,-96,10,,259822584,28,1543,259822556,259822584
11318,5,24,149,5745,-87,-96,9,,259838392,28,15780,259838364,259838392
11319,5,12,149,5745,-77,-96,19,9a:24:38:da:96:bb,259841466,272,2802,259841194,259841466
11320,5,12,149,5745,-77,-96,19,3e:ef:29:c7:4b:17,259851161,272,9423,259850889,259851161
11321,5,24,149,5745,-88,-96,8,,259864485,32,13292,259864453,259864485
11322,5,12,149,5745,-71,-96,25,22:ec:75:a8:8a:31,259874820,272,10063,259874548,259874820
11323,5,6,149,5745,-85,-96,11,54:e4:3a:ec:fb:65,259875124,360,-56,259874764,259875124
11324,5,12,149,5745,-63,-96,33,f2:da:61:dd:98:c5,259876021,268,629,259875753,259876021
11325,5,12,149,5745,-56,-96,40,3e:d1:9b:c7:a4:de,259886457,544,9892,259885913,259886457
11326,5,12,149,5745,-69,-96,27,fa:44:8d:e1:c7:1b,259899632,244,12931,259899388,259899632
11327,5,12,149,5745,-72,-96,24,72:d1:72:1d:22:a1,259900092,256,204,259899836,259900092
11328,5,12,149,5745,-67,-96,29,b6:90:18:f6:b1:d4,259900383,244,47,259900139,259900383
11329,5,12,149,5745,-71,-96,25,56:68:e2:c2:8d:d5,259901818,284,1151,259901534,259901818
11330,5,24,149,5745,-86,-96,10,,259903888,32,2038,259903856,259903888
11331,5,24,149,5745,-87,-96,9,,259914626,28,10710,259914598,259914626
11332,5,24,149,5745,-89,-96,7,,259914670,28,16,259914642,259914670
11333,5,12,149,5745,-57,-96,39,5e:29:73:5b:30:00,259915978,272,1036,259915706,259915978
11334,5,12,149,5745,-56,-96,40,3e:d1:9b:c7:a4:de,259918964,272,2714,259918692,259918964
11335,5,24,149,5745,-72,-96,24,,259924373,28,5381,259924345,259924373
11336,5,24,149,5745,-89,-96,7,,259924417,28,16,259924389,259924417
11337,5,24,149,5745,-87,-96,9,,259924526,28,81,259924498,259924526
11338,5,12,149,5745,-74,-96,22,3e:ef:29:c7:4b:17,259953909,272,29111,259953637,259953909
11339,5,12,149,5745,-78,-96,18,9a:24:38:da:96:bb,259954859,272,678,259954587,259954859
11340,5,6,149,5745,-88,-96,8,54:e4:3a:ec:fb:65,259977491,360,22272,259977131,259977491
11341,5,12,149,5745,-64,-96,32,f2:da:61:dd:98:c5,259978156,268,397,259977888,259978156
11342,5,24,149,5745,-71,-96,25,,259984749,28,6565,259984721,259984749
11343,5,24,149,5745,-87,-96,9,,259984901,28,124,259984873,259984901
11344,5,12,149,5745,-73,-96,23,22:ec:75:a8:8a:31,259988486,272,3313,259988214,259988486
11345,5,12,149,5745,-68,-96,28,fa:44:8d:e1:c7:1b,260002032,244,13302,260001788,260002032
11346,5,12,149,5745,-68,-96,28,b6:90:18:f6:b1:d4,260002372,244,96,260002128,260002372
11347,5,12,149,5745,-72,-96,24,72:d1:72:1d:22:a1,260002663,256,35,260002407,260002663
11348,5,12,149,5745,-72,-96,24,56:68:e2:c2:8d:d5,260004247,284,1300,260003963,260004247
11349,5,12,149,5745,-55,-96,41,3e:d1:9b:c7:a4:de,260011755,272,7236,260011483,260011755
11350,5,24,149,5745,-70,-96,26,,260017786,28,6003,260017758,260017786
11351,5,24,149,5745,-88,-96,8,,260017830,28,16,260017802,260017830
11352,5,24,149,5745,-87,-96,9,,260017938,28,80,260017910,260017938
11353,5,12,149,5745,-57,-96,39,5e:29:73:5b:30:00,260033264,272,15054,260032992,260033264
11354,5,12,149,5745,-72,-96,24,3e:ef:29:c7:4b:17,260055686,272,22150,260055414,260055686
11355,5,24,149,5745,-69,-96,27,,260061046,28,5332,260061018,260061046
11356,5,24,149,5745,-88,-96,8,,260061090,28,16,260061062,260061090
11357,5,24,149,5745,-88,-96,8,,260064985,32,3863,260064953,260064985
11358,5,24,149,5745,-89,-96,7,,260065521,32,504,260065489,260065521
11359,5,24,149,5745,-87,-96,9,,260066057,28,508,260066029,260066057
11360,5,6,149,5745,-86,-96,10,54:e4:3a:ec:fb:65,260079892,360,13475,260079532,260079892
11361,5,12,149,5745,-66,-96,30,f2:da:61:dd:98:c5,260081367,268,1207,260081099,260081367
11362,5,12,149,5745,-71,-96,25,22:ec:75:a8:8a:31,260100679,272,19040,260100407,260100679
11363,5,12,149,5745,-67,-96,29,b6:90:18:f6:b1:d4,260104157,244,3234,260103913,260104157
11364,5,12,149,5745,-70,-96,26,fa:44:8d:e1:c7:1b,260104446,244,45,260104202,260104446
11365,5,12,149,5745,-76,-96,20,72:d1:72:1d:22:a1,260104779,256,77,260104523,260104779
11366,5,12,149,5745,-71,-96,25,56:68:e2:c2:8d:d5,260105780,284,717,260105496,260105780
11367,5,12,149,5745,-67,-96,29,f6:0a:5c:59:72:df,260115979,284,9915,260115695,260115979
11368,5,24,149,5745,-88,-96,8,,260119764,28,3757,260119736,260119764
11369,5,24,149,5745,-90,-96,6,,260119808,28,16,260119780,260119808
11370,5,24,149,5745,-89,-96,7,,260119917,32,77,260119885,260119917
11371,5,12,149,5745,-56,-96,40,3e:d1:9b:c7:a4:de,260131227,272,11038,260130955,260131227
11372,5,12,149,5745,-72,-96,24,22:ec:75:a8:8a:31,260135971,544,4200,260135427,260135971
11373,5,12,149,5745,-67,-96,29,f6:0a:5c:59:72:df,260137494,480,1043,260137014,260137494
11374,5,12,149,5745,-67,-96,29,b6:90:18:f6:b1:d4,260140511,440,2577,260140071,260140511
11375,5,12,149,5745,-71,-96,25,fa:44:8d:e1:c7:1b,260145928,440,4977,260145488,260145928
11376,5,12,149,5745,-69,-96,27,fa:44:8d:e1:c7:1b,260146386,244,214,260146142,260146386
11377,5,12,149,5745,-67,-96,29,b6:90:18:f6:b1:d4,260147665,244,1035,260147421,260147665
11378,5,12,149,5745,-55,-96,41,3e:d1:9b:c7:a4:de,260148888,544,679,260148344,260148888
11379,5,12,149,5745,-65,-96,31,f2:da:61:dd:98:c5,260149477,268,321,260149209,260149477
11380,5,12,149,5745,-58,-96,38,5e:29:73:5b:30:00,260150517,540,500,260149977,260150517
11381,5,12,149,5745,-72,-96,24,56:68:e2:c2:8d:d5,260151228,480,231,260150748,260151228
11382,5,12,149,5745,-75,-96,21,72:d1:72:1d:22:a1,260153201,452,1521,260152749,260153201
11383,5,12,149,5745,-72,-96,24,3e:ef:29:c7:4b:17,260155084,468,1415,260154616,260155084
11384,5,12,149,5745,-65,-96,31,f2:da:61:dd:98:c5,260158505,268,3153,260158237,260158505
11385,5,12,149,5745,-72,-96,24,3e:ef:29:c7:4b:17,260164375,272,5598,260164103,260164375
11386,5,12,149,5745,-58,-96,38,5e:29:73:5b:30:00,260165391,272,744,260165119,260165391
11387,5,12,149,5745,-77,-96,19,9a:24:38:da:96:bb,260178489,272,12826,260178217,260178489
11388,5,12,149,5745,-73,-96,23,72:d1:72:1d:22:a1,260181288,256,2543,260181032,260181288
11389,5,6,149,5745,-84,-96,12,54:e4:3a:ec:fb:65,260182293,360,645,260181933,260182293
11390,5,12,149,5745,-71,-96,25,22:ec:75:a8:8a:31,260200635,544,17798,260200091,260200635
11391,5,12,149,5745,-70,-96,26,f6:0a:5c:59:72:df,260203238,480,2123,260202758,260203238
11392,5,12,149,5745,-67,-96,29,b6:90:18:f6:b1:d4,260205941,440,2263,260205501,260205941
11393,5,12,149,5745,-67,-96,29,fa:44:8d:e1:c7:1b,260210448,440,4067,260210008,260210448
11394,5,12,149,5745,-73,-96,23,56:68:e2:c2:8d:d5,260213712,284,2980,260213428,260213712
11395,5,12,149,5745,-55,-96,41,3e:d1:9b:c7:a4:de,260214058,544,-198,260213514,260214058
11396,5,12,149,5745,-73,-96,23,a6:92:ad:b7:76:65,260214690,484,148,260214206,260214690
11397,5,12,149,5745,-59,-96,37,5e:29:73:5b:30:00,260215667,540,437,260215127,260215667
11398,5,12,149,5745,-74,-96,22,56:68:e2:c2:8d:d5,260216629,480,482,260216149,260216629
11399,5,12,149,5745,-78,-96,18,9a:24:38:da:96:bb,260217658,824,205,260216834,260217658
11400,5,12,149,5745,-72,-96,24,72:d1:72:1d:22:a1,260220128,452,2018,260219676,260220128
11401,5,12,149,5745,-74,-96,22,3e:ef:29:c7:4b:17,260220651,468,55,260220183,260220651
11402,5,12,149,5745,-60,-96,36,0a:b9:b7:b1:4d:fa,260221180,268,261,260220912,260221180
11403,5,12,149,5745,-62,-96,34,f2:da:61:dd:98:c5,260221538,268,90,260221270,260221538
11404,5,12,149,5745,-70,-96,26,f6:0a:5c:59:72:df,260228198,284,6376,260227914,260228198
11405,5,12,149,5745,-72,-96,24,22:ec:75:a8:8a:31,260229011,272,541,260228739,260229011
11406,5,12,149,5745,-56,-96,40,3e:d1:9b:c7:a4:de,260246142,272,16859,260245870,260246142
11407,5,12,149,5745,-61,-96,35,5e:29:73:5b:30:00,260259805,272,13391,260259533,260259805
11408,5,12,149,5745,-67,-96,29,b6:90:18:f6:b1:d4,260275794,244,15745,260275550,260275794
11409,5,12,149,5745,-67,-96,29,f2:da:61:dd:98:c5,260277845,268,1783,260277577,260277845
11410,5,12,149,5745,-57,-96,39,3e:d1:9b:c7:a4:de,260279758,544,1369,260279214,260279758
11411,5,12,149,5745,-73,-96,23,3e:ef:29:c7:4b:17,260282094,272,2064,260281822,260282094
11412,5,6,149,5745,-85,-96,11,54:e4:3a:ec:fb:65,260284693,360,2239,260284333,260284693
11413,5,12,149,5745,-78,-96,18,9a:24:38:da:96:bb,260290696,272,5731,260290424,260290696
11414,5,12,149,5745,-72,-96,24,72:d1:72:1d:22:a1,260298853,256,7901,260298597,260298853
11415,5,12,149,5745,-70,-96,26,22:ec:75:a8:8a:31,260329062,272,29937,260328790,260329062
11416,5,12,149,5745,-59,-96,37,3e:d1:9b:c7:a4:de,260345164,544,15558,260344620,260345164
11417,5,12,149,5745,-59,-96,37,3e:d1:9b:c7:a4:de,260360559,272,15123,260360287,260360559
11418,5,24,149,5745,-69,-96,27,,260367830,28,7243,260367802,260367830
11419,5,12,149,5745,-63,-96,33,5e:29:73:5b:30:00,260375807,272,7705,260375535,260375807
11420,5,6,149,5745,-84,-96,12,54:e4:3a:ec:fb:65,260387094,360,10927,260386734,260387094
11421,5,12,149,5745,-64,-96,32,f2:da:61:dd:98:c5,260391052,268,3690,260390784,260391052
11422,5,12,149,5745,-78,-96,18,9a:24:38:da:96:bb,260403488,272,12164,260403216,260403488
11423,5,12,149,5745,-58,-96,38,3e:d1:9b:c7:a4:de,260410832,544,6800,260410288,260410832
11424,5,12,149,5745,-73,-96,23,56:68:e2:c2:8d:d5,260413819,284,2703,260413535,260413819
11425,5,12,149,5745,-62,-96,34,4a:ea:3c:f4:ce:b2,260425099,244,11036,260424855,260425099
11426,5,12,149,5745,-62,-96,34,4a:ea:3c:f4:ce:b2,260437396,116,12181,260437280,260437396
11427,5,12,149,5745,-62,-96,34,4a:ea:3c:f4:ce:b2,260437531,132,3,260437399,260437531
11428,5,12,149,5745,-61,-96,35,4a:ea:3c:f4:ce:b2,260437680,116,33,260437564,260437680
11429,5,12,149,5745,-61,-96,35,4a:ea:3c:f4:ce:b2,260437814,364,-230,260437450,260437814
11430,5,12,149,5745,-60,-96,36,4a:ea:3c:f4:ce:b2,260442029,440,3775,260441589,260442029
11431,5,12,149,5745,-70,-96,26,22:ec:75:a8:8a:31,260445698,272,3397,260445426,260445698
11432,5,12,149,5745,-57,-96,39,3e:d1:9b:c7:a4:de,260461820,272,15850,260461548,260461820
11433,5,12,149,5745,-71,-96,25,3e:ef:29:c7:4b:17,260465307,272,3215,260465035,260465307
11434,5,12,149,5745,-70,-96,26,f6:0a:5c:59:72:df,260477698,284,12107,260477414,260477698
11435,5,6,149,5745,-84,-96,12,54:e4:3a:ec:fb:65,260489494,360,11436,260489134,260489494
11436,5,12,149,5745,-60,-96,36,5e:29:73:5b:30:00,260492559,272,2793,260492287,260492559
11437,5,12,149,5745,-64,-96,32,f2:da:61:dd:98:c5,260502977,268,10150,260502709,260502977
11438,5,12,149,5745,-62,-96,34,4a:ea:3c:f4:ce:b2,260508895,468,5450,260508427,260508895
11439,5,12,149,5745,-66,-96,30,b6:90:18:f6:b1:d4,260513207,244,4068,260512963,260513207
11440,5,12,149,5745,-73,-96,23,56:68:e2:c2:8d:d5,260516275,284,2784,260515991,260516275
11441,5,12,149,5745,-78,-96,18,9a:24:38:da:96:bb,260516999,272,452,260516727,260516999
11442,5,12,149,5745,-72,-96,24,72:d1:72:1d:22:a1,260524490,256,7235,260524234,260524490
11443,5,24,149,5745,-86,-96,10,,260553798,32,29276,260553766,260553798
11444,5,12,149,5745,-72,-96,24,56:68:e2:c2:8d:d5,260560020,284,5938,260559736,260560020
11445,5,12,149,5745,-71,-96,25,22:ec:75:a8:8a:31,260563144,272,2852,260562872,260563144
11446,5,24,149,5745,-87,-96,9,,260567491,28,4319,260567463,260567491
11447,5,12,149,5745,-70,-96,26,3e:ef:29:c7:4b:17,260567772,272,9,260567500,260567772
11448,5,12,149,5745,-72,-96,24,f6:0a:5c:59:72:df,260573568,284,5512,260573284,260573568
11449,5,12,149,5745,-57,-96,39,3e:d1:9b:c7:a4:de,260589922,272,16082,260589650,260589922
11450,5,6,149,5745,-83,-96,13,54:e4:3a:ec:fb:65,260591895,360,1613,260591535,260591895
11451,5,12,149,5745,-70,-96,26,22:ec:75:a8:8a:31,260595658,544,3219,260595114,260595658
11452,5,12,149,5745,-73,-96,23,f6:0a:5c:59:72:df,260596263,480,125,260595783,260596263
11453,5,12,149,5745,-67,-96,29,b6:90:18:f6:b1:d4,260600810,440,4107,260600370,260600810
11454,5,12,149,5745,-67,-96,29,b6:90:18:f6:b1:d4,260605794,244,4740,260605550,260605794
11455,5,12,149,5745,-63,-96,33,f2:da:61:dd:98:c5,260607134,268,1072,260606866,260607134
11456,5,12,149,5745,-57,-96,39,3e:d1:9b:c7:a4:de,260607652,544,-26,260607108,260607652
11457,5,12,149,5745,-72,-96,24,a6:92:ad:b7:76:65,260608257,484,121,260607773,260608257
11458,5,12,149,5745,-72,-96,24,56:68:e2:c2:8d:d5,260611493,480,2756,260611013,260611493
11459,5,12,149,5745,-59,-96,37,5e:29:73:5b:30:00,260612113,540,80,260611573,260612113
11460,5,12,149,5745,-70,-96,26,72:d1:72:1d:22:a1,260613166,452,601,260612714,260613166
11461,5,12,149,5745,-70,-96,26,3e:ef:29:c7:4b:17,260613663,468,29,260613195,260613663
11462,5,12,149,5745,-63,-96,33,f2:da:61:dd:98:c5,260616154,268,2223,260615886,260616154
11463,5,12,149,5745,-61,-96,35,4a:ea:3c:f4:ce:b2,260617191,272,765,260616919,260617191
11464,5,12,149,5745,-70,-96,26,72:d1:72:1d:22:a1,260622476,256,5029,260622220,260622476
11465,5,12,149,5745,-70,-96,26,3e:ef:29:c7:4b:17,260623215,272,467,260622943,260623215
11466,5,12,149,5745,-60,-96,36,5e:29:73:5b:30:00,260624169,272,682,260623897,260624169
11467,5,12,149,5745,-80,-96,16,9a:24:38:da:96:bb,260627936,272,3495,260627664,260627936
11468,5,24,149,5745,-88,-96,8,,260645043,28,17079,260645015,260645043
11469,5,12,149,5745,-61,-96,35,4a:ea:3c:f4:ce:b2,260659447,468,13936,260658979,260659447
11470,5,24,149,5745,-86,-96,10,,260662931,28,3456,260662903,260662931
11471,5,12,149,5745,-67,-96,29,b6:90:18:f6:b1:d4,260664068,440,697,260663628,260664068
11472,5,12,149,5745,-74,-96,22,aa:b6:ae:27:64:4e,260670540,440,6032,260670100,260670540
11473,5,12,149,5745,-71,-96,25,a6:92:ad:b7:76:65,260671788,484,764,260671304,260671788
11474,5,12,149,5745,-56,-96,40,3e:d1:9b:c7:a4:de,260672441,544,109,260671897,260672441
11475,5,12,149,5745,-69,-96,27,56:68:e2:c2:8d:d5,260675008,284,2283,260674724,260675008
11476,5,12,149,5745,-71,-96,25,22:ec:75:a8:8a:31,260677086,272,1806,260676814,260677086
11477,5,12,149,5745,-62,-96,34,f2:da:61:dd:98:c5,260679750,268,2396,260679482,260679750
11478,5,12,149,5745,-55,-96,41,3e:d1:9b:c7:a4:de,260686604,272,6582,260686332,260686604
11479,5,12,149,5745,-65,-96,31,76:d6:6a:bb:b3:f5,260696647,380,9663,260696267,260696647
11480,5,12,149,5745,-70,-96,26,a6:92:ad:b7:76:65,260704536,284,7605,260704252,260704536
11481,5,12,149,5745,-60,-96,36,4a:ea:3c:f4:ce:b2,260706349,272,1541,260706077,260706349
11482,5,12,149,5745,-67,-96,29,b6:90:18:f6:b1:d4,260720544,244,13951,260720300,260720544
11483,5,12,149,5745,-60,-96,36,f2:da:61:dd:98:c5,260721822,268,1010,260721554,260721822
11484,5,12,149,5745,-71,-96,25,3e:ef:29:c7:4b:17,260722255,272,161,260721983,260722255
11485,5,12,149,5745,-59,-96,37,4a:ea:3c:f4:ce:b2,260723840,468,1117,260723372,260723840
11486,5,12,149,5745,-71,-96,25,22:ec:75:a8:8a:31,260727645,544,3261,260727101,260727645
11487,5,12,149,5745,-55,-96,41,3e:d1:9b:c7:a4:de,260728223,544,34,260727679,260728223
11488,5,12,149,5745,-67,-96,29,b6:90:18:f6:b1:d4,260730927,440,2264,260730487,260730927
11489,5,12,149,5745,-69,-96,27,a6:92:ad:b7:76:65,260737353,484,5942,260736869,260737353
11490,5,12,149,5745,-60,-96,36,5e:29:73:5b:30:00,260738826,272,1201,260738554,260738826
11491,5,12,149,5745,-78,-96,18,9a:24:38:da:96:bb,260739612,272,514,260739340,260739612
11492,5,12,149,5745,-60,-96,36,5e:29:73:5b:30:00,260741265,540,1113,260740725,260741265
11493,5,12,149,5745,-79,-96,17,9a:24:38:da:96:bb,260742379,824,290,260741555,260742379
11494,5,12,149,5745,-60,-96,36,0a:b9:b7:b1:4d:fa,260743417,468,570,260742949,260743417
11495,5,12,149,5745,-62,-96,34,76:d6:6a:bb:b3:f5,260745087,468,1202,260744619,260745087
11496,5,12,149,5745,-60,-96,36,f2:da:61:dd:98:c5,260745753,268,398,260745485,260745753
11497,5,12,149,5745,-71,-96,25,3e:ef:29:c7:4b:17,260746997,468,776,260746529,260746997
11498,5,12,149,5745,-60,-96,36,76:d6:6a:bb:b3:f5,260774308,272,27039,260774036,260774308
11499,5,24,149,5745,-87,-96,9,,260775481,28,1145,260775453,260775481
11500,5,24,149,5745,-87,-96,9,,260775589,32,76,260775557,260775589
11501,5,24,149,5745,-87,-96,9,,260786318,28,10701,260786290,260786318
11502,5,12,149,5745,-58,-96,38,4a:ea:3c:f4:ce:b2,260788850,468,2064,260788382,260788850
11503,5,24,149,5745,-88,-96,8,,260790132,28,1254,260790104,260790132
11504,5,24,149,5745,-87,-96,9,,260790550,28,390,260790522,260790550
11505,5,12,149,5745,-72,-96,24,22:ec:75:a8:8a:31,260795086,272,4264,260794814,260795086
11506,5,6,149,5745,-85,-96,11,54:e4:3a:ec:fb:65,260796696,360,1250,260796336,260796696
11507,5,24,149,5745,-88,-96,8,,260797323,32,595,260797291,260797323
11508,5,12,149,5745,-58,-96,38,76:d6:6a:bb:b3:f5,260801776,468,3985,260801308,260801776
11509,5,24,149,5745,-87,-96,9,,260802390,32,582,260802358,260802390
11510,5,24,149,5745,-88,-96,8,,260802849,32,427,260802817,260802849
11511,5,12,149,5745,-54,-96,42,3e:d1:9b:c7:a4:de,260804138,272,1017,260803866,260804138
11512,5,12,149,5745,-58,-96,38,4a:ea:3c:f4:ce:b2,260819061,272,14651,260818789,260819061
11513,5,24,149,5745,-86,-96,10,,260819723,28,634,260819695,260819723
11514,5,24,149,5745,-87,-96,9,,260820000,28,249,260819972,260820000
11515,5,24,149,5745,-86,-96,10,,260820233,28,205,260820205,260820233
11516,5,12,149,5745,-70,-96,26,72:d1:72:1d:22:a1,260821495,256,1006,260821239,260821495
11517,5,12,149,5745,-69,-96,27,56:68:e2:c2:8d:d5,260823441,284,1662,260823157,260823441
11518,5,12,149,5745,-69,-96,27,a6:92:ad:b7:76:65,260824866,284,1141,260824582,260824866
11519,5,12,149,5745,-61,-96,35,5e:29:73:5b:30:00,260834139,272,9001,260833867,260834139
11520,5,24,149,5745,-87,-96,9,,260851623,28,17456,260851595,260851623
11521,5,24,149,5745,-87,-96,9,,260852032,28,381,260852004,260852032
11522,5,12,149,5745,-78,-96,18,9a:24:38:da:96:bb,260852556,272,252,260852284,260852556
11523,5,12,149,5745,-73,-96,23,3e:ef:29:c7:4b:17,260853261,272,433,260852989,260853261
11524,5,24,149,5745,-87,-96,9,,260858892,32,5599,260858860,260858892
11525,5,24,149,5745,-87,-96,9,,260864409,32,5485,260864377,260864409
11526,5,24,149,5745,-87,-96,9,,260864596,32,155,260864564,260864596
11527,5,12,149,5745,-65,-96,31,76:d6:6a:bb:b3:f5,260891383,272,26515,260891111,260891383
11528,5,6,149,5745,-83,-96,13,54:e4:3a:ec:fb:65,260899096,360,7353,260898736,260899096
11529,5,12,149,5745,-59,-96,37,f2:da:61:dd:98:c5,260899867,268,503,260899599,260899867
11530,5,12,149,5745,-71,-96,25,22:ec:75:a8:8a:31,260910858,272,10719,260910586,260910858
11531,5,24,149,5745,-68,-96,28,,260920918,28,10032,260920890,260920918
11532,5,24,149,5745,-88,-96,8,,260920962,28,16,260920934,260920962
11533,5,24,149,5745,-87,-96,9,,260921070,28,80,260921042,260921070
11534,5,12,149,5745,-55,-96,41,3e:d1:9b:c7:a4:de,260921833,272,491,260921561,260921833
11535,5,12,149,5745,-66,-96,30,b6:90:18:f6:b1:d4,260923655,244,1578,260923411,260923655
11536,5,12,149,5745,-71,-96,25,56:68:e2:c2:8d:d5,260924066,284,127,260923782,260924066
11537,5,12,149,5745,-69,-96,27,72:d1:72:1d:22:a1,260924406,256,84,260924150,260924406
11538,5,12,149,5745,-72,-96,24,f6:0a:5c:59:72:df,260929285,284,4595,260929001,260929285
11539,5,12,149,5745,-68,-96,28,a6:92:ad:b7:76:65,260934742,284,5173,260934458,260934742
11540,5,24,149,5745,-88,-96,8,,260938029,32,3255,260937997,260938029
11541,5,24,149,5745,-87,-96,9,,260938511,32,450,260938479,260938511
11542,5,24,149,5745,-87,-96,9,,260938992,28,453,260938964,260938992
11543,5,12,149,5745,-63,-96,33,0a:b9:b7:b1:4d:fa,260942207,468,2747,260941739,260942207
11544,5,12,149,5745,-64,-96,32,5e:29:73:5b:30:00,260946783,272,4304,260946511,260946783
11545,5,12,149,5745,-59,-96,37,4a:ea:3c:f4:ce:b2,260948030,272,975,260947758,260948030
11546,5,24,149,5745,-86,-96,10,,260951949,28,3891,260951921,260951949
11547,5,24,149,5745,-87,-96,9,,260952267,28,290,260952239,260952267
11548,5,24,149,5745,-87,-96,9,,260959411,32,7112,260959379,260959411
11549,5,12,149,5745,-77,-96,19,9a:24:38:da:96:bb,260974361,272,14678,260974089,260974361
11550,5,12,149,5745,-71,-96,25,3e:ef:29:c7:4b:17,260977955,272,3322,260977683,260977955
11551,5,24,149,5745,-70,-96,26,,260982288,28,4305,260982260,260982288
11552,5,24,149,5745,-88,-96,8,,260982332,28,16,260982304,260982332
11553,5,24,149,5745,-88,-96,8,,260982440,28,80,260982412,260982440
11554,5,12,149,5745,-64,-96,32,3a:de:b0:2e:cd:45,260990994,116,8438,260990878,260990994
11555,5,12,149,5745,-65,-96,31,3a:de:b0:2e:cd:45,260991180,132,54,260991048,260991180
11556,5,12,149,5745,-65,-96,31,3a:de:b0:2e:cd:45,260991373,104,89,260991269,260991373
11557,5,12,149,5745,-65,-96,31,3a:de:b0:2e:cd:45,260991611,104,134,260991507,260991611
11558,5,12,149,5745,-65,-96,31,3a:de:b0:2e:cd:45,260991776,104,61,260991672,260991776
11559,5,12,149,5745,-65,-96,31,3a:de:b0:2e:cd:45,260992013,380,-143,260991633,260992013
11560,5,24,149,5745,-89,-96,7,,260994281,28,2240,260994253,260994281
11561,5,24,149,5745,-88,-96,8,,260994389,32,76,260994357,260994389
11562,5,12,149,5745,-65,-96,31,3a:de:b0:2e:cd:45,260996867,440,2038,260996427,260996867
11563,5,12,149,5745,-76,-96,20,d2:00:04:7e:2c:ab,260997387,272,248,260997115,260997387
11564,5,6,149,5745,-82,-96,14,54:e4:3a:ec:fb:65,261001497,360,3750,261001137,261001497
11565,5,12,149,5745,-59,-96,37,f2:da:61:dd:98:c5,261002172,268,407,261001904,261002172
11566,5,12,149,5745,-65,-96,31,76:d6:6a:bb:b3:f5,261003890,272,1446,261003618,261003890
11567,5,24,149,5745,-87,-96,9,,261005076,28,1158,261005048,261005076
11568,5,24,149,5745,-88,-96,8,,261009602,28,4498,261009574,261009602
11569,5,24,149,5745,-87,-96,9,,261009948,28,318,261009920,261009948
11570,5,24,149,5745,-88,-96,8,,261016648,28,6672,261016620,261016648
11571,5,24,149,5745,-87,-96,9,,261016757,32,77,261016725,261016757
11572,5,24,149,5745,-88,-96,8,,261022793,28,6008,261022765,261022793
11573,5,24,149,5745,-87,-96,9,,261023157,28,336,261023129,261023157
11574,5,24,149,5745,-87,-96,9,,261025496,28,2311,261025468,261025496
11575,5,24,149,5745,-87,-96,9,,261025847,28,323,261025819,261025847
11576,5,12,149,5745,-70,-96,26,b6:90:18:f6:b1:d4,261026166,244,75,261025922,261026166
11577,5,12,149,5745,-70,-96,26,72:d1:72:1d:22:a1,261026635,256,213,261026379,261026635
11578,5,12,149,5745,-71,-96,25,22:ec:75:a8:8a:31,261027895,272,988,261027623,261027895
11579,5,24,149,5745,-70,-96,26,,261028226,28,303,261028198,261028226
11580,5,24,149,5745,-88,-96,8,,261028269,28,15,261028241,261028269
11581,5,24,149,5745,-88,-96,8,,261028378,28,81,261028350,261028378
11582,5,12,149,5745,-71,-96,25,56:68:e2:c2:8d:d5,261028467,284,-195,261028183,261028467
11583,5,24,149,5745,-87,-96,9,,261029019,32,520,261028987,261029019
11584,5,24,149,5745,-86,-96,10,,261034102,28,5055,261034074,261034102
11585,5,24,149,5745,-87,-96,9,,261035544,28,1414,261035516,261035544
11586,5,12,149,5745,-61,-96,35,3e:d1:9b:c7:a4:de,261039029,272,3213,261038757,261039029
11587,5,24,149,5745,-87,-96,9,,261039434,28,377,261039406,261039434
11588,5,24,149,5745,-88,-96,8,,261039811,28,349,261039783,261039811
11589,5,24,149,5745,-87,-96,9,,261041335,32,1492,261041303,261041335
11590,5,24,149,5745,-87,-96,9,,261046309,28,4946,261046281,261046309
11591,5,24,149,5745,-87,-96,9,,261046417,32,76,261046385,261046417
11592,5,24,149,5745,-88,-96,8,,261051370,28,4925,261051342,261051370
11593,5,24,149,5745,-87,-96,9,,261051753,28,355,261051725,261051753
11594,5,24,149,5745,-88,-96,8,,261052174,28,393,261052146,261052174
11595,5,24,149,5745,-88,-96,8,,261058019,32,5813,261057987,261058019
11596,5,12,149,5745,-61,-96,35,4a:ea:3c:f4:ce:b2,261059275,272,984,261059003,261059275
11597,5,24,149,5745,-87,-96,9,,261062527,32,3220,261062495,261062527
11598,5,12,149,5745,-64,-96,32,5e:29:73:5b:30:00,261063713,272,914,261063441,261063713
11599,5,12,149,5745,-72,-96,24,3e:ef:29:c7:4b:17,261078313,272,14328,261078041,261078313
11600,5,24,149,5745,-89,-96,7,,261080448,28,2107,261080420,261080448
11601,5,24,149,5745,-88,-96,8,,261082812,28,2336,261082784,261082812
11602,5,24,149,5745,-89,-96,7,,261083137,28,297,261083109,261083137
11603,5,24,149,5745,-87,-96,9,,261083519,28,354,261083491,261083519
11604,5,24,149,5745,-87,-96,9,,261089959,32,6408,261089927,261089959
11605,5,12,149,5745,-64,-96,32,3a:de:b0:2e:cd:45,261103359,272,13128,261103087,261103359
11606,5,6,149,5745,-83,-96,13,54:e4:3a:ec:fb:65,261103898,360,179,261103538,261103898
11607,5,12,149,5745,-61,-96,35,f2:da:61:dd:98:c5,261105361,268,1195,261105093,261105361
11608,5,12,149,5745,-69,-96,27,a6:92:ad:b7:76:65,261126631,284,20986,261126347,261126631
11609,5,12,149,5745,-67,-96,29,b6:90:18:f6:b1:d4,261127920,244,1045,261127676,261127920
11610,5,12,149,5745,-69,-96,27,72:d1:72:1d:22:a1,261128621,256,445,261128365,261128621
11611,5,12,149,5745,-77,-96,19,d2:00:04:7e:2c:ab,261128912,272,19,261128640,261128912
11612,5,12,149,5745,-73,-96,23,56:68:e2:c2:8d:d5,261129936,284,740,261129652,261129936
11613,5,12,149,5745,-71,-96,25,22:ec:75:a8:8a:31,261139962,272,9754,261139690,261139962
11614,5,12,149,5745,-65,-96,31,76:d6:6a:bb:b3:f5,261142684,272,2450,261142412,261142684
11615,5,12,149,5745,-59,-96,37,3e:d1:9b:c7:a4:de,261150887,272,7931,261150615,261150887
11616,5,24,149,5745,-88,-96,8,,261152730,28,1815,261152702,261152730
11617,5,24,149,5745,-88,-96,8,,261153121,28,363,261153093,261153121
11618,5,24,149,5745,-87,-96,9,,261153442,28,293,261153414,261153442
11619,5,24,149,5745,-88,-96,8,,261159666,28,6196,261159638,261159666
11620,5,24,149,5745,-88,-96,8,,261159775,32,77,261159743,261159775
11621,5,24,149,5745,-88,-96,8,,261159941,28,138,261159913,261159941
11622,5,24,149,5745,-89,-96,7,,261160259,28,290,261160231,261160259
11623,5,24,149,5745,-88,-96,8,,261160587,28,300,261160559,261160587
11624,5,12,149,5745,-69,-96,27,a6:92:ad:b7:76:65,261162486,284,1615,261162202,261162486
11625,5,12,149,5745,-65,-96,31,76:d6:6a:bb:b3:f5,261165300,380,2434,261164920,261165300
11626,5,24,149,5745,-88,-96,8,,261166630,28,1302,261166602,261166630
11627,5,24,149,5745,-88,-96,8,,261166739,32,77,261166707,261166739
11628,5,24,149,5745,-86,-96,10,,261167431,28,664,261167403,261167431
11629,5,24,149,5745,-88,-96,8,,261167809,28,350,261167781,261167809
11630,5,12,149,5745,-61,-96,35,4a:ea:3c:f4:ce:b2,261168212,272,131,261167940,261168212
11631,5,12,149,5745,-64,-96,32,3a:de:b0:2e:cd:45,261168637,272,153,261168365,261168637
11632,5,24,149,5745,-89,-96,7,,261171429,28,2764,261171401,261171429
11633,5,24,149,5745,-87,-96,9,,261171764,28,307,261171736,261171764
11634,5,24,149,5745,-88,-96,8,,261172064,28,272,261172036,261172064
11635,5,24,149,5745,-89,-96,7,,261173903,28,1811,261173875,261173903
11636,5,24,149,5745,-88,-96,8,,261174274,28,343,261174246,261174274
11637,5,24,149,5745,-88,-96,8,,261174665,28,363,261174637,261174665
11638,5,24,149,5745,-89,-96,7,,261177658,28,2965,261177630,261177658
11639,5,24,149,5745,-89,-96,7,,261178038,28,352,261178010,261178038
11640,5,12,149,5745,-66,-96,30,b6:90:18:f6:b1:d4,261179416,244,1134,261179172,261179416
11641,5,12,149,5745,-61,-96,35,f2:da:61:dd:98:c5,261180729,268,1045,261180461,261180729
11642,5,24,149,5745,-89,-96,7,,261181691,28,934,261181663,261181691
11643,5,24,149,5745,-87,-96,9,,261182024,28,305,261181996,261182024
11644,5,24,149,5745,-87,-96,9,,261182352,28,300,261182324,261182352
11645,5,12,149,5745,-61,-96,35,4a:ea:3c:f4:ce:b2,261183408,468,588,261182940,261183408
11646,5,12,149,5745,-70,-96,26,22:ec:75:a8:8a:31,261183964,544,12,261183420,261183964
11647,5,24,149,5745,-88,-96,8,,261184613,28,621,261184585,261184613
11648,5,24,149,5745,-88,-96,8,,261184722,32,77,261184690,261184722
11649,5,24,149,5745,-88,-96,8,,261186023,28,1273,261185995,261186023
11650,5,24,149,5745,-89,-96,7,,261186661,28,610,261186633,261186661
11651,5,12,149,5745,-75,-96,21,f6:0a:5c:59:72:df,261186906,480,-235,261186426,261186906
11652,5,12,149,5745,-59,-96,37,3e:d1:9b:c7:a4:de,261187420,544,-30,261186876,261187420
11653,5,12,149,5745,-80,-96,16,9a:24:38:da:96:bb,261187999,272,307,261187727,261187999
11654,5,24,149,5745,-88,-96,8,,261188855,28,828,261188827,261188855
11655,5,12,149,5745,-66,-96,30,b6:90:18:f6:b1:d4,261190709,440,1414,261190269,261190709
11656,5,12,149,5745,-63,-96,33,3a:de:b0:2e:cd:45,261191770,468,593,261191302,261191770
11657,5,12,149,5745,-64,-96,32,76:d6:6a:bb:b3:f5,261192363,468,125,261191895,261192363
11658,5,24,149,5745,-88,-96,8,,261193045,32,650,261193013,261193045
11659,5,12,149,5745,-68,-96,28,72:d1:72:1d:22:a1,261195893,256,2592,261195637,261195893
11660,5,12,149,5745,-73,-96,23,3e:ef:29:c7:4b:17,261196638,272,473,261196366,261196638
11661,5,12,149,5745,-70,-96,26,a6:92:ad:b7:76:65,261196989,484,-133,261196505,261196989
11662,5,12,149,5745,-62,-96,34,5e:29:73:5b:30:00,261197624,272,363,261197352,261197624
11663,5,24,149,5745,-88,-96,8,,261198304,28,652,261198276,261198304
11664,5,24,149,5745,-88,-96,8,,261198660,28,328,261198632,261198660
11665,5,12,149,5745,-62,-96,34,5e:29:73:5b:30:00,261198996,540,-204,261198456,261198996
11666,5,24,149,5745,-89,-96,7,,261200890,28,1866,261200862,261200890
11667,5,24,149,5745,-89,-96,7,,261201199,28,281,261201171,261201199
11668,5,24,149,5745,-87,-96,9,,261201482,28,255,261201454,261201482
11669,5,12,149,5745,-75,-96,21,56:68:e2:c2:8d:d5,261202421,480,459,261201941,261202421
11670,5,12,149,5745,-68,-96,28,72:d1:72:1d:22:a1,261202955,452,82,261202503,261202955
11671,5,12,149,5745,-73,-96,23,3e:ef:29:c7:4b:17,261203523,468,100,261203055,261203523
11672,5,24,149,5745,-88,-96,8,,261204057,28,506,261204029,261204057
11673,5,24,149,5745,-89,-96,7,,261204404,28,319,261204376,261204404
11674,5,24,149,5745,-89,-96,7,,261204866,32,430,261204834,261204866
11675,5,12,149,5745,-61,-96,35,f2:da:61:dd:98:c5,261206153,268,1019,261205885,261206153
11676,5,6,149,5745,-84,-96,12,54:e4:3a:ec:fb:65,261206453,360,-60,261206093,261206453
11677,5,24,149,5745,-89,-96,7,,261206949,28,468,261206921,261206949
11678,5,24,149,5745,-88,-96,8,,261207281,28,304,261207253,261207281
11679,5,24,149,5745,-88,-96,8,,261207700,28,391,261207672,261207700
11680,5,12,149,5745,-75,-96,21,d2:00:04:7e:2c:ab,261208040,468,-128,261207572,261208040
11681,5,24,149,5745,-88,-96,8,,261208830,32,758,261208798,261208830
11682,5,24,149,5745,-88,-96,8,,261209018,28,160,261208990,261209018
11683,5,24,149,5745,-88,-96,8,,261209328,28,282,261209300,261209328
11684,5,24,149,5745,-88,-96,8,,261209649,28,293,261209621,261209649
11685,5,12,149,5745,-75,-96,21,d2:00:04:7e:2c:ab,261212289,272,2368,261212017,261212289
11686,5,24,149,5745,-89,-96,7,,261213901,32,1580,261213869,261213901
11687,5,24,149,5745,-88,-96,8,,261214066,28,137,261214038,261214066
11688,5,24,149,5745,-89,-96,7,,261214391,28,297,261214363,261214391
11689,5,24,149,5745,-88,-96,8,,261214702,28,283,261214674,261214702
11690,5,24,149,5745,-88,-96,8,,261219885,28,5155,261219857,261219885
11691,5,24,149,5745,-88,-96,8,,261219994,32,77,261219962,261219994
11692,5,24,149,5745,-87,-96,9,,261220132,28,110,261220104,261220132
11693,5,24,149,5745,-90,-96,6,,261221487,28,1327,261221459,261221487
11694,5,24,149,5745,-89,-96,7,,261221833,28,318,261221805,261221833
11695,5,24,149,5745,-89,-96,7,,261225619,28,3758,261225591,261225619
11696,5,24,149,5745,-88,-96,8,,261225727,32,76,261225695,261225727
11697,5,24,149,5745,-89,-96,7,,261226389,28,634,261226361,261226389
11698,5,12,149,5745,-65,-96,31,76:d6:6a:bb:b3:f5,261229740,272,3079,261229468,261229740
11699,5,12,149,5745,-75,-96,21,56:68:e2:c2:8d:d5,261230064,284,40,261229780,261230064
11700,5,24,149,5745,-89,-96,7,,261231315,32,1219,261231283,261231315
11701,5,24,149,5745,-89,-96,7,,261231765,28,422,261231737,261231765
11702,5,24,149,5745,-89,-96,7,,261232097,28,304,261232069,261232097
11703,5,24,149,5745,-88,-96,8,,261232506,28,381,261232478,261232506
11704,5,24,149,5745,-90,-96,6,,261238944,32,6406,261238912,261238944
11705,5,24,149,5745,-88,-96,8,,261239251,28,279,261239223,261239251
11706,5,24,149,5745,-89,-96,7,,261239606,28,327,261239578,261239606
11707,5,24,149,5745,-88,-96,8,,261242610,28,2976,261242582,261242610
11708,5,24,149,5745,-88,-96,8,,261242938,28,300,261242910,261242938
11709,5,24,149,5745,-89,-96,7,,261244114,28,1148,261244086,261244114
11710,5,24,149,5745,-89,-96,7,,261244463,28,321,261244435,261244463
11711,5,24,149,5745,-89,-96,7,,261247674,28,3183,261247646,261247674
11712,5,12,149,5745,-60,-96,36,4a:ea:3c:f4:ce:b2,261247937,468,-205,261247469,261247937
11713,5,12,149,5745,-77,-96,19,f6:0a:5c:59:72:df,261248574,480,157,261248094,261248574
11714,5,12,149,5745,-70,-96,26,22:ec:75:a8:8a:31,261249142,544,24,261248598,261249142
11715,5,24,149,5745,-89,-96,7,,261249801,28,631,261249773,261249801
11716,5,24,149,5745,-88,-96,8,,261250223,32,390,261250191,261250223
11717,5,24,149,5745,-89,-96,7,,261251809,28,1558,261251781,261251809
11718,5,24,149,5745,-90,-96,6,,261252120,28,283,261252092,261252120
11719,5,12,149,5745,-59,-96,37,3e:d1:9b:c7:a4:de,261252349,544,-315,261251805,261252349
11720,5,24,149,5745,-88,-96,8,,261253098,28,721,261253070,261253098
11721,5,12,149,5745,-67,-96,29,b6:90:18:f6:b1:d4,261254099,440,561,261253659,261254099
11722,5,12,149,5745,-78,-96,18,f6:0a:5c:59:72:df,261254915,284,532,261254631,261254915
11723,5,12,149,5745,-81,-96,15,9a:24:38:da:96:bb,261255587,824,-152,261254763,261255587
11724,5,12,149,5745,-64,-96,32,3a:de:b0:2e:cd:45,261256578,468,523,261256110,261256578
11725,5,12,149,5745,-66,-96,30,76:d6:6a:bb:b3:f5,261257523,468,477,261257055,261257523
11726,5,24,149,5745,-90,-96,6,,261258422,28,871,261258394,261258422
11727,5,24,149,5745,-88,-96,8,,261259031,28,581,261259003,261259031
11728,5,12,149,5745,-70,-96,26,22:ec:75:a8:8a:31,261261317,272,2014,261261045,261261317
11729,5,12,149,5745,-68,-96,28,a6:92:ad:b7:76:65,261261631,484,-170,261261147,261261631
11730,5,12,149,5745,-68,-96,28,a6:92:ad:b7:76:65,261262187,284,272,261261903,261262187
11731,5,24,149,5745,-88,-96,8,,261262756,32,537,261262724,261262756
11732,5,24,149,5745,-89,-96,7,,261262922,28,138,261262894,261262922
11733,5,24,149,5745,-88,-96,8,,261263258,28,308,261263230,261263258
11734,5,24,149,5745,-88,-96,8,,261263649,28,363,261263621,261263649
11735,5,12,149,5745,-72,-96,24,aa:b6:ae:27:64:4e,261263886,468,-231,261263418,261263886
11736,5,12,149,5745,-63,-96,33,5e:29:73:5b:30:00,261264422,540,-4,261263882,261264422
11737,5,12,149,5745,-75,-96,21,56:68:e2:c2:8d:d5,261265236,480,334,261264756,261265236
11738,5,24,149,5745,-88,-96,8,,261265812,28,548,261265784,261265812
11739,5,12,149,5745,-67,-96,29,72:d1:72:1d:22:a1,261267706,452,1442,261267254,261267706
11740,5,12,149,5745,-73,-96,23,3e:ef:29:c7:4b:17,261268544,468,370,261268076,261268544
11741,5,12,149,5745,-61,-96,35,4a:ea:3c:f4:ce:b2,261269047,272,231,261268775,261269047
11742,5,12,149,5745,-61,-96,35,f2:da:61:dd:98:c5,261269399,268,84,261269131,261269399
11743,5,12,149,5745,-60,-96,36,0a:b9:b7:b1:4d:fa,261269878,468,11,261269410,261269878
11744,5,12,149,5745,-67,-96,29,b6:90:18:f6:b1:d4,261277537,244,7415,261277293,261277537
11745,5,12,149,5745,-60,-96,36,3e:d1:9b:c7:a4:de,261278059,272,250,261277787,261278059
11746,5,12,149,5745,-61,-96,35,f2:da:61:dd:98:c5,261279276,268,949,261279008,261279276
11747,5,12,149,5745,-64,-96,32,3a:de:b0:2e:cd:45,261280325,272,777,261280053,261280325
11748,5,24,149,5745,-89,-96,7,,261292398,28,12045,261292370,261292398
11749,5,24,149,5745,-89,-96,7,,261293389,28,963,261293361,261293389
11750,5,12,149,5745,-73,-96,23,3e:ef:29:c7:4b:17,261295375,272,1714,261295103,261295375
11751,5,12,149,5745,-62,-96,34,5e:29:73:5b:30:00,261296203,272,556,261295931,261296203
11752,5,24,149,5745,-90,-96,6,,261298397,28,2166,261298369,261298397
11753,5,24,149,5745,-89,-96,7,,261299049,28,624,261299021,261299049
11754,5,24,149,5745,-89,-96,7,,261299357,28,280,261299329,261299357
11755,5,24,149,5745,-89,-96,7,,261299465,32,76,261299433,261299465
11756,5,12,149,5745,-79,-96,17,9a:24:38:da:96:bb,261300746,272,1009,261300474,261300746
11757,5,24,149,5745,-90,-96,6,,261302444,28,1670,261302416,261302444
11758,5,24,149,5745,-90,-96,6,,261303515,28,1043,261303487,261303515
11759,5,24,149,5745,-90,-96,6,,261307113,28,3570,261307085,261307113
11760,5,24,149,5745,-89,-96,7,,261307477,28,336,261307449,261307477
11761,5,24,149,5745,-90,-96,6,,261308093,28,588,261308065,261308093
11762,5,6,149,5745,-83,-96,13,54:e4:3a:ec:fb:65,261308699,360,246,261308339,261308699
11763,5,24,149,5745,-88,-96,8,,261309435,32,704,261309403,261309435
11764,5,12,149,5745,-61,-96,35,4a:ea:3c:f4:ce:b2,261312725,468,2822,261312257,261312725
11765,5,12,149,5745,-76,-96,20,f6:0a:5c:59:72:df,261313488,480,283,261313008,261313488
11766,5,24,149,5745,-89,-96,7,,261314136,28,620,261314108,261314136
11767,5,24,149,5745,-90,-96,6,,261314244,32,76,261314212,261314244
11768,5,24,149,5745,-90,-96,6,,261314747,28,475,261314719,261314747
11769,5,24,149,5745,-90,-96,6,,261315084,28,309,261315056,261315084
11770,5,24,149,5745,-89,-96,7,,261315416,28,304,261315388,261315416
11771,5,24,149,5745,-89,-96,7,,261318852,28,3408,261318824,261318852
11772,5,24,149,5745,-90,-96,6,,261319163,28,283,261319135,261319163
11773,5,24,149,5745,-90,-96,6,,261319473,28,282,261319445,261319473
11774,5,12,149,5745,-63,-96,33,3a:de:b0:2e:cd:45,261321141,468,1200,261320673,261321141
11775,5,24,149,5745,-88,-96,8,,261321723,28,554,261321695,261321723
11776,5,12,149,5745,-68,-96,28,72:d1:72:1d:22:a1,261322281,256,302,261322025,261322281
11777,5,12,149,5745,-67,-96,29,76:d6:6a:bb:b3:f5,261322614,468,-135,261322146,261322614
11778,5,24,149,5745,-89,-96,7,,261323296,28,654,261323268,261323296
11779,5,24,149,5745,-89,-96,7,,261325021,28,1697,261324993,261325021
11780,5,24,149,5745,-89,-96,7,,261325771,28,722,261325743,261325771
11781,5,24,149,5745,-88,-96,8,,261326068,28,269,261326040,261326068
11782,5,24,149,5745,-88,-96,8,,261326423,28,327,261326395,261326423
11783,5,24,149,5745,-90,-96,6,,261326751,28,300,261326723,261326751
11784,5,12,149,5745,-75,-96,21,d2:00:04:7e:2c:ab,261327015,272,-8,261326743,261327015
11785,5,24,149,5745,-89,-96,7,,261328871,32,1824,261328839,261328871
11786,5,24,149,5745,-89,-96,7,,261333260,28,4361,261333232,261333260
11787,5,24,149,5745,-90,-96,6,,261333646,28,358,261333618,261333646
11788,5,12,149,5745,-75,-96,21,d2:00:04:7e:2c:ab,261334705,468,591,261334237,261334705
11789,5,24,149,5745,-88,-96,8,,261338429,28,3696,261338401,261338429
11790,5,24,149,5745,-89,-96,7,,261338770,28,313,261338742,261338770
11791,5,24,149,5745,-89,-96,7,,261339171,28,373,261339143,261339171
11792,5,24,149,5745,-89,-96,7,,261339703,32,500,261339671,261339703
11793,5,24,149,5745,-89,-96,7,,261342631,28,2900,261342603,261342631
11794,5,24,149,5745,-89,-96,7,,261343189,28,530,261343161,261343189
11795,5,12,149,5745,-67,-96,29,76:d6:6a:bb:b3:f5,261344022,272,561,261343750,261344022
11796,5,24,149,5745,-89,-96,7,,261344400,28,350,261344372,261344400
11797,5,24,149,5745,-89,-96,7,,261344925,32,493,261344893,261344925
11798,5,24,149,5745,-88,-96,8,,261345073,28,120,261345045,261345073
11799,5,24,149,5745,-89,-96,7,,261345444,32,339,261345412,261345444
11800,5,24,149,5745,-89,-96,7,,261345619,28,147,261345591,261345619
11801,5,24,149,5745,-89,-96,7,,261346743,28,1096,261346715,261346743
11802,5,24,149,5745,-90,-96,6,,261347089,28,318,261347061,261347089
11803,5,24,149,5745,-88,-96,8,,261349214,32,2093,261349182,261349214
11804,5,24,149,5745,-89,-96,7,,261349369,28,127,261349341,261349369
11805,5,24,149,5745,-89,-96,7,,261349710,28,313,261349682,261349710
11806,5,24,149,5745,-88,-96,8,,261350055,28,317,261350027,261350055
11807,5,24,149,5745,-88,-96,8,,261353147,32,3060,261353115,261353147
11808,5,24,149,5745,-88,-96,8,,261354332,28,1157,261354304,261354332
11809,5,24,149,5745,-89,-96,7,,261354676,28,316,261354648,261354676
11810,5,24,149,5745,-89,-96,7,,261355051,28,347,261355023,261355051
11811,5,24,149,5745,-89,-96,7,,261355589,28,510,261355561,261355589
11812,5,24,149,5745,-88,-96,8,,261359910,28,4293,261359882,261359910
11813,5,24,149,5745,-89,-96,7,,261361095,32,1153,261361063,261361095
11814,5,24,149,5745,-88,-96,8,,261361225,28,102,261361197,261361225
11815,5,24,149,5745,-89,-96,7,,261361545,28,292,261361517,261361545
11816,5,24,149,5745,-88,-96,8,,261366595,32,5018,261366563,261366595
11817,5,12,149,5745,-70,-96,26,22:ec:75:a8:8a:31,261369358,272,2491,261369086,261369358
11818,5,12,149,5745,-61,-96,35,3e:d1:9b:c7:a4:de,261380647,272,11017,261380375,261380647
11819,5,12,149,5745,-74,-96,22,f6:0a:5c:59:72:df,261381567,284,636,261381283,261381567
11820,5,12,149,5745,-61,-96,35,3a:de:b0:2e:cd:45,261393980,272,12141,261393708,261393980
11821,5,12,149,5745,-60,-96,36,4a:ea:3c:f4:ce:b2,261395953,272,1701,261395681,261395953
11822,5,12,149,5745,-60,-96,36,5e:29:73:5b:30:00,261402003,272,5778,261401731,261402003
11823,5,12,149,5745,-59,-96,37,f2:da:61:dd:98:c5,261405553,268,3282,261405285,261405553
11824,5,6,149,5745,-83,-96,13,54:e4:3a:ec:fb:65,261411099,360,5186,261410739,261411099
11825,5,12,149,5745,-77,-96,19,9a:24:38:da:96:bb,261416409,272,5038,261416137,261416409
11826,5,12,149,5745,-68,-96,28,72:d1:72:1d:22:a1,261427084,256,10419,261426828,261427084
11827,5,12,149,5745,-68,-96,28,a6:92:ad:b7:76:65,261434521,284,7153,261434237,261434521
11828,5,12,149,5745,-65,-96,31,b6:90:18:f6:b1:d4,261435797,244,1032,261435553,261435797
11829,5,12,149,5745,-74,-96,22,d2:00:04:7e:2c:ab,261447597,272,11528,261447325,261447597
11830,5,12,149,5745,-60,-96,36,0a:b9:b7:b1:4d:fa,261465606,468,17541,261465138,261465606
11831,5,12,149,5745,-70,-96,26,22:ec:75:a8:8a:31,261487220,272,21342,261486948,261487220
11832,5,12,149,5745,-71,-96,25,3e:ef:29:c7:4b:17,261489339,272,1847,261489067,261489339
11833,5,12,149,5745,-56,-96,40,3e:d1:9b:c7:a4:de,261495901,272,6290,261495629,261495901
11834,5,12,149,5745,-58,-96,38,3a:de:b0:2e:cd:45,261506180,272,10007,261505908,261506180
11835,5,12,149,5745,-65,-96,31,76:d6:6a:bb:b3:f5,261513553,272,7101,261513281,261513553
11836,5,12,149,5745,-60,-96,36,f2:da:61:dd:98:c5,261517967,268,4146,261517699,261517967
11837,5,12,149,5745,-60,-96,36,5e:29:73:5b:30:00,261519783,272,1544,261519511,261519783
11838,5,12,149,5745,-77,-96,19,9a:24:38:da:96:bb,261524632,272,4577,261524360,261524632
11839,5,12,149,5745,-68,-96,28,a6:92:ad:b7:76:65,261536597,284,11681,261536313,261536597
11840,5,12,149,5745,-65,-96,31,b6:90:18:f6:b1:d4,261538024,244,1183,261537780,261538024
11841,5,12,149,5745,-74,-96,22,56:68:e2:c2:8d:d5,261539157,284,849,261538873,261539157
11842,5,12,149,5745,-69,-96,27,72:d1:72:1d:22:a1,261540073,256,660,261539817,261540073
11843,5,24,149,5745,-89,-96,7,,261560318,28,20217,261560290,261560318
11844,5,12,149,5745,-76,-96,20,d2:00:04:7e:2c:ab,261569753,272,9163,261569481,261569753
11845,5,24,149,5745,-88,-96,8,,261571176,28,1395,261571148,261571176
11846,5,12,149,5745,-72,-96,24,56:68:e2:c2:8d:d5,261576096,284,4636,261575812,261576096
11847,5,12,149,5745,-72,-96,24,3e:ef:29:c7:4b:17,261590518,272,14150,261590246,261590518
11848,5,12,149,5745,-69,-96,27,22:ec:75:a8:8a:31,261600500,272,9710,261600228,261600500
11849,5,12,149,5745,-54,-96,42,3e:d1:9b:c7:a4:de,261613246,272,12474,261612974,261613246
11850,5,12,149,5745,-66,-96,30,a6:92:ad:b7:76:65,261614923,284,1393,261614639,261614923
11851,5,12,149,5745,-63,-96,33,76:d6:6a:bb:b3:f5,261616091,272,896,261615819,261616091
11852,5,12,149,5745,-61,-96,35,3a:de:b0:2e:cd:45,261618874,272,2511,261618602,261618874
11853,5,24,149,5745,-88,-96,8,,261621327,28,2425,261621299,261621327
11854,5,12,149,5745,-66,-96,30,b6:90:18:f6:b1:d4,261624200,244,2629,261623956,261624200
11855,5,12,149,5745,-63,-96,33,f2:da:61:dd:98:c5,261625216,268,748,261624948,261625216
11856,5,24,149,5745,-89,-96,7,,261628578,32,3330,261628546,261628578
11857,5,12,149,5745,-82,-96,14,9a:24:38:da:96:bb,261635949,272,7099,261635677,261635949
11858,5,12,149,5745,-70,-96,26,72:d1:72:1d:22:a1,261638292,256,2087,261638036,261638292
11859,5,12,149,5745,-72,-96,24,3e:ef:29:c7:4b:17,261638881,272,317,261638609,261638881
11860,5,12,149,5745,-64,-96,32,5e:29:73:5b:30:00,261639997,272,844,261639725,261639997
11861,5,12,149,5745,-72,-96,24,f6:0a:5c:59:72:df,261641725,480,1248,261641245,261641725
11862,5,12,149,5745,-57,-96,39,4a:ea:3c:f4:ce:b2,261643347,468,1154,261642879,261643347
11863,5,12,149,5745,-70,-96,26,22:ec:75:a8:8a:31,261645110,544,1219,261644566,261645110
11864,5,12,149,5745,-53,-96,43,3e:d1:9b:c7:a4:de,261647732,544,2078,261647188,261647732
11865,5,12,149,5745,-62,-96,34,3a:de:b0:2e:cd:45,261649004,468,804,261648536,261649004
11866,5,12,149,5745,-67,-96,29,b6:90:18:f6:b1:d4,261649517,440,73,261649077,261649517
11867,5,12,149,5745,-57,-96,39,4a:ea:3c:f4:ce:b2,261650118,364,237,261649754,261650118
11868,5,12,149,5745,-64,-96,32,76:d6:6a:bb:b3:f5,261651049,468,463,261650581,261651049
11869,5,12,149,5745,-62,-96,34,76:d6:6a:bb:b3:f5,261651659,380,230,261651279,261651659
11870,5,12,149,5745,-62,-96,34,5e:29:73:5b:30:00,261659363,540,7164,261658823,261659363
11871,5,12,149,5745,-69,-96,27,72:d1:72:1d:22:a1,261662135,452,2320,261661683,261662135
11872,5,12,149,5745,-71,-96,25,56:68:e2:c2:8d:d5,261663548,480,933,261663068,261663548
11873,5,12,149,5745,-72,-96,24,3e:ef:29:c7:4b:17,261664064,468,48,261663596,261664064
11874,5,12,149,5745,-74,-96,22,d2:00:04:7e:2c:ab,261664568,468,36,261664100,261664568
11875,5,12,149,5745,-60,-96,36,f2:da:61:dd:98:c5,261665078,268,242,261664810,261665078
11876,5,24,149,5745,-87,-96,9,,261665534,28,428,261665506,261665534
11877,5,24,149,5745,-87,-96,9,,261666127,28,565,261666099,261666127
11878,5,12,149,5745,-63,-96,33,76:d6:6a:bb:b3:f5,261671646,272,5247,261671374,261671646
11879,5,12,149,5745,-71,-96,25,56:68:e2:c2:8d:d5,261671952,284,22,261671668,261671952
11880,5,12,149,5745,-71,-96,25,f6:0a:5c:59:72:df,261704196,284,31960,261703912,261704196
11881,5,12,149,5745,-56,-96,40,4a:ea:3c:f4:ce:b2,261704803,468,139,261704335,261704803
11882,5,12,149,5745,-77,-96,19,d2:00:04:7e:2c:ab,261705341,468,70,261704873,261705341
11883,5,12,149,5745,-72,-96,24,f6:0a:5c:59:72:df,261706612,480,791,261706132,261706612
11884,5,12,149,5745,-66,-96,30,b6:90:18:f6:b1:d4,261713005,440,5953,261712565,261713005
11885,5,12,149,5745,-66,-96,30,3a:de:b0:2e:cd:45,261714308,468,835,261713840,261714308
11886,5,12,149,5745,-56,-96,40,4a:ea:3c:f4:ce:b2,261715711,272,1131,261715439,261715711
11887,5,12,149,5745,-64,-96,32,76:d6:6a:bb:b3:f5,261716028,468,-151,261715560,261716028
11888,5,12,149,5745,-70,-96,26,22:ec:75:a8:8a:31,261717820,272,1520,261717548,261717820
11889,5,6,149,5745,-87,-96,9,54:e4:3a:ec:fb:65,261718301,360,121,261717941,261718301
11890,5,12,149,5745,-66,-96,30,3a:de:b0:2e:cd:45,261722601,272,4028,261722329,261722601
11891,5,12,149,5745,-53,-96,43,3e:d1:9b:c7:a4:de,261726992,272,4119,261726720,261726992
11892,5,12,149,5745,-65,-96,31,f2:da:61:dd:98:c5,261728461,268,1201,261728193,261728461
11893,5,12,149,5745,-66,-96,30,b6:90:18:f6:b1:d4,261736196,244,7491,261735952,261736196
11894,5,12,149,5745,-65,-96,31,f2:da:61:dd:98:c5,261737536,268,1072,261737268,261737536
11895,5,24,149,5745,-89,-96,7,,261744293,28,6729,261744265,261744293
11896,5,24,149,5745,-88,-96,8,,261744639,28,318,261744611,261744639
11897,5,12,149,5745,-86,-96,10,9a:24:38:da:96:bb,261748073,272,3162,261747801,261748073
11898,5,24,149,5745,-86,-96,10,,261751181,28,3080,261751153,261751181
11899,5,24,149,5745,-87,-96,9,,261751289,32,76,261751257,261751289
11900,5,12,149,5745,-71,-96,25,3e:ef:29:c7:4b:17,261769942,272,18381,261769670,261769942
11901,5,12,149,5745,-77,-96,19,d2:00:04:7e:2c:ab,261770483,468,73,261770015,261770483
11902,5,12,149,5745,-61,-96,35,5e:29:73:5b:30:00,261771093,272,338,261770821,261771093
11903,5,12,149,5745,-54,-96,42,4a:ea:3c:f4:ce:b2,261771400,468,-161,261770932,261771400
11904,5,12,149,5745,-74,-96,22,f6:0a:5c:59:72:df,261773261,480,1381,261772781,261773261
11905,5,12,149,5745,-66,-96,30,a6:92:ad:b7:76:65,261773793,484,48,261773309,261773793
11906,5,12,149,5745,-69,-96,27,22:ec:75:a8:8a:31,261776237,544,1900,261775693,261776237
11907,5,12,149,5745,-65,-96,31,b6:90:18:f6:b1:d4,261778194,440,1517,261777754,261778194
11908,5,12,149,5745,-55,-96,41,3e:d1:9b:c7:a4:de,261778668,544,-70,261778124,261778668
11909,5,12,149,5745,-64,-96,32,3a:de:b0:2e:cd:45,261779913,468,777,261779445,261779913
11910,5,12,149,5745,-84,-96,12,9a:24:38:da:96:bb,261780712,824,-25,261779888,261780712
11911,5,12,149,5745,-64,-96,32,76:d6:6a:bb:b3:f5,261781616,468,436,261781148,261781616
11912,5,12,149,5745,-64,-96,32,76:d6:6a:bb:b3:f5,261786348,272,4460,261786076,261786348
11913,5,12,149,5745,-62,-96,34,5e:29:73:5b:30:00,261790443,540,3555,261789903,261790443
11914,5,12,149,5745,-60,-96,36,0a:b9:b7:b1:4d:fa,261793321,468,2410,261792853,261793321
11915,5,12,149,5745,-65,-96,31,f2:da:61:dd:98:c5,261793824,268,235,261793556,261793824
11916,5,12,149,5745,-71,-96,25,3e:ef:29:c7:4b:17,261795803,468,1511,261795335,261795803
11917,5,24,149,5745,-87,-96,9,,261814739,32,18904,261814707,261814739
11918,5,12,149,5745,-73,-96,23,f6:0a:5c:59:72:df,261815538,284,515,261815254,261815538
11919,5,6,149,5745,-87,-96,9,54:e4:3a:ec:fb:65,261820701,360,4803,261820341,261820701
11920,5,24,149,5745,-87,-96,9,,261824756,32,4023,261824724,261824756
11921,5,24,149,5745,-87,-96,9,,261825337,32,549,261825305,261825337
11922,5,24,149,5745,-87,-96,9,,261825917,28,552,261825889,261825917
11923,5,12,149,5745,-56,-96,40,4a:ea:3c:f4:ce:b2,261828269,272,2080,261827997,261828269
11924,5,24,149,5745,-70,-96,26,,261829045,28,748,261829017,261829045
11925,5,24,149,5745,-88,-96,8,,261829089,28,16,261829061,261829089
11926,5,24,149,5745,-88,-96,8,,261829197,28,80,261829169,261829197
11927,5,24,149,5745,-70,-96,26,,261829396,28,171,261829368,261829396
11928,5,24,149,5745,-88,-96,8,,261829440,28,16,261829412,261829440
11929,5,24,149,5745,-88,-96,8,,261829549,28,81,261829521,261829549
11930,5,12,149,5745,-68,-96,28,22:ec:75:a8:8a:31,261831625,272,1804,261831353,261831625
11931,5,24,149,5745,-88,-96,8,,261833802,32,2145,261833770,261833802
11932,5,24,149,5745,-88,-96,8,,261834081,28,251,261834053,261834081
11933,5,12,149,5745,-76,-96,20,d2:00:04:7e:2c:ab,261835992,468,1443,261835524,261835992
11934,5,12,149,5745,-56,-96,40,4a:ea:3c:f4:ce:b2,261836774,468,314,261836306,261836774
11935,5,12,149,5745,-62,-96,34,3a:de:b0:2e:cd:45,261837323,272,277,261837051,261837323
11936,5,12,149,5745,-73,-96,23,f6:0a:5c:59:72:df,261837665,480,-138,261837185,261837665
11937,5,24,149,5745,-88,-96,8,,261839981,28,2288,261839953,261839981
11938,5,12,149,5745,-57,-96,39,3e:d1:9b:c7:a4:de,261844972,272,4719,261844700,261844972
11939,5,12,149,5745,-71,-96,25,72:d1:72:1d:22:a1,261845306,256,78,261845050,261845306
11940,5,12,149,5745,-61,-96,35,3a:de:b0:2e:cd:45,261845643,468,-131,261845175,261845643
11941,5,12,149,5745,-71,-96,25,56:68:e2:c2:8d:d5,261847441,284,1514,261847157,261847441
11942,5,12,149,5745,-62,-96,34,76:d6:6a:bb:b3:f5,261847985,468,76,261847517,261847985
11943,5,12,149,5745,-63,-96,33,f2:da:61:dd:98:c5,261857006,268,8753,261856738,261857006
11944,5,12,149,5745,-66,-96,30,b6:90:18:f6:b1:d4,261857533,244,283,261857289,261857533
11945,5,12,149,5745,-60,-96,36,5e:29:73:5b:30:00,261865933,272,8128,261865661,261865933
11946,5,12,149,5745,-85,-96,11,9a:24:38:da:96:bb,261874719,272,8514,261874447,261874719
11947,5,12,149,5745,-72,-96,24,3e:ef:29:c7:4b:17,261880079,272,5088,261879807,261880079
11948,5,24,149,5745,-87,-96,9,,261880508,32,397,261880476,261880508
11949,5,12,149,5745,-74,-96,22,d2:00:04:7e:2c:ab,261901562,468,20586,261901094,261901562
11950,5,12,149,5745,-65,-96,31,76:d6:6a:bb:b3:f5,261913929,272,12095,261913657,261913929
11951,5,24,149,5745,-70,-96,26,,261922166,28,8209,261922138,261922166
11952,5,24,149,5745,-89,-96,7,,261922210,28,16,261922182,261922210
11953,5,24,149,5745,-90,-96,6,,261922318,28,80,261922290,261922318
11954,5,24,149,5745,-69,-96,27,,261922448,28,102,261922420,261922448
11955,5,24,149,5745,-91,-96,5,,261922492,28,16,261922464,261922492
11956,5,24,149,5745,-69,-96,27,,261922773,28,253,261922745,261922773
11957,5,24,149,5745,-90,-96,6,,261922817,28,16,261922789,261922817
11958,5,6,149,5745,-85,-96,11,54:e4:3a:ec:fb:65,261923101,360,-76,261922741,261923101
11959,5,24,149,5745,-70,-96,26,,261936456,28,13327,261936428,261936456
11960,5,24,149,5745,-90,-96,6,,261936500,28,16,261936472,261936500
11961,5,24,149,5745,-90,-96,6,,261939216,32,2684,261939184,261939216
11962,5,24,149,5745,-90,-96,6,,261939760,32,512,261939728,261939760
11963,5,24,149,5745,-89,-96,7,,261940305,28,517,261940277,261940305
11964,5,24,149,5745,-89,-96,7,,261942309,28,1976,261942281,261942309
11965,5,12,149,5745,-69,-96,27,72:d1:72:1d:22:a1,261947693,256,5128,261947437,261947693
11966,5,12,149,5745,-71,-96,25,56:68:e2:c2:8d:d5,261948514,284,537,261948230,261948514
11967,5,12,149,5745,-67,-96,29,22:ec:75:a8:8a:31,261948831,272,45,261948559,261948831
11968,5,12,149,5745,-58,-96,38,3e:d1:9b:c7:a4:de,261961910,272,12807,261961638,261961910
11969,5,12,149,5745,-73,-96,23,d2:00:04:7e:2c:ab,261967256,468,4878,261966788,261967256
11970,5,12,149,5745,-83,-96,13,9a:24:38:da:96:bb,261972439,272,4911,261972167,261972439
11971,5,24,149,5745,-72,-96,24,,261982686,28,10219,261982658,261982686
11972,5,24,149,5745,-89,-96,7,,261982729,28,15,261982701,261982729
11973,5,24,149,5745,-89,-96,7,,261982846,32,85,261982814,261982846
11974,5,12,149,5745,-58,-96,38,5e:29:73:5b:30:00,261983169,272,51,261982897,261983169
11975,5,12,149,5745,-58,-96,38,0a:b9:b7:b1:4d:fa,261992090,468,8453,261991622,261992090
11976,5,12,149,5745,-72,-96,24,3e:ef:29:c7:4b:17,261992592,272,230,261992320,261992592
11977,5,24,149,5745,-72,-96,24,,261998025,28,5405,261997997,261998025
11978,5,24,149,5745,-72,-96,24,,261998138,28,85,261998110,261998138
11979,5,6,149,5745,-71,-96,25,,261998473,52,283,261998421,261998473
11980,5,6,149,5745,-72,-96,24,,262001598,52,3073,262001546,262001598
11981,5,6,149,5745,-89,-96,7,,262001666,44,24,262001622,262001666
11982,5,24,149,5745,-89,-96,7,,262001783,28,89,262001755,262001783
11983,5,6,149,5745,-88,-96,8,54:e4:3a:ec:fb:65,262025502,360,23359,262025142,262025502
11984,5,12,149,5745,-63,-96,33,f2:da:61:dd:98:c5,262026221,268,451,262025953,262026221
11985,5,12,149,5745,-57,-96,39,3a:de:b0:2e:cd:45,262027342,272,849,262027070,262027342
11986,5,12,149,5745,-65,-96,31,76:d6:6a:bb:b3:f5,262028419,272,805,262028147,262028419
11987,5,12,149,5745,-72,-96,24,56:68:e2:c2:8d:d5,262050834,284,22131,262050550,262050834
11988,5,12,149,5745,-66,-96,30,b6:90:18:f6:b1:d4,262052245,244,1167,262052001,262052245
11989,5,12,149,5745,-71,-96,25,72:d1:72:1d:22:a1,262052570,256,69,262052314,262052570
11990,5,12,149,5745,-69,-96,27,22:ec:75:a8:8a:31,262065862,272,13020,262065590,262065862
11991,5,12,149,5745,-58,-96,38,3e:d1:9b:c7:a4:de,262074793,272,8659,262074521,262074793
11992,5,12,149,5745,-84,-96,12,9a:24:38:da:96:bb,262088881,272,13816,262088609,262088881
11993,5,12,149,5745,-59,-96,37,5e:29:73:5b:30:00,262100199,272,11046,262099927,262100199
11994,5,12,149,5745,-72,-96,24,3e:ef:29:c7:4b:17,262109850,272,9379,262109578,262109850
11995,5,6,149,5745,-84,-96,12,54:e4:3a:ec:fb:65,262127903,360,17693,262127543,262127903
11996,5,12,149,5745,-64,-96,32,f2:da:61:dd:98:c5,262128588,268,417,262128320,262128588
11997,5,12,149,5745,-58,-96,38,3a:de:b0:2e:cd:45,262129166,272,306,262128894,262129166
11998,5,12,149,5745,-63,-96,33,76:d6:6a:bb:b3:f5,262140441,272,11003,262140169,262140441
11999,5,12,149,5745,-72,-96,24,56:68:e2:c2:8d:d5,262152859,284,12134,262152575,262152859
12000,5,12,149,5745,-65,-96,31,b6:90:18:f6:b1:d4,262153223,244,120,262152979,262153223
12001,5,12,149,5745,-72,-96,24,72:d1:72:1d:22:a1,262153611,256,132,262153355,262153611
12002,5,12,149,5745,-59,-96,37,4a:ea:3c:f4:ce:b2,262175962,272,22079,262175690,262175962
12003,5,12,149,5745,-67,-96,29,22:ec:75:a8:8a:31,262177674,272,1440,262177402,262177674
12004,5,12,149,5745,-59,-96,37,3a:de:b0:2e:cd:45,262184034,272,6088,262183762,262184034
12005,5,12,149,5745,-57,-96,39,3e:d1:9b:c7:a4:de,262186713,272,2407,262186441,262186713
12006,5,12,149,5745,-64,-96,32,f2:da:61:dd:98:c5,262195792,268,8811,262195524,262195792
12007,5,12,149,5745,-64,-96,32,b6:90:18:f6:b1:d4,262197256,244,1220,262197012,262197256
12008,5,12,149,5745,-73,-96,23,3e:ef:29:c7:4b:17,262213951,272,16423,262213679,262213951
12009,5,12,149,5745,-73,-96,23,72:d1:72:1d:22:a1,262214986,256,779,262214730,262214986
12010,5,12,149,5745,-64,-96,32,5e:29:73:5b:30:00,262229835,272,14577,262229563,262229835
12011,5,6,149,5745,-84,-96,12,54:e4:3a:ec:fb:65,262230303,360,108,262229943,262230303
12012,5,12,149,5745,-67,-96,29,f6:0a:5c:59:72:df,262231500,480,717,262231020,262231500
12013,5,12,149,5745,-67,-96,29,22:ec:75:a8:8a:31,262232059,544,15,262231515,262232059
12014,5,12,149,5745,-73,-96,23,d2:00:04:7e:2c:ab,262232693,468,166,262232225,262232693
12015,5,12,149,5745,-61,-96,35,4a:ea:3c:f4:ce:b2,262233277,468,116,262232809,262233277
12016,5,12,149,5745,-56,-96,40,3e:d1:9b:c7:a4:de,262235956,544,2135,262235412,262235956
12017,5,12,149,5745,-64,-96,32,b6:90:18:f6:b1:d4,262237724,440,1328,262237284,262237724
12018,5,12,149,5745,-59,-96,37,3a:de:b0:2e:cd:45,262239297,468,1105,262238829,262239297
12019,5,12,149,5745,-63,-96,33,76:d6:6a:bb:b3:f5,262241772,468,2007,262241304,262241772
12020,5,12,149,5745,-63,-96,33,76:d6:6a:bb:b3:f5,262245082,272,3038,262244810,262245082
12021,5,12,149,5745,-72,-96,24,56:68:e2:c2:8d:d5,262245443,284,77,262245159,262245443
12022,5,12,149,5745,-62,-96,34,5e:29:73:5b:30:00,262248236,540,2253,262247696,262248236
12023,5,12,149,5745,-72,-96,24,56:68:e2:c2:8d:d5,262250990,480,2274,262250510,262250990
12024,5,12,149,5745,-61,-96,35,f2:da:61:dd:98:c5,262252477,268,1219,262252209,262252477
12025,5,12,149,5745,-73,-96,23,72:d1:72:1d:22:a1,262252824,452,-105,262252372,262252824
12026,5,12,149,5745,-73,-96,23,3e:ef:29:c7:4b:17,262253319,468,27,262252851,262253319
12027,5,12,149,5745,-67,-96,29,f6:0a:5c:59:72:df,262270653,284,17050,262270369,262270653
12028,5,12,149,5745,-63,-96,33,4a:ea:3c:f4:ce:b2,262278073,272,7148,262277801,262278073
12029,5,12,149,5745,-57,-96,39,9e:1f:b0:a7:b8:90,262282867,416,4378,262282451,262282867
12030,5,12,149,5745,-63,-96,33,f2:da:61:dd:98:c5,262294635,268,11500,262294367,262294635
12031,5,12,149,5745,-61,-96,35,4a:ea:3c:f4:ce:b2,262294947,468,-156,262294479,262294947
12032,5,12,149,5745,-60,-96,36,3a:de:b0:2e:cd:45,262296666,272,1447,262296394,262296666
12033,5,12,149,5745,-68,-96,28,f6:0a:5c:59:72:df,262297079,480,-67,262296599,262297079
12034,5,12,149,5745,-68,-96,28,22:ec:75:a8:8a:31,262297603,544,-20,262297059,262297603
12035,5,12,149,5745,-69,-96,27,a6:92:ad:b7:76:65,262298181,484,94,262297697,262298181
12036,5,24,149,5745,-89,-96,7,,262298807,28,598,262298779,262298807
12037,5,12,149,5745,-61,-96,35,3a:de:b0:2e:cd:45,262299588,380,401,262299208,262299588
12038,5,12,149,5745,-56,-96,40,3e:d1:9b:c7:a4:de,262301424,544,1292,262300880,262301424
12039,5,12,149,5745,-64,-96,32,b6:90:18:f6:b1:d4,262302643,440,779,262302203,262302643
12040,5,12,149,5745,-61,-96,35,3a:de:b0:2e:cd:45,262304307,468,1196,262303839,262304307
12041,5,12,149,5745,-84,-96,12,9a:24:38:da:96:bb,262304819,824,-312,262303995,262304819
12042,5,12,149,5745,-62,-96,34,4a:ea:3c:f4:ce:b2,262305877,272,786,262305605,262305877
12043,5,12,149,5745,-62,-96,34,76:d6:6a:bb:b3:f5,262306665,468,320,262306197,262306665
12044,5,12,149,5745,-84,-96,12,9a:24:38:da:96:bb,262307574,272,637,262307302,262307574
12045,5,12,149,5745,-64,-96,32,b6:90:18:f6:b1:d4,262309649,244,1831,262309405,262309649
12046,5,12,149,5745,-68,-96,28,22:ec:75:a8:8a:31,262309981,272,60,262309709,262309981
12047,5,12,149,5745,-57,-96,39,3e:d1:9b:c7:a4:de,262310386,272,133,262310114,262310386
12048,5,12,149,5745,-69,-96,27,aa:b6:ae:27:64:4e,262312304,468,1450,262311836,262312304
12049,5,12,149,5745,-73,-96,23,d2:00:04:7e:2c:ab,262312951,380,267,262312571,262312951
12050,5,12,149,5745,-74,-96,22,56:68:e2:c2:8d:d5,262313680,480,249,262313200,262313680
12051,5,12,149,5745,-58,-96,38,5e:29:73:5b:30:00,262314194,540,-26,262313654,262314194
12052,5,12,149,5745,-72,-96,24,72:d1:72:1d:22:a1,262315615,452,969,262315163,262315615
12053,5,12,149,5745,-61,-96,35,4a:ea:3c:f4:ce:b2,262316469,272,582,262316197,262316469
12054,5,12,149,5745,-75,-96,21,3e:ef:29:c7:4b:17,262317477,468,540,262317009,262317477
12055,5,12,149,5745,-65,-96,31,0a:b9:b7:b1:4d:fa,262318007,468,62,262317539,262318007
12056,5,12,149,5745,-63,-96,33,f2:da:61:dd:98:c5,262318537,268,262,262318269,262318537
12057,5,12,149,5745,-72,-96,24,72:d1:72:1d:22:a1,262326363,256,7570,262326107,262326363
12058,5,12,149,5745,-61,-96,35,4a:ea:3c:f4:ce:b2,262326654,272,19,262326382,262326654
12059,5,12,149,5745,-74,-96,22,3e:ef:29:c7:4b:17,262326997,272,71,262326725,262326997
12060,5,6,149,5745,-85,-96,11,54:e4:3a:ec:fb:65,262332704,360,5347,262332344,262332704
12061,5,12,149,5745,-59,-96,37,9e:1f:b0:a7:b8:90,262339620,456,6460,262339164,262339620
12062,5,12,149,5745,-74,-96,22,56:68:e2:c2:8d:d5,262344034,284,4130,262343750,262344034
12063,5,12,149,5745,-58,-96,38,5e:29:73:5b:30:00,262345396,272,1090,262345124,262345396
12064,5,12,149,5745,-61,-96,35,76:d6:6a:bb:b3:f5,262359724,272,14056,262359452,262359724
12065,5,12,149,5745,-63,-96,33,4a:ea:3c:f4:ce:b2,262360094,468,-98,262359626,262360094
12066,5,12,149,5745,-73,-96,23,d2:00:04:7e:2c:ab,262360641,468,79,262360173,262360641
12067,5,12,149,5745,-60,-96,36,9e:1f:b0:a7:b8:90,262362412,288,1483,262362124,262362412
12068,5,12,149,5745,-69,-96,27,f6:0a:5c:59:72:df,262363213,480,321,262362733,262363213
12069,5,12,149,5745,-60,-96,36,9e:1f:b0:a7:b8:90,262364132,456,463,262363676,262364132
12070,5,12,149,5745,-61,-96,35,3a:de:b0:2e:cd:45,262370149,468,5549,262369681,262370149
12071,5,12,149,5745,-61,-96,35,76:d6:6a:bb:b3:f5,262371227,468,610,262370759,262371227
12072,5,12,149,5745,-69,-96,27,f6:0a:5c:59:72:df,262382718,284,11207,262382434,262382718
12073,5,12,149,5745,-63,-96,33,4a:ea:3c:f4:ce:b2,262389868,272,6878,262389596,262389868
12074,5,12,149,5745,-60,-96,36,3a:de:b0:2e:cd:45,262394351,272,4211,262394079,262394351
12075,5,12,149,5745,-67,-96,29,22:ec:75:a8:8a:31,262407963,272,13340,262407691,262407963
12076,5,12,149,5745,-59,-96,37,3e:d1:9b:c7:a4:de,262413867,272,5632,262413595,262413867
12077,5,12,149,5745,-63,-96,33,f2:da:61:dd:98:c5,262420618,268,6483,262420350,262420618
12078,5,12,149,5745,-83,-96,13,9a:24:38:da:96:bb,262421029,272,139,262420757,262421029
12079,5,12,149,5745,-65,-96,31,b6:90:18:f6:b1:d4,262424738,244,3465,262424494,262424738
12080,5,12,149,5745,-73,-96,23,d2:00:04:7e:2c:ab,262426287,468,1081,262425819,262426287
12081,5,6,149,5745,-84,-96,12,54:e4:3a:ec:fb:65,262435104,360,8457,262434744,262435104
12082,5,12,149,5745,-61,-96,35,5e:29:73:5b:30:00,262441700,272,6324,262441428,262441700
12083,5,12,149,5745,-76,-96,20,72:d1:72:1d:22:a1,262442089,256,133,262441833,262442089
12084,5,12,149,5745,-72,-96,24,56:68:e2:c2:8d:d5,262472130,284,29757,262471846,262472130
12085,5,12,149,5745,-72,-96,24,d2:00:04:7e:2c:ab,262490880,468,18282,262490412,262490880
12086,5,12,149,5745,-72,-96,24,3e:ef:29:c7:4b:17,262513270,272,22118,262512998,262513270
12087,5,12,149,5745,-64,-96,32,0a:b9:b7:b1:4d:fa,262514170,468,432,262513702,262514170
12088,5,12,149,5745,-67,-96,29,22:ec:75:a8:8a:31,262520339,272,5897,262520067,262520339
12089,5,12,149,5745,-60,-96,36,4a:ea:3c:f4:ce:b2,262522014,272,1403,262521742,262522014
12090,5,12,149,5745,-58,-96,38,3e:d1:9b:c7:a4:de,262531057,272,8771,262530785,262531057
12091,5,12,149,5745,-64,-96,32,f2:da:61:dd:98:c5,262533143,268,1818,262532875,262533143
12092,5,12,149,5745,-66,-96,30,f6:0a:5c:59:72:df,262536211,284,2784,262535927,262536211
12093,5,12,149,5745,-56,-96,40,3a:de:b0:2e:cd:45,262537182,272,699,262536910,262537182
12094,5,12,149,5745,-64,-96,32,76:d6:6a:bb:b3:f5,262537546,272,92,262537274,262537546
12095,5,12,149,5745,-59,-96,37,9e:1f:b0:a7:b8:90,262538619,256,817,262538363,262538619
12096,5,12,149,5745,-77,-96,19,72:d1:72:1d:22:a1,262554586,256,15711,262554330,262554586
12097,5,12,149,5745,-62,-96,34,5e:29:73:5b:30:00,262557604,272,2746,262557332,262557604
12098,5,12,149,5745,-65,-96,31,b6:90:18:f6:b1:d4,262562025,244,4177,262561781,262562025
12099,5,12,149,5745,-71,-96,25,3e:ef:29:c7:4b:17,262616009,272,53712,262615737,262616009
12100,5,12,149,5745,-67,-96,29,f6:0a:5c:59:72:df,262624758,284,8465,262624474,262624758
12101,5,12,149,5745,-61,-96,35,4a:ea:3c:f4:ce:b2,262630354,272,5324,262630082,262630354
12102,5,12,149,5745,-69,-96,27,22:ec:75:a8:8a:31,262638407,272,7781,262638135,262638407
12103,5,12,149,5745,-64,-96,32,76:d6:6a:bb:b3:f5,262639825,272,1146,262639553,262639825
12104,5,12,149,5745,-58,-96,38,3a:de:b0:2e:cd:45,262640412,272,315,262640140,262640412
12105,5,12,149,5745,-58,-96,38,9e:1f:b0:a7:b8:90,262640781,256,113,262640525,262640781
12106,5,12,149,5745,-64,-96,32,f2:da:61:dd:98:c5,262644801,268,3752,262644533,262644801
12107,5,12,149,5745,-58,-96,38,3e:d1:9b:c7:a4:de,262646276,272,1203,262646004,262646276
12108,5,12,149,5745,-79,-96,17,9a:24:38:da:96:bb,262646898,272,350,262646626,262646898
12109,5,12,149,5745,-65,-96,31,b6:90:18:f6:b1:d4,262664456,244,17314,262664212,262664456
12110,5,12,149,5745,-71,-96,25,56:68:e2:c2:8d:d5,262666166,284,1426,262665882,262666166
12111,5,12,149,5745,-76,-96,20,72:d1:72:1d:22:a1,262673301,256,6879,262673045,262673301
12112,5,12,149,5745,-74,-96,22,3e:ef:29:c7:4b:17,262674275,272,702,262674003,262674275
12113,5,12,149,5745,-71,-96,25,56:68:e2:c2:8d:d5,262687766,284,13207,262687482,262687766
12114,5,12,149,5745,-59,-96,37,5e:29:73:5b:30:00,262688688,272,650,262688416,262688688
12115,5,12,149,5745,-71,-96,25,d2:00:04:7e:2c:ab,262689165,468,9,262688697,262689165
12116,5,12,149,5745,-68,-96,28,f6:0a:5c:59:72:df,262689694,480,49,262689214,262689694
12117,5,12,149,5745,-61,-96,35,4a:ea:3c:f4:ce:b2,262690488,468,326,262690020,262690488
12118,5,12,149,5745,-65,-97,32,b6:90:18:f6:b1:d4,262695575,440,4647,262695135,262695575
12119,5,12,149,5745,-57,-97,40,3e:d1:9b:c7:a4:de,262696958,544,839,262696414,262696958
12120,5,12,149,5745,-82,-97,15,9a:24:38:da:96:bb,262697555,824,-227,262696731,262697555
12121,5,12,149,5745,-63,-97,34,76:d6:6a:bb:b3:f5,262698557,468,534,262698089,262698557
12122,5,12,149,5745,-58,-97,39,3a:de:b0:2e:cd:45,262699916,468,891,262699448,262699916
12123,5,12,149,5745,-62,-97,35,76:d6:6a:bb:b3:f5,262703785,272,3597,262703513,262703785
12124,5,12,149,5745,-58,-97,39,9e:1f:b0:a7:b8:90,262705947,256,1906,262705691,262705947
12125,5,12,149,5745,-59,-97,38,5e:29:73:5b:30:00,262707092,540,605,262706552,262707092
12126,5,12,149,5745,-72,-97,25,56:68:e2:c2:8d:d5,262708739,480,1167,262708259,262708739
12127,5,12,149,5745,-77,-97,20,72:d1:72:1d:22:a1,262710471,452,1280,262710019,262710471
12128,5,12,149,5745,-62,-97,35,f2:da:61:dd:98:c5,262711282,268,543,262711014,262711282
12129,5,12,149,5745,-74,-97,23,3e:ef:29:c7:4b:17,262712627,468,877,262712159,262712627
12130,5,12,149,5745,-58,-97,39,9e:1f:b0:a7:b8:90,262714221,452,1142,262713769,262714221
12131,5,12,149,5745,-68,-97,29,f6:0a:5c:59:72:df,262721693,284,7188,262721409,262721693
12132,5,12,149,5745,-61,-97,36,4a:ea:3c:f4:ce:b2,262727429,272,5464,262727157,262727429
12133,5,12,149,5745,-58,-97,39,3a:de:b0:2e:cd:45,262738771,272,11070,262738499,262738771
12134,5,6,149,5745,-82,-97,15,54:e4:3a:ec:fb:65,262742306,360,3175,262741946,262742306
12135,5,12,149,5745,-58,-97,39,9e:1f:b0:a7:b8:90,262742891,356,229,262742535,262742891
12136,5,12,149,5745,-58,-97,39,9e:1f:b0:a7:b8:90,262743389,104,394,262743285,262743389
12137,5,12,149,5745,-66,-97,31,b6:90:18:f6:b1:d4,262751936,244,8303,262751692,262751936
12138,5,12,149,5745,-68,-97,29,22:ec:75:a8:8a:31,262752959,272,751,262752687,262752959
12139,5,12,149,5745,-62,-97,35,f2:da:61:dd:98:c5,262753418,268,191,262753150,262753418
12140,5,12,149,5745,-61,-97,36,4a:ea:3c:f4:ce:b2,262755071,468,1185,262754603,262755071
12141,5,12,149,5745,-70,-97,27,f6:0a:5c:59:72:df,262755591,480,40,262755111,262755591
12142,5,12,149,5745,-82,-97,15,9a:24:38:da:96:bb,262757108,272,1245,262756836,262757108
12143,5,12,149,5745,-66,-97,31,b6:90:18:f6:b1:d4,262761519,440,3971,262761079,262761519
12144,5,12,149,5745,-59,-97,38,3a:de:b0:2e:cd:45,262762855,468,868,262762387,262762855
12145,5,12,149,5745,-56,-97,41,3e:d1:9b:c7:a4:de,262763889,272,762,262763617,262763889
12146,5,12,149,5745,-61,-97,36,76:d6:6a:bb:b3:f5,262776508,468,12151,262776040,262776508
12147,5,12,149,5745,-62,-97,35,f2:da:61:dd:98:c5,262777039,268,263,262776771,262777039
12148,5,12,149,5745,-57,-97,40,9e:1f:b0:a7:b8:90,262778288,452,797,262777836,262778288
12149,5,12,149,5745,-77,-97,20,72:d1:72:1d:22:a1,262779290,256,746,262779034,262779290
12150,5,12,149,5745,-59,-97,38,5e:29:73:5b:30:00,262787617,272,8055,262787345,262787617
12151,5,12,149,5745,-73,-97,24,3e:ef:29:c7:4b:17,262793928,272,6039,262793656,262793928
12152,5,12,149,5745,-57,-97,40,9e:1f:b0:a7:b8:90,262817841,256,23657,262817585,262817841
12153,5,12,149,5745,-61,-97,36,76:d6:6a:bb:b3:f5,262818888,272,775,262818616,262818888
12154,5,12,149,5745,-71,-97,26,d2:00:04:7e:2c:ab,262819576,468,220,262819108,262819576
12155,5,12,149,5745,-62,-97,35,4a:ea:3c:f4:ce:b2,262820802,468,758,262820334,262820802
12156,5,12,149,5745,-70,-97,27,f6:0a:5c:59:72:df,262821412,480,130,262820932,262821412
12157,5,12,149,5745,-68,-97,29,a6:92:ad:b7:76:65,262822484,484,588,262822000,262822484
12158,5,12,149,5745,-68,-97,29,22:ec:75:a8:8a:31,262823002,544,-26,262822458,262823002
12159,5,12,149,5745,-65,-97,32,b6:90:18:f6:b1:d4,262827064,440,3622,262826624,262827064
12160,5,12,149,5745,-57,-97,40,3e:d1:9b:c7:a4:de,262827539,544,-69,262826995,262827539
12161,5,12,149,5745,-84,-97,13,9a:24:38:da:96:bb,262828126,824,-237,262827302,262828126
12162,5,12,149,5745,-60,-97,37,3a:de:b0:2e:cd:45,262828985,468,391,262828517,262828985
12163,5,12,149,5745,-71,-97,26,f6:0a:5c:59:72:df,262834486,284,5217,262834202,262834486
12164,5,12,149,5745,-70,-97,27,aa:b6:ae:27:64:4e,262834832,468,-122,262834364,262834832
12165,5,12,149,5745,-62,-97,35,76:d6:6a:bb:b3:f5,262837989,468,2689,262837521,262837989
12166,5,12,149,5745,-64,-97,33,4a:ea:3c:f4:ce:b2,262838795,272,534,262838523,262838795
12167,5,12,149,5745,-59,-97,38,5e:29:73:5b:30:00,262839642,540,307,262839102,262839642
12168,5,12,149,5745,-57,-97,40,9e:1f:b0:a7:b8:90,262841279,452,1185,262840827,262841279
12169,5,12,149,5745,-72,-97,25,3e:ef:29:c7:4b:17,262841766,468,19,262841298,262841766
12170,5,12,149,5745,-65,-97,32,0a:b9:b7:b1:4d:fa,262842286,468,52,262841818,262842286
12171,5,12,149,5745,-62,-97,35,f2:da:61:dd:98:c5,262842789,268,235,262842521,262842789
12172,5,6,149,5745,-84,-97,13,54:e4:3a:ec:fb:65,262844706,360,1557,262844346,262844706
12173,5,12,149,5745,-60,-97,37,3a:de:b0:2e:cd:45,262853082,272,8104,262852810,262853082
12174,5,12,149,5745,-64,-97,33,b6:90:18:f6:b1:d4,262867060,244,13734,262866816,262867060
12175,5,12,149,5745,-67,-97,30,22:ec:75:a8:8a:31,262867993,272,661,262867721,262867993
12176,5,12,149,5745,-61,-97,36,f2:da:61:dd:98:c5,262868812,268,551,262868544,262868812
12177,5,12,149,5745,-72,-97,25,56:68:e2:c2:8d:d5,262871417,284,2321,262871133,262871417
12178,5,12,149,5745,-61,-97,36,3e:d1:9b:c7:a4:de,262877000,272,5311,262876728,262877000
12179,5,12,149,5745,-69,-97,28,d2:00:04:7e:2c:ab,262883646,468,6178,262883178,262883646
12180,5,12,149,5745,-64,-97,33,4a:ea:3c:f4:ce:b2,262884445,468,331,262883977,262884445
12181,5,12,149,5745,-69,-97,28,f6:0a:5c:59:72:df,262887458,480,2533,262886978,262887458
12182,5,12,149,5745,-59,-97,38,3a:de:b0:2e:cd:45,262894526,468,6600,262894058,262894526
12183,5,12,149,5745,-61,-97,36,5e:29:73:5b:30:00,262904842,272,10044,262904570,262904842
12184,5,12,149,5745,-56,-97,41,9e:1f:b0:a7:b8:90,262906508,452,1214,262906056,262906508
12185,5,12,149,5745,-76,-97,21,3e:ef:29:c7:4b:17,262909089,272,2309,262908817,262909089
12186,5,24,149,5745,-71,-97,26,,262922500,28,13383,262922472,262922500
12187,5,24,149,5745,-88,-97,9,,262922544,28,16,262922516,262922544
12188,5,12,149,5745,-56,-97,41,9e:1f:b0:a7:b8:90,262933302,256,10502,262933046,262933302
12189,5,12,149,5745,-62,-97,35,76:d6:6a:bb:b3:f5,262938383,272,4809,262938111,262938383
12190,5,6,149,5745,-86,-97,11,54:e4:3a:ec:fb:65,262947107,360,8364,262946747,262947107
12191,5,12,149,5745,-69,-97,28,d2:00:04:7e:2c:ab,262950133,468,2558,262949665,262950133
12192,5,12,149,5745,-68,-97,29,f6:0a:5c:59:72:df,262958454,284,8037,262958170,262958454
12193,5,12,149,5745,-64,-97,33,4a:ea:3c:f4:ce:b2,262966871,272,8145,262966599,262966871
12194,5,12,149,5745,-59,-97,38,3a:de:b0:2e:cd:45,262971037,272,3894,262970765,262971037
12195,5,12,149,5745,-76,-97,21,72:d1:72:1d:22:a1,262971905,256,612,262971649,262971905
12196,5,12,149,5745,-70,-97,27,56:68:e2:c2:8d:d5,262973120,284,931,262972836,262973120
12197,5,12,149,5745,-67,-97,30,22:ec:75:a8:8a:31,262982211,272,8819,262981939,262982211
12198,5,12,149,5745,-64,-97,33,b6:90:18:f6:b1:d4,262983372,244,917,262983128,262983372
12199,5,12,149,5745,-81,-97,16,9a:24:38:da:96:bb,262983983,272,339,262983711,262983983
12200,5,12,149,5745,-59,-97,38,3e:d1:9b:c7:a4:de,262993995,272,9740,262993723,262993995
12201,5,24,149,5745,-71,-97,26,,262997063,28,3040,262997035,262997063
12202,5,24,149,5745,-89,-97,8,,262997107,28,16,262997079,262997107
12203,5,12,149,5745,-69,-97,28,d2:00:04:7e:2c:ab,263015619,468,18044,263015151,263015619
12204,5,12,149,5745,-59,-97,38,5e:29:73:5b:30:00,263021884,272,5993,263021612,263021884
12205,5,12,149,5745,-73,-97,24,3e:ef:29:c7:4b:17,263025182,272,3026,263024910,263025182
12206,5,12,149,5745,-66,-97,31,0a:b9:b7:b1:4d:fa,263038529,468,12879,263038061,263038529
12207,5,24,149,5745,-70,-97,27,,263043553,28,4996,263043525,263043553
12208,5,24,149,5745,-89,-97,8,,263043597,28,16,263043569,263043597
12209,5,24,149,5745,-89,-97,8,,263043705,28,80,263043677,263043705
12210,5,6,149,5745,-87,-97,10,54:e4:3a:ec:fb:65,263049508,360,5443,263049148,263049508
12211,5,12,149,5745,-55,-97,42,9e:1f:b0:a7:b8:90,263050147,256,383,263049891,263050147
12212,5,12,149,5745,-67,-97,30,76:d6:6a:bb:b3:f5,263051379,272,960,263051107,263051379
12213,5,12,149,5745,-60,-97,37,f2:da:61:dd:98:c5,263052319,268,672,263052051,263052319
12214,5,12,149,5745,-77,-97,20,72:d1:72:1d:22:a1,263074717,256,22142,263074461,263074717
12215,5,12,149,5745,-71,-97,26,56:68:e2:c2:8d:d5,263075287,284,286,263075003,263075287
12216,5,12,149,5745,-81,-97,16,9a:24:38:da:96:bb,263093150,272,17591,263092878,263093150
12217,5,12,149,5745,-66,-97,31,22:ec:75:a8:8a:31,263099177,272,5755,263098905,263099177
12218,5,12,149,5745,-60,-97,37,3e:d1:9b:c7:a4:de,263110961,272,11512,263110689,263110961
12219,5,12,149,5745,-57,-97,40,5e:29:73:5b:30:00,263136538,272,25305,263136266,263136538
12220,5,12,149,5745,-73,-97,24,3e:ef:29:c7:4b:17,263137946,272,1136,263137674,263137946
12221,5,6,149,5745,-87,-97,10,54:e4:3a:ec:fb:65,263151908,360,13602,263151548,263151908
12222,5,12,149,5745,-60,-97,37,f2:da:61:dd:98:c5,263152659,268,483,263152391,263152659
12223,5,12,149,5745,-60,-97,37,3a:de:b0:2e:cd:45,263153149,272,218,263152877,263153149
12224,5,12,149,5745,-56,-97,41,9e:1f:b0:a7:b8:90,263163149,256,9744,263162893,263163149
12225,5,12,149,5745,-68,-97,29,76:d6:6a:bb:b3:f5,263164704,272,1283,263164432,263164704
12226,5,12,149,5745,-75,-97,22,72:d1:72:1d:22:a1,263176648,256,11688,263176392,263176648
12227,5,12,149,5745,-63,-97,34,b6:90:18:f6:b1:d4,263177104,244,212,263176860,263177104
12228,5,12,149,5745,-71,-97,26,56:68:e2:c2:8d:d5,263177976,284,588,263177692,263177976
12229,5,12,149,5745,-67,-97,30,22:ec:75:a8:8a:31,263210966,272,32718,263210694,263210966
12230,5,12,149,5745,-66,-97,31,0a:e1:ab:b3:c3:a6,263212839,116,1757,263212723,263212839
12231,5,12,149,5745,-66,-97,31,0a:e1:ab:b3:c3:a6,263213043,116,88,263212927,263213043
12232,5,12,149,5745,-65,-97,32,0a:e1:ab:b3:c3:a6,263213328,116,169,263213212,263213328
12233,5,12,149,5745,-65,-97,32,0a:e1:ab:b3:c3:a6,263213551,116,107,263213435,263213551
12234,5,12,149,5745,-65,-97,32,0a:e1:ab:b3:c3:a6,263213845,360,-66,263213485,263213845
12235,5,12,149,5745,-64,-97,33,b6:90:18:f6:b1:d4,263214993,244,904,263214749,263214993
12236,5,12,149,5745,-60,-97,37,3e:d1:9b:c7:a4:de,263222755,272,7490,263222483,263222755
12237,5,12,149,5745,-74,-97,23,72:d1:72:1d:22:a1,263231984,256,8973,263231728,263231984
12238,5,12,149,5745,-77,-97,20,3e:ef:29:c7:4b:17,263244566,272,12310,263244294,263244566
12239,5,12,149,5745,-58,-97,39,5e:29:73:5b:30:00,263248851,272,4013,263248579,263248851
12240,5,6,149,5745,-86,-97,11,54:e4:3a:ec:fb:65,263254308,360,5097,263253948,263254308
12241,5,12,149,5745,-59,-97,38,3a:de:b0:2e:cd:45,263255054,272,474,263254782,263255054
12242,5,12,149,5745,-61,-97,36,f2:da:61:dd:98:c5,263255779,268,457,263255511,263255779
12243,5,12,149,5745,-72,-97,25,56:68:e2:c2:8d:d5,263264180,284,8117,263263896,263264180
12244,5,12,149,5745,-56,-97,41,9e:1f:b0:a7:b8:90,263276558,256,12122,263276302,263276558
12245,5,12,149,5745,-64,-97,33,76:d6:6a:bb:b3:f5,263277493,272,663,263277221,263277493
12246,5,12,149,5745,-68,-97,29,f6:0a:5c:59:72:df,263280625,480,2652,263280145,263280625
12247,5,12,149,5745,-68,-97,29,22:ec:75:a8:8a:31,263281139,544,-30,263280595,263281139
12248,5,12,149,5745,-59,-97,38,3e:d1:9b:c7:a4:de,263284570,544,2887,263284026,263284570
12249,5,12,149,5745,-65,-97,32,0a:e1:ab:b3:c3:a6,263287067,468,2029,263286599,263287067
12250,5,12,149,5745,-61,-97,36,4a:ea:3c:f4:ce:b2,263287570,468,35,263287102,263287570
12251,5,12,149,5745,-68,-97,29,f6:0a:5c:59:72:df,263288080,284,226,263287796,263288080
12252,5,12,149,5745,-59,-97,38,3a:de:b0:2e:cd:45,263288400,468,-148,263287932,263288400
12253,5,12,149,5745,-64,-97,33,b6:90:18:f6:b1:d4,263288904,440,64,263288464,263288904
12254,5,12,149,5745,-60,-97,37,3a:de:b0:2e:cd:45,263295432,272,6256,263295160,263295432
12255,5,12,149,5745,-69,-97,28,d2:00:04:7e:2c:ab,263295918,468,18,263295450,263295918
12256,5,12,149,5745,-64,-97,33,76:d6:6a:bb:b3:f5,263296422,468,36,263295954,263296422
12257,5,12,149,5745,-58,-97,39,5e:29:73:5b:30:00,263296951,540,-11,263296411,263296951
12258,5,12,149,5745,-74,-97,23,3e:ef:29:c7:4b:17,263297534,468,115,263297066,263297534
12259,5,12,149,5745,-64,-97,33,0a:e1:ab:b3:c3:a6,263298036,272,230,263297764,263298036
12260,5,12,149,5745,-74,-97,23,72:d1:72:1d:22:a1,263298657,452,169,263298205,263298657
12261,5,12,149,5745,-73,-97,24,56:68:e2:c2:8d:d5,263299224,480,87,263298744,263299224
12262,5,12,149,5745,-62,-97,35,f2:da:61:dd:98:c5,263300971,268,1479,263300703,263300971
12263,5,12,149,5745,-57,-97,40,9e:1f:b0:a7:b8:90,263301851,452,428,263301399,263301851
12264,5,12,149,5745,-63,-97,34,f2:da:61:dd:98:c5,263310384,268,8265,263310116,263310384
12265,5,12,149,5745,-84,-97,13,9a:24:38:da:96:bb,263316317,272,5661,263316045,263316317
12266,5,6,149,5745,-76,-97,21,24:f6:77:10:02:c8,263317643,176,1150,263317467,263317643
12267,5,12,149,5745,-62,-97,35,b6:90:18:f6:b1:d4,263325799,244,7912,263325555,263325799
12268,5,6,149,5745,-76,-97,21,24:f6:77:10:02:c8,263328242,176,2267,263328066,263328242
12269,5,12,149,5745,-69,-97,28,22:ec:75:a8:8a:31,263341888,272,13374,263341616,263341888
12270,5,12,149,5745,-72,-97,25,72:d1:72:1d:22:a1,263342195,256,51,263341939,263342195
12271,5,12,149,5745,-56,-97,41,3e:d1:9b:c7:a4:de,263342680,272,213,263342408,263342680
12272,5,12,149,5745,-70,-97,27,f6:0a:5c:59:72:df,263346010,480,2850,263345530,263346010
12273,5,12,149,5745,-58,-97,39,9e:1f:b0:a7:b8:90,263348125,356,1759,263347769,263348125
12274,5,12,149,5745,-58,-97,39,9e:1f:b0:a7:b8:90,263348560,104,331,263348456,263348560
12275,5,12,149,5745,-58,-97,39,9e:1f:b0:a7:b8:90,263348779,156,63,263348623,263348779
12276,5,12,149,5745,-63,-97,34,4a:ea:3c:f4:ce:b2,263349300,364,157,263348936,263349300
12277,5,12,149,5745,-56,-97,41,3e:d1:9b:c7:a4:de,263349698,544,-146,263349154,263349698
12278,5,12,149,5745,-62,-97,35,b6:90:18:f6:b1:d4,263351475,440,1337,263351035,263351475
12279,5,12,149,5745,-62,-97,35,4a:ea:3c:f4:ce:b2,263351949,468,6,263351481,263351949
12280,5,12,149,5745,-85,-97,12,9a:24:38:da:96:bb,263352470,824,-303,263351646,263352470
12281,5,12,149,5745,-62,-97,35,0a:e1:ab:b3:c3:a6,263353337,468,399,263352869,263353337
12282,5,12,149,5745,-59,-97,38,3a:de:b0:2e:cd:45,263353841,468,36,263353373,263353841
12283,5,6,149,5745,-87,-97,10,54:e4:3a:ec:fb:65,263356709,360,2508,263356349,263356709
12284,5,12,149,5745,-68,-97,29,aa:b6:ae:27:64:4e,263359132,468,1955,263358664,263359132
12285,5,12,149,5745,-64,-97,33,76:d6:6a:bb:b3:f5,263360901,468,1301,263360433,263360901
12286,5,12,149,5745,-59,-97,38,5e:29:73:5b:30:00,263361430,540,-11,263360890,263361430
12287,5,12,149,5745,-73,-97,24,56:68:e2:c2:8d:d5,263362448,480,538,263361968,263362448
12288,5,12,149,5745,-72,-97,25,3e:ef:29:c7:4b:17,263362963,468,47,263362495,263362963
12289,5,12,149,5745,-73,-97,24,72:d1:72:1d:22:a1,263364314,452,899,263363862,263364314
12290,5,12,149,5745,-58,-97,39,9e:1f:b0:a7:b8:90,263366122,452,1356,263365670,263366122
12291,5,12,149,5745,-61,-97,36,0a:b9:b7:b1:4d:fa,263366608,468,18,263366140,263366608
12292,5,12,149,5745,-64,-97,33,f2:da:61:dd:98:c5,263367130,268,254,263366862,263367130
12293,5,12,149,5745,-59,-97,38,9e:1f:b0:a7:b8:90,263374867,256,7481,263374611,263374867
12294,5,12,149,5745,-59,-97,38,5e:29:73:5b:30:00,263376728,272,1589,263376456,263376728
12295,5,12,149,5745,-62,-97,35,4a:ea:3c:f4:ce:b2,263385396,272,8396,263385124,263385396
12296,5,12,149,5745,-68,-97,29,76:d6:6a:bb:b3:f5,263392361,272,6693,263392089,263392361
12297,5,12,149,5745,-70,-97,27,f6:0a:5c:59:72:df,263399984,284,7339,263399700,263399984
12298,5,12,149,5745,-61,-97,36,0a:e1:ab:b3:c3:a6,263409853,272,9597,263409581,263409853
12299,5,12,149,5745,-60,-97,37,3a:de:b0:2e:cd:45,263410215,272,90,263409943,263410215
12300,5,12,149,5745,-71,-97,26,f6:0a:5c:59:72:df,263411897,480,1202,263411417,263411897
12301,5,12,149,5745,-61,-97,36,0a:e1:ab:b3:c3:a6,263418297,468,5932,263417829,263418297
12302,5,12,149,5745,-61,-97,36,3a:de:b0:2e:cd:45,263418809,468,44,263418341,263418809
12303,5,12,149,5745,-73,-97,24,3e:ef:29:c7:4b:17,263428086,468,8809,263427618,263428086
12304,5,12,149,5745,-60,-97,37,9e:1f:b0:a7:b8:90,263431639,452,3101,263431187,263431639
12305,5,12,149,5745,-80,-97,17,9a:24:38:da:96:bb,263432563,272,652,263432291,263432563
12306,5,12,149,5745,-66,-97,31,f2:da:61:dd:98:c5,263436518,268,3687,263436250,263436518
12307,5,12,149,5745,-68,-97,29,22:ec:75:a8:8a:31,263440063,272,3273,263439791,263440063
12308,5,12,149,5745,-61,-97,36,b6:90:18:f6:b1:d4,263441155,244,848,263440911,263441155
12309,5,12,149,5745,-54,-97,43,3e:d1:9b:c7:a4:de,263452475,272,11048,263452203,263452475
12310,5,12,149,5745,-75,-97,22,72:d1:72:1d:22:a1,263457421,256,4690,263457165,263457421
12311,5,6,149,5745,-86,-97,11,54:e4:3a:ec:fb:65,263459110,360,1329,263458750,263459110
12312,5,12,149,5745,-73,-97,24,3e:ef:29:c7:4b:17,263473805,272,14423,263473533,263473805
12313,5,12,149,5745,-60,-97,37,5e:29:73:5b:30:00,263478485,272,4408,263478213,263478485
12314,5,12,149,5745,-72,-97,25,56:68:e2:c2:8d:d5,263485670,284,6901,263485386,263485670
12315,5,12,149,5745,-73,-97,24,3e:ef:29:c7:4b:17,263493612,468,7474,263493144,263493612
12316,5,12,149,5745,-59,-97,38,9e:1f:b0:a7:b8:90,263502057,256,8189,263501801,263502057
12317,5,12,149,5745,-63,-97,34,0a:e1:ab:b3:c3:a6,263523400,272,21071,263523128,263523400
12318,5,12,149,5745,-60,-97,37,3a:de:b0:2e:cd:45,263538314,272,14642,263538042,263538314
12319,5,12,149,5745,-80,-97,17,9a:24:38:da:96:bb,263541648,272,3062,263541376,263541648
12320,5,12,149,5745,-72,-97,25,22:ec:75:a8:8a:31,263557815,272,15895,263557543,263557815
12321,5,12,149,5745,-74,-97,23,3e:ef:29:c7:4b:17,263559194,468,911,263558726,263559194
12322,5,12,149,5745,-60,-97,37,0a:b9:b7:b1:4d:fa,263559741,468,79,263559273,263559741
12323,5,12,149,5745,-68,-97,29,76:d6:6a:bb:b3:f5,263561489,272,1476,263561217,263561489
12324,5,12,149,5745,-64,-97,33,f2:da:61:dd:98:c5,263562303,268,546,263562035,263562303
12325,5,6,149,5745,-73,-97,24,,263565220,52,2865,263565168,263565220
12326,5,6,149,5745,-89,-97,8,,263565288,44,24,263565244,263565288
12327,5,24,149,5745,-89,-97,8,,263565406,28,90,263565378,263565406
12328,5,12,149,5745,-56,-97,41,3e:d1:9b:c7:a4:de,263568848,272,3170,263568576,263568848
12329,5,24,149,5745,-88,-97,9,,263584540,32,15660,263584508,263584540
12330,5,24,149,5745,-88,-97,9,,263584870,32,298,263584838,263584870
12331,5,24,149,5745,-89,-97,8,,263585199,28,301,263585171,263585199
12332,5,12,149,5745,-62,-97,35,b6:90:18:f6:b1:d4,263586159,244,716,263585915,263586159
12333,5,12,149,5745,-74,-97,23,3e:ef:29:c7:4b:17,263588990,272,2559,263588718,263588990
12334,5,12,149,5745,-61,-97,36,5e:29:73:5b:30:00,263595446,272,6184,263595174,263595446
12335,5,6,149,5745,-72,-97,25,,263596784,52,1286,263596732,263596784
12336,5,6,149,5745,-88,-97,9,,263596853,44,25,263596809,263596853
12337,5,24,149,5745,-88,-97,9,,263596970,28,89,263596942,263596970
12338,5,12,149,5745,-70,-97,27,56:68:e2:c2:8d:d5,263597527,284,273,263597243,263597527
12339,5,24,149,5745,-88,-97,9,,263625801,32,28242,263625769,263625801
12340,5,24,149,5745,-87,-97,10,,263626238,32,405,263626206,263626238
12341,5,24,149,5745,-87,-97,10,,263626674,28,408,263626646,263626674
12342,5,12,149,5745,-62,-97,35,4a:ea:3c:f4:ce:b2,263630895,272,3949,263630623,263630895
12343,5,12,149,5745,-68,-97,29,0a:e1:ab:b3:c3:a6,263657888,272,26721,263657616,263657888
12344,5,12,149,5745,-67,-97,30,76:d6:6a:bb:b3:f5,263664117,272,5957,263663845,263664117
12345,5,12,149,5745,-65,-97,32,f2:da:61:dd:98:c5,263664589,268,204,263664321,263664589
12346,5,12,149,5745,-62,-97,35,3a:de:b0:2e:cd:45,263665062,272,201,263664790,263665062
12347,5,12,149,5745,-58,-97,39,9e:1f:b0:a7:b8:90,263665505,256,187,263665249,263665505
12348,5,6,149,5745,-71,-97,26,,263673048,52,7491,263672996,263673048
12349,5,6,149,5745,-88,-97,9,,263673116,44,24,263673072,263673116
12350,5,24,149,5745,-88,-97,9,,263673234,28,90,263673206,263673234
12351,5,12,149,5745,-71,-97,26,22:ec:75:a8:8a:31,263674877,272,1371,263674605,263674877
12352,5,12,149,5745,-58,-97,39,3e:d1:9b:c7:a4:de,263686519,272,11370,263686247,263686519
12353,5,12,149,5745,-61,-97,36,b6:90:18:f6:b1:d4,263688303,244,1540,263688059,263688303
12354,5,12,149,5745,-73,-97,24,72:d1:72:1d:22:a1,263688655,256,96,263688399,263688655
12355,5,12,149,5745,-73,-97,24,d2:00:04:7e:2c:ab,263690072,272,1145,263689800,263690072
12356,5,12,149,5745,-73,-97,24,3e:ef:29:c7:4b:17,263705163,272,14819,263704891,263705163
12357,5,24,149,5745,-90,-97,7,,263705620,32,425,263705588,263705620
12358,5,24,149,5745,-89,-97,8,,263706182,32,530,263706150,263706182
12359,5,12,149,5745,-69,-97,28,56:68:e2:c2:8d:d5,263706689,284,223,263706405,263706689
12360,5,6,149,5745,-72,-97,25,,263708817,52,2076,263708765,263708817
12361,5,6,149,5745,-89,-97,8,,263708885,44,24,263708841,263708885
12362,5,24,149,5745,-90,-97,7,,263709003,28,90,263708975,263709003
12363,5,12,149,5745,-60,-97,37,5e:29:73:5b:30:00,263709355,272,80,263709083,263709355
12364,5,12,149,5745,-58,-97,39,9e:1f:b0:a7:b8:90,263721762,256,12151,263721506,263721762
12365,5,12,149,5745,-64,-97,33,4a:ea:3c:f4:ce:b2,263722984,272,950,263722712,263722984
12366,5,24,149,5745,-89,-97,8,,263723317,28,305,263723289,263723317
12367,5,12,149,5745,-67,-97,30,76:d6:6a:bb:b3:f5,263735977,272,12388,263735705,263735977
12368,5,12,149,5745,-65,-97,32,0a:e1:ab:b3:c3:a6,263737455,272,1206,263737183,263737455
12369,5,12,149,5745,-71,-97,26,22:ec:75:a8:8a:31,263742019,544,4020,263741475,263742019
12370,5,12,149,5745,-67,-97,30,f6:0a:5c:59:72:df,263742615,480,116,263742135,263742615
12371,5,12,149,5745,-67,-97,30,f6:0a:5c:59:72:df,263743112,284,213,263742828,263743112
12372,5,12,149,5745,-62,-97,35,3a:de:b0:2e:cd:45,263744160,468,580,263743692,263744160
12373,5,12,149,5745,-59,-97,38,9e:1f:b0:a7:b8:90,263744781,156,465,263744625,263744781
12374,5,12,149,5745,-59,-97,38,9e:1f:b0:a7:b8:90,263745061,356,-76,263744705,263745061
12375,5,12,149,5745,-59,-97,38,3e:d1:9b:c7:a4:de,263745497,544,-108,263744953,263745497
12376,5,12,149,5745,-61,-97,36,b6:90:18:f6:b1:d4,263746076,440,139,263745636,263746076
12377,5,12,149,5745,-65,-97,32,0a:e1:ab:b3:c3:a6,263747088,468,544,263746620,263747088
12378,5,12,149,5745,-72,-97,25,d2:00:04:7e:2c:ab,263750074,152,2834,263749922,263750074
12379,5,12,149,5745,-72,-97,25,d2:00:04:7e:2c:ab,263753286,436,2776,263752850,263753286
12380,5,12,149,5745,-62,-97,35,3a:de:b0:2e:cd:45,263754811,272,1253,263754539,263754811
12381,5,12,149,5745,-73,-97,24,3e:ef:29:c7:4b:17,263755486,468,207,263755018,263755486
12382,5,12,149,5745,-60,-97,37,5e:29:73:5b:30:00,263756006,540,-20,263755466,263756006
12383,5,12,149,5745,-70,-97,27,56:68:e2:c2:8d:d5,263756600,480,114,263756120,263756600
12384,5,12,149,5745,-67,-97,30,76:d6:6a:bb:b3:f5,263757161,380,181,263756781,263757161
12385,5,12,149,5745,-67,-97,30,76:d6:6a:bb:b3:f5,263758592,468,963,263758124,263758592
12386,5,12,149,5745,-73,-97,24,72:d1:72:1d:22:a1,263759555,452,511,263759103,263759555
12387,5,12,149,5745,-59,-97,38,9e:1f:b0:a7:b8:90,263760581,452,574,263760129,263760581
12388,5,12,149,5745,-65,-97,32,f2:da:61:dd:98:c5,263761086,268,237,263760818,263761086
12389,5,12,149,5745,-83,-97,14,9a:24:38:da:96:bb,263765132,272,3774,263764860,263765132
12390,5,6,149,5745,-86,-97,11,54:e4:3a:ec:fb:65,263766311,360,819,263765951,263766311
12391,5,12,149,5745,-61,-97,36,b6:90:18:f6:b1:d4,263767759,244,1204,263767515,263767759
12392,5,12,149,5745,-65,-97,32,f2:da:61:dd:98:c5,263769099,268,1072,263768831,263769099
12393,5,12,149,5745,-73,-97,24,72:d1:72:1d:22:a1,263785331,256,15976,263785075,263785331
12394,5,12,149,5745,-71,-97,26,d2:00:04:7e:2c:ab,263785622,272,19,263785350,263785622
12395,5,12,149,5745,-70,-97,27,22:ec:75:a8:8a:31,263790779,272,4885,263790507,263790779
12396,5,12,149,5745,-74,-97,23,3e:ef:29:c7:4b:17,263801437,272,10386,263801165,263801437
12397,5,12,149,5745,-60,-97,37,3e:d1:9b:c7:a4:de,263801854,244,173,263801610,263801854
12398,5,12,149,5745,-69,-97,28,f6:0a:5c:59:72:df,263805066,480,2732,263804586,263805066
12399,5,12,149,5745,-63,-97,34,3a:de:b0:2e:cd:45,263806607,468,1073,263806139,263806607
12400,5,12,149,5745,-61,-97,36,b6:90:18:f6:b1:d4,263810007,440,2960,263809567,263810007
12401,5,12,149,5745,-65,-97,32,0a:e1:ab:b3:c3:a6,263811878,468,1403,263811410,263811878
12402,5,12,149,5745,-70,-97,27,56:68:e2:c2:8d:d5,263820392,284,8230,263820108,263820392
12403,5,12,149,5745,-67,-97,30,76:d6:6a:bb:b3:f5,263820712,468,-148,263820244,263820712
12404,5,12,149,5745,-74,-97,23,3e:ef:29:c7:4b:17,263821313,468,133,263820845,263821313
12405,5,12,149,5745,-59,-97,38,9e:1f:b0:a7:b8:90,263824839,452,3074,263824387,263824839
12406,5,12,149,5745,-60,-97,37,5e:29:73:5b:30:00,263826603,272,1492,263826331,263826603
12407,5,12,149,5745,-59,-97,38,9e:1f:b0:a7:b8:90,263833561,256,6702,263833305,263833561
12408,5,12,149,5745,-67,-97,30,76:d6:6a:bb:b3:f5,263834491,272,658,263834219,263834491
12409,5,12,149,5745,-69,-97,28,f6:0a:5c:59:72:df,263851723,284,16948,263851439,263851723
12410,5,12,149,5745,-63,-97,34,0a:e1:ab:b3:c3:a6,263852806,272,811,263852534,263852806
12411,5,12,149,5745,-60,-97,37,b6:90:18:f6:b1:d4,263865595,440,12349,263865155,263865595
12412,5,12,149,5745,-61,-97,36,4a:ea:3c:f4:ce:b2,263866196,468,133,263865728,263866196
12413,5,6,149,5745,-86,-97,11,54:e4:3a:ec:fb:65,263868712,360,2156,263868352,263868712
12414,5,12,149,5745,-69,-97,28,f6:0a:5c:59:72:df,263869497,480,305,263869017,263869497
12415,5,12,149,5745,-62,-97,35,3a:de:b0:2e:cd:45,263870031,272,262,263869759,263870031
12416,5,12,149,5745,-62,-97,35,0a:e1:ab:b3:c3:a6,263876963,468,6464,263876495,263876963
12417,5,12,149,5745,-60,-97,37,b6:90:18:f6:b1:d4,263882391,244,5184,263882147,263882391
12418,5,12,149,5745,-68,-97,29,f2:da:61:dd:98:c5,263883740,268,1081,263883472,263883740
12419,5,12,149,5745,-68,-97,29,aa:b6:ae:27:64:4e,263884474,468,266,263884006,263884474
12420,5,12,149,5745,-69,-97,28,22:ec:75:a8:8a:31,263885021,516,31,263884505,263885021
12421,5,12,149,5745,-69,-97,28,76:d6:6a:bb:b3:f5,263886311,468,822,263885843,263886311
12422,5,12,149,5745,-69,-97,28,a6:92:ad:b7:76:65,263886849,456,82,263886393,263886849
12423,5,12,149,5745,-74,-97,23,3e:ef:29:c7:4b:17,263887349,468,32,263886881,263887349
12424,5,12,149,5745,-62,-97,35,0a:b9:b7:b1:4d:fa,263887897,468,80,263887429,263887897
12425,5,12,149,5745,-58,-97,39,5e:29:73:5b:30:00,263888399,540,-38,263887859,263888399
12426,5,12,149,5745,-61,-97,36,3e:d1:9b:c7:a4:de,263889828,516,913,263889312,263889828
12427,5,12,149,5745,-58,-97,39,9e:1f:b0:a7:b8:90,263890389,452,109,263889937,263890389
12428,5,12,149,5745,-61,-97,36,3a:de:b0:2e:cd:45,263890912,468,55,263890444,263890912
12429,5,12,149,5745,-68,-97,29,f2:da:61:dd:98:c5,263893223,268,2043,263892955,263893223
12430,5,12,149,5745,-84,-97,13,9a:24:38:da:96:bb,263893646,824,-401,263892822,263893646
12431,5,12,149,5745,-85,-97,12,9a:24:38:da:96:bb,263906698,272,12780,263906426,263906698
12432,5,12,149,5745,-75,-97,22,72:d1:72:1d:22:a1,263908485,256,1531,263908229,263908485
12433,5,12,149,5745,-69,-97,28,22:ec:75:a8:8a:31,263916209,244,7480,263915965,263916209
12434,5,12,149,5745,-61,-97,36,3e:d1:9b:c7:a4:de,263916777,244,324,263916533,263916777
12435,5,12,149,5745,-61,-97,36,0a:e1:ab:b3:c3:a6,263934583,468,17338,263934115,263934583
12436,5,12,149,5745,-58,-97,39,5e:29:73:5b:30:00,263939557,272,4702,263939285,263939557
12437,5,12,149,5745,-59,-97,38,9e:1f:b0:a7:b8:90,263948280,256,8467,263948024,263948280
12438,5,12,149,5745,-73,-97,24,3e:ef:29:c7:4b:17,263952421,440,3701,263951981,263952421
12439,5,12,149,5745,-59,-97,38,9e:1f:b0:a7:b8:90,263955947,452,3074,263955495,263955947
12440,5,12,149,5745,-68,-97,29,76:d6:6a:bb:b3:f5,263958840,272,2621,263958568,263958840
12441,5,12,149,5745,-61,-97,36,0a:e1:ab:b3:c3:a6,263966808,272,7696,263966536,263966808
12442,5,6,149,5745,-85,-97,12,54:e4:3a:ec:fb:65,263971112,360,3944,263970752,263971112
12443,5,12,149,5745,-59,-97,38,3a:de:b0:2e:cd:45,263993411,244,22055,263993167,263993411
12444,5,12,149,5745,-70,-97,27,56:68:e2:c2:8d:d5,263998394,284,4699,263998110,263998394
12445,5,12,149,5745,-72,-97,25,3e:ef:29:c7:4b:17,264008074,440,9240,264007634,264008074
12446,5,12,149,5745,-61,-97,36,b6:90:18:f6:b1:d4,264011519,272,3173,264011247,264011519
12447,5,12,149,5745,-69,-97,28,22:ec:75:a8:8a:31,264017719,244,5956,264017475,264017719
12448,5,12,149,5745,-82,-97,15,9a:24:38:da:96:bb,264019566,272,1575,264019294,264019566
12449,5,12,149,5745,-61,-97,36,3e:d1:9b:c7:a4:de,264027779,272,7941,264027507,264027779
12450,5,6,149,5745,-71,-97,26,,264029821,52,1990,264029769,264029821
12451,5,6,149,5745,-89,-97,8,,264029889,44,24,264029845,264029889
12452,5,12,149,5745,-73,-97,24,3e:ef:29:c7:4b:17,264030851,244,718,264030607,264030851
12453,5,12,149,5745,-60,-97,37,5e:29:73:5b:30:00,264055533,272,24410,264055261,264055533
12454,5,12,149,5745,-59,-97,38,9e:1f:b0:a7:b8:90,264068768,256,12979,264068512,264068768
12455,5,12,149,5745,-73,-97,24,3e:ef:29:c7:4b:17,264073036,440,3828,264072596,264073036
12456,5,6,149,5745,-86,-97,11,54:e4:3a:ec:fb:65,264073513,360,117,264073153,264073513
12457,5,12,149,5745,-66,-97,31,76:d6:6a:bb:b3:f5,264074991,272,1206,264074719,264074991
12458,5,12,149,5745,-64,-97,33,f2:da:61:dd:98:c5,264076283,268,1024,264076015,264076283
12459,5,12,149,5745,-62,-97,35,0a:e1:ab:b3:c3:a6,264078956,272,2401,264078684,264078956
12460,5,12,149,5745,-63,-97,34,4a:ea:3c:f4:ce:b2,264079379,468,-45,264078911,264079379
12461,5,12,149,5745,-60,-97,37,0a:b9:b7:b1:4d:fa,264081844,468,1997,264081376,264081844
12462,5,12,149,5745,-76,-97,21,72:d1:72:1d:22:a1,264098399,256,16299,264098143,264098399
12463,5,12,149,5745,-69,-97,28,56:68:e2:c2:8d:d5,264098786,284,103,264098502,264098786
12464,5,12,149,5745,-61,-97,36,b6:90:18:f6:b1:d4,264113878,272,14820,264113606,264113878
12465,5,12,149,5745,-71,-97,26,22:ec:75:a8:8a:31,264133393,244,19271,264133149,264133393
12466,5,12,149,5745,-80,-97,17,9a:24:38:da:96:bb,264134851,272,1186,264134579,264134851
12467,5,12,149,5745,-58,-97,39,3e:d1:9b:c7:a4:de,264143722,272,8599,264143450,264143722
12468,5,24,149,5745,-89,-97,8,,264152326,28,8576,264152298,264152326
12469,5,12,149,5745,-72,-97,25,3e:ef:29:c7:4b:17,264159370,244,6800,264159126,264159370
12470,5,12,149,5745,-62,-97,35,5e:29:73:5b:30:00,264168071,272,8429,264167799,264168071
12471,5,6,149,5745,-88,-97,9,54:e4:3a:ec:fb:65,264175913,360,7482,264175553,264175913
12472,5,12,149,5745,-61,-97,36,3a:de:b0:2e:cd:45,264176445,244,288,264176201,264176445
12473,5,12,149,5745,-63,-97,34,f2:da:61:dd:98:c5,264178665,268,1952,264178397,264178665
12474,5,12,149,5745,-59,-97,38,9e:1f:b0:a7:b8:90,264181677,256,2756,264181421,264181677
12475,5,12,149,5745,-66,-97,31,76:d6:6a:bb:b3:f5,264187772,272,5823,264187500,264187772
12476,5,12,149,5745,-74,-97,23,72:d1:72:1d:22:a1,264200929,256,12901,264200673,264200929
12477,5,12,149,5745,-70,-97,27,56:68:e2:c2:8d:d5,264201733,284,520,264201449,264201733
12478,5,12,149,5745,-70,-97,27,f6:0a:5c:59:72:df,264209136,280,7123,264208856,264209136
12479,5,12,149,5745,-69,-97,28,22:ec:75:a8:8a:31,264246209,244,36829,264245965,264246209
12480,5,12,149,5745,-56,-97,41,3e:d1:9b:c7:a4:de,264255621,272,9140,264255349,264255621
12481,5,12,149,5745,-76,-97,21,3e:ef:29:c7:4b:17,264267977,244,12112,264267733,264267977
12482,5,12,149,5745,-66,-97,31,0a:e1:ab:b3:c3:a6,264273198,272,4949,264272926,264273198
12483,5,12,149,5745,-65,-97,32,3a:de:b0:2e:cd:45,264278529,244,5087,264278285,264278529
12484,5,12,149,5745,-62,-97,35,f2:da:61:dd:98:c5,264279254,268,457,264278986,264279254
12485,5,12,149,5745,-63,-97,34,5e:29:73:5b:30:00,264280097,272,571,264279825,264280097
12486,5,12,149,5745,-60,-97,37,9e:1f:b0:a7:b8:90,264291356,256,11003,264291100,264291356
12487,5,12,149,5745,-66,-97,31,76:d6:6a:bb:b3:f5,264294253,272,2625,264293981,264294253
12488,5,12,149,5745,-73,-97,24,72:d1:72:1d:22:a1,264303384,256,8875,264303128,264303384
12489,5,12,149,5745,-62,-97,35,b6:90:18:f6:b1:d4,264303865,272,209,264303593,264303865
12490,5,12,149,5745,-72,-97,25,56:68:e2:c2:8d:d5,264304405,284,256,264304121,264304405
12491,5,12,149,5745,-72,-97,25,f6:0a:5c:59:72:df,264311814,280,7129,264311534,264311814
12492,5,12,149,5745,-65,-97,32,0a:e1:ab:b3:c3:a6,264313062,272,976,264312790,264313062
12493,5,12,149,5745,-63,-97,34,3a:de:b0:2e:cd:45,264325394,244,12088,264325150,264325394
12494,5,12,149,5745,-71,-97,26,f6:0a:5c:59:72:df,264326576,476,706,264326100,264326576
12495,5,12,149,5745,-64,-97,33,f2:da:61:dd:98:c5,264327275,268,431,264327007,264327275
12496,5,12,149,5745,-58,-97,39,9e:1f:b0:a7:b8:90,264330278,452,2551,264329826,264330278
12497,5,12,149,5745,-65,-97,32,0a:e1:ab:b3:c3:a6,264331612,468,866,264331144,264331612
12498,5,12,149,5745,-55,-97,42,3e:d1:9b:c7:a4:de,264332159,544,3,264331615,264332159
12499,5,12,149,5745,-64,-97,33,76:d6:6a:bb:b3:f5,264332784,468,157,264332316,264332784
12500,5,12,149,5745,-62,-97,35,5e:29:73:5b:30:00,264336193,540,2869,264335653,264336193
12501,5,12,149,5745,-67,-97,30,f2:da:61:dd:98:c5,264337876,268,1415,264337608,264337876
12502,5,12,149,5745,-64,-97,33,3a:de:b0:2e:cd:45,264338820,440,504,264338380,264338820
12503,5,12,149,5745,-63,-97,34,b6:90:18:f6:b1:d4,264341149,272,2057,264340877,264341149
12504,5,12,149,5745,-70,-97,27,22:ec:75:a8:8a:31,264342350,516,685,264341834,264342350
12505,5,12,149,5745,-73,-97,24,56:68:e2:c2:8d:d5,264345573,476,2747,264345097,264345573
12506,5,12,149,5745,-75,-97,22,72:d1:72:1d:22:a1,264347210,480,1157,264346730,264347210
12507,5,12,149,5745,-74,-97,23,3e:ef:29:c7:4b:17,264347724,440,74,264347284,264347724
12508,5,12,149,5745,-83,-97,14,9a:24:38:da:96:bb,264354842,272,6846,264354570,264354842
12509,5,12,149,5745,-73,-97,24,72:d1:72:1d:22:a1,264357927,284,2801,264357643,264357927
12510,5,24,149,5745,-88,-97,9,,264360794,32,2835,264360762,264360794
12511,5,12,149,5745,-64,-97,33,b6:90:18:f6:b1:d4,264362615,468,1353,264362147,264362615
12512,5,12,149,5745,-71,-97,26,22:ec:75:a8:8a:31,264374413,244,11554,264374169,264374413
12513,5,12,149,5745,-56,-97,41,3e:d1:9b:c7:a4:de,264374996,272,311,264374724,264374996
12514,5,12,149,5745,-72,-97,25,3e:ef:29:c7:4b:17,264375331,244,91,264375087,264375331
12515,5,12,149,5745,-75,-97,22,56:68:e2:c2:8d:d5,264376032,280,421,264375752,264376032
12516,5,24,149,5745,-87,-97,10,,264379088,28,3028,264379060,264379088
12517,5,24,149,5745,-89,-97,8,,264379133,28,17,264379105,264379133
12518,5,6,149,5745,-84,-97,13,54:e4:3a:ec:fb:65,264380714,360,1221,264380354,264380714
12519,5,12,149,5745,-71,-97,26,f6:0a:5c:59:72:df,264390647,476,9457,264390171,264390647
12520,5,12,149,5745,-76,-97,21,56:68:e2:c2:8d:d5,264394090,476,2967,264393614,264394090
12521,5,12,149,5745,-57,-97,40,9e:1f:b0:a7:b8:90,264395636,452,1094,264395184,264395636
12522,5,12,149,5745,-63,-97,34,0a:e1:ab:b3:c3:a6,264396123,468,19,264395655,264396123
12523,5,12,149,5745,-65,-97,32,3a:de:b0:2e:cd:45,264396663,380,160,264396283,264396663
12524,5,12,149,5745,-57,-97,40,3e:d1:9b:c7:a4:de,264397215,544,8,264396671,264397215
12525,5,12,149,5745,-65,-97,32,76:d6:6a:bb:b3:f5,264397822,468,139,264397354,264397822
12526,5,12,149,5745,-72,-97,25,72:d1:72:1d:22:a1,264398370,480,68,264397890,264398370
12527,5,12,149,5745,-57,-97,40,9e:1f:b0:a7:b8:90,264398965,356,239,264398609,264398965
12528,5,12,149,5745,-57,-97,40,9e:1f:b0:a7:b8:90,264399410,156,289,264399254,264399410
12529,5,12,149,5745,-58,-97,39,4a:ea:3c:f4:ce:b2,264400968,468,1090,264400500,264400968
12530,5,12,149,5745,-65,-97,32,3a:de:b0:2e:cd:45,264401481,468,45,264401013,264401481
12531,5,12,149,5745,-58,-97,39,9e:1f:b0:a7:b8:90,264407007,256,5270,264406751,264407007
12532,5,12,149,5745,-67,-97,30,aa:b6:ae:27:64:4e,264407390,468,-85,264406922,264407390
12533,5,12,149,5745,-72,-97,25,22:ec:75:a8:8a:31,264407919,516,13,264407403,264407919
12534,5,12,149,5745,-64,-97,33,76:d6:6a:bb:b3:f5,264408480,272,289,264408208,264408480
12535,5,12,149,5745,-68,-97,29,a6:92:ad:b7:76:65,264408804,484,-160,264408320,264408804
12536,5,12,149,5745,-58,-97,39,5e:29:73:5b:30:00,264409340,272,264,264409068,264409340
12537,5,12,149,5745,-62,-97,35,0a:e1:ab:b3:c3:a6,264409872,272,260,264409600,264409872
12538,5,12,149,5745,-72,-97,25,3e:ef:29:c7:4b:17,264410781,440,469,264410341,264410781
12539,5,12,149,5745,-57,-97,40,5e:29:73:5b:30:00,264411274,540,-47,264410734,264411274
12540,5,12,149,5745,-65,-97,32,b6:90:18:f6:b1:d4,264411849,468,107,264411381,264411849
12541,5,12,149,5745,-62,-97,35,0a:e1:ab:b3:c3:a6,264412369,360,160,264412009,264412369
12542,5,12,149,5745,-62,-97,35,f2:da:61:dd:98:c5,264412810,268,173,264412542,264412810
12543,5,12,149,5745,-85,-97,12,9a:24:38:da:96:bb,264415579,824,1945,264414755,264415579
12544,5,12,149,5745,-60,-97,37,0a:b9:b7:b1:4d:fa,264418408,468,2361,264417940,264418408
12545,5,12,149,5745,-70,-97,27,f6:0a:5c:59:72:df,264423455,280,4767,264423175,264423455
12546,5,12,149,5745,-66,-97,31,3a:de:b0:2e:cd:45,264440641,272,16914,264440369,264440641
12547,5,12,149,5745,-64,-97,33,f2:da:61:dd:98:c5,264441137,268,228,264440869,264441137
12548,5,12,149,5745,-64,-97,33,0a:e1:ab:b3:c3:a6,264461892,468,20287,264461424,264461892
12549,5,12,149,5745,-86,-97,11,9a:24:38:da:96:bb,264467534,272,5370,264467262,264467534
12550,5,12,149,5745,-65,-97,32,b6:90:18:f6:b1:d4,264468018,272,212,264467746,264468018
12551,5,12,149,5745,-73,-97,24,72:d1:72:1d:22:a1,264472711,284,4409,264472427,264472711
12552,5,12,149,5745,-73,-97,24,22:ec:75:a8:8a:31,264476069,244,3114,264475825,264476069
12553,5,6,149,5745,-85,-97,12,54:e4:3a:ec:fb:65,264483115,360,6686,264482755,264483115
12554,5,12,149,5745,-59,-97,38,3e:d1:9b:c7:a4:de,264485438,272,2051,264485166,264485438
12555,5,12,149,5745,-73,-97,24,56:68:e2:c2:8d:d5,264496315,280,10597,264496035,264496315
12556,5,12,149,5745,-71,-97,26,3e:ef:29:c7:4b:17,264498809,244,2250,264498565,264498809
12557,5,12,149,5745,-63,-97,34,5e:29:73:5b:30:00,264509658,272,10577,264509386,264509658
12558,5,12,149,5745,-62,-97,35,0a:e1:ab:b3:c3:a6,264538496,272,28566,264538224,264538496
12559,5,6,149,5745,-72,-97,25,,264563511,52,24963,264563459,264563511
12560,5,6,149,5745,-88,-97,9,,264563579,44,24,264563535,264563579
12561,5,24,149,5745,-87,-97,10,,264563696,28,89,264563668,264563696
12562,5,12,149,5745,-81,-97,16,9a:24:38:da:96:bb,264583465,272,19497,264583193,264583465
12563,5,6,149,5745,-86,-97,11,54:e4:3a:ec:fb:65,264585516,360,1691,264585156,264585516
12564,5,12,149,5745,-60,-97,37,f2:da:61:dd:98:c5,264586582,268,798,264586314,264586582
12565,5,12,149,5745,-59,-97,38,9e:1f:b0:a7:b8:90,264587051,256,213,264586795,264587051
12566,5,12,149,5745,-68,-97,29,76:d6:6a:bb:b3:f5,264587416,272,93,264587144,264587416
12567,5,24,149,5745,-86,-97,11,,264588324,28,880,264588296,264588324
12568,5,24,149,5745,-86,-97,11,,264588433,32,77,264588401,264588433
12569,5,12,149,5745,-71,-97,26,22:ec:75:a8:8a:31,264593098,244,4421,264592854,264593098
12570,5,12,149,5745,-62,-97,35,4a:ea:3c:f4:ce:b2,264593682,468,116,264593214,264593682
12571,5,12,149,5745,-59,-97,38,3e:d1:9b:c7:a4:de,264600454,272,6500,264600182,264600454
12572,5,12,149,5745,-71,-97,26,56:68:e2:c2:8d:d5,264606058,280,5324,264605778,264606058
12573,5,24,149,5745,-85,-97,12,,264606408,28,322,264606380,264606408
12574,5,12,149,5745,-66,-97,31,b6:90:18:f6:b1:d4,264610047,272,3367,264609775,264610047
12575,5,12,149,5745,-72,-97,25,72:d1:72:1d:22:a1,264610433,284,102,264610149,264610433
12576,5,12,149,5745,-58,-97,39,0a:b9:b7:b1:4d:fa,264616842,468,5941,264616374,264616842
12577,5,12,149,5745,-59,-97,38,5e:29:73:5b:30:00,264625638,272,8524,264625366,264625638
12578,5,12,149,5745,-74,-97,23,3e:ef:29:c7:4b:17,264663664,244,37782,264663420,264663664
12579,5,12,149,5745,-67,-97,30,f6:0a:5c:59:72:df,264663945,280,1,264663665,264663945
12580,5,12,149,5745,-64,-97,33,0a:e1:ab:b3:c3:a6,264682356,272,18139,264682084,264682356
12581,5,6,149,5745,-84,-97,13,54:e4:3a:ec:fb:65,264687916,360,5200,264687556,264687916
12582,5,12,149,5745,-64,-97,33,f2:da:61:dd:98:c5,264688738,268,554,264688470,264688738
12583,5,12,149,5745,-65,-97,32,76:d6:6a:bb:b3:f5,264689077,272,67,264688805,264689077
12584,5,12,149,5745,-58,-97,39,9e:1f:b0:a7:b8:90,264689403,256,70,264689147,264689403
12585,5,12,149,5745,-55,-97,42,3a:de:b0:2e:cd:45,264689749,272,74,264689477,264689749
12586,5,12,149,5745,-80,-97,17,9a:24:38:da:96:bb,264692203,272,2182,264691931,264692203
12587,5,12,149,5745,-70,-97,27,22:ec:75:a8:8a:31,264708881,244,16434,264708637,264708881
12588,5,12,149,5745,-78,-97,19,72:d1:72:1d:22:a1,264712979,284,3814,264712695,264712979
12589,5,12,149,5745,-69,-97,28,b6:90:18:f6:b1:d4,264713404,272,153,264713132,264713404
12590,5,12,149,5745,-57,-97,40,3e:d1:9b:c7:a4:de,264717455,272,3779,264717183,264717455
12591,5,12,149,5745,-69,-97,28,56:68:e2:c2:8d:d5,264719344,280,1609,264719064,264719344
12592,5,12,149,5745,-61,-97,36,5e:29:73:5b:30:00,264742521,272,22905,264742249,264742521
12593,5,12,149,5745,-58,-97,39,9e:1f:b0:a7:b8:90,264748020,256,5243,264747764,264748020
12594,5,12,149,5745,-71,-97,26,76:d6:6a:bb:b3:f5,264761813,272,13521,264761541,264761813
12595,5,12,149,5745,-66,-97,31,0a:e1:ab:b3:c3:a6,264766118,272,4033,264765846,264766118
12596,5,12,149,5745,-71,-97,26,3e:ef:29:c7:4b:17,264768022,244,1660,264767778,264768022
12597,5,12,149,5745,-70,-97,27,b6:90:18:f6:b1:d4,264783712,272,15418,264783440,264783712
12598,5,12,149,5745,-59,-97,38,3a:de:b0:2e:cd:45,264784136,272,152,264783864,264784136
12599,5,12,149,5745,-66,-97,31,f6:0a:5c:59:72:df,264784442,476,-170,264783966,264784442
12600,5,12,149,5745,-62,-97,35,f2:da:61:dd:98:c5,264785208,268,498,264784940,264785208
12601,5,12,149,5745,-58,-97,39,9e:1f:b0:a7:b8:90,264788461,452,2801,264788009,264788461
12602,5,12,149,5745,-65,-97,32,0a:e1:ab:b3:c3:a6,264788958,468,29,264788490,264788958
12603,5,12,149,5745,-58,-97,39,9e:1f:b0:a7:b8:90,264789498,156,384,264789342,264789498
12604,5,6,149,5745,-83,-97,14,54:e4:3a:ec:fb:65,264790316,360,458,264789956,264790316
12605,5,12,149,5745,-70,-97,27,76:d6:6a:bb:b3:f5,264790722,468,-62,264790254,264790722
12606,5,12,149,5745,-70,-97,27,56:68:e2:c2:8d:d5,264791269,476,71,264790793,264791269
12607,5,12,149,5745,-55,-97,42,3e:d1:9b:c7:a4:de,264791815,544,2,264791271,264791815
12608,5,12,149,5745,-78,-97,19,72:d1:72:1d:22:a1,264792404,480,109,264791924,264792404
12609,5,12,149,5745,-78,-97,19,72:d1:72:1d:22:a1,264800208,284,7520,264799924,264800208
12610,5,12,149,5745,-59,-97,38,3a:de:b0:2e:cd:45,264801041,468,365,264800573,264801041
12611,5,12,149,5745,-70,-97,27,3e:ef:29:c7:4b:17,264804681,440,3200,264804241,264804681
12612,5,12,149,5745,-62,-97,35,f2:da:61:dd:98:c5,264805788,268,839,264805520,264805788
12613,5,12,149,5745,-61,-97,36,5e:29:73:5b:30:00,264806972,540,644,264806432,264806972
12614,5,12,149,5745,-70,-97,27,b6:90:18:f6:b1:d4,264807593,468,153,264807125,264807593
12615,5,12,149,5745,-80,-97,17,9a:24:38:da:96:bb,264808972,824,555,264808148,264808972
12616,5,24,149,5745,-88,-97,9,,264811240,28,2240,264811212,264811240
12617,5,24,149,5745,-89,-97,8,,264811284,28,16,264811256,264811284
12618,5,24,149,5745,-89,-97,8,,264811393,32,77,264811361,264811393
12619,5,12,149,5745,-70,-97,27,56:68:e2:c2:8d:d5,264817723,280,6050,264817443,264817723
12620,5,24,149,5745,-89,-97,8,,264829044,28,11293,264829016,264829044
12621,5,24,149,5745,-87,-97,10,,264829089,28,17,264829061,264829089
12622,5,24,149,5745,-86,-97,11,,264829197,32,76,264829165,264829197
12623,5,12,149,5745,-69,-97,28,22:ec:75:a8:8a:31,264833700,244,4259,264833456,264833700
12624,5,12,149,5745,-69,-97,28,3e:ef:29:c7:4b:17,264834135,244,191,264833891,264834135
12625,5,12,149,5745,-55,-97,42,3e:d1:9b:c7:a4:de,264834440,272,33,264834168,264834440
12626,5,12,149,5745,-72,-97,25,d2:00:04:7e:2c:ab,264836380,272,1668,264836108,264836380
12627,5,12,149,5745,-59,-97,38,9e:1f:b0:a7:b8:90,264849359,256,12723,264849103,264849359
12628,5,12,149,5745,-66,-97,31,f6:0a:5c:59:72:df,264850210,476,375,264849734,264850210
12629,5,12,149,5745,-66,-97,31,0a:e1:ab:b3:c3:a6,264851701,468,1023,264851233,264851701
12630,5,12,149,5745,-59,-97,38,9e:1f:b0:a7:b8:90,264854382,452,2229,264853930,264854382
12631,5,12,149,5745,-68,-97,29,76:d6:6a:bb:b3:f5,264855950,468,1100,264855482,264855950
12632,5,12,149,5745,-61,-97,36,4a:ea:3c:f4:ce:b2,264856570,468,152,264856102,264856570
12633,5,12,149,5745,-62,-97,35,5e:29:73:5b:30:00,264859543,272,2701,264859271,264859543
12634,5,12,149,5745,-59,-97,38,3a:de:b0:2e:cd:45,264864072,468,4061,264863604,264864072
12635,5,12,149,5745,-68,-97,29,76:d6:6a:bb:b3:f5,264866349,272,2005,264866077,264866349
12636,5,12,149,5745,-72,-97,25,d2:00:04:7e:2c:ab,264870915,440,4126,264870475,264870915
12637,5,12,149,5745,-68,-97,29,f6:0a:5c:59:72:df,264875317,280,4122,264875037,264875317
12638,5,12,149,5745,-60,-97,37,4a:ea:3c:f4:ce:b2,264885082,272,9493,264884810,264885082
12639,5,6,149,5745,-82,-97,15,54:e4:3a:ec:fb:65,264892717,360,7275,264892357,264892717
12640,5,12,149,5745,-59,-97,38,3a:de:b0:2e:cd:45,264899089,272,6100,264898817,264899089
12641,5,12,149,5745,-70,-97,27,b6:90:18:f6:b1:d4,264900018,272,657,264899746,264900018
12642,5,12,149,5745,-62,-97,35,f2:da:61:dd:98:c5,264901967,268,1681,264901699,264901967
12643,5,12,149,5745,-70,-97,27,f6:0a:5c:59:72:df,264915952,476,13509,264915476,264915952
12644,5,12,149,5745,-63,-97,34,0a:e1:ab:b3:c3:a6,264917020,468,600,264916552,264917020
12645,5,12,149,5745,-60,-97,37,9e:1f:b0:a7:b8:90,264918981,452,1509,264918529,264918981
12646,5,12,149,5745,-65,-97,32,76:d6:6a:bb:b3:f5,264921062,468,1613,264920594,264921062
12647,5,12,149,5745,-59,-97,38,0a:b9:b7:b1:4d:fa,264923013,468,1483,264922545,264923013
12648,5,12,149,5745,-55,-97,42,3e:d1:9b:c7:a4:de,264923560,544,3,264923016,264923560
12649,5,12,149,5745,-87,-97,10,9a:24:38:da:96:bb,264924157,824,-227,264923333,264924157
12650,5,12,149,5745,-71,-97,26,d2:00:04:7e:2c:ab,264926657,440,2060,264926217,264926657
12651,5,12,149,5745,-60,-97,37,3a:de:b0:2e:cd:45,264931029,468,3904,264930561,264931029
12652,5,12,149,5745,-72,-97,25,a6:92:ad:b7:76:65,264932818,484,1305,264932334,264932818
12653,5,12,149,5745,-67,-97,30,aa:b6:ae:27:64:4e,264933338,468,52,264932870,264933338
12654,5,12,149,5745,-70,-97,27,22:ec:75:a8:8a:31,264933894,516,40,264933378,264933894
12655,5,12,149,5745,-70,-97,27,3e:ef:29:c7:4b:17,264935796,440,1462,264935356,264935796
12656,5,12,149,5745,-64,-97,33,f2:da:61:dd:98:c5,264937242,268,1178,264936974,264937242
12657,5,12,149,5745,-60,-97,37,5e:29:73:5b:30:00,264937616,540,-166,264937076,264937616
12658,5,12,149,5745,-72,-97,25,b6:90:18:f6:b1:d4,264938741,468,657,264938273,264938741
12659,5,12,149,5745,-71,-97,26,22:ec:75:a8:8a:31,264947496,244,8511,264947252,264947496
12660,5,12,149,5745,-55,-97,42,3e:d1:9b:c7:a4:de,264948251,272,483,264947979,264948251
12661,5,12,149,5745,-70,-97,27,3e:ef:29:c7:4b:17,264948568,244,73,264948324,264948568
12662,5,12,149,5745,-72,-97,25,d2:00:04:7e:2c:ab,264949883,244,1071,264949639,264949883
12663,5,12,149,5745,-84,-97,13,9a:24:38:da:96:bb,264956911,272,6756,264956639,264956911
12664,5,12,149,5745,-65,-97,32,9e:1f:b0:a7:b8:90,264965480,256,8313,264965224,264965480
12665,5,12,149,5745,-61,-97,36,5e:29:73:5b:30:00,264972833,272,7081,264972561,264972833
12666,5,12,149,5745,-63,-97,34,0a:e1:ab:b3:c3:a6,264982311,468,9010,264981843,264982311
12667,5,12,149,5745,-72,-97,25,d2:00:04:7e:2c:ab,264991679,440,8928,264991239,264991679
12668,5,12,149,5745,-68,-97,29,76:d6:6a:bb:b3:f5,264992243,272,292,264991971,264992243
12669,5,6,149,5745,-84,-97,13,54:e4:3a:ec:fb:65,264995117,360,2514,264994757,264995117
12670,5,12,149,5745,-66,-97,31,f6:0a:5c:59:72:df,265001676,280,6279,265001396,265001676
12671,5,24,149,5745,-88,-97,9,,265020363,32,18655,265020331,265020363
12672,5,12,149,5745,-72,-97,25,b6:90:18:f6:b1:d4,265021096,272,461,265020824,265021096
12673,5,12,149,5745,-73,-97,24,56:68:e2:c2:8d:d5,265022654,280,1278,265022374,265022654
12674,5,12,149,5745,-75,-97,22,72:d1:72:1d:22:a1,265032155,284,9217,265031871,265032155
12675,5,24,149,5745,-87,-97,10,,265034837,28,2654,265034809,265034837
12676,5,24,149,5745,-87,-97,10,,265037029,28,2164,265037001,265037029
12677,5,24,149,5745,-89,-97,8,,265037137,32,76,265037105,265037137
12678,5,6,149,5745,-70,-97,27,,265039429,52,2240,265039377,265039429
12679,5,6,149,5745,-88,-97,9,,265039497,44,24,265039453,265039497
12680,5,24,149,5745,-88,-97,9,,265039615,28,90,265039587,265039615
12681,5,24,149,5745,-87,-97,10,,265043557,32,3910,265043525,265043557
12682,5,12,149,5745,-62,-97,35,0a:e1:ab:b3:c3:a6,265047499,468,3474,265047031,265047499
12683,5,24,149,5745,-88,-97,9,,265048128,28,601,265048100,265048128
12684,5,24,149,5745,-88,-97,9,,265048481,28,325,265048453,265048481
12685,5,12,149,5745,-71,-97,26,22:ec:75:a8:8a:31,265049241,244,516,265048997,265049241
12686,5,24,149,5745,-87,-97,10,,265051435,32,2162,265051403,265051435
12687,5,24,149,5745,-88,-97,9,,265054909,28,3446,265054881,265054909
12688,5,24,149,5745,-88,-97,9,,265056779,28,1842,265056751,265056779
12689,5,24,149,5745,-88,-97,9,,265056887,32,76,265056855,265056887
12690,5,12,149,5745,-54,-97,43,3e:d1:9b:c7:a4:de,265057686,272,527,265057414,265057686
12691,5,24,149,5745,-88,-97,9,,265061071,32,3353,265061039,265061071
12692,5,24,149,5745,-87,-97,10,,265061543,32,440,265061511,265061543
12693,5,24,149,5745,-87,-97,10,,265062016,28,445,265061988,265062016
12694,5,12,149,5745,-84,-97,13,9a:24:38:da:96:bb,265069936,272,7648,265069664,265069936
12695,5,12,149,5745,-73,-97,24,d2:00:04:7e:2c:ab,265071466,244,1286,265071222,265071466
12696,5,12,149,5745,-70,-97,27,3e:ef:29:c7:4b:17,265073192,244,1482,265072948,265073192
12697,5,12,149,5745,-61,-97,36,5e:29:73:5b:30:00,265086691,272,13227,265086419,265086691
12698,5,24,149,5745,-87,-97,10,,265090587,28,3868,265090559,265090587
12699,5,6,149,5745,-88,-97,9,54:e4:3a:ec:fb:65,265097518,360,6571,265097158,265097518
12700,5,12,149,5745,-61,-97,36,9e:1f:b0:a7:b8:90,265097905,256,131,265097649,265097905
12701,5,12,149,5745,-60,-97,37,3a:de:b0:2e:cd:45,265098269,272,92,265097997,265098269
12702,5,12,149,5745,-67,-97,30,76:d6:6a:bb:b3:f5,265103383,272,4842,265103111,265103383
12703,5,12,149,5745,-58,-97,39,0a:e1:ab:b3:c3:a6,265113031,468,9180,265112563,265113031
12704,5,6,149,5745,-71,-97,26,,265115594,52,2511,265115542,265115594
12705,5,6,149,5745,-86,-97,11,,265115662,44,24,265115618,265115662
12706,5,24,149,5745,-86,-97,11,,265115780,28,90,265115752,265115780
12707,5,12,149,5745,-71,-97,26,f6:0a:5c:59:72:df,265115881,280,-179,265115601,265115881
12708,5,12,149,5745,-63,-97,34,0a:b9:b7:b1:4d:fa,265117932,468,1583,265117464,265117932
12709,5,12,149,5745,-73,-97,24,56:68:e2:c2:8d:d5,265124820,280,6608,265124540,265124820
12710,5,24,149,5745,-86,-97,11,,265131358,32,6506,265131326,265131358
12711,5,24,149,5745,-86,-97,11,,265131830,32,440,265131798,265131830
12712,5,24,149,5745,-85,-97,12,,265132302,28,444,265132274,265132302
12713,5,12,149,5745,-71,-97,26,b6:90:18:f6:b1:d4,265134092,272,1518,265133820,265134092
12714,5,12,149,5745,-60,-97,37,4a:ea:3c:f4:ce:b2,265134437,272,73,265134165,265134437
12715,5,12,149,5745,-70,-97,27,22:ec:75:a8:8a:31,265162018,244,27337,265161774,265162018
12716,5,12,149,5745,-54,-97,43,3e:d1:9b:c7:a4:de,265175156,272,12866,265174884,265175156
12717,5,24,149,5745,-87,-97,10,,265176297,28,1113,265176269,265176297
12718,5,24,149,5745,-79,-97,18,,265176341,28,16,265176313,265176341
12719,5,24,149,5745,-86,-97,11,,265176557,28,188,265176529,265176557
12720,5,24,149,5745,-80,-97,17,,265176601,28,16,265176573,265176601
12721,5,24,149,5745,-87,-97,10,,265176756,28,127,265176728,265176756
12722,5,24,149,5745,-80,-97,17,,265176800,28,16,265176772,265176800
12723,5,24,149,5745,-80,-97,17,,265176912,32,80,265176880,265176912
12724,5,6,149,5745,-72,-97,25,,265177072,52,108,265177020,265177072
12725,5,6,149,5745,-87,-97,10,,265177140,44,24,265177096,265177140
12726,5,24,149,5745,-88,-97,9,,265177257,28,89,265177229,265177257
12727,5,24,149,5745,-80,-97,17,,265178183,28,898,265178155,265178183
12728,5,24,149,5745,-87,-97,10,,265178227,28,16,265178199,265178227
12729,5,24,149,5745,-87,-97,10,,265178335,32,76,265178303,265178335
12730,5,24,149,5745,-80,-97,17,,265179211,28,848,265179183,265179211
12731,5,24,149,5745,-87,-97,10,,265179255,28,16,265179227,265179255
12732,5,24,149,5745,-88,-97,9,,265179363,32,76,265179331,265179363
12733,5,12,149,5745,-72,-97,25,3e:ef:29:c7:4b:17,265185113,244,5506,265184869,265185113
12734,5,6,149,5745,-86,-97,11,54:e4:3a:ec:fb:65,265199919,360,14446,265199559,265199919
12735,5,12,149,5745,-64,-97,33,f2:da:61:dd:98:c5,265200306,268,119,265200038,265200306
12736,5,12,149,5745,-59,-97,38,3a:de:b0:2e:cd:45,265200608,272,30,265200336,265200608
12737,5,12,149,5745,-61,-97,36,9e:1f:b0:a7:b8:90,265201194,256,330,265200938,265201194
12738,5,12,149,5745,-60,-97,37,5e:29:73:5b:30:00,265204645,272,3179,265204373,265204645
12739,5,12,149,5745,-67,-97,30,76:d6:6a:bb:b3:f5,265212397,272,7480,265212125,265212397
12740,5,12,149,5745,-74,-97,23,d2:00:04:7e:2c:ab,265224372,244,11731,265224128,265224372
12741,5,12,149,5745,-73,-97,24,72:d1:72:1d:22:a1,265224729,284,73,265224445,265224729
12742,5,12,149,5745,-75,-97,22,56:68:e2:c2:8d:d5,265225810,280,801,265225530,265225810
12743,5,24,149,5745,-79,-97,18,66:48:51:4e:71:fa,265245964,328,19826,265245636,265245964
12744,5,24,149,5745,-89,-97,8,,265246416,28,424,265246388,265246416
12745,5,24,149,5745,-79,-97,18,,265246460,28,16,265246432,265246460
12746,5,24,149,5745,-79,-97,18,,265246568,32,76,265246536,265246568
12747,5,24,149,5745,-79,-97,18,,265247699,28,1103,265247671,265247699
12748,5,24,149,5745,-89,-97,8,,265247743,28,16,265247715,265247743
12749,5,24,149,5745,-89,-97,8,,265247850,32,75,265247818,265247850
12750,5,24,149,5745,-91,-97,6,,265261585,32,13703,265261553,265261585
12751,5,12,149,5745,-68,-97,29,22:ec:75:a8:8a:31,265276603,244,14774,265276359,265276603
12752,5,24,149,5745,-91,-97,6,,265279641,28,3010,265279613,265279641
12753,5,12,149,5745,-56,-97,41,3e:d1:9b:c7:a4:de,265289947,272,10034,265289675,265289947
12754,5,12,149,5745,-72,-97,25,3e:ef:29:c7:4b:17,265293170,244,2979,265292926,265293170
12755,5,6,149,5745,-85,-97,12,54:e4:3a:ec:fb:65,265302319,360,8789,265301959,265302319
12756,5,12,149,5745,-65,-97,32,f2:da:61:dd:98:c5,265302707,268,120,265302439,265302707
12757,5,12,149,5745,-56,-97,41,3a:de:b0:2e:cd:45,265303537,272,558,265303265,265303537
12758,5,12,149,5745,-59,-97,38,5e:29:73:5b:30:00,265316606,272,12797,265316334,265316606
12759,5,12,149,5745,-64,-97,33,9e:1f:b0:a7:b8:90,265319282,256,2420,265319026,265319282
12760,5,12,149,5745,-75,-97,22,d2:00:04:7e:2c:ab,265326062,244,6536,265325818,265326062
12761,5,12,149,5745,-73,-97,24,b6:90:18:f6:b1:d4,265326627,272,293,265326355,265326627
12762,5,12,149,5745,-72,-97,25,72:d1:72:1d:22:a1,265326971,284,60,265326687,265326971
12763,5,12,149,5745,-73,-97,24,56:68:e2:c2:8d:d5,265327469,280,218,265327189,265327469
12764,5,12,149,5745,-68,-97,29,76:d6:6a:bb:b3:f5,265334040,272,6299,265333768,265334040
12765,5,12,149,5745,-62,-97,35,4a:ea:3c:f4:ce:b2,265339599,272,5287,265339327,265339599
12766,5,12,149,5745,-71,-97,26,b6:90:18:f6:b1:d4,265358852,272,18981,265358580,265358852
12767,5,12,149,5745,-56,-97,41,3a:de:b0:2e:cd:45,265359295,272,171,265359023,265359295
12768,5,12,149,5745,-65,-97,32,f2:da:61:dd:98:c5,265360220,268,657,265359952,265360220
12769,5,12,149,5745,-71,-97,26,72:d1:72:1d:22:a1,265373689,284,13185,265373405,265373689
12770,5,12,149,5745,-71,-97,26,f6:0a:5c:59:72:df,265374393,476,228,265373917,265374393
12771,5,12,149,5745,-74,-97,23,56:68:e2:c2:8d:d5,265379867,476,4998,265379391,265379867
12772,5,12,149,5745,-62,-97,35,9e:1f:b0:a7:b8:90,265380377,452,58,265379925,265380377
12773,5,12,149,5745,-66,-97,31,76:d6:6a:bb:b3:f5,265380882,468,37,265380414,265380882
12774,5,12,149,5745,-60,-97,37,3e:d1:9b:c7:a4:de,265381430,544,4,265380886,265381430
12775,5,12,149,5745,-71,-97,26,72:d1:72:1d:22:a1,265383161,480,1251,265382681,265383161
12776,5,12,149,5745,-62,-97,35,4a:ea:3c:f4:ce:b2,265383775,468,146,265383307,265383775
12777,5,12,149,5745,-75,-97,22,d2:00:04:7e:2c:ab,265386978,440,2763,265386538,265386978
12778,5,12,149,5745,-56,-97,41,3a:de:b0:2e:cd:45,265389793,468,2347,265389325,265389793
12779,5,12,149,5745,-70,-97,27,22:ec:75:a8:8a:31,265391169,516,860,265390653,265391169
12780,5,12,149,5745,-74,-97,23,56:68:e2:c2:8d:d5,265391764,280,315,265391484,265391764
12781,5,12,149,5745,-60,-97,37,5e:29:73:5b:30:00,265394418,540,2114,265393878,265394418
12782,5,12,149,5745,-74,-97,23,3e:ef:29:c7:4b:17,265395200,440,342,265394760,265395200
12783,5,12,149,5745,-64,-97,33,f2:da:61:dd:98:c5,265395940,268,472,265395672,265395940
12784,5,12,149,5745,-71,-97,26,b6:90:18:f6:b1:d4,265397260,468,852,265396792,265397260
12785,5,12,149,5745,-66,-97,31,0a:e1:ab:b3:c3:a6,265397789,468,61,265397321,265397789
12786,5,6,149,5745,-86,-97,11,54:e4:3a:ec:fb:65,265404720,360,6571,265404360,265404720
12787,5,12,149,5745,-74,-97,23,3e:ef:29:c7:4b:17,265408291,244,3327,265408047,265408291
12788,5,12,149,5745,-75,-97,22,d2:00:04:7e:2c:ab,265408616,244,81,265408372,265408616
12789,5,12,149,5745,-61,-97,36,3e:d1:9b:c7:a4:de,265423606,272,14718,265423334,265423606
12790,5,12,149,5745,-61,-97,36,9e:1f:b0:a7:b8:90,265424318,256,456,265424062,265424318
12791,5,12,149,5745,-71,-97,26,f6:0a:5c:59:72:df,265438950,280,14352,265438670,265438950
12792,5,12,149,5745,-73,-97,24,f6:0a:5c:59:72:df,265439248,476,-178,265438772,265439248
12793,5,12,149,5745,-64,-97,33,76:d6:6a:bb:b3:f5,265439966,272,446,265439694,265439966
12794,5,12,149,5745,-60,-97,37,5e:29:73:5b:30:00,265441155,272,917,265440883,265441155
12795,5,12,149,5745,-75,-97,22,56:68:e2:c2:8d:d5,265442487,476,856,265442011,265442487
12796,5,12,149,5745,-57,-97,40,0a:b9:b7:b1:4d:fa,265443591,468,636,265443123,265443591
12797,5,12,149,5745,-61,-97,36,9e:1f:b0:a7:b8:90,265444446,452,403,265443994,265444446
12798,5,12,149,5745,-81,-97,16,9a:24:38:da:96:bb,265445343,824,73,265444519,265445343
12799,5,12,149,5745,-62,-97,35,4a:ea:3c:f4:ce:b2,265446201,468,390,265445733,265446201
12800,5,12,149,5745,-61,-97,36,4a:ea:3c:f4:ce:b2,265446686,272,213,265446414,265446686
12801,5,12,149,5745,-70,-97,27,72:d1:72:1d:22:a1,265447002,480,-164,265446522,265447002
12802,5,12,149,5745,-61,-97,36,3e:d1:9b:c7:a4:de,265447516,544,-30,265446972,265447516
12803,5,12,149,5745,-64,-97,33,76:d6:6a:bb:b3:f5,265448095,468,111,265447627,265448095
12804,5,12,149,5745,-74,-97,23,d2:00:04:7e:2c:ab,265450473,440,1938,265450033,265450473
12805,5,12,149,5745,-57,-97,40,3a:de:b0:2e:cd:45,265453892,468,2951,265453424,265453892
12806,5,12,149,5745,-57,-97,40,3a:de:b0:2e:cd:45,265455783,272,1619,265455511,265455783
12807,5,12,149,5745,-63,-97,34,f2:da:61:dd:98:c5,265456621,268,570,265456353,265456621
12808,5,12,149,5745,-74,-97,23,d2:00:04:7e:2c:ab,265457693,380,692,265457313,265457693
12809,5,12,149,5745,-70,-97,27,a6:92:ad:b7:76:65,265458116,484,-61,265457632,265458116
12810,5,12,149,5745,-67,-97,30,aa:b6:ae:27:64:4e,265458636,468,52,265458168,265458636
12811,5,12,149,5745,-61,-97,36,5e:29:73:5b:30:00,265459208,540,32,265458668,265459208
12812,5,12,149,5745,-63,-97,34,f2:da:61:dd:98:c5,265459819,268,343,265459551,265459819
12813,5,12,149,5745,-68,-97,29,0a:e1:ab:b3:c3:a6,265461329,468,1042,265460861,265461329
12814,5,12,149,5745,-71,-97,26,b6:90:18:f6:b1:d4,265461867,468,70,265461399,265461867
12815,5,12,149,5745,-69,-97,28,72:d1:72:1d:22:a1,265471976,284,9825,265471692,265471976
12816,5,12,149,5745,-71,-97,26,b6:90:18:f6:b1:d4,265473691,272,1443,265473419,265473691
12817,5,24,149,5745,-88,-97,9,,265487329,32,13606,265487297,265487329
12818,5,12,149,5745,-74,-97,23,56:68:e2:c2:8d:d5,265490391,280,2782,265490111,265490391
12819,5,24,149,5745,-89,-97,8,,265495287,28,4868,265495259,265495287
12820,5,24,149,5745,-77,-97,20,,265495330,28,15,265495302,265495330
12821,5,24,149,5745,-79,-97,18,,265495438,32,76,265495406,265495438
12822,5,24,149,5745,-79,-97,18,,265495531,28,65,265495503,265495531
12823,5,24,149,5745,-89,-97,8,,265495683,32,120,265495651,265495683
12824,5,12,149,5745,-71,-97,26,22:ec:75:a8:8a:31,265500906,244,4979,265500662,265500906
12825,5,24,149,5745,-86,-97,11,,265503730,28,2796,265503702,265503730
12826,5,24,149,5745,-88,-97,9,,265503775,28,17,265503747,265503775
12827,5,24,149,5745,-89,-97,8,,265503883,32,76,265503851,265503883
12828,5,24,149,5745,-88,-97,9,,265505229,28,1318,265505201,265505229
12829,5,24,149,5745,-87,-97,10,,265505274,28,17,265505246,265505274
12830,5,12,149,5745,-74,-97,23,d2:00:04:7e:2c:ab,265506645,244,1127,265506401,265506645
12831,5,6,149,5745,-86,-97,11,54:e4:3a:ec:fb:65,265507120,360,115,265506760,265507120
12832,5,24,149,5745,-89,-97,8,,265513442,28,6294,265513414,265513442
12833,5,24,149,5745,-79,-97,18,,265513486,28,16,265513458,265513486
12834,5,24,149,5745,-79,-97,18,,265513594,32,76,265513562,265513594
12835,5,12,149,5745,-59,-97,38,3e:d1:9b:c7:a4:de,265515884,272,2018,265515612,265515884
12836,5,12,149,5745,-80,-97,17,9a:24:38:da:96:bb,265518271,272,2115,265517999,265518271
12837,5,24,149,5745,-87,-97,10,,265521735,28,3436,265521707,265521735
12838,5,12,149,5745,-66,-97,31,0a:e1:ab:b3:c3:a6,265526218,468,4015,265525750,265526218
12839,5,12,149,5745,-72,-97,25,3e:ef:29:c7:4b:17,265529051,244,2589,265528807,265529051
12840,5,12,149,5745,-64,-97,33,5e:29:73:5b:30:00,265545023,272,15700,265544751,265545023
12841,5,12,149,5745,-63,-97,34,4a:ea:3c:f4:ce:b2,265573107,272,27812,265572835,265573107
12842,5,12,149,5745,-65,-97,32,0a:e1:ab:b3:c3:a6,265591757,468,18182,265591289,265591757
12843,5,6,149,5745,-70,-97,27,,265597157,52,5348,265597105,265597157
12844,5,6,149,5745,-89,-97,8,,265597225,44,24,265597181,265597225
12845,5,24,149,5745,-89,-97,8,,265597342,28,89,265597314,265597342
12846,5,6,149,5745,-86,-97,11,54:e4:3a:ec:fb:65,265609521,360,11819,265609161,265609521
12847,5,12,149,5745,-62,-97,35,76:d6:6a:bb:b3:f5,265610069,272,276,265609797,265610069
12848,5,12,149,5745,-57,-97,40,3a:de:b0:2e:cd:45,265610454,272,113,265610182,265610454
12849,5,12,149,5745,-61,-97,36,f2:da:61:dd:98:c5,265610769,268,47,265610501,265610769
12850,5,12,149,5745,-65,-97,32,9e:1f:b0:a7:b8:90,265611072,256,47,265610816,265611072
12851,5,12,149,5745,-70,-97,27,22:ec:75:a8:8a:31,265616706,244,5390,265616462,265616706
12852,5,12,149,5745,-80,-97,17,9a:24:38:da:96:bb,265633981,272,17003,265633709,265633981
12853,5,12,149,5745,-56,-97,41,3e:d1:9b:c7:a4:de,265634315,272,62,265634043,265634315
12854,5,12,149,5745,-74,-97,23,d2:00:04:7e:2c:ab,265634700,244,141,265634456,265634700
12855,5,12,149,5745,-73,-97,24,b6:90:18:f6:b1:d4,265635107,272,135,265634835,265635107
12856,5,12,149,5745,-73,-97,24,56:68:e2:c2:8d:d5,265636827,280,1440,265636547,265636827
12857,5,12,149,5745,-53,-97,44,0a:b9:b7:b1:4d:fa,265641364,468,4069,265640896,265641364
12858,5,12,149,5745,-60,-97,37,5e:29:73:5b:30:00,265657216,272,15580,265656944,265657216
12859,5,12,149,5745,-64,-97,33,0a:e1:ab:b3:c3:a6,265657560,468,-124,265657092,265657560
12860,5,24,149,5745,-87,-97,10,,265682185,32,24593,265682153,265682185
12861,5,24,149,5745,-87,-97,10,,265682702,32,485,265682670,265682702
12862,5,24,149,5745,-87,-97,10,,265683219,28,489,265683191,265683219
12863,5,12,149,5745,-72,-97,25,3e:ef:29:c7:4b:17,265687654,244,4191,265687410,265687654
12864,5,12,149,5745,-63,-97,34,76:d6:6a:bb:b3:f5,265711768,272,23842,265711496,265711768
12865,5,12,149,5745,-61,-97,36,f2:da:61:dd:98:c5,265712496,268,460,265712228,265712496
12866,5,12,149,5745,-58,-97,39,3a:de:b0:2e:cd:45,265712906,272,138,265712634,265712906
12867,5,12,149,5745,-62,-97,35,9e:1f:b0:a7:b8:90,265713340,256,178,265713084,265713340
12868,5,12,149,5745,-73,-97,24,22:ec:75:a8:8a:31,265733791,244,20207,265733547,265733791
12869,5,12,149,5745,-69,-97,28,72:d1:72:1d:22:a1,265736663,284,2588,265736379,265736663
12870,5,12,149,5745,-72,-97,25,b6:90:18:f6:b1:d4,265737097,272,162,265736825,265737097
12871,5,12,149,5745,-75,-97,22,56:68:e2:c2:8d:d5,265739248,280,1871,265738968,265739248
12872,5,12,149,5745,-79,-97,18,9a:24:38:da:96:bb,265742479,272,2959,265742207,265742479
12873,5,12,149,5745,-74,-97,23,d2:00:04:7e:2c:ab,265746894,244,4171,265746650,265746894
12874,5,12,149,5745,-55,-97,42,3e:d1:9b:c7:a4:de,265751027,272,3861,265750755,265751027
12875,5,12,149,5745,-59,-97,38,5e:29:73:5b:30:00,265774169,272,22870,265773897,265774169
12876,5,12,149,5745,-69,-97,28,f6:0a:5c:59:72:df,265785379,280,10930,265785099,265785379
12877,5,12,149,5745,-73,-97,24,3e:ef:29:c7:4b:17,265789117,244,3494,265788873,265789117
12878,5,24,149,5745,-88,-97,9,,265793963,32,4814,265793931,265793963
12879,5,6,149,5745,-72,-97,25,,265794403,52,388,265794351,265794403
12880,5,6,149,5745,-88,-97,9,,265794471,44,24,265794427,265794471
12881,5,24,149,5745,-88,-97,9,,265794596,32,93,265794564,265794596
12882,5,6,149,5745,-71,-97,26,,265794718,52,70,265794666,265794718
12883,5,6,149,5745,-88,-97,9,,265794786,44,24,265794742,265794786
12884,5,24,149,5745,-88,-97,9,,265794904,28,90,265794876,265794904
12885,5,24,149,5745,-88,-97,9,,265795672,28,740,265795644,265795672
12886,5,24,149,5745,-89,-97,8,,265810421,28,14721,265810393,265810421
12887,5,6,149,5745,-89,-97,8,54:e4:3a:ec:fb:65,265814322,360,3541,265813962,265814322
12888,5,12,149,5745,-71,-97,26,b6:90:18:f6:b1:d4,265817337,272,2743,265817065,265817337
12889,5,12,149,5745,-64,-97,33,76:d6:6a:bb:b3:f5,265817744,272,135,265817472,265817744
12890,5,12,149,5745,-57,-97,40,3a:de:b0:2e:cd:45,265818069,272,53,265817797,265818069
12891,5,12,149,5745,-71,-97,26,72:d1:72:1d:22:a1,265818377,284,24,265818093,265818377
12892,5,12,149,5745,-65,-97,32,9e:1f:b0:a7:b8:90,265819019,256,386,265818763,265819019
12893,5,12,149,5745,-65,-97,32,f2:da:61:dd:98:c5,265819320,268,33,265819052,265819320
12894,5,12,149,5745,-70,-97,27,f6:0a:5c:59:72:df,265832677,476,12881,265832201,265832677
12895,5,12,149,5745,-73,-97,24,56:68:e2:c2:8d:d5,265833682,280,725,265833402,265833682
12896,5,12,149,5745,-83,-97,14,9a:24:38:da:96:bb,265837670,824,3164,265836846,265837670
12897,5,12,149,5745,-65,-97,32,9e:1f:b0:a7:b8:90,265838933,452,811,265838481,265838933
12898,5,12,149,5745,-64,-97,33,76:d6:6a:bb:b3:f5,265839466,468,65,265838998,265839466
12899,5,12,149,5745,-73,-97,24,56:68:e2:c2:8d:d5,265839977,476,35,265839501,265839977
12900,5,12,149,5745,-57,-97,40,3e:d1:9b:c7:a4:de,265842223,544,1702,265841679,265842223
12901,5,12,149,5745,-65,-97,32,9e:1f:b0:a7:b8:90,265842838,104,511,265842734,265842838
12902,5,12,149,5745,-75,-97,22,d2:00:04:7e:2c:ab,265845556,440,2278,265845116,265845556
12903,5,12,149,5745,-57,-97,40,3a:de:b0:2e:cd:45,265848308,468,2284,265847840,265848308
12904,5,12,149,5745,-65,-97,32,5e:29:73:5b:30:00,265848829,540,-19,265848289,265848829
12905,5,12,149,5745,-75,-97,22,d2:00:04:7e:2c:ab,265850546,244,1473,265850302,265850546
12906,5,12,149,5745,-71,-97,26,22:ec:75:a8:8a:31,265852615,516,1553,265852099,265852615
12907,5,12,149,5745,-73,-97,24,3e:ef:29:c7:4b:17,265853194,440,139,265852754,265853194
12908,5,12,149,5745,-64,-97,33,f2:da:61:dd:98:c5,265854334,268,872,265854066,265854334
12909,5,12,149,5745,-67,-97,30,0a:e1:ab:b3:c3:a6,265855739,468,937,265855271,265855739
12910,5,12,149,5745,-72,-97,25,b6:90:18:f6:b1:d4,265856232,468,25,265855764,265856232
12911,5,12,149,5745,-70,-97,27,22:ec:75:a8:8a:31,265865032,244,8556,265864788,265865032
12912,5,12,149,5745,-64,-97,33,9e:1f:b0:a7:b8:90,265865338,256,50,265865082,265865338
12913,5,12,149,5745,-73,-97,24,3e:ef:29:c7:4b:17,265867122,244,1540,265866878,265867122
12914,5,12,149,5745,-58,-97,39,3e:d1:9b:c7:a4:de,265882799,272,15405,265882527,265882799
12915,5,12,149,5745,-70,-97,27,f6:0a:5c:59:72:df,265887065,280,3986,265886785,265887065
12916,5,12,149,5745,-61,-97,36,4a:ea:3c:f4:ce:b2,265894250,272,6913,265893978,265894250
12917,5,12,149,5745,-62,-97,35,76:d6:6a:bb:b3:f5,265898499,272,3977,265898227,265898499
12918,5,12,149,5745,-72,-97,25,f6:0a:5c:59:72:df,265898889,476,-86,265898413,265898889
12919,5,12,149,5745,-63,-97,34,5e:29:73:5b:30:00,265899948,272,787,265899676,265899948
12920,5,12,149,5745,-61,-97,36,9e:1f:b0:a7:b8:90,265903361,452,2961,265902909,265903361
12921,5,12,149,5745,-62,-97,35,76:d6:6a:bb:b3:f5,265904440,468,611,265903972,265904440
12922,5,12,149,5745,-74,-97,23,d2:00:04:7e:2c:ab,265909939,440,5059,265909499,265909939
12923,5,24,149,5745,-86,-97,11,,265911465,28,1498,265911437,265911465
12924,5,12,149,5745,-62,-97,35,5e:29:73:5b:30:00,265912591,540,586,265912051,265912591
12925,5,12,149,5745,-59,-97,38,3a:de:b0:2e:cd:45,265913212,468,153,265912744,265913212
12926,5,24,149,5745,-91,-97,6,,265913822,28,582,265913794,265913822
12927,5,24,149,5745,-85,-97,12,,265913866,28,16,265913838,265913866
12928,5,24,149,5745,-86,-97,11,,265913978,32,80,265913946,265913978
12929,5,24,149,5745,-86,-97,11,,265914261,28,255,265914233,265914261
12930,5,24,149,5745,-90,-97,7,,265914305,28,16,265914277,265914305
12931,5,24,149,5745,-90,-97,7,,265914413,32,76,265914381,265914413
12932,5,12,149,5745,-58,-97,39,3a:de:b0:2e:cd:45,265914605,272,-80,265914333,265914605
12933,5,6,149,5745,-89,-97,8,54:e4:3a:ec:fb:65,265916722,360,1757,265916362,265916722
12934,5,12,149,5745,-61,-97,36,f2:da:61:dd:98:c5,265917171,268,181,265916903,265917171
12935,5,12,149,5745,-67,-97,30,0a:e1:ab:b3:c3:a6,265919657,468,2018,265919189,265919657
12936,5,12,149,5745,-73,-97,24,b6:90:18:f6:b1:d4,265929464,272,9535,265929192,265929464
12937,5,24,149,5745,-91,-97,6,,265929736,28,244,265929708,265929736
12938,5,24,149,5745,-86,-97,11,,265929781,28,17,265929753,265929781
12939,5,24,149,5745,-85,-97,12,,265929889,32,76,265929857,265929889
12940,5,24,149,5745,-86,-97,11,,265932256,28,2339,265932228,265932256
12941,5,24,149,5745,-88,-97,9,,265932364,32,76,265932332,265932364
12942,5,24,149,5745,-86,-97,11,,265938030,28,5638,265938002,265938030
12943,5,24,149,5745,-91,-97,6,,265938074,28,16,265938046,265938074
12944,5,12,149,5745,-71,-97,26,72:d1:72:1d:22:a1,265939057,284,699,265938773,265939057
12945,5,12,149,5745,-72,-97,25,56:68:e2:c2:8d:d5,265954692,280,15355,265954412,265954692
12946,5,12,149,5745,-72,-97,25,f6:0a:5c:59:72:df,265963520,476,8352,265963044,265963520
12947,5,12,149,5745,-72,-97,25,d2:00:04:7e:2c:ab,265965423,244,1659,265965179,265965423
12948,5,12,149,5745,-81,-97,16,9a:24:38:da:96:bb,265966240,272,545,265965968,265966240
12949,5,12,149,5745,-61,-97,36,9e:1f:b0:a7:b8:90,265967681,452,989,265967229,265967681
12950,5,12,149,5745,-58,-97,39,0a:b9:b7:b1:4d:fa,265969085,468,936,265968617,265969085
12951,5,12,149,5745,-61,-97,36,76:d6:6a:bb:b3:f5,265970101,468,548,265969633,265970101
12952,5,12,149,5745,-59,-97,38,3e:d1:9b:c7:a4:de,265972277,544,1632,265971733,265972277
12953,5,12,149,5745,-81,-97,16,9a:24:38:da:96:bb,265972866,824,-235,265972042,265972866
12954,5,12,149,5745,-60,-97,37,4a:ea:3c:f4:ce:b2,265975110,468,1776,265974642,265975110
12955,5,12,149,5745,-71,-97,26,d2:00:04:7e:2c:ab,265975711,440,161,265975271,265975711
12956,5,12,149,5745,-61,-97,36,5e:29:73:5b:30:00,265977945,540,1694,265977405,265977945
12957,5,12,149,5745,-59,-97,38,3a:de:b0:2e:cd:45,265978539,468,126,265978071,265978539
12958,5,12,149,5745,-68,-97,29,22:ec:75:a8:8a:31,265979856,244,1073,265979612,265979856
12959,5,12,149,5745,-69,-97,28,aa:b6:ae:27:64:4e,265980144,468,-180,265979676,265980144
12960,5,12,149,5745,-73,-97,24,3e:ef:29:c7:4b:17,265980666,244,278,265980422,265980666
12961,5,12,149,5745,-62,-97,35,9e:1f:b0:a7:b8:90,265980962,256,40,265980706,265980962
12962,5,12,149,5745,-67,-97,30,a6:92:ad:b7:76:65,265981342,484,-104,265980858,265981342
12963,5,12,149,5745,-68,-97,29,22:ec:75:a8:8a:31,265983624,516,1766,265983108,265983624
12964,5,12,149,5745,-66,-97,31,0a:e1:ab:b3:c3:a6,265985047,468,955,265984579,265985047
12965,5,12,149,5745,-73,-97,24,3e:ef:29:c7:4b:17,265985549,440,62,265985109,265985549
12966,5,12,149,5745,-70,-97,27,b6:90:18:f6:b1:d4,265986024,468,7,265985556,265986024
12967,5,12,149,5745,-62,-97,35,f2:da:61:dd:98:c5,265986526,268,234,265986258,265986526
12968,5,12,149,5745,-57,-97,40,3e:d1:9b:c7:a4:de,265996695,272,9897,265996423,265996695
12969,5,12,149,5745,-71,-97,26,f6:0a:5c:59:72:df,265999350,280,2375,265999070,265999350
12970,5,12,149,5745,-59,-97,38,4a:ea:3c:f4:ce:b2,266006217,272,6595,266005945,266006217
12971,5,12,149,5745,-62,-97,35,76:d6:6a:bb:b3:f5,266013544,272,7055,266013272,266013544
12972,5,12,149,5745,-60,-97,37,5e:29:73:5b:30:00,266014895,272,1079,266014623,266014895
12973,5,6,149,5745,-84,-97,13,54:e4:3a:ec:fb:65,266019123,360,3868,266018763,266019123
12974,5,24,149,5745,-91,-97,6,,266022813,28,3662,266022785,266022813
12975,5,24,149,5745,-86,-97,11,,266022858,28,17,266022830,266022858
12976,5,24,149,5745,-90,-97,7,,266026204,28,3318,266026176,266026204
12977,5,24,149,5745,-90,-97,7,,266026320,32,84,266026288,266026320
12978,5,12,149,5745,-59,-97,38,3a:de:b0:2e:cd:45,266040553,272,13961,266040281,266040553
12979,5,12,149,5745,-70,-97,27,d2:00:04:7e:2c:ab,266041300,440,307,266040860,266041300
12980,5,12,149,5745,-65,-97,32,f2:da:61:dd:98:c5,266042277,268,709,266042009,266042277
12981,5,12,149,5745,-59,-97,38,5e:29:73:5b:30:00,266043448,540,631,266042908,266043448
12982,5,12,149,5745,-69,-97,28,b6:90:18:f6:b1:d4,266044946,272,1226,266044674,266044946
12983,5,12,149,5745,-65,-97,32,0a:e1:ab:b3:c3:a6,266050498,468,5084,266050030,266050498
12984,5,12,149,5745,-72,-97,25,72:d1:72:1d:22:a1,266052327,284,1545,266052043,266052327
12985,5,12,149,5745,-69,-97,28,22:ec:75:a8:8a:31,266075341,244,22770,266075097,266075341
12986,5,12,149,5745,-86,-97,11,9a:24:38:da:96:bb,266078184,272,2571,266077912,266078184
12987,5,12,149,5745,-69,-97,28,d2:00:04:7e:2c:ab,266080868,244,2440,266080624,266080868
12988,5,12,149,5745,-56,-97,41,3e:d1:9b:c7:a4:de,266092586,272,11446,266092314,266092586
12989,5,12,149,5745,-72,-97,25,3e:ef:29:c7:4b:17,266098395,244,5565,266098151,266098395
12990,5,12,149,5745,-61,-97,36,9e:1f:b0:a7:b8:90,266104135,256,5484,266103879,266104135
12991,5,12,149,5745,-59,-97,38,5e:29:73:5b:30:00,266108997,540,4322,266108457,266108997
12992,5,24,149,5745,-86,-97,11,,266111107,28,2082,266111079,266111107
12993,5,24,149,5745,-85,-97,12,,266111215,32,76,266111183,266111215
12994,5,24,149,5745,-85,-97,12,,266111406,28,163,266111378,266111406
12995,5,24,149,5745,-85,-97,12,,266111525,32,87,266111493,266111525
12996,5,24,149,5745,-85,-97,12,,266111824,32,267,266111792,266111824
12997,5,24,149,5745,-88,-97,9,,266111976,28,124,266111948,266111976
12998,5,24,149,5745,-86,-97,11,,266112020,28,16,266111992,266112020
12999,5,24,149,5745,-86,-97,11,,266112139,32,87,266112107,266112139
13000,5,24,149,5745,-88,-97,9,,266112280,28,113,266112252,266112280
13001,5,24,149,5745,-86,-97,11,,266112325,28,17,266112297,266112325
13002,5,24,149,5745,-86,-97,11,,266112443,32,86,266112411,266112443
13003,5,24,149,5745,-88,-97,9,,266112639,28,168,266112611,266112639
13004,5,24,149,5745,-85,-97,12,,266112683,28,16,266112655,266112683
13005,5,24,149,5745,-85,-97,12,,266112791,32,76,266112759,266112791
13006,5,24,149,5745,-86,-97,11,,266115535,28,2716,266115507,266115535
13007,5,24,149,5745,-88,-97,9,,266115687,32,120,266115655,266115687
13008,5,12,149,5745,-64,-97,33,0a:e1:ab:b3:c3:a6,266115999,468,-156,266115531,266115999
13009,5,24,149,5745,-86,-97,11,,266116526,28,499,266116498,266116526
13010,5,6,149,5745,-84,-97,13,54:e4:3a:ec:fb:65,266121523,360,4637,266121163,266121523
13011,5,12,149,5745,-59,-97,38,5e:29:73:5b:30:00,266129318,272,7523,266129046,266129318
13012,5,12,149,5745,-69,-97,28,76:d6:6a:bb:b3:f5,266129714,272,124,266129442,266129714
13013,5,24,149,5745,-88,-97,9,,266143639,28,13897,266143611,266143639
13014,5,24,149,5745,-87,-97,10,,266143747,32,76,266143715,266143747
13015,5,12,149,5745,-70,-97,27,56:68:e2:c2:8d:d5,266147168,280,3141,266146888,266147168
13016,5,24,149,5745,-88,-97,9,,266153629,28,6433,266153601,266153629
13017,5,24,149,5745,-88,-97,9,,266153757,32,96,266153725,266153757
13018,5,12,149,5745,-70,-97,27,b6:90:18:f6:b1:d4,266155632,272,1603,266155360,266155632
13019,5,12,149,5745,-71,-97,26,72:d1:72:1d:22:a1,266162374,284,6458,266162090,266162374
13020,5,12,149,5745,-63,-97,34,0a:b9:b7:b1:4d:fa,266165668,468,2826,266165200,266165668
13021,5,12,149,5745,-59,-97,38,5e:29:73:5b:30:00,266174612,540,8404,266174072,266174612
13022,5,12,149,5745,-63,-97,34,0a:e1:ab:b3:c3:a6,266181613,468,6533,266181145,266181613
13023,5,12,149,5745,-69,-97,28,22:ec:75:a8:8a:31,266187397,244,5540,266187153,266187397
13024,5,12,149,5745,-61,-97,36,3e:d1:9b:c7:a4:de,266206459,272,18790,266206187,266206459
13025,5,12,149,5745,-74,-97,23,3e:ef:29:c7:4b:17,266211517,244,4814,266211273,266211517
13026,5,12,149,5745,-64,-97,33,9e:1f:b0:a7:b8:90,266216948,256,5175,266216692,266216948
13027,5,6,149,5745,-86,-97,11,54:e4:3a:ec:fb:65,266223924,360,6616,266223564,266223924
13028,5,12,149,5745,-68,-97,29,f2:da:61:dd:98:c5,266224721,268,529,266224453,266224721
13029,5,12,149,5745,-66,-97,31,3a:de:b0:2e:cd:45,266225203,272,210,266224931,266225203
13030,5,12,149,5745,-59,-97,38,5e:29:73:5b:30:00,266227538,272,2063,266227266,266227538
13031,5,24,149,5745,-85,-97,12,,266228389,28,823,266228361,266228389
13032,5,24,149,5745,-87,-97,10,,266228644,28,227,266228616,266228644
13033,5,24,149,5745,-86,-97,11,,266228688,28,16,266228660,266228688
13034,5,24,149,5745,-86,-97,11,,266228796,32,76,266228764,266228796
13035,5,12,149,5745,-67,-97,30,f6:0a:5c:59:72:df,266236202,280,7126,266235922,266236202
13036,5,12,149,5745,-67,-97,30,76:d6:6a:bb:b3:f5,266236536,272,62,266236264,266236536
13037,5,24,149,5745,-87,-97,10,,266238444,28,1880,266238416,266238444
13038,5,24,149,5745,-86,-97,11,,266238488,28,16,266238460,266238488
13039,5,24,149,5745,-86,-97,11,,266238596,32,76,266238564,266238596
13040,5,12,149,5745,-56,-97,41,4a:ea:3c:f4:ce:b2,266244663,272,5795,266244391,266244663
13041,5,12,149,5745,-72,-97,25,d2:00:04:7e:2c:ab,266248124,244,3217,266247880,266248124
13042,5,12,149,5745,-71,-97,26,56:68:e2:c2:8d:d5,266252344,280,3940,266252064,266252344
13043,5,12,149,5745,-68,-97,29,b6:90:18:f6:b1:d4,266264467,272,11851,266264195,266264467
13044,5,24,149,5745,-86,-97,11,,266298136,28,33641,266298108,266298136
13045,5,24,149,5745,-87,-97,10,,266298180,28,16,266298152,266298180
13046,5,24,149,5745,-87,-97,10,,266298468,28,260,266298440,266298468
13047,5,24,149,5745,-87,-97,10,,266298631,32,131,266298599,266298631
13048,5,24,149,5745,-87,-97,10,,266301413,28,2754,266301385,266301413
13049,5,24,149,5745,-87,-97,10,,266301864,28,423,266301836,266301864
13050,5,24,149,5745,-86,-97,11,,266301909,28,17,266301881,266301909
13051,5,24,149,5745,-89,-97,8,,266302173,28,236,266302145,266302173
13052,5,24,149,5745,-87,-97,10,,266302217,28,16,266302189,266302217
13053,5,24,149,5745,-87,-97,10,,266302326,32,77,266302294,266302326
13054,5,24,149,5745,-87,-97,10,,266304178,28,1824,266304150,266304178
13055,5,24,149,5745,-86,-97,11,,266304287,32,77,266304255,266304287
13056,5,12,149,5745,-67,-97,30,22:ec:75:a8:8a:31,266304389,244,-142,266304145,266304389
13057,5,12,149,5745,-87,-97,10,9a:24:38:da:96:bb,266305950,272,1289,266305678,266305950
13058,5,12,149,5745,-74,-97,23,3e:ef:29:c7:4b:17,266318204,244,12010,266317960,266318204
13059,5,12,149,5745,-62,-97,35,3e:d1:9b:c7:a4:de,266323767,272,5291,266323495,266323767
13060,5,6,149,5745,-86,-97,11,54:e4:3a:ec:fb:65,266326324,360,2197,266325964,266326324
13061,5,12,149,5745,-63,-97,34,f2:da:61:dd:98:c5,266327054,268,462,266326786,266327054
13062,5,12,149,5745,-66,-97,31,3a:de:b0:2e:cd:45,266327550,272,224,266327278,266327550
13063,5,12,149,5745,-59,-97,38,9e:1f:b0:a7:b8:90,266330190,256,2384,266329934,266330190
13064,5,12,149,5745,-57,-97,40,5e:29:73:5b:30:00,266344253,272,13791,266343981,266344253
13065,5,12,149,5745,-73,-97,24,d2:00:04:7e:2c:ab,266350387,244,5890,266350143,266350387
13066,5,12,149,5745,-73,-97,24,72:d1:72:1d:22:a1,266351916,284,1245,266351632,266351916
13067,5,12,149,5745,-71,-97,26,56:68:e2:c2:8d:d5,266352279,280,83,266351999,266352279
13068,5,12,149,5745,-67,-97,30,76:d6:6a:bb:b3:f5,266358282,272,5731,266358010,266358282
13069,5,12,149,5745,-61,-97,36,4a:ea:3c:f4:ce:b2,266367808,272,9254,266367536,266367808
13070,5,12,149,5745,-65,-97,32,3a:de:b0:2e:cd:45,266373962,272,5882,266373690,266373962
13071,5,12,149,5745,-61,-97,36,f2:da:61:dd:98:c5,266374296,268,66,266374028,266374296
13072,5,12,149,5745,-69,-97,28,b6:90:18:f6:b1:d4,266382261,272,7693,266381989,266382261
13073,5,12,149,5745,-72,-97,25,72:d1:72:1d:22:a1,266389970,284,7425,266389686,266389970
13074,5,12,149,5745,-72,-97,25,56:68:e2:c2:8d:d5,266409989,280,19739,266409709,266409989
13075,5,12,149,5745,-80,-97,17,9a:24:38:da:96:bb,266414432,272,4171,266414160,266414432
13076,5,12,149,5745,-73,-97,24,3e:ef:29:c7:4b:17,266422779,244,8103,266422535,266422779
13077,5,12,149,5745,-67,-97,30,f6:0a:5c:59:72:df,266423057,476,-198,266422581,266423057
13078,5,12,149,5745,-73,-97,24,d2:00:04:7e:2c:ab,266424954,244,1653,266424710,266424954
13079,5,12,149,5745,-72,-97,25,56:68:e2:c2:8d:d5,266428013,476,2583,266427537,266428013
13080,5,12,149,5745,-58,-97,39,9e:1f:b0:a7:b8:90,266428694,452,229,266428242,266428694
13081,5,12,149,5745,-67,-97,30,76:d6:6a:bb:b3:f5,266429443,468,281,266428975,266429443
13082,5,12,149,5745,-60,-97,37,3e:d1:9b:c7:a4:de,266429934,544,-53,266429390,266429934
13083,5,12,149,5745,-73,-97,24,72:d1:72:1d:22:a1,266430541,480,127,266430061,266430541
13084,5,12,149,5745,-73,-97,24,d2:00:04:7e:2c:ab,266435814,440,4833,266435374,266435814
13085,5,12,149,5745,-60,-97,37,4a:ea:3c:f4:ce:b2,266436415,468,133,266435947,266436415
13086,5,12,149,5745,-59,-97,38,5e:29:73:5b:30:00,266436953,540,-2,266436413,266436953
13087,5,12,149,5745,-74,-97,23,22:ec:75:a8:8a:31,266438728,244,1531,266438484,266438728
13088,5,12,149,5745,-64,-97,33,3a:de:b0:2e:cd:45,266439053,468,-143,266438585,266439053
13089,5,12,149,5745,-58,-97,39,9e:1f:b0:a7:b8:90,266439610,256,301,266439354,266439610
13090,5,12,149,5745,-73,-97,24,3e:ef:29:c7:4b:17,266443262,440,3212,266442822,266443262
13091,5,12,149,5745,-66,-97,31,0a:e1:ab:b3:c3:a6,266443925,468,195,266443457,266443925
13092,5,12,149,5745,-68,-97,29,b6:90:18:f6:b1:d4,266444895,468,502,266444427,266444895
13093,5,12,149,5745,-59,-97,38,f2:da:61:dd:98:c5,266445433,268,270,266445165,266445433
13094,5,12,149,5745,-67,-97,30,f6:0a:5c:59:72:df,266447872,280,2159,266447592,266447872
13095,5,12,149,5745,-60,-97,37,3e:d1:9b:c7:a4:de,266455458,272,7314,266455186,266455458
13096,5,12,149,5745,-67,-97,30,76:d6:6a:bb:b3:f5,266455802,272,72,266455530,266455802
13097,5,12,149,5745,-60,-97,37,4a:ea:3c:f4:ce:b2,266456949,272,875,266456677,266456949
13098,5,24,149,5745,-87,-97,10,,266465238,28,8261,266465210,266465238
13099,5,24,149,5745,-87,-97,10,,266465962,32,692,266465930,266465962
13100,5,12,149,5745,-64,-97,33,3a:de:b0:2e:cd:45,266471879,272,5645,266471607,266471879
13101,5,12,149,5745,-59,-97,38,f2:da:61:dd:98:c5,266472701,268,554,266472433,266472701
13102,5,12,149,5745,-60,-97,37,5e:29:73:5b:30:00,266473930,272,957,266473658,266473930
13103,5,12,149,5745,-68,-97,29,b6:90:18:f6:b1:d4,266487682,272,13480,266487410,266487682
13104,5,12,149,5745,-72,-97,25,72:d1:72:1d:22:a1,266487989,284,23,266487705,266487989
13105,5,12,149,5745,-69,-97,28,f6:0a:5c:59:72:df,266488324,476,-141,266487848,266488324
13106,5,12,149,5745,-72,-97,25,56:68:e2:c2:8d:d5,266491165,476,2365,266490689,266491165
13107,5,12,149,5745,-82,-97,15,9a:24:38:da:96:bb,266492549,824,560,266491725,266492549
13108,5,12,149,5745,-62,-97,35,0a:b9:b7:b1:4d:fa,266493424,468,407,266492956,266493424
13109,5,12,149,5745,-61,-97,36,9e:1f:b0:a7:b8:90,266493973,452,97,266493521,266493973
13110,5,12,149,5745,-62,-97,35,9e:1f:b0:a7:b8:90,266494504,380,151,266494124,266494504
13111,5,12,149,5745,-67,-97,30,76:d6:6a:bb:b3:f5,266494920,468,-52,266494452,266494920
13112,5,12,149,5745,-60,-97,37,3e:d1:9b:c7:a4:de,266495458,544,-6,266494914,266495458
13113,5,12,149,5745,-61,-97,36,9e:1f:b0:a7:b8:90,266496135,104,573,266496031,266496135
13114,5,12,149,5745,-72,-97,25,d2:00:04:7e:2c:ab,266499594,440,3019,266499154,266499594
13115,5,12,149,5745,-59,-97,38,4a:ea:3c:f4:ce:b2,266500806,468,744,266500338,266500806
13116,5,12,149,5745,-61,-97,36,5e:29:73:5b:30:00,266501965,540,619,266501425,266501965
13117,5,12,149,5745,-63,-97,34,3a:de:b0:2e:cd:45,266502559,468,126,266502091,266502559
13118,5,12,149,5745,-67,-97,30,0a:e1:ab:b3:c3:a6,266503115,360,196,266502755,266503115
13119,5,12,149,5745,-72,-97,25,56:68:e2:c2:8d:d5,266505280,280,1885,266505000,266505280
13120,5,12,149,5745,-73,-97,24,aa:b6:ae:27:64:4e,266506017,468,269,266505549,266506017
13121,5,12,149,5745,-71,-97,26,a6:92:ad:b7:76:65,266506939,484,438,266506455,266506939
13122,5,12,149,5745,-65,-97,32,0a:e1:ab:b3:c3:a6,266508490,468,1083,266508022,266508490
13123,5,12,149,5745,-67,-97,30,b6:90:18:f6:b1:d4,266509609,468,651,266509141,266509609
13124,5,12,149,5745,-71,-97,26,d2:00:04:7e:2c:ab,266522390,244,12537,266522146,266522390
13125,5,12,149,5745,-85,-97,12,9a:24:38:da:96:bb,266526547,272,3885,266526275,266526547
13126,5,6,149,5745,-86,-97,11,54:e4:3a:ec:fb:65,266531125,360,4218,266530765,266531125
13127,5,12,149,5745,-73,-97,24,22:ec:75:a8:8a:31,266537672,244,6303,266537428,266537672
13128,5,12,149,5745,-73,-97,24,3e:ef:29:c7:4b:17,266537999,244,83,266537755,266537999
13129,5,12,149,5745,-60,-97,37,3e:d1:9b:c7:a4:de,266549862,272,11591,266549590,266549862
13130,5,12,149,5745,-62,-97,35,9e:1f:b0:a7:b8:90,266565083,256,14965,266564827,266565083
13131,5,12,149,5745,-61,-97,36,5e:29:73:5b:30:00,266567710,540,2087,266567170,266567710
13132,5,12,149,5745,-67,-97,30,f6:0a:5c:59:72:df,266570175,280,2185,266569895,266570175
13133,5,12,149,5745,-72,-97,25,d2:00:04:7e:2c:ab,266570904,440,289,266570464,266570904
13134,5,12,149,5745,-67,-97,30,76:d6:6a:bb:b3:f5,266585756,272,14580,266585484,266585756
13135,5,12,149,5745,-61,-97,36,5e:29:73:5b:30:00,266588204,272,2176,266587932,266588204
13136,5,12,149,5745,-62,-97,35,f2:da:61:dd:98:c5,266592423,268,3951,266592155,266592423
13137,5,12,149,5745,-59,-97,38,3a:de:b0:2e:cd:45,266598869,272,6174,266598597,266598869
13138,5,12,149,5745,-62,-97,35,5e:29:73:5b:30:00,266632313,540,32904,266631773,266632313
13139,5,12,149,5745,-73,-97,24,56:68:e2:c2:8d:d5,266633131,280,538,266632851,266633131
13140,5,6,149,5745,-87,-97,10,54:e4:3a:ec:fb:65,266633526,360,35,266633166,266633526
13141,5,12,149,5745,-83,-97,14,9a:24:38:da:96:bb,266640090,272,6292,266639818,266640090
13142,5,12,149,5745,-71,-97,26,22:ec:75:a8:8a:31,266646156,244,5822,266645912,266646156
13143,5,12,149,5745,-75,-97,22,d2:00:04:7e:2c:ab,266647615,244,1215,266647371,266647615
13144,5,12,149,5745,-64,-97,33,b6:90:18:f6:b1:d4,266657982,272,10095,266657710,266657982
13145,5,12,149,5745,-73,-97,24,72:d1:72:1d:22:a1,266658290,284,24,266658006,266658290
13146,5,12,149,5745,-55,-97,42,3e:d1:9b:c7:a4:de,266666980,272,8418,266666708,266666980
13147,5,12,149,5745,-61,-97,36,5e:29:73:5b:30:00,266681087,272,13835,266680815,266681087
13148,5,12,149,5745,-67,-97,30,f6:0a:5c:59:72:df,266687964,280,6597,266687684,266687964
13149,5,12,149,5745,-59,-97,38,4a:ea:3c:f4:ce:b2,266697234,272,8998,266696962,266697234
13150,5,12,149,5745,-65,-97,32,0a:b9:b7:b1:4d:fa,266706072,468,8370,266705604,266706072
13151,5,24,149,5745,-88,-97,9,,266711637,28,5537,266711609,266711637
13152,5,12,149,5745,-75,-97,22,3e:ef:29:c7:4b:17,266711967,244,86,266711723,266711967
13153,5,24,149,5745,-91,-97,6,,266716997,28,5002,266716969,266716997
13154,5,24,149,5745,-89,-97,8,,266717106,32,77,266717074,266717106
13155,5,6,149,5745,-86,-97,11,54:e4:3a:ec:fb:65,266735926,360,18460,266735566,266735926
13156,5,12,149,5745,-58,-97,39,3a:de:b0:2e:cd:45,266736595,272,397,266736323,266736595
13157,5,12,149,5745,-65,-97,32,f2:da:61:dd:98:c5,266736973,268,110,266736705,266736973
13158,5,24,149,5745,-88,-97,9,,266737383,28,382,266737355,266737383
13159,5,24,149,5745,-89,-97,8,,266737491,32,76,266737459,266737491
13160,5,12,149,5745,-69,-97,28,76:d6:6a:bb:b3:f5,266738194,272,431,266737922,266738194
13161,5,12,149,5745,-62,-97,35,9e:1f:b0:a7:b8:90,266738598,256,148,266738342,266738598
13162,5,24,149,5745,-88,-97,9,,266756262,28,17636,266756234,266756262
13163,5,12,149,5745,-81,-97,16,9a:24:38:da:96:bb,266756555,272,21,266756283,266756555
13164,5,12,149,5745,-75,-97,22,d2:00:04:7e:2c:ab,266760018,244,3219,266759774,266760018
13165,5,12,149,5745,-77,-97,20,72:d1:72:1d:22:a1,266760306,284,4,266760022,266760306
13166,5,12,149,5745,-62,-97,35,b6:90:18:f6:b1:d4,266760647,272,69,266760375,266760647
13167,5,12,149,5745,-74,-97,23,56:68:e2:c2:8d:d5,266762006,280,1079,266761726,266762006
13168,5,12,149,5745,-72,-97,25,22:ec:75:a8:8a:31,266763178,244,928,266762934,266763178
13169,5,6,149,5745,-71,-97,26,,266779894,52,16664,266779842,266779894
13170,5,6,149,5745,-89,-97,8,,266779962,44,24,266779918,266779962
13171,5,24,149,5745,-89,-97,8,,266780080,28,90,266780052,266780080
13172,5,24,149,5745,-89,-97,8,,266783753,28,3645,266783725,266783753
13173,5,12,149,5745,-56,-97,41,3e:d1:9b:c7:a4:de,266784028,272,3,266783756,266784028
13174,5,6,149,5745,-70,-97,27,,266784397,52,317,266784345,266784397
13175,5,6,149,5745,-88,-97,9,,266784465,44,24,266784421,266784465
13176,5,24,149,5745,-89,-97,8,,266784583,28,90,266784555,266784583
13177,5,6,149,5745,-71,-97,26,,266784771,52,136,266784719,266784771
13178,5,6,149,5745,-89,-97,8,,266784839,44,24,266784795,266784839
13179,5,24,149,5745,-87,-97,10,,266784957,28,90,266784929,266784957
13180,5,6,149,5745,-71,-97,26,,266790080,52,5071,266790028,266790080
13181,5,6,149,5745,-89,-97,8,,266790148,44,24,266790104,266790148
13182,5,24,149,5745,-89,-97,8,,266790265,28,89,266790237,266790265
13183,5,6,149,5745,-70,-97,27,,266790473,52,156,266790421,266790473
13184,5,6,149,5745,-88,-97,9,,266790541,44,24,266790497,266790541
13185,5,24,149,5745,-88,-97,9,,266790658,28,89,266790630,266790658
13186,5,24,149,5745,-87,-97,10,,266795412,28,4726,266795384,266795412
13187,5,12,149,5745,-64,-97,33,5e:29:73:5b:30:00,266798081,272,2397,266797809,266798081
13188,5,12,149,5745,-77,-97,20,3e:ef:29:c7:4b:17,266817407,244,19082,266817163,266817407
13189,5,12,149,5745,-59,-97,38,0a:e1:ab:b3:c3:a6,266832661,272,14982,266832389,266832661
13190,5,6,149,5745,-87,-97,10,54:e4:3a:ec:fb:65,266838327,360,5306,266837967,266838327
13191,5,12,149,5745,-68,-97,29,76:d6:6a:bb:b3:f5,266838738,272,139,266838466,266838738
13192,5,12,149,5745,-59,-97,38,3a:de:b0:2e:cd:45,266839077,272,67,266838805,266839077
13193,5,12,149,5745,-62,-97,35,f2:da:61:dd:98:c5,266839437,268,92,266839169,266839437
13194,5,12,149,5745,-63,-97,34,9e:1f:b0:a7:b8:90,266841153,256,1460,266840897,266841153
13195,5,12,149,5745,-85,-97,12,9a:24:38:da:96:bb,266864740,272,23315,266864468,266864740
13196,5,12,149,5745,-62,-97,35,b6:90:18:f6:b1:d4,266865842,272,830,266865570,266865842
13197,5,12,149,5745,-77,-97,20,72:d1:72:1d:22:a1,266867482,284,1356,266867198,266867482
13198,5,12,149,5745,-73,-97,24,d2:00:04:7e:2c:ab,266868773,244,1047,266868529,266868773
13199,5,12,149,5745,-72,-97,25,56:68:e2:c2:8d:d5,266870411,280,1358,266870131,266870411
13200,5,12,149,5745,-61,-97,36,9e:1f:b0:a7:b8:90,266880956,256,10289,266880700,266880956
13201,5,12,149,5745,-75,-97,22,3e:ef:29:c7:4b:17,266881866,244,666,266881622,266881866
13202,5,12,149,5745,-66,-97,31,f6:0a:5c:59:72:df,266884115,476,1773,266883639,266884115
13203,5,12,149,5745,-62,-97,35,0a:e1:ab:b3:c3:a6,266885444,468,861,266884976,266885444
13204,5,12,149,5745,-60,-97,37,9e:1f:b0:a7:b8:90,266885948,452,52,266885496,266885948
13205,5,12,149,5745,-85,-97,12,9a:24:38:da:96:bb,266886462,824,-310,266885638,266886462
13206,5,12,149,5745,-63,-97,34,b6:90:18:f6:b1:d4,266887365,468,435,266886897,266887365
13207,5,12,149,5745,-56,-97,41,3e:d1:9b:c7:a4:de,266891325,544,3416,266890781,266891325
13208,5,12,149,5745,-67,-97,30,76:d6:6a:bb:b3:f5,266891959,468,166,266891491,266891959
13209,5,12,149,5745,-58,-97,39,3a:de:b0:2e:cd:45,266895630,468,3203,266895162,266895630
13210,5,12,149,5745,-59,-97,38,4a:ea:3c:f4:ce:b2,266896241,468,143,266895773,266896241
13211,5,12,149,5745,-69,-97,28,22:ec:75:a8:8a:31,266897228,244,743,266896984,266897228
13212,5,12,149,5745,-65,-97,32,f2:da:61:dd:98:c5,266898379,268,883,266898111,266898379
13213,5,12,149,5745,-76,-97,21,72:d1:72:1d:22:a1,266900985,480,2126,266900505,266900985
13214,5,12,149,5745,-66,-97,31,f6:0a:5c:59:72:df,266902453,280,1188,266902173,266902453
13215,5,12,149,5745,-75,-97,22,3e:ef:29:c7:4b:17,266903116,440,223,266902676,266903116
13216,5,12,149,5745,-68,-97,29,22:ec:75:a8:8a:31,266907064,516,3432,266906548,266907064
13217,5,12,149,5745,-59,-97,38,4a:ea:3c:f4:ce:b2,266907624,272,288,266907352,266907624
13218,5,12,149,5745,-66,-97,31,5e:29:73:5b:30:00,266909172,540,1008,266908632,266909172
13219,5,12,149,5745,-65,-97,32,76:d6:6a:bb:b3:f5,266914677,272,5233,266914405,266914677
13220,5,12,149,5745,-57,-97,40,3e:d1:9b:c7:a4:de,266915028,272,79,266914756,266915028
13221,5,12,149,5745,-64,-97,33,b6:90:18:f6:b1:d4,266930298,272,14998,266930026,266930298
13222,5,12,149,5745,-58,-97,39,3a:de:b0:2e:cd:45,266930606,272,36,266930334,266930606
13223,5,12,149,5745,-66,-97,31,f2:da:61:dd:98:c5,266932316,268,1442,266932048,266932316
13224,5,12,149,5745,-68,-97,29,0a:e1:ab:b3:c3:a6,266932844,272,256,266932572,266932844
13225,5,12,149,5745,-63,-97,34,5e:29:73:5b:30:00,266933178,272,62,266932906,266933178
13226,5,24,149,5745,-91,-97,6,,266938100,28,4894,266938072,266938100
13227,5,24,149,5745,-88,-97,9,,266938145,28,17,266938117,266938145
13228,5,6,149,5745,-87,-97,10,54:e4:3a:ec:fb:65,266940728,360,2223,266940368,266940728
13229,5,12,149,5745,-68,-97,29,f6:0a:5c:59:72:df,266948660,476,7456,266948184,266948660
13230,5,12,149,5745,-65,-97,32,0a:e1:ab:b3:c3:a6,266949178,468,50,266948710,266949178
13231,5,12,149,5745,-59,-97,38,9e:1f:b0:a7:b8:90,266950681,484,1019,266950197,266950681
13232,5,12,149,5745,-67,-97,30,76:d6:6a:bb:b3:f5,266956997,468,5848,266956529,266956997
13233,5,12,149,5745,-59,-97,38,4a:ea:3c:f4:ce:b2,266958228,468,763,266957760,266958228
13234,5,12,149,5745,-57,-97,40,3a:de:b0:2e:cd:45,266961108,468,2412,266960640,266961108
13235,5,12,149,5745,-74,-97,23,72:d1:72:1d:22:a1,266965326,284,3934,266965042,266965326
13236,5,12,149,5745,-71,-97,26,56:68:e2:c2:8d:d5,266967219,280,1613,266966939,266967219
13237,5,12,149,5745,-68,-97,29,22:ec:75:a8:8a:31,266969874,516,2139,266969358,266969874
13238,5,12,149,5745,-69,-97,28,22:ec:75:a8:8a:31,266995848,244,25730,266995604,266995848
13239,5,12,149,5745,-57,-97,40,9e:1f:b0:a7:b8:90,266997058,288,922,266996770,266997058
13240,5,12,149,5745,-75,-97,22,3e:ef:29:c7:4b:17,267012617,272,15287,267012345,267012617
13241,5,12,149,5745,-57,-97,40,9e:1f:b0:a7:b8:90,267014183,484,1082,267013699,267014183
13242,5,12,149,5745,-68,-97,29,f6:0a:5c:59:72:df,267014992,476,333,267014516,267014992
13243,5,12,149,5745,-68,-97,29,f6:0a:5c:59:72:df,267015485,280,213,267015205,267015485
13244,5,12,149,5745,-65,-97,32,0a:e1:ab:b3:c3:a6,267016059,468,106,267015591,267016059
13245,5,12,149,5745,-66,-97,31,b6:90:18:f6:b1:d4,267016861,468,334,267016393,267016861
13246,5,12,149,5745,-70,-97,27,d2:00:04:7e:2c:ab,267017512,440,211,267017072,267017512
13247,5,12,149,5745,-61,-97,36,3a:de:b0:2e:cd:45,267018440,468,460,267017972,267018440
13248,5,12,149,5745,-63,-97,34,4a:ea:3c:f4:ce:b2,267022057,468,3149,267021589,267022057
13249,5,12,149,5745,-66,-97,31,76:d6:6a:bb:b3:f5,267022560,468,35,267022092,267022560
13250,5,12,149,5745,-57,-97,40,3e:d1:9b:c7:a4:de,267023161,544,57,267022617,267023161
13251,5,24,149,5745,-90,-97,7,,267027253,28,4064,267027225,267027253
13252,5,12,149,5745,-55,-97,42,3e:d1:9b:c7:a4:de,267028920,272,1395,267028648,267028920
13253,5,24,149,5745,-89,-97,8,,267029274,28,326,267029246,267029274
13254,5,12,149,5745,-62,-97,35,5e:29:73:5b:30:00,267030441,272,895,267030169,267030441
13255,5,12,149,5745,-66,-97,31,0a:e1:ab:b3:c3:a6,267030749,272,36,267030477,267030749
13256,5,12,149,5745,-65,-97,32,f2:da:61:dd:98:c5,267031056,268,39,267030788,267031056
13257,5,12,149,5745,-73,-97,24,aa:b6:ae:27:64:4e,267032123,468,599,267031655,267032123
13258,5,12,149,5745,-67,-97,30,a6:92:ad:b7:76:65,267033876,484,1269,267033392,267033876
13259,5,12,149,5745,-66,-97,31,0a:b9:b7:b1:4d:fa,267034539,468,195,267034071,267034539
13260,5,12,149,5745,-71,-97,26,22:ec:75:a8:8a:31,267035051,516,-4,267034535,267035051
13261,5,24,149,5745,-89,-97,8,,267035726,28,647,267035698,267035726
13262,5,24,149,5745,-89,-97,8,,267035834,32,76,267035802,267035834
13263,5,12,149,5745,-61,-97,36,5e:29:73:5b:30:00,267039757,540,3383,267039217,267039757
13264,5,6,149,5745,-86,-97,11,54:e4:3a:ec:fb:65,267043128,360,3011,267042768,267043128
13265,5,24,149,5745,-89,-97,8,,267043670,28,514,267043642,267043670
13266,5,24,149,5745,-89,-97,8,,267044008,28,310,267043980,267044008
13267,5,12,149,5745,-66,-97,31,b6:90:18:f6:b1:d4,267044326,272,46,267044054,267044326
13268,5,12,149,5745,-61,-97,36,3a:de:b0:2e:cd:45,267045138,272,540,267044866,267045138
13269,5,12,149,5745,-66,-97,31,f2:da:61:dd:98:c5,267045858,268,452,267045590,267045858
13270,5,24,149,5745,-89,-97,8,,267047101,32,1211,267047069,267047101
13271,5,6,149,5745,-76,-97,21,,267051339,52,4186,267051287,267051339
13272,5,6,149,5745,-89,-97,8,,267051407,44,24,267051363,267051407
13273,5,12,149,5745,-63,-97,34,4a:ea:3c:f4:ce:b2,267053570,272,1891,267053298,267053570
13274,5,12,149,5745,-84,-97,13,9a:24:38:da:96:bb,267056343,272,2501,267056071,267056343
13275,5,24,149,5745,-88,-97,9,,267068071,28,11700,267068043,267068071
13276,5,24,149,5745,-89,-97,8,,267070616,28,2517,267070588,267070616
13277,5,24,149,5745,-89,-97,8,,267070660,28,16,267070632,267070660
13278,5,24,149,5745,-88,-97,9,,267075095,28,4407,267075067,267075095
13279,5,24,149,5745,-89,-97,8,,267075251,32,124,267075219,267075251
13280,5,12,149,5745,-75,-97,22,72:d1:72:1d:22:a1,267083893,284,8358,267083609,267083893
13281,5,12,149,5745,-70,-97,27,56:68:e2:c2:8d:d5,267085867,280,1694,267085587,267085867
13282,5,24,149,5745,-90,-97,7,,267089428,28,3533,267089400,267089428
13283,5,24,149,5745,-90,-97,7,,267091417,28,1961,267091389,267091417
13284,5,24,149,5745,-88,-97,9,,267091461,28,16,267091433,267091461
13285,5,12,149,5745,-66,-97,31,22:ec:75:a8:8a:31,267101068,516,9091,267100552,267101068
13286,5,12,149,5745,-66,-97,31,22:ec:75:a8:8a:31,267110204,244,8892,267109960,267110204
13287,5,12,149,5745,-58,-97,39,9e:1f:b0:a7:b8:90,267123744,288,13252,267123456,267123744
13288,5,12,149,5745,-53,-97,44,3e:d1:9b:c7:a4:de,267125110,272,1094,267124838,267125110
13289,5,12,149,5745,-75,-97,22,3e:ef:29:c7:4b:17,267126120,272,738,267125848,267126120
13290,5,12,149,5745,-63,-97,34,5e:29:73:5b:30:00,267136407,272,10015,267136135,267136407
13291,5,24,149,5745,-89,-97,8,,267142231,28,5796,267142203,267142231
13292,5,6,149,5745,-85,-97,12,54:e4:3a:ec:fb:65,267145528,360,2937,267145168,267145528
13293,5,12,149,5745,-65,-97,32,0a:e1:ab:b3:c3:a6,267152477,272,6677,267152205,267152477
13294,5,12,149,5745,-62,-97,35,76:d6:6a:bb:b3:f5,267153253,272,504,267152981,267153253
13295,5,12,149,5745,-62,-97,35,3a:de:b0:2e:cd:45,267158563,272,5038,267158291,267158563
13296,5,24,149,5745,-88,-97,9,,267159848,28,1257,267159820,267159848
13297,5,24,149,5745,-88,-97,9,,267159892,28,16,267159864,267159892
13298,5,12,149,5745,-65,-97,32,f6:0a:5c:59:72:df,267160833,280,661,267160553,267160833
13299,5,12,149,5745,-69,-97,28,22:ec:75:a8:8a:31,267166438,516,5089,267165922,267166438
13300,5,12,149,5745,-83,-97,14,9a:24:38:da:96:bb,267169455,272,2745,267169183,267169455
13301,5,12,149,5745,-61,-97,36,b6:90:18:f6:b1:d4,267170907,272,1180,267170635,267170907
13302,5,12,149,5745,-75,-97,22,72:d1:72:1d:22:a1,267186160,284,14969,267185876,267186160
13303,5,12,149,5745,-67,-97,30,22:ec:75:a8:8a:31,267224979,244,38575,267224735,267224979
13304,5,12,149,5745,-64,-97,33,0a:b9:b7:b1:4d:fa,267230315,468,4868,267229847,267230315
13305,5,12,149,5745,-67,-97,30,22:ec:75:a8:8a:31,267232033,516,1202,267231517,267232033
13306,5,12,149,5745,-74,-97,23,3e:ef:29:c7:4b:17,267235550,272,3245,267235278,267235550
13307,5,12,149,5745,-52,-97,45,3e:d1:9b:c7:a4:de,267241180,272,5358,267240908,267241180
13308,5,6,149,5745,-87,-97,10,54:e4:3a:ec:fb:65,267247929,360,6389,267247569,267247929
13309,5,12,149,5745,-65,-97,32,f2:da:61:dd:98:c5,267249401,268,1204,267249133,267249401
13310,5,12,149,5745,-58,-97,39,9e:1f:b0:a7:b8:90,267250572,288,883,267250284,267250572
13311,5,12,149,5745,-65,-97,32,5e:29:73:5b:30:00,267253500,272,2656,267253228,267253500
13312,5,12,149,5745,-59,-97,38,76:d6:6a:bb:b3:f5,267260474,272,6702,267260202,267260474
13313,5,12,149,5745,-69,-97,28,56:68:e2:c2:8d:d5,267274657,280,13903,267274377,267274657
13314,5,12,149,5745,-64,-97,33,b6:90:18:f6:b1:d4,267283740,272,8811,267283468,267283740
13315,5,12,149,5745,-80,-97,17,9a:24:38:da:96:bb,267284730,272,718,267284458,267284730
13316,5,12,149,5745,-60,-97,37,4a:ea:3c:f4:ce:b2,267293149,272,8147,267292877,267293149
13317,5,24,149,5745,-86,-97,11,,267294930,28,1753,267294902,267294930
13318,5,24,149,5745,-87,-97,10,,267295038,32,76,267295006,267295038
13319,5,24,149,5745,-86,-97,11,,267303124,32,8054,267303092,267303124
13320,5,24,149,5745,-85,-97,12,,267312959,28,9807,267312931,267312959
13321,5,24,149,5745,-86,-97,11,,267313003,28,16,267312975,267313003
13322,5,24,149,5745,-85,-97,12,,267316729,28,3698,267316701,267316729
13323,5,24,149,5745,-84,-97,13,,267316776,28,19,267316748,267316776
13324,5,24,149,5745,-84,-97,13,,267316885,32,77,267316853,267316885
13325,5,12,149,5745,-70,-97,27,22:ec:75:a8:8a:31,267328555,244,11426,267328311,267328555
13326,5,12,149,5745,-63,-97,34,0a:e1:ab:b3:c3:a6,267344884,272,16057,267344612,267344884
13327,5,12,149,5745,-63,-97,34,f2:da:61:dd:98:c5,267350259,268,5107,267349991,267350259
13328,5,6,149,5745,-85,-97,12,54:e4:3a:ec:fb:65,267350636,360,17,267350276,267350636
13329,5,12,149,5745,-65,-97,32,3a:de:b0:2e:cd:45,267351568,272,660,267351296,267351568
13330,5,12,149,5745,-56,-97,41,9e:1f:b0:a7:b8:90,267353035,288,1179,267352747,267353035
13331,5,12,149,5745,-59,-97,38,3e:d1:9b:c7:a4:de,267357669,272,4362,267357397,267357669
13332,5,12,149,5745,-59,-97,38,5e:29:73:5b:30:00,267367118,272,9177,267366846,267367118
13333,5,24,149,5745,-85,-97,12,,267368295,28,1149,267368267,267368295
13334,5,24,149,5745,-86,-97,11,,267368403,32,76,267368371,267368403
13335,5,12,149,5745,-71,-97,26,72:d1:72:1d:22:a1,267375355,284,6668,267375071,267375355
13336,5,12,149,5745,-70,-97,27,56:68:e2:c2:8d:d5,267377734,280,2099,267377454,267377734
13337,5,24,149,5745,-85,-97,12,,267386383,28,8621,267386355,267386383
13338,5,12,149,5745,-64,-97,33,b6:90:18:f6:b1:d4,267406247,272,19592,267405975,267406247
13339,5,12,149,5745,-72,-97,25,72:d1:72:1d:22:a1,267413557,284,7026,267413273,267413557
13340,5,12,149,5745,-60,-97,37,4a:ea:3c:f4:ce:b2,267416468,272,2639,267416196,267416468
13341,5,12,149,5745,-60,-97,37,4a:ea:3c:f4:ce:b2,267416758,468,-178,267416290,267416758
13342,5,12,149,5745,-72,-97,25,56:68:e2:c2:8d:d5,267423380,280,6342,267423100,267423380
13343,5,12,149,5745,-76,-97,21,3e:ef:29:c7:4b:17,267427125,272,3473,267426853,267427125
13344,5,24,149,5745,-86,-97,11,,267428696,32,1539,267428664,267428696
13345,5,24,149,5745,-86,-97,11,,267429150,32,422,267429118,267429150
13346,5,24,149,5745,-86,-97,11,,267429604,28,426,267429576,267429604
13347,5,24,149,5745,-88,-97,9,,267429650,28,18,267429622,267429650
13348,5,24,149,5745,-89,-97,8,,267429759,32,77,267429727,267429759
13349,5,6,149,5745,-68,-97,29,f4:26:79:6c:3e:23,267432377,220,2398,267432157,267432377
13350,5,6,149,5745,-86,-97,11,54:e4:3a:ec:fb:65,267432753,352,24,267432401,267432753
13351,5,6,149,5745,-86,-97,11,54:e4:3a:ec:fb:65,267433329,352,224,267432977,267433329
13352,5,6,149,5745,-86,-97,11,54:e4:3a:ec:fb:65,267434232,352,551,267433880,267434232
13353,5,6,149,5745,-85,-97,12,54:e4:3a:ec:fb:65,267435150,352,566,267434798,267435150
13354,5,12,149,5745,-67,-97,30,22:ec:75:a8:8a:31,267441025,244,5631,267440781,267441025
13355,5,6,149,5745,-87,-97,10,54:e4:3a:ec:fb:65,267442120,352,743,267441768,267442120
13356,5,12,149,5745,-76,-97,21,3e:ef:29:c7:4b:17,267446012,272,3620,267445740,267446012
13357,5,12,149,5745,-62,-97,35,0a:e1:ab:b3:c3:a6,267447748,272,1464,267447476,267447748
13358,5,6,149,5745,-66,-97,31,f4:26:79:6c:3e:23,267448102,220,134,267447882,267448102
13359,5,6,149,5745,-86,-97,11,54:e4:3a:ec:fb:65,267448505,352,51,267448153,267448505
13360,5,6,149,5745,-87,-97,10,54:e4:3a:ec:fb:65,267448954,352,97,267448602,267448954
13361,5,6,149,5745,-87,-97,10,54:e4:3a:ec:fb:65,267449629,352,323,267449277,267449629
13362,5,6,149,5745,-86,-97,11,54:e4:3a:ec:fb:65,267450348,352,367,267449996,267450348
13363,5,6,149,5745,-86,-97,11,54:e4:3a:ec:fb:65,267452730,360,2022,267452370,267452730
13364,5,6,149,5745,-87,-97,10,54:e4:3a:ec:fb:65,267453125,352,43,267452773,267453125
13365,5,12,149,5745,-63,-97,34,76:d6:6a:bb:b3:f5,267455851,272,2454,267455579,267455851
13366,5,12,149,5745,-65,-97,32,3a:de:b0:2e:cd:45,267456267,272,144,267455995,267456267
13367,5,12,149,5745,-64,-97,33,f2:da:61:dd:98:c5,267457419,268,884,267457151,267457419
13368,5,12,149,5745,-57,-97,40,9e:1f:b0:a7:b8:90,267458993,288,1286,267458705,267458993
13369,5,12,149,5745,-67,-97,30,f6:0a:5c:59:72:df,267469010,280,9737,267468730,267469010
13370,5,12,149,5745,-67,-97,30,f6:0a:5c:59:72:df,267473594,476,4108,267473118,267473594
13371,5,12,149,5745,-62,-97,35,0a:e1:ab:b3:c3:a6,267475085,468,1023,267474617,267475085
13372,5,12,149,5745,-57,-97,40,9e:1f:b0:a7:b8:90,267475967,484,398,267475483,267475967
13373,5,12,149,5745,-64,-97,33,b6:90:18:f6:b1:d4,267477862,468,1427,267477394,267477862
13374,5,12,149,5745,-64,-97,33,3a:de:b0:2e:cd:45,267478488,468,158,267478020,267478488
13375,5,12,149,5745,-60,-97,37,3e:d1:9b:c7:a4:de,267479629,544,597,267479085,267479629
13376,5,12,149,5745,-76,-97,21,3e:ef:29:c7:4b:17,267480207,468,110,267479739,267480207
13377,5,12,149,5745,-63,-97,34,76:d6:6a:bb:b3:f5,267481339,468,664,267480871,267481339
13378,5,12,149,5745,-61,-97,36,4a:ea:3c:f4:ce:b2,267481940,468,133,267481472,267481940
13379,5,12,149,5745,-73,-97,24,56:68:e2:c2:8d:d5,267485000,476,2584,267484524,267485000
13380,5,12,149,5745,-65,-97,32,3a:de:b0:2e:cd:45,267487321,272,2049,267487049,267487321
13381,5,12,149,5745,-60,-97,37,3e:d1:9b:c7:a4:de,267487672,272,79,267487400,267487672
13382,5,12,149,5745,-61,-97,36,76:d6:6a:bb:b3:f5,267487979,272,35,267487707,267487979
13383,5,12,149,5745,-59,-97,38,5e:29:73:5b:30:00,267489287,272,1036,267489015,267489287
13384,5,12,149,5745,-64,-97,33,f2:da:61:dd:98:c5,267489595,268,40,267489327,267489595
13385,5,12,149,5745,-62,-97,35,0a:e1:ab:b3:c3:a6,267489916,272,49,267489644,267489916
13386,5,12,149,5745,-70,-97,27,72:d1:72:1d:22:a1,267491392,480,996,267490912,267491392
13387,5,12,149,5745,-67,-97,30,22:ec:75:a8:8a:31,267495000,516,3092,267494484,267495000
13388,5,12,149,5745,-58,-97,39,5e:29:73:5b:30:00,267496422,540,882,267495882,267496422
13389,5,12,149,5745,-64,-97,33,f2:da:61:dd:98:c5,267504500,268,7810,267504232,267504500
13390,5,12,149,5745,-83,-97,14,9a:24:38:da:96:bb,267505197,272,425,267504925,267505197
13391,5,24,149,5745,-86,-97,11,,267514072,28,8847,267514044,267514072
13392,5,24,149,5745,-85,-97,12,,267514767,32,663,267514735,267514767
13393,5,24,149,5745,-85,-97,12,,267520494,28,5699,267520466,267520494
13394,5,24,149,5745,-86,-97,11,,267520538,28,16,267520510,267520538
13395,5,24,149,5745,-85,-97,12,,267520647,32,77,267520615,267520647
13396,5,12,149,5745,-72,-97,25,56:68:e2:c2:8d:d5,267521577,280,650,267521297,267521577
13397,5,12,149,5745,-70,-97,27,72:d1:72:1d:22:a1,267523926,284,2065,267523642,267523926
13398,5,12,149,5745,-70,-97,27,f6:0a:5c:59:72:df,267538495,476,14093,267538019,267538495
13399,5,24,149,5745,-86,-97,11,,267539032,28,509,267539004,267539032
13400,5,24,149,5745,-86,-97,11,,267539076,28,16,267539048,267539076
13401,5,12,149,5745,-64,-97,33,0a:e1:ab:b3:c3:a6,267539734,468,190,267539266,267539734
13402,5,12,149,5745,-59,-97,38,9e:1f:b0:a7:b8:90,267540337,484,119,267539853,267540337
13403,5,12,149,5745,-63,-97,34,b6:90:18:f6:b1:d4,267541480,468,675,267541012,267541480
13404,5,12,149,5745,-64,-97,33,3a:de:b0:2e:cd:45,267542911,468,963,267542443,267542911
13405,5,12,149,5745,-76,-97,21,3e:ef:29:c7:4b:17,267544772,468,1393,267544304,267544772
13406,5,12,149,5745,-61,-97,36,3e:d1:9b:c7:a4:de,267545328,544,12,267544784,267545328
13407,5,12,149,5745,-61,-97,36,76:d6:6a:bb:b3:f5,267547005,468,1209,267546537,267547005
13408,5,12,149,5745,-72,-97,25,aa:b6:ae:27:64:4e,267547579,360,214,267547219,267547579
13409,5,12,149,5745,-71,-97,26,56:68:e2:c2:8d:d5,267547983,476,-72,267547507,267547983
13410,5,12,149,5745,-72,-97,25,d2:00:04:7e:2c:ab,267548504,412,109,267548092,267548504
13411,5,12,149,5745,-61,-97,36,76:d6:6a:bb:b3:f5,267548987,380,103,267548607,267548987
13412,5,12,149,5745,-64,-97,33,0a:b9:b7:b1:4d:fa,267550604,360,1257,267550244,267550604
13413,5,12,149,5745,-64,-97,33,4a:ea:3c:f4:ce:b2,267551226,364,258,267550862,267551226
13414,5,12,149,5745,-62,-97,35,f2:da:61:dd:98:c5,267553714,268,2220,267553446,267553714
13415,5,6,149,5745,-85,-97,12,54:e4:3a:ec:fb:65,267555131,360,1057,267554771,267555131
13416,5,12,149,5745,-73,-97,24,aa:b6:ae:27:64:4e,267555482,468,-117,267555014,267555482
13417,5,12,149,5745,-69,-97,28,72:d1:72:1d:22:a1,267557453,480,1491,267556973,267557453
13418,5,12,149,5745,-64,-97,33,0a:b9:b7:b1:4d:fa,267557956,468,35,267557488,267557956
13419,5,12,149,5745,-74,-97,23,a6:92:ad:b7:76:65,267558954,484,514,267558470,267558954
13420,5,12,149,5745,-68,-97,29,22:ec:75:a8:8a:31,267559491,516,21,267558975,267559491
13421,5,12,149,5745,-84,-97,13,9a:24:38:da:96:bb,267560059,824,-256,267559235,267560059
13422,5,12,149,5745,-72,-97,25,d2:00:04:7e:2c:ab,267561815,152,1604,267561663,267561815
13423,5,12,149,5745,-60,-97,37,5e:29:73:5b:30:00,267562002,540,-353,267561462,267562002
13424,5,12,149,5745,-68,-97,29,22:ec:75:a8:8a:31,267568949,244,6703,267568705,267568949
13425,5,12,149,5745,-76,-97,21,3e:ef:29:c7:4b:17,267569825,272,604,267569553,267569825
13426,5,12,149,5745,-58,-97,39,9e:1f:b0:a7:b8:90,267571112,288,999,267570824,267571112
13427,5,12,149,5745,-70,-97,27,f6:0a:5c:59:72:df,267580688,280,9296,267580408,267580688
13428,5,12,149,5745,-59,-97,38,3e:d1:9b:c7:a4:de,267586880,272,5920,267586608,267586880
13429,5,12,149,5745,-62,-97,35,5e:29:73:5b:30:00,267593749,272,6597,267593477,267593749
13430,5,24,149,5745,-87,-97,10,,267594940,28,1163,267594912,267594940
13431,5,24,149,5745,-86,-97,11,,267594984,28,16,267594956,267594984
13432,5,24,149,5745,-87,-97,10,,267595092,32,76,267595060,267595092
13433,5,24,149,5745,-86,-97,11,,267612712,28,17592,267612684,267612712
13434,5,24,149,5745,-87,-97,10,,267612756,28,16,267612728,267612756
13435,5,24,149,5745,-87,-97,10,,267612864,32,76,267612832,267612864
13436,5,12,149,5745,-64,-97,33,76:d6:6a:bb:b3:f5,267613389,272,253,267613117,267613389
13437,5,12,149,5745,-65,-97,32,0a:e1:ab:b3:c3:a6,267615608,272,1947,267615336,267615608
13438,5,12,149,5745,-63,-97,34,3a:de:b0:2e:cd:45,267616823,272,943,267616551,267616823
13439,5,12,149,5745,-86,-97,11,9a:24:38:da:96:bb,267618138,272,1043,267617866,267618138
13440,5,12,149,5745,-64,-97,33,f2:da:61:dd:98:c5,267620023,268,1617,267619755,267620023
13441,5,12,149,5745,-62,-97,35,b6:90:18:f6:b1:d4,267622248,272,1953,267621976,267622248
13442,5,12,149,5745,-69,-97,28,22:ec:75:a8:8a:31,267625290,516,2526,267624774,267625290
13443,5,24,149,5745,-86,-97,11,,267633606,32,8284,267633574,267633606
13444,5,24,149,5745,-75,-97,22,66:48:51:4e:71:fa,267633723,328,-211,267633395,267633723
13445,5,24,149,5745,-87,-97,10,,267634149,28,398,267634121,267634149
13446,5,24,149,5745,-76,-97,21,,267634192,28,15,267634164,267634192
13447,5,24,149,5745,-76,-97,21,,267634304,32,80,267634272,267634304
13448,5,24,149,5745,-76,-97,21,,267635243,28,911,267635215,267635243
13449,5,24,149,5745,-87,-97,10,,267635287,28,16,267635259,267635287
13450,5,24,149,5745,-87,-97,10,,267635399,32,80,267635367,267635399
13451,5,24,149,5745,-76,-97,21,,267635739,28,312,267635711,267635739
13452,5,24,149,5745,-76,-97,21,,267635892,28,125,267635864,267635892
13453,5,24,149,5745,-75,-97,22,,267636162,28,242,267636134,267636162
13454,5,24,149,5745,-88,-97,9,,267636206,28,16,267636178,267636206
13455,5,24,149,5745,-88,-97,9,,267636314,32,76,267636282,267636314
13456,5,12,149,5745,-73,-97,24,72:d1:72:1d:22:a1,267638318,284,1720,267638034,267638318
13457,5,12,149,5745,-72,-97,25,56:68:e2:c2:8d:d5,267646396,280,7798,267646116,267646396
13458,5,6,149,5745,-87,-97,10,54:e4:3a:ec:fb:65,267657531,360,10775,267657171,267657531
13459,5,12,149,5745,-68,-97,29,22:ec:75:a8:8a:31,267683626,244,25851,267683382,267683626
13460,5,12,149,5745,-69,-97,28,22:ec:75:a8:8a:31,267690267,516,6125,267689751,267690267
13461,5,24,149,5745,-87,-97,10,,267695021,32,4722,267694989,267695021
13462,5,24,149,5745,-75,-97,22,66:48:51:4e:71:fa,267695138,328,-211,267694810,267695138
13463,5,24,149,5745,-75,-97,22,,267695670,28,504,267695642,267695670
13464,5,24,149,5745,-75,-97,22,,267695777,32,75,267695745,267695777
13465,5,24,149,5745,-75,-97,22,,267696429,28,624,267696401,267696429
13466,5,24,149,5745,-88,-97,9,,267696473,28,16,267696445,267696473
13467,5,24,149,5745,-89,-97,8,,267696581,32,76,267696549,267696581
13468,5,12,149,5745,-57,-97,40,3e:d1:9b:c7:a4:de,267699982,272,3129,267699710,267699982
13469,5,12,149,5745,-63,-97,34,5e:29:73:5b:30:00,267710719,272,10465,267710447,267710719
13470,5,12,149,5745,-81,-97,16,9a:24:38:da:96:bb,267733960,272,22969,267733688,267733960
13471,5,12,149,5745,-75,-97,22,3e:ef:29:c7:4b:17,267735995,272,1763,267735723,267735995
13472,5,24,149,5745,-86,-97,11,,267744410,28,8387,267744382,267744410
13473,5,24,149,5745,-88,-97,9,,267744454,28,16,267744426,267744454
13474,5,24,149,5745,-87,-97,10,,267744562,32,76,267744530,267744562
13475,5,12,149,5745,-62,-97,35,4a:ea:3c:f4:ce:b2,267744945,272,111,267744673,267744945
13476,5,12,149,5745,-66,-97,31,0a:e1:ab:b3:c3:a6,267754420,272,9203,267754148,267754420
13477,5,12,149,5745,-66,-97,31,0a:b9:b7:b1:4d:fa,267754744,468,-144,267754276,267754744
13478,5,24,149,5745,-88,-97,9,,267757533,32,2757,267757501,267757533
13479,5,24,149,5745,-77,-97,20,66:48:51:4e:71:fa,267757650,328,-211,267757322,267757650
13480,5,24,149,5745,-87,-97,10,,267758031,28,353,267758003,267758031
13481,5,24,149,5745,-78,-97,19,,267758074,28,15,267758046,267758074
13482,5,24,149,5745,-78,-97,19,,267758182,32,76,267758150,267758182
13483,5,12,149,5745,-62,-97,35,76:d6:6a:bb:b3:f5,267759776,272,1322,267759504,267759776
13484,5,12,149,5745,-62,-97,35,9e:1f:b0:a7:b8:90,267760165,288,101,267759877,267760165
13485,5,12,149,5745,-60,-97,37,3a:de:b0:2e:cd:45,267760533,272,96,267760261,267760533
13486,5,12,149,5745,-66,-97,31,f2:da:61:dd:98:c5,267760938,268,137,267760670,267760938
13487,5,24,149,5745,-87,-97,10,,267762456,28,1490,267762428,267762456
13488,5,24,149,5745,-87,-97,10,,267762500,28,16,267762472,267762500
13489,5,12,149,5745,-68,-97,29,22:ec:75:a8:8a:31,267777038,244,14294,267776794,267777038
13490,5,12,149,5745,-65,-97,32,fa:44:8d:e1:c7:1b,267784346,244,7064,267784102,267784346
13491,5,12,149,5745,-72,-97,25,72:d1:72:1d:22:a1,267785184,284,554,267784900,267785184
13492,5,12,149,5745,-71,-97,26,56:68:e2:c2:8d:d5,267786040,280,576,267785760,267786040
13493,5,12,149,5745,-63,-97,34,b6:90:18:f6:b1:d4,267786461,272,149,267786189,267786461
13494,5,24,149,5745,-88,-97,9,,267799177,32,12684,267799145,267799177
13495,5,24,149,5745,-89,-97,8,,267799629,32,420,267799597,267799629
13496,5,12,149,5745,-57,-97,40,3e:d1:9b:c7:a4:de,267812783,272,12882,267812511,267812783
13497,5,24,149,5745,-89,-97,8,,267816804,28,3993,267816776,267816804
13498,5,12,149,5745,-71,-97,26,f6:0a:5c:59:72:df,267817404,280,320,267817124,267817404
13499,5,24,149,5745,-89,-97,8,,267818682,28,1250,267818654,267818682
13500,5,24,149,5745,-89,-97,8,,267820432,28,1722,267820404,267820432
13501,5,24,149,5745,-88,-97,9,,267820476,28,16,267820448,267820476
13502,5,24,149,5745,-88,-97,9,,267820585,32,77,267820553,267820585
13503,5,12,149,5745,-65,-97,32,5e:29:73:5b:30:00,267827592,272,6735,267827320,267827592
13504,5,12,149,5745,-75,-97,22,3e:ef:29:c7:4b:17,267838346,272,10482,267838074,267838346
13505,5,24,149,5745,-87,-97,10,,267838898,28,524,267838870,267838898
13506,5,24,149,5745,-88,-97,9,,267838943,28,17,267838915,267838943
13507,5,12,149,5745,-80,-97,17,9a:24:38:da:96:bb,267843071,272,3856,267842799,267843071
13508,5,24,149,5745,-87,-97,10,,267854109,28,11010,267854081,267854109
13509,5,24,149,5745,-84,-97,13,,267854155,28,18,267854127,267854155
13510,5,24,149,5745,-84,-97,13,,267854265,32,78,267854233,267854265
13511,5,12,149,5745,-70,-97,27,0a:e1:ab:b3:c3:a6,267856354,272,1817,267856082,267856354
13512,5,24,149,5745,-87,-97,10,,267861187,32,4801,267861155,267861187
13513,5,24,149,5745,-87,-97,10,,267861313,32,94,267861281,267861313
13514,5,12,149,5745,-63,-97,34,76:d6:6a:bb:b3:f5,267862324,272,739,267862052,267862324
13515,5,12,149,5745,-58,-97,39,3a:de:b0:2e:cd:45,267863022,272,426,267862750,267863022
13516,5,12,149,5745,-64,-97,33,f2:da:61:dd:98:c5,267863472,268,182,267863204,267863472
13517,5,12,149,5745,-61,-97,36,9e:1f:b0:a7:b8:90,267863884,288,124,267863596,267863884
13518,5,12,149,5745,-63,-97,34,fa:44:8d:e1:c7:1b,267885821,244,21693,267885577,267885821
13519,5,12,149,5745,-63,-97,34,b6:90:18:f6:b1:d4,267886431,272,338,267886159,267886431
13520,5,12,149,5745,-74,-97,23,72:d1:72:1d:22:a1,267886872,284,157,267886588,267886872
13521,5,12,149,5745,-70,-97,27,56:68:e2:c2:8d:d5,267887443,280,291,267887163,267887443
13522,5,12,149,5745,-68,-97,29,22:ec:75:a8:8a:31,267889296,244,1609,267889052,267889296
13523,5,24,149,5745,-88,-97,9,,267892566,32,3238,267892534,267892566
13524,5,24,149,5745,-87,-97,10,,267899591,28,6997,267899563,267899591
13525,5,24,149,5745,-84,-97,13,,267899637,28,18,267899609,267899637
13526,5,24,149,5745,-84,-97,13,,267899747,32,78,267899715,267899747
13527,5,24,149,5745,-87,-97,10,,267900332,32,553,267900300,267900332
13528,5,12,149,5745,-74,-97,23,3e:ef:29:c7:4b:17,267917012,272,16408,267916740,267917012
13529,5,12,149,5745,-70,-97,27,f6:0a:5c:59:72:df,267917669,280,377,267917389,267917669
13530,5,12,149,5745,-63,-97,34,9e:1f:b0:a7:b8:90,267918109,288,152,267917821,267918109
13531,5,12,149,5745,-66,-97,31,0a:e1:ab:b3:c3:a6,267931825,272,13444,267931553,267931825
13532,5,12,149,5745,-69,-97,28,f6:0a:5c:59:72:df,267932275,476,-26,267931799,267932275
13533,5,12,149,5745,-66,-97,31,0a:e1:ab:b3:c3:a6,267934882,468,2139,267934414,267934882
13534,5,12,149,5745,-62,-97,35,9e:1f:b0:a7:b8:90,267935385,484,19,267934901,267935385
13535,5,12,149,5745,-58,-97,39,3a:de:b0:2e:cd:45,267936112,380,347,267935732,267936112
13536,5,12,149,5745,-64,-97,33,fa:44:8d:e1:c7:1b,267936582,412,58,267936170,267936582
13537,5,12,149,5745,-68,-97,29,22:ec:75:a8:8a:31,267937055,516,-43,267936539,267937055
13538,5,12,149,5745,-62,-97,35,b6:90:18:f6:b1:d4,267937661,468,138,267937193,267937661
13539,5,12,149,5745,-58,-97,39,3a:de:b0:2e:cd:45,267938209,468,80,267937741,267938209
13540,5,12,149,5745,-56,-97,41,3e:d1:9b:c7:a4:de,267941179,544,2426,267940635,267941179
13541,5,12,149,5745,-59,-97,38,4a:ea:3c:f4:ce:b2,267941893,468,246,267941425,267941893
13542,5,12,149,5745,-70,-97,27,56:68:e2:c2:8d:d5,267945050,476,2681,267944574,267945050
13543,5,12,149,5745,-56,-97,41,3e:d1:9b:c7:a4:de,267946472,272,1150,267946200,267946472
13544,5,12,149,5745,-61,-97,36,f2:da:61:dd:98:c5,267946807,268,67,267946539,267946807
13545,5,12,149,5745,-59,-97,38,3a:de:b0:2e:cd:45,267947145,272,66,267946873,267947145
13546,5,12,149,5745,-65,-97,32,76:d6:6a:bb:b3:f5,267947506,272,89,267947234,267947506
13547,5,12,149,5745,-64,-97,33,fa:44:8d:e1:c7:1b,267947995,244,245,267947751,267947995
13548,5,12,149,5745,-63,-97,34,5e:29:73:5b:30:00,267948291,272,24,267948019,267948291
13549,5,12,149,5745,-63,-97,34,b6:90:18:f6:b1:d4,267948626,272,63,267948354,267948626
13550,5,12,149,5745,-61,-97,36,f2:da:61:dd:98:c5,267948986,268,92,267948718,267948986
13551,5,12,149,5745,-65,-97,32,76:d6:6a:bb:b3:f5,267950946,468,1492,267950478,267950946
13552,5,12,149,5745,-68,-97,29,a6:92:ad:b7:76:65,267952123,484,693,267951639,267952123
13553,5,12,149,5745,-75,-97,22,72:d1:72:1d:22:a1,267952660,480,57,267952180,267952660
13554,5,12,149,5745,-82,-97,15,9a:24:38:da:96:bb,267953330,824,-154,267952506,267953330
13555,5,12,149,5745,-74,-97,23,3e:ef:29:c7:4b:17,267954454,468,656,267953986,267954454
13556,5,12,149,5745,-59,-97,38,4a:ea:3c:f4:ce:b2,267954984,272,258,267954712,267954984
13557,5,12,149,5745,-63,-97,34,5e:29:73:5b:30:00,267956820,540,1296,267956280,267956820
13558,5,12,149,5745,-75,-97,22,72:d1:72:1d:22:a1,267964631,284,7527,267964347,267964631
13559,5,24,149,5745,-88,-97,9,,267970494,28,5835,267970466,267970494
13560,5,24,149,5745,-89,-97,8,,267970603,32,77,267970571,267970603
13561,5,12,149,5745,-70,-97,27,56:68:e2:c2:8d:d5,267980158,280,9275,267979878,267980158
13562,5,24,149,5745,-88,-97,9,,267988465,28,8279,267988437,267988465
13563,5,12,149,5745,-71,-97,26,f6:0a:5c:59:72:df,267997245,476,8304,267996769,267997245
13564,5,12,149,5745,-64,-97,33,0a:e1:ab:b3:c3:a6,267998412,468,699,267997944,267998412
13565,5,12,149,5745,-60,-97,37,9e:1f:b0:a7:b8:90,267999114,480,222,267998634,267999114
13566,5,12,149,5745,-64,-97,33,fa:44:8d:e1:c7:1b,268000744,412,1218,268000332,268000744
13567,5,12,149,5745,-58,-97,39,3a:de:b0:2e:cd:45,268001576,468,364,268001108,268001576
13568,5,12,149,5745,-59,-97,38,4a:ea:3c:f4:ce:b2,268004021,468,1977,268003553,268004021
13569,5,12,149,5745,-69,-97,28,22:ec:75:a8:8a:31,268007554,244,3289,268007310,268007554
13570,5,12,149,5745,-68,-97,29,a6:92:ad:b7:76:65,268011747,484,3709,268011263,268011747
13571,5,12,149,5745,-60,-97,37,9e:1f:b0:a7:b8:90,268029869,284,17838,268029585,268029869
13572,5,12,149,5745,-71,-97,26,f6:0a:5c:59:72:df,268030260,280,111,268029980,268030260
13573,5,12,149,5745,-57,-97,40,3e:d1:9b:c7:a4:de,268038173,272,7641,268037901,268038173
13574,5,12,149,5745,-75,-97,22,3e:ef:29:c7:4b:17,268041082,272,2637,268040810,268041082
13575,5,12,149,5745,-66,-97,31,a6:92:ad:b7:76:65,268044299,284,2933,268044015,268044299
13576,5,24,149,5745,-87,-97,10,,268044699,28,372,268044671,268044699
13577,5,24,149,5745,-88,-97,9,,268044742,28,15,268044714,268044742
13578,5,24,149,5745,-88,-97,9,,268044851,32,77,268044819,268044851
13579,5,12,149,5745,-64,-97,33,0a:e1:ab:b3:c3:a6,268046903,272,1780,268046631,268046903
13580,5,12,149,5745,-63,-97,34,fa:44:8d:e1:c7:1b,268047264,244,117,268047020,268047264
13581,5,12,149,5745,-56,-97,41,3a:de:b0:2e:cd:45,268060710,272,13174,268060438,268060710
13582,5,12,149,5745,-66,-97,31,76:d6:6a:bb:b3:f5,268061126,272,144,268060854,268061126
13583,5,12,149,5745,-64,-97,33,f2:da:61:dd:98:c5,268061531,268,137,268061263,268061531
13584,5,24,149,5745,-87,-97,10,,268062253,28,694,268062225,268062253
13585,5,12,149,5745,-64,-97,33,5e:29:73:5b:30:00,268062661,272,136,268062389,268062661
13586,5,12,149,5745,-63,-97,34,b6:90:18:f6:b1:d4,268062978,272,45,268062706,268062978
13587,5,12,149,5745,-71,-97,26,f6:0a:5c:59:72:df,268063338,476,-116,268062862,268063338
13588,5,12,149,5745,-85,-97,12,9a:24:38:da:96:bb,268064459,824,297,268063635,268064459
13589,5,12,149,5745,-65,-97,32,0a:e1:ab:b3:c3:a6,268065326,468,399,268064858,268065326
13590,5,12,149,5745,-58,-97,39,4a:ea:3c:f4:ce:b2,268066369,272,771,268066097,268066369
13591,5,12,149,5745,-63,-97,34,fa:44:8d:e1:c7:1b,268067467,412,686,268067055,268067467
13592,5,12,149,5745,-56,-97,41,3a:de:b0:2e:cd:45,268067923,468,-12,268067455,268067923
13593,5,12,149,5745,-64,-97,33,b6:90:18:f6:b1:d4,268068472,468,81,268068004,268068472
13594,5,12,149,5745,-57,-97,40,3e:d1:9b:c7:a4:de,268069685,544,669,268069141,268069685
13595,5,12,149,5745,-67,-97,30,a6:92:ad:b7:76:65,268076447,484,6278,268075963,268076447
13596,5,12,149,5745,-65,-97,32,f2:da:61:dd:98:c5,268080070,268,3355,268079802,268080070
13597,5,12,149,5745,-68,-97,29,0a:b9:b7:b1:4d:fa,268080720,468,182,268080252,268080720
13598,5,12,149,5745,-66,-97,31,76:d6:6a:bb:b3:f5,268081938,468,750,268081470,268081938
13599,5,12,149,5745,-71,-97,26,aa:b6:ae:27:64:4e,268082494,468,88,268082026,268082494
13600,5,12,149,5745,-61,-97,36,9e:1f:b0:a7:b8:90,268086901,480,3927,268086421,268086901
13601,5,12,149,5745,-64,-97,33,5e:29:73:5b:30:00,268088820,540,1379,268088280,268088820
13602,5,12,149,5745,-77,-97,20,72:d1:72:1d:22:a1,268089929,284,825,268089645,268089929
13603,5,12,149,5745,-70,-97,27,56:68:e2:c2:8d:d5,268095560,280,5351,268095280,268095560
13604,5,12,149,5745,-86,-97,11,9a:24:38:da:96:bb,268104302,272,8470,268104030,268104302
13605,5,12,149,5745,-69,-97,28,22:ec:75:a8:8a:31,268121695,244,17149,268121451,268121695
13606,5,12,149,5745,-62,-97,35,9e:1f:b0:a7:b8:90,268144055,284,22076,268143771,268144055
13607,5,12,149,5745,-61,-97,36,fa:44:8d:e1:c7:1b,268144582,440,87,268144142,268144582
13608,5,12,149,5745,-59,-97,38,3e:d1:9b:c7:a4:de,268152087,272,7233,268151815,268152087
13609,5,12,149,5745,-74,-97,23,3e:ef:29:c7:4b:17,268154908,272,2549,268154636,268154908
13610,5,12,149,5745,-61,-97,36,fa:44:8d:e1:c7:1b,268160201,244,5049,268159957,268160201
13611,5,12,149,5745,-68,-97,29,a6:92:ad:b7:76:65,268164706,284,4221,268164422,268164706
13612,5,12,149,5745,-61,-97,36,5e:29:73:5b:30:00,268168007,272,3029,268167735,268168007
13613,5,6,149,5745,-86,-97,11,54:e4:3a:ec:fb:65,268169534,360,1167,268169174,268169534
13614,5,12,149,5745,-64,-97,33,0a:e1:ab:b3:c3:a6,268170869,272,1063,268170597,268170869
13615,5,12,149,5745,-66,-97,31,76:d6:6a:bb:b3:f5,268173012,272,1871,268172740,268173012
13616,5,12,149,5745,-54,-97,43,3a:de:b0:2e:cd:45,268179674,272,6390,268179402,268179674
13617,5,12,149,5745,-65,-97,32,f2:da:61:dd:98:c5,268182768,268,2826,268182500,268182768
13618,5,12,149,5745,-62,-97,35,b6:90:18:f6:b1:d4,268192698,272,9658,268192426,268192698
13619,5,12,149,5745,-57,-97,40,4a:ea:3c:f4:ce:b2,268193933,272,963,268193661,268193933
13620,5,24,149,5745,-86,-97,11,,268195067,28,1106,268195039,268195067
13621,5,24,149,5745,-87,-97,10,,268195111,28,16,268195083,268195111
13622,5,24,149,5745,-89,-97,8,,268195219,32,76,268195187,268195219
13623,5,12,149,5745,-76,-97,21,72:d1:72:1d:22:a1,268202815,284,7312,268202531,268202815
13624,5,12,149,5745,-69,-97,28,56:68:e2:c2:8d:d5,268207165,280,4070,268206885,268207165
13625,5,24,149,5745,-89,-97,8,,268213320,28,6127,268213292,268213320
13626,5,24,149,5745,-86,-97,11,,268213363,28,15,268213335,268213363
13627,5,24,149,5745,-87,-97,10,,268213472,32,77,268213440,268213472
13628,5,12,149,5745,-86,-97,11,9a:24:38:da:96:bb,268217618,272,3874,268217346,268217618
13629,5,12,149,5745,-68,-97,29,22:ec:75:a8:8a:31,268233843,244,15981,268233599,268233843
13630,5,12,149,5745,-73,-97,24,3e:ef:29:c7:4b:17,268263839,272,29724,268263567,268263839
13631,5,12,149,5745,-70,-97,27,f6:0a:5c:59:72:df,268265943,280,1824,268265663,268265943
13632,5,12,149,5745,-60,-97,37,3e:d1:9b:c7:a4:de,268269385,272,3170,268269113,268269385
13633,5,24,149,5745,-87,-97,10,,268270591,28,1178,268270563,268270591
13634,5,24,149,5745,-88,-97,9,,268270634,28,15,268270606,268270634
13635,5,24,149,5745,-89,-97,8,,268270751,32,85,268270719,268270751
13636,5,24,149,5745,-87,-97,10,,268271766,28,987,268271738,268271766
13637,5,24,149,5745,-88,-97,9,,268271810,28,16,268271782,268271810
13638,5,6,149,5745,-88,-97,9,54:e4:3a:ec:fb:65,268271934,360,-236,268271574,268271934
13639,5,12,149,5745,-63,-97,34,9e:1f:b0:a7:b8:90,268272497,284,279,268272213,268272497
13640,5,12,149,5745,-66,-97,31,0a:b9:b7:b1:4d:fa,268278837,468,5872,268278369,268278837
13641,5,24,149,5745,-88,-97,9,,268279606,32,737,268279574,268279606
13642,5,24,149,5745,-88,-97,9,,268280501,32,863,268280469,268280501
13643,5,24,149,5745,-88,-97,9,,268281610,28,1081,268281582,268281610
13644,5,12,149,5745,-64,-97,33,0a:e1:ab:b3:c3:a6,268282369,272,487,268282097,268282369
13645,5,12,149,5745,-66,-97,31,76:d6:6a:bb:b3:f5,268283914,272,1273,268283642,268283914
13646,5,12,149,5745,-64,-97,33,5e:29:73:5b:30:00,268284942,272,756,268284670,268284942
13647,5,24,149,5745,-88,-97,9,,268286063,32,1089,268286031,268286063
13648,5,12,149,5745,-54,-97,43,3a:de:b0:2e:cd:45,268288546,272,2211,268288274,268288546
13649,5,12,149,5745,-68,-97,29,a6:92:ad:b7:76:65,268295175,284,6345,268294891,268295175
13650,5,12,149,5745,-63,-97,34,fa:44:8d:e1:c7:1b,268296154,244,735,268295910,268296154
13651,5,12,149,5745,-62,-97,35,b6:90:18:f6:b1:d4,268304830,272,8404,268304558,268304830
13652,5,24,149,5745,-89,-97,8,,268309026,28,4168,268308998,268309026
13653,5,24,149,5745,-89,-97,8,,268309274,28,220,268309246,268309274
13654,5,24,149,5745,-90,-97,7,,268309488,28,186,268309460,268309488
13655,5,24,149,5745,-90,-97,7,,268312283,32,2763,268312251,268312283
13656,5,24,149,5745,-90,-97,7,,268312483,32,168,268312451,268312483
13657,5,12,149,5745,-77,-97,20,72:d1:72:1d:22:a1,268312873,284,106,268312589,268312873
13658,5,24,149,5745,-89,-97,8,,268313744,32,839,268313712,268313744
13659,5,24,149,5745,-88,-97,9,,268328557,28,14785,268328529,268328557
13660,5,24,149,5745,-88,-97,9,,268328771,28,186,268328743,268328771
13661,5,24,149,5745,-89,-97,8,,268328984,28,185,268328956,268328984
13662,5,24,149,5745,-87,-97,10,,268330447,28,1435,268330419,268330447
13663,5,12,149,5745,-84,-97,13,9a:24:38:da:96:bb,268333232,272,2513,268332960,268333232
13664,5,24,149,5745,-89,-97,8,,268333770,32,506,268333738,268333770
13665,5,12,149,5745,-67,-97,30,22:ec:75:a8:8a:31,268350996,244,16982,268350752,268350996
13666,5,24,149,5745,-88,-97,9,,268353922,28,2898,268353894,268353922
13667,5,24,149,5745,-90,-97,7,,268356655,28,2705,268356627,268356655
13668,5,24,149,5745,-88,-97,9,,268356699,28,16,268356671,268356699
13669,5,24,149,5745,-87,-97,10,,268356807,32,76,268356775,268356807
13670,5,24,149,5745,-87,-97,10,,268361104,28,4269,268361076,268361104
13671,5,24,149,5745,-90,-97,7,,268361148,28,16,268361120,268361148
13672,5,24,149,5745,-89,-97,8,,268361257,32,77,268361225,268361257
13673,5,6,149,5745,-88,-97,9,54:e4:3a:ec:fb:65,268374335,360,12718,268373975,268374335
13674,5,12,149,5745,-59,-97,38,f2:da:61:dd:98:c5,268375195,272,588,268374923,268375195
13675,5,12,149,5745,-63,-97,34,9e:1f:b0:a7:b8:90,268375602,284,123,268375318,268375602
13676,5,24,149,5745,-89,-97,8,,268379298,28,3668,268379270,268379298
13677,5,24,149,5745,-87,-97,10,,268379342,28,16,268379314,268379342
13678,5,12,149,5745,-58,-97,39,3e:d1:9b:c7:a4:de,268383022,272,3408,268382750,268383022
13679,5,12,149,5745,-67,-97,30,a6:92:ad:b7:76:65,268397755,284,14449,268397471,268397755
13680,5,12,149,5745,-64,-97,33,fa:44:8d:e1:c7:1b,268398563,244,564,268398319,268398563
13681,5,12,149,5745,-69,-97,28,56:68:e2:c2:8d:d5,268400524,280,1681,268400244,268400524
13682,5,12,149,5745,-64,-97,33,5e:29:73:5b:30:00,268401897,272,1101,268401625,268401897
13683,5,24,149,5745,-88,-97,9,,268412508,32,10579,268412476,268412508
13684,5,24,149,5745,-87,-97,10,,268412786,28,250,268412758,268412786
13685,5,12,149,5745,-62,-97,35,b6:90:18:f6:b1:d4,268414980,272,1922,268414708,268414980
13686,5,24,149,5745,-87,-97,10,,268417119,28,2111,268417091,268417119
13687,5,24,149,5745,-88,-97,9,,268417163,28,16,268417135,268417163
13688,5,24,149,5745,-89,-97,8,,268417271,32,76,268417239,268417271
13689,5,24,149,5745,-89,-97,8,,268418766,32,1463,268418734,268418766
13690,5,24,149,5745,-88,-97,9,,268435427,28,16633,268435399,268435427
13691,5,24,149,5745,-87,-97,10,,268435579,32,120,268435547,268435579
13692,5,12,149,5745,-72,-97,25,3e:ef:29:c7:4b:17,268451124,272,15273,268450852,268451124
13693,5,24,149,5745,-88,-97,9,,268459379,32,8223,268459347,268459379
13694,5,24,149,5745,-88,-97,9,,268459738,28,331,268459710,268459738
13695,5,12,149,5745,-68,-97,29,22:ec:75:a8:8a:31,268462845,244,2863,268462601,268462845
13696,5,24,149,5745,-87,-97,10,,268470441,28,7568,268470413,268470441
13697,5,24,149,5745,-86,-97,11,,268470484,28,15,268470456,268470484
13698,5,24,149,5745,-88,-97,9,,268470593,32,77,268470561,268470593
13699,5,12,149,5745,-66,-97,31,0a:e1:ab:b3:c3:a6,268471813,272,948,268471541,268471813
13700,5,6,149,5745,-88,-97,9,54:e4:3a:ec:fb:65,268476735,360,4562,268476375,268476735
13701,5,12,149,5745,-67,-97,30,76:d6:6a:bb:b3:f5,268477177,272,170,268476905,268477177
13702,5,12,149,5745,-61,-97,36,f2:da:61:dd:98:c5,268477519,272,70,268477247,268477519
13703,5,24,149,5745,-86,-97,11,,268488100,28,10553,268488072,268488100
13704,5,12,149,5745,-70,-97,27,d2:00:04:7e:2c:ab,268489920,412,1408,268489508,268489920
13705,5,12,149,5745,-68,-97,29,76:d6:6a:bb:b3:f5,268491115,272,923,268490843,268491115
13706,5,12,149,5745,-54,-97,43,3a:de:b0:2e:cd:45,268495013,272,3626,268494741,268495013
13707,5,12,149,5745,-58,-97,39,3e:d1:9b:c7:a4:de,268495875,272,590,268495603,268495875
13708,5,12,149,5745,-72,-97,25,3e:ef:29:c7:4b:17,268496743,272,596,268496471,268496743
13709,5,12,149,5745,-64,-97,33,fa:44:8d:e1:c7:1b,268500349,244,3362,268500105,268500349
13710,5,12,149,5745,-68,-97,29,a6:92:ad:b7:76:65,268501012,284,379,268500728,268501012
13711,5,12,149,5745,-77,-97,20,72:d1:72:1d:22:a1,268501419,284,123,268501135,268501419
13712,5,12,149,5745,-70,-97,27,56:68:e2:c2:8d:d5,268507164,280,5465,268506884,268507164
13713,5,12,149,5745,-64,-97,33,0a:e1:ab:b3:c3:a6,268508441,272,1005,268508169,268508441
13714,5,12,149,5745,-61,-97,36,4a:ea:3c:f4:ce:b2,268515848,272,7135,268515576,268515848
13715,5,12,149,5745,-62,-97,35,f2:da:61:dd:98:c5,268520242,272,4122,268519970,268520242
13716,5,12,149,5745,-62,-97,35,5e:29:73:5b:30:00,268521448,272,934,268521176,268521448
13717,5,12,149,5745,-63,-97,34,b6:90:18:f6:b1:d4,268521774,272,54,268521502,268521774
13718,5,12,149,5745,-70,-97,27,f6:0a:5c:59:72:df,268522187,476,-63,268521711,268522187
13719,5,12,149,5745,-62,-97,35,b6:90:18:f6:b1:d4,268525360,468,2705,268524892,268525360
13720,5,12,149,5745,-64,-97,33,0a:e1:ab:b3:c3:a6,268525907,468,79,268525439,268525907
13721,5,12,149,5745,-55,-97,42,3a:de:b0:2e:cd:45,268526409,468,34,268525941,268526409
13722,5,12,149,5745,-58,-97,39,3e:d1:9b:c7:a4:de,268528556,544,1603,268528012,268528556
13723,5,12,149,5745,-63,-97,34,f2:da:61:dd:98:c5,268529316,468,292,268528848,268529316
13724,5,12,149,5745,-71,-97,26,56:68:e2:c2:8d:d5,268533229,476,3437,268532753,268533229
13725,5,12,149,5745,-72,-97,25,56:68:e2:c2:8d:d5,268536917,280,3408,268536637,268536917
13726,5,12,149,5745,-68,-97,29,a6:92:ad:b7:76:65,268537321,484,-80,268536837,268537321
13727,5,12,149,5745,-76,-97,21,72:d1:72:1d:22:a1,268538668,284,1063,268538384,268538668
13728,5,12,149,5745,-63,-97,34,fa:44:8d:e1:c7:1b,268539685,440,577,268539245,268539685
13729,5,12,149,5745,-64,-97,33,76:d6:6a:bb:b3:f5,268540197,468,44,268539729,268540197
13730,5,12,149,5745,-62,-97,35,5e:29:73:5b:30:00,268545298,540,4561,268544758,268545298
13731,5,12,149,5745,-63,-97,34,9e:1f:b0:a7:b8:90,268545910,480,132,268545430,268545910
13732,5,12,149,5745,-85,-97,12,9a:24:38:da:96:bb,268552929,272,6747,268552657,268552929
13733,5,12,149,5745,-75,-97,22,72:d1:72:1d:22:a1,268555999,480,2590,268555519,268555999
13734,5,24,149,5745,-72,-97,25,,268570083,28,14056,268570055,268570083
13735,5,24,149,5745,-87,-97,10,,268570127,28,16,268570099,268570127
13736,5,24,149,5745,-87,-97,10,,268570235,28,80,268570207,268570235
13737,5,6,149,5745,-86,-97,11,54:e4:3a:ec:fb:65,268579136,360,8541,268578776,268579136
13738,5,12,149,5745,-70,-97,27,22:ec:75:a8:8a:31,268584799,244,5419,268584555,268584799
13739,5,12,149,5745,-63,-97,34,9e:1f:b0:a7:b8:90,268586864,284,1781,268586580,268586864
13740,5,12,149,5745,-70,-97,27,f6:0a:5c:59:72:df,268587308,476,-32,268586832,268587308
13741,5,12,149,5745,-63,-97,34,0a:e1:ab:b3:c3:a6,268588484,468,708,268588016,268588484
13742,5,12,149,5745,-62,-97,35,b6:90:18:f6:b1:d4,268589895,468,943,268589427,268589895
13743,5,12,149,5745,-72,-97,25,f6:0a:5c:59:72:df,268591351,280,1176,268591071,268591351
13744,5,12,149,5745,-70,-97,27,22:ec:75:a8:8a:31,268591827,516,-40,268591311,268591827
13745,5,12,149,5745,-63,-97,34,f2:da:61:dd:98:c5,268593299,360,1112,268592939,268593299
13746,5,12,149,5745,-58,-97,39,3e:d1:9b:c7:a4:de,268593702,544,-141,268593158,268593702
13747,5,12,149,5745,-56,-97,41,3a:de:b0:2e:cd:45,268594318,468,148,268593850,268594318
13748,5,12,149,5745,-62,-97,35,4a:ea:3c:f4:ce:b2,268594820,468,34,268594352,268594820
13749,5,12,149,5745,-63,-97,34,f2:da:61:dd:98:c5,268595333,468,45,268594865,268595333
13750,5,12,149,5745,-63,-97,34,9e:1f:b0:a7:b8:90,268595936,380,223,268595556,268595936
13751,5,12,149,5745,-73,-97,24,56:68:e2:c2:8d:d5,268596350,476,-62,268595874,268596350
13752,5,12,149,5745,-61,-97,36,fa:44:8d:e1:c7:1b,268599468,360,2758,268599108,268599468
13753,5,12,149,5745,-61,-97,36,fa:44:8d:e1:c7:1b,268599997,240,289,268599757,268599997
13754,5,12,149,5745,-66,-97,31,a6:92:ad:b7:76:65,268601612,484,1131,268601128,268601612
13755,5,12,149,5745,-66,-97,31,a6:92:ad:b7:76:65,268602116,284,220,268601832,268602116
13756,5,12,149,5745,-72,-97,25,3e:ef:29:c7:4b:17,268602445,272,57,268602173,268602445
13757,5,12,149,5745,-60,-97,37,fa:44:8d:e1:c7:1b,268604192,440,1307,268603752,268604192
13758,5,12,149,5745,-66,-97,31,76:d6:6a:bb:b3:f5,268605217,468,557,268604749,268605217
13759,5,12,149,5745,-74,-97,23,72:d1:72:1d:22:a1,268605811,480,114,268605331,268605811
13760,5,12,149,5745,-70,-97,27,aa:b6:ae:27:64:4e,268606425,468,146,268605957,268606425
13761,5,12,149,5745,-71,-97,26,d2:00:04:7e:2c:ab,268607774,468,881,268607306,268607774
13762,5,12,149,5745,-71,-97,26,d2:00:04:7e:2c:ab,268608305,380,151,268607925,268608305
13763,5,12,149,5745,-63,-97,34,5e:29:73:5b:30:00,268610417,540,1572,268609877,268610417
13764,5,12,149,5745,-62,-97,35,0a:b9:b7:b1:4d:fa,268610992,468,107,268610524,268610992
13765,5,12,149,5745,-63,-97,34,9e:1f:b0:a7:b8:90,268611494,480,22,268611014,268611494
13766,5,12,149,5745,-66,-97,31,76:d6:6a:bb:b3:f5,268618102,272,6336,268617830,268618102
13767,5,12,149,5745,-58,-97,39,3e:d1:9b:c7:a4:de,268618436,272,62,268618164,268618436
13768,5,12,149,5745,-60,-97,37,fa:44:8d:e1:c7:1b,268619616,244,936,268619372,268619616
13769,5,12,149,5745,-63,-97,34,0a:e1:ab:b3:c3:a6,268619939,272,51,268619667,268619939
13770,5,12,149,5745,-56,-97,41,3a:de:b0:2e:cd:45,268620245,272,34,268619973,268620245
13771,5,12,149,5745,-61,-97,36,4a:ea:3c:f4:ce:b2,268627869,272,7352,268627597,268627869
13772,5,24,149,5745,-71,-97,26,,268632061,28,4164,268632033,268632061
13773,5,24,149,5745,-85,-97,12,,268632105,28,16,268632077,268632105
13774,5,24,149,5745,-85,-97,12,,268632213,28,80,268632185,268632213
13775,5,12,149,5745,-63,-97,34,f2:da:61:dd:98:c5,268635353,272,2868,268635081,268635353
13776,5,12,149,5745,-61,-97,36,b6:90:18:f6:b1:d4,268636226,272,601,268635954,268636226
13777,5,12,149,5745,-62,-97,35,5e:29:73:5b:30:00,268636577,272,79,268636305,268636577
13778,5,12,149,5745,-63,-97,34,f2:da:61:dd:98:c5,268659869,468,22824,268659401,268659869
13779,5,12,149,5745,-74,-97,23,72:d1:72:1d:22:a1,268664637,284,4484,268664353,268664637
13780,5,12,149,5745,-84,-97,13,9a:24:38:da:96:bb,268665484,272,575,268665212,268665484
13781,5,12,149,5745,-61,-97,36,fa:44:8d:e1:c7:1b,268669260,440,3336,268668820,268669260
13782,5,12,149,5745,-72,-97,25,56:68:e2:c2:8d:d5,268670571,280,1031,268670291,268670571
13783,5,6,149,5745,-85,-97,12,54:e4:3a:ec:fb:65,268681536,360,10605,268681176,268681536
13784,5,24,149,5745,-87,-97,10,,268684836,28,3272,268684808,268684836
13785,5,24,149,5745,-85,-97,12,,268684999,32,131,268684967,268684999
13786,5,24,149,5745,-85,-97,12,,268685092,28,65,268685064,268685092
13787,5,24,149,5745,-87,-97,10,,268685255,32,131,268685223,268685255
13788,5,24,149,5745,-85,-97,12,,268685419,28,136,268685391,268685419
13789,5,24,149,5745,-87,-97,10,,268685464,28,17,268685436,268685464
13790,5,24,149,5745,-85,-97,12,,268685753,28,261,268685725,268685753
13791,5,24,149,5745,-86,-97,11,,268685797,28,16,268685769,268685797
13792,5,24,149,5745,-86,-97,11,,268685905,32,76,268685873,268685905
13793,5,24,149,5745,-86,-97,11,,268688585,28,2652,268688557,268688585
13794,5,24,149,5745,-85,-97,12,,268688628,28,15,268688600,268688628
13795,5,24,149,5745,-86,-97,11,,268688737,32,77,268688705,268688737
13796,5,24,149,5745,-86,-97,11,,268703662,32,14893,268703630,268703662
13797,5,24,149,5745,-86,-97,11,,268704335,32,641,268704303,268704335
13798,5,24,149,5745,-85,-97,12,,268704898,28,535,268704870,268704898
13799,5,24,149,5745,-86,-97,11,,268712089,28,7163,268712061,268712089
13800,5,24,149,5745,-85,-97,12,,268712133,28,16,268712105,268712133
13801,5,24,149,5745,-85,-97,12,,268712241,32,76,268712209,268712241
13802,5,12,149,5745,-71,-97,26,f6:0a:5c:59:72:df,268715183,280,2662,268714903,268715183
13803,5,24,149,5745,-87,-97,10,,268715569,28,358,268715541,268715569
13804,5,24,149,5745,-85,-97,12,,268715613,28,16,268715585,268715613
13805,5,24,149,5745,-85,-97,12,,268715722,32,77,268715690,268715722
13806,5,24,149,5745,-85,-97,12,,268720844,28,5094,268720816,268720844
13807,5,24,149,5745,-85,-97,12,,268720888,28,16,268720860,268720888
13808,5,24,149,5745,-85,-97,12,,268720997,32,77,268720965,268720997
13809,5,12,149,5745,-55,-97,42,3e:d1:9b:c7:a4:de,268721514,544,-27,268720970,268721514
13810,5,12,149,5745,-55,-97,42,3e:d1:9b:c7:a4:de,268732892,272,11106,268732620,268732892
13811,5,12,149,5745,-65,-97,32,fa:44:8d:e1:c7:1b,268735556,244,2420,268735312,268735556
13812,5,12,149,5745,-63,-97,34,5e:29:73:5b:30:00,268743452,272,7624,268743180,268743452
13813,5,12,149,5745,-64,-97,33,f2:da:61:dd:98:c5,268747326,272,3602,268747054,268747326
13814,5,12,149,5745,-73,-97,24,3e:ef:29:c7:4b:17,268759894,272,12296,268759622,268759894
13815,5,24,149,5745,-86,-97,11,,268777086,28,17164,268777058,268777086
13816,5,24,149,5745,-78,-97,19,,268777130,28,16,268777102,268777130
13817,5,24,149,5745,-81,-97,16,,268777238,32,76,268777206,268777238
13818,5,12,149,5745,-67,-97,30,0a:e1:ab:b3:c3:a6,268778236,272,726,268777964,268778236
13819,5,24,149,5745,-80,-97,17,,268778560,28,296,268778532,268778560
13820,5,24,149,5745,-85,-97,12,,268778604,28,16,268778576,268778604
13821,5,24,149,5745,-85,-97,12,,268778712,32,76,268778680,268778712
13822,5,24,149,5745,-85,-97,12,,268779138,28,398,268779110,268779138
13823,5,24,149,5745,-85,-97,12,,268779182,28,16,268779154,268779182
13824,5,24,149,5745,-86,-97,11,,268779290,32,76,268779258,268779290
13825,5,24,149,5745,-79,-97,18,,268779590,28,272,268779562,268779590
13826,5,24,149,5745,-86,-97,11,,268779635,28,17,268779607,268779635
13827,5,24,149,5745,-85,-97,12,,268779742,32,75,268779710,268779742
13828,5,12,149,5745,-83,-97,14,9a:24:38:da:96:bb,268780711,272,697,268780439,268780711
13829,5,6,149,5745,-83,-97,14,54:e4:3a:ec:fb:65,268783937,360,2866,268783577,268783937
13830,5,12,149,5745,-55,-97,42,3a:de:b0:2e:cd:45,268784637,272,428,268784365,268784637
13831,5,12,149,5745,-67,-97,30,9e:1f:b0:a7:b8:90,268785382,284,461,268785098,268785382
13832,5,12,149,5745,-66,-97,31,76:d6:6a:bb:b3:f5,268785836,272,182,268785564,268785836
13833,5,12,149,5745,-54,-97,43,3e:d1:9b:c7:a4:de,268787663,544,1283,268787119,268787663
13834,5,12,149,5745,-62,-97,35,0a:b9:b7:b1:4d:fa,268803152,468,15021,268802684,268803152
13835,5,24,149,5745,-87,-97,10,,268804938,32,1754,268804906,268804938
13836,5,12,149,5745,-65,-97,32,a6:92:ad:b7:76:65,268807327,284,2105,268807043,268807327
13837,5,12,149,5745,-62,-97,35,b6:90:18:f6:b1:d4,268807908,272,309,268807636,268807908
13838,5,12,149,5745,-74,-97,23,72:d1:72:1d:22:a1,268809029,284,837,268808745,268809029
13839,5,12,149,5745,-68,-97,29,22:ec:75:a8:8a:31,268809637,244,364,268809393,268809637
13840,5,12,149,5745,-74,-97,23,56:68:e2:c2:8d:d5,268810762,280,845,268810482,268810762
13841,5,24,149,5745,-86,-97,11,,268822654,32,11860,268822622,268822654
13842,5,24,149,5745,-87,-97,10,,268823266,28,584,268823238,268823266
13843,5,12,149,5745,-54,-97,43,3e:d1:9b:c7:a4:de,268833078,272,9540,268832806,268833078
13844,5,24,149,5745,-86,-97,11,,268843703,28,10597,268843675,268843703
13845,5,24,149,5745,-86,-97,11,,268843747,28,16,268843719,268843747
13846,5,24,149,5745,-86,-97,11,,268843856,32,77,268843824,268843856
13847,5,24,149,5745,-88,-97,9,,268847382,32,3494,268847350,268847382
13848,5,24,149,5745,-80,-97,17,66:48:51:4e:71:fa,268847500,328,-210,268847172,268847500
13849,5,24,149,5745,-87,-97,10,,268847880,28,352,268847852,268847880
13850,5,24,149,5745,-81,-97,16,,268847924,28,16,268847896,268847924
13851,5,24,149,5745,-81,-97,16,,268848032,32,76,268848000,268848032
13852,5,24,149,5745,-80,-97,17,,268849014,28,954,268848986,268849014
13853,5,24,149,5745,-86,-97,11,,268849058,28,16,268849030,268849058
13854,5,24,149,5745,-86,-97,11,,268849166,32,76,268849134,268849166
13855,5,12,149,5745,-60,-97,37,5e:29:73:5b:30:00,268860488,272,11050,268860216,268860488
13856,5,12,149,5745,-72,-97,25,3e:ef:29:c7:4b:17,268862047,272,1287,268861775,268862047
13857,5,24,149,5745,-85,-97,12,,268862371,28,296,268862343,268862371
13858,5,24,149,5745,-86,-97,11,,268862416,28,17,268862388,268862416
13859,5,24,149,5745,-86,-97,11,,268862523,32,75,268862491,268862523
13860,5,24,149,5745,-85,-97,12,,268867323,32,4768,268867291,268867323
13861,5,12,149,5745,-61,-97,36,4a:ea:3c:f4:ce:b2,268868326,272,731,268868054,268868326
13862,5,24,149,5745,-87,-97,10,,268880545,28,12191,268880517,268880545
13863,5,24,149,5745,-85,-97,12,,268880653,32,76,268880621,268880653
13864,5,12,149,5745,-69,-97,28,0a:e1:ab:b3:c3:a6,268880960,272,35,268880688,268880960
13865,5,12,149,5745,-65,-97,32,76:d6:6a:bb:b3:f5,268885660,272,4428,268885388,268885660
13866,5,6,149,5745,-83,-97,14,54:e4:3a:ec:fb:65,268886338,360,318,268885978,268886338
13867,5,12,149,5745,-66,-97,31,9e:1f:b0:a7:b8:90,268886725,284,103,268886441,268886725
13868,5,12,149,5745,-55,-97,42,3a:de:b0:2e:cd:45,268887063,272,66,268886791,268887063
13869,5,12,149,5745,-66,-97,31,f2:da:61:dd:98:c5,268887414,272,79,268887142,268887414
13870,5,12,149,5745,-82,-97,15,9a:24:38:da:96:bb,268889199,272,1513,268888927,268889199
13871,5,12,149,5745,-65,-97,32,a6:92:ad:b7:76:65,268909701,284,20218,268909417,268909701
13872,5,24,149,5745,-85,-97,12,,268910055,32,322,268910023,268910055
13873,5,24,149,5745,-79,-97,18,66:48:51:4e:71:fa,268910173,328,-210,268909845,268910173
13874,5,12,149,5745,-62,-97,35,b6:90:18:f6:b1:d4,268910623,272,178,268910351,268910623
13875,5,12,149,5745,-65,-97,32,fa:44:8d:e1:c7:1b,268910970,244,103,268910726,268910970
13876,5,12,149,5745,-74,-97,23,72:d1:72:1d:22:a1,268911303,284,49,268911019,268911303
13877,5,24,149,5745,-85,-97,12,,268911684,28,353,268911656,268911684
13878,5,24,149,5745,-81,-97,16,,268911727,28,15,268911699,268911727
13879,5,24,149,5745,-79,-97,18,,268911836,32,77,268911804,268911836
13880,5,12,149,5745,-71,-97,26,56:68:e2:c2:8d:d5,268911929,280,-187,268911649,268911929
13881,5,12,149,5745,-67,-97,30,22:ec:75:a8:8a:31,268925537,244,13364,268925293,268925537
13882,5,12,149,5745,-65,-97,32,9e:1f:b0:a7:b8:90,268935473,284,9652,268935189,268935473
13883,5,12,149,5745,-54,-97,43,3e:d1:9b:c7:a4:de,268950345,272,14600,268950073,268950345
13884,5,12,149,5745,-65,-97,32,a6:92:ad:b7:76:65,268954135,284,3506,268953851,268954135
13885,5,12,149,5745,-73,-97,24,3e:ef:29:c7:4b:17,268964057,272,9650,268963785,268964057
13886,5,12,149,5745,-64,-97,33,76:d6:6a:bb:b3:f5,268964382,272,53,268964110,268964382
13887,5,12,149,5745,-65,-97,32,f2:da:61:dd:98:c5,268964822,272,168,268964550,268964822
13888,5,12,149,5745,-67,-97,30,0a:e1:ab:b3:c3:a6,268966455,272,1361,268966183,268966455
13889,5,12,149,5745,-57,-97,40,3a:de:b0:2e:cd:45,268966948,272,221,268966676,268966948
13890,5,12,149,5745,-59,-97,38,4a:ea:3c:f4:ce:b2,268967273,272,53,268967001,268967273
13891,5,24,149,5745,-87,-97,10,,268972266,28,4965,268972238,268972266
13892,5,24,149,5745,-85,-97,12,,268972311,28,17,268972283,268972311
13893,5,24,149,5745,-86,-97,11,,268972427,32,84,268972395,268972427
13894,5,12,149,5745,-61,-97,36,b6:90:18:f6:b1:d4,268979853,272,7154,268979581,268979853
13895,5,12,149,5745,-59,-97,38,5e:29:73:5b:30:00,268980233,272,108,268979961,268980233
13896,5,12,149,5745,-73,-97,24,72:d1:72:1d:22:a1,268981485,284,968,268981201,268981485
13897,5,12,149,5745,-67,-97,30,0a:e1:ab:b3:c3:a6,268983594,468,1641,268983126,268983594
13898,5,12,149,5745,-61,-97,36,b6:90:18:f6:b1:d4,268985069,468,1007,268984601,268985069
13899,5,12,149,5745,-55,-97,42,3e:d1:9b:c7:a4:de,268986579,544,966,268986035,268986579
13900,5,12,149,5745,-68,-97,29,22:ec:75:a8:8a:31,268987757,516,662,268987241,268987757
13901,5,12,149,5745,-74,-97,23,3e:ef:29:c7:4b:17,268988344,468,119,268987876,268988344
13902,5,12,149,5745,-64,-97,33,9e:1f:b0:a7:b8:90,268988927,380,203,268988547,268988927
13903,5,12,149,5745,-71,-97,26,56:68:e2:c2:8d:d5,268993608,476,4205,268993132,268993608
13904,5,12,149,5745,-65,-97,32,a6:92:ad:b7:76:65,268994702,484,610,268994218,268994702
13905,5,12,149,5745,-71,-97,26,56:68:e2:c2:8d:d5,268995850,280,868,268995570,268995850
13906,5,12,149,5745,-65,-97,32,fa:44:8d:e1:c7:1b,268997012,440,722,268996572,268997012
13907,5,12,149,5745,-74,-97,23,72:d1:72:1d:22:a1,269000313,480,2821,268999833,269000313
13908,5,12,149,5745,-58,-97,39,3a:de:b0:2e:cd:45,269003349,468,2568,269002881,269003349
13909,5,12,149,5745,-64,-97,33,f2:da:61:dd:98:c5,269003851,468,34,269003383,269003851
13910,5,12,149,5745,-65,-97,32,9e:1f:b0:a7:b8:90,269004363,480,32,269003883,269004363
13911,5,12,149,5745,-60,-97,37,5e:29:73:5b:30:00,269006298,540,1395,269005758,269006298
13912,5,12,149,5745,-68,-97,29,76:d6:6a:bb:b3:f5,269014767,468,8001,269014299,269014767
13913,5,12,149,5745,-68,-97,29,22:ec:75:a8:8a:31,269038118,244,23107,269037874,269038118
13914,5,12,149,5745,-64,-97,33,9e:1f:b0:a7:b8:90,269045562,284,7160,269045278,269045562
13915,5,12,149,5745,-65,-97,32,0a:e1:ab:b3:c3:a6,269047069,468,1039,269046601,269047069
13916,5,12,149,5745,-54,-97,43,3e:d1:9b:c7:a4:de,269049650,544,2037,269049106,269049650
13917,5,12,149,5745,-75,-97,22,f6:0a:5c:59:72:df,269051775,280,1845,269051495,269051775
13918,5,12,149,5745,-59,-97,38,4a:ea:3c:f4:ce:b2,269052216,468,-27,269051748,269052216
13919,5,12,149,5745,-58,-97,39,3a:de:b0:2e:cd:45,269052729,468,45,269052261,269052729
13920,5,12,149,5745,-63,-97,34,f2:da:61:dd:98:c5,269053285,468,88,269052817,269053285
13921,5,12,149,5745,-64,-97,33,a6:92:ad:b7:76:65,269056637,484,2868,269056153,269056637
13922,5,24,149,5745,-87,-97,10,,269058344,28,1679,269058316,269058344
13923,5,24,149,5745,-85,-97,12,,269058388,28,16,269058360,269058388
13924,5,24,149,5745,-86,-97,11,,269058496,32,76,269058464,269058496
13925,5,24,149,5745,-85,-97,12,,269058696,28,172,269058668,269058696
13926,5,24,149,5745,-85,-97,12,,269058740,28,16,269058712,269058740
13927,5,24,149,5745,-85,-97,12,,269058902,32,130,269058870,269058902
13928,5,24,149,5745,-86,-97,11,,269059090,28,160,269059062,269059090
13929,5,24,149,5745,-85,-97,12,,269059134,28,16,269059106,269059134
13930,5,24,149,5745,-85,-97,12,,269059243,32,77,269059211,269059243
13931,5,12,149,5745,-64,-97,33,a6:92:ad:b7:76:65,269059957,284,430,269059673,269059957
13932,5,12,149,5745,-65,-97,32,fa:44:8d:e1:c7:1b,269061716,244,1515,269061472,269061716
13933,5,12,149,5745,-63,-97,34,fa:44:8d:e1:c7:1b,269061978,440,-178,269061538,269061978
13934,5,12,149,5745,-65,-97,32,0a:e1:ab:b3:c3:a6,269062488,272,238,269062216,269062488
13935,5,12,149,5745,-74,-97,23,3e:ef:29:c7:4b:17,269066955,272,4195,269066683,269066955
13936,5,12,149,5745,-64,-97,33,9e:1f:b0:a7:b8:90,269068737,480,1302,269068257,269068737
13937,5,24,149,5745,-85,-97,12,,269069324,28,559,269069296,269069324
13938,5,24,149,5745,-86,-97,11,,269069368,28,16,269069340,269069368
13939,5,24,149,5745,-86,-97,11,,269069476,32,76,269069444,269069476
13940,5,12,149,5745,-53,-97,44,3e:d1:9b:c7:a4:de,269076976,272,7228,269076704,269076976
13941,5,12,149,5745,-63,-97,34,f2:da:61:dd:98:c5,269077302,272,54,269077030,269077302
13942,5,12,149,5745,-57,-97,40,3a:de:b0:2e:cd:45,269078850,272,1276,269078578,269078850
13943,5,12,149,5745,-61,-97,36,4a:ea:3c:f4:ce:b2,269079499,272,377,269079227,269079499
13944,5,12,149,5745,-68,-97,29,76:d6:6a:bb:b3:f5,269082107,272,2336,269081835,269082107
13945,5,24,149,5745,-85,-97,12,,269082476,28,341,269082448,269082476
13946,5,24,149,5745,-86,-97,11,,269082521,28,17,269082493,269082521
13947,5,24,149,5745,-85,-97,12,,269082629,32,76,269082597,269082629
13948,5,24,149,5745,-85,-97,12,,269084879,28,2222,269084851,269084879
13949,5,24,149,5745,-86,-97,11,,269084923,28,16,269084895,269084923
13950,5,24,149,5745,-86,-97,11,,269085051,32,96,269085019,269085051
13951,5,24,149,5745,-85,-97,12,,269085841,28,762,269085813,269085841
13952,5,24,149,5745,-86,-97,11,,269085886,28,17,269085858,269085886
13953,5,24,149,5745,-86,-97,11,,269085998,32,80,269085966,269085998
13954,5,12,149,5745,-62,-97,35,5e:29:73:5b:30:00,269087023,272,753,269086751,269087023
13955,5,6,149,5745,-85,-97,12,54:e4:3a:ec:fb:65,269091138,360,3755,269090778,269091138
13956,5,12,149,5745,-61,-97,36,b6:90:18:f6:b1:d4,269096279,272,4869,269096007,269096279
13957,5,12,149,5745,-74,-97,23,72:d1:72:1d:22:a1,269105254,284,8691,269104970,269105254
13958,5,12,149,5745,-83,-97,14,9a:24:38:da:96:bb,269111578,824,5500,269110754,269111578
13959,5,12,149,5745,-65,-97,32,0a:e1:ab:b3:c3:a6,269112535,468,489,269112067,269112535
13960,5,12,149,5745,-83,-97,14,9a:24:38:da:96:bb,269113065,272,258,269112793,269113065
13961,5,12,149,5745,-53,-97,44,3e:d1:9b:c7:a4:de,269115234,544,1625,269114690,269115234
13962,5,12,149,5745,-61,-97,36,b6:90:18:f6:b1:d4,269115868,468,166,269115400,269115868
13963,5,12,149,5745,-57,-97,40,3a:de:b0:2e:cd:45,269117443,468,1107,269116975,269117443
13964,5,12,149,5745,-74,-97,23,3e:ef:29:c7:4b:17,269117945,468,34,269117477,269117945
13965,5,12,149,5745,-63,-97,34,f2:da:61:dd:98:c5,269118528,468,115,269118060,269118528
13966,5,12,149,5745,-69,-97,28,22:ec:75:a8:8a:31,269121336,516,2292,269120820,269121336
13967,5,12,149,5745,-65,-97,32,a6:92:ad:b7:76:65,269121922,484,102,269121438,269121922
13968,5,12,149,5745,-70,-97,27,56:68:e2:c2:8d:d5,269123061,280,859,269122781,269123061
13969,5,12,149,5745,-65,-97,32,fa:44:8d:e1:c7:1b,269127841,440,4340,269127401,269127841
13970,5,12,149,5745,-68,-97,29,76:d6:6a:bb:b3:f5,269129928,468,1619,269129460,269129928
13971,5,12,149,5745,-73,-97,24,aa:b6:ae:27:64:4e,269130429,468,33,269129961,269130429
13972,5,12,149,5745,-58,-97,39,0a:b9:b7:b1:4d:fa,269131735,468,838,269131267,269131735
13973,5,12,149,5745,-65,-97,32,9e:1f:b0:a7:b8:90,269135172,480,2957,269134692,269135172
13974,5,12,149,5745,-63,-97,34,5e:29:73:5b:30:00,269136254,540,542,269135714,269136254
13975,5,12,149,5745,-79,-97,18,d2:00:04:7e:2c:ab,269136828,440,134,269136388,269136828
13976,5,12,149,5745,-69,-97,28,22:ec:75:a8:8a:31,269159090,244,22018,269158846,269159090
13977,5,12,149,5745,-64,-97,33,9e:1f:b0:a7:b8:90,269161253,284,1879,269160969,269161253
13978,5,24,149,5745,-86,-97,11,,269168715,28,7434,269168687,269168715
13979,5,24,149,5745,-87,-97,10,,269168759,28,16,269168731,269168759
13980,5,24,149,5745,-87,-97,10,,269168867,32,76,269168835,269168867
13981,5,24,149,5745,-87,-97,10,,269169078,28,183,269169050,269169078
13982,5,24,149,5745,-87,-97,10,,269169168,28,62,269169140,269169168
13983,5,24,149,5745,-86,-97,11,,269169266,28,70,269169238,269169266
13984,5,24,149,5745,-87,-97,10,,269169382,28,88,269169354,269169382
13985,5,24,149,5745,-88,-97,9,,269169473,28,63,269169445,269169473
13986,5,24,149,5745,-88,-97,9,,269169563,28,62,269169535,269169563
13987,5,24,149,5745,-87,-97,10,,269169654,28,63,269169626,269169654
13988,5,24,149,5745,-87,-97,10,,269169698,28,16,269169670,269169698
13989,5,24,149,5745,-86,-97,11,,269169817,32,87,269169785,269169817
13990,5,24,149,5745,-88,-97,9,,269170000,28,155,269169972,269170000
13991,5,24,149,5745,-87,-97,10,,269170044,28,16,269170016,269170044
13992,5,24,149,5745,-87,-97,10,,269170372,28,300,269170344,269170372
13993,5,24,149,5745,-87,-97,10,,269170416,28,16,269170388,269170416
13994,5,24,149,5745,-87,-97,10,,269172315,28,1871,269172287,269172315
13995,5,24,149,5745,-87,-97,10,,269172359,28,16,269172331,269172359
13996,5,24,149,5745,-87,-97,10,,269172475,32,84,269172443,269172475
13997,5,12,149,5745,-64,-97,33,fa:44:8d:e1:c7:1b,269175970,244,3251,269175726,269175970
13998,5,12,149,5745,-54,-97,43,3e:d1:9b:c7:a4:de,269177724,544,1210,269177180,269177724
13999,5,12,149,5745,-64,-97,33,fa:44:8d:e1:c7:1b,269181499,440,3335,269181059,269181499
14000,5,12,149,5745,-64,-97,33,f2:da:61:dd:98:c5,269184070,468,2103,269183602,269184070
14001,5,12,149,5745,-74,-97,23,3e:ef:29:c7:4b:17,269187713,272,3371,269187441,269187713
14002,5,12,149,5745,-54,-97,43,3e:d1:9b:c7:a4:de,269191664,272,3679,269191392,269191664
14003,5,12,149,5745,-63,-97,34,f2:da:61:dd:98:c5,269192017,272,81,269191745,269192017
14004,5,12,149,5745,-66,-97,31,0a:e1:ab:b3:c3:a6,269193300,272,1011,269193028,269193300
14005,5,12,149,5745,-55,-97,42,3a:de:b0:2e:cd:45,269193709,272,137,269193437,269193709
14006,5,12,149,5745,-66,-97,31,76:d6:6a:bb:b3:f5,269196951,272,2970,269196679,269196951
14007,5,12,149,5745,-63,-97,34,5e:29:73:5b:30:00,269204190,272,6967,269203918,269204190
14008,5,24,149,5745,-88,-97,9,,269212828,28,8610,269212800,269212828
14009,5,24,149,5745,-88,-97,9,,269212872,28,16,269212844,269212872
14010,5,24,149,5745,-87,-97,10,,269212979,32,75,269212947,269212979
14011,5,12,149,5745,-66,-97,31,a6:92:ad:b7:76:65,269216714,284,3451,269216430,269216714
14012,5,12,149,5745,-64,-97,33,b6:90:18:f6:b1:d4,269218067,272,1081,269217795,269218067
14013,5,12,149,5745,-76,-97,21,72:d1:72:1d:22:a1,269218429,284,78,269218145,269218429
14014,5,12,149,5745,-72,-97,25,56:68:e2:c2:8d:d5,269232575,280,13866,269232295,269232575
14015,5,12,149,5745,-55,-97,42,3e:d1:9b:c7:a4:de,269243267,544,10148,269242723,269243267
14016,5,24,149,5745,-87,-97,10,,269256746,28,13451,269256718,269256746
14017,5,12,149,5745,-72,-97,25,22:ec:75:a8:8a:31,269267394,244,10404,269267150,269267394
14018,5,24,149,5745,-87,-97,10,,269295037,28,27615,269295009,269295037
14019,5,24,149,5745,-86,-97,11,,269295146,32,77,269295114,269295146
14020,5,6,149,5745,-86,-97,11,54:e4:3a:ec:fb:65,269295940,360,434,269295580,269295940
14021,5,12,149,5745,-64,-97,33,9e:1f:b0:a7:b8:90,269297420,284,1196,269297136,269297420
14022,5,12,149,5745,-65,-97,32,0a:e1:ab:b3:c3:a6,269301209,272,3517,269300937,269301209
14023,5,12,149,5745,-64,-97,33,fa:44:8d:e1:c7:1b,269302314,244,861,269302070,269302314
14024,5,12,149,5745,-54,-97,43,3a:de:b0:2e:cd:45,269305239,272,2653,269304967,269305239
14025,5,12,149,5745,-56,-97,41,3e:d1:9b:c7:a4:de,269306346,272,835,269306074,269306346
14026,5,12,149,5745,-56,-97,41,3e:d1:9b:c7:a4:de,269308291,544,1401,269307747,269308291
14027,5,12,149,5745,-64,-97,33,76:d6:6a:bb:b3:f5,269308879,272,316,269308607,269308879
14028,5,12,149,5745,-65,-97,32,f2:da:61:dd:98:c5,269309322,272,171,269309050,269309322
14029,5,24,149,5745,-86,-97,11,,269312636,28,3286,269312608,269312636
14030,5,12,149,5745,-62,-97,35,4a:ea:3c:f4:ce:b2,269318440,272,5532,269318168,269318440
14031,5,12,149,5745,-68,-97,29,a6:92:ad:b7:76:65,269319137,284,413,269318853,269319137
14032,5,12,149,5745,-61,-97,36,5e:29:73:5b:30:00,269323719,272,4310,269323447,269323719
14033,5,12,149,5745,-74,-97,23,72:d1:72:1d:22:a1,269331276,284,7273,269330992,269331276
14034,5,12,149,5745,-59,-97,38,0a:b9:b7:b1:4d:fa,269331873,468,129,269331405,269331873
14035,5,12,149,5745,-64,-97,33,b6:90:18:f6:b1:d4,269336353,272,4208,269336081,269336353
14036,5,12,149,5745,-85,-97,12,9a:24:38:da:96:bb,269337880,272,1255,269337608,269337880
14037,5,24,149,5745,-86,-97,11,,269358499,28,20591,269358471,269358499
14038,5,24,149,5745,-86,-97,11,,269358898,28,371,269358870,269358898
14039,5,24,149,5745,-86,-97,11,,269359273,28,347,269359245,269359273
14040,5,24,149,5745,-87,-97,10,,269359538,28,237,269359510,269359538
14041,5,24,149,5745,-87,-97,10,,269359928,28,362,269359900,269359928
14042,5,24,149,5745,-86,-97,11,,269361790,28,1834,269361762,269361790
14043,5,24,149,5745,-86,-97,11,,269361898,32,76,269361866,269361898
14044,5,24,149,5745,-87,-97,10,,269363429,32,1499,269363397,269363429
14045,5,12,149,5745,-75,-97,22,3e:ef:29:c7:4b:17,269374208,272,10507,269373936,269374208
14046,5,12,149,5745,-71,-97,26,22:ec:75:a8:8a:31,269380931,244,6479,269380687,269380931
14047,5,12,149,5745,-69,-97,28,f6:0a:5c:59:72:df,269389236,280,8025,269388956,269389236
14048,5,6,149,5745,-89,-97,8,54:e4:3a:ec:fb:65,269398340,360,8744,269397980,269398340
14049,5,12,149,5745,-63,-97,34,9e:1f:b0:a7:b8:90,269399422,284,798,269399138,269399422
14050,5,24,149,5745,-86,-97,11,,269401255,32,1801,269401223,269401255
14051,5,12,149,5745,-57,-97,40,3e:d1:9b:c7:a4:de,269403473,272,1946,269403201,269403473
14052,5,12,149,5745,-63,-97,34,fa:44:8d:e1:c7:1b,269415025,244,11308,269414781,269415025
14053,5,12,149,5745,-54,-97,43,3a:de:b0:2e:cd:45,269415312,272,15,269415040,269415312
14054,5,12,149,5745,-69,-97,28,a6:92:ad:b7:76:65,269420850,284,5254,269420566,269420850
14055,5,12,149,5745,-75,-97,22,56:68:e2:c2:8d:d5,269425076,280,3946,269424796,269425076
14056,5,12,149,5745,-60,-97,37,5e:29:73:5b:30:00,269437173,272,11825,269436901,269437173
14057,5,12,149,5745,-75,-97,22,72:d1:72:1d:22:a1,269438506,284,1049,269438222,269438506
14058,5,12,149,5745,-65,-97,32,b6:90:18:f6:b1:d4,269438889,272,111,269438617,269438889
14059,5,24,149,5745,-86,-97,11,,269444057,28,5140,269444029,269444057
14060,5,24,149,5745,-85,-97,12,,269444165,32,76,269444133,269444165
14061,5,24,149,5745,-87,-97,10,,269446189,28,1996,269446161,269446189
14062,5,24,149,5745,-86,-97,11,,269446556,28,339,269446528,269446556
14063,5,24,149,5745,-86,-97,11,,269449943,32,3355,269449911,269449943
14064,5,12,149,5745,-86,-97,11,9a:24:38:da:96:bb,269452890,272,2675,269452618,269452890
14065,5,24,149,5745,-86,-97,11,,269472015,28,19097,269471987,269472015
14066,5,12,149,5745,-74,-97,23,3e:ef:29:c7:4b:17,269475898,272,3611,269475626,269475898
14067,5,24,149,5745,-87,-97,10,,269476518,32,588,269476486,269476518
14068,5,24,149,5745,-86,-97,11,,269485865,28,9319,269485837,269485865
14069,5,12,149,5745,-69,-97,28,22:ec:75:a8:8a:31,269493775,244,7666,269493531,269493775
14070,5,12,149,5745,-65,-97,32,0a:e1:ab:b3:c3:a6,269496399,272,2352,269496127,269496399
14071,5,24,149,5745,-86,-97,11,,269496791,28,364,269496763,269496791
14072,5,24,149,5745,-91,-97,6,,269496835,28,16,269496807,269496835
14073,5,24,149,5745,-86,-97,11,,269497138,28,275,269497110,269497138
14074,5,24,149,5745,-87,-97,10,,269497452,28,286,269497424,269497452
14075,5,12,149,5745,-61,-97,36,76:d6:6a:bb:b3:f5,269499628,272,1904,269499356,269499628
14076,5,6,149,5745,-90,-97,7,54:e4:3a:ec:fb:65,269500741,360,753,269500381,269500741
14077,5,12,149,5745,-66,-97,31,f2:da:61:dd:98:c5,269501290,272,277,269501018,269501290
14078,5,12,149,5745,-61,-97,36,9e:1f:b0:a7:b8:90,269502075,284,501,269501791,269502075
14079,5,24,149,5745,-87,-97,10,,269503056,28,953,269503028,269503056
14080,5,12,149,5745,-52,-97,45,3e:d1:9b:c7:a4:de,269515983,272,12655,269515711,269515983
14081,5,24,149,5745,-89,-97,8,,269522345,28,6334,269522317,269522345
14082,5,24,149,5745,-89,-97,8,,269522389,28,16,269522361,269522389
14083,5,24,149,5745,-89,-97,8,,269522497,32,76,269522465,269522497
14084,5,12,149,5745,-70,-97,27,a6:92:ad:b7:76:65,269523379,284,598,269523095,269523379
14085,5,12,149,5745,-77,-97,20,56:68:e2:c2:8d:d5,269525947,280,2288,269525667,269525947
14086,5,12,149,5745,-61,-97,36,fa:44:8d:e1:c7:1b,269529390,244,3199,269529146,269529390
14087,5,12,149,5745,-76,-97,21,3e:ef:29:c7:4b:17,269529724,272,62,269529452,269529724
14088,5,12,149,5745,-65,-97,32,0a:e1:ab:b3:c3:a6,269530279,272,283,269530007,269530279
14089,5,12,149,5745,-57,-97,40,3a:de:b0:2e:cd:45,269533276,272,2725,269533004,269533276
14090,5,12,149,5745,-59,-97,38,4a:ea:3c:f4:ce:b2,269534546,272,998,269534274,269534546
14091,5,12,149,5745,-64,-97,33,f2:da:61:dd:98:c5,269535868,272,1050,269535596,269535868
14092,5,12,149,5745,-62,-97,35,76:d6:6a:bb:b3:f5,269537947,272,1807,269537675,269537947
14093,5,12,149,5745,-72,-97,25,72:d1:72:1d:22:a1,269541350,284,3119,269541066,269541350
14094,5,12,149,5745,-66,-97,31,b6:90:18:f6:b1:d4,269541976,272,354,269541704,269541976
14095,5,12,149,5745,-72,-97,25,f6:0a:5c:59:72:df,269553459,128,11355,269553331,269553459
14096,5,12,149,5745,-88,-97,9,9a:24:38:da:96:bb,269560967,272,7236,269560695,269560967
14097,5,24,149,5745,-73,-97,24,,269568673,28,7678,269568645,269568673
14098,5,24,149,5745,-89,-97,8,,269568717,28,16,269568689,269568717
14099,5,24,149,5745,-89,-97,8,,269568825,28,80,269568797,269568825
14100,5,12,149,5745,-77,-97,20,56:68:e2:c2:8d:d5,269569148,280,43,269568868,269569148
14101,5,12,149,5745,-60,-97,37,5e:29:73:5b:30:00,269570028,272,608,269569756,269570028
14102,5,12,149,5745,-71,-97,26,f6:0a:5c:59:72:df,269570361,476,-143,269569885,269570361
14103,5,12,149,5745,-53,-97,44,3e:d1:9b:c7:a4:de,269570916,544,11,269570372,269570916
14104,5,12,149,5745,-64,-97,33,fa:44:8d:e1:c7:1b,269574979,440,3623,269574539,269574979
14105,5,12,149,5745,-75,-97,22,3e:ef:29:c7:4b:17,269575509,468,62,269575041,269575509
14106,5,12,149,5745,-58,-97,39,3a:de:b0:2e:cd:45,269576596,468,619,269576128,269576596
14107,5,12,149,5745,-68,-97,29,22:ec:75:a8:8a:31,269577680,516,568,269577164,269577680
14108,5,12,149,5745,-60,-97,37,4a:ea:3c:f4:ce:b2,269579556,468,1408,269579088,269579556
14109,5,12,149,5745,-78,-97,19,56:68:e2:c2:8d:d5,269580193,476,161,269579717,269580193
14110,5,12,149,5745,-67,-97,30,b6:90:18:f6:b1:d4,269583756,468,3095,269583288,269583756
14111,5,12,149,5745,-64,-97,33,76:d6:6a:bb:b3:f5,269586149,468,1925,269585681,269586149
14112,5,12,149,5745,-74,-97,23,72:d1:72:1d:22:a1,269588543,480,1914,269588063,269588543
14113,5,12,149,5745,-69,-97,28,f2:da:61:dd:98:c5,269589111,468,100,269588643,269589111
14114,5,12,149,5745,-62,-97,35,9e:1f:b0:a7:b8:90,269590604,480,1013,269590124,269590604
14115,5,12,149,5745,-66,-97,31,a6:92:ad:b7:76:65,269592234,484,1146,269591750,269592234
14116,5,12,149,5745,-58,-97,39,5e:29:73:5b:30:00,269592771,540,-3,269592231,269592771
14117,5,12,149,5745,-68,-97,29,0a:e1:ab:b3:c3:a6,269593400,468,161,269592932,269593400
14118,5,12,149,5745,-62,-97,35,9e:1f:b0:a7:b8:90,269602670,284,8986,269602386,269602670
14119,5,6,149,5745,-84,-97,13,54:e4:3a:ec:fb:65,269603141,360,111,269602781,269603141
14120,5,12,149,5745,-71,-97,26,f6:0a:5c:59:72:df,269604581,280,1160,269604301,269604581
14121,5,12,149,5745,-66,-97,31,a6:92:ad:b7:76:65,269617317,284,12452,269617033,269617317
14122,5,12,149,5745,-67,-97,30,22:ec:75:a8:8a:31,269617653,244,92,269617409,269617653
14123,5,12,149,5745,-66,-97,31,f2:da:61:dd:98:c5,269634288,272,16363,269634016,269634288
14124,5,12,149,5745,-68,-97,29,0a:e1:ab:b3:c3:a6,269635384,272,824,269635112,269635384
14125,5,12,149,5745,-61,-97,36,3a:de:b0:2e:cd:45,269635744,272,88,269635472,269635744
14126,5,12,149,5745,-65,-97,32,fa:44:8d:e1:c7:1b,269636050,244,62,269635806,269636050
14127,5,12,149,5745,-55,-97,42,3e:d1:9b:c7:a4:de,269636337,544,-257,269635793,269636337
14128,5,12,149,5745,-68,-97,29,f6:0a:5c:59:72:df,269638391,476,1578,269637915,269638391
14129,5,12,149,5745,-61,-97,36,3a:de:b0:2e:cd:45,269639200,468,341,269638732,269639200
14130,5,12,149,5745,-74,-97,23,3e:ef:29:c7:4b:17,269640611,468,943,269640143,269640611
14131,5,12,149,5745,-65,-97,32,fa:44:8d:e1:c7:1b,269641115,440,64,269640675,269641115
14132,5,12,149,5745,-67,-97,30,f2:da:61:dd:98:c5,269641634,360,159,269641274,269641634
14133,5,12,149,5745,-68,-97,29,22:ec:75:a8:8a:31,269643018,516,868,269642502,269643018
14134,5,12,149,5745,-69,-97,28,f6:0a:5c:59:72:df,269643720,128,574,269643592,269643720
14135,5,12,149,5745,-76,-97,21,56:68:e2:c2:8d:d5,269645083,476,887,269644607,269645083
14136,5,12,149,5745,-70,-97,27,aa:b6:ae:27:64:4e,269647232,468,1681,269646764,269647232
14137,5,12,149,5745,-66,-97,31,b6:90:18:f6:b1:d4,269648887,468,1187,269648419,269648887
14138,5,12,149,5745,-65,-97,32,fa:44:8d:e1:c7:1b,269649508,360,261,269649148,269649508
14139,5,12,149,5745,-60,-97,37,4a:ea:3c:f4:ce:b2,269650001,468,25,269649533,269650001
14140,5,12,149,5745,-55,-97,42,3e:d1:9b:c7:a4:de,269650549,272,276,269650277,269650549
14141,5,12,149,5745,-65,-97,32,fa:44:8d:e1:c7:1b,269650946,260,137,269650686,269650946
14142,5,12,149,5745,-65,-97,32,76:d6:6a:bb:b3:f5,269651771,272,553,269651499,269651771
14143,5,12,149,5745,-65,-97,32,76:d6:6a:bb:b3:f5,269652062,468,-177,269651594,269652062
14144,5,12,149,5745,-65,-97,32,b6:90:18:f6:b1:d4,269652582,272,248,269652310,269652582
14145,5,12,149,5745,-60,-97,37,9e:1f:b0:a7:b8:90,269653644,480,582,269653164,269653644
14146,5,12,149,5745,-66,-97,31,f2:da:61:dd:98:c5,269654159,468,47,269653691,269654159
14147,5,12,149,5745,-77,-97,20,d2:00:04:7e:2c:ab,269655974,380,1435,269655594,269655974
14148,5,12,149,5745,-65,-97,32,a6:92:ad:b7:76:65,269656424,484,-34,269655940,269656424
14149,5,12,149,5745,-76,-97,21,d2:00:04:7e:2c:ab,269657106,440,242,269656666,269657106
14150,5,12,149,5745,-59,-97,38,5e:29:73:5b:30:00,269657659,540,13,269657119,269657659
14151,5,12,149,5745,-67,-97,30,0a:e1:ab:b3:c3:a6,269658280,468,153,269657812,269658280
14152,5,12,149,5745,-72,-97,25,72:d1:72:1d:22:a1,269659403,480,643,269658923,269659403
14153,5,12,149,5745,-64,-97,33,0a:b9:b7:b1:4d:fa,269660268,468,397,269659800,269660268
14154,5,12,149,5745,-60,-97,37,5e:29:73:5b:30:00,269668294,272,7754,269668022,269668294
14155,5,12,149,5745,-72,-97,25,72:d1:72:1d:22:a1,269668647,284,69,269668363,269668647
14156,5,24,149,5745,-89,-97,8,,269670493,32,1814,269670461,269670493
14157,5,12,149,5745,-85,-97,12,9a:24:38:da:96:bb,269672901,272,2136,269672629,269672901
14158,5,12,149,5745,-59,-97,38,4a:ea:3c:f4:ce:b2,269675598,272,2425,269675326,269675598
14159,5,12,149,5745,-76,-97,21,56:68:e2:c2:8d:d5,269684707,280,8829,269684427,269684707
14160,5,24,149,5745,-88,-97,9,,269688374,28,3639,269688346,269688374
14161,5,24,149,5745,-72,-97,25,,269697500,28,9098,269697472,269697500
14162,5,24,149,5745,-87,-97,10,,269697543,28,15,269697515,269697543
14163,5,24,149,5745,-87,-97,10,,269697652,28,81,269697624,269697652
14164,5,24,149,5745,-87,-97,10,,269699779,28,2099,269699751,269699779
14165,5,24,149,5745,-72,-97,25,,269700963,28,1156,269700935,269700963
14166,5,24,149,5745,-86,-97,11,,269701008,28,17,269700980,269701008
14167,5,24,149,5745,-87,-97,10,,269701116,28,80,269701088,269701116
14168,5,6,149,5745,-85,-97,12,54:e4:3a:ec:fb:65,269705542,360,4066,269705182,269705542
14169,5,12,149,5745,-66,-97,31,f2:da:61:dd:98:c5,269719276,468,13266,269718808,269719276
14170,5,12,149,5745,-66,-97,31,22:ec:75:a8:8a:31,269723510,244,3990,269723266,269723510
14171,5,12,149,5745,-66,-97,31,a6:92:ad:b7:76:65,269741016,284,17222,269740732,269741016
14172,5,12,149,5745,-55,-97,42,3e:d1:9b:c7:a4:de,269745609,272,4321,269745337,269745609
14173,5,12,149,5745,-67,-97,30,f2:da:61:dd:98:c5,269749571,272,3690,269749299,269749571
14174,5,12,149,5745,-67,-97,30,0a:e1:ab:b3:c3:a6,269755780,272,5937,269755508,269755780
14175,5,12,149,5745,-73,-97,24,3e:ef:29:c7:4b:17,269759568,272,3516,269759296,269759568
14176,5,12,149,5745,-64,-97,33,76:d6:6a:bb:b3:f5,269765259,272,5419,269764987,269765259
14177,5,12,149,5745,-62,-97,35,5e:29:73:5b:30:00,269778492,272,12961,269778220,269778492
14178,5,12,149,5745,-85,-97,12,9a:24:38:da:96:bb,269784864,272,6100,269784592,269784864
14179,5,6,149,5745,-87,-97,10,54:e4:3a:ec:fb:65,269807942,360,22718,269807582,269807942
14180,5,12,149,5745,-55,-97,42,3a:de:b0:2e:cd:45,269808519,272,305,269808247,269808519
14181,5,12,149,5745,-61,-97,36,9e:1f:b0:a7:b8:90,269809178,284,375,269808894,269809178
14182,5,24,149,5745,-88,-97,9,,269809787,32,577,269809755,269809787
14183,5,24,149,5745,-87,-97,10,,269828488,28,18673,269828460,269828488
14184,5,12,149,5745,-70,-97,27,fa:44:8d:e1:c7:1b,269832563,244,3831,269832319,269832563
14185,5,12,149,5745,-65,-97,32,b6:90:18:f6:b1:d4,269832842,272,7,269832570,269832842
14186,5,12,149,5745,-72,-97,25,72:d1:72:1d:22:a1,269833150,284,24,269832866,269833150
14187,5,12,149,5745,-69,-97,28,56:68:e2:c2:8d:d5,269834710,280,1280,269834430,269834710
14188,5,12,149,5745,-66,-97,31,22:ec:75:a8:8a:31,269839293,244,4339,269839049,269839293
14189,5,12,149,5745,-65,-97,32,f6:0a:5c:59:72:df,269840005,280,432,269839725,269840005
14190,5,12,149,5745,-62,-97,35,0a:b9:b7:b1:4d:fa,269856712,468,16239,269856244,269856712
14191,5,12,149,5745,-56,-97,41,3e:d1:9b:c7:a4:de,269862654,272,5670,269862382,269862654
14192,5,24,149,5745,-86,-97,11,,269870807,32,8121,269870775,269870807
14193,5,12,149,5745,-79,-97,18,3e:ef:29:c7:4b:17,269886654,272,15575,269886382,269886654
14194,5,24,149,5745,-85,-97,12,,269887266,32,580,269887234,269887266
14195,5,24,149,5745,-86,-97,11,,269887729,32,431,269887697,269887729
14196,5,24,149,5745,-85,-97,12,,269888193,28,436,269888165,269888193
14197,5,24,149,5745,-73,-97,24,,269889019,28,798,269888991,269889019
14198,5,24,149,5745,-85,-97,12,,269889063,28,16,269889035,269889063
14199,5,24,149,5745,-86,-97,11,,269889171,28,80,269889143,269889171
14200,5,24,149,5745,-73,-97,24,,269891049,28,1850,269891021,269891049
14201,5,24,149,5745,-84,-97,13,,269891093,28,16,269891065,269891093
14202,5,24,149,5745,-86,-97,11,,269891201,28,80,269891173,269891201
14203,5,12,149,5745,-62,-97,35,5e:29:73:5b:30:00,269894950,272,3477,269894678,269894950
14204,5,12,149,5745,-84,-97,13,9a:24:38:da:96:bb,269897671,272,2449,269897399,269897671
14205,5,12,149,5745,-66,-97,31,0a:e1:ab:b3:c3:a6,269905304,272,7361,269905032,269905304
14206,5,12,149,5745,-63,-97,34,76:d6:6a:bb:b3:f5,269910404,272,4828,269910132,269910404
14207,5,12,149,5745,-56,-97,41,3a:de:b0:2e:cd:45,269911099,272,423,269910827,269911099
14208,5,12,149,5745,-68,-97,29,f2:da:61:dd:98:c5,269911531,272,160,269911259,269911531
14209,5,12,149,5745,-62,-97,35,9e:1f:b0:a7:b8:90,269911938,284,123,269911654,269911938
14210,5,12,149,5745,-59,-97,38,4a:ea:3c:f4:ce:b2,269916281,272,4071,269916009,269916281
14211,5,24,149,5745,-85,-97,12,,269919260,32,2947,269919228,269919260
14212,5,24,149,5745,-73,-97,24,,269924038,28,4750,269924010,269924038
14213,5,24,149,5745,-84,-97,13,,269924083,28,17,269924055,269924083
14214,5,24,149,5745,-85,-97,12,,269924190,28,79,269924162,269924190
14215,5,12,149,5745,-66,-97,31,a6:92:ad:b7:76:65,269933447,284,8973,269933163,269933447
14216,5,12,149,5745,-63,-97,34,b6:90:18:f6:b1:d4,269934957,272,1238,269934685,269934957
14217,5,12,149,5745,-68,-97,29,fa:44:8d:e1:c7:1b,269935354,244,153,269935110,269935354
14218,5,12,149,5745,-76,-97,21,72:d1:72:1d:22:a1,269935652,284,14,269935368,269935652
14219,5,12,149,5745,-70,-97,27,56:68:e2:c2:8d:d5,269937093,280,1161,269936813,269937093
14220,5,24,149,5745,-73,-97,24,,269938357,28,1236,269938329,269938357
14221,5,24,149,5745,-85,-97,12,,269938401,28,16,269938373,269938401
14222,5,24,149,5745,-86,-97,11,,269938508,28,79,269938480,269938508
14223,5,24,149,5745,-85,-97,12,,269940003,28,1467,269939975,269940003
14224,5,24,149,5745,-86,-97,11,,269940356,28,325,269940328,269940356
14225,5,24,149,5745,-84,-97,13,,269941923,32,1535,269941891,269941923
14226,5,24,149,5745,-85,-97,12,,269942440,32,485,269942408,269942440
14227,5,24,149,5745,-84,-97,13,,269942957,28,489,269942929,269942957
14228,5,24,149,5745,-85,-97,12,,269946521,32,3532,269946489,269946521
14229,5,12,149,5745,-65,-97,32,22:ec:75:a8:8a:31,269956307,244,9542,269956063,269956307
14230,5,12,149,5745,-66,-97,31,a6:92:ad:b7:76:65,269970163,284,13572,269969879,269970163
14231,5,12,149,5745,-54,-97,43,3e:d1:9b:c7:a4:de,269979570,272,9135,269979298,269979570
14232,5,24,149,5745,-71,-97,26,,269984124,28,4526,269984096,269984124
14233,5,24,149,5745,-85,-97,12,,269984168,28,16,269984140,269984168
14234,5,24,149,5745,-85,-97,12,,269984276,28,80,269984248,269984276
14235,5,12,149,5745,-72,-97,25,fa:44:8d:e1:c7:1b,269984483,244,-37,269984239,269984483
14236,5,12,149,5745,-73,-97,24,3e:ef:29:c7:4b:17,269986924,272,2169,269986652,269986924
14237,5,12,149,5745,-70,-97,27,f2:da:61:dd:98:c5,269987857,272,661,269987585,269987857
14238,5,12,149,5745,-66,-97,31,76:d6:6a:bb:b3:f5,269990924,272,2795,269990652,269990924
14239,5,24,149,5745,-86,-97,11,,269999437,32,8481,269999405,269999437
14240,5,12,149,5745,-65,-97,32,b6:90:18:f6:b1:d4,270003406,272,3697,270003134,270003406
14241,5,12,149,5745,-73,-97,24,72:d1:72:1d:22:a1,270007426,284,3736,270007142,270007426
14242,5,12,149,5745,-67,-97,30,0a:e1:ab:b3:c3:a6,270011949,272,4251,270011677,270011949
14243,5,6,149,5745,-87,-97,10,54:e4:3a:ec:fb:65,270012744,360,435,270012384,270012744
14244,5,24,149,5745,-85,-97,12,,270013766,28,994,270013738,270013766
14245,5,24,149,5745,-85,-97,12,,270013812,28,18,270013784,270013812
14246,5,24,149,5745,-85,-97,12,,270013922,32,78,270013890,270013922
14247,5,12,149,5745,-60,-97,37,3a:de:b0:2e:cd:45,270014672,272,478,270014400,270014672
14248,5,12,149,5745,-59,-97,38,9e:1f:b0:a7:b8:90,270015062,284,106,270014778,270015062
14249,5,12,149,5745,-58,-97,39,4a:ea:3c:f4:ce:b2,270015812,272,478,270015540,270015812
14250,5,12,149,5745,-70,-97,27,56:68:e2:c2:8d:d5,270016650,280,558,270016370,270016650
14251,5,12,149,5745,-62,-97,35,5e:29:73:5b:30:00,270028799,272,11877,270028527,270028799
14252,5,24,149,5745,-86,-97,11,,270029498,28,671,270029470,270029498
14253,5,12,149,5745,-68,-97,29,f6:0a:5c:59:72:df,270031472,476,1498,270030996,270031472
14254,5,12,149,5745,-72,-97,25,3e:ef:29:c7:4b:17,270033477,468,1537,270033009,270033477
14255,5,24,149,5745,-86,-97,11,,270034159,28,654,270034131,270034159
14256,5,24,149,5745,-85,-97,12,,270034275,32,84,270034243,270034275
14257,5,12,149,5745,-75,-97,22,fa:44:8d:e1:c7:1b,270035106,440,391,270034666,270035106
14258,5,12,149,5745,-52,-97,45,3e:d1:9b:c7:a4:de,270036146,544,496,270035602,270036146
14259,5,12,149,5745,-66,-97,31,22:ec:75:a8:8a:31,270037517,516,855,270037001,270037517
14260,5,12,149,5745,-63,-97,34,0a:e1:ab:b3:c3:a6,270039346,360,1469,270038986,270039346
14261,5,12,149,5745,-66,-97,31,76:d6:6a:bb:b3:f5,270040564,288,930,270040276,270040564
14262,5,12,149,5745,-65,-97,32,b6:90:18:f6:b1:d4,270041777,468,745,270041309,270041777
14263,5,12,149,5745,-86,-97,11,9a:24:38:da:96:bb,270043392,824,791,270042568,270043392
14264,5,12,149,5745,-66,-97,31,76:d6:6a:bb:b3:f5,270044286,468,426,270043818,270044286
14265,5,12,149,5745,-63,-97,34,f2:da:61:dd:98:c5,270046940,468,2186,270046472,270046940
14266,5,12,149,5745,-56,-97,41,4a:ea:3c:f4:ce:b2,270047497,468,89,270047029,270047497
14267,5,12,149,5745,-70,-97,27,a6:92:ad:b7:76:65,270050019,484,2038,270049535,270050019
14268,5,12,149,5745,-62,-97,35,0a:e1:ab:b3:c3:a6,270050537,468,50,270050069,270050537
14269,5,12,149,5745,-68,-97,29,f6:0a:5c:59:72:df,270052657,280,1840,270052377,270052657
14270,5,12,149,5745,-72,-97,25,56:68:e2:c2:8d:d5,270053522,476,389,270053046,270053522
14271,5,12,149,5745,-60,-97,37,9e:1f:b0:a7:b8:90,270054185,480,183,270053705,270054185
14272,5,24,149,5745,-69,-97,28,,270061108,28,6895,270061080,270061108
14273,5,24,149,5745,-86,-97,11,,270061152,28,16,270061124,270061152
14274,5,24,149,5745,-86,-97,11,,270061260,28,80,270061232,270061260
14275,5,12,149,5745,-60,-97,37,9e:1f:b0:a7:b8:90,270061376,284,-168,270061092,270061376
14276,5,24,149,5745,-70,-97,27,,270061664,28,260,270061636,270061664
14277,5,24,149,5745,-86,-97,11,,270061708,28,16,270061680,270061708
14278,5,24,149,5745,-85,-97,12,,270061815,28,79,270061787,270061815
14279,5,24,149,5745,-86,-97,11,,270063001,32,1154,270062969,270063001
14280,5,24,149,5745,-86,-97,11,,270063546,32,513,270063514,270063546
14281,5,24,149,5745,-87,-97,10,,270064090,28,516,270064062,270064090
14282,5,24,149,5745,-85,-97,12,,270066890,28,2772,270066862,270066890
14283,5,24,149,5745,-70,-97,27,,270066934,28,16,270066906,270066934
14284,5,12,149,5745,-73,-97,24,72:d1:72:1d:22:a1,270068364,480,950,270067884,270068364
14285,5,12,149,5745,-70,-97,27,a6:92:ad:b7:76:65,270075925,284,7277,270075641,270075925
14286,5,12,149,5745,-66,-97,31,22:ec:75:a8:8a:31,270076628,244,459,270076384,270076628
14287,5,12,149,5745,-66,-97,31,0a:e1:ab:b3:c3:a6,270091935,272,15035,270091663,270091935
14288,5,12,149,5745,-52,-97,45,3e:d1:9b:c7:a4:de,270093357,272,1150,270093085,270093357
14289,5,12,149,5745,-65,-97,32,f2:da:61:dd:98:c5,270093682,272,53,270093410,270093682
14290,5,12,149,5745,-66,-97,31,fa:44:8d:e1:c7:1b,270093989,244,63,270093745,270093989
14291,5,12,149,5745,-66,-97,31,fa:44:8d:e1:c7:1b,270102140,440,7711,270101700,270102140
14292,5,12,149,5745,-74,-97,23,3e:ef:29:c7:4b:17,270105192,272,2780,270104920,270105192
14293,5,12,149,5745,-64,-97,33,76:d6:6a:bb:b3:f5,270106674,272,1210,270106402,270106674
14294,5,12,149,5745,-64,-97,33,f2:da:61:dd:98:c5,270112616,468,5474,270112148,270112616
14295,5,12,149,5745,-67,-97,30,a6:92:ad:b7:76:65,270114216,484,1116,270113732,270114216
14296,5,12,149,5745,-64,-97,33,0a:e1:ab:b3:c3:a6,270114743,468,59,270114275,270114743
14297,5,6,149,5745,-86,-97,11,54:e4:3a:ec:fb:65,270115243,360,140,270114883,270115243
14298,5,12,149,5745,-59,-97,38,3a:de:b0:2e:cd:45,270115693,272,178,270115421,270115693
14299,5,12,149,5745,-67,-97,30,b6:90:18:f6:b1:d4,270117200,272,1235,270116928,270117200
14300,5,24,149,5745,-87,-97,10,,270117568,28,340,270117540,270117568
14301,5,24,149,5745,-88,-97,9,,270117612,28,16,270117584,270117612
14302,5,24,149,5745,-87,-97,10,,270117720,32,76,270117688,270117720
14303,5,24,149,5745,-87,-97,10,,270117903,28,155,270117875,270117903
14304,5,24,149,5745,-86,-97,11,,270117947,28,16,270117919,270117947
14305,5,24,149,5745,-87,-97,10,,270118080,32,101,270118048,270118080
14306,5,24,149,5745,-88,-97,9,,270118228,28,120,270118200,270118228
14307,5,24,149,5745,-86,-97,11,,270118272,28,16,270118244,270118272
14308,5,24,149,5745,-87,-97,10,,270118391,32,87,270118359,270118391
14309,5,24,149,5745,-87,-97,10,,270118511,28,92,270118483,270118511
14310,5,24,149,5745,-87,-97,10,,270118555,28,16,270118527,270118555
14311,5,24,149,5745,-86,-97,11,,270118674,32,87,270118642,270118674
14312,5,24,149,5745,-86,-97,11,,270118842,28,140,270118814,270118842
14313,5,24,149,5745,-85,-97,12,,270118886,28,16,270118858,270118886
14314,5,24,149,5745,-86,-97,11,,270118994,32,76,270118962,270118994
14315,5,12,149,5745,-71,-97,26,72:d1:72:1d:22:a1,270119168,284,-110,270118884,270119168
14316,5,24,149,5745,-87,-97,10,,270121608,32,2408,270121576,270121608
14317,5,24,149,5745,-87,-97,10,,270122043,28,407,270122015,270122043
14318,5,24,149,5745,-88,-97,9,,270122087,28,16,270122059,270122087
14319,5,24,149,5745,-87,-97,10,,270122195,32,76,270122163,270122195
14320,5,24,149,5745,-87,-97,10,,270122310,32,83,270122278,270122310
14321,5,24,149,5745,-89,-97,8,,270122493,32,151,270122461,270122493
14322,5,24,149,5745,-88,-97,9,,270123029,28,508,270123001,270123029
14323,5,24,149,5745,-87,-97,10,,270127030,28,3973,270127002,270127030
14324,5,24,149,5745,-88,-97,9,,270128226,28,1168,270128198,270128226
14325,5,24,149,5745,-86,-97,11,,270128545,28,291,270128517,270128545
14326,5,24,149,5745,-69,-97,28,,270128808,28,235,270128780,270128808
14327,5,24,149,5745,-87,-97,10,,270128852,28,16,270128824,270128852
14328,5,24,149,5745,-88,-97,9,,270128960,28,80,270128932,270128960
14329,5,24,149,5745,-87,-97,10,,270129113,28,125,270129085,270129113
14330,5,24,149,5745,-88,-97,9,,270129316,28,175,270129288,270129316
14331,5,24,149,5745,-70,-97,27,,270129360,28,16,270129332,270129360
14332,5,12,149,5745,-60,-97,37,5e:29:73:5b:30:00,270129636,272,4,270129364,270129636
14333,5,24,149,5745,-70,-97,27,,270129975,28,311,270129947,270129975
14334,5,24,149,5745,-85,-97,12,,270130019,28,16,270129991,270130019
14335,5,24,149,5745,-88,-97,9,,270130126,28,79,270130098,270130126
14336,5,24,149,5745,-70,-97,27,,270131665,28,1511,270131637,270131665
14337,5,24,149,5745,-87,-97,10,,270131709,28,16,270131681,270131709
14338,5,24,149,5745,-86,-97,11,,270131817,28,80,270131789,270131817
14339,5,12,149,5745,-72,-97,25,56:68:e2:c2:8d:d5,270135776,280,3679,270135496,270135776
14340,5,24,149,5745,-87,-97,10,,270136153,28,349,270136125,270136153
14341,5,24,149,5745,-88,-97,9,,270136197,28,16,270136169,270136197
14342,5,24,149,5745,-88,-97,9,,270136306,32,77,270136274,270136306
14343,5,24,149,5745,-87,-97,10,,270138245,28,1911,270138217,270138245
14344,5,24,149,5745,-88,-97,9,,270138289,28,16,270138261,270138289
14345,5,24,149,5745,-88,-97,9,,270138418,32,97,270138386,270138418
14346,5,24,149,5745,-87,-97,10,,270139676,28,1230,270139648,270139676
14347,5,24,149,5745,-88,-97,9,,270139720,28,16,270139692,270139720
14348,5,24,149,5745,-88,-97,9,,270139832,32,80,270139800,270139832
14349,5,12,149,5745,-59,-97,38,4a:ea:3c:f4:ce:b2,270161811,468,21511,270161343,270161811
14350,5,12,149,5745,-72,-97,25,3e:ef:29:c7:4b:17,270165229,468,2950,270164761,270165229
14351,5,12,149,5745,-65,-97,32,fa:44:8d:e1:c7:1b,270166752,440,1083,270166312,270166752
14352,5,12,149,5745,-54,-97,43,3e:d1:9b:c7:a4:de,270168189,544,893,270167645,270168189
14353,5,12,149,5745,-65,-97,32,22:ec:75:a8:8a:31,270170090,516,1385,270169574,270170090
14354,5,12,149,5745,-70,-97,27,aa:b6:ae:27:64:4e,270172245,468,1687,270171777,270172245
14355,5,12,149,5745,-69,-97,28,b6:90:18:f6:b1:d4,270172901,468,188,270172433,270172901
14356,5,12,149,5745,-63,-97,34,76:d6:6a:bb:b3:f5,270177365,468,3996,270176897,270177365
14357,5,12,149,5745,-64,-97,33,f2:da:61:dd:98:c5,270177985,468,152,270177517,270177985
14358,5,12,149,5745,-68,-97,29,f6:0a:5c:59:72:df,270178600,280,335,270178320,270178600
14359,5,12,149,5745,-63,-97,34,0a:e1:ab:b3:c3:a6,270179977,468,909,270179509,270179977
14360,5,12,149,5745,-69,-97,28,a6:92:ad:b7:76:65,270180802,484,341,270180318,270180802
14361,5,12,149,5745,-61,-97,36,3a:de:b0:2e:cd:45,270182456,468,1186,270181988,270182456
14362,5,12,149,5745,-77,-97,20,d2:00:04:7e:2c:ab,270183588,440,692,270183148,270183588
14363,5,24,149,5745,-69,-97,28,,270184099,28,483,270184071,270184099
14364,5,24,149,5745,-88,-97,9,,270184143,28,16,270184115,270184143
14365,5,24,149,5745,-88,-97,9,,270184251,28,80,270184223,270184251
14366,5,12,149,5745,-65,-97,32,5e:29:73:5b:30:00,270185025,540,234,270184485,270185025
14367,5,12,149,5745,-63,-97,34,0a:b9:b7:b1:4d:fa,270185617,468,124,270185149,270185617
14368,5,12,149,5745,-68,-97,29,a6:92:ad:b7:76:65,270190803,284,4902,270190519,270190803
14369,5,12,149,5745,-62,-97,35,0a:e1:ab:b3:c3:a6,270191176,272,101,270190904,270191176
14370,5,12,149,5745,-60,-97,37,3a:de:b0:2e:cd:45,270192785,272,1337,270192513,270192785
14371,5,24,149,5745,-88,-97,9,,270195864,32,3047,270195832,270195864
14372,5,24,149,5745,-89,-97,8,,270196408,32,512,270196376,270196408
14373,5,24,149,5745,-88,-97,9,,270196953,28,517,270196925,270196953
14374,5,12,149,5745,-85,-97,12,9a:24:38:da:96:bb,270197566,272,341,270197294,270197566
14375,5,24,149,5745,-69,-97,28,,270198974,28,1380,270198946,270198974
14376,5,24,149,5745,-87,-97,10,,270199018,28,16,270198990,270199018
14377,5,24,149,5745,-88,-97,9,,270199126,28,80,270199098,270199126
14378,5,12,149,5745,-64,-97,33,76:d6:6a:bb:b3:f5,270207647,272,8249,270207375,270207647
14379,5,12,149,5745,-71,-97,26,3e:ef:29:c7:4b:17,270207963,272,44,270207691,270207963
14380,5,12,149,5745,-55,-97,42,3e:d1:9b:c7:a4:de,270208251,272,16,270207979,270208251
14381,5,12,149,5745,-66,-97,31,fa:44:8d:e1:c7:1b,270208567,244,72,270208323,270208567
14382,5,12,149,5745,-64,-97,33,f2:da:61:dd:98:c5,270208891,272,52,270208619,270208891
14383,5,24,149,5745,-88,-97,9,,270211435,28,2516,270211407,270211435
14384,5,6,149,5745,-87,-97,10,54:e4:3a:ec:fb:65,270217544,360,5749,270217184,270217544
14385,5,12,149,5745,-59,-97,38,9e:1f:b0:a7:b8:90,270218528,284,700,270218244,270218528
14386,5,24,149,5745,-87,-97,10,,270219333,28,777,270219305,270219333
14387,5,24,149,5745,-89,-97,8,,270219377,28,16,270219349,270219377
14388,5,24,149,5745,-89,-97,8,,270219485,32,76,270219453,270219485
14389,5,24,149,5745,-88,-97,9,,270219662,28,149,270219634,270219662
14390,5,24,149,5745,-87,-97,10,,270219982,28,292,270219954,270219982
14391,5,24,149,5745,-88,-97,9,,270221679,28,1669,270221651,270221679
14392,5,24,149,5745,-86,-97,11,,270222005,28,298,270221977,270222005
14393,5,24,149,5745,-90,-97,7,,270222049,28,16,270222021,270222049
14394,5,24,149,5745,-90,-97,7,,270222157,32,76,270222125,270222157
14395,5,24,149,5745,-87,-97,10,,270222662,28,477,270222634,270222662
14396,5,24,149,5745,-87,-97,10,,270222775,32,81,270222743,270222775
14397,5,24,149,5745,-87,-97,10,,270225217,32,2410,270225185,270225217
14398,5,12,149,5745,-70,-97,27,b6:90:18:f6:b1:d4,270236314,272,10825,270236042,270236314
14399,5,12,149,5745,-72,-97,25,72:d1:72:1d:22:a1,270242321,284,5723,270242037,270242321
14400,5,12,149,5745,-64,-97,33,f2:da:61:dd:98:c5,270243620,468,831,270243152,270243620
14401,5,12,149,5745,-63,-97,34,5e:29:73:5b:30:00,270246669,272,2777,270246397,270246669
14402,5,12,149,5745,-73,-97,24,56:68:e2:c2:8d:d5,270247254,280,305,270246974,270247254
14403,5,24,149,5745,-85,-97,12,,270266601,28,19319,270266573,270266601
14404,5,12,149,5745,-73,-97,24,f6:0a:5c:59:72:df,270290826,280,23945,270290546,270290826
14405,5,12,149,5745,-68,-97,29,22:ec:75:a8:8a:31,270298030,244,6960,270297786,270298030
14406,5,24,149,5745,-86,-97,11,,270306140,28,8082,270306112,270306140
14407,5,24,149,5745,-89,-97,8,,270306292,32,120,270306260,270306292
14408,5,12,149,5745,-87,-97,10,9a:24:38:da:96:bb,270310171,272,3607,270309899,270310171
14409,5,24,149,5745,-85,-97,12,,270310456,28,257,270310428,270310456
14410,5,24,149,5745,-86,-97,11,,270310838,28,354,270310810,270310838
14411,5,24,149,5745,-88,-97,9,,270310882,28,16,270310854,270310882
14412,5,24,149,5745,-85,-97,12,,270311243,28,333,270311215,270311243
14413,5,24,149,5745,-89,-97,8,,270314122,28,2851,270314094,270314122
14414,5,24,149,5745,-86,-97,11,,270314166,28,16,270314138,270314166
14415,5,24,149,5745,-85,-97,12,,270314275,32,77,270314243,270314275
14416,5,24,149,5745,-88,-97,9,,270315331,28,1028,270315303,270315331
14417,5,24,149,5745,-86,-97,11,,270315374,28,15,270315346,270315374
14418,5,24,149,5745,-85,-97,12,,270315483,32,77,270315451,270315483
14419,5,12,149,5745,-63,-97,34,0a:e1:ab:b3:c3:a6,270318774,272,3019,270318502,270318774
14420,5,6,149,5745,-90,-97,7,54:e4:3a:ec:fb:65,270319945,360,811,270319585,270319945
14421,5,12,149,5745,-56,-97,41,3a:de:b0:2e:cd:45,270320707,272,490,270320435,270320707
14422,5,24,149,5745,-86,-97,11,,270321067,32,328,270321035,270321067
14423,5,24,149,5745,-85,-97,12,,270321539,32,440,270321507,270321539
14424,5,12,149,5745,-58,-97,39,9e:1f:b0:a7:b8:90,270321581,284,-242,270321297,270321581
14425,5,24,149,5745,-85,-97,12,,270322012,28,403,270321984,270322012
14426,5,24,149,5745,-86,-97,11,,270322782,28,742,270322754,270322782
14427,5,12,149,5745,-55,-97,42,3e:d1:9b:c7:a4:de,270323057,272,3,270322785,270323057
14428,5,24,149,5745,-70,-97,27,,270323378,28,293,270323350,270323378
14429,5,24,149,5745,-85,-97,12,,270323422,28,16,270323394,270323422
14430,5,24,149,5745,-85,-97,12,,270323530,28,80,270323502,270323530
14431,5,12,149,5745,-65,-97,32,f2:da:61:dd:98:c5,270325428,272,1626,270325156,270325428
14432,5,24,149,5745,-69,-97,28,,270329495,28,4039,270329467,270329495
14433,5,24,149,5745,-86,-97,11,,270329539,28,16,270329511,270329539
14434,5,24,149,5745,-85,-97,12,,270329648,28,81,270329620,270329648
14435,5,24,149,5745,-70,-97,27,,270329830,28,154,270329802,270329830
14436,5,24,149,5745,-86,-97,11,,270329874,28,16,270329846,270329874
14437,5,24,149,5745,-86,-97,11,,270329986,28,84,270329958,270329986
14438,5,24,149,5745,-70,-97,27,,270330078,28,64,270330050,270330078
14439,5,24,149,5745,-85,-97,12,,270330230,28,124,270330202,270330230
14440,5,24,149,5745,-69,-97,28,,270330376,28,118,270330348,270330376
14441,5,24,149,5745,-85,-97,12,,270330420,28,16,270330392,270330420
14442,5,24,149,5745,-70,-97,27,,270330769,28,321,270330741,270330769
14443,5,24,149,5745,-85,-97,12,,270330813,28,16,270330785,270330813
14444,5,24,149,5745,-85,-97,12,,270330936,32,91,270330904,270330936
14445,5,24,149,5745,-70,-97,27,,270331070,28,106,270331042,270331070
14446,5,24,149,5745,-85,-97,12,,270331115,28,17,270331087,270331115
14447,5,24,149,5745,-85,-97,12,,270331223,28,80,270331195,270331223
14448,5,12,149,5745,-64,-97,33,76:d6:6a:bb:b3:f5,270331942,272,447,270331670,270331942
14449,5,12,149,5745,-72,-97,25,b6:90:18:f6:b1:d4,270342369,272,10155,270342097,270342369
14450,5,12,149,5745,-68,-97,29,a6:92:ad:b7:76:65,270343094,284,441,270342810,270343094
14451,5,12,149,5745,-68,-97,29,fa:44:8d:e1:c7:1b,270344673,244,1335,270344429,270344673
14452,5,12,149,5745,-73,-97,24,72:d1:72:1d:22:a1,270345186,284,229,270344902,270345186
14453,5,12,149,5745,-74,-97,23,56:68:e2:c2:8d:d5,270358927,280,13461,270358647,270358927
14454,5,12,149,5745,-65,-97,32,4a:ea:3c:f4:ce:b2,270359254,468,-141,270358786,270359254
14455,5,12,149,5745,-60,-97,37,5e:29:73:5b:30:00,270360347,272,821,270360075,270360347
14456,5,12,149,5745,-62,-97,35,0a:b9:b7:b1:4d:fa,270379760,468,18945,270379292,270379760
14457,5,24,149,5745,-85,-97,12,,270397632,28,17844,270397604,270397632
14458,5,24,149,5745,-85,-97,12,,270398003,28,343,270397975,270398003
14459,5,12,149,5745,-70,-97,27,3e:ef:29:c7:4b:17,270398252,272,-23,270397980,270398252
14460,5,24,149,5745,-88,-97,9,,270401003,28,2723,270400975,270401003
14461,5,24,149,5745,-85,-97,12,,270401047,28,16,270401019,270401047
14462,5,24,149,5745,-85,-97,12,,270401156,32,77,270401124,270401156
14463,5,12,149,5745,-69,-97,28,22:ec:75:a8:8a:31,270413873,244,12473,270413629,270413873
14464,5,24,149,5745,-85,-97,12,,270414222,28,321,270414194,270414222
14465,5,24,149,5745,-85,-97,12,,270414331,32,77,270414299,270414331
14466,5,24,149,5745,-85,-97,12,,270417846,28,3487,270417818,270417846
14467,5,24,149,5745,-85,-97,12,,270417954,32,76,270417922,270417954
14468,5,24,149,5745,-85,-97,12,,270419093,32,1107,270419061,270419093
14469,5,6,149,5745,-84,-97,13,54:e4:3a:ec:fb:65,270422346,360,2893,270421986,270422346
14470,5,12,149,5745,-87,-97,10,9a:24:38:da:96:bb,270423283,272,665,270423011,270423283
14471,5,12,149,5745,-61,-97,36,9e:1f:b0:a7:b8:90,270423616,284,49,270423332,270423616
14472,5,12,149,5745,-61,-97,36,0a:e1:ab:b3:c3:a6,270429188,272,5300,270428916,270429188
14473,5,12,149,5745,-57,-97,40,3a:de:b0:2e:cd:45,270433754,272,4294,270433482,270433754
14474,5,12,149,5745,-68,-97,29,f2:da:61:dd:98:c5,270435353,272,1327,270435081,270435353
14475,5,12,149,5745,-56,-97,41,3e:d1:9b:c7:a4:de,270440697,272,5072,270440425,270440697
14476,5,12,149,5745,-70,-97,27,a6:92:ad:b7:76:65,270445547,284,4566,270445263,270445547
14477,5,12,149,5745,-68,-97,29,fa:44:8d:e1:c7:1b,270446905,244,1114,270446661,270446905
14478,5,12,149,5745,-70,-97,27,b6:90:18:f6:b1:d4,270455244,272,8067,270454972,270455244
14479,5,12,149,5745,-75,-97,22,72:d1:72:1d:22:a1,270463289,284,7761,270463005,270463289
14480,5,12,149,5745,-60,-97,37,5e:29:73:5b:30:00,270477691,272,14130,270477419,270477691
14481,5,12,149,5745,-71,-97,26,3e:ef:29:c7:4b:17,270500521,272,22558,270500249,270500521
14482,5,24,149,5745,-87,-97,10,,270500880,28,331,270500852,270500880
14483,5,24,149,5745,-86,-97,11,,270501245,28,337,270501217,270501245
14484,5,24,149,5745,-86,-97,11,,270502062,28,789,270502034,270502062
14485,5,24,149,5745,-87,-97,10,,270504291,32,2197,270504259,270504291
14486,5,24,149,5745,-86,-97,11,,270515278,28,10959,270515250,270515278
14487,5,24,149,5745,-87,-97,10,,270516135,28,829,270516107,270516135
14488,5,6,149,5745,-85,-97,12,54:e4:3a:ec:fb:65,270524746,360,8251,270524386,270524746
14489,5,12,149,5745,-65,-97,32,76:d6:6a:bb:b3:f5,270525257,272,239,270524985,270525257
14490,5,12,149,5745,-62,-97,35,9e:1f:b0:a7:b8:90,270525689,284,148,270525405,270525689
14491,5,12,149,5745,-68,-97,29,22:ec:75:a8:8a:31,270531554,244,5621,270531310,270531554
14492,5,12,149,5745,-58,-97,39,3a:de:b0:2e:cd:45,270541278,272,9452,270541006,270541278
14493,5,24,149,5745,-86,-97,11,,270546785,28,5479,270546757,270546785
14494,5,24,149,5745,-87,-97,10,,270546913,32,96,270546881,270546913
14495,5,12,149,5745,-70,-97,27,a6:92:ad:b7:76:65,270547095,284,-102,270546811,270547095
14496,5,24,149,5745,-86,-97,11,,270548074,32,947,270548042,270548074
14497,5,12,149,5745,-74,-97,23,56:68:e2:c2:8d:d5,270550704,280,2350,270550424,270550704
14498,5,12,149,5745,-57,-97,40,3e:d1:9b:c7:a4:de,270551142,272,166,270550870,270551142
14499,5,12,149,5745,-64,-97,33,0a:e1:ab:b3:c3:a6,270551592,272,178,270551320,270551592
14500,5,12,149,5745,-67,-97,30,f2:da:61:dd:98:c5,270558155,272,6291,270557883,270558155
14501,5,12,149,5745,-65,-97,32,76:d6:6a:bb:b3:f5,270558741,272,314,270558469,270558741
14502,5,12,149,5745,-72,-97,25,b6:90:18:f6:b1:d4,270565061,272,6048,270564789,270565061
14503,5,24,149,5745,-73,-97,24,,270567762,28,2673,270567734,270567762
14504,5,24,149,5745,-87,-97,10,,270567806,28,16,270567778,270567806
14505,5,24,149,5745,-86,-97,11,,270567915,28,81,270567887,270567915
14506,5,24,149,5745,-73,-97,24,,270568008,28,65,270567980,270568008
14507,5,24,149,5745,-87,-97,10,,270568052,28,16,270568024,270568052
14508,5,24,149,5745,-86,-97,11,,270568160,28,80,270568132,270568160
14509,5,12,149,5745,-76,-97,21,72:d1:72:1d:22:a1,270581454,284,13010,270581170,270581454
14510,5,12,149,5745,-75,-97,22,56:68:e2:c2:8d:d5,270585295,280,3561,270585015,270585295
14511,5,12,149,5745,-59,-97,38,5e:29:73:5b:30:00,270589599,272,4032,270589327,270589599
14512,5,12,149,5745,-73,-97,24,3e:ef:29:c7:4b:17,270602493,272,12622,270602221,270602493
14513,5,12,149,5745,-69,-97,28,f6:0a:5c:59:72:df,270615679,280,12906,270615399,270615679
14514,5,12,149,5745,-61,-97,36,9e:1f:b0:a7:b8:90,270618352,284,2389,270618068,270618352
14515,5,12,149,5745,-70,-97,27,f6:0a:5c:59:72:df,270621893,476,3065,270621417,270621893
14516,5,12,149,5745,-73,-97,24,3e:ef:29:c7:4b:17,270623944,468,1583,270623476,270623944
14517,5,12,149,5745,-57,-97,40,3e:d1:9b:c7:a4:de,270624779,544,291,270624235,270624779
14518,5,12,149,5745,-75,-97,22,56:68:e2:c2:8d:d5,270625376,476,121,270624900,270625376
14519,5,12,149,5745,-70,-97,27,22:ec:75:a8:8a:31,270626003,516,111,270625487,270626003
14520,5,6,149,5745,-86,-97,11,54:e4:3a:ec:fb:65,270627146,360,783,270626786,270627146
14521,5,24,149,5745,-85,-97,12,,270631615,28,4441,270631587,270631615
14522,5,24,149,5745,-86,-97,11,,270631888,28,245,270631860,270631888
14523,5,12,149,5745,-67,-97,30,a6:92:ad:b7:76:65,270632880,284,708,270632596,270632880
14524,5,24,149,5745,-86,-97,11,,270633324,28,416,270633296,270633324
14525,5,12,149,5745,-70,-97,27,b6:90:18:f6:b1:d4,270633713,468,-79,270633245,270633713
14526,5,24,149,5745,-86,-97,11,,270634759,28,1018,270634731,270634759
14527,5,24,149,5745,-85,-97,12,,270634900,32,109,270634868,270634900
14528,5,12,149,5745,-64,-97,33,76:d6:6a:bb:b3:f5,270636406,468,1038,270635938,270636406
14529,5,12,149,5745,-68,-97,29,a6:92:ad:b7:76:65,270639768,484,2878,270639284,270639768
14530,5,12,149,5745,-66,-97,31,f2:da:61:dd:98:c5,270640286,468,50,270639818,270640286
14531,5,12,149,5745,-66,-97,31,0a:e1:ab:b3:c3:a6,270641303,468,549,270640835,270641303
14532,5,12,149,5745,-74,-97,23,72:d1:72:1d:22:a1,270641832,480,49,270641352,270641832
14533,5,12,149,5745,-58,-97,39,5e:29:73:5b:30:00,270642346,540,-26,270641806,270642346
14534,5,12,149,5745,-57,-97,40,3a:de:b0:2e:cd:45,270642940,468,126,270642472,270642940
14535,5,12,149,5745,-61,-97,36,9e:1f:b0:a7:b8:90,270644478,480,1058,270643998,270644478
14536,5,12,149,5745,-84,-97,13,9a:24:38:da:96:bb,270646381,272,1631,270646109,270646381
14537,5,12,149,5745,-66,-97,31,0a:e1:ab:b3:c3:a6,270648947,272,2294,270648675,270648947
14538,5,12,149,5745,-71,-97,26,22:ec:75:a8:8a:31,270649289,244,98,270649045,270649289
14539,5,12,149,5745,-67,-97,30,f2:da:61:dd:98:c5,270650665,272,1104,270650393,270650665
14540,5,12,149,5745,-57,-97,40,3a:de:b0:2e:cd:45,270651917,272,980,270651645,270651917
14541,5,12,149,5745,-64,-97,33,76:d6:6a:bb:b3:f5,270666422,272,14233,270666150,270666422
14542,5,12,149,5745,-70,-97,27,b6:90:18:f6:b1:d4,270667657,272,963,270667385,270667657
14543,5,12,149,5745,-73,-97,24,72:d1:72:1d:22:a1,270669081,284,1140,270668797,270669081
14544,5,12,149,5745,-55,-97,42,3e:d1:9b:c7:a4:de,270682677,272,13324,270682405,270682677
14545,5,12,149,5745,-76,-97,21,56:68:e2:c2:8d:d5,270683433,280,476,270683153,270683433
14546,5,24,149,5745,-85,-97,12,,270684816,28,1355,270684788,270684816
14547,5,12,149,5745,-73,-97,24,f6:0a:5c:59:72:df,270686433,476,1141,270685957,270686433
14548,5,12,149,5745,-73,-97,24,3e:ef:29:c7:4b:17,270688583,468,1682,270688115,270688583
14549,5,24,149,5745,-85,-97,12,,270689310,32,695,270689278,270689310
14550,5,12,149,5745,-63,-97,34,4a:ea:3c:f4:ce:b2,270689377,468,-401,270688909,270689377
14551,5,12,149,5745,-55,-97,42,3e:d1:9b:c7:a4:de,270689924,544,3,270689380,270689924
14552,5,12,149,5745,-76,-97,21,56:68:e2:c2:8d:d5,270690547,476,147,270690071,270690547
14553,5,12,149,5745,-71,-97,26,22:ec:75:a8:8a:31,270691111,516,48,270690595,270691111
14554,5,12,149,5745,-72,-97,25,aa:b6:ae:27:64:4e,270695416,468,3837,270694948,270695416
14555,5,12,149,5745,-71,-97,26,b6:90:18:f6:b1:d4,270697251,468,1367,270696783,270697251
14556,5,12,149,5745,-63,-97,34,76:d6:6a:bb:b3:f5,270699663,468,1944,270699195,270699663
14557,5,12,149,5745,-60,-97,37,0a:b9:b7:b1:4d:fa,270700228,468,97,270699760,270700228
14558,5,12,149,5745,-66,-97,31,f2:da:61:dd:98:c5,270702262,468,1566,270701794,270702262
14559,5,12,149,5745,-84,-97,13,9a:24:38:da:96:bb,270702783,824,-303,270701959,270702783
14560,5,12,149,5745,-64,-97,33,0a:e1:ab:b3:c3:a6,270704374,468,1123,270703906,270704374
14561,5,12,149,5745,-68,-97,29,a6:92:ad:b7:76:65,270704876,484,18,270704392,270704876
14562,5,12,149,5745,-58,-97,39,3a:de:b0:2e:cd:45,270705821,468,477,270705353,270705821
14563,5,12,149,5745,-59,-97,38,5e:29:73:5b:30:00,270706621,540,260,270706081,270706621
14564,5,12,149,5745,-73,-97,24,72:d1:72:1d:22:a1,270707638,480,537,270707158,270707638
14565,5,12,149,5745,-64,-97,33,9e:1f:b0:a7:b8:90,270708845,480,727,270708365,270708845
14566,5,12,149,5745,-78,-97,19,d2:00:04:7e:2c:ab,270710871,440,1586,270710431,270710871
14567,5,12,149,5745,-59,-97,38,5e:29:73:5b:30:00,270716959,272,5816,270716687,270716959
14568,5,24,149,5745,-85,-97,12,,270719348,28,2361,270719320,270719348
14569,5,24,149,5745,-90,-97,7,,270719392,28,16,270719364,270719392
14570,5,24,149,5745,-85,-97,12,,270719593,28,173,270719565,270719593
14571,5,24,149,5745,-85,-97,12,,270719887,28,266,270719859,270719887
14572,5,12,149,5745,-73,-97,24,f6:0a:5c:59:72:df,270728016,280,7849,270727736,270728016
14573,5,6,149,5745,-85,-97,12,54:e4:3a:ec:fb:65,270729547,360,1171,270729187,270729547
14574,5,12,149,5745,-63,-97,34,9e:1f:b0:a7:b8:90,270734480,284,4649,270734196,270734480
14575,5,24,149,5745,-85,-97,12,,270754449,28,19941,270754421,270754449
14576,5,12,149,5745,-84,-97,13,9a:24:38:da:96:bb,270758605,272,3884,270758333,270758605
14577,5,12,149,5745,-69,-97,28,a6:92:ad:b7:76:65,270759273,284,384,270758989,270759273
14578,5,12,149,5745,-70,-97,27,22:ec:75:a8:8a:31,270760276,244,759,270760032,270760276
14579,5,12,149,5745,-66,-97,31,f2:da:61:dd:98:c5,270766791,272,6243,270766519,270766791
14580,5,12,149,5745,-64,-97,33,0a:e1:ab:b3:c3:a6,270769835,272,2772,270769563,270769835
14581,5,12,149,5745,-66,-97,31,f2:da:61:dd:98:c5,270770170,468,-133,270769702,270770170
14582,5,24,149,5745,-69,-97,28,,270771981,28,1783,270771953,270771981
14583,5,24,149,5745,-85,-97,12,,270772024,28,15,270771996,270772024
14584,5,24,149,5745,-85,-97,12,,270772133,28,81,270772105,270772133
14585,5,12,149,5745,-57,-97,40,3a:de:b0:2e:cd:45,270772212,272,-193,270771940,270772212
14586,5,24,149,5745,-86,-97,11,,270772892,32,648,270772860,270772892
14587,5,24,149,5745,-85,-97,12,,270773161,28,241,270773133,270773161
14588,5,24,149,5745,-85,-97,12,,270774404,32,1211,270774372,270774404
14589,5,12,149,5745,-77,-97,20,3e:ef:29:c7:4b:17,270780391,272,5715,270780119,270780391
14590,5,12,149,5745,-56,-97,41,3e:d1:9b:c7:a4:de,270780816,272,153,270780544,270780816
14591,5,24,149,5745,-85,-97,12,,270784033,32,3185,270784001,270784033
14592,5,24,149,5745,-84,-97,13,,270784175,32,110,270784143,270784175
14593,5,24,149,5745,-84,-97,13,,270784344,32,137,270784312,270784344
14594,5,24,149,5745,-86,-97,11,,270784494,32,118,270784462,270784494
14595,5,12,149,5745,-64,-97,33,76:d6:6a:bb:b3:f5,270787161,272,2395,270786889,270787161
14596,5,24,149,5745,-84,-97,13,,270799245,32,12052,270799213,270799245
14597,5,24,149,5745,-84,-97,13,,270799595,28,322,270799567,270799595
14598,5,24,149,5745,-84,-97,13,,270800035,28,412,270800007,270800035
14599,5,24,149,5745,-85,-97,12,,270801161,28,1098,270801133,270801161
14600,5,24,149,5745,-85,-97,12,,270803364,32,2171,270803332,270803364
14601,5,24,149,5745,-85,-97,12,,270803695,32,299,270803663,270803695
14602,5,24,149,5745,-85,-97,12,,270808538,32,4811,270808506,270808538
14603,5,24,149,5745,-85,-97,12,,270809691,32,1121,270809659,270809691
14604,5,12,149,5745,-57,-97,40,5e:29:73:5b:30:00,270818773,272,8810,270818501,270818773
14605,5,24,149,5745,-85,-97,12,,270820472,28,1671,270820444,270820472
14606,5,6,149,5745,-87,-97,10,54:e4:3a:ec:fb:65,270831947,360,11115,270831587,270831947
14607,5,12,149,5745,-72,-97,25,b6:90:18:f6:b1:d4,270856443,272,24224,270856171,270856443
14608,5,12,149,5745,-73,-97,24,72:d1:72:1d:22:a1,270856839,284,112,270856555,270856839
14609,5,12,149,5745,-76,-97,21,56:68:e2:c2:8d:d5,270858642,280,1523,270858362,270858642
14610,5,12,149,5745,-69,-97,28,a6:92:ad:b7:76:65,270871114,284,12188,270870830,270871114
14611,5,24,149,5745,-86,-97,11,,270872563,32,1417,270872531,270872563
14612,5,24,149,5745,-87,-97,10,,270872689,32,94,270872657,270872689
14613,5,12,149,5745,-71,-97,26,22:ec:75:a8:8a:31,270877305,244,4372,270877061,270877305
14614,5,12,149,5745,-81,-97,16,9a:24:38:da:96:bb,270877993,272,416,270877721,270877993
14615,5,12,149,5745,-58,-97,39,4a:ea:3c:f4:ce:b2,270882686,468,4225,270882218,270882686
14616,5,24,149,5745,-86,-97,11,,270892869,28,10155,270892841,270892869
14617,5,24,149,5745,-87,-97,10,,270893848,28,951,270893820,270893848
14618,5,24,149,5745,-85,-97,12,,270894183,28,307,270894155,270894183
14619,5,24,149,5745,-86,-97,11,,270897005,28,2794,270896977,270897005
14620,5,24,149,5745,-85,-97,12,,270897113,32,76,270897081,270897113
14621,5,12,149,5745,-55,-97,42,3e:d1:9b:c7:a4:de,270897990,272,605,270897718,270897990
14622,5,12,149,5745,-77,-97,20,3e:ef:29:c7:4b:17,270910414,272,12152,270910142,270910414
14623,5,24,149,5745,-87,-97,10,,270915977,28,5535,270915949,270915977
14624,5,24,149,5745,-86,-97,11,,270916085,32,76,270916053,270916085
14625,5,24,149,5745,-88,-97,9,,270920390,28,4277,270920362,270920390
14626,5,24,149,5745,-86,-97,11,,270920435,28,17,270920407,270920435
14627,5,24,149,5745,-88,-97,9,,270920543,32,76,270920511,270920543
14628,5,24,149,5745,-72,-97,25,,270921815,28,1244,270921787,270921815
14629,5,24,149,5745,-87,-97,10,,270921860,28,17,270921832,270921860
14630,5,24,149,5745,-87,-97,10,,270921967,28,79,270921939,270921967
14631,5,12,149,5745,-64,-97,33,0a:e1:ab:b3:c3:a6,270928693,272,6454,270928421,270928693
14632,5,6,149,5745,-87,-97,10,54:e4:3a:ec:fb:65,270934348,360,5295,270933988,270934348
14633,5,12,149,5745,-63,-97,34,f2:da:61:dd:98:c5,270935638,272,1018,270935366,270935638
14634,5,12,149,5745,-59,-97,38,76:d6:6a:bb:b3:f5,270936047,272,137,270935775,270936047
14635,5,12,149,5745,-65,-97,32,9e:1f:b0:a7:b8:90,270936994,284,663,270936710,270936994
14636,5,24,149,5745,-87,-97,10,,270938099,28,1077,270938071,270938099
14637,5,24,149,5745,-87,-97,10,,270939979,32,1848,270939947,270939979
14638,5,24,149,5745,-86,-97,11,,270940424,32,413,270940392,270940424
14639,5,24,149,5745,-86,-97,11,,270940870,28,418,270940842,270940870
14640,5,24,149,5745,-88,-97,9,,270945392,28,4494,270945364,270945392
14641,5,24,149,5745,-90,-97,7,,270948360,28,2940,270948332,270948360
14642,5,24,149,5745,-86,-97,11,,270949187,28,799,270949159,270949187
14643,5,24,149,5745,-87,-97,10,,270949295,32,76,270949263,270949295
14644,5,24,149,5745,-86,-97,11,,270957576,28,8253,270957548,270957576
14645,5,24,149,5745,-71,-97,26,,270957983,28,379,270957955,270957983
14646,5,24,149,5745,-85,-97,12,,270958028,28,17,270958000,270958028
14647,5,24,149,5745,-86,-97,11,,270958136,28,80,270958108,270958136
14648,5,12,149,5745,-73,-97,24,72:d1:72:1d:22:a1,270958896,284,476,270958612,270958896
14649,5,12,149,5745,-71,-97,26,b6:90:18:f6:b1:d4,270959395,272,227,270959123,270959395
14650,5,12,149,5745,-74,-97,23,56:68:e2:c2:8d:d5,270959852,280,177,270959572,270959852
14651,5,24,149,5745,-72,-97,25,,270983512,28,23632,270983484,270983512
14652,5,24,149,5745,-86,-97,11,,270983556,28,16,270983528,270983556
14653,5,24,149,5745,-85,-97,12,,270983664,28,80,270983636,270983664
14654,5,12,149,5745,-83,-97,14,9a:24:38:da:96:bb,270983986,272,50,270983714,270983986
14655,5,12,149,5745,-68,-97,29,a6:92:ad:b7:76:65,270989297,284,5027,270989013,270989297
14656,5,12,149,5745,-72,-97,25,22:ec:75:a8:8a:31,270994169,244,4628,270993925,270994169
14657,5,12,149,5745,-76,-97,21,3e:ef:29:c7:4b:17,271013040,272,18599,271012768,271013040
14658,5,12,149,5745,-55,-97,42,3e:d1:9b:c7:a4:de,271013671,272,359,271013399,271013671
14659,5,24,149,5745,-86,-97,11,,271014776,28,1077,271014748,271014776
14660,5,24,149,5745,-86,-97,11,,271014888,32,80,271014856,271014888
14661,5,24,149,5745,-85,-97,12,,271029232,28,14316,271029204,271029232
14662,5,24,149,5745,-89,-97,8,,271029276,28,16,271029248,271029276
14663,5,12,149,5745,-66,-97,31,0a:e1:ab:b3:c3:a6,271031245,272,1697,271030973,271031245
14664,5,6,149,5745,-85,-97,12,54:e4:3a:ec:fb:65,271036749,360,5144,271036389,271036749
14665,5,24,149,5745,-85,-97,12,,271037515,32,734,271037483,271037515
14666,5,12,149,5745,-63,-97,34,3a:de:b0:2e:cd:45,271037630,272,-157,271037358,271037630
14667,5,12,149,5745,-64,-97,33,f2:da:61:dd:98:c5,271038116,272,214,271037844,271038116
14668,5,12,149,5745,-60,-97,37,9e:1f:b0:a7:b8:90,271038511,284,111,271038227,271038511
14669,5,12,149,5745,-60,-97,37,76:d6:6a:bb:b3:f5,271038919,272,136,271038647,271038919
14670,5,12,149,5745,-63,-97,34,5e:29:73:5b:30:00,271052138,272,12947,271051866,271052138
14671,5,24,149,5745,-72,-97,25,,271059972,28,7806,271059944,271059972
14672,5,24,149,5745,-85,-97,12,,271060016,28,16,271059988,271060016
14673,5,24,149,5745,-85,-97,12,,271060124,28,80,271060096,271060124
14674,5,12,149,5745,-68,-97,29,b6:90:18:f6:b1:d4,271062200,272,1804,271061928,271062200
14675,5,12,149,5745,-74,-97,23,56:68:e2:c2:8d:d5,271063476,280,996,271063196,271063476
14676,5,12,149,5745,-74,-97,23,72:d1:72:1d:22:a1,271064116,284,356,271063832,271064116
14677,5,24,149,5745,-85,-97,12,,271066499,28,2355,271066471,271066499
14678,5,24,149,5745,-85,-97,12,,271066848,28,321,271066820,271066848
14679,5,24,149,5745,-85,-97,12,,271069702,28,2826,271069674,271069702
14680,5,24,149,5745,-85,-97,12,,271069810,32,76,271069778,271069810
14681,5,12,149,5745,-69,-97,28,f6:0a:5c:59:72:df,271069894,280,-196,271069614,271069894
14682,5,24,149,5745,-85,-97,12,,271074143,32,4217,271074111,271074143
14683,5,12,149,5745,-61,-97,36,9e:1f:b0:a7:b8:90,271077114,284,2687,271076830,271077114
14684,5,12,149,5745,-69,-97,28,f6:0a:5c:59:72:df,271079799,476,2209,271079323,271079799
14685,5,12,149,5745,-76,-97,21,3e:ef:29:c7:4b:17,271085413,468,5146,271084945,271085413
14686,5,12,149,5745,-54,-97,43,3e:d1:9b:c7:a4:de,271085916,544,-41,271085372,271085916
14687,5,12,149,5745,-74,-97,23,56:68:e2:c2:8d:d5,271086521,476,129,271086045,271086521
14688,5,12,149,5745,-71,-97,26,22:ec:75:a8:8a:31,271087157,516,120,271086641,271087157
14689,5,24,149,5745,-85,-97,12,,271087721,28,536,271087693,271087721
14690,5,12,149,5745,-67,-97,30,b6:90:18:f6:b1:d4,271091665,468,3476,271091197,271091665
14691,5,12,149,5745,-59,-97,38,76:d6:6a:bb:b3:f5,271093780,468,1647,271093312,271093780
14692,5,12,149,5745,-86,-97,11,9a:24:38:da:96:bb,271095204,272,1152,271094932,271095204
14693,5,12,149,5745,-86,-97,11,9a:24:38:da:96:bb,271097730,824,1702,271096906,271097730
14694,5,12,149,5745,-68,-97,29,0a:e1:ab:b3:c3:a6,271099200,468,1002,271098732,271099200
14695,5,12,149,5745,-67,-97,30,f2:da:61:dd:98:c5,271101791,468,2123,271101323,271101791
14696,5,12,149,5745,-75,-97,22,72:d1:72:1d:22:a1,271102975,480,704,271102495,271102975
14697,5,12,149,5745,-69,-97,28,0a:e1:ab:b3:c3:a6,271107629,272,4382,271107357,271107629
14698,5,12,149,5745,-76,-97,21,3e:ef:29:c7:4b:17,271108970,272,1069,271108698,271108970
14699,5,12,149,5745,-68,-97,29,f2:da:61:dd:98:c5,271110914,272,1672,271110642,271110914
14700,5,12,149,5745,-58,-97,39,76:d6:6a:bb:b3:f5,271125125,272,13939,271124853,271125125
14701,5,12,149,5745,-71,-97,26,22:ec:75:a8:8a:31,271125467,244,98,271125223,271125467
14702,5,12,149,5745,-54,-97,43,3e:d1:9b:c7:a4:de,271126816,272,1077,271126544,271126816
14703,5,12,149,5745,-67,-97,30,b6:90:18:f6:b1:d4,271127169,272,81,271126897,271127169
14704,5,12,149,5745,-75,-97,22,72:d1:72:1d:22:a1,271127530,284,77,271127246,271127530
14705,5,6,149,5745,-85,-97,12,54:e4:3a:ec:fb:65,271139149,360,11259,271138789,271139149
14706,5,12,149,5745,-58,-97,39,4a:ea:3c:f4:ce:b2,271146126,468,6509,271145658,271146126
14707,5,12,149,5745,-66,-97,31,0a:e1:ab:b3:c3:a6,271162748,468,16154,271162280,271162748
14708,5,12,149,5745,-75,-97,22,56:68:e2:c2:8d:d5,271165897,280,2869,271165617,271165897
14709,5,12,149,5745,-64,-97,33,5e:29:73:5b:30:00,271166924,272,755,271166652,271166924
14710,5,12,149,5745,-66,-97,31,f2:da:61:dd:98:c5,271167300,468,-92,271166832,271167300
14711,5,12,149,5745,-58,-97,39,4a:ea:3c:f4:ce:b2,271175155,272,7583,271174883,271175155
14712,5,12,149,5745,-63,-97,34,9e:1f:b0:a7:b8:90,271203163,284,27724,271202879,271203163
14713,5,12,149,5745,-64,-97,33,0a:e1:ab:b3:c3:a6,271205985,272,2550,271205713,271205985
14714,5,12,149,5745,-66,-97,31,a6:92:ad:b7:76:65,271206660,484,191,271206176,271206660
14715,5,12,149,5745,-85,-97,12,9a:24:38:da:96:bb,271210207,824,2723,271209383,271210207
14716,5,12,149,5745,-75,-97,22,d2:00:04:7e:2c:ab,271212589,412,1970,271212177,271212589
14717,5,12,149,5745,-78,-97,19,3e:ef:29:c7:4b:17,271214902,468,1845,271214434,271214902
14718,5,12,149,5745,-55,-97,42,3e:d1:9b:c7:a4:de,271216991,544,1545,271216447,271216991
14719,5,12,149,5745,-69,-97,28,22:ec:75:a8:8a:31,271217569,516,62,271217053,271217569
14720,5,12,149,5745,-70,-97,27,aa:b6:ae:27:64:4e,271221514,468,3477,271221046,271221514
14721,5,12,149,5745,-67,-97,30,b6:90:18:f6:b1:d4,271222719,468,737,271222251,271222719
14722,5,12,149,5745,-79,-97,18,3e:ef:29:c7:4b:17,271223493,272,502,271223221,271223493
14723,5,12,149,5745,-67,-97,30,f2:da:61:dd:98:c5,271225509,272,1744,271225237,271225509
14724,5,12,149,5745,-62,-97,35,0a:b9:b7:b1:4d:fa,271226193,468,216,271225725,271226193
14725,5,12,149,5745,-60,-97,37,76:d6:6a:bb:b3:f5,271227759,468,1098,271227291,271227759
14726,5,12,149,5745,-59,-97,38,3a:de:b0:2e:cd:45,271228290,468,63,271227822,271228290
14727,5,12,149,5745,-63,-97,34,0a:e1:ab:b3:c3:a6,271228909,468,151,271228441,271228909
14728,5,12,149,5745,-62,-97,35,5e:29:73:5b:30:00,271232246,540,2797,271231706,271232246
14729,5,12,149,5745,-67,-97,30,f2:da:61:dd:98:c5,271232831,468,117,271232363,271232831
14730,5,12,149,5745,-69,-97,28,22:ec:75:a8:8a:31,271239012,244,5937,271238768,271239012
14731,5,12,149,5745,-61,-97,36,76:d6:6a:bb:b3:f5,271239436,272,152,271239164,271239436
14732,5,12,149,5745,-67,-97,30,b6:90:18:f6:b1:d4,271240903,272,1195,271240631,271240903
14733,5,6,149,5745,-85,-97,12,54:e4:3a:ec:fb:65,271241550,360,287,271241190,271241550
14734,5,12,149,5745,-85,-97,12,9a:24:38:da:96:bb,271250257,272,8435,271249985,271250257
14735,5,12,149,5745,-55,-97,42,3e:d1:9b:c7:a4:de,271256925,272,6396,271256653,271256925
14736,5,12,149,5745,-76,-97,21,72:d1:72:1d:22:a1,271266362,284,9153,271266078,271266362
14737,5,12,149,5745,-75,-97,22,56:68:e2:c2:8d:d5,271267755,280,1113,271267475,271267755
14738,5,12,149,5745,-64,-97,33,5e:29:73:5b:30:00,271283694,272,15667,271283422,271283694
14739,5,24,149,5745,-86,-97,11,,271295876,28,12154,271295848,271295876
14740,5,24,149,5745,-86,-97,11,,271295984,32,76,271295952,271295984
14741,5,24,149,5745,-86,-97,11,,271314168,28,18156,271314140,271314168
14742,5,12,149,5745,-67,-97,30,0a:e1:ab:b3:c3:a6,271332877,272,18437,271332605,271332877
14743,5,12,149,5745,-66,-97,31,22:ec:75:a8:8a:31,271334697,244,1576,271334453,271334697
14744,5,12,149,5745,-64,-97,33,f2:da:61:dd:98:c5,271341498,272,6529,271341226,271341498
14745,5,6,149,5745,-84,-97,13,54:e4:3a:ec:fb:65,271343951,360,2093,271343591,271343951
14746,5,12,149,5745,-62,-97,35,9e:1f:b0:a7:b8:90,271347172,284,2937,271346888,271347172
14747,5,12,149,5745,-52,-97,45,3e:d1:9b:c7:a4:de,271352665,272,5221,271352393,271352665
14748,5,12,149,5745,-66,-97,31,76:d6:6a:bb:b3:f5,271356364,272,3427,271356092,271356364
14749,5,12,149,5745,-66,-97,31,b6:90:18:f6:b1:d4,271356699,272,63,271356427,271356699
14750,5,12,149,5745,-74,-97,23,72:d1:72:1d:22:a1,271368910,284,11927,271368626,271368910
14751,5,12,149,5745,-73,-97,24,56:68:e2:c2:8d:d5,271369335,280,145,271369055,271369335
14752,5,12,149,5745,-62,-97,35,5e:29:73:5b:30:00,271400928,272,31321,271400656,271400928
14753,5,12,149,5745,-57,-97,40,4a:ea:3c:f4:ce:b2,271420153,272,18953,271419881,271420153
14754,5,12,149,5745,-79,-97,18,3e:ef:29:c7:4b:17,271422175,272,1750,271421903,271422175
14755,5,12,149,5745,-65,-97,32,0a:e1:ab:b3:c3:a6,271446285,272,23838,271446013,271446285
14756,5,6,149,5745,-84,-97,13,54:e4:3a:ec:fb:65,271446588,360,-57,271446228,271446588
14757,5,12,149,5745,-63,-97,34,9e:1f:b0:a7:b8:90,271448966,284,2094,271448682,271448966
14758,5,12,149,5745,-66,-97,31,22:ec:75:a8:8a:31,271451774,244,2564,271451530,271451774
14759,5,12,149,5745,-64,-97,33,f2:da:61:dd:98:c5,271454548,272,2502,271454276,271454548
14760,5,12,149,5745,-54,-97,43,3e:d1:9b:c7:a4:de,271467967,272,13147,271467695,271467967
14761,5,12,149,5745,-64,-97,33,b6:90:18:f6:b1:d4,271470281,272,2042,271470009,271470281
14762,5,12,149,5745,-73,-97,24,72:d1:72:1d:22:a1,271470884,284,319,271470600,271470884
14763,5,12,149,5745,-83,-97,14,9a:24:38:da:96:bb,271479070,272,7914,271478798,271479070
14764,5,12,149,5745,-70,-97,27,56:68:e2:c2:8d:d5,271489113,280,9763,271488833,271489113
14765,5,12,149,5745,-62,-97,35,5e:29:73:5b:30:00,271516852,272,27467,271516580,271516852
14766,5,24,149,5745,-89,-97,8,,271520558,32,3674,271520526,271520558
14767,5,12,149,5745,-75,-97,22,3e:ef:29:c7:4b:17,271523755,272,2925,271523483,271523755
14768,5,24,149,5745,-90,-97,7,,271538646,28,14863,271538618,271538646
14769,5,6,149,5745,-84,-97,13,54:e4:3a:ec:fb:65,271548752,360,9746,271548392,271548752
14770,5,12,149,5745,-62,-97,35,9e:1f:b0:a7:b8:90,271550117,284,1081,271549833,271550117
14771,5,12,149,5745,-67,-97,30,76:d6:6a:bb:b3:f5,271550542,272,153,271550270,271550542
14772,5,12,149,5745,-66,-97,31,f6:0a:5c:59:72:df,271552672,280,1850,271552392,271552672
14773,5,12,149,5745,-67,-97,30,0a:e1:ab:b3:c3:a6,271554008,272,1064,271553736,271554008
14774,5,12,149,5745,-64,-97,33,f2:da:61:dd:98:c5,271565479,272,11199,271565207,271565479
14775,5,12,149,5745,-68,-97,29,22:ec:75:a8:8a:31,271567529,244,1806,271567285,271567529
14776,5,12,149,5745,-66,-97,31,b6:90:18:f6:b1:d4,271582957,272,15156,271582685,271582957
14777,5,12,149,5745,-64,-97,33,76:d6:6a:bb:b3:f5,271584686,272,1457,271584414,271584686
14778,5,12,149,5745,-56,-97,41,3e:d1:9b:c7:a4:de,271585040,272,82,271584768,271585040
14779,5,24,149,5745,-87,-97,10,,271585373,28,305,271585345,271585373
14780,5,24,149,5745,-86,-97,11,,271587069,28,1668,271587041,271587069
14781,5,24,149,5745,-87,-97,10,,271587177,32,76,271587145,271587177
14782,5,12,149,5745,-70,-97,27,72:d1:72:1d:22:a1,271589480,284,2019,271589196,271589480
14783,5,24,149,5745,-89,-97,8,,271593644,32,4132,271593612,271593644
14784,5,24,149,5745,-90,-97,7,,271605656,28,11984,271605628,271605656
14785,5,12,149,5745,-71,-97,26,56:68:e2:c2:8d:d5,271605892,280,-44,271605612,271605892
14786,5,12,149,5745,-73,-97,24,3e:ef:29:c7:4b:17,271625757,272,19593,271625485,271625757
14787,5,12,149,5745,-65,-97,32,5e:29:73:5b:30:00,271628845,272,2816,271628573,271628845
14788,5,12,149,5745,-60,-97,37,4a:ea:3c:f4:ce:b2,271630854,272,1737,271630582,271630854
14789,5,6,149,5745,-81,-97,16,54:e4:3a:ec:fb:65,271651152,360,19938,271650792,271651152
14790,5,12,149,5745,-63,-97,34,9e:1f:b0:a7:b8:90,271653759,284,2323,271653475,271653759
14791,5,12,149,5745,-65,-97,32,0a:e1:ab:b3:c3:a6,271664689,272,10658,271664417,271664689
14792,5,12,149,5745,-64,-97,33,f2:da:61:dd:98:c5,271667967,272,3006,271667695,271667967
14793,5,12,149,5745,-65,-97,32,f6:0a:5c:59:72:df,271670617,476,2174,271670141,271670617
14794,5,12,149,5745,-72,-97,25,3e:ef:29:c7:4b:17,271672090,468,1005,271671622,271672090
14795,5,12,149,5745,-60,-97,37,3e:d1:9b:c7:a4:de,271673411,544,777,271672867,271673411
14796,5,12,149,5745,-66,-97,31,22:ec:75:a8:8a:31,271674844,516,917,271674328,271674844
14797,5,12,149,5745,-63,-97,34,4a:ea:3c:f4:ce:b2,271675503,468,191,271675035,271675503
14798,5,12,149,5745,-70,-97,27,56:68:e2:c2:8d:d5,271676419,476,440,271675943,271676419
14799,5,12,149,5745,-65,-97,32,f2:da:61:dd:98:c5,271676956,468,69,271676488,271676956
14800,5,12,149,5745,-71,-97,26,3e:ef:29:c7:4b:17,271681796,272,4568,271681524,271681796
14801,5,12,149,5745,-65,-97,32,b6:90:18:f6:b1:d4,271682221,468,-43,271681753,271682221
14802,5,12,149,5745,-65,-97,32,b6:90:18:f6:b1:d4,271683056,272,563,271682784,271683056
14803,5,12,149,5745,-75,-97,22,72:d1:72:1d:22:a1,271683607,284,267,271683323,271683607
14804,5,12,149,5745,-64,-97,33,76:d6:6a:bb:b3:f5,271684718,468,643,271684250,271684718
14805,5,12,149,5745,-65,-97,32,0a:e1:ab:b3:c3:a6,271688478,468,3292,271688010,271688478
14806,5,12,149,5745,-62,-97,35,5e:29:73:5b:30:00,271690564,540,1546,271690024,271690564
14807,5,12,149,5745,-75,-97,22,72:d1:72:1d:22:a1,271692085,480,1041,271691605,271692085
14808,5,12,149,5745,-61,-97,36,9e:1f:b0:a7:b8:90,271694048,480,1483,271693568,271694048
14809,5,12,149,5745,-67,-97,30,22:ec:75:a8:8a:31,271697847,244,3555,271697603,271697847
14810,5,12,149,5745,-85,-97,12,9a:24:38:da:96:bb,271698758,272,639,271698486,271698758
14811,5,12,149,5745,-64,-97,33,76:d6:6a:bb:b3:f5,271699082,272,52,271698810,271699082
14812,5,12,149,5745,-69,-97,28,56:68:e2:c2:8d:d5,271699433,280,71,271699153,271699433
14813,5,12,149,5745,-56,-97,41,3e:d1:9b:c7:a4:de,271715148,272,15443,271714876,271715148
14814,5,12,149,5745,-70,-97,27,a6:92:ad:b7:76:65,271730983,484,15351,271730499,271730983
14815,5,12,149,5745,-83,-97,14,9a:24:38:da:96:bb,271732622,824,815,271731798,271732622
14816,5,12,149,5745,-62,-97,35,4a:ea:3c:f4:ce:b2,271735579,272,2685,271735307,271735579
14817,5,12,149,5745,-66,-97,31,f6:0a:5c:59:72:df,271735894,476,-161,271735418,271735894
14818,5,24,149,5745,-85,-97,12,,271737403,32,1477,271737371,271737403
14819,5,12,149,5745,-72,-97,25,3e:ef:29:c7:4b:17,271737719,468,-152,271737251,271737719
14820,5,24,149,5745,-84,-97,13,,271738330,28,583,271738302,271738330
14821,5,12,149,5745,-56,-97,41,3e:d1:9b:c7:a4:de,271738594,544,-280,271738050,271738594
14822,5,12,149,5745,-70,-97,27,56:68:e2:c2:8d:d5,271739227,476,157,271738751,271739227
14823,5,12,149,5745,-67,-97,30,22:ec:75:a8:8a:31,271739773,516,30,271739257,271739773
14824,5,24,149,5745,-84,-97,13,,271740459,32,654,271740427,271740459
14825,5,12,149,5745,-67,-97,30,f2:da:61:dd:98:c5,271740777,468,-150,271740309,271740777
14826,5,12,149,5745,-66,-97,31,f2:da:61:dd:98:c5,271741370,360,233,271741010,271741370
14827,5,24,149,5745,-87,-97,10,,271744336,28,2938,271744308,271744336
14828,5,24,149,5745,-84,-97,13,,271744381,28,17,271744353,271744381
14829,5,24,149,5745,-84,-97,13,,271744489,32,76,271744457,271744489
14830,5,12,149,5745,-70,-97,27,aa:b6:ae:27:64:4e,271744582,468,-375,271744114,271744582
14831,5,12,149,5745,-68,-97,29,b6:90:18:f6:b1:d4,271746256,468,1206,271745788,271746256
14832,5,12,149,5745,-61,-97,36,76:d6:6a:bb:b3:f5,271748460,468,1736,271747992,271748460
14833,5,12,149,5745,-60,-97,37,5e:29:73:5b:30:00,271749089,272,357,271748817,271749089
14834,5,12,149,5745,-61,-97,36,0a:b9:b7:b1:4d:fa,271750332,468,775,271749864,271750332
14835,5,12,149,5745,-69,-97,28,f6:0a:5c:59:72:df,271752336,280,1724,271752056,271752336
14836,5,12,149,5745,-66,-97,31,0a:e1:ab:b3:c3:a6,271752677,468,-127,271752209,271752677
14837,5,12,149,5745,-57,-97,40,3a:de:b0:2e:cd:45,271753577,468,432,271753109,271753577
14838,5,12,149,5745,-60,-97,37,5e:29:73:5b:30:00,271755174,540,1057,271754634,271755174
14839,5,12,149,5745,-72,-97,25,72:d1:72:1d:22:a1,271756307,480,653,271755827,271756307
14840,5,12,149,5745,-66,-97,31,9e:1f:b0:a7:b8:90,271757226,480,439,271756746,271757226
14841,5,24,149,5745,-84,-97,13,,271762501,28,5247,271762473,271762501
14842,5,24,149,5745,-86,-97,11,,271762545,28,16,271762517,271762545
14843,5,24,149,5745,-86,-97,11,,271762653,32,76,271762621,271762653
14844,5,12,149,5745,-65,-97,32,9e:1f:b0:a7:b8:90,271765274,284,2337,271764990,271765274
14845,5,12,149,5745,-65,-97,32,0a:e1:ab:b3:c3:a6,271780002,272,14456,271779730,271780002
14846,5,12,149,5745,-61,-97,36,f2:da:61:dd:98:c5,271783145,272,2871,271782873,271783145
14847,5,12,149,5745,-66,-97,31,22:ec:75:a8:8a:31,271793346,244,9957,271793102,271793346
14848,5,24,149,5745,-83,-97,14,,271798058,32,4680,271798026,271798058
14849,5,12,149,5745,-71,-97,26,f6:0a:5c:59:72:df,271803397,476,4863,271802921,271803397
14850,5,12,149,5745,-71,-97,26,3e:ef:29:c7:4b:17,271809836,272,6167,271809564,271809836
14851,5,12,149,5745,-69,-97,28,b6:90:18:f6:b1:d4,271811015,272,907,271810743,271811015
14852,5,24,149,5745,-86,-97,11,,271811475,28,432,271811447,271811475
14853,5,24,149,5745,-84,-97,13,,271811519,28,16,271811491,271811519
14854,5,24,149,5745,-85,-97,12,,271811627,32,76,271811595,271811627
14855,5,12,149,5745,-73,-97,24,72:d1:72:1d:22:a1,271812457,284,546,271812173,271812457
14856,5,12,149,5745,-57,-97,40,3e:d1:9b:c7:a4:de,271814047,272,1318,271813775,271814047
14857,5,12,149,5745,-64,-97,33,76:d6:6a:bb:b3:f5,271814432,272,113,271814160,271814432
14858,5,24,149,5745,-84,-97,13,,271816823,32,2359,271816791,271816823
14859,5,24,149,5745,-84,-97,13,,271817129,28,278,271817101,271817129
14860,5,12,149,5745,-71,-97,26,56:68:e2:c2:8d:d5,271820746,280,3337,271820466,271820746
14861,5,24,149,5745,-85,-97,12,,271826728,32,5950,271826696,271826728
14862,5,24,149,5745,-84,-97,13,,271827282,32,522,271827250,271827282
14863,5,24,149,5745,-84,-97,13,,271827835,28,525,271827807,271827835
14864,5,24,149,5745,-84,-97,13,,271831412,28,3549,271831384,271831412
14865,5,24,149,5745,-87,-97,10,,271831456,28,16,271831428,271831456
14866,5,24,149,5745,-86,-97,11,,271831564,32,76,271831532,271831564
14867,5,24,149,5745,-67,-97,30,,271831678,28,86,271831650,271831678
14868,5,24,149,5745,-84,-97,13,,271831722,28,16,271831694,271831722
14869,5,24,149,5745,-84,-97,13,,271831830,28,80,271831802,271831830
14870,5,24,149,5745,-67,-97,30,,271831984,28,126,271831956,271831984
14871,5,24,149,5745,-84,-97,13,,271832028,28,16,271832000,271832028
14872,5,24,149,5745,-83,-97,14,,271832136,28,80,271832108,271832136
14873,5,24,149,5745,-84,-97,13,,271842700,28,10536,271842672,271842700
14874,5,6,149,5745,-86,-97,11,54:e4:3a:ec:fb:65,271855953,360,12893,271855593,271855953
14875,5,12,149,5745,-61,-97,36,5e:29:73:5b:30:00,271858367,272,2142,271858095,271858367
14876,5,24,149,5745,-84,-97,13,,271860027,32,1628,271859995,271860027
14877,5,12,149,5745,-62,-97,35,4a:ea:3c:f4:ce:b2,271863580,272,3281,271863308,271863580
14878,5,12,149,5745,-68,-97,29,f6:0a:5c:59:72:df,271895059,280,31199,271894779,271895059
14879,5,6,149,5745,-73,-97,24,48:e7:da:41:38:ff,271906367,80,11228,271906287,271906367
14880,5,6,149,5745,-74,-97,23,48:e7:da:41:38:ff,271906484,80,37,271906404,271906484
14881,5,12,149,5745,-65,-97,32,22:ec:75:a8:8a:31,271909189,244,2461,271908945,271909189
14882,5,24,149,5745,-64,-97,33,,271919060,28,9843,271919032,271919060
14883,5,24,149,5745,-87,-97,10,,271919104,28,16,271919076,271919104
14884,5,24,149,5745,-86,-97,11,,271919212,28,80,271919184,271919212
14885,5,24,149,5745,-64,-97,33,,271919616,28,376,271919588,271919616
14886,5,24,149,5745,-86,-97,11,,271919660,28,16,271919632,271919660
14887,5,24,149,5745,-85,-97,12,,271919768,28,80,271919740,271919768
14888,5,24,149,5745,-64,-97,33,,271920031,28,235,271920003,271920031
14889,5,24,149,5745,-87,-97,10,,271920075,28,16,271920047,271920075
14890,5,24,149,5745,-85,-97,12,,271920183,28,80,271920155,271920183
14891,5,12,149,5745,-78,-97,19,9a:24:38:da:96:bb,271927153,272,6698,271926881,271927153
14892,5,12,149,5745,-53,-97,44,3e:d1:9b:c7:a4:de,271931170,272,3745,271930898,271931170
14893,5,12,149,5745,-72,-97,25,3e:ef:29:c7:4b:17,271934066,272,2624,271933794,271934066
14894,5,24,149,5745,-85,-97,12,,271936106,32,2008,271936074,271936106
14895,5,24,149,5745,-84,-97,13,,271936606,32,468,271936574,271936606
14896,5,24,149,5745,-85,-97,12,,271937105,28,471,271937077,271937105
14897,5,24,149,5745,-85,-97,12,,271937456,28,323,271937428,271937456
14898,5,24,149,5745,-86,-97,11,,271937658,28,174,271937630,271937658
14899,5,24,149,5745,-85,-97,12,,271937796,28,110,271937768,271937796
14900,5,24,149,5745,-85,-97,12,,271938078,28,254,271938050,271938078
14901,5,12,149,5745,-64,-97,33,0a:e1:ab:b3:c3:a6,271952673,272,14323,271952401,271952673
14902,5,6,149,5745,-87,-97,10,54:e4:3a:ec:fb:65,271958353,360,5320,271957993,271958353
14903,5,12,149,5745,-68,-97,29,76:d6:6a:bb:b3:f5,271958757,272,132,271958485,271958757
14904,5,12,149,5745,-64,-97,33,9e:1f:b0:a7:b8:90,271959830,284,789,271959546,271959830
14905,5,12,149,5745,-66,-97,31,f2:da:61:dd:98:c5,271961888,272,1786,271961616,271961888
14906,5,24,149,5745,-84,-97,13,,271965649,28,3733,271965621,271965649
14907,5,24,149,5745,-84,-97,13,,271965757,32,76,271965725,271965757
14908,5,12,149,5745,-61,-97,36,5e:29:73:5b:30:00,271975425,272,9396,271975153,271975425
14909,5,24,149,5745,-64,-97,33,,271979642,28,4189,271979614,271979642
14910,5,24,149,5745,-83,-97,14,,271979686,28,16,271979658,271979686
14911,5,24,149,5745,-83,-97,14,,271979806,32,88,271979774,271979806
14912,5,12,149,5745,-74,-97,23,72:d1:72:1d:22:a1,271982995,284,2905,271982711,271982995
14913,5,12,149,5745,-69,-97,28,56:68:e2:c2:8d:d5,271983404,280,129,271983124,271983404
14914,5,24,149,5745,-84,-97,13,,271984475,28,1043,271984447,271984475
14915,5,12,149,5745,-64,-97,33,b6:90:18:f6:b1:d4,271984826,272,79,271984554,271984826
14916,5,12,149,5745,-70,-97,27,f6:0a:5c:59:72:df,271996990,280,11884,271996710,271996990
14917,5,12,149,5745,-68,-97,29,22:ec:75:a8:8a:31,272027881,244,30647,272027637,272027881
14918,5,12,149,5745,-83,-97,14,9a:24:38:da:96:bb,272035791,272,7638,272035519,272035791
14919,5,12,149,5745,-71,-97,26,3e:ef:29:c7:4b:17,272036734,272,671,272036462,272036734
14920,5,24,149,5745,-86,-97,11,,272037210,32,444,272037178,272037210
14921,5,12,149,5745,-55,-97,42,3e:d1:9b:c7:a4:de,272043078,272,5596,272042806,272043078
14922,5,24,149,5745,-86,-97,11,,272054727,28,11621,272054699,272054727
14923,5,12,149,5745,-63,-97,34,0a:e1:ab:b3:c3:a6,272055222,272,223,272054950,272055222
14924,5,12,149,5745,-68,-97,29,76:d6:6a:bb:b3:f5,272060758,272,5264,272060486,272060758
14925,5,12,149,5745,-67,-97,30,f2:da:61:dd:98:c5,272061362,272,332,272061090,272061362
14926,5,12,149,5745,-62,-97,35,9e:1f:b0:a7:b8:90,272062267,284,621,272061983,272062267
14927,5,12,149,5745,-65,-97,32,b6:90:18:f6:b1:d4,272087285,272,24746,272087013,272087285
14928,5,12,149,5745,-76,-97,21,72:d1:72:1d:22:a1,272087595,284,26,272087311,272087595
14929,5,12,149,5745,-70,-97,27,56:68:e2:c2:8d:d5,272087959,280,84,272087679,272087959
14930,5,12,149,5745,-61,-97,36,5e:29:73:5b:30:00,272092463,272,4232,272092191,272092463
14931,5,12,149,5745,-62,-97,35,9e:1f:b0:a7:b8:90,272113579,284,20832,272113295,272113579
14932,5,12,149,5745,-65,-97,32,0a:e1:ab:b3:c3:a6,272123461,272,9610,272123189,272123461
14933,5,12,149,5745,-73,-97,24,d2:00:04:7e:2c:ab,272126512,272,2779,272126240,272126512
14934,5,12,149,5745,-67,-97,30,f2:da:61:dd:98:c5,272126854,272,70,272126582,272126854
14935,5,12,149,5745,-58,-97,39,3e:d1:9b:c7:a4:de,272132551,544,5153,272132007,272132551
14936,5,12,149,5745,-60,-97,37,4a:ea:3c:f4:ce:b2,272133129,468,110,272132661,272133129
14937,5,12,149,5745,-73,-97,24,3e:ef:29:c7:4b:17,272134001,468,404,272133533,272134001
14938,5,12,149,5745,-70,-97,27,56:68:e2:c2:8d:d5,272134701,476,224,272134225,272134701
14939,5,12,149,5745,-65,-97,32,f2:da:61:dd:98:c5,272136617,468,1448,272136149,272136617
14940,5,12,149,5745,-65,-97,32,b6:90:18:f6:b1:d4,272138990,468,1905,272138522,272138990
14941,5,12,149,5745,-66,-97,31,76:d6:6a:bb:b3:f5,272141168,272,1906,272140896,272141168
14942,5,12,149,5745,-70,-97,27,56:68:e2:c2:8d:d5,272141510,280,62,272141230,272141510
14943,5,12,149,5745,-66,-97,31,b6:90:18:f6:b1:d4,272141879,272,97,272141607,272141879
14944,5,12,149,5745,-75,-97,22,72:d1:72:1d:22:a1,272143447,284,1284,272143163,272143447
14945,5,12,149,5745,-68,-97,29,76:d6:6a:bb:b3:f5,272143785,468,-130,272143317,272143785
14946,5,12,149,5745,-73,-97,24,d2:00:04:7e:2c:ab,272145275,436,1054,272144839,272145275
14947,5,12,149,5745,-85,-97,12,9a:24:38:da:96:bb,272146763,272,1216,272146491,272146763
14948,5,12,149,5745,-67,-97,30,0a:e1:ab:b3:c3:a6,272147753,468,522,272147285,272147753
14949,5,12,149,5745,-73,-97,24,72:d1:72:1d:22:a1,272148768,480,535,272148288,272148768
14950,5,12,149,5745,-60,-97,37,5e:29:73:5b:30:00,272150353,540,1045,272149813,272150353
14951,5,12,149,5745,-62,-97,35,9e:1f:b0:a7:b8:90,272152486,480,1653,272152006,272152486
14952,5,12,149,5745,-68,-97,29,22:ec:75:a8:8a:31,272156609,244,3879,272156365,272156609
14953,5,6,149,5745,-87,-97,10,54:e4:3a:ec:fb:65,272163154,360,6185,272162794,272163154
14954,5,12,149,5745,-59,-97,38,3e:d1:9b:c7:a4:de,272174432,272,11006,272174160,272174432
14955,5,12,149,5745,-59,-97,38,4a:ea:3c:f4:ce:b2,272185827,272,11123,272185555,272185827
14956,5,24,149,5745,-84,-97,13,,272188194,32,2335,272188162,272188194
14957,5,12,149,5745,-70,-97,27,f6:0a:5c:59:72:df,272197890,476,9220,272197414,272197890
14958,5,12,149,5745,-72,-97,25,a6:92:ad:b7:76:65,272198967,484,593,272198483,272198967
14959,5,12,149,5745,-62,-97,35,f2:da:61:dd:98:c5,272200331,468,896,272199863,272200331
14960,5,24,149,5745,-84,-97,13,,272206680,28,6321,272206652,272206680
14961,5,12,149,5745,-71,-97,26,f6:0a:5c:59:72:df,272208078,280,1118,272207798,272208078
14962,5,12,149,5745,-61,-97,36,5e:29:73:5b:30:00,272208434,272,84,272208162,272208434
14963,5,12,149,5745,-72,-97,25,d2:00:04:7e:2c:ab,272210639,440,1765,272210199,272210639
14964,5,12,149,5745,-65,-97,32,0a:e1:ab:b3:c3:a6,272211338,468,231,272210870,272211338
14965,5,12,149,5745,-56,-97,41,3a:de:b0:2e:cd:45,272214667,468,2861,272214199,272214667
14966,5,12,149,5745,-64,-97,33,0a:e1:ab:b3:c3:a6,272221749,272,6810,272221477,272221749
14967,5,12,149,5745,-63,-97,34,9e:1f:b0:a7:b8:90,272228122,284,6089,272227838,272228122
14968,5,12,149,5745,-72,-97,25,a6:92:ad:b7:76:65,272240367,284,11961,272240083,272240367
14969,5,12,149,5745,-56,-97,41,3a:de:b0:2e:cd:45,272241129,272,490,272240857,272241129
14970,5,12,149,5745,-61,-97,36,f2:da:61:dd:98:c5,272242092,272,691,272241820,272242092
14971,5,12,149,5745,-72,-97,25,d2:00:04:7e:2c:ab,272243686,244,1350,272243442,272243686
14972,5,12,149,5745,-66,-97,31,22:ec:75:a8:8a:31,272254878,244,10948,272254634,272254878
14973,5,12,149,5745,-65,-97,32,76:d6:6a:bb:b3:f5,272255176,272,26,272254904,272255176
14974,5,12,149,5745,-74,-97,23,3e:ef:29:c7:4b:17,272255527,272,79,272255255,272255527
14975,5,12,149,5745,-64,-97,33,b6:90:18:f6:b1:d4,272256950,272,1151,272256678,272256950
14976,5,12,149,5745,-84,-97,13,9a:24:38:da:96:bb,272258567,272,1345,272258295,272258567
14977,5,12,149,5745,-71,-97,26,f6:0a:5c:59:72:df,272262683,476,3640,272262207,272262683
14978,5,12,149,5745,-72,-97,25,72:d1:72:1d:22:a1,272263827,284,860,272263543,272263827
14979,5,12,149,5745,-71,-97,26,a6:92:ad:b7:76:65,272264535,484,224,272264051,272264535
14980,5,12,149,5745,-54,-97,43,3e:d1:9b:c7:a4:de,272265161,544,82,272264617,272265161
14981,5,6,149,5745,-85,-97,12,54:e4:3a:ec:fb:65,272265737,360,216,272265377,272265737
14982,5,12,149,5745,-61,-97,36,f2:da:61:dd:98:c5,272266161,468,-44,272265693,272266161
14983,5,12,149,5745,-58,-97,39,4a:ea:3c:f4:ce:b2,272266708,468,79,272266240,272266708
14984,5,12,149,5745,-64,-97,33,b6:90:18:f6:b1:d4,272272512,468,5336,272272044,272272512
14985,5,12,149,5745,-56,-97,41,0a:b9:b7:b1:4d:fa,272273067,468,87,272272599,272273067
14986,5,12,149,5745,-64,-97,33,76:d6:6a:bb:b3:f5,272274614,468,1079,272274146,272274614
14987,5,12,149,5745,-61,-97,36,0a:e1:ab:b3:c3:a6,272276874,468,1792,272276406,272276874
14988,5,12,149,5745,-66,-97,31,22:ec:75:a8:8a:31,272277619,516,229,272277103,272277619
14989,5,12,149,5745,-74,-97,23,aa:b6:ae:27:64:4e,272279260,468,1173,272278792,272279260
14990,5,12,149,5745,-56,-97,41,3a:de:b0:2e:cd:45,272279772,468,44,272279304,272279772
14991,5,12,149,5745,-62,-97,35,5e:29:73:5b:30:00,272282237,540,1925,272281697,272282237
14992,5,12,149,5745,-71,-97,26,d2:00:04:7e:2c:ab,272283919,440,1242,272283479,272283919
14993,5,24,149,5745,-85,-97,12,,272284656,28,709,272284628,272284656
14994,5,24,149,5745,-89,-97,8,,272284808,32,120,272284776,272284808
14995,5,12,149,5745,-54,-97,43,3e:d1:9b:c7:a4:de,272288241,272,3161,272287969,272288241
14996,5,12,149,5745,-57,-97,40,4a:ea:3c:f4:ce:b2,272297328,272,8815,272297056,272297328
14997,5,12,149,5745,-71,-97,26,f6:0a:5c:59:72:df,272320467,280,22859,272320187,272320467
14998,5,12,149,5745,-63,-97,34,5e:29:73:5b:30:00,272320889,272,150,272320617,272320889
14999,5,12,149,5745,-71,-97,26,f6:0a:5c:59:72:df,272328682,476,7317,272328206,272328682
15000,5,12,149,5745,-72,-97,25,d2:00:04:7e:2c:ab,272348104,440,18982,272347664,272348104
15001,5,12,149,5745,-66,-97,31,0a:e1:ab:b3:c3:a6,272349605,272,1229,272349333,272349605
15002,5,12,149,5745,-73,-97,24,d2:00:04:7e:2c:ab,272355884,244,6035,272355640,272355884
15003,5,12,149,5745,-70,-97,27,a6:92:ad:b7:76:65,272356990,284,822,272356706,272356990
15004,5,12,149,5745,-64,-97,33,f2:da:61:dd:98:c5,272361425,272,4163,272361153,272361425
15005,5,12,149,5745,-54,-97,43,3a:de:b0:2e:cd:45,272361801,272,104,272361529,272361801
15006,5,12,149,5745,-67,-97,30,22:ec:75:a8:8a:31,272364165,244,2120,272363921,272364165
15007,5,6,149,5745,-86,-97,11,54:e4:3a:ec:fb:65,272367956,360,3431,272367596,272367956
15008,5,12,149,5745,-62,-97,35,9e:1f:b0:a7:b8:90,272369862,284,1622,272369578,272369862
15009,5,12,149,5745,-64,-97,33,76:d6:6a:bb:b3:f5,272380219,272,10085,272379947,272380219
15010,5,12,149,5745,-54,-97,43,3e:d1:9b:c7:a4:de,272382125,272,1634,272381853,272382125
15011,5,12,149,5745,-63,-97,34,b6:90:18:f6:b1:d4,272392000,272,9603,272391728,272392000
15012,5,12,149,5745,-74,-97,23,72:d1:72:1d:22:a1,272392506,284,222,272392222,272392506
15013,5,12,149,5745,-70,-97,27,56:68:e2:c2:8d:d5,272394711,280,1925,272394431,272394711
15014,5,24,149,5745,-87,-97,10,,272411638,28,16899,272411610,272411638
15015,5,24,149,5745,-84,-97,13,,272411682,28,16,272411654,272411682
15016,5,24,149,5745,-84,-97,13,,272411791,32,77,272411759,272411791
15017,5,24,149,5745,-83,-97,14,,272430406,28,18587,272430378,272430406
15018,5,24,149,5745,-86,-97,11,,272430450,28,16,272430422,272430450
15019,5,12,149,5745,-64,-97,33,5e:29:73:5b:30:00,272436824,272,6102,272436552,272436824
15020,5,12,149,5745,-73,-97,24,3e:ef:29:c7:4b:17,272446063,272,8967,272445791,272446063
15021,5,12,149,5745,-68,-97,29,0a:e1:ab:b3:c3:a6,272462455,272,16120,272462183,272462455
15022,5,6,149,5745,-86,-97,11,54:e4:3a:ec:fb:65,272470356,360,7541,272469996,272470356
15023,5,12,149,5745,-61,-97,36,9e:1f:b0:a7:b8:90,272470771,284,131,272470487,272470771
15024,5,12,149,5745,-75,-97,22,d2:00:04:7e:2c:ab,272472998,244,1983,272472754,272472998
15025,5,12,149,5745,-54,-97,43,3a:de:b0:2e:cd:45,272473784,272,514,272473512,272473784
15026,5,12,149,5745,-69,-97,28,f2:da:61:dd:98:c5,272474215,272,159,272473943,272474215
15027,5,12,149,5745,-65,-97,32,22:ec:75:a8:8a:31,272479920,244,5461,272479676,272479920
15028,5,12,149,5745,-84,-97,13,9a:24:38:da:96:bb,272483470,272,3278,272483198,272483470
15029,5,24,149,5745,-84,-97,13,,272491192,28,7694,272491164,272491192
15030,5,24,149,5745,-84,-97,13,,272491301,32,77,272491269,272491301
15031,5,12,149,5745,-70,-97,27,a6:92:ad:b7:76:65,272493761,284,2176,272493477,272493761
15032,5,12,149,5745,-78,-97,19,72:d1:72:1d:22:a1,272495050,284,1005,272494766,272495050
15033,5,12,149,5745,-63,-97,34,b6:90:18:f6:b1:d4,272497941,272,2619,272497669,272497941
15034,5,12,149,5745,-71,-97,26,56:68:e2:c2:8d:d5,272498679,280,458,272498399,272498679
15035,5,12,149,5745,-55,-97,42,3e:d1:9b:c7:a4:de,272499304,272,353,272499032,272499304
15036,5,24,149,5745,-85,-97,12,,272508960,28,9628,272508932,272508960
15037,5,24,149,5745,-88,-97,9,,272509112,32,120,272509080,272509112
15038,5,12,149,5745,-60,-97,37,4a:ea:3c:f4:ce:b2,272544599,272,35215,272544327,272544599
15039,5,12,149,5745,-74,-97,23,3e:ef:29:c7:4b:17,272548478,272,3607,272548206,272548478
15040,5,12,149,5745,-59,-97,38,5e:29:73:5b:30:00,272553731,272,4981,272553459,272553731
15041,5,6,149,5745,-86,-97,11,54:e4:3a:ec:fb:65,272572757,360,18666,272572397,272572757
15042,5,12,149,5745,-68,-97,29,76:d6:6a:bb:b3:f5,272573231,272,202,272572959,272573231
15043,5,12,149,5745,-61,-97,36,9e:1f:b0:a7:b8:90,272574079,284,564,272573795,272574079
15044,5,12,149,5745,-66,-97,31,0a:e1:ab:b3:c3:a6,272575428,272,1077,272575156,272575428
15045,5,12,149,5745,-54,-97,43,3a:de:b0:2e:cd:45,272585545,272,9845,272585273,272585545
15046,5,12,149,5745,-66,-97,31,f2:da:61:dd:98:c5,272585897,272,80,272585625,272585897
15047,5,12,149,5745,-69,-97,28,a6:92:ad:b7:76:65,272596050,284,9869,272595766,272596050
15048,5,12,149,5745,-76,-97,21,d2:00:04:7e:2c:ab,272596885,244,591,272596641,272596885
15049,5,12,149,5745,-64,-97,33,22:ec:75:a8:8a:31,272597164,244,35,272596920,272597164
15050,5,12,149,5745,-76,-97,21,72:d1:72:1d:22:a1,272597482,284,34,272597198,272597482
15051,5,12,149,5745,-81,-97,16,9a:24:38:da:96:bb,272599582,272,1828,272599310,272599582
15052,5,24,149,5745,-87,-97,10,,272602922,28,3312,272602894,272602922
15053,5,24,149,5745,-85,-97,12,,272602967,28,17,272602939,272602967
15054,5,24,149,5745,-84,-97,13,,272603075,32,76,272603043,272603075
15055,5,12,149,5745,-63,-97,34,b6:90:18:f6:b1:d4,272613333,272,9986,272613061,272613333
15056,5,12,149,5745,-72,-97,25,56:68:e2:c2:8d:d5,272614072,280,459,272613792,272614072
15057,5,12,149,5745,-55,-97,42,3e:d1:9b:c7:a4:de,272614751,272,407,272614479,272614751
15058,5,24,149,5745,-85,-97,12,,272630837,28,16058,272630809,272630837
15059,5,24,149,5745,-87,-97,10,,272630881,28,16,272630853,272630881
15060,5,24,149,5745,-85,-97,12,,272633956,28,3047,272633928,272633956
15061,5,24,149,5745,-85,-97,12,,272634065,32,77,272634033,272634065
15062,5,12,149,5745,-64,-97,33,4a:ea:3c:f4:ce:b2,272647904,272,13567,272647632,272647904
15063,5,12,149,5745,-73,-97,24,3e:ef:29:c7:4b:17,272649439,272,1263,272649167,272649439
15064,5,12,149,5745,-58,-97,39,5e:29:73:5b:30:00,272665644,272,15933,272665372,272665644
15065,5,12,149,5745,-67,-97,30,76:d6:6a:bb:b3:f5,272675105,272,9189,272674833,272675105
15066,5,12,149,5745,-65,-97,32,0a:e1:ab:b3:c3:a6,272686054,272,10677,272685782,272686054
15067,5,12,149,5745,-63,-97,34,9e:1f:b0:a7:b8:90,272691608,284,5270,272691324,272691608
15068,5,12,149,5745,-55,-97,42,3a:de:b0:2e:cd:45,272692467,272,587,272692195,272692467
15069,5,12,149,5745,-68,-97,29,a6:92:ad:b7:76:65,272696769,284,4018,272696485,272696769
15070,5,12,149,5745,-74,-97,23,d2:00:04:7e:2c:ab,272702021,244,5008,272701777,272702021
15071,5,12,149,5745,-84,-97,13,9a:24:38:da:96:bb,272708143,272,5850,272707871,272708143
15072,5,12,149,5745,-66,-97,31,76:d6:6a:bb:b3:f5,272713936,272,5521,272713664,272713936
15073,5,12,149,5745,-74,-97,23,3e:ef:29:c7:4b:17,272714287,272,79,272714015,272714287
15074,5,12,149,5745,-72,-97,25,56:68:e2:c2:8d:d5,272715079,280,512,272714799,272715079
15075,5,12,149,5745,-63,-97,34,b6:90:18:f6:b1:d4,272715611,272,260,272715339,272715611
15076,5,12,149,5745,-55,-97,42,3e:d1:9b:c7:a4:de,272715935,544,-220,272715391,272715935
15077,5,24,149,5745,-68,-97,29,,272716517,28,554,272716489,272716517
15078,5,24,149,5745,-86,-97,11,,272716561,28,16,272716533,272716561
15079,5,24,149,5745,-86,-97,11,,272716669,28,80,272716641,272716669
15080,5,12,149,5745,-74,-97,23,72:d1:72:1d:22:a1,272716740,284,-213,272716456,272716740
15081,5,24,149,5745,-86,-97,11,,272717558,28,790,272717530,272717558
15082,5,24,149,5745,-86,-97,11,,272717602,28,16,272717574,272717602
15083,5,24,149,5745,-85,-97,12,,272717710,32,76,272717678,272717710
15084,5,12,149,5745,-64,-97,33,76:d6:6a:bb:b3:f5,272719432,468,1254,272718964,272719432
15085,5,12,149,5745,-68,-97,29,f6:0a:5c:59:72:df,272721320,476,1412,272720844,272721320
15086,5,12,149,5745,-63,-97,34,b6:90:18:f6:b1:d4,272723965,468,2177,272723497,272723965
15087,5,12,149,5745,-67,-97,30,f2:da:61:dd:98:c5,272724575,468,142,272724107,272724575
15088,5,12,149,5745,-72,-97,25,56:68:e2:c2:8d:d5,272725194,476,143,272724718,272725194
15089,5,12,149,5745,-67,-97,30,a6:92:ad:b7:76:65,272727324,484,1646,272726840,272727324
15090,5,12,149,5745,-63,-97,34,4a:ea:3c:f4:ce:b2,272727951,468,159,272727483,272727951
15091,5,12,149,5745,-74,-97,23,d2:00:04:7e:2c:ab,272729452,440,1061,272729012,272729452
15092,5,12,149,5745,-64,-97,33,22:ec:75:a8:8a:31,272729972,244,276,272729728,272729972
15093,5,12,149,5745,-64,-97,33,22:ec:75:a8:8a:31,272734358,516,3870,272733842,272734358
15094,5,24,149,5745,-85,-97,12,,272735504,28,1118,272735476,272735504
15095,5,24,149,5745,-86,-97,11,,272735548,28,16,272735520,272735548
15096,5,24,149,5745,-85,-97,12,,272735656,32,76,272735624,272735656
15097,5,12,149,5745,-65,-97,32,0a:e1:ab:b3:c3:a6,272735988,468,-136,272735520,272735988
15098,5,12,149,5745,-74,-97,23,3e:ef:29:c7:4b:17,272738395,468,1939,272737927,272738395
15099,5,12,149,5745,-73,-97,24,72:d1:72:1d:22:a1,272740249,480,1374,272739769,272740249
15100,5,12,149,5745,-63,-97,34,9e:1f:b0:a7:b8:90,272740818,480,89,272740338,272740818
15101,5,12,149,5745,-54,-97,43,3e:d1:9b:c7:a4:de,272747092,272,6002,272746820,272747092
15102,5,12,149,5745,-62,-97,35,4a:ea:3c:f4:ce:b2,272751297,272,3933,272751025,272751297
15103,5,12,149,5745,-68,-97,29,f6:0a:5c:59:72:df,272768979,280,17402,272768699,272768979
15104,5,6,149,5745,-84,-97,13,54:e4:3a:ec:fb:65,272777558,360,8219,272777198,272777558
15105,5,12,149,5745,-54,-97,43,3e:d1:9b:c7:a4:de,272781321,544,3219,272780777,272781321
15106,5,12,149,5745,-64,-97,33,76:d6:6a:bb:b3:f5,272781909,468,120,272781441,272781909
15107,5,12,149,5745,-57,-97,40,0a:b9:b7:b1:4d:fa,272785919,468,3542,272785451,272785919
15108,5,12,149,5745,-69,-97,28,f6:0a:5c:59:72:df,272786565,476,170,272786089,272786565
15109,5,12,149,5745,-62,-97,35,5e:29:73:5b:30:00,272789865,540,2760,272789325,272789865
15110,5,12,149,5745,-63,-97,34,9e:1f:b0:a7:b8:90,272790486,480,141,272790006,272790486
15111,5,12,149,5745,-86,-97,11,9a:24:38:da:96:bb,272791018,824,-292,272790194,272791018
15112,5,24,149,5745,-85,-97,12,,272791867,28,821,272791839,272791867
15113,5,12,149,5745,-60,-97,37,4a:ea:3c:f4:ce:b2,272792050,468,-285,272791582,272792050
15114,5,12,149,5745,-67,-97,30,a6:92:ad:b7:76:65,272793121,484,587,272792637,272793121
15115,5,12,149,5745,-73,-97,24,d2:00:04:7e:2c:ab,272793668,440,107,272793228,272793668
15116,5,12,149,5745,-67,-97,30,f2:da:61:dd:98:c5,272795042,468,906,272794574,272795042
15117,5,12,149,5745,-66,-97,31,a6:92:ad:b7:76:65,272795544,284,218,272795260,272795544
15118,5,12,149,5745,-74,-97,23,d2:00:04:7e:2c:ab,272795891,380,-33,272795511,272795891
15119,5,12,149,5745,-55,-97,42,3a:de:b0:2e:cd:45,272796943,468,584,272796475,272796943
15120,5,12,149,5745,-62,-97,35,5e:29:73:5b:30:00,272797818,272,603,272797546,272797818
15121,5,12,149,5745,-55,-97,42,3a:de:b0:2e:cd:45,272798325,272,235,272798053,272798325
15122,5,12,149,5745,-73,-97,24,56:68:e2:c2:8d:d5,272798640,476,-161,272798164,272798640
15123,5,12,149,5745,-63,-97,34,9e:1f:b0:a7:b8:90,272799150,284,226,272798866,272799150
15124,5,12,149,5745,-72,-97,25,aa:b6:ae:27:64:4e,272800201,468,583,272799733,272800201
15125,5,24,149,5745,-86,-97,11,,272801075,32,842,272801043,272801075
15126,5,12,149,5745,-66,-97,31,0a:e1:ab:b3:c3:a6,272801531,468,-12,272801063,272801531
15127,5,12,149,5745,-76,-97,21,3e:ef:29:c7:4b:17,272802051,468,52,272801583,272802051
15128,5,12,149,5745,-72,-97,25,72:d1:72:1d:22:a1,272804660,480,2129,272804180,272804660
15129,5,12,149,5745,-72,-97,25,72:d1:72:1d:22:a1,272814074,284,9130,272813790,272814074
15130,5,24,149,5745,-87,-97,10,,272820726,28,6624,272820698,272820726
15131,5,12,149,5745,-87,-97,10,9a:24:38:da:96:bb,272821096,272,98,272820824,272821096
15132,5,12,149,5745,-65,-97,32,22:ec:75:a8:8a:31,272829137,244,7797,272828893,272829137
15133,5,12,149,5745,-63,-97,34,76:d6:6a:bb:b3:f5,272829461,272,52,272829189,272829461
15134,5,12,149,5745,-73,-97,24,56:68:e2:c2:8d:d5,272829957,280,216,272829677,272829957
15135,5,12,149,5745,-63,-97,34,b6:90:18:f6:b1:d4,272830650,272,421,272830378,272830650
15136,5,24,149,5745,-85,-97,12,,272837142,28,6464,272837114,272837142
15137,5,24,149,5745,-86,-97,11,,272837187,28,17,272837159,272837187
15138,5,24,149,5745,-86,-97,11,,272837295,32,76,272837263,272837295
15139,5,12,149,5745,-55,-97,42,3e:d1:9b:c7:a4:de,272842030,272,4463,272841758,272842030
15140,5,12,149,5745,-69,-97,28,f6:0a:5c:59:72:df,272853685,476,11179,272853209,272853685
15141,5,24,149,5745,-86,-97,11,,272855548,28,1835,272855520,272855548
15142,5,24,149,5745,-86,-97,11,,272855592,28,16,272855564,272855592
15143,5,24,149,5745,-85,-97,12,,272855700,32,76,272855668,272855700
15144,5,12,149,5745,-74,-97,23,d2:00:04:7e:2c:ab,272860321,440,4181,272859881,272860321
15145,5,12,149,5745,-64,-97,33,b6:90:18:f6:b1:d4,272861894,468,1105,272861426,272861894
15146,5,6,149,5745,-85,-97,12,54:e4:3a:ec:fb:65,272879959,360,17705,272879599,272879959
15147,5,12,149,5745,-70,-97,27,f6:0a:5c:59:72:df,272880909,280,670,272880629,272880909
15148,5,12,149,5745,-61,-97,36,5e:29:73:5b:30:00,272895195,272,14014,272894923,272895195
15149,5,24,149,5745,-68,-97,29,,272916900,28,21677,272916872,272916900
15150,5,24,149,5745,-86,-97,11,,272916944,28,16,272916916,272916944
15151,5,24,149,5745,-86,-97,11,,272917052,28,80,272917024,272917052
15152,5,12,149,5745,-74,-97,23,d2:00:04:7e:2c:ab,272927177,244,9881,272926933,272927177
15153,5,12,149,5745,-66,-97,31,b6:90:18:f6:b1:d4,272927484,468,-161,272927016,272927484
15154,5,12,149,5745,-86,-97,11,9a:24:38:da:96:bb,272933768,272,6012,272933496,272933768
15155,5,12,149,5745,-68,-97,29,22:ec:75:a8:8a:31,272938174,244,4162,272937930,272938174
15156,5,24,149,5745,-85,-97,12,,272943499,28,5297,272943471,272943499
15157,5,24,149,5745,-87,-97,10,,272943543,28,16,272943515,272943543
15158,5,24,149,5745,-86,-97,11,,272943651,32,76,272943619,272943651
15159,5,12,149,5745,-66,-97,31,b6:90:18:f6:b1:d4,272944509,272,586,272944237,272944509
15160,5,24,149,5745,-85,-97,12,,272947817,28,3280,272947789,272947817
15161,5,12,149,5745,-74,-97,23,3e:ef:29:c7:4b:17,272958374,272,10285,272958102,272958374
15162,5,12,149,5745,-55,-97,42,3e:d1:9b:c7:a4:de,272959238,272,592,272958966,272959238
15163,5,24,149,5745,-87,-97,10,,272961274,28,2008,272961246,272961274
15164,5,24,149,5745,-83,-97,14,,272961318,28,16,272961290,272961318
15165,5,24,149,5745,-84,-97,13,,272961427,32,77,272961395,272961427
15166,5,12,149,5745,-65,-97,32,0a:e1:ab:b3:c3:a6,272976682,272,14983,272976410,272976682
15167,5,6,149,5745,-87,-97,10,54:e4:3a:ec:fb:65,272982359,360,5317,272981999,272982359
15168,5,12,149,5745,-54,-97,43,3a:de:b0:2e:cd:45,272983353,272,722,272983081,272983353
15169,5,12,149,5745,-68,-97,29,9e:1f:b0:a7:b8:90,272983750,284,113,272983466,272983750
15170,5,12,149,5745,-64,-97,33,f2:da:61:dd:98:c5,272984073,272,51,272983801,272984073
15171,5,12,149,5745,-67,-97,30,76:d6:6a:bb:b3:f5,272984389,272,44,272984117,272984389
15172,5,24,149,5745,-70,-97,27,,272992283,28,7866,272992255,272992283
15173,5,24,149,5745,-86,-97,11,,272992327,28,16,272992299,272992327
15174,5,24,149,5745,-86,-97,11,,272992435,28,80,272992407,272992435
15175,5,12,149,5745,-67,-97,30,b6:90:18:f6:b1:d4,272992812,468,-91,272992344,272992812
15176,5,12,149,5745,-68,-97,29,a6:92:ad:b7:76:65,273005512,284,12416,273005228,273005512
15177,5,12,149,5745,-72,-97,25,72:d1:72:1d:22:a1,273007178,284,1382,273006894,273007178
15178,5,12,149,5745,-71,-97,26,56:68:e2:c2:8d:d5,273009087,280,1629,273008807,273009087
15179,5,12,149,5745,-63,-97,34,5e:29:73:5b:30:00,273011172,272,1813,273010900,273011172
15180,5,24,149,5745,-84,-97,13,,273012154,28,954,273012126,273012154
15181,5,24,149,5745,-86,-97,11,,273012198,28,16,273012170,273012198
15182,5,24,149,5745,-86,-97,11,,273012307,32,77,273012275,273012307
15183,5,24,149,5745,-84,-97,13,,273013264,28,929,273013236,273013264
15184,5,24,149,5745,-85,-97,12,,273013308,28,16,273013280,273013308
15185,5,24,149,5745,-86,-97,11,,273013420,32,80,273013388,273013420
15186,5,24,149,5745,-86,-97,11,,273026977,28,13529,273026949,273026977
15187,5,24,149,5745,-84,-97,13,,273027021,28,16,273026993,273027021
15188,5,24,149,5745,-85,-97,12,,273027129,32,76,273027097,273027129
15189,5,24,149,5745,-86,-97,11,,273027979,28,822,273027951,273027979
15190,5,24,149,5745,-84,-97,13,,273028023,28,16,273027995,273028023
15191,5,24,149,5745,-84,-97,13,,273028131,32,76,273028099,273028131
15192,5,24,149,5745,-85,-97,12,,273035266,28,7107,273035238,273035266
15193,5,24,149,5745,-86,-97,11,,273035310,28,16,273035282,273035310
15194,5,24,149,5745,-86,-97,11,,273035422,32,80,273035390,273035422
15195,5,12,149,5745,-73,-97,24,d2:00:04:7e:2c:ab,273039175,244,3509,273038931,273039175
15196,5,24,149,5745,-85,-97,12,,273040237,28,1034,273040209,273040237
15197,5,24,149,5745,-84,-97,13,,273040281,28,16,273040253,273040281
15198,5,24,149,5745,-84,-97,13,,273040389,32,76,273040357,273040389
15199,5,24,149,5745,-85,-97,12,,273040568,28,151,273040540,273040568
15200,5,24,149,5745,-85,-97,12,,273040612,28,16,273040584,273040612
15201,5,24,149,5745,-84,-97,13,,273040720,32,76,273040688,273040720
15202,5,24,149,5745,-85,-97,12,,273043336,28,2588,273043308,273043336
15203,5,24,149,5745,-86,-97,11,,273043380,28,16,273043352,273043380
15204,5,24,149,5745,-86,-97,11,,273043489,32,77,273043457,273043489
15205,5,24,149,5745,-86,-97,11,,273043857,28,340,273043829,273043857
15206,5,24,149,5745,-84,-97,13,,273043901,28,16,273043873,273043901
15207,5,24,149,5745,-85,-97,12,,273044009,32,76,273043977,273044009
15208,5,24,149,5745,-85,-97,12,,273044181,28,144,273044153,273044181
15209,5,24,149,5745,-85,-97,12,,273044226,28,17,273044198,273044226
15210,5,24,149,5745,-84,-97,13,,273044334,32,76,273044302,273044334
15211,5,24,149,5745,-85,-97,12,,273046670,28,2308,273046642,273046670
15212,5,24,149,5745,-86,-97,11,,273046714,28,16,273046686,273046714
15213,5,24,149,5745,-85,-97,12,,273046822,32,76,273046790,273046822
15214,5,24,149,5745,-85,-97,12,,273047760,28,910,273047732,273047760
15215,5,24,149,5745,-85,-97,12,,273047804,28,16,273047776,273047804
15216,5,24,149,5745,-85,-97,12,,273047913,32,77,273047881,273047913
15217,5,12,149,5745,-84,-97,13,9a:24:38:da:96:bb,273049154,272,969,273048882,273049154
15218,5,12,149,5745,-69,-97,28,22:ec:75:a8:8a:31,273051462,244,2064,273051218,273051462
15219,5,24,149,5745,-85,-97,12,,273051804,28,314,273051776,273051804
15220,5,24,149,5745,-85,-97,12,,273051848,28,16,273051820,273051848
15221,5,24,149,5745,-86,-97,11,,273051956,32,76,273051924,273051956
15222,5,12,149,5745,-75,-97,22,3e:ef:29:c7:4b:17,273059422,272,7194,273059150,273059422
15223,5,24,149,5745,-85,-97,12,,273061144,28,1694,273061116,273061144
15224,5,24,149,5745,-85,-97,12,,273061188,28,16,273061160,273061188
15225,5,24,149,5745,-85,-97,12,,273061300,32,80,273061268,273061300
15226,5,12,149,5745,-67,-97,30,b6:90:18:f6:b1:d4,273063895,272,2323,273063623,273063895
15227,5,24,149,5745,-84,-97,13,,273064517,28,594,273064489,273064517
15228,5,24,149,5745,-84,-97,13,,273064562,28,17,273064534,273064562
15229,5,24,149,5745,-85,-97,12,,273064669,32,75,273064637,273064669
15230,5,12,149,5745,-54,-97,43,3e:d1:9b:c7:a4:de,273076055,272,11114,273075783,273076055
15231,5,12,149,5745,-64,-97,33,0a:e1:ab:b3:c3:a6,273079375,272,3048,273079103,273079375
15232,5,24,149,5745,-86,-97,11,,273082578,28,3175,273082550,273082578
15233,5,24,149,5745,-84,-97,13,,273082622,28,16,273082594,273082622
15234,5,24,149,5745,-84,-97,13,,273082730,32,76,273082698,273082730
15235,5,6,149,5745,-84,-97,13,54:e4:3a:ec:fb:65,273084760,360,1670,273084400,273084760
15236,5,12,149,5745,-65,-97,32,9e:1f:b0:a7:b8:90,273085817,284,773,273085533,273085817
15237,5,12,149,5745,-56,-97,41,3a:de:b0:2e:cd:45,273086217,272,128,273085945,273086217
15238,5,12,149,5745,-66,-97,31,f2:da:61:dd:98:c5,273086570,272,81,273086298,273086570
15239,5,12,149,5745,-63,-97,34,76:d6:6a:bb:b3:f5,273086878,272,36,273086606,273086878
15240,5,24,149,5745,-86,-97,11,,273089166,28,2260,273089138,273089166
15241,5,24,149,5745,-85,-97,12,,273089211,28,17,273089183,273089211
15242,5,24,149,5745,-84,-97,13,,273089319,32,76,273089287,273089319
15243,5,24,149,5745,-86,-97,11,,273089502,28,155,273089474,273089502
15244,5,24,149,5745,-85,-97,12,,273089546,28,16,273089518,273089546
15245,5,24,149,5745,-84,-97,13,,273089654,32,76,273089622,273089654
15246,5,24,149,5745,-84,-97,13,,273092160,28,2478,273092132,273092160
15247,5,24,149,5745,-87,-97,10,,273092204,28,16,273092176,273092204
15248,5,24,149,5745,-87,-97,10,,273092316,32,80,273092284,273092316
15249,5,12,149,5745,-66,-97,31,a6:92:ad:b7:76:65,273108067,284,15467,273107783,273108067
15250,5,12,149,5745,-75,-97,22,72:d1:72:1d:22:a1,273109827,284,1476,273109543,273109827
15251,5,12,149,5745,-71,-97,26,56:68:e2:c2:8d:d5,273110334,280,227,273110054,273110334
15252,5,12,149,5745,-60,-97,37,4a:ea:3c:f4:ce:b2,273125765,272,15159,273125493,273125765
15253,5,12,149,5745,-61,-97,36,5e:29:73:5b:30:00,273127974,272,1937,273127702,273127974
15254,5,12,149,5745,-67,-97,30,f6:0a:5c:59:72:df,273134506,280,6252,273134226,273134506
15255,5,12,149,5745,-64,-97,33,9e:1f:b0:a7:b8:90,273137227,284,2437,273136943,273137227
15256,5,12,149,5745,-63,-97,34,0a:e1:ab:b3:c3:a6,273138714,272,1215,273138442,273138714
15257,5,12,149,5745,-67,-97,30,a6:92:ad:b7:76:65,273148221,284,9223,273147937,273148221
15258,5,12,149,5745,-73,-97,24,d2:00:04:7e:2c:ab,273152775,244,4310,273152531,273152775
15259,5,12,149,5745,-56,-97,41,3a:de:b0:2e:cd:45,273153406,272,359,273153134,273153406
15260,5,12,149,5745,-85,-97,12,9a:24:38:da:96:bb,273156196,272,2518,273155924,273156196
15261,5,12,149,5745,-67,-97,30,f2:da:61:dd:98:c5,273158433,272,1965,273158161,273158433
15262,5,12,149,5745,-75,-97,22,72:d1:72:1d:22:a1,273161741,284,3024,273161457,273161741
15263,5,12,149,5745,-68,-97,29,22:ec:75:a8:8a:31,273172380,244,10395,273172136,273172380
15264,5,12,149,5745,-63,-97,34,76:d6:6a:bb:b3:f5,273172677,272,25,273172405,273172677
15265,5,12,149,5745,-73,-97,24,3e:ef:29:c7:4b:17,273172992,272,43,273172720,273172992
15266,5,12,149,5745,-72,-97,25,56:68:e2:c2:8d:d5,273173892,280,620,273173612,273173892
15267,5,12,149,5745,-63,-97,34,b6:90:18:f6:b1:d4,273174430,272,266,273174158,273174430
15268,5,12,149,5745,-63,-97,34,76:d6:6a:bb:b3:f5,273175746,468,848,273175278,273175746
15269,5,12,149,5745,-59,-97,38,3e:d1:9b:c7:a4:de,273177106,544,816,273176562,273177106
15270,5,12,149,5745,-68,-97,29,f6:0a:5c:59:72:df,273180825,476,3243,273180349,273180825
15271,5,12,149,5745,-75,-97,22,72:d1:72:1d:22:a1,273181679,480,374,273181199,273181679
15272,5,12,149,5745,-60,-97,37,4a:ea:3c:f4:ce:b2,273182441,468,294,273181973,273182441
15273,5,12,149,5745,-62,-97,35,9e:1f:b0:a7:b8:90,273182980,480,59,273182500,273182980
15274,5,12,149,5745,-60,-97,37,5e:29:73:5b:30:00,273185304,540,1784,273184764,273185304
15275,5,12,149,5745,-74,-97,23,d2:00:04:7e:2c:ab,273187003,440,1259,273186563,273187003
15276,5,12,149,5745,-67,-97,30,f2:da:61:dd:98:c5,273188017,468,546,273187549,273188017
15277,5,12,149,5745,-63,-97,34,b6:90:18:f6:b1:d4,273191084,468,2599,273190616,273191084
15278,5,12,149,5745,-64,-97,33,0a:e1:ab:b3:c3:a6,273194232,468,2680,273193764,273194232
15279,5,12,149,5745,-72,-97,25,56:68:e2:c2:8d:d5,273194734,476,26,273194258,273194734
15280,5,12,149,5745,-69,-97,28,22:ec:75:a8:8a:31,273195245,516,-5,273194729,273195245
15281,5,12,149,5745,-74,-97,23,3e:ef:29:c7:4b:17,273198505,468,2792,273198037,273198505
15282,5,12,149,5745,-60,-97,37,3e:d1:9b:c7:a4:de,273205794,272,7017,273205522,273205794
15283,5,12,149,5745,-55,-97,42,3a:de:b0:2e:cd:45,273206524,468,262,273206056,273206524
15284,5,12,149,5745,-66,-97,31,f6:0a:5c:59:72:df,273222835,280,16031,273222555,273222835
15285,5,12,149,5745,-60,-97,37,4a:ea:3c:f4:ce:b2,273223888,272,781,273223616,273223888
15286,5,12,149,5745,-65,-97,32,0a:e1:ab:b3:c3:a6,273237515,272,13355,273237243,273237515
15287,5,12,149,5745,-73,-97,24,d2:00:04:7e:2c:ab,273252058,440,14103,273251618,273252058
15288,5,12,149,5745,-67,-97,30,f2:da:61:dd:98:c5,273252577,468,51,273252109,273252577
15289,5,12,149,5745,-67,-97,30,f2:da:61:dd:98:c5,273254933,272,2084,273254661,273254933
15290,5,12,149,5745,-64,-97,33,b6:90:18:f6:b1:d4,273255239,468,-162,273254771,273255239
15291,5,12,149,5745,-65,-97,32,9e:1f:b0:a7:b8:90,273255957,284,434,273255673,273255957
15292,5,12,149,5745,-55,-97,42,3a:de:b0:2e:cd:45,273256457,272,228,273256185,273256457
15293,5,12,149,5745,-73,-97,24,d2:00:04:7e:2c:ab,273257533,244,832,273257289,273257533
15294,5,12,149,5745,-65,-97,32,0a:e1:ab:b3:c3:a6,273259783,468,1782,273259315,273259783
15295,5,12,149,5745,-74,-97,23,3e:ef:29:c7:4b:17,273261608,468,1357,273261140,273261608
15296,5,12,149,5745,-55,-97,42,3a:de:b0:2e:cd:45,273265050,468,2974,273264582,273265050
15297,5,24,149,5745,-84,-97,13,,273269972,28,4894,273269944,273269972
15298,5,24,149,5745,-90,-97,7,,273270016,28,16,273269988,273270016
15299,5,24,149,5745,-90,-97,7,,273270124,32,76,273270092,273270124
15300,5,12,149,5745,-75,-97,22,72:d1:72:1d:22:a1,273279451,284,9043,273279167,273279451
15301,5,12,149,5745,-75,-97,22,3e:ef:29:c7:4b:17,273287635,272,7912,273287363,273287635
15302,5,24,149,5745,-90,-97,7,,273288651,28,988,273288623,273288651
15303,5,24,149,5745,-85,-97,12,,273288695,28,16,273288667,273288695
15304,5,24,149,5745,-84,-97,13,,273288803,32,76,273288771,273288803
15305,5,12,149,5745,-71,-97,26,56:68:e2:c2:8d:d5,273289256,280,173,273288976,273289256
15306,5,12,149,5745,-65,-97,32,b6:90:18:f6:b1:d4,273289625,272,97,273289353,273289625
15307,5,12,149,5745,-66,-97,31,76:d6:6a:bb:b3:f5,273290153,272,256,273289881,273290153
15308,5,12,149,5745,-86,-97,11,9a:24:38:da:96:bb,273292887,272,2462,273292615,273292887
15309,5,12,149,5745,-67,-97,30,22:ec:75:a8:8a:31,273303473,244,10342,273303229,273303473
15310,5,12,149,5745,-85,-97,12,9a:24:38:da:96:bb,273307199,824,2902,273306375,273307199
15311,5,12,149,5745,-59,-97,38,3e:d1:9b:c7:a4:de,273308057,544,314,273307513,273308057
15312,5,12,149,5745,-66,-97,31,76:d6:6a:bb:b3:f5,273308646,468,121,273308178,273308646
15313,5,12,149,5745,-59,-97,38,4a:ea:3c:f4:ce:b2,273310706,468,1592,273310238,273310706
15314,5,12,149,5745,-68,-97,29,f6:0a:5c:59:72:df,273311474,476,292,273310998,273311474
15315,5,6,149,5745,-84,-97,13,,273311973,44,455,273311929,273311973
15316,5,12,149,5745,-64,-97,33,0a:b9:b7:b1:4d:fa,273312177,468,-264,273311709,273312177
15317,5,12,149,5745,-60,-97,37,5e:29:73:5b:30:00,273316406,540,3689,273315866,273316406
15318,5,12,149,5745,-64,-97,33,f2:da:61:dd:98:c5,273317584,468,710,273317116,273317584
15319,5,12,149,5745,-73,-97,24,d2:00:04:7e:2c:ab,273318087,440,63,273317647,273318087
15320,5,12,149,5745,-59,-97,38,3e:d1:9b:c7:a4:de,273320487,272,2128,273320215,273320487
15321,5,12,149,5745,-66,-97,31,b6:90:18:f6:b1:d4,273321091,468,136,273320623,273321091
15322,5,12,149,5745,-68,-97,29,a6:92:ad:b7:76:65,273321603,484,28,273321119,273321603
15323,5,12,149,5745,-67,-97,30,aa:b6:ae:27:64:4e,273322509,468,438,273322041,273322509
15324,5,6,149,5745,-84,-97,13,,273323699,44,1146,273323655,273323699
15325,5,12,149,5745,-64,-97,33,0a:e1:ab:b3:c3:a6,273327376,468,3209,273326908,273327376
15326,5,12,149,5745,-68,-97,29,22:ec:75:a8:8a:31,273328172,516,280,273327656,273328172
15327,5,12,149,5745,-76,-97,21,3e:ef:29:c7:4b:17,273328777,468,137,273328309,273328777
15328,5,12,149,5745,-56,-97,41,3a:de:b0:2e:cd:45,273329288,468,43,273328820,273329288
15329,5,6,149,5745,-85,-97,12,,273333708,44,4376,273333664,273333708
15330,5,12,149,5745,-68,-97,29,f6:0a:5c:59:72:df,273338179,280,4191,273337899,273338179
15331,5,12,149,5745,-59,-97,38,4a:ea:3c:f4:ce:b2,273338539,272,88,273338267,273338539
15332,5,6,149,5745,-85,-97,12,,273343696,44,5113,273343652,273343696
15333,5,6,149,5745,-83,-97,14,,273353697,44,9957,273353653,273353697
15334,5,12,149,5745,-64,-97,33,0a:e1:ab:b3:c3:a6,273354707,272,738,273354435,273354707
15335,5,12,149,5745,-61,-97,36,5e:29:73:5b:30:00,273358266,272,3287,273357994,273358266
15336,5,6,149,5745,-84,-97,13,,273363701,44,5391,273363657,273363701
15337,5,24,149,5745,-84,-97,13,,273369631,28,5902,273369603,273369631
15338,5,24,149,5745,-85,-97,12,,273369910,28,251,273369882,273369910
15339,5,24,149,5745,-89,-97,8,,273369954,28,16,273369926,273369954
15340,5,24,149,5745,-89,-97,8,,273370063,32,77,273370031,273370063
15341,5,12,149,5745,-73,-97,24,d2:00:04:7e:2c:ab,273371560,244,1253,273371316,273371560
15342,5,6,149,5745,-83,-97,14,,273375703,44,4099,273375659,273375703
15343,5,12,149,5745,-69,-97,28,f6:0a:5c:59:72:df,273380193,476,4014,273379717,273380193
15344,5,12,149,5745,-87,-97,10,9a:24:38:da:96:bb,273381565,272,1100,273381293,273381565
15345,5,12,149,5745,-56,-97,41,3a:de:b0:2e:cd:45,273382042,272,205,273381770,273382042
15346,5,12,149,5745,-73,-97,24,d2:00:04:7e:2c:ab,273383420,440,938,273382980,273383420
15347,5,12,149,5745,-63,-97,34,f2:da:61:dd:98:c5,273383957,272,265,273383685,273383957
15348,5,12,149,5745,-65,-97,32,b6:90:18:f6:b1:d4,273385649,468,1224,273385181,273385649
15349,5,6,149,5745,-83,-97,14,,273387702,44,2009,273387658,273387702
15350,5,6,149,5745,-83,-97,14,54:e4:3a:ec:fb:65,273392164,360,4102,273391804,273392164
15351,5,12,149,5745,-75,-97,22,3e:ef:29:c7:4b:17,273392724,468,92,273392256,273392724
15352,5,12,149,5745,-64,-97,33,9e:1f:b0:a7:b8:90,273393271,284,263,273392987,273393271
15353,5,24,149,5745,-90,-97,7,,273393853,28,554,273393825,273393853
15354,5,24,149,5745,-85,-97,12,,273393897,28,16,273393869,273393897
15355,5,24,149,5745,-85,-97,12,,273394006,32,77,273393974,273394006
15356,5,12,149,5745,-67,-97,30,22:ec:75:a8:8a:31,273398884,244,4634,273398640,273398884
15357,5,6,149,5745,-83,-97,14,,273399224,44,296,273399180,273399224
15358,5,12,149,5745,-66,-97,31,b6:90:18:f6:b1:d4,273403706,272,4210,273403434,273403706
15359,5,12,149,5745,-74,-97,23,3e:ef:29:c7:4b:17,273404014,272,36,273403742,273404014
15360,5,12,149,5745,-68,-97,29,76:d6:6a:bb:b3:f5,273404488,272,202,273404216,273404488
15361,5,6,149,5745,-82,-97,15,,273407707,44,3175,273407663,273407707
15362,5,6,149,5745,-83,-97,14,,273415707,44,7956,273415663,273415707
15363,5,12,149,5745,-74,-97,23,72:d1:72:1d:22:a1,273416842,284,851,273416558,273416842
15364,5,12,149,5745,-57,-97,40,3e:d1:9b:c7:a4:de,273417554,272,440,273417282,273417554
15365,5,12,149,5745,-70,-97,27,56:68:e2:c2:8d:d5,273418498,280,664,273418218,273418498
15366,5,6,149,5745,-82,-97,15,,273423707,44,5165,273423663,273423707
15367,5,6,149,5745,-82,-97,15,,273437442,44,13691,273437398,273437442
15368,5,12,149,5745,-64,-97,33,b6:90:18:f6:b1:d4,273452027,468,14117,273451559,273452027
15369,5,12,149,5745,-74,-97,23,3e:ef:29:c7:4b:17,273459029,468,6534,273458561,273459029
15370,5,12,149,5745,-58,-97,39,4a:ea:3c:f4:ce:b2,273462320,272,3019,273462048,273462320
15371,5,12,149,5745,-65,-97,32,5e:29:73:5b:30:00,273475523,272,12931,273475251,273475523
15372,5,12,149,5745,-63,-97,34,0a:e1:ab:b3:c3:a6,273488883,272,13088,273488611,273488883
15373,5,12,149,5745,-73,-97,24,d2:00:04:7e:2c:ab,273491993,244,2866,273491749,273491993
15374,5,12,149,5745,-56,-97,41,3a:de:b0:2e:cd:45,273492273,272,8,273492001,273492273
15375,5,24,149,5745,-84,-97,13,,273492669,28,368,273492641,273492669
15376,5,24,149,5745,-87,-97,10,,273492713,28,16,273492685,273492713
15377,5,24,149,5745,-87,-97,10,,273492822,32,77,273492790,273492822
15378,5,6,149,5745,-84,-97,13,54:e4:3a:ec:fb:65,273494361,360,1179,273494001,273494361
15379,5,12,149,5745,-63,-97,34,9e:1f:b0:a7:b8:90,273495514,284,869,273495230,273495514
15380,5,12,149,5745,-85,-97,12,9a:24:38:da:96:bb,273496942,272,1156,273496670,273496942
15381,5,12,149,5745,-65,-97,32,f2:da:61:dd:98:c5,273497257,272,43,273496985,273497257
15382,5,24,149,5745,-88,-97,9,,273510992,28,13707,273510964,273510992
15383,5,24,149,5745,-84,-97,13,,273511036,28,16,273511008,273511036
15384,5,24,149,5745,-84,-97,13,,273511144,32,76,273511112,273511144
15385,5,12,149,5745,-67,-97,30,22:ec:75:a8:8a:31,273515987,244,4599,273515743,273515987
15386,5,12,149,5745,-74,-97,23,3e:ef:29:c7:4b:17,273516906,272,647,273516634,273516906
15387,5,12,149,5745,-65,-97,32,b6:90:18:f6:b1:d4,273517308,468,-66,273516840,273517308
15388,5,12,149,5745,-65,-97,32,b6:90:18:f6:b1:d4,273518260,272,680,273517988,273518260
15389,5,12,149,5745,-75,-97,22,72:d1:72:1d:22:a1,273519164,284,620,273518880,273519164
15390,5,12,149,5745,-69,-97,28,56:68:e2:c2:8d:d5,273520792,280,1348,273520512,273520792
15391,5,12,149,5745,-75,-97,22,3e:ef:29:c7:4b:17,273524185,468,2925,273523717,273524185
15392,5,12,149,5745,-54,-97,43,3e:d1:9b:c7:a4:de,273533250,272,8793,273532978,273533250
15393,5,12,149,5745,-56,-97,41,4a:ea:3c:f4:ce:b2,273575768,272,42246,273575496,273575768
15394,5,12,149,5745,-68,-97,29,f6:0a:5c:59:72:df,273580401,280,4353,273580121,273580401
15395,5,12,149,5745,-61,-97,36,5e:29:73:5b:30:00,273589023,272,8350,273588751,273589023
15396,5,12,149,5745,-65,-97,32,0a:e1:ab:b3:c3:a6,273591213,272,1918,273590941,273591213
15397,5,12,149,5745,-63,-97,34,76:d6:6a:bb:b3:f5,273596748,272,5263,273596476,273596748
15398,5,12,149,5745,-63,-97,34,9e:1f:b0:a7:b8:90,273598081,284,1049,273597797,273598081
15399,5,12,149,5745,-57,-97,40,3a:de:b0:2e:cd:45,273605180,272,6827,273604908,273605180
15400,5,12,149,5745,-65,-97,32,f2:da:61:dd:98:c5,273609797,272,4345,273609525,273609797
15401,5,12,149,5745,-71,-97,26,d2:00:04:7e:2c:ab,273621211,244,11170,273620967,273621211
15402,5,12,149,5745,-75,-97,22,72:d1:72:1d:22:a1,273621589,284,94,273621305,273621589
15403,5,12,149,5745,-70,-97,27,56:68:e2:c2:8d:d5,273622348,280,479,273622068,273622348
15404,5,12,149,5745,-66,-97,31,22:ec:75:a8:8a:31,273633060,244,10468,273632816,273633060
15405,5,12,149,5745,-62,-97,35,b6:90:18:f6:b1:d4,273633475,272,143,273633203,273633475
15406,5,12,149,5745,-54,-97,43,3e:d1:9b:c7:a4:de,273650348,272,16601,273650076,273650348
15407,5,12,149,5745,-74,-97,23,3e:ef:29:c7:4b:17,273674961,272,24341,273674689,273674961
15408,5,12,149,5745,-60,-97,37,76:d6:6a:bb:b3:f5,273698743,272,23510,273698471,273698743
15409,5,6,149,5745,-85,-97,12,54:e4:3a:ec:fb:65,273699162,360,59,273698802,273699162
15410,5,12,149,5745,-60,-97,37,5e:29:73:5b:30:00,273700868,272,1434,273700596,273700868
15411,5,12,149,5745,-64,-97,33,0a:e1:ab:b3:c3:a6,273709907,272,8767,273709635,273709907
15412,5,12,149,5745,-62,-97,35,9e:1f:b0:a7:b8:90,273715678,284,5487,273715394,273715678
15413,5,12,149,5745,-62,-97,35,3a:de:b0:2e:cd:45,273716414,272,464,273716142,273716414
15414,5,24,149,5745,-87,-97,10,,273718488,28,2046,273718460,273718488
15415,5,24,149,5745,-86,-97,11,,273718597,32,77,273718565,273718597
15416,5,12,149,5745,-74,-97,23,d2:00:04:7e:2c:ab,273722143,244,3302,273721899,273722143
15417,5,12,149,5745,-65,-97,32,f2:da:61:dd:98:c5,273732564,272,10149,273732292,273732564
15418,5,12,149,5745,-61,-97,36,76:d6:6a:bb:b3:f5,273735755,272,2919,273735483,273735755
15419,5,24,149,5745,-87,-97,10,,273737440,28,1657,273737412,273737440
15420,5,24,149,5745,-86,-97,11,,273737484,28,16,273737456,273737484
15421,5,12,149,5745,-72,-97,25,72:d1:72:1d:22:a1,273739881,284,2113,273739597,273739881
15422,5,12,149,5745,-74,-97,23,3e:ef:29:c7:4b:17,273747481,272,7328,273747209,273747481
15423,5,12,149,5745,-68,-97,29,22:ec:75:a8:8a:31,273762187,244,14462,273761943,273762187
15424,5,12,149,5745,-51,-97,46,3e:d1:9b:c7:a4:de,273764634,544,1903,273764090,273764634
15425,5,12,149,5745,-63,-97,34,76:d6:6a:bb:b3:f5,273765249,468,147,273764781,273765249
15426,5,12,149,5745,-71,-97,26,72:d1:72:1d:22:a1,273769434,480,3705,273768954,273769434
15427,5,12,149,5745,-66,-97,31,f6:0a:5c:59:72:df,273770074,476,164,273769598,273770074
15428,5,12,149,5745,-57,-97,40,4a:ea:3c:f4:ce:b2,273771917,468,1375,273771449,273771917
15429,5,12,149,5745,-60,-97,37,5e:29:73:5b:30:00,273773319,540,862,273772779,273773319
15430,5,12,149,5745,-60,-97,37,9e:1f:b0:a7:b8:90,273775263,480,1464,273774783,273775263
15431,5,12,149,5745,-66,-97,31,f2:da:61:dd:98:c5,273777168,468,1437,273776700,273777168
15432,5,12,149,5745,-78,-97,19,d2:00:04:7e:2c:ab,273777697,440,89,273777257,273777697
15433,5,12,149,5745,-51,-97,46,3e:d1:9b:c7:a4:de,273779242,272,1273,273778970,273779242
15434,5,12,149,5745,-70,-97,27,56:68:e2:c2:8d:d5,273782104,476,2386,273781628,273782104
15435,5,12,149,5745,-57,-97,40,4a:ea:3c:f4:ce:b2,273782939,272,563,273782667,273782939
15436,5,12,149,5745,-68,-97,29,22:ec:75:a8:8a:31,273783273,516,-182,273782757,273783273
15437,5,12,149,5745,-66,-97,31,b6:90:18:f6:b1:d4,273787013,468,3272,273786545,273787013
15438,5,12,149,5745,-67,-97,30,0a:e1:ab:b3:c3:a6,273789467,468,1986,273788999,273789467
15439,5,12,149,5745,-63,-97,34,3a:de:b0:2e:cd:45,273789971,468,36,273789503,273789971
15440,5,12,149,5745,-66,-97,31,f6:0a:5c:59:72:df,273795168,280,4917,273794888,273795168
15441,5,6,149,5745,-85,-97,12,54:e4:3a:ec:fb:65,273801563,360,6035,273801203,273801563
15442,5,12,149,5745,-74,-97,23,3e:ef:29:c7:4b:17,273803346,468,1315,273802878,273803346
15443,5,12,149,5745,-65,-97,32,0a:e1:ab:b3:c3:a6,273813635,272,10017,273813363,273813635
15444,5,12,149,5745,-63,-97,34,9e:1f:b0:a7:b8:90,273814602,284,683,273814318,273814602
15445,5,12,149,5745,-66,-97,31,f2:da:61:dd:98:c5,273828332,272,13458,273828060,273828332
15446,5,12,149,5745,-50,-97,47,3e:d1:9b:c7:a4:de,273829556,544,680,273829012,273829556
15447,5,12,149,5745,-67,-97,30,76:d6:6a:bb:b3:f5,273830463,468,439,273829995,273830463
15448,5,12,149,5745,-76,-97,21,d2:00:04:7e:2c:ab,273830983,244,276,273830739,273830983
15449,5,12,149,5745,-72,-97,25,72:d1:72:1d:22:a1,273831316,284,49,273831032,273831316
15450,5,12,149,5745,-73,-97,24,72:d1:72:1d:22:a1,273835163,480,3367,273834683,273835163
15451,5,12,149,5745,-60,-97,37,0a:b9:b7:b1:4d:fa,273835731,468,100,273835263,273835731
15452,5,12,149,5745,-60,-97,37,4a:ea:3c:f4:ce:b2,273836233,468,34,273835765,273836233
15453,5,12,149,5745,-61,-97,36,5e:29:73:5b:30:00,273838455,540,1682,273837915,273838455
15454,5,12,149,5745,-63,-97,34,9e:1f:b0:a7:b8:90,273839048,480,113,273838568,273839048
15455,5,12,149,5745,-66,-97,31,f2:da:61:dd:98:c5,273842426,468,2910,273841958,273842426
15456,5,12,149,5745,-75,-97,22,d2:00:04:7e:2c:ab,273842946,440,80,273842506,273842946
15457,5,12,149,5745,-67,-97,30,a6:92:ad:b7:76:65,273844234,484,804,273843750,273844234
15458,5,12,149,5745,-71,-97,26,56:68:e2:c2:8d:d5,273845499,280,985,273845219,273845499
15459,5,12,149,5745,-69,-97,28,b6:90:18:f6:b1:d4,273846427,272,656,273846155,273846427
15460,5,12,149,5745,-75,-97,22,d2:00:04:7e:2c:ab,273846814,104,283,273846710,273846814
15461,5,12,149,5745,-75,-97,22,d2:00:04:7e:2c:ab,273847053,380,-141,273846673,273847053
15462,5,12,149,5745,-71,-97,26,56:68:e2:c2:8d:d5,273847476,476,-53,273847000,273847476
15463,5,12,149,5745,-70,-97,27,22:ec:75:a8:8a:31,273847987,516,-5,273847471,273847987
15464,5,12,149,5745,-71,-97,26,aa:b6:ae:27:64:4e,273848682,468,227,273848214,273848682
15465,5,12,149,5745,-69,-97,28,b6:90:18:f6:b1:d4,273851697,468,2547,273851229,273851697
15466,5,12,149,5745,-75,-97,22,3e:ef:29:c7:4b:17,273852200,468,35,273851732,273852200
15467,5,12,149,5745,-64,-97,33,0a:e1:ab:b3:c3:a6,273852711,468,43,273852243,273852711
15468,5,12,149,5745,-61,-97,36,3a:de:b0:2e:cd:45,273853269,468,90,273852801,273853269
15469,5,12,149,5745,-66,-97,31,76:d6:6a:bb:b3:f5,273860712,272,7171,273860440,273860712
15470,5,12,149,5745,-74,-97,23,3e:ef:29:c7:4b:17,273861044,272,60,273860772,273861044
15471,5,12,149,5745,-71,-97,26,22:ec:75:a8:8a:31,273877926,244,16638,273877682,273877926
15472,5,12,149,5745,-50,-97,47,3e:d1:9b:c7:a4:de,273878413,272,215,273878141,273878413
15473,5,6,149,5745,-86,-97,11,54:e4:3a:ec:fb:65,273903964,360,25191,273903604,273903964
15474,5,12,149,5745,-71,-97,26,d2:00:04:7e:2c:ab,273908080,440,3676,273907640,273908080
15475,5,12,149,5745,-64,-97,33,4a:ea:3c:f4:ce:b2,273911510,272,3158,273911238,273911510
15476,5,12,149,5745,-74,-97,23,3e:ef:29:c7:4b:17,273917459,468,5481,273916991,273917459
15477,5,12,149,5745,-71,-97,26,d2:00:04:7e:2c:ab,273928628,244,10925,273928384,273928628
15478,5,12,149,5745,-61,-97,36,5e:29:73:5b:30:00,273929359,272,459,273929087,273929359
15479,5,12,149,5745,-85,-97,12,9a:24:38:da:96:bb,273941203,272,11572,273940931,273941203
15480,5,24,149,5745,-85,-97,12,,273944499,28,3268,273944471,273944499
15481,5,24,149,5745,-88,-97,9,,273944544,28,17,273944516,273944544
15482,5,24,149,5745,-89,-97,8,,273944652,32,76,273944620,273944652
15483,5,24,149,5745,-90,-97,7,,273962328,28,17648,273962300,273962328
15484,5,24,149,5745,-84,-97,13,,273962372,28,16,273962344,273962372
15485,5,24,149,5745,-85,-97,12,,273962480,32,76,273962448,273962480
15486,5,12,149,5745,-68,-97,29,22:ec:75:a8:8a:31,273973264,244,10540,273973020,273973264
15487,5,12,149,5745,-74,-97,23,3e:ef:29:c7:4b:17,273976062,272,2526,273975790,273976062
15488,5,12,149,5745,-74,-97,23,3e:ef:29:c7:4b:17,273982886,468,6356,273982418,273982886
15489,5,12,149,5745,-55,-97,42,3e:d1:9b:c7:a4:de,273988820,272,5662,273988548,273988820
15490,5,24,149,5745,-88,-97,9,,273996416,32,7564,273996384,273996416
15491,5,12,149,5745,-67,-97,30,0a:e1:ab:b3:c3:a6,274000933,272,4245,274000661,274000933
15492,5,12,149,5745,-64,-97,33,76:d6:6a:bb:b3:f5,274006504,272,5299,274006232,274006504
15493,5,12,149,5745,-56,-97,41,3a:de:b0:2e:cd:45,274007220,272,444,274006948,274007220
15494,5,12,149,5745,-62,-97,35,9e:1f:b0:a7:b8:90,274007615,284,111,274007331,274007615
15495,5,12,149,5745,-63,-97,34,f2:da:61:dd:98:c5,274007935,272,48,274007663,274007935
15496,5,12,149,5745,-67,-97,30,b6:90:18:f6:b1:d4,274030774,272,22567,274030502,274030774
15497,5,12,149,5745,-74,-97,23,72:d1:72:1d:22:a1,274031288,284,230,274031004,274031288
15498,5,12,149,5745,-72,-97,25,56:68:e2:c2:8d:d5,274033101,280,1533,274032821,274033101
15499,5,12,149,5745,-69,-97,28,f6:0a:5c:59:72:df,274037498,280,4117,274037218,274037498
15500,5,12,149,5745,-63,-97,34,5e:29:73:5b:30:00,274046179,272,8409,274045907,274046179
15501,5,12,149,5745,-74,-97,23,3e:ef:29:c7:4b:17,274048926,468,2279,274048458,274048926
15502,5,12,149,5745,-70,-97,27,22:ec:75:a8:8a:31,274089637,244,40467,274089393,274089637
15503,5,12,149,5745,-72,-97,25,3e:ef:29:c7:4b:17,274100410,272,10501,274100138,274100410
15504,5,12,149,5745,-53,-97,44,3e:d1:9b:c7:a4:de,274101891,272,1209,274101619,274101891
15505,5,12,149,5745,-69,-97,28,0a:e1:ab:b3:c3:a6,274103264,272,1101,274102992,274103264
15506,5,12,149,5745,-62,-97,35,76:d6:6a:bb:b3:f5,274108799,272,5263,274108527,274108799
15507,5,12,149,5745,-55,-97,42,3a:de:b0:2e:cd:45,274109366,272,295,274109094,274109366
15508,5,12,149,5745,-67,-97,30,f2:da:61:dd:98:c5,274109832,272,194,274109560,274109832
15509,5,12,149,5745,-64,-97,33,9e:1f:b0:a7:b8:90,274110203,284,87,274109919,274110203
15510,5,6,149,5745,-86,-97,11,54:e4:3a:ec:fb:65,274114218,360,3655,274113858,274114218
15511,5,12,149,5745,-70,-97,27,b6:90:18:f6:b1:d4,274133191,272,18701,274132919,274133191
15512,5,12,149,5745,-72,-97,25,d2:00:04:7e:2c:ab,274133544,244,109,274133300,274133544
15513,5,12,149,5745,-70,-97,27,72:d1:72:1d:22:a1,274134004,284,176,274133720,274134004
15514,5,12,149,5745,-74,-97,23,56:68:e2:c2:8d:d5,274134322,280,38,274134042,274134322
15515,5,24,149,5745,-86,-97,11,,274144506,28,10156,274144478,274144506
15516,5,24,149,5745,-88,-97,9,,274144550,28,16,274144522,274144550
15517,5,24,149,5745,-88,-97,9,,274144658,32,76,274144626,274144658
15518,5,12,149,5745,-62,-97,35,9e:1f:b0:a7:b8:90,274160679,284,15737,274160395,274160679
15519,5,24,149,5745,-89,-97,8,,274162122,28,1415,274162094,274162122
15520,5,24,149,5745,-88,-97,9,,274162167,28,17,274162139,274162167
15521,5,12,149,5745,-65,-97,32,5e:29:73:5b:30:00,274163410,272,971,274163138,274163410
15522,5,12,149,5745,-60,-97,37,3a:de:b0:2e:cd:45,274168124,272,4442,274167852,274168124
15523,5,12,149,5745,-69,-97,28,f2:da:61:dd:98:c5,274173447,272,5051,274173175,274173447
15524,5,12,149,5745,-71,-97,26,72:d1:72:1d:22:a1,274181286,284,7555,274181002,274181286
15525,5,24,149,5745,-91,-97,6,,274188039,28,6725,274188011,274188039
15526,5,24,149,5745,-87,-97,10,,274188191,32,120,274188159,274188191
15527,5,12,149,5745,-74,-97,23,56:68:e2:c2:8d:d5,274188551,280,80,274188271,274188551
15528,5,12,149,5745,-90,-97,7,42:d2:d9:2b:ac:61,274191198,444,2203,274190754,274191198
15529,5,12,149,5745,-73,-97,24,3e:ef:29:c7:4b:17,274197695,272,6225,274197423,274197695
15530,5,12,149,5745,-69,-97,28,b6:90:18:f6:b1:d4,274198762,272,795,274198490,274198762
15531,5,24,149,5745,-90,-97,7,,274202353,32,3559,274202321,274202353
15532,5,12,149,5745,-65,-97,32,76:d6:6a:bb:b3:f5,274205951,272,3326,274205679,274205951
15533,5,12,149,5745,-66,-97,31,0a:e1:ab:b3:c3:a6,274210253,272,4030,274209981,274210253
15534,5,6,149,5745,-84,-97,13,54:e4:3a:ec:fb:65,274211165,360,552,274210805,274211165
15535,5,24,149,5745,-88,-97,9,,274219863,28,8670,274219835,274219863
15536,5,12,149,5745,-70,-97,27,22:ec:75:a8:8a:31,274221000,244,893,274220756,274221000
15537,5,12,149,5745,-73,-97,24,3e:ef:29:c7:4b:17,274221280,468,-188,274220812,274221280
15538,5,12,149,5745,-54,-97,43,3e:d1:9b:c7:a4:de,274221782,272,230,274221510,274221782
15539,5,12,149,5745,-64,-97,33,76:d6:6a:bb:b3:f5,274223754,468,1504,274223286,274223754
15540,5,12,149,5745,-85,-97,12,9a:24:38:da:96:bb,274225374,824,796,274224550,274225374
15541,5,12,149,5745,-54,-97,43,3e:d1:9b:c7:a4:de,274226268,544,350,274225724,274226268
15542,5,12,149,5745,-72,-97,25,72:d1:72:1d:22:a1,274228980,480,2232,274228500,274228980
15543,5,12,149,5745,-62,-97,35,4a:ea:3c:f4:ce:b2,274232168,468,2720,274231700,274232168
15544,5,12,149,5745,-63,-97,34,9e:1f:b0:a7:b8:90,274233455,480,807,274232975,274233455
15545,5,12,149,5745,-66,-97,31,5e:29:73:5b:30:00,274233987,540,-8,274233447,274233987
15546,5,12,149,5745,-67,-97,30,f2:da:61:dd:98:c5,274236534,468,2079,274236066,274236534
15547,5,12,149,5745,-74,-97,23,56:68:e2:c2:8d:d5,274241257,476,4247,274240781,274241257
15548,5,12,149,5745,-70,-97,27,22:ec:75:a8:8a:31,274241920,516,147,274241404,274241920
15549,5,12,149,5745,-68,-97,29,f6:0a:5c:59:72:df,274242974,476,578,274242498,274242974
15550,5,12,149,5745,-70,-97,27,b6:90:18:f6:b1:d4,274244683,468,1241,274244215,274244683
15551,5,12,149,5745,-59,-97,38,3a:de:b0:2e:cd:45,274247733,468,2582,274247265,274247733
15552,5,12,149,5745,-66,-97,31,0a:e1:ab:b3:c3:a6,274248343,468,142,274247875,274248343
15553,5,12,149,5745,-68,-97,29,f6:0a:5c:59:72:df,274251941,280,3318,274251661,274251941
15554,5,12,149,5745,-66,-97,31,0a:e1:ab:b3:c3:a6,274255279,272,3066,274255007,274255279
15555,5,12,149,5745,-66,-97,31,f2:da:61:dd:98:c5,274271067,272,15516,274270795,274271067
15556,5,12,149,5745,-59,-97,38,3a:de:b0:2e:cd:45,274272696,272,1357,274272424,274272696
15557,5,12,149,5745,-64,-97,33,9e:1f:b0:a7:b8:90,274273372,284,392,274273088,274273372
15558,5,12,149,5745,-85,-97,12,9a:24:38:da:96:bb,274277116,272,3472,274276844,274277116
15559,5,12,149,5745,-63,-97,34,5e:29:73:5b:30:00,274278442,272,1054,274278170,274278442
15560,5,12,149,5745,-74,-97,23,72:d1:72:1d:22:a1,274300252,284,21526,274299968,274300252
15561,5,12,149,5745,-65,-97,32,f2:da:61:dd:98:c5,274300597,468,-123,274300129,274300597
15562,5,6,149,5745,-84,-97,13,,274303749,44,3108,274303705,274303749
15563,5,12,149,5745,-72,-97,25,56:68:e2:c2:8d:d5,274306881,280,2852,274306601,274306881
15564,5,12,149,5745,-71,-97,26,f6:0a:5c:59:72:df,274309436,476,2079,274308960,274309436
15565,5,12,149,5745,-65,-97,32,0a:e1:ab:b3:c3:a6,274310963,468,1059,274310495,274310963
15566,5,12,149,5745,-71,-97,26,b6:90:18:f6:b1:d4,274311474,272,239,274311202,274311474
15567,5,12,149,5745,-59,-97,38,3a:de:b0:2e:cd:45,274312420,468,478,274311952,274312420
15568,5,6,149,5745,-85,-97,12,54:e4:3a:ec:fb:65,274313566,360,786,274313206,274313566
15569,5,12,149,5745,-65,-97,32,76:d6:6a:bb:b3:f5,274319072,272,5234,274318800,274319072
15570,5,12,149,5745,-75,-97,22,3e:ef:29:c7:4b:17,274319618,272,274,274319346,274319618
15571,5,12,149,5745,-67,-97,30,22:ec:75:a8:8a:31,274322947,244,3085,274322703,274322947
15572,5,12,149,5745,-52,-97,45,3e:d1:9b:c7:a4:de,274330627,272,7408,274330355,274330627
15573,5,12,149,5745,-76,-97,21,3e:ef:29:c7:4b:17,274352043,468,20948,274351575,274352043
15574,5,12,149,5745,-63,-97,34,76:d6:6a:bb:b3:f5,274354417,468,1906,274353949,274354417
15575,5,12,149,5745,-59,-97,38,4a:ea:3c:f4:ce:b2,274354964,468,79,274354496,274354964
15576,5,12,149,5745,-53,-97,44,3e:d1:9b:c7:a4:de,274355503,544,-5,274354959,274355503
15577,5,12,149,5745,-60,-97,37,0a:b9:b7:b1:4d:fa,274358529,468,2558,274358061,274358529
15578,5,12,149,5745,-76,-97,21,f6:0a:5c:59:72:df,274363770,280,4961,274363490,274363770
15579,5,12,149,5745,-60,-97,37,5e:29:73:5b:30:00,274365462,540,1152,274364922,274365462
15580,5,12,149,5745,-67,-97,30,f2:da:61:dd:98:c5,274366055,468,125,274365587,274366055
15581,5,12,149,5745,-71,-97,26,a6:92:ad:b7:76:65,274368887,484,2348,274368403,274368887
15582,5,12,149,5745,-81,-97,16,d2:00:04:7e:2c:ab,274369883,440,556,274369443,274369883
15583,5,12,149,5745,-64,-97,33,0a:e1:ab:b3:c3:a6,274370357,272,202,274370085,274370357
15584,5,12,149,5745,-91,-97,6,42:d2:d9:2b:ac:61,274372438,264,1817,274372174,274372438
15585,5,12,149,5745,-71,-97,26,aa:b6:ae:27:64:4e,274373256,468,350,274372788,274373256
15586,5,12,149,5745,-77,-97,20,f6:0a:5c:59:72:df,274374117,476,385,274373641,274374117
15587,5,12,149,5745,-68,-97,29,22:ec:75:a8:8a:31,274375346,516,713,274374830,274375346
15588,5,12,149,5745,-58,-97,39,3a:de:b0:2e:cd:45,274377029,468,1215,274376561,274377029
15589,5,12,149,5745,-84,-97,13,9a:24:38:da:96:bb,274377863,824,10,274377039,274377863
15590,5,12,149,5745,-68,-97,29,f2:da:61:dd:98:c5,274385355,272,7220,274385083,274385355
15591,5,12,149,5745,-58,-97,39,3a:de:b0:2e:cd:45,274386833,272,1206,274386561,274386833
15592,5,24,149,5745,-89,-97,8,,274395308,28,8447,274395280,274395308
15593,5,24,149,5745,-87,-97,10,,274395352,28,16,274395324,274395352
15594,5,24,149,5745,-88,-97,9,,274395461,32,77,274395429,274395461
15595,5,12,149,5745,-87,-97,10,9a:24:38:da:96:bb,274398437,272,2704,274398165,274398437
15596,5,12,149,5745,-61,-97,36,5e:29:73:5b:30:00,274403664,272,4955,274403392,274403664
15597,5,12,149,5745,-64,-97,33,fa:44:8d:e1:c7:1b,274404375,244,467,274404131,274404375
15598,5,24,149,5745,-89,-97,8,,274413857,28,9454,274413829,274413857
15599,5,6,149,5745,-85,-97,12,54:e4:3a:ec:fb:65,274415967,360,1750,274415607,274415967
15600,5,12,149,5745,-67,-97,30,9e:1f:b0:a7:b8:90,274417271,284,1020,274416987,274417271
15601,5,12,149,5745,-70,-97,27,b6:90:18:f6:b1:d4,274430262,272,12719,274429990,274430262
15602,5,12,149,5745,-66,-97,31,76:d6:6a:bb:b3:f5,274431519,272,985,274431247,274431519
15603,5,12,149,5745,-74,-97,23,3e:ef:29:c7:4b:17,274434439,272,2648,274434167,274434439
15604,5,12,149,5745,-67,-97,30,fa:44:8d:e1:c7:1b,274434936,440,57,274434496,274434936
15605,5,12,149,5745,-67,-97,30,22:ec:75:a8:8a:31,274440012,244,4832,274439768,274440012
15606,5,12,149,5745,-75,-97,22,72:d1:72:1d:22:a1,274440830,284,534,274440546,274440830
15607,5,12,149,5745,-71,-97,26,56:68:e2:c2:8d:d5,274441776,280,666,274441496,274441776
15608,5,12,149,5745,-54,-97,43,3e:d1:9b:c7:a4:de,274447806,272,5758,274447534,274447806
15609,5,12,149,5745,-69,-97,28,0a:e1:ab:b3:c3:a6,274488825,272,40747,274488553,274488825
15610,5,12,149,5745,-70,-97,27,f6:0a:5c:59:72:df,274489501,280,396,274489221,274489501
15611,5,12,149,5745,-94,-97,3,42:d2:d9:2b:ac:61,274500212,260,10451,274499952,274500212
15612,5,12,149,5745,-61,-97,36,5e:29:73:5b:30:00,274505918,272,5434,274505646,274505918
15613,5,12,149,5745,-54,-97,43,3a:de:b0:2e:cd:45,274506270,272,80,274505998,274506270
15614,5,12,149,5745,-69,-97,28,f2:da:61:dd:98:c5,274511496,272,4954,274511224,274511496
15615,5,6,149,5745,-85,-97,12,54:e4:3a:ec:fb:65,274518367,360,6511,274518007,274518367
15616,5,12,149,5745,-63,-97,34,9e:1f:b0:a7:b8:90,274519535,284,884,274519251,274519535
15617,5,12,149,5745,-71,-97,26,fa:44:8d:e1:c7:1b,274523334,244,3555,274523090,274523334
15618,5,12,149,5745,-72,-97,25,b6:90:18:f6:b1:d4,274536616,272,13010,274536344,274536616
15619,5,12,149,5745,-75,-97,22,72:d1:72:1d:22:a1,274542994,284,6094,274542710,274542994
15620,5,12,149,5745,-70,-97,27,56:68:e2:c2:8d:d5,274543888,280,614,274543608,274543888
15621,5,12,149,5745,-59,-97,38,4a:ea:3c:f4:ce:b2,274550575,468,6219,274550107,274550575
15622,5,12,149,5745,-68,-97,29,22:ec:75:a8:8a:31,274557095,244,6276,274556851,274557095
15623,5,12,149,5745,-54,-97,43,3e:d1:9b:c7:a4:de,274564724,272,7357,274564452,274564724
15624,5,12,149,5745,-73,-97,24,3e:ef:29:c7:4b:17,274595543,272,30547,274595271,274595543
15625,5,24,149,5745,-86,-97,11,,274598579,32,3004,274598547,274598579
15626,5,12,149,5745,-72,-97,25,0a:e1:ab:b3:c3:a6,274614740,272,15889,274614468,274614740
15627,5,24,149,5745,-84,-97,13,,274616755,32,1983,274616723,274616755
15628,5,24,149,5745,-84,-97,13,,274617118,32,331,274617086,274617118
15629,5,12,149,5745,-55,-97,42,3a:de:b0:2e:cd:45,274618910,272,1520,274618638,274618910
15630,5,6,149,5745,-88,-97,9,54:e4:3a:ec:fb:65,274620767,360,1497,274620407,274620767
15631,5,12,149,5745,-65,-97,32,9e:1f:b0:a7:b8:90,274621974,284,923,274621690,274621974
15632,5,12,149,5745,-64,-97,33,76:d6:6a:bb:b3:f5,274622463,272,217,274622191,274622463
15633,5,12,149,5745,-62,-97,35,5e:29:73:5b:30:00,274623540,272,805,274623268,274623540
15634,5,12,149,5745,-66,-97,31,f2:da:61:dd:98:c5,274624471,272,659,274624199,274624471
15635,5,12,149,5745,-82,-97,15,9a:24:38:da:96:bb,274628419,272,3676,274628147,274628419
15636,5,12,149,5745,-63,-97,34,fa:44:8d:e1:c7:1b,274636400,244,7737,274636156,274636400
15637,5,12,149,5745,-76,-97,21,72:d1:72:1d:22:a1,274645491,284,8807,274645207,274645491
15638,5,12,149,5745,-70,-97,27,56:68:e2:c2:8d:d5,274646007,280,236,274645727,274646007
15639,5,12,149,5745,-90,-97,7,02:af:71:9e:85:a6,274648893,244,2642,274648649,274648893
15640,5,12,149,5745,-68,-97,29,b6:90:18:f6:b1:d4,274649711,272,546,274649439,274649711
15641,5,12,149,5745,-90,-97,7,42:d2:d9:2b:ac:61,274657829,260,7858,274657569,274657829
15642,5,12,149,5745,-70,-97,27,22:ec:75:a8:8a:31,274674109,244,16036,274673865,274674109
15643,5,12,149,5745,-56,-97,41,3e:d1:9b:c7:a4:de,274680430,272,6049,274680158,274680430
15644,5,12,149,5745,-74,-97,23,3e:ef:29:c7:4b:17,274698929,272,18227,274698657,274698929
15645,5,24,149,5745,-84,-97,13,,274711546,28,12589,274711518,274711546
15646,5,24,149,5745,-84,-97,13,,274711654,32,76,274711622,274711654
15647,5,12,149,5745,-67,-97,30,0a:e1:ab:b3:c3:a6,274717119,272,5193,274716847,274717119
15648,5,6,149,5745,-84,-97,13,54:e4:3a:ec:fb:65,274723168,360,5689,274722808,274723168
15649,5,12,149,5745,-60,-97,37,76:d6:6a:bb:b3:f5,274723594,272,154,274723322,274723594
15650,5,12,149,5745,-64,-97,33,9e:1f:b0:a7:b8:90,274724488,284,610,274724204,274724488
15651,5,24,149,5745,-86,-97,11,,274728197,28,3681,274728169,274728197
15652,5,24,149,5745,-85,-97,12,,274731311,32,3082,274731279,274731311
15653,5,12,149,5745,-57,-97,40,3a:de:b0:2e:cd:45,274731717,272,134,274731445,274731717
15654,5,24,149,5745,-86,-97,11,,274732149,28,404,274732121,274732149
15655,5,24,149,5745,-86,-97,11,,274732265,32,84,274732233,274732265
15656,5,12,149,5745,-64,-97,33,5e:29:73:5b:30:00,274735432,272,2895,274735160,274735432
15657,5,12,149,5745,-64,-97,33,f2:da:61:dd:98:c5,274736961,272,1257,274736689,274736961
15658,5,24,149,5745,-87,-97,10,,274748410,28,11421,274748382,274748410
15659,5,12,149,5745,-78,-97,19,72:d1:72:1d:22:a1,274748888,284,194,274748604,274748888
15660,5,24,149,5745,-86,-97,11,,274749251,28,335,274749223,274749251
15661,5,12,149,5745,-65,-97,32,fa:44:8d:e1:c7:1b,274749523,244,28,274749279,274749523
15662,5,24,149,5745,-87,-97,10,,274749909,28,358,274749881,274749909
15663,5,24,149,5745,-88,-97,9,,274752571,32,2630,274752539,274752571
15664,5,24,149,5745,-88,-97,9,,274753422,28,823,274753394,274753422
15665,5,24,149,5745,-87,-97,10,,274753530,32,76,274753498,274753530
15666,5,24,149,5745,-86,-97,11,,274754725,28,1167,274754697,274754725
15667,5,24,149,5745,-86,-97,11,,274754969,32,212,274754937,274754969
15668,5,12,149,5745,-67,-97,30,b6:90:18:f6:b1:d4,274760527,272,5286,274760255,274760527
15669,5,12,149,5745,-69,-97,28,56:68:e2:c2:8d:d5,274764343,280,3536,274764063,274764343
15670,5,24,149,5745,-88,-97,9,,274769513,28,5142,274769485,274769513
15671,5,24,149,5745,-88,-97,9,,274769846,28,305,274769818,274769846
15672,5,24,149,5745,-89,-97,8,,274770906,28,1032,274770878,274770906
15673,5,24,149,5745,-88,-97,9,,274771343,28,409,274771315,274771343
15674,5,24,149,5745,-88,-97,9,,274771616,28,245,274771588,274771616
15675,5,24,149,5745,-89,-97,8,,274771925,28,281,274771897,274771925
15676,5,24,149,5745,-90,-97,7,,274772252,28,299,274772224,274772252
15677,5,24,149,5745,-89,-97,8,,274772360,32,76,274772328,274772360
15678,5,24,149,5745,-87,-97,10,,274773805,32,1413,274773773,274773805
15679,5,12,149,5745,-59,-97,38,76:d6:6a:bb:b3:f5,274774013,272,-64,274773741,274774013
15680,5,12,149,5745,-75,-97,22,3e:ef:29:c7:4b:17,274776905,272,2620,274776633,274776905
15681,5,12,149,5745,-91,-97,6,42:d2:d9:2b:ac:61,274778210,260,1045,274777950,274778210
15682,5,12,149,5745,-71,-97,26,22:ec:75:a8:8a:31,274785963,244,7509,274785719,274785963
15683,5,24,149,5745,-88,-97,9,,274786277,28,286,274786249,274786277
15684,5,24,149,5745,-89,-97,8,,274786619,28,314,274786591,274786619
15685,5,24,149,5745,-88,-97,9,,274789186,28,2539,274789158,274789186
15686,5,24,149,5745,-89,-97,8,,274789294,32,76,274789262,274789294
15687,5,24,149,5745,-88,-97,9,,274789816,28,494,274789788,274789816
15688,5,24,149,5745,-88,-97,9,,274790119,28,275,274790091,274790119
15689,5,24,149,5745,-89,-97,8,,274790164,28,17,274790136,274790164
15690,5,24,149,5745,-90,-97,7,,274790407,28,215,274790379,274790407
15691,5,12,149,5745,-57,-97,40,3e:d1:9b:c7:a4:de,274811483,272,20804,274811211,274811483
15692,5,12,149,5745,-70,-97,27,f6:0a:5c:59:72:df,274812169,280,406,274811889,274812169
15693,5,12,149,5745,-68,-97,29,0a:e1:ab:b3:c3:a6,274812491,272,50,274812219,274812491
15694,5,12,149,5745,-57,-97,40,3e:d1:9b:c7:a4:de,274813581,544,546,274813037,274813581
15695,5,12,149,5745,-59,-97,38,76:d6:6a:bb:b3:f5,274814236,468,187,274813768,274814236
15696,5,12,149,5745,-91,-97,6,42:d2:d9:2b:ac:61,274816551,452,1863,274816099,274816551
15697,5,12,149,5745,-66,-97,31,fa:44:8d:e1:c7:1b,274818653,440,1662,274818213,274818653
15698,5,12,149,5745,-78,-97,19,72:d1:72:1d:22:a1,274820280,480,1147,274819800,274820280
15699,5,12,149,5745,-63,-97,34,5e:29:73:5b:30:00,274821353,540,533,274820813,274821353
15700,5,12,149,5745,-62,-97,35,9e:1f:b0:a7:b8:90,274822559,480,726,274822079,274822559
15701,5,24,149,5745,-88,-97,9,,274823610,28,1023,274823582,274823610
15702,5,12,149,5745,-89,-97,8,02:af:71:9e:85:a6,274824209,212,387,274823997,274824209
15703,5,6,149,5745,-86,-97,11,54:e4:3a:ec:fb:65,274825569,360,1000,274825209,274825569
15704,5,24,149,5745,-88,-97,9,,274825934,28,337,274825906,274825934
15705,5,24,149,5745,-88,-97,9,,274826043,32,77,274826011,274826043
15706,5,12,149,5745,-66,-97,31,f2:da:61:dd:98:c5,274827525,468,1014,274827057,274827525
15707,5,12,149,5745,-60,-97,37,3a:de:b0:2e:cd:45,274829262,272,1465,274828990,274829262
15708,5,12,149,5745,-63,-97,34,9e:1f:b0:a7:b8:90,274829569,284,23,274829285,274829569
15709,5,12,149,5745,-92,-97,5,02:af:71:9e:85:a6,274830929,440,920,274830489,274830929
15710,5,12,149,5745,-72,-97,25,22:ec:75:a8:8a:31,274832048,516,603,274831532,274832048
15711,5,12,149,5745,-68,-97,29,56:68:e2:c2:8d:d5,274833192,476,668,274832716,274833192
15712,5,12,149,5745,-69,-97,28,f6:0a:5c:59:72:df,274834142,476,474,274833666,274834142
15713,5,12,149,5745,-68,-97,29,b6:90:18:f6:b1:d4,274837786,468,3176,274837318,274837786
15714,5,12,149,5745,-69,-97,28,0a:e1:ab:b3:c3:a6,274838297,468,43,274837829,274838297
15715,5,12,149,5745,-60,-97,37,3a:de:b0:2e:cd:45,274838800,468,35,274838332,274838800
15716,5,12,149,5745,-65,-97,32,f2:da:61:dd:98:c5,274844128,272,5056,274843856,274844128
15717,5,12,149,5745,-78,-97,19,72:d1:72:1d:22:a1,274845686,284,1274,274845402,274845686
15718,5,12,149,5745,-91,-97,6,02:af:71:9e:85:a6,274862214,244,16284,274861970,274862214
15719,5,12,149,5745,-62,-97,35,5e:29:73:5b:30:00,274862475,272,-11,274862203,274862475
15720,5,12,149,5745,-66,-97,31,fa:44:8d:e1:c7:1b,274862781,244,62,274862537,274862781
15721,5,6,149,5745,-89,-97,8,70:bc:10:5f:b5:61,274863374,124,469,274863250,274863374
15722,5,6,149,5745,-90,-97,7,70:bc:10:5f:b5:61,274863574,124,76,274863450,274863574
15723,5,6,149,5745,-86,-97,11,54:e4:3a:ec:fb:65,274863845,352,-81,274863493,274863845
15724,5,6,149,5745,-89,-97,8,,274864212,44,323,274864168,274864212
15725,5,12,149,5745,-76,-97,21,3e:ef:29:c7:4b:17,274876397,468,11717,274875929,274876397
15726,5,12,149,5745,-76,-97,21,3e:ef:29:c7:4b:17,274876884,272,215,274876612,274876884
15727,5,12,149,5745,-61,-97,36,76:d6:6a:bb:b3:f5,274877217,272,61,274876945,274877217
15728,5,12,149,5745,-56,-97,41,3e:d1:9b:c7:a4:de,274878063,544,302,274877519,274878063
15729,5,12,149,5745,-61,-97,36,76:d6:6a:bb:b3:f5,274878661,468,130,274878193,274878661
15730,5,12,149,5745,-60,-97,37,4a:ea:3c:f4:ce:b2,274879623,468,494,274879155,274879623
15731,5,12,149,5745,-64,-97,33,fa:44:8d:e1:c7:1b,274882616,440,2553,274882176,274882616
15732,5,12,149,5745,-60,-97,37,0a:b9:b7:b1:4d:fa,274884022,468,938,274883554,274884022
15733,5,12,149,5745,-66,-97,31,9e:1f:b0:a7:b8:90,274887092,480,2590,274886612,274887092
15734,5,12,149,5745,-63,-97,34,5e:29:73:5b:30:00,274887606,540,-26,274887066,274887606
15735,5,12,149,5745,-66,-97,31,f2:da:61:dd:98:c5,274890522,468,2448,274890054,274890522
15736,5,12,149,5745,-64,-97,33,fa:44:8d:e1:c7:1b,274892927,104,2301,274892823,274892927
15737,5,12,149,5745,-64,-97,33,fa:44:8d:e1:c7:1b,274893164,360,-123,274892804,274893164
15738,5,12,149,5745,-64,-97,33,fa:44:8d:e1:c7:1b,274893577,104,309,274893473,274893577
15739,5,12,149,5745,-64,-97,33,fa:44:8d:e1:c7:1b,274893850,216,57,274893634,274893850
15740,5,12,149,5745,-70,-97,27,56:68:e2:c2:8d:d5,274895874,476,1548,274895398,274895874
15741,5,12,149,5745,-72,-97,25,22:ec:75:a8:8a:31,274896384,516,-6,274895868,274896384
15742,5,12,149,5745,-67,-97,30,a6:92:ad:b7:76:65,274896943,484,75,274896459,274896943
15743,5,12,149,5745,-72,-97,25,aa:b6:ae:27:64:4e,274897462,468,51,274896994,274897462
15744,5,12,149,5745,-69,-97,28,f6:0a:5c:59:72:df,274899656,476,1718,274899180,274899656
15745,5,12,149,5745,-70,-97,27,0a:e1:ab:b3:c3:a6,274900220,468,96,274899752,274900220
15746,5,12,149,5745,-66,-97,31,b6:90:18:f6:b1:d4,274900731,468,43,274900263,274900731
15747,5,12,149,5745,-81,-97,16,d2:00:04:7e:2c:ab,274902987,152,2104,274902835,274902987
15748,5,12,149,5745,-59,-97,38,3a:de:b0:2e:cd:45,274905793,468,2338,274905325,274905793
15749,5,12,149,5745,-74,-97,23,22:ec:75:a8:8a:31,274909085,244,3048,274908841,274909085
15750,5,12,149,5745,-69,-97,28,f6:0a:5c:59:72:df,274925106,280,15741,274924826,274925106
15751,5,12,149,5745,-57,-97,40,3e:d1:9b:c7:a4:de,274927298,272,1920,274927026,274927298
15752,5,12,149,5745,-69,-97,28,0a:e1:ab:b3:c3:a6,274927608,272,38,274927336,274927608
15753,5,6,149,5745,-88,-97,9,54:e4:3a:ec:fb:65,274927969,360,1,274927609,274927969
15754,5,12,149,5745,-66,-97,31,fa:44:8d:e1:c7:1b,274948008,440,19599,274947568,274948008
15755,5,12,149,5745,-65,-97,32,9e:1f:b0:a7:b8:90,274959769,284,11477,274959485,274959769
15756,5,12,149,5745,-66,-97,31,fa:44:8d:e1:c7:1b,274960690,244,677,274960446,274960690
15757,5,12,149,5745,-90,-97,7,7e:05:42:11:d2:ec,274961402,244,468,274961158,274961402
15758,5,12,149,5745,-88,-97,9,7e:05:42:11:d2:ec,274962302,440,460,274961862,274962302
15759,5,12,149,5745,-70,-97,27,f2:da:61:dd:98:c5,274963200,272,626,274962928,274963200
15760,5,12,149,5745,-64,-97,33,5e:29:73:5b:30:00,274965095,272,1623,274964823,274965095
15761,5,12,149,5745,-88,-97,9,02:af:71:9e:85:a6,274969137,440,3602,274968697,274969137
15762,5,12,149,5745,-87,-97,10,02:af:71:9e:85:a6,274976587,244,7206,274976343,274976587
15763,5,12,149,5745,-65,-97,32,76:d6:6a:bb:b3:f5,275001375,272,24516,275001103,275001375
15764,5,12,149,5745,-76,-97,21,3e:ef:29:c7:4b:17,275006184,272,4537,275005912,275006184
15765,5,12,149,5745,-74,-97,23,22:ec:75:a8:8a:31,275013124,244,6696,275012880,275013124
15766,5,12,149,5745,-55,-97,42,3e:d1:9b:c7:a4:de,275021968,272,8572,275021696,275021968
15767,5,12,149,5745,-88,-97,9,02:af:71:9e:85:a6,275025494,212,3314,275025282,275025494
15768,5,6,149,5745,-90,-97,7,54:e4:3a:ec:fb:65,275030370,360,4516,275030010,275030370
15769,5,12,149,5745,-88,-97,9,02:af:71:9e:85:a6,275031612,440,802,275031172,275031612
15770,5,12,149,5745,-88,-97,9,,275035732,32,4088,275035700,275035732
15771,5,24,149,5745,-69,-97,28,,275051748,28,15988,275051720,275051748
15772,5,24,149,5745,-85,-97,12,,275051792,28,16,275051764,275051792
15773,5,24,149,5745,-85,-97,12,,275051900,28,80,275051872,275051900
15774,5,12,149,5745,-89,-97,8,42:d2:d9:2b:ac:61,275053143,256,987,275052887,275053143
15775,5,12,149,5745,-77,-97,20,72:d1:72:1d:22:a1,275054923,284,1496,275054639,275054923
15776,5,12,149,5745,-71,-97,26,56:68:e2:c2:8d:d5,275056114,280,911,275055834,275056114
15777,5,12,149,5745,-67,-97,30,b6:90:18:f6:b1:d4,275056466,272,80,275056194,275056466
15778,5,12,149,5745,-56,-97,41,4a:ea:3c:f4:ce:b2,275074059,468,17125,275073591,275074059
15779,5,12,149,5745,-65,-97,32,5e:29:73:5b:30:00,275077913,272,3582,275077641,275077913
15780,5,12,149,5745,-90,-97,7,7e:05:42:11:d2:ec,275081095,244,2938,275080851,275081095
15781,5,12,149,5745,-83,-97,14,9a:24:38:da:96:bb,275090814,272,9447,275090542,275090814
15782,5,12,149,5745,-89,-97,8,02:af:71:9e:85:a6,275091141,244,83,275090897,275091141
15783,5,12,149,5745,-92,-97,5,02:af:71:9e:85:a6,275095838,440,4257,275095398,275095838
15784,5,24,149,5745,-86,-97,11,,275108904,28,13038,275108876,275108904
15785,5,24,149,5745,-73,-97,24,,275108948,28,16,275108920,275108948
15786,5,24,149,5745,-75,-97,22,,275109056,32,76,275109024,275109056
15787,5,24,149,5745,-86,-97,11,,275111177,32,2089,275111145,275111177
15788,5,24,149,5745,-86,-97,11,,275111466,32,257,275111434,275111466
15789,5,24,149,5745,-75,-97,22,,275111811,28,317,275111783,275111811
15790,5,24,149,5745,-87,-97,10,,275111855,28,16,275111827,275111855
15791,5,24,149,5745,-86,-97,11,,275111967,32,80,275111935,275111967
15792,5,12,149,5745,-74,-97,23,3e:ef:29:c7:4b:17,275117408,272,5169,275117136,275117408
15793,5,12,149,5745,-68,-97,29,0a:e1:ab:b3:c3:a6,275127237,272,9557,275126965,275127237
15794,5,12,149,5745,-71,-97,26,22:ec:75:a8:8a:31,275129828,244,2347,275129584,275129828
15795,5,6,149,5745,-88,-97,9,54:e4:3a:ec:fb:65,275132770,360,2582,275132410,275132770
15796,5,12,149,5745,-67,-97,30,f2:da:61:dd:98:c5,275133486,272,444,275133214,275133486
15797,5,12,149,5745,-63,-97,34,9e:1f:b0:a7:b8:90,275133894,284,124,275133610,275133894
15798,5,12,149,5745,-61,-97,36,76:d6:6a:bb:b3:f5,275134636,272,470,275134364,275134636
15799,5,12,149,5745,-55,-97,42,3e:d1:9b:c7:a4:de,275138252,272,3344,275137980,275138252
15800,5,12,149,5745,-71,-97,26,fa:44:8d:e1:c7:1b,275156444,244,17948,275156200,275156444
15801,5,12,149,5745,-72,-97,25,b6:90:18:f6:b1:d4,275157311,272,595,275157039,275157311
15802,5,12,149,5745,-74,-97,23,72:d1:72:1d:22:a1,275157816,284,221,275157532,275157816
15803,5,12,149,5745,-72,-97,25,56:68:e2:c2:8d:d5,275159539,280,1443,275159259,275159539
15804,5,12,149,5745,-90,-97,7,42:d2:d9:2b:ac:61,275166323,256,6528,275166067,275166323
15805,5,24,149,5745,-86,-97,11,,275169656,28,3305,275169628,275169656
15806,5,24,149,5745,-76,-97,21,,275169700,28,16,275169672,275169700
15807,5,24,149,5745,-77,-97,20,,275169808,32,76,275169776,275169808
15808,5,24,149,5745,-77,-97,20,,275170805,28,969,275170777,275170805
15809,5,24,149,5745,-85,-97,12,,275170849,28,16,275170821,275170849
15810,5,24,149,5745,-86,-97,11,,275170956,32,75,275170924,275170956
15811,5,12,149,5745,-82,-97,15,9a:24:38:da:96:bb,275184857,272,13629,275184585,275184857
15812,5,12,149,5745,-61,-97,36,5e:29:73:5b:30:00,275194854,272,9725,275194582,275194854
15813,5,12,149,5745,-72,-97,25,fa:44:8d:e1:c7:1b,275199596,244,4498,275199352,275199596
15814,5,12,149,5745,-74,-97,23,56:68:e2:c2:8d:d5,275204808,280,4932,275204528,275204808
15815,5,12,149,5745,-75,-97,22,72:d1:72:1d:22:a1,275206717,284,1625,275206433,275206717
15816,5,12,149,5745,-72,-97,25,b6:90:18:f6:b1:d4,275212634,272,5645,275212362,275212634
15817,5,24,149,5745,-86,-97,11,,275223700,32,11034,275223668,275223700
15818,5,12,149,5745,-72,-97,25,3e:ef:29:c7:4b:17,275226805,272,2833,275226533,275226805
15819,5,12,149,5745,-65,-97,32,0a:e1:ab:b3:c3:a6,275229108,272,2031,275228836,275229108
15820,5,24,149,5745,-86,-97,11,,275232163,32,3023,275232131,275232163
15821,5,24,149,5745,-76,-97,21,66:48:51:4e:71:fa,275232281,328,-210,275231953,275232281
15822,5,24,149,5745,-87,-97,10,,275232742,28,433,275232714,275232742
15823,5,24,149,5745,-77,-97,20,,275232786,28,16,275232758,275232786
15824,5,24,149,5745,-77,-97,20,,275232894,32,76,275232862,275232894
15825,5,6,149,5745,-90,-97,7,54:e4:3a:ec:fb:65,275235171,360,1917,275234811,275235171
15826,5,12,149,5745,-66,-97,31,f2:da:61:dd:98:c5,275236134,272,691,275235862,275236134
15827,5,12,149,5745,-65,-97,32,76:d6:6a:bb:b3:f5,275236842,272,436,275236570,275236842
15828,5,12,149,5745,-65,-97,32,9e:1f:b0:a7:b8:90,275237836,284,710,275237552,275237836
15829,5,12,149,5745,-69,-97,28,22:ec:75:a8:8a:31,275246884,244,8804,275246640,275246884
15830,5,12,149,5745,-93,-97,4,02:af:71:9e:85:a6,275257049,244,9921,275256805,275257049
15831,5,12,149,5745,-68,-97,29,f6:0a:5c:59:72:df,275265905,280,8576,275265625,275265905
15832,5,12,149,5745,-72,-97,25,3e:ef:29:c7:4b:17,275269608,468,3235,275269140,275269608
15833,5,12,149,5745,-52,-97,45,3e:d1:9b:c7:a4:de,275270238,272,358,275269966,275270238
15834,5,12,149,5745,-66,-97,31,0a:e1:ab:b3:c3:a6,275271392,272,882,275271120,275271392
15835,5,12,149,5745,-65,-97,32,76:d6:6a:bb:b3:f5,275271835,468,-25,275271367,275271835
15836,5,12,149,5745,-52,-97,45,3e:d1:9b:c7:a4:de,275272364,544,-15,275271820,275272364
15837,5,12,149,5745,-89,-97,8,42:d2:d9:2b:ac:61,275272996,256,376,275272740,275272996
15838,5,12,149,5745,-69,-97,28,fa:44:8d:e1:c7:1b,275276881,440,3445,275276441,275276881
15839,5,12,149,5745,-65,-97,32,f2:da:61:dd:98:c5,275277400,360,159,275277040,275277400
15840,5,12,149,5745,-74,-97,23,72:d1:72:1d:22:a1,275278536,480,656,275278056,275278536
15841,5,12,149,5745,-65,-97,32,9e:1f:b0:a7:b8:90,275279680,480,664,275279200,275279680
15842,5,12,149,5745,-65,-97,32,76:d6:6a:bb:b3:f5,275281407,288,1439,275281119,275281407
15843,5,12,149,5745,-62,-97,35,5e:29:73:5b:30:00,275281738,540,-209,275281198,275281738
15844,5,12,149,5745,-88,-97,9,42:d2:d9:2b:ac:61,275282427,452,237,275281975,275282427
15845,5,12,149,5745,-65,-97,32,f2:da:61:dd:98:c5,275283475,468,580,275283007,275283475
15846,5,12,149,5745,-65,-97,32,f2:da:61:dd:98:c5,275286434,272,2687,275286162,275286434
15847,5,12,149,5745,-59,-97,38,3a:de:b0:2e:cd:45,275287894,272,1188,275287622,275287894
15848,5,12,149,5745,-65,-97,32,9e:1f:b0:a7:b8:90,275291189,284,3011,275290905,275291189
15849,5,12,149,5745,-64,-97,33,0a:e1:ab:b3:c3:a6,275293471,468,1814,275293003,275293471
15850,5,12,149,5745,-87,-97,10,9a:24:38:da:96:bb,275295431,824,1136,275294607,275295431
15851,5,12,149,5745,-86,-97,11,9a:24:38:da:96:bb,275296273,272,570,275296001,275296273
15852,5,12,149,5745,-59,-97,38,3a:de:b0:2e:cd:45,275296614,468,-127,275296146,275296614
15853,5,12,149,5745,-74,-97,23,72:d1:72:1d:22:a1,275304372,284,7474,275304088,275304372
15854,5,12,149,5745,-69,-97,28,fa:44:8d:e1:c7:1b,275304699,244,83,275304455,275304699
15855,5,12,149,5745,-71,-97,26,b6:90:18:f6:b1:d4,275320642,272,15671,275320370,275320642
15856,5,12,149,5745,-61,-97,36,5e:29:73:5b:30:00,275321726,272,812,275321454,275321726
15857,5,12,149,5745,-90,-97,7,42:d2:d9:2b:ac:61,275325300,360,3214,275324940,275325300
15858,5,12,149,5745,-89,-97,8,02:af:71:9e:85:a6,275327862,244,2318,275327618,275327862
15859,5,6,149,5745,-87,-97,10,54:e4:3a:ec:fb:65,275337571,360,9349,275337211,275337571
15860,5,12,149,5745,-68,-97,29,fa:44:8d:e1:c7:1b,275341643,440,3632,275341203,275341643
15861,5,12,149,5745,-90,-97,7,42:d2:d9:2b:ac:61,275345585,452,3490,275345133,275345585
15862,5,12,149,5745,-64,-97,33,f2:da:61:dd:98:c5,275349119,468,3066,275348651,275349119
15863,5,12,149,5745,-65,-97,32,76:d6:6a:bb:b3:f5,275349683,272,292,275349411,275349683
15864,5,12,149,5745,-54,-97,43,4a:ea:3c:f4:ce:b2,275349999,468,-152,275349531,275349999
15865,5,12,149,5745,-71,-97,26,3e:ef:29:c7:4b:17,275350588,272,317,275350316,275350588
15866,5,12,149,5745,-66,-97,31,f6:0a:5c:59:72:df,275357809,476,6745,275357333,275357809
15867,5,12,149,5745,-63,-97,34,0a:e1:ab:b3:c3:a6,275358976,468,699,275358508,275358976
15868,5,12,149,5745,-59,-97,38,3a:de:b0:2e:cd:45,275360461,468,1017,275359993,275360461
15869,5,12,149,5745,-55,-97,42,4a:ea:3c:f4:ce:b2,275369215,272,8482,275368943,275369215
15870,5,12,149,5745,-51,-97,46,3e:d1:9b:c7:a4:de,275371165,272,1678,275370893,275371165
15871,5,12,149,5745,-67,-97,30,f6:0a:5c:59:72:df,275377942,280,6497,275377662,275377942
15872,5,12,149,5745,-64,-97,33,0a:e1:ab:b3:c3:a6,275386581,272,8367,275386309,275386581
15873,5,12,149,5745,-89,-97,8,42:d2:d9:2b:ac:61,275388217,256,1380,275387961,275388217
15874,5,12,149,5745,-64,-97,33,f2:da:61:dd:98:c5,275401107,272,12618,275400835,275401107
15875,5,12,149,5745,-70,-97,27,3e:ef:29:c7:4b:17,275402270,468,695,275401802,275402270
15876,5,12,149,5745,-59,-97,38,3a:de:b0:2e:cd:45,275402790,272,248,275402518,275402790
15877,5,12,149,5745,-64,-97,33,76:d6:6a:bb:b3:f5,275405501,468,2243,275405033,275405501
15878,5,12,149,5745,-51,-97,46,3e:d1:9b:c7:a4:de,275406057,544,12,275405513,275406057
15879,5,12,149,5745,-67,-97,30,fa:44:8d:e1:c7:1b,275407194,440,697,275406754,275407194
15880,5,12,149,5745,-59,-97,38,0a:b9:b7:b1:4d:fa,275407695,468,33,275407227,275407695
15881,5,12,149,5745,-89,-97,8,02:af:71:9e:85:a6,275409649,440,1514,275409209,275409649
15882,5,12,149,5745,-90,-97,7,42:d2:d9:2b:ac:61,275411078,452,977,275410626,275411078
15883,5,12,149,5745,-62,-97,35,5e:29:73:5b:30:00,275412626,540,1008,275412086,275412626
15884,5,12,149,5745,-67,-97,30,22:ec:75:a8:8a:31,275414216,516,1074,275413700,275414216
15885,5,12,149,5745,-65,-97,32,f2:da:61:dd:98:c5,275414766,468,82,275414298,275414766
15886,5,12,149,5745,-55,-97,42,4a:ea:3c:f4:ce:b2,275416499,468,1265,275416031,275416499
15887,5,12,149,5745,-69,-97,28,9e:1f:b0:a7:b8:90,275418249,284,1466,275417965,275418249
15888,5,12,149,5745,-66,-97,31,fa:44:8d:e1:c7:1b,275419854,244,1361,275419610,275419854
15889,5,12,149,5745,-70,-97,27,a6:92:ad:b7:76:65,275420150,484,-188,275419666,275420150
15890,5,12,149,5745,-72,-97,25,aa:b6:ae:27:64:4e,275420697,468,79,275420229,275420697
15891,5,12,149,5745,-67,-97,30,f6:0a:5c:59:72:df,275423455,476,2282,275422979,275423455
15892,5,12,149,5745,-66,-97,31,0a:e1:ab:b3:c3:a6,275424592,468,669,275424124,275424592
15893,5,12,149,5745,-67,-97,30,b6:90:18:f6:b1:d4,275425643,468,583,275425175,275425643
15894,5,12,149,5745,-59,-97,38,3a:de:b0:2e:cd:45,275426174,468,63,275425706,275426174
15895,5,12,149,5745,-87,-97,10,9a:24:38:da:96:bb,275428885,824,1887,275428061,275428885
15896,5,12,149,5745,-91,-97,6,02:af:71:9e:85:a6,275435190,244,6061,275434946,275435190
15897,5,12,149,5745,-63,-97,34,5e:29:73:5b:30:00,275435605,272,143,275435333,275435605
15898,5,6,149,5745,-86,-97,11,54:e4:3a:ec:fb:65,275439972,360,4007,275439612,275439972
15899,5,12,149,5745,-61,-97,36,76:d6:6a:bb:b3:f5,275450430,272,10186,275450158,275450430
15900,5,12,149,5745,-69,-97,28,3e:ef:29:c7:4b:17,275450790,272,88,275450518,275450790
15901,5,12,149,5745,-75,-97,22,72:d1:72:1d:22:a1,275464668,284,13594,275464384,275464668
15902,5,12,149,5745,-73,-97,24,56:68:e2:c2:8d:d5,275466021,280,1073,275465741,275466021
15903,5,12,149,5745,-65,-97,32,fa:44:8d:e1:c7:1b,275473375,440,6914,275472935,275473375
15904,5,12,149,5745,-90,-97,7,42:d2:d9:2b:ac:61,275475770,452,1943,275475318,275475770
15905,5,12,149,5745,-68,-97,29,22:ec:75:a8:8a:31,275476720,244,706,275476476,275476720
15906,5,12,149,5745,-51,-97,46,3e:d1:9b:c7:a4:de,275483265,272,6273,275482993,275483265
15907,5,12,149,5745,-69,-97,28,0a:e1:ab:b3:c3:a6,275500611,272,17074,275500339,275500611
15908,5,12,149,5745,-91,-97,6,42:d2:d9:2b:ac:61,275501755,256,888,275501499,275501755
15909,5,24,149,5745,-86,-97,11,,275508085,32,6298,275508053,275508085
15910,5,12,149,5745,-61,-97,36,3a:de:b0:2e:cd:45,275520048,272,11691,275519776,275520048
15911,5,12,149,5745,-84,-97,13,9a:24:38:da:96:bb,275520633,272,313,275520361,275520633
15912,5,12,149,5745,-65,-97,32,f2:da:61:dd:98:c5,275527055,272,6150,275526783,275527055
15913,5,12,149,5745,-62,-97,35,5e:29:73:5b:30:00,275533097,272,5770,275532825,275533097
15914,5,6,149,5745,-83,-97,14,54:e4:3a:ec:fb:65,275542602,360,9145,275542242,275542602
15915,5,12,149,5745,-69,-97,28,9e:1f:b0:a7:b8:90,275543735,284,849,275543451,275543735
15916,5,12,149,5745,-70,-97,27,fa:44:8d:e1:c7:1b,275545089,244,1110,275544845,275545089
15917,5,12,149,5745,-68,-97,29,b6:90:18:f6:b1:d4,275566960,272,21599,275566688,275566960
15918,5,12,149,5745,-73,-97,24,72:d1:72:1d:22:a1,275567313,284,69,275567029,275567313
15919,5,12,149,5745,-73,-97,24,56:68:e2:c2:8d:d5,275569089,280,1496,275568809,275569089
15920,5,12,149,5745,-89,-97,8,02:af:71:9e:85:a6,275579551,244,10218,275579307,275579551
15921,5,12,149,5745,-65,-97,32,22:ec:75:a8:8a:31,275593708,244,13913,275593464,275593708
15922,5,12,149,5745,-52,-97,45,3e:d1:9b:c7:a4:de,275600363,272,6383,275600091,275600363
15923,5,24,149,5745,-85,-97,12,,275607250,28,6859,275607222,275607250
15924,5,24,149,5745,-89,-97,8,,275607294,28,16,275607266,275607294
15925,5,24,149,5745,-88,-97,9,,275607403,32,77,275607371,275607403
15926,5,24,149,5745,-88,-97,9,,275609218,28,1787,275609190,275609218
15927,5,24,149,5745,-85,-97,12,,275609262,28,16,275609234,275609262
15928,5,24,149,5745,-84,-97,13,,275609370,32,76,275609338,275609370
15929,5,12,149,5745,-54,-97,43,4a:ea:3c:f4:ce:b2,275610110,272,468,275609838,275610110
15930,5,12,149,5745,-70,-97,27,3e:ef:29:c7:4b:17,275620444,272,10062,275620172,275620444
15931,5,12,149,5745,-90,-97,7,7e:05:42:11:d2:ec,275627267,244,6579,275627023,275627267
15932,5,12,149,5745,-65,-97,32,f6:0a:5c:59:72:df,275628216,280,669,275627936,275628216
15933,5,12,149,5745,-81,-97,16,9a:24:38:da:96:bb,275635920,272,7432,275635648,275635920
15934,5,12,149,5745,-73,-97,24,0a:e1:ab:b3:c3:a6,275639729,272,3537,275639457,275639729
15935,5,12,149,5745,-68,-97,29,f2:da:61:dd:98:c5,275640082,272,81,275639810,275640082
15936,5,24,149,5745,-72,-97,25,,275641445,28,1335,275641417,275641445
15937,5,24,149,5745,-89,-97,8,,275641489,28,16,275641461,275641489
15938,5,24,149,5745,-89,-97,8,,275641597,28,80,275641569,275641597
15939,5,6,149,5745,-85,-97,12,54:e4:3a:ec:fb:65,275644773,360,2816,275644413,275644773
15940,5,12,149,5745,-61,-97,36,76:d6:6a:bb:b3:f5,275645278,272,233,275645006,275645278
15941,5,12,149,5745,-59,-97,38,3a:de:b0:2e:cd:45,275645670,272,120,275645398,275645670
15942,5,12,149,5745,-66,-97,31,9e:1f:b0:a7:b8:90,275646022,284,68,275645738,275646022
15943,5,12,149,5745,-63,-97,34,5e:29:73:5b:30:00,275650239,272,3945,275649967,275650239
15944,5,24,149,5745,-85,-97,12,,275652364,28,2097,275652336,275652364
15945,5,24,149,5745,-88,-97,9,,275652408,28,16,275652380,275652408
15946,5,12,149,5745,-68,-97,29,b6:90:18:f6:b1:d4,275669322,272,16642,275669050,275669322
15947,5,12,149,5745,-70,-97,27,56:68:e2:c2:8d:d5,275670009,280,407,275669729,275670009
15948,5,24,149,5745,-85,-97,12,,275670911,28,874,275670883,275670911
15949,5,24,149,5745,-85,-97,12,,275671019,32,76,275670987,275671019
15950,5,12,149,5745,-91,-97,6,02:af:71:9e:85:a6,275681725,244,10462,275681481,275681725
15951,5,12,149,5745,-89,-97,8,42:d2:d9:2b:ac:61,275682013,260,28,275681753,275682013
15952,5,12,149,5745,-66,-97,31,22:ec:75:a8:8a:31,275707538,244,25281,275707294,275707538
15953,5,12,149,5745,-53,-97,44,3e:d1:9b:c7:a4:de,275717514,272,9704,275717242,275717514
15954,5,12,149,5745,-73,-97,24,3e:ef:29:c7:4b:17,275722879,272,5093,275722607,275722879
15955,5,24,149,5745,-85,-97,12,,275724445,28,1538,275724417,275724445
15956,5,24,149,5745,-86,-97,11,,275724489,28,16,275724461,275724489
15957,5,24,149,5745,-86,-97,11,,275724610,32,89,275724578,275724610
15958,5,12,149,5745,-66,-97,31,f6:0a:5c:59:72:df,275724705,280,-185,275724425,275724705
15959,5,24,149,5745,-86,-97,11,,275727225,28,2492,275727197,275727225
15960,5,24,149,5745,-84,-97,13,,275727269,28,16,275727241,275727269
15961,5,24,149,5745,-85,-97,12,,275727380,32,79,275727348,275727380
15962,5,24,149,5745,-87,-97,10,,275727573,28,165,275727545,275727573
15963,5,24,149,5745,-85,-97,12,,275727617,28,16,275727589,275727617
15964,5,24,149,5745,-85,-97,12,,275727729,32,80,275727697,275727729
15965,5,12,149,5745,-68,-97,29,0a:e1:ab:b3:c3:a6,275741183,272,13182,275740911,275741183
15966,5,12,149,5745,-84,-97,13,9a:24:38:da:96:bb,275744040,272,2585,275743768,275744040
15967,5,6,149,5745,-88,-97,9,54:e4:3a:ec:fb:65,275747173,360,2773,275746813,275747173
15968,5,12,149,5745,-58,-97,39,3a:de:b0:2e:cd:45,275747694,272,249,275747422,275747694
15969,5,12,149,5745,-63,-97,34,76:d6:6a:bb:b3:f5,275749490,272,1524,275749218,275749490
15970,5,12,149,5745,-67,-97,30,f2:da:61:dd:98:c5,275752518,272,2756,275752246,275752518
15971,5,12,149,5745,-66,-97,31,9e:1f:b0:a7:b8:90,275764512,284,11710,275764228,275764512
15972,5,12,149,5745,-63,-97,34,5e:29:73:5b:30:00,275767345,272,2561,275767073,275767345
15973,5,12,149,5745,-69,-97,28,fa:44:8d:e1:c7:1b,275771004,244,3415,275770760,275771004
15974,5,12,149,5745,-69,-97,28,b6:90:18:f6:b1:d4,275771473,272,197,275771201,275771473
15975,5,12,149,5745,-73,-97,24,72:d1:72:1d:22:a1,275771859,284,102,275771575,275771859
15976,5,12,149,5745,-70,-97,27,56:68:e2:c2:8d:d5,275772931,280,792,275772651,275772931
15977,5,12,149,5745,-91,-97,6,02:af:71:9e:85:a6,275783839,244,10664,275783595,275783839
15978,5,12,149,5745,-92,-97,5,42:d2:d9:2b:ac:61,275784200,260,101,275783940,275784200
15979,5,12,149,5745,-63,-97,34,76:d6:6a:bb:b3:f5,275802036,272,17564,275801764,275802036
15980,5,12,149,5745,-66,-97,31,22:ec:75:a8:8a:31,275819749,244,17469,275819505,275819749
15981,5,12,149,5745,-73,-97,24,3e:ef:29:c7:4b:17,275823742,272,3721,275823470,275823742
15982,5,12,149,5745,-57,-97,40,4a:ea:3c:f4:ce:b2,275824842,272,828,275824570,275824842
15983,5,24,149,5745,-85,-97,12,,275828254,28,3384,275828226,275828254
15984,5,24,149,5745,-84,-97,13,,275828298,28,16,275828270,275828298
15985,5,24,149,5745,-85,-97,12,,275828407,32,77,275828375,275828407
15986,5,12,149,5745,-52,-97,45,3e:d1:9b:c7:a4:de,275829661,272,982,275829389,275829661
15987,5,24,149,5745,-84,-97,13,,275846263,28,16574,275846235,275846263
15988,5,24,149,5745,-85,-97,12,,275846307,28,16,275846279,275846307
15989,5,24,149,5745,-85,-97,12,,275846415,32,76,275846383,275846415
15990,5,12,149,5745,-68,-97,29,0a:e1:ab:b3:c3:a6,275846624,272,-63,275846352,275846624
15991,5,6,149,5745,-85,-97,12,54:e4:3a:ec:fb:65,275849574,360,2590,275849214,275849574
15992,5,12,149,5745,-84,-97,13,9a:24:38:da:96:bb,275855589,272,5743,275855317,275855589
15993,5,12,149,5745,-74,-97,23,3e:ef:29:c7:4b:17,275860095,468,4038,275859627,275860095
15994,5,12,149,5745,-68,-97,29,56:68:e2:c2:8d:d5,275860624,280,249,275860344,275860624
15995,5,12,149,5745,-56,-97,41,3a:de:b0:2e:cd:45,275861696,272,800,275861424,275861696
15996,5,12,149,5745,-51,-97,46,3e:d1:9b:c7:a4:de,275862002,544,-238,275861458,275862002
15997,5,12,149,5745,-67,-97,30,f2:da:61:dd:98:c5,275862575,272,301,275862303,275862575
15998,5,12,149,5745,-62,-97,35,76:d6:6a:bb:b3:f5,275862892,468,-151,275862424,275862892
15999,5,12,149,5745,-74,-97,23,72:d1:72:1d:22:a1,275863404,284,228,275863120,275863404
16000,5,12,149,5745,-74,-97,23,72:d1:72:1d:22:a1,275868691,480,4807,275868211,275868691
16001,5,12,149,5745,-66,-97,31,fa:44:8d:e1:c7:1b,275869233,440,102,275868793,275869233
16002,5,12,149,5745,-66,-97,31,9e:1f:b0:a7:b8:90,275870742,480,1029,275870262,275870742
16003,5,12,149,5745,-68,-97,29,22:ec:75:a8:8a:31,275873117,516,1859,275872601,275873117
16004,5,12,149,5745,-66,-97,31,f6:0a:5c:59:72:df,275874198,476,605,275873722,275874198
16005,5,12,149,5745,-69,-97,28,b6:90:18:f6:b1:d4,275877341,272,2871,275877069,275877341
16006,5,12,149,5745,-56,-97,41,4a:ea:3c:f4:ce:b2,275877759,468,-50,275877291,275877759
16007,5,12,149,5745,-66,-97,31,fa:44:8d:e1:c7:1b,275878504,244,501,275878260,275878504
16008,5,12,149,5745,-67,-97,30,f2:da:61:dd:98:c5,275878783,468,-189,275878315,275878783
16009,5,12,149,5745,-69,-97,28,56:68:e2:c2:8d:d5,275881760,476,2501,275881284,275881760
16010,5,12,149,5745,-58,-97,39,5e:29:73:5b:30:00,275883305,540,1005,275882765,275883305
16011,5,12,149,5745,-68,-97,29,b6:90:18:f6:b1:d4,275884745,468,972,275884277,275884745
16012,5,12,149,5745,-67,-97,30,0a:e1:ab:b3:c3:a6,275885283,468,70,275884815,275885283
16013,5,12,149,5745,-57,-97,40,3a:de:b0:2e:cd:45,275886416,468,665,275885948,275886416
16014,5,12,149,5745,-59,-97,38,5e:29:73:5b:30:00,275894380,272,7692,275894108,275894380
16015,5,12,149,5745,-75,-97,22,d2:00:04:7e:2c:ab,275903101,412,8309,275902689,275903101
16016,5,12,149,5745,-75,-97,22,3e:ef:29:c7:4b:17,275909010,272,5637,275908738,275909010
16017,5,12,149,5745,-62,-97,35,76:d6:6a:bb:b3:f5,275909369,272,87,275909097,275909369
16018,5,12,149,5745,-52,-97,45,3e:d1:9b:c7:a4:de,275928037,544,18124,275927493,275928037
16019,5,12,149,5745,-66,-97,31,b6:90:18:f6:b1:d4,275928662,468,157,275928194,275928662
16020,5,12,149,5745,-60,-97,37,76:d6:6a:bb:b3:f5,275929165,468,35,275928697,275929165
16021,5,12,149,5745,-72,-97,25,aa:b6:ae:27:64:4e,275930702,468,1069,275930234,275930702
16022,5,12,149,5745,-64,-97,33,fa:44:8d:e1:c7:1b,275931206,440,64,275930766,275931206
16023,5,12,149,5745,-72,-97,25,72:d1:72:1d:22:a1,275931879,480,193,275931399,275931879
16024,5,12,149,5745,-62,-97,35,0a:b9:b7:b1:4d:fa,275932754,468,407,275932286,275932754
16025,5,12,149,5745,-89,-97,8,42:d2:d9:2b:ac:61,275933328,360,214,275932968,275933328
16026,5,12,149,5745,-63,-97,34,9e:1f:b0:a7:b8:90,275934581,480,773,275934101,275934581
16027,5,12,149,5745,-71,-97,26,a6:92:ad:b7:76:65,275936710,484,1645,275936226,275936710
16028,5,12,149,5745,-67,-97,30,22:ec:75:a8:8a:31,275938146,516,920,275937630,275938146
16029,5,12,149,5745,-69,-97,28,f6:0a:5c:59:72:df,275938694,280,268,275938414,275938694
16030,5,12,149,5745,-71,-97,26,f6:0a:5c:59:72:df,275938991,476,-179,275938515,275938991
16031,5,12,149,5745,-56,-97,41,4a:ea:3c:f4:ce:b2,275939511,468,52,275939043,275939511
16032,5,12,149,5745,-64,-97,33,fa:44:8d:e1:c7:1b,275940067,360,196,275939707,275940067
16033,5,12,149,5745,-65,-97,32,fa:44:8d:e1:c7:1b,275940506,260,179,275940246,275940506
16034,5,12,149,5745,-69,-97,28,f2:da:61:dd:98:c5,275941142,468,168,275940674,275941142
16035,5,12,149,5745,-70,-97,27,56:68:e2:c2:8d:d5,275941731,476,113,275941255,275941731
16036,5,12,149,5745,-75,-97,22,3e:ef:29:c7:4b:17,275942270,468,71,275941802,275942270
16037,5,12,149,5745,-63,-97,34,0a:e1:ab:b3:c3:a6,275942875,272,333,275942603,275942875
16038,5,12,149,5745,-63,-97,34,0a:e1:ab:b3:c3:a6,275945170,468,1827,275944702,275945170
16039,5,12,149,5745,-90,-97,7,02:af:71:9e:85:a6,275946178,440,568,275945738,275946178
16040,5,12,149,5745,-62,-97,35,5e:29:73:5b:30:00,275948625,540,1907,275948085,275948625
16041,5,12,149,5745,-86,-97,11,9a:24:38:da:96:bb,275949227,824,-222,275948403,275949227
16042,5,12,149,5745,-60,-97,37,3a:de:b0:2e:cd:45,275950778,468,1083,275950310,275950778
16043,5,6,149,5745,-84,-97,13,54:e4:3a:ec:fb:65,275951974,360,836,275951614,275951974
16044,5,12,149,5745,-52,-97,45,3e:d1:9b:c7:a4:de,275958419,272,6173,275958147,275958419
16045,5,12,149,5745,-60,-97,37,3a:de:b0:2e:cd:45,275959870,272,1179,275959598,275959870
16046,5,12,149,5745,-89,-97,8,42:d2:d9:2b:ac:61,275960540,256,414,275960284,275960540
16047,5,12,149,5745,-87,-97,10,9a:24:38:da:96:bb,275967430,272,6618,275967158,275967430
16048,5,12,149,5745,-69,-97,28,56:68:e2:c2:8d:d5,275976213,280,8503,275975933,275976213
16049,5,12,149,5745,-72,-97,25,72:d1:72:1d:22:a1,275977006,284,509,275976722,275977006
16050,5,12,149,5745,-72,-97,25,f2:da:61:dd:98:c5,275977324,272,46,275977052,275977324
16051,5,12,149,5745,-63,-97,34,9e:1f:b0:a7:b8:90,275977676,284,68,275977392,275977676
16052,5,12,149,5745,-65,-97,32,fa:44:8d:e1:c7:1b,275990405,244,12485,275990161,275990405
16053,5,12,149,5745,-59,-97,38,76:d6:6a:bb:b3:f5,275994481,468,3608,275994013,275994481
16054,5,12,149,5745,-65,-97,32,fa:44:8d:e1:c7:1b,275997188,440,2267,275996748,275997188
16055,5,12,149,5745,-91,-97,6,02:af:71:9e:85:a6,276005045,244,7613,276004801,276005045
16056,5,12,149,5745,-69,-97,28,b6:90:18:f6:b1:d4,276005877,272,560,276005605,276005877
16057,5,12,149,5745,-62,-97,35,5e:29:73:5b:30:00,276009010,272,2861,276008738,276009010
16058,5,24,149,5745,-84,-97,13,,276012078,32,3036,276012046,276012078
16059,5,12,149,5745,-62,-97,35,5e:29:73:5b:30:00,276013617,540,999,276013077,276013617
16060,5,12,149,5745,-61,-97,36,76:d6:6a:bb:b3:f5,276023241,272,9352,276022969,276023241
16061,5,12,149,5745,-75,-97,22,3e:ef:29:c7:4b:17,276033244,272,9731,276032972,276033244
16062,5,12,149,5745,-65,-97,32,22:ec:75:a8:8a:31,276049422,244,15934,276049178,276049422
16063,5,6,149,5745,-86,-97,11,54:e4:3a:ec:fb:65,276054375,360,4593,276054015,276054375
16064,5,12,149,5745,-56,-97,41,3e:d1:9b:c7:a4:de,276056515,272,1868,276056243,276056515
16065,5,12,149,5745,-65,-97,32,76:d6:6a:bb:b3:f5,276059504,468,2521,276059036,276059504
16066,5,12,149,5745,-70,-97,27,0a:e1:ab:b3:c3:a6,276061914,272,2138,276061642,276061914
16067,5,12,149,5745,-69,-97,28,f6:0a:5c:59:72:df,276062609,280,415,276062329,276062609
16068,5,12,149,5745,-91,-97,6,42:d2:d9:2b:ac:61,276074331,256,11466,276074075,276074331
16069,5,12,149,5745,-64,-97,33,5e:29:73:5b:30:00,276075767,540,896,276075227,276075767
16070,5,12,149,5745,-87,-97,10,9a:24:38:da:96:bb,276080696,272,4657,276080424,276080696
16071,5,6,149,5745,-82,-97,15,54:e4:3a:ec:fb:65,276115101,352,34053,276114749,276115101
16072,5,6,149,5745,-82,-97,15,54:e4:3a:ec:fb:65,276115532,352,79,276115180,276115532
16073,5,6,149,5745,-82,-97,15,54:e4:3a:ec:fb:65,276116096,352,212,276115744,276116096
16074,5,6,149,5745,-82,-97,15,54:e4:3a:ec:fb:65,276116654,352,206,276116302,276116654
16075,5,12,149,5745,-64,-97,33,5e:29:73:5b:30:00,276123728,272,6802,276123456,276123728
16076,5,12,149,5745,-63,-97,34,76:d6:6a:bb:b3:f5,276125619,468,1423,276125151,276125619
16077,5,6,149,5745,-83,-97,14,54:e4:3a:ec:fb:65,276135783,352,9812,276135431,276135783
16078,5,6,149,5745,-83,-97,14,54:e4:3a:ec:fb:65,276136350,352,215,276135998,276136350
16079,5,6,149,5745,-84,-97,13,54:e4:3a:ec:fb:65,276136871,352,169,276136519,276136871
16080,5,6,149,5745,-84,-97,13,54:e4:3a:ec:fb:65,276137969,352,746,276137617,276137969
16081,5,12,149,5745,-63,-97,34,76:d6:6a:bb:b3:f5,276138445,272,204,276138173,276138445
16082,5,12,149,5745,-64,-97,33,5e:29:73:5b:30:00,276141307,540,2322,276140767,276141307
16083,5,12,149,5745,-73,-97,24,3e:ef:29:c7:4b:17,276142706,272,1127,276142434,276142706
16084,5,6,149,5745,-86,-97,11,54:e4:3a:ec:fb:65,276156775,360,13709,276156415,276156775
16085,5,12,149,5745,-61,-97,36,3a:de:b0:2e:cd:45,276157530,272,483,276157258,276157530
16086,5,12,149,5745,-66,-97,31,f2:da:61:dd:98:c5,276157939,272,137,276157667,276157939
16087,5,12,149,5745,-65,-97,32,9e:1f:b0:a7:b8:90,276159426,284,1203,276159142,276159426
16088,5,12,149,5745,-67,-97,30,22:ec:75:a8:8a:31,276166527,244,6857,276166283,276166527
16089,5,12,149,5745,-55,-97,42,3e:d1:9b:c7:a4:de,276171833,272,5034,276171561,276171833
16090,5,12,149,5745,-62,-97,35,fa:44:8d:e1:c7:1b,276180064,244,7987,276179820,276180064
16091,5,12,149,5745,-70,-97,27,b6:90:18:f6:b1:d4,276180398,272,62,276180126,276180398
16092,5,12,149,5745,-73,-97,24,72:d1:72:1d:22:a1,276180794,284,112,276180510,276180794
16093,5,24,149,5745,-83,-97,14,,276182518,32,1692,276182486,276182518
16094,5,12,149,5745,-69,-97,28,56:68:e2:c2:8d:d5,276183563,280,765,276183283,276183563
16095,5,12,149,5745,-92,-97,5,42:d2:d9:2b:ac:61,276187659,256,3840,276187403,276187659
16096,5,12,149,5745,-92,-97,5,02:af:71:9e:85:a6,276193870,244,5967,276193626,276193870
16097,5,12,149,5745,-83,-97,14,9a:24:38:da:96:bb,276196338,272,2196,276196066,276196338
16098,5,12,149,5745,-61,-97,36,5e:29:73:5b:30:00,276221206,272,24596,276220934,276221206
16099,5,24,149,5745,-85,-97,12,,276234890,28,13656,276234862,276234890
16100,5,24,149,5745,-88,-97,9,,276234934,28,16,276234906,276234934
16101,5,24,149,5745,-84,-97,13,,276235202,28,240,276235174,276235202
16102,5,24,149,5745,-88,-97,9,,276235361,32,127,276235329,276235361
16103,5,24,149,5745,-84,-97,13,,276240107,28,4718,276240079,276240107
16104,5,24,149,5745,-85,-97,12,,276240216,32,77,276240184,276240216
16105,5,12,149,5745,-67,-97,30,0a:e1:ab:b3:c3:a6,276253665,272,13177,276253393,276253665
16106,5,6,149,5745,-85,-97,12,54:e4:3a:ec:fb:65,276259176,360,5151,276258816,276259176
16107,5,12,149,5745,-66,-97,31,f2:da:61:dd:98:c5,276259563,272,115,276259291,276259563
16108,5,12,149,5745,-61,-97,36,3a:de:b0:2e:cd:45,276259898,272,63,276259626,276259898
16109,5,12,149,5745,-61,-97,36,76:d6:6a:bb:b3:f5,276260246,272,76,276259974,276260246
16110,5,12,149,5745,-64,-97,33,9e:1f:b0:a7:b8:90,276261820,284,1290,276261536,276261820
16111,5,12,149,5745,-78,-97,19,3e:ef:29:c7:4b:17,276265116,272,3024,276264844,276265116
16112,5,12,149,5745,-61,-97,36,4a:ea:3c:f4:ce:b2,276269582,272,4194,276269310,276269582
16113,5,12,149,5745,-76,-97,21,72:d1:72:1d:22:a1,276283374,284,13508,276283090,276283374
16114,5,12,149,5745,-67,-97,30,22:ec:75:a8:8a:31,276283692,244,74,276283448,276283692
16115,5,12,149,5745,-69,-97,28,b6:90:18:f6:b1:d4,276284059,272,95,276283787,276284059
16116,5,12,149,5745,-60,-97,37,fa:44:8d:e1:c7:1b,276284589,244,286,276284345,276284589
16117,5,12,149,5745,-72,-97,25,56:68:e2:c2:8d:d5,276284867,280,-2,276284587,276284867
16118,5,12,149,5745,-67,-97,30,0a:e1:ab:b3:c3:a6,276288930,272,3791,276288658,276288930
16119,5,12,149,5745,-56,-97,41,3e:d1:9b:c7:a4:de,276289272,272,70,276289000,276289272
16120,5,12,149,5745,-89,-97,8,42:d2:d9:2b:ac:61,276300823,256,11295,276300567,276300823
16121,5,12,149,5745,-87,-97,10,9a:24:38:da:96:bb,276303318,272,2223,276303046,276303318
16122,5,12,149,5745,-62,-97,35,3a:de:b0:2e:cd:45,276305840,272,2250,276305568,276305840
16123,5,12,149,5745,-60,-97,37,fa:44:8d:e1:c7:1b,276318090,244,12006,276317846,276318090
16124,5,12,149,5745,-72,-97,25,56:68:e2:c2:8d:d5,276319435,280,1065,276319155,276319435
16125,5,12,149,5745,-62,-97,35,9e:1f:b0:a7:b8:90,276319767,284,48,276319483,276319767
16126,5,12,149,5745,-72,-97,25,72:d1:72:1d:22:a1,276320796,480,549,276320316,276320796
16127,5,12,149,5745,-71,-97,26,72:d1:72:1d:22:a1,276321294,284,214,276321010,276321294
16128,5,12,149,5745,-69,-97,28,f2:da:61:dd:98:c5,276321639,272,73,276321367,276321639
16129,5,12,149,5745,-57,-97,40,3e:d1:9b:c7:a4:de,276321954,544,-229,276321410,276321954
16130,5,12,149,5745,-68,-97,29,b6:90:18:f6:b1:d4,276322727,468,305,276322259,276322727
16131,5,12,149,5745,-69,-97,28,f2:da:61:dd:98:c5,276323292,468,97,276322824,276323292
16132,5,12,149,5745,-62,-97,35,3a:de:b0:2e:cd:45,276323813,468,53,276323345,276323813
16133,5,12,149,5745,-58,-97,39,fa:44:8d:e1:c7:1b,276325207,440,954,276324767,276325207
16134,5,12,149,5745,-63,-97,34,76:d6:6a:bb:b3:f5,276325690,468,15,276325222,276325690
16135,5,12,149,5745,-63,-97,34,3a:de:b0:2e:cd:45,276326292,116,486,276326176,276326292
16136,5,12,149,5745,-89,-97,8,42:d2:d9:2b:ac:61,276331222,452,4478,276330770,276331222
16137,5,12,149,5745,-67,-97,30,22:ec:75:a8:8a:31,276331707,516,-31,276331191,276331707
16138,5,12,149,5745,-61,-97,36,9e:1f:b0:a7:b8:90,276332339,480,152,276331859,276332339
16139,5,12,149,5745,-70,-97,27,f6:0a:5c:59:72:df,276333636,476,821,276333160,276333636
16140,5,12,149,5745,-63,-97,34,76:d6:6a:bb:b3:f5,276335317,288,1393,276335029,276335317
16141,5,12,149,5745,-68,-97,29,b6:90:18:f6:b1:d4,276336126,272,537,276335854,276336126
16142,5,12,149,5745,-67,-97,30,0a:e1:ab:b3:c3:a6,276336477,468,-117,276336009,276336477
16143,5,12,149,5745,-60,-97,37,5e:29:73:5b:30:00,276337930,540,913,276337390,276337930
16144,5,12,149,5745,-78,-97,19,3e:ef:29:c7:4b:17,276338522,468,124,276338054,276338522
16145,5,12,149,5745,-61,-97,36,4a:ea:3c:f4:ce:b2,276339061,468,71,276338593,276339061
16146,5,12,149,5745,-86,-97,11,9a:24:38:da:96:bb,276343296,824,3411,276342472,276343296
16147,5,12,149,5745,-61,-97,36,5e:29:73:5b:30:00,276353093,272,9525,276352821,276353093
16148,5,6,149,5745,-87,-97,10,54:e4:3a:ec:fb:65,276361577,360,8124,276361217,276361577
16149,5,12,149,5745,-62,-97,35,4a:ea:3c:f4:ce:b2,276366572,272,4723,276366300,276366572
16150,5,12,149,5745,-62,-97,35,76:d6:6a:bb:b3:f5,276368104,272,1260,276367832,276368104
16151,5,12,149,5745,-76,-97,21,3e:ef:29:c7:4b:17,276368788,272,412,276368516,276368788
16152,5,12,149,5745,-91,-97,6,02:af:71:9e:85:a6,276375731,244,6699,276375487,276375731
16153,5,12,149,5745,-66,-97,31,f2:da:61:dd:98:c5,276386746,468,10547,276386278,276386746
16154,5,12,149,5745,-70,-97,27,f6:0a:5c:59:72:df,276387248,280,222,276386968,276387248
16155,5,12,149,5745,-61,-97,36,3a:de:b0:2e:cd:45,276387618,468,-98,276387150,276387618
16156,5,12,149,5745,-64,-97,33,76:d6:6a:bb:b3:f5,276388121,468,35,276387653,276388121
16157,5,12,149,5745,-60,-97,37,fa:44:8d:e1:c7:1b,276389991,440,1430,276389551,276389991
16158,5,12,149,5745,-93,-97,4,52:6b:a9:19:82:49,276393055,452,2612,276392603,276393055
16159,5,12,149,5745,-94,-97,3,42:d2:d9:2b:ac:61,276395402,452,1895,276394950,276395402
16160,5,12,149,5745,-72,-97,25,f6:0a:5c:59:72:df,276398680,476,2802,276398204,276398680
16161,5,12,149,5745,-60,-97,37,4a:ea:3c:f4:ce:b2,276399559,468,411,276399091,276399559
16162,5,12,149,5745,-71,-97,26,22:ec:75:a8:8a:31,276400637,244,834,276400393,276400637
16163,5,12,149,5745,-70,-97,27,0a:e1:ab:b3:c3:a6,276401879,272,970,276401607,276401879
16164,5,12,149,5745,-93,-97,4,42:d2:d9:2b:ac:61,276402849,256,714,276402593,276402849
16165,5,12,149,5745,-64,-97,33,5e:29:73:5b:30:00,276403146,540,-243,276402606,276403146
16166,5,12,149,5745,-53,-97,44,3e:d1:9b:c7:a4:de,276405881,272,2463,276405609,276405881
16167,5,12,149,5745,-59,-97,38,3a:de:b0:2e:cd:45,276418418,272,12265,276418146,276418418
16168,5,12,149,5745,-59,-97,38,fa:44:8d:e1:c7:1b,276433102,244,14440,276432858,276433102
16169,5,12,149,5745,-65,-97,32,f2:da:61:dd:98:c5,276435747,272,2373,276435475,276435747
16170,5,12,149,5745,-77,-97,20,d2:00:04:7e:2c:ab,276438908,380,2781,276438528,276438908
16171,5,12,149,5745,-77,-97,20,72:d1:72:1d:22:a1,276441214,284,2022,276440930,276441214
16172,5,12,149,5745,-72,-97,25,56:68:e2:c2:8d:d5,276443395,280,1901,276443115,276443395
16173,5,24,149,5745,-86,-97,11,,276445201,28,1778,276445173,276445201
16174,5,24,149,5745,-86,-97,11,,276445246,28,17,276445218,276445246
16175,5,24,149,5745,-86,-97,11,,276445354,32,76,276445322,276445354
16176,5,12,149,5745,-64,-97,33,9e:1f:b0:a7:b8:90,276446884,284,1246,276446600,276446884
16177,5,24,149,5745,-86,-97,11,,276447856,32,940,276447824,276447856
16178,5,24,149,5745,-87,-97,10,,276448355,32,467,276448323,276448355
16179,5,24,149,5745,-85,-97,12,,276448855,28,472,276448827,276448855
16180,5,12,149,5745,-70,-97,27,b6:90:18:f6:b1:d4,276450558,272,1431,276450286,276450558
16181,5,12,149,5745,-91,-97,6,02:af:71:9e:85:a6,276451727,244,925,276451483,276451727
16182,5,12,149,5745,-65,-97,32,f2:da:61:dd:98:c5,276452039,468,-156,276451571,276452039
16183,5,12,149,5745,-67,-97,30,76:d6:6a:bb:b3:f5,276452541,468,34,276452073,276452541
16184,5,12,149,5745,-58,-97,39,3a:de:b0:2e:cd:45,276453071,468,62,276452603,276453071
16185,5,12,149,5745,-54,-97,43,3e:d1:9b:c7:a4:de,276453645,544,30,276453101,276453645
16186,5,12,149,5745,-70,-97,27,b6:90:18:f6:b1:d4,276454252,468,139,276453784,276454252
16187,5,12,149,5745,-59,-97,38,fa:44:8d:e1:c7:1b,276456370,440,1678,276455930,276456370
16188,5,12,149,5745,-88,-97,9,42:d2:d9:2b:ac:61,276458431,452,1609,276457979,276458431
16189,5,12,149,5745,-54,-97,43,4a:ea:3c:f4:ce:b2,276460274,468,1375,276459806,276460274
16190,5,12,149,5745,-89,-97,8,7e:05:42:11:d2:ec,276461042,440,328,276460602,276461042
16191,5,12,149,5745,-68,-97,29,a6:92:ad:b7:76:65,276462579,484,1053,276462095,276462579
16192,5,24,149,5745,-85,-97,12,,276463107,28,500,276463079,276463107
16193,5,24,149,5745,-86,-97,11,,276463152,28,17,276463124,276463152
16194,5,24,149,5745,-86,-97,11,,276463259,32,75,276463227,276463259
16195,5,12,149,5745,-58,-97,39,0a:b9:b7:b1:4d:fa,276463335,468,-392,276462867,276463335
16196,5,12,149,5745,-73,-97,24,f6:0a:5c:59:72:df,276463900,476,89,276463424,276463900
16197,5,12,149,5745,-66,-97,31,22:ec:75:a8:8a:31,276465283,516,867,276464767,276465283
16198,5,12,149,5745,-65,-97,32,5e:29:73:5b:30:00,276467849,272,2294,276467577,276467849
16199,5,12,149,5745,-64,-97,33,5e:29:73:5b:30:00,276468462,540,73,276467922,276468462
16200,5,12,149,5745,-73,-97,24,3e:ef:29:c7:4b:17,276469036,468,106,276468568,276469036
16201,5,12,149,5745,-64,-97,33,0a:e1:ab:b3:c3:a6,276469583,468,79,276469115,276469583
16202,5,12,149,5745,-76,-97,21,d2:00:04:7e:2c:ab,276470139,440,116,276469699,276470139
16203,5,12,149,5745,-90,-97,7,02:af:71:9e:85:a6,276471169,440,590,276470729,276471169
16204,5,12,149,5745,-83,-97,14,9a:24:38:da:96:bb,276476133,824,4140,276475309,276476133
16205,5,12,149,5745,-54,-97,43,4a:ea:3c:f4:ce:b2,276478521,272,2116,276478249,276478521
16206,5,12,149,5745,-65,-97,32,76:d6:6a:bb:b3:f5,276481970,272,3177,276481698,276481970
16207,5,12,149,5745,-73,-97,24,3e:ef:29:c7:4b:17,276482303,272,61,276482031,276482303
16208,5,12,149,5745,-83,-97,14,9a:24:38:da:96:bb,276495092,272,12517,276494820,276495092
16209,5,24,149,5745,-71,-97,26,,276496224,28,1104,276496196,276496224
16210,5,24,149,5745,-84,-97,13,,276496268,28,16,276496240,276496268
16211,5,24,149,5745,-85,-97,12,,276496376,28,80,276496348,276496376
16212,5,12,149,5745,-74,-97,23,f6:0a:5c:59:72:df,276498548,280,1892,276498268,276498548
16213,5,12,149,5745,-65,-97,32,0a:e1:ab:b3:c3:a6,276500384,272,1564,276500112,276500384
16214,5,24,149,5745,-84,-97,13,,276511322,32,10906,276511290,276511322
16215,5,12,149,5745,-65,-97,32,22:ec:75:a8:8a:31,276513074,244,1508,276512830,276513074
16216,5,12,149,5745,-55,-97,42,3e:d1:9b:c7:a4:de,276518479,272,5133,276518207,276518479
16217,5,12,149,5745,-61,-97,36,76:d6:6a:bb:b3:f5,276518804,468,-143,276518336,276518804
16218,5,12,149,5745,-59,-97,38,fa:44:8d:e1:c7:1b,276521304,440,2060,276520864,276521304
16219,5,12,149,5745,-91,-97,6,42:d2:d9:2b:ac:61,276533210,256,11650,276532954,276533210
16220,5,12,149,5745,-59,-97,38,3a:de:b0:2e:cd:45,276533747,272,265,276533475,276533747
16221,5,12,149,5745,-62,-97,35,5e:29:73:5b:30:00,276534480,540,193,276533940,276534480
16222,5,12,149,5745,-90,-97,7,c6:71:4f:a2:d1:86,276540754,440,5834,276540314,276540754
16223,5,12,149,5745,-59,-97,38,fa:44:8d:e1:c7:1b,276547425,244,6427,276547181,276547425
16224,5,12,149,5745,-65,-97,32,f2:da:61:dd:98:c5,276555796,272,8099,276555524,276555796
16225,5,12,149,5745,-65,-97,32,9e:1f:b0:a7:b8:90,276559446,284,3366,276559162,276559446
16226,5,6,149,5745,-86,-97,11,54:e4:3a:ec:fb:65,276566378,360,6572,276566018,276566378
16227,5,12,149,5745,-63,-97,34,5e:29:73:5b:30:00,276566765,272,115,276566493,276566765
16228,5,12,149,5745,-68,-97,29,b6:90:18:f6:b1:d4,276572370,272,5333,276572098,276572370
16229,5,24,149,5745,-70,-97,27,,276572725,28,327,276572697,276572725
16230,5,24,149,5745,-85,-97,12,,276572769,28,16,276572741,276572769
16231,5,24,149,5745,-86,-97,11,,276572877,28,80,276572849,276572877
16232,5,12,149,5745,-91,-97,6,02:af:71:9e:85:a6,276578537,244,5416,276578293,276578537
16233,5,12,149,5745,-59,-97,38,76:d6:6a:bb:b3:f5,276584222,468,5217,276583754,276584222
16234,5,12,149,5745,-70,-97,27,72:d1:72:1d:22:a1,276591080,284,6574,276590796,276591080
16235,5,12,149,5745,-68,-97,29,56:68:e2:c2:8d:d5,276591767,280,407,276591487,276591767
16236,5,12,149,5745,-60,-97,37,76:d6:6a:bb:b3:f5,276596689,272,4650,276596417,276596689
16237,5,12,149,5745,-62,-97,35,5e:29:73:5b:30:00,276600029,540,2800,276599489,276600029
16238,5,12,149,5745,-57,-97,40,4a:ea:3c:f4:ce:b2,276605271,272,4970,276604999,276605271
16239,5,12,149,5745,-67,-97,30,22:ec:75:a8:8a:31,276628499,244,22984,276628255,276628499
16240,5,12,149,5745,-57,-97,40,3e:d1:9b:c7:a4:de,276635590,272,6819,276635318,276635590
16241,5,12,149,5745,-73,-97,24,3e:ef:29:c7:4b:17,276644769,272,8907,276644497,276644769
16242,5,12,149,5745,-87,-97,10,42:d2:d9:2b:ac:61,276646825,256,1800,276646569,276646825
16243,5,12,149,5745,-61,-97,36,76:d6:6a:bb:b3:f5,276650880,468,3587,276650412,276650880
16244,5,12,149,5745,-89,-97,8,7e:05:42:11:d2:ec,276657378,440,6058,276656938,276657378
16245,5,12,149,5745,-70,-97,27,0a:e1:ab:b3:c3:a6,276663500,272,5850,276663228,276663500
16246,5,12,149,5745,-60,-97,37,5e:29:73:5b:30:00,276665219,540,1179,276664679,276665219
16247,5,12,149,5745,-68,-97,29,f2:da:61:dd:98:c5,276667556,272,2065,276667284,276667556
16248,5,6,149,5745,-87,-97,10,54:e4:3a:ec:fb:65,276668778,360,862,276668418,276668778
16249,5,12,149,5745,-60,-97,37,5e:29:73:5b:30:00,276669196,272,146,276668924,276669196
16250,5,12,149,5745,-61,-97,36,3a:de:b0:2e:cd:45,276669548,272,80,276669276,276669548
16251,5,24,149,5745,-85,-97,12,,276670465,28,889,276670437,276670465
16252,5,24,149,5745,-86,-97,11,,276670509,28,16,276670481,276670509
16253,5,24,149,5745,-86,-97,11,,276670617,32,76,276670585,276670617
16254,5,12,149,5745,-65,-97,32,9e:1f:b0:a7:b8:90,276677347,284,6446,276677063,276677347
16255,5,12,149,5745,-69,-97,28,b6:90:18:f6:b1:d4,276685297,272,7678,276685025,276685297
16256,5,24,149,5745,-87,-97,10,,276688641,28,3316,276688613,276688641
16257,5,24,149,5745,-84,-97,13,,276688685,28,16,276688657,276688685
16258,5,24,149,5745,-84,-97,13,,276688793,32,76,276688761,276688793
16259,5,12,149,5745,-66,-97,31,fa:44:8d:e1:c7:1b,276692670,244,3633,276692426,276692670
16260,5,12,149,5745,-72,-97,25,72:d1:72:1d:22:a1,276693521,284,567,276693237,276693521
16261,5,12,149,5745,-67,-97,30,56:68:e2:c2:8d:d5,276693900,280,99,276693620,276693900
16262,5,12,149,5745,-92,-97,5,02:af:71:9e:85:a6,276705690,244,11546,276705446,276705690
16263,5,12,149,5745,-60,-97,37,4a:ea:3c:f4:ce:b2,276717060,272,11098,276716788,276717060
16264,5,12,149,5745,-85,-97,12,9a:24:38:da:96:bb,276724371,272,7039,276724099,276724371
16265,5,12,149,5745,-63,-97,34,76:d6:6a:bb:b3:f5,276728959,272,4316,276728687,276728959
16266,5,12,149,5745,-66,-97,31,22:ec:75:a8:8a:31,276746620,244,17417,276746376,276746620
16267,5,12,149,5745,-71,-97,26,3e:ef:29:c7:4b:17,276746969,272,77,276746697,276746969
16268,5,12,149,5745,-56,-97,41,3e:d1:9b:c7:a4:de,276752352,272,5111,276752080,276752352
16269,5,12,149,5745,-87,-97,10,42:d2:d9:2b:ac:61,276760588,256,7980,276760332,276760588
16270,5,24,149,5745,-86,-97,11,,276762159,28,1543,276762131,276762159
16271,5,24,149,5745,-87,-97,10,,276763133,32,942,276763101,276763133
16272,5,12,149,5745,-68,-97,29,0a:e1:ab:b3:c3:a6,276765192,272,1787,276764920,276765192
16273,5,6,149,5745,-84,-97,13,54:e4:3a:ec:fb:65,276771178,360,5626,276770818,276771178
16274,5,12,149,5745,-61,-97,36,3a:de:b0:2e:cd:45,276771701,272,251,276771429,276771701
16275,5,12,149,5745,-67,-97,30,f2:da:61:dd:98:c5,276781414,272,9441,276781142,276781414
16276,5,12,149,5745,-64,-97,33,5e:29:73:5b:30:00,276781747,272,61,276781475,276781747
16277,5,12,149,5745,-63,-97,34,9e:1f:b0:a7:b8:90,276784644,284,2613,276784360,276784644
16278,5,12,149,5745,-68,-97,29,fa:44:8d:e1:c7:1b,276795463,244,10575,276795219,276795463
16279,5,12,149,5745,-70,-97,27,72:d1:72:1d:22:a1,276795830,284,83,276795546,276795830
16280,5,12,149,5745,-69,-97,28,b6:90:18:f6:b1:d4,276798223,272,2121,276797951,276798223
16281,5,12,149,5745,-69,-97,28,56:68:e2:c2:8d:d5,276800606,280,2103,276800326,276800606
16282,5,12,149,5745,-89,-97,8,02:af:71:9e:85:a6,276808148,244,7298,276807904,276808148
16283,5,24,149,5745,-87,-97,10,,276822202,32,14022,276822170,276822202
16284,5,24,149,5745,-88,-97,9,,276840298,32,18064,276840266,276840298
16285,5,24,149,5745,-88,-97,9,,276840684,28,358,276840656,276840684
16286,5,12,149,5745,-71,-97,26,3e:ef:29:c7:4b:17,276847475,272,6519,276847203,276847475
16287,5,12,149,5745,-69,-97,28,22:ec:75:a8:8a:31,276858681,244,10962,276858437,276858681
16288,5,12,149,5745,-56,-97,41,3e:d1:9b:c7:a4:de,276864557,272,5604,276864285,276864557
16289,5,12,149,5745,-70,-97,27,0a:e1:ab:b3:c3:a6,276868810,272,3981,276868538,276868810
16290,5,12,149,5745,-89,-97,8,42:d2:d9:2b:ac:61,276872578,256,3512,276872322,276872578
16291,5,12,149,5745,-65,-97,32,76:d6:6a:bb:b3:f5,276873664,272,814,276873392,276873664
16292,5,12,149,5745,-61,-97,36,3a:de:b0:2e:cd:45,276874815,272,879,276874543,276874815
16293,5,12,149,5745,-70,-97,27,f2:da:61:dd:98:c5,276891142,272,16055,276890870,276891142
16294,5,12,149,5745,-71,-97,26,fa:44:8d:e1:c7:1b,276892901,244,1515,276892657,276892901
16295,5,24,149,5745,-88,-97,9,,276894854,28,1925,276894826,276894854
16296,5,24,149,5745,-87,-97,10,,276894963,32,77,276894931,276894963
16297,5,12,149,5745,-62,-97,35,9e:1f:b0:a7:b8:90,276895811,284,564,276895527,276895811
16298,5,12,149,5745,-70,-97,27,b6:90:18:f6:b1:d4,276909505,272,13422,276909233,276909505
16299,5,12,149,5745,-56,-97,41,3e:d1:9b:c7:a4:de,276909892,544,-157,276909348,276909892
16300,5,12,149,5745,-64,-97,33,5e:29:73:5b:30:00,276910506,272,342,276910234,276910506
16301,5,12,149,5745,-61,-97,36,3a:de:b0:2e:cd:45,276911399,468,425,276910931,276911399
16302,5,12,149,5745,-72,-97,25,72:d1:72:1d:22:a1,276911938,480,59,276911458,276911938
16303,5,12,149,5745,-67,-97,30,76:d6:6a:bb:b3:f5,276912643,468,237,276912175,276912643
16304,5,12,149,5745,-71,-97,26,fa:44:8d:e1:c7:1b,276913199,440,116,276912759,276913199
16305,5,24,149,5745,-88,-97,9,,276913760,28,533,276913732,276913760
16306,5,24,149,5745,-87,-97,10,,276913805,28,17,276913777,276913805
16307,5,12,149,5745,-88,-97,9,42:d2:d9:2b:ac:61,276916350,452,2093,276915898,276916350
16308,5,12,149,5745,-70,-97,27,22:ec:75:a8:8a:31,276917793,516,927,276917277,276917793
16309,5,12,149,5745,-64,-97,33,5e:29:73:5b:30:00,276918343,540,10,276917803,276918343
16310,5,12,149,5745,-62,-97,35,9e:1f:b0:a7:b8:90,276921772,480,2949,276921292,276921772
16311,5,12,149,5745,-59,-97,38,4a:ea:3c:f4:ce:b2,276922331,468,91,276921863,276922331
16312,5,12,149,5745,-69,-97,28,f6:0a:5c:59:72:df,276922977,476,170,276922501,276922977
16313,5,12,149,5745,-65,-97,32,76:d6:6a:bb:b3:f5,276924805,272,1556,276924533,276924805
16314,5,12,149,5745,-70,-97,27,b6:90:18:f6:b1:d4,276925915,468,642,276925447,276925915
16315,5,12,149,5745,-70,-97,27,0a:e1:ab:b3:c3:a6,276926435,468,52,276925967,276926435
16316,5,12,149,5745,-59,-97,38,4a:ea:3c:f4:ce:b2,276926956,272,249,276926684,276926956
16317,5,12,149,5745,-72,-97,25,56:68:e2:c2:8d:d5,276927262,476,-170,276926786,276927262
16318,5,12,149,5745,-71,-97,26,3e:ef:29:c7:4b:17,276927774,468,44,276927306,276927774
16319,5,12,149,5745,-71,-97,26,3e:ef:29:c7:4b:17,276940797,272,12751,276940525,276940797
16320,5,12,149,5745,-85,-97,12,9a:24:38:da:96:bb,276944613,272,3544,276944341,276944613
16321,5,12,149,5745,-69,-97,28,f2:da:61:dd:98:c5,276948115,468,3034,276947647,276948115
16322,5,12,149,5745,-69,-97,28,f6:0a:5c:59:72:df,276952944,280,4549,276952664,276952944
16323,5,12,149,5745,-70,-97,27,0a:e1:ab:b3:c3:a6,276959216,272,6000,276958944,276959216
16324,5,12,149,5745,-61,-97,36,3a:de:b0:2e:cd:45,276975429,272,15941,276975157,276975429
16325,5,12,149,5745,-55,-97,42,3e:d1:9b:c7:a4:de,276975762,544,-211,276975218,276975762
16326,5,12,149,5745,-72,-97,25,72:d1:72:1d:22:a1,276976342,480,100,276975862,276976342
16327,5,12,149,5745,-65,-97,32,76:d6:6a:bb:b3:f5,276976896,468,86,276976428,276976896
16328,5,12,149,5745,-61,-97,36,3a:de:b0:2e:cd:45,276977453,468,89,276976985,276977453
16329,5,12,149,5745,-74,-97,23,aa:b6:ae:27:64:4e,276978050,468,129,276977582,276978050
16330,5,12,149,5745,-88,-97,9,42:d2:d9:2b:ac:61,276982700,452,4198,276982248,276982700
16331,5,12,149,5745,-65,-97,32,5e:29:73:5b:30:00,276983277,540,37,276982737,276983277
16332,5,12,149,5745,-63,-97,34,9e:1f:b0:a7:b8:90,276985454,480,1697,276984974,276985454
16333,5,12,149,5745,-58,-97,39,4a:ea:3c:f4:ce:b2,276985978,468,56,276985510,276985978
16334,5,12,149,5745,-90,-97,7,02:af:71:9e:85:a6,276986525,156,391,276986369,276986525
16335,5,12,149,5745,-69,-97,28,fa:44:8d:e1:c7:1b,276987629,440,664,276987189,276987629
16336,5,12,149,5745,-71,-97,26,b6:90:18:f6:b1:d4,276988105,468,8,276987637,276988105
16337,5,12,149,5745,-57,-97,40,0a:b9:b7:b1:4d:fa,276988625,468,52,276988157,276988625
16338,5,12,149,5745,-72,-97,25,f6:0a:5c:59:72:df,276989127,476,26,276988651,276989127
16339,5,12,149,5745,-71,-97,26,22:ec:75:a8:8a:31,276989827,244,456,276989583,276989827
16340,5,12,149,5745,-73,-97,24,3e:ef:29:c7:4b:17,276990125,468,-170,276989657,276990125
16341,5,12,149,5745,-55,-97,42,3e:d1:9b:c7:a4:de,276990844,272,447,276990572,276990844
16342,5,12,149,5745,-72,-97,25,56:68:e2:c2:8d:d5,276991159,476,-161,276990683,276991159
16343,5,12,149,5745,-72,-97,25,56:68:e2:c2:8d:d5,276991651,280,212,276991371,276991651
16344,5,12,149,5745,-69,-97,28,f2:da:61:dd:98:c5,276992559,272,636,276992287,276992559
16345,5,12,149,5745,-73,-97,24,d2:00:04:7e:2c:ab,276993153,440,154,276992713,276993153
16346,5,12,149,5745,-69,-97,28,f2:da:61:dd:98:c5,276996607,468,2986,276996139,276996607
16347,5,12,149,5745,-87,-97,10,9a:24:38:da:96:bb,277001593,824,4162,277000769,277001593
16348,5,12,149,5745,-68,-97,29,fa:44:8d:e1:c7:1b,277006296,244,4459,277006052,277006296
16349,5,12,149,5745,-64,-97,33,9e:1f:b0:a7:b8:90,277007967,284,1387,277007683,277007967
16350,5,12,149,5745,-71,-97,26,b6:90:18:f6:b1:d4,277024347,272,16108,277024075,277024347
16351,5,12,149,5745,-64,-97,33,5e:29:73:5b:30:00,277025805,272,1186,277025533,277025805
16352,5,12,149,5745,-72,-97,25,22:ec:75:a8:8a:31,277048145,516,21824,277047629,277048145
16353,5,12,149,5745,-58,-97,39,4a:ea:3c:f4:ce:b2,277053443,272,5026,277053171,277053443
16354,5,12,149,5745,-66,-97,31,76:d6:6a:bb:b3:f5,277054240,272,525,277053968,277054240
16355,5,12,149,5745,-85,-97,12,9a:24:38:da:96:bb,277057667,272,3155,277057395,277057667
16356,5,12,149,5745,-73,-97,24,3e:ef:29:c7:4b:17,277059086,272,1147,277058814,277059086
16357,5,12,149,5745,-71,-97,26,0a:e1:ab:b3:c3:a6,277077619,272,18261,277077347,277077619
16358,5,6,149,5745,-86,-97,11,54:e4:3a:ec:fb:65,277078380,360,401,277078020,277078380
16359,5,12,149,5745,-56,-97,41,3e:d1:9b:c7:a4:de,277090220,272,11568,277089948,277090220
16360,5,12,149,5745,-59,-97,38,3a:de:b0:2e:cd:45,277090850,272,358,277090578,277090850
16361,5,12,149,5745,-87,-97,10,42:d2:d9:2b:ac:61,277100042,256,8936,277099786,277100042
16362,5,12,149,5745,-71,-97,26,22:ec:75:a8:8a:31,277104580,244,4294,277104336,277104580
16363,5,12,149,5745,-71,-97,26,22:ec:75:a8:8a:31,277113518,516,8422,277113002,277113518
16364,5,12,149,5745,-64,-97,33,fa:44:8d:e1:c7:1b,277114785,244,1023,277114541,277114785
16365,5,12,149,5745,-70,-97,27,56:68:e2:c2:8d:d5,277115828,280,763,277115548,277115828
16366,5,12,149,5745,-75,-97,22,72:d1:72:1d:22:a1,277117665,284,1553,277117381,277117665
16367,5,24,149,5745,-89,-97,8,,277118083,28,390,277118055,277118083
16368,5,24,149,5745,-84,-97,13,,277118127,28,16,277118099,277118127
16369,5,24,149,5745,-83,-97,14,,277118236,32,77,277118204,277118236
16370,5,12,149,5745,-62,-97,35,5e:29:73:5b:30:00,277123717,272,5209,277123445,277123717
16371,5,24,149,5745,-84,-97,13,,277136625,28,12880,277136597,277136625
16372,5,24,149,5745,-89,-97,8,,277136669,28,16,277136641,277136669
16373,5,12,149,5745,-75,-97,22,3e:ef:29:c7:4b:17,277166927,272,29986,277166655,277166927
16374,5,12,149,5745,-73,-97,24,22:ec:75:a8:8a:31,277179551,516,12108,277179035,277179551
16375,5,6,149,5745,-85,-97,12,54:e4:3a:ec:fb:65,277180780,360,869,277180420,277180780
16376,5,12,149,5745,-68,-97,29,f2:da:61:dd:98:c5,277181772,272,720,277181500,277181772
16377,5,12,149,5745,-66,-97,31,9e:1f:b0:a7:b8:90,277182206,284,150,277181922,277182206
16378,5,12,149,5745,-65,-97,32,76:d6:6a:bb:b3:f5,277182622,272,144,277182350,277182622
16379,5,12,149,5745,-69,-97,28,0a:e1:ab:b3:c3:a6,277187712,272,4818,277187440,277187712
16380,5,12,149,5745,-81,-97,16,9a:24:38:da:96:bb,277188151,272,167,277187879,277188151
16381,5,12,149,5745,-73,-97,24,22:ec:75:a8:8a:31,277202860,244,14465,277202616,277202860
16382,5,12,149,5745,-70,-97,27,b6:90:18:f6:b1:d4,277205443,272,2311,277205171,277205443
16383,5,12,149,5745,-57,-97,40,3e:d1:9b:c7:a4:de,277205970,272,255,277205698,277205970
16384,5,12,149,5745,-68,-97,29,f6:0a:5c:59:72:df,277211735,280,5485,277211455,277211735
16385,5,12,149,5745,-90,-97,7,42:d2:d9:2b:ac:61,277213274,256,1283,277213018,277213274
16386,5,12,149,5745,-62,-97,35,5e:29:73:5b:30:00,277240924,272,27378,277240652,277240924
16387,5,12,149,5745,-82,-97,15,9a:24:38:da:96:bb,277281204,272,40008,277280932,277281204
16388,5,6,149,5745,-86,-97,11,54:e4:3a:ec:fb:65,277283181,360,1617,277282821,277283181
16389,5,12,149,5745,-69,-97,28,f2:da:61:dd:98:c5,277283902,272,449,277283630,277283902
16390,5,12,149,5745,-67,-97,30,9e:1f:b0:a7:b8:90,277284400,284,214,277284116,277284400
16391,5,12,149,5745,-60,-97,37,3a:de:b0:2e:cd:45,277284817,272,145,277284545,277284817
16392,5,12,149,5745,-62,-97,35,76:d6:6a:bb:b3:f5,277285250,272,161,277284978,277285250
16393,5,12,149,5745,-75,-97,22,3e:ef:29:c7:4b:17,277287951,272,2429,277287679,277287951
16394,5,12,149,5745,-68,-97,29,b6:90:18:f6:b1:d4,277307580,272,19357,277307308,277307580
16395,5,12,149,5745,-72,-97,25,72:d1:72:1d:22:a1,277308039,284,175,277307755,277308039
16396,5,12,149,5745,-71,-97,26,56:68:e2:c2:8d:d5,277309912,280,1593,277309632,277309912
16397,5,12,149,5745,-68,-97,29,0a:e1:ab:b3:c3:a6,277310298,272,114,277310026,277310298
16398,5,12,149,5745,-66,-97,31,f6:0a:5c:59:72:df,277311173,280,595,277310893,277311173
16399,5,12,149,5745,-71,-97,26,22:ec:75:a8:8a:31,277311829,244,412,277311585,277311829
16400,5,12,149,5745,-60,-97,37,3a:de:b0:2e:cd:45,277322143,272,10042,277321871,277322143
16401,5,12,149,5745,-54,-97,43,3e:d1:9b:c7:a4:de,277323048,272,633,277322776,277323048
16402,5,12,149,5745,-72,-97,25,72:d1:72:1d:22:a1,277342983,284,19651,277342699,277342983
16403,5,24,149,5745,-88,-97,9,,277344704,28,1693,277344676,277344704
16404,5,24,149,5745,-87,-97,10,,277344813,32,77,277344781,277344813
16405,5,12,149,5745,-71,-97,26,56:68:e2:c2:8d:d5,277346040,280,947,277345760,277346040
16406,5,12,149,5745,-68,-97,29,f2:da:61:dd:98:c5,277346520,272,208,277346248,277346520
16407,5,12,149,5745,-68,-97,29,b6:90:18:f6:b1:d4,277353759,272,6967,277353487,277353759
16408,5,12,149,5745,-67,-97,30,9e:1f:b0:a7:b8:90,277355986,284,1943,277355702,277355986
16409,5,24,149,5745,-90,-97,7,,277362962,28,6948,277362934,277362962
16410,5,24,149,5745,-88,-97,9,,277363006,28,16,277362978,277363006
16411,5,12,149,5745,-72,-97,25,72:d1:72:1d:22:a1,277368852,480,5366,277368372,277368852
16412,5,12,149,5745,-61,-97,36,5e:29:73:5b:30:00,277369411,272,287,277369139,277369411
16413,5,12,149,5745,-54,-97,43,3e:d1:9b:c7:a4:de,277371310,544,1355,277370766,277371310
16414,5,12,149,5745,-60,-97,37,76:d6:6a:bb:b3:f5,277371935,468,157,277371467,277371935
16415,5,12,149,5745,-54,-97,43,4a:ea:3c:f4:ce:b2,277375168,272,2961,277374896,277375168
16416,5,12,149,5745,-92,-97,5,42:d2:d9:2b:ac:61,277376475,360,947,277376115,277376475
16417,5,12,149,5745,-70,-97,27,22:ec:75:a8:8a:31,277377872,516,881,277377356,277377872
16418,5,12,149,5745,-61,-97,36,5e:29:73:5b:30:00,277379268,540,856,277378728,277379268
16419,5,12,149,5745,-68,-97,29,f6:0a:5c:59:72:df,277381117,476,1373,277380641,277381117
16420,5,12,149,5745,-67,-97,30,b6:90:18:f6:b1:d4,277383041,468,1456,277382573,277383041
16421,5,12,149,5745,-60,-97,37,76:d6:6a:bb:b3:f5,277383545,272,232,277383273,277383545
16422,5,12,149,5745,-74,-97,23,3e:ef:29:c7:4b:17,277384667,468,654,277384199,277384667
16423,5,6,149,5745,-86,-97,11,54:e4:3a:ec:fb:65,277385582,360,555,277385222,277385582
16424,5,12,149,5745,-69,-97,28,0a:e1:ab:b3:c3:a6,277386047,468,-3,277385579,277386047
16425,5,12,149,5745,-69,-97,28,f2:da:61:dd:98:c5,277390969,468,4454,277390501,277390969
16426,5,12,149,5745,-89,-97,8,9a:24:38:da:96:bb,277392941,272,1700,277392669,277392941
16427,5,12,149,5745,-88,-97,9,9a:24:38:da:96:bb,277393336,824,-429,277392512,277393336
16428,5,12,149,5745,-67,-97,30,9e:1f:b0:a7:b8:90,277395004,480,1188,277394524,277395004
16429,5,12,149,5745,-75,-97,22,3e:ef:29:c7:4b:17,277399565,272,4289,277399293,277399565
16430,5,12,149,5745,-69,-97,28,0a:e1:ab:b3:c3:a6,277400854,272,1017,277400582,277400854
16431,5,12,149,5745,-68,-97,29,f6:0a:5c:59:72:df,277407613,280,6479,277407333,277407613
16432,5,12,149,5745,-68,-97,29,22:ec:75:a8:8a:31,277432413,244,24556,277432169,277432413
16433,5,12,149,5745,-92,-97,5,42:d2:d9:2b:ac:61,277434987,256,2318,277434731,277434987
16434,5,12,149,5745,-56,-97,41,3e:d1:9b:c7:a4:de,277440201,272,4942,277439929,277440201
16435,5,12,149,5745,-92,-97,5,42:d2:d9:2b:ac:61,277441026,452,373,277440574,277441026
16436,5,12,149,5745,-68,-97,29,22:ec:75:a8:8a:31,277441531,516,-11,277441015,277441531
16437,5,12,149,5745,-56,-97,41,4a:ea:3c:f4:ce:b2,277443423,468,1424,277442955,277443423
16438,5,12,149,5745,-70,-97,27,f6:0a:5c:59:72:df,277447489,476,3590,277447013,277447489
16439,5,12,149,5745,-71,-97,26,a6:92:ad:b7:76:65,277453662,484,5689,277453178,277453662
16440,5,12,149,5745,-90,-97,7,7e:05:42:11:d2:ec,277455957,440,1855,277455517,277455957
16441,5,12,149,5745,-72,-97,25,72:d1:72:1d:22:a1,277456486,284,245,277456202,277456486
16442,5,12,149,5745,-71,-97,26,56:68:e2:c2:8d:d5,277456858,280,92,277456578,277456858
16443,5,12,149,5745,-69,-97,28,f2:da:61:dd:98:c5,277458104,272,974,277457832,277458104
16444,5,12,149,5745,-59,-97,38,5e:29:73:5b:30:00,277473038,272,14662,277472766,277473038
16445,5,12,149,5745,-67,-97,30,b6:90:18:f6:b1:d4,277475344,272,2034,277475072,277475344
16446,5,12,149,5745,-66,-97,31,9e:1f:b0:a7:b8:90,277477742,284,2114,277477458,277477742
16447,5,12,149,5745,-70,-97,27,a6:92:ad:b7:76:65,277483889,284,5863,277483605,277483889
16448,5,12,149,5745,-90,-97,7,7e:05:42:11:d2:ec,277484204,244,71,277483960,277484204
16449,5,6,149,5745,-87,-97,10,54:e4:3a:ec:fb:65,277487982,360,3418,277487622,277487982
16450,5,12,149,5745,-67,-97,30,76:d6:6a:bb:b3:f5,277497712,272,9458,277497440,277497712
16451,5,12,149,5745,-75,-97,22,3e:ef:29:c7:4b:17,277498054,272,70,277497782,277498054
16452,5,12,149,5745,-56,-97,41,3e:d1:9b:c7:a4:de,277500691,544,2093,277500147,277500691
16453,5,12,149,5745,-67,-97,30,76:d6:6a:bb:b3:f5,277501271,468,112,277500803,277501271
16454,5,12,149,5745,-68,-97,29,aa:b6:ae:27:64:4e,277502117,468,378,277501649,277502117
16455,5,12,149,5745,-85,-97,12,9a:24:38:da:96:bb,277506119,824,3178,277505295,277506119
16456,5,12,149,5745,-67,-97,30,22:ec:75:a8:8a:31,277506969,516,334,277506453,277506969
16457,5,12,149,5745,-90,-97,7,42:d2:d9:2b:ac:61,277507557,452,136,277507105,277507557
16458,5,12,149,5745,-59,-97,38,5e:29:73:5b:30:00,277509032,540,935,277508492,277509032
16459,5,12,149,5745,-58,-97,39,0a:b9:b7:b1:4d:fa,277511133,468,1633,277510665,277511133
16460,5,12,149,5745,-70,-97,27,f6:0a:5c:59:72:df,277511896,476,287,277511420,277511896
16461,5,12,149,5745,-68,-97,29,b6:90:18:f6:b1:d4,277512902,468,538,277512434,277512902
16462,5,12,149,5745,-76,-97,21,3e:ef:29:c7:4b:17,277514387,468,1017,277513919,277514387
16463,5,12,149,5745,-70,-97,27,0a:e1:ab:b3:c3:a6,277515564,272,905,277515292,277515564
16464,5,12,149,5745,-69,-97,28,a6:92:ad:b7:76:65,277516361,484,313,277515877,277516361
16465,5,12,149,5745,-70,-97,27,0a:e1:ab:b3:c3:a6,277517977,468,1148,277517509,277517977
16466,5,12,149,5745,-73,-97,24,d2:00:04:7e:2c:ab,277518947,440,530,277518507,277518947
16467,5,12,149,5745,-90,-97,7,7e:05:42:11:d2:ec,277519439,440,52,277518999,277519439
16468,5,12,149,5745,-71,-97,26,f6:0a:5c:59:72:df,277519913,280,194,277519633,277519913
16469,5,12,149,5745,-69,-97,28,f2:da:61:dd:98:c5,277520875,468,494,277520407,277520875
16470,5,12,149,5745,-57,-97,40,4a:ea:3c:f4:ce:b2,277521459,468,116,277520991,277521459
16471,5,12,149,5745,-56,-97,41,3a:de:b0:2e:cd:45,277524717,468,2790,277524249,277524717
16472,5,24,149,5745,-90,-97,7,,277525729,32,980,277525697,277525729
16473,5,12,149,5745,-57,-97,40,4a:ea:3c:f4:ce:b2,277537015,272,11014,277536743,277537015
16474,5,12,149,5745,-85,-97,12,9a:24:38:da:96:bb,277540788,272,3501,277540516,277540788
16475,5,12,149,5745,-67,-97,30,22:ec:75:a8:8a:31,277547267,244,6235,277547023,277547267
16476,5,12,149,5745,-92,-97,5,42:d2:d9:2b:ac:61,277550515,256,2992,277550259,277550515
16477,5,12,149,5745,-56,-97,41,3e:d1:9b:c7:a4:de,277552623,272,1836,277552351,277552623
16478,5,24,149,5745,-68,-97,29,,277569421,28,16770,277569393,277569421
16479,5,24,149,5745,-90,-97,7,,277569465,28,16,277569437,277569465
16480,5,24,149,5745,-89,-97,8,,277569573,28,80,277569545,277569573
16481,5,24,149,5745,-86,-97,11,,277571084,28,1483,277571056,277571084
16482,5,24,149,5745,-90,-97,7,,277571128,28,16,277571100,277571128
16483,5,24,149,5745,-90,-97,7,,277571236,32,76,277571204,277571236
16484,5,24,149,5745,-91,-97,6,,277572216,32,948,277572184,277572216
16485,5,12,149,5745,-68,-97,29,22:ec:75:a8:8a:31,277572463,516,-269,277571947,277572463
16486,5,12,149,5745,-69,-97,28,f2:da:61:dd:98:c5,277576453,272,3718,277576181,277576453
16487,5,12,149,5745,-68,-97,29,b6:90:18:f6:b1:d4,277587974,272,11249,277587702,277587974
16488,5,24,149,5745,-87,-97,10,,277588905,28,903,277588877,277588905
16489,5,24,149,5745,-86,-97,11,,277589013,32,76,277588981,277589013
16490,5,12,149,5745,-65,-97,32,9e:1f:b0:a7:b8:90,277589658,284,361,277589374,277589658
16491,5,12,149,5745,-63,-97,34,5e:29:73:5b:30:00,277590639,272,709,277590367,277590639
16492,5,12,149,5745,-69,-97,28,a6:92:ad:b7:76:65,277603784,284,12861,277603500,277603784
16493,5,12,149,5745,-72,-97,25,72:d1:72:1d:22:a1,277615249,284,11181,277614965,277615249
16494,5,12,149,5745,-72,-97,25,56:68:e2:c2:8d:d5,277617122,280,1593,277616842,277617122
16495,5,12,149,5745,-77,-97,20,3e:ef:29:c7:4b:17,277626181,272,8787,277625909,277626181
16496,5,12,149,5745,-69,-97,28,22:ec:75:a8:8a:31,277638358,516,11661,277637842,277638358
16497,5,12,149,5745,-66,-97,31,f6:0a:5c:59:72:df,277646297,280,7659,277646017,277646297
16498,5,12,149,5745,-69,-97,28,22:ec:75:a8:8a:31,277661619,244,15078,277661375,277661619
16499,5,12,149,5745,-55,-97,42,3e:d1:9b:c7:a4:de,277669655,272,7764,277669383,277669655
16500,5,12,149,5745,-70,-97,27,f2:da:61:dd:98:c5,277683656,272,13729,277683384,277683656
16501,5,12,149,5745,-68,-97,29,0a:e1:ab:b3:c3:a6,277687314,272,3386,277687042,277687314
16502,5,6,149,5745,-84,-97,13,54:e4:3a:ec:fb:65,277692783,360,5109,277692423,277692783
16503,5,12,149,5745,-64,-97,33,76:d6:6a:bb:b3:f5,277693278,272,223,277693006,277693278
16504,5,12,149,5745,-67,-97,30,9e:1f:b0:a7:b8:90,277705767,284,12205,277705483,277705767
16505,5,12,149,5745,-60,-97,37,5e:29:73:5b:30:00,277707653,272,1614,277707381,277707653
16506,5,12,149,5745,-69,-97,28,a6:92:ad:b7:76:65,277717053,284,9116,277716769,277717053
16507,5,12,149,5745,-67,-97,30,b6:90:18:f6:b1:d4,277717461,272,136,277717189,277717461
16508,5,12,149,5745,-73,-97,24,72:d1:72:1d:22:a1,277717769,284,24,277717485,277717769
16509,5,12,149,5745,-72,-97,25,56:68:e2:c2:8d:d5,277718157,280,108,277717877,277718157
16510,5,12,149,5745,-54,-97,43,3e:d1:9b:c7:a4:de,277720559,544,1858,277720015,277720559
16511,5,12,149,5745,-87,-97,10,42:d2:d9:2b:ac:61,277730666,256,9851,277730410,277730666
16512,5,12,149,5745,-89,-97,8,7e:05:42:11:d2:ec,277734658,244,3748,277734414,277734658
16513,5,12,149,5745,-67,-97,30,22:ec:75:a8:8a:31,277765816,244,30914,277765572,277765816
16514,5,12,149,5745,-67,-97,30,f6:0a:5c:59:72:df,277767463,280,1367,277767183,277767463
16515,5,12,149,5745,-77,-97,20,3e:ef:29:c7:4b:17,277769307,272,1572,277769035,277769307
16516,5,12,149,5745,-84,-97,13,9a:24:38:da:96:bb,277770307,272,728,277770035,277770307
16517,5,12,149,5745,-62,-97,35,4a:ea:3c:f4:ce:b2,277776734,272,6155,277776462,277776734
16518,5,12,149,5745,-56,-97,41,3e:d1:9b:c7:a4:de,277786785,272,9779,277786513,277786785
16519,5,12,149,5745,-69,-97,28,0a:e1:ab:b3:c3:a6,277789539,272,2482,277789267,277789539
16520,5,6,149,5745,-85,-97,12,54:e4:3a:ec:fb:65,277795402,360,5503,277795042,277795402
16521,5,12,149,5745,-65,-97,32,f2:da:61:dd:98:c5,277796462,272,788,277796190,277796462
16522,5,12,149,5745,-65,-97,32,76:d6:6a:bb:b3:f5,277797429,272,695,277797157,277797429
16523,5,24,149,5745,-91,-97,6,,277806991,32,9530,277806959,277806991
16524,5,24,149,5745,-89,-97,8,,277807234,32,211,277807202,277807234
16525,5,12,149,5745,-62,-97,35,9e:1f:b0:a7:b8:90,277811535,284,4017,277811251,277811535
16526,5,12,149,5745,-73,-97,24,72:d1:72:1d:22:a1,277819869,284,8050,277819585,277819869
16527,5,12,149,5745,-66,-97,31,b6:90:18:f6:b1:d4,277820182,272,41,277819910,277820182
16528,5,12,149,5745,-71,-97,26,56:68:e2:c2:8d:d5,277821566,280,1104,277821286,277821566
16529,5,12,149,5745,-62,-97,35,5e:29:73:5b:30:00,277823591,272,1753,277823319,277823591
16530,5,24,149,5745,-89,-97,8,,277824643,28,1024,277824615,277824643
16531,5,24,149,5745,-89,-97,8,,277826531,28,1860,277826503,277826531
16532,5,12,149,5745,-67,-97,30,a6:92:ad:b7:76:65,277830194,284,3379,277829910,277830194
16533,5,12,149,5745,-88,-97,9,42:d2:d9:2b:ac:61,277833400,256,2950,277833144,277833400
16534,5,24,149,5745,-86,-97,11,,277867882,32,34450,277867850,277867882
16535,5,24,149,5745,-87,-97,10,,277868000,32,86,277867968,277868000
16536,5,12,149,5745,-76,-97,21,3e:ef:29:c7:4b:17,277872764,272,4492,277872492,277872764
16537,5,12,149,5745,-70,-97,27,22:ec:75:a8:8a:31,277877691,244,4683,277877447,277877691
16538,5,12,149,5745,-66,-97,31,0a:e1:ab:b3:c3:a6,277892446,272,14483,277892174,277892446
16539,5,12,149,5745,-61,-97,36,76:d6:6a:bb:b3:f5,277897466,272,4748,277897194,277897466
16540,5,12,149,5745,-57,-97,40,3e:d1:9b:c7:a4:de,277898459,272,721,277898187,277898459
16541,5,12,149,5745,-56,-97,41,4a:ea:3c:f4:ce:b2,277902888,272,4157,277902616,277902888
16542,5,12,149,5745,-70,-97,27,f2:da:61:dd:98:c5,277909708,272,6548,277909436,277909708
16543,5,12,149,5745,-64,-97,33,b6:90:18:f6:b1:d4,277921703,272,11723,277921431,277921703
16544,5,12,149,5745,-76,-97,21,72:d1:72:1d:22:a1,277922512,284,525,277922228,277922512
16545,5,12,149,5745,-73,-97,24,56:68:e2:c2:8d:d5,277923602,280,810,277923322,277923602
16546,5,12,149,5745,-63,-97,34,9e:1f:b0:a7:b8:90,277930025,284,6139,277929741,277930025
16547,5,24,149,5745,-86,-97,11,,277930445,32,388,277930413,277930445
16548,5,12,149,5745,-60,-97,37,5e:29:73:5b:30:00,277935345,272,4628,277935073,277935345
16549,5,12,149,5745,-66,-97,31,a6:92:ad:b7:76:65,277936343,284,714,277936059,277936343
16550,5,12,149,5745,-88,-97,9,7e:05:42:11:d2:ec,277943720,244,7133,277943476,277943720
16551,5,12,149,5745,-58,-97,39,76:d6:6a:bb:b3:f5,277956518,272,12526,277956246,277956518
16552,5,12,149,5745,-78,-97,19,3e:ef:29:c7:4b:17,277956841,272,51,277956569,277956841
16553,5,12,149,5745,-76,-97,21,72:d1:72:1d:22:a1,277958058,480,737,277957578,277958058
16554,5,12,149,5745,-58,-97,39,76:d6:6a:bb:b3:f5,277960131,468,1605,277959663,277960131
16555,5,12,149,5745,-70,-97,27,22:ec:75:a8:8a:31,277963279,516,2632,277962763,277963279
16556,5,12,149,5745,-86,-97,11,42:d2:d9:2b:ac:61,277965794,452,2063,277965342,277965794
16557,5,12,149,5745,-60,-97,37,5e:29:73:5b:30:00,277967114,540,780,277966574,277967114
16558,5,12,149,5745,-64,-97,33,9e:1f:b0:a7:b8:90,277969202,480,1608,277968722,277969202
16559,5,12,149,5745,-64,-97,33,b6:90:18:f6:b1:d4,277971791,468,2121,277971323,277971791
16560,5,12,149,5745,-66,-97,31,f6:0a:5c:59:72:df,277972382,476,115,277971906,277972382
16561,5,12,149,5745,-65,-97,32,a6:92:ad:b7:76:65,277976412,484,3546,277975928,277976412
16562,5,12,149,5745,-66,-97,31,f6:0a:5c:59:72:df,277976965,280,273,277976685,277976965
16563,5,12,149,5745,-67,-97,30,0a:e1:ab:b3:c3:a6,277977365,468,-68,277976897,277977365
16564,5,12,149,5745,-93,-97,4,7e:05:42:11:d2:ec,277978501,440,696,277978061,277978501
16565,5,12,149,5745,-56,-97,41,3e:d1:9b:c7:a4:de,277980831,544,1786,277980287,277980831
16566,5,24,149,5745,-73,-97,24,,277982426,28,1567,277982398,277982426
16567,5,24,149,5745,-88,-97,9,,277982470,28,16,277982442,277982470
16568,5,12,149,5745,-67,-97,30,f2:da:61:dd:98:c5,277982596,468,-342,277982128,277982596
16569,5,12,149,5745,-56,-97,41,4a:ea:3c:f4:ce:b2,277984683,468,1619,277984215,277984683
16570,5,24,149,5745,-89,-97,8,,277985542,28,831,277985514,277985542
16571,5,24,149,5745,-73,-97,24,,277987220,28,1650,277987192,277987220
16572,5,24,149,5745,-88,-97,9,,277987264,28,16,277987236,277987264
16573,5,24,149,5745,-87,-97,10,,277987372,28,80,277987344,277987372
16574,5,12,149,5745,-87,-97,10,9a:24:38:da:96:bb,277990275,272,2631,277990003,277990275
16575,5,12,149,5745,-87,-97,10,42:d2:d9:2b:ac:61,277991997,256,1466,277991741,277991997
16576,5,12,149,5745,-56,-97,41,4a:ea:3c:f4:ce:b2,277993350,272,1081,277993078,277993350
16577,5,6,149,5745,-87,-97,10,54:e4:3a:ec:fb:65,277999985,360,6275,277999625,277999985
16578,5,24,149,5745,-88,-97,9,,278003077,32,3060,278003045,278003077
16579,5,12,149,5745,-69,-97,28,22:ec:75:a8:8a:31,278006042,244,2721,278005798,278006042
16580,5,12,149,5745,-73,-97,24,56:68:e2:c2:8d:d5,278007445,280,1123,278007165,278007445
16581,5,12,149,5745,-73,-97,24,72:d1:72:1d:22:a1,278008309,284,580,278008025,278008309
16582,5,12,149,5745,-66,-97,31,f2:da:61:dd:98:c5,278008708,272,127,278008436,278008708
16583,5,24,149,5745,-88,-97,9,,278020908,28,12172,278020880,278020908
16584,5,12,149,5745,-57,-97,40,3e:d1:9b:c7:a4:de,278022737,272,1557,278022465,278022737
16585,5,12,149,5745,-64,-97,33,b6:90:18:f6:b1:d4,278023747,272,738,278023475,278023747
16586,5,12,149,5745,-73,-97,24,72:d1:72:1d:22:a1,278024090,480,-137,278023610,278024090
16587,5,12,149,5745,-57,-97,40,76:d6:6a:bb:b3:f5,278024984,468,426,278024516,278024984
16588,5,12,149,5745,-89,-97,8,9a:24:38:da:96:bb,278025555,824,-253,278024731,278025555
16589,5,12,149,5745,-68,-97,29,aa:b6:ae:27:64:4e,278026871,468,848,278026403,278026871
16590,5,12,149,5745,-70,-97,27,22:ec:75:a8:8a:31,278028319,516,932,278027803,278028319
16591,5,12,149,5745,-63,-97,34,5e:29:73:5b:30:00,278031912,540,3053,278031372,278031912
16592,5,12,149,5745,-65,-97,32,9e:1f:b0:a7:b8:90,278033522,480,1130,278033042,278033522
16593,5,12,149,5745,-69,-97,28,f6:0a:5c:59:72:df,278035897,476,1899,278035421,278035897
16594,5,12,149,5745,-92,-97,5,02:af:71:9e:85:a6,278036566,104,565,278036462,278036566
16595,5,12,149,5745,-60,-97,37,0a:b9:b7:b1:4d:fa,278036974,468,-60,278036506,278036974
16596,5,12,149,5745,-65,-97,32,b6:90:18:f6:b1:d4,278037564,468,122,278037096,278037564
16597,5,12,149,5745,-75,-97,22,56:68:e2:c2:8d:d5,278038651,476,611,278038175,278038651
16598,5,12,149,5745,-64,-97,33,a6:92:ad:b7:76:65,278039206,484,71,278038722,278039206
16599,5,12,149,5745,-64,-97,33,a6:92:ad:b7:76:65,278039712,284,222,278039428,278039712
16600,5,12,149,5745,-65,-97,32,9e:1f:b0:a7:b8:90,278040165,284,169,278039881,278040165
16601,5,12,149,5745,-70,-97,27,0a:e1:ab:b3:c3:a6,278040485,468,-148,278040017,278040485
16602,5,12,149,5745,-75,-97,22,3e:ef:29:c7:4b:17,278041093,468,140,278040625,278041093
16603,5,12,149,5745,-67,-97,30,f2:da:61:dd:98:c5,278045231,468,3670,278044763,278045231
16604,5,12,149,5745,-56,-97,41,4a:ea:3c:f4:ce:b2,278045811,468,112,278045343,278045811
16605,5,12,149,5745,-57,-97,40,3e:d1:9b:c7:a4:de,278046358,544,3,278045814,278046358
16606,5,12,149,5745,-56,-97,41,3a:de:b0:2e:cd:45,278048153,468,1327,278047685,278048153
16607,5,12,149,5745,-63,-97,34,5e:29:73:5b:30:00,278057124,272,8699,278056852,278057124
16608,5,12,149,5745,-75,-97,22,3e:ef:29:c7:4b:17,278071607,272,14211,278071335,278071607
16609,5,12,149,5745,-60,-97,37,76:d6:6a:bb:b3:f5,278071967,272,88,278071695,278071967
16610,5,12,149,5745,-67,-97,30,f6:0a:5c:59:72:df,278098333,280,26086,278098053,278098333
16611,5,12,149,5745,-88,-97,9,02:af:71:9e:85:a6,278098809,440,36,278098369,278098809
16612,5,12,149,5745,-71,-97,26,0a:e1:ab:b3:c3:a6,278100710,272,1629,278100438,278100710
16613,5,6,149,5745,-82,-97,15,54:e4:3a:ec:fb:65,278102386,360,1316,278102026,278102386
16614,5,12,149,5745,-85,-97,12,9a:24:38:da:96:bb,278103277,272,619,278103005,278103277
16615,5,12,149,5745,-72,-97,25,22:ec:75:a8:8a:31,278107718,244,4197,278107474,278107718
16616,5,12,149,5745,-52,-97,45,3e:d1:9b:c7:a4:de,278111254,544,2992,278110710,278111254
16617,5,12,149,5745,-88,-97,9,42:d2:d9:2b:ac:61,278121508,256,9998,278121252,278121508
16618,5,12,149,5745,-71,-97,26,56:68:e2:c2:8d:d5,278132264,280,10476,278131984,278132264
16619,5,12,149,5745,-75,-97,22,72:d1:72:1d:22:a1,278132579,284,31,278132295,278132579
16620,5,12,149,5745,-51,-97,46,3e:d1:9b:c7:a4:de,278137788,272,4937,278137516,278137788
16621,5,12,149,5745,-60,-97,37,5e:29:73:5b:30:00,278165171,272,27111,278164899,278165171
16622,5,6,149,5745,-73,-97,24,24:f6:77:10:02:c8,278170483,176,5136,278170307,278170483
16623,5,24,149,5745,-85,-97,12,,278172449,32,1934,278172417,278172449
16624,5,24,149,5745,-85,-97,12,,278172894,32,413,278172862,278172894
16625,5,24,149,5745,-86,-97,11,,278173340,28,418,278173312,278173340
16626,5,24,149,5745,-71,-97,26,,278174173,28,805,278174145,278174173
16627,5,24,149,5745,-86,-97,11,,278174217,28,16,278174189,278174217
16628,5,24,149,5745,-85,-97,12,,278174325,28,80,278174297,278174325
16629,5,24,149,5745,-72,-97,25,,278176215,28,1862,278176187,278176215
16630,5,24,149,5745,-85,-97,12,,278176259,28,16,278176231,278176259
16631,5,24,149,5745,-86,-97,11,,278176367,28,80,278176339,278176367
16632,5,12,149,5745,-51,-97,46,3e:d1:9b:c7:a4:de,278177455,544,544,278176911,278177455
16633,5,6,149,5745,-82,-97,15,54:e4:3a:ec:fb:65,278201506,352,23699,278201154,278201506
16634,5,12,149,5745,-66,-97,31,0a:e1:ab:b3:c3:a6,278202564,272,786,278202292,278202564
16635,5,6,149,5745,-82,-97,15,54:e4:3a:ec:fb:65,278204786,360,1862,278204426,278204786
16636,5,12,149,5745,-68,-97,29,f2:da:61:dd:98:c5,278205607,272,549,278205335,278205607
16637,5,12,149,5745,-63,-97,34,76:d6:6a:bb:b3:f5,278206022,272,143,278205750,278206022
16638,5,12,149,5745,-82,-97,15,9a:24:38:da:96:bb,278219395,272,13101,278219123,278219395
16639,5,12,149,5745,-70,-97,27,22:ec:75:a8:8a:31,278224742,244,5103,278224498,278224742
16640,5,12,149,5745,-69,-97,28,a6:92:ad:b7:76:65,278227912,284,2886,278227628,278227912
16641,5,12,149,5745,-68,-97,29,f6:0a:5c:59:72:df,278229123,280,931,278228843,278229123
16642,5,12,149,5745,-66,-97,31,b6:90:18:f6:b1:d4,278229474,272,79,278229202,278229474
16643,5,12,149,5745,-55,-97,42,4a:ea:3c:f4:ce:b2,278234204,272,4458,278233932,278234204
16644,5,12,149,5745,-85,-97,12,42:d2:d9:2b:ac:61,278234511,256,51,278234255,278234511
16645,5,12,149,5745,-71,-97,26,72:d1:72:1d:22:a1,278241796,284,7001,278241512,278241796
16646,5,12,149,5745,-54,-97,43,3e:d1:9b:c7:a4:de,278242890,544,550,278242346,278242890
16647,5,12,149,5745,-70,-97,27,56:68:e2:c2:8d:d5,278244011,280,841,278243731,278244011
16648,5,12,149,5745,-54,-97,43,3e:d1:9b:c7:a4:de,278252197,272,7914,278251925,278252197
16649,5,12,149,5745,-62,-97,35,5e:29:73:5b:30:00,278282191,272,29722,278281919,278282191
16650,5,6,149,5745,-84,-97,13,54:e4:3a:ec:fb:65,278307186,360,24635,278306826,278307186
16651,5,12,149,5745,-64,-97,33,f2:da:61:dd:98:c5,278308008,272,550,278307736,278308008
16652,5,12,149,5745,-59,-97,38,76:d6:6a:bb:b3:f5,278308930,272,650,278308658,278308930
16653,5,12,149,5745,-63,-97,34,9e:1f:b0:a7:b8:90,278312215,284,3001,278311931,278312215
16654,5,12,149,5745,-65,-97,32,0a:e1:ab:b3:c3:a6,278313630,272,1143,278313358,278313630
16655,5,12,149,5745,-82,-97,15,9a:24:38:da:96:bb,278328404,272,14502,278328132,278328404
16656,5,12,149,5745,-70,-97,27,a6:92:ad:b7:76:65,278330548,284,1860,278330264,278330548
16657,5,12,149,5745,-68,-97,29,b6:90:18:f6:b1:d4,278331614,272,794,278331342,278331614
16658,5,12,149,5745,-69,-97,28,22:ec:75:a8:8a:31,278341884,244,10026,278341640,278341884
16659,5,12,149,5745,-88,-97,9,42:d2:d9:2b:ac:61,278346890,256,4750,278346634,278346890
16660,5,12,149,5745,-53,-97,44,3e:d1:9b:c7:a4:de,278352563,272,5401,278352291,278352563
16661,5,12,149,5745,-70,-97,27,f2:da:61:dd:98:c5,278359927,272,7092,278359655,278359927
16662,5,24,149,5745,-87,-97,10,,278361578,28,1623,278361550,278361578
16663,5,24,149,5745,-88,-97,9,,278361933,28,327,278361905,278361933
16664,5,24,149,5745,-86,-97,11,,278362308,28,347,278362280,278362308
16665,5,24,149,5745,-73,-97,24,,278362627,28,291,278362599,278362627
16666,5,24,149,5745,-87,-97,10,,278362671,28,16,278362643,278362671
16667,5,24,149,5745,-87,-97,10,,278362779,28,80,278362751,278362779
16668,5,24,149,5745,-72,-97,25,,278363029,28,222,278363001,278363029
16669,5,24,149,5745,-86,-97,11,,278363073,28,16,278363045,278363073
16670,5,24,149,5745,-86,-97,11,,278363181,28,80,278363153,278363181
16671,5,12,149,5745,-73,-97,24,72:d1:72:1d:22:a1,278363630,284,165,278363346,278363630
16672,5,12,149,5745,-74,-97,23,56:68:e2:c2:8d:d5,278365397,280,1487,278365117,278365397
16673,5,24,149,5745,-71,-97,26,,278373637,28,8212,278373609,278373637
16674,5,24,149,5745,-87,-97,10,,278373681,28,16,278373653,278373681
16675,5,24,149,5745,-86,-97,11,,278373789,28,80,278373761,278373789
16676,5,12,149,5745,-72,-97,25,b6:90:18:f6:b1:d4,278377683,272,3622,278377411,278377683
16677,5,12,149,5745,-63,-97,34,9e:1f:b0:a7:b8:90,278381716,284,3749,278381432,278381716
16678,5,12,149,5745,-73,-97,24,3e:ef:29:c7:4b:17,278384477,272,2489,278384205,278384477
16679,5,12,149,5745,-90,-97,7,7e:05:42:11:d2:ec,278393467,244,8746,278393223,278393467
16680,5,12,149,5745,-70,-97,27,a6:92:ad:b7:76:65,278394748,284,997,278394464,278394748
16681,5,6,149,5745,-83,-97,14,54:e4:3a:ec:fb:65,278409587,360,14479,278409227,278409587
16682,5,12,149,5745,-63,-97,34,76:d6:6a:bb:b3:f5,278415209,272,5350,278414937,278415209
16683,5,12,149,5745,-72,-97,25,3e:ef:29:c7:4b:17,278415551,272,70,278415279,278415551
16684,5,12,149,5745,-64,-97,33,0a:e1:ab:b3:c3:a6,278416684,272,861,278416412,278416684
16685,5,12,149,5745,-62,-97,35,5e:29:73:5b:30:00,278417612,272,656,278417340,278417612
16686,5,6,149,5745,-66,-97,31,d8:b0:53:eb:7b:b7,278418025,92,321,278417933,278418025
16687,5,6,149,5745,-66,-97,31,d8:b0:53:eb:7b:b7,278418171,92,54,278418079,278418171
16688,5,12,149,5745,-63,-97,34,76:d6:6a:bb:b3:f5,278418940,468,301,278418472,278418940
16689,5,12,149,5745,-74,-97,23,72:d1:72:1d:22:a1,278419497,480,77,278419017,278419497
16690,5,12,149,5745,-67,-97,30,22:ec:75:a8:8a:31,278421898,516,1885,278421382,278421898
16691,5,12,149,5745,-91,-97,6,42:d2:d9:2b:ac:61,278425854,452,3504,278425402,278425854
16692,5,12,149,5745,-61,-97,36,5e:29:73:5b:30:00,278426345,540,-49,278425805,278426345
16693,5,12,149,5745,-89,-97,8,7e:05:42:11:d2:ec,278426987,440,202,278426547,278426987
16694,5,12,149,5745,-63,-97,34,9e:1f:b0:a7:b8:90,278427892,480,425,278427412,278427892
16695,5,12,149,5745,-69,-97,28,f6:0a:5c:59:72:df,278429883,280,1711,278429603,278429883
16696,5,12,149,5745,-69,-97,28,f6:0a:5c:59:72:df,278430180,476,-179,278429704,278430180
16697,5,12,149,5745,-73,-97,24,b6:90:18:f6:b1:d4,278430691,468,43,278430223,278430691
16698,5,12,149,5745,-73,-97,24,3e:ef:29:c7:4b:17,278432527,468,1368,278432059,278432527
16699,5,12,149,5745,-72,-97,25,a6:92:ad:b7:76:65,278434020,484,1009,278433536,278434020
16700,5,12,149,5745,-64,-97,33,0a:e1:ab:b3:c3:a6,278435384,468,896,278434916,278435384
16701,5,12,149,5745,-74,-97,23,56:68:e2:c2:8d:d5,278435934,476,74,278435458,278435934
16702,5,12,149,5745,-91,-97,6,c6:71:4f:a2:d1:86,278438686,440,2312,278438246,278438686
16703,5,12,149,5745,-84,-97,13,9a:24:38:da:96:bb,278439373,272,415,278439101,278439373
16704,5,12,149,5745,-66,-97,31,f2:da:61:dd:98:c5,278439679,468,-162,278439211,278439679
16705,5,12,149,5745,-60,-97,37,3a:de:b0:2e:cd:45,278441117,468,970,278440649,278441117
16706,5,12,149,5745,-59,-97,38,4a:ea:3c:f4:ce:b2,278441638,468,53,278441170,278441638
16707,5,12,149,5745,-53,-97,44,3e:d1:9b:c7:a4:de,278442185,544,3,278441641,278442185
16708,5,12,149,5745,-90,-97,7,42:d2:d9:2b:ac:61,278450753,256,8312,278450497,278450753
16709,5,12,149,5745,-67,-97,30,22:ec:75:a8:8a:31,278465281,244,14284,278465037,278465281
16710,5,12,149,5745,-71,-97,26,56:68:e2:c2:8d:d5,278466631,280,1070,278466351,278466631
16711,5,12,149,5745,-62,-97,35,f2:da:61:dd:98:c5,278467315,272,412,278467043,278467315
16712,5,12,149,5745,-73,-97,24,72:d1:72:1d:22:a1,278467630,284,31,278467346,278467630
16713,5,12,149,5745,-54,-97,43,3e:d1:9b:c7:a4:de,278481607,272,13705,278481335,278481607
16714,5,12,149,5745,-90,-97,7,7e:05:42:11:d2:ec,278485722,440,3675,278485282,278485722
16715,5,12,149,5745,-92,-97,5,42:d2:d9:2b:ac:61,278490409,452,4235,278489957,278490409
16716,5,12,149,5745,-57,-97,40,3a:de:b0:2e:cd:45,278493521,468,2644,278493053,278493521
16717,5,12,149,5745,-70,-97,27,f6:0a:5c:59:72:df,278495409,476,1412,278494933,278495409
16718,5,12,149,5745,-72,-97,25,b6:90:18:f6:b1:d4,278496738,272,1057,278496466,278496738
16719,5,12,149,5745,-68,-97,29,a6:92:ad:b7:76:65,278497494,284,472,278497210,278497494
16720,5,12,149,5745,-64,-97,33,9e:1f:b0:a7:b8:90,278497821,284,43,278497537,278497821
16721,5,12,149,5745,-68,-97,29,a6:92:ad:b7:76:65,278502782,484,4477,278502298,278502782
16722,5,12,149,5745,-57,-97,40,3e:d1:9b:c7:a4:de,278505025,544,1699,278504481,278505025
16723,5,12,149,5745,-91,-97,6,7e:05:42:11:d2:ec,278505604,244,335,278505360,278505604
16724,5,6,149,5745,-85,-97,12,54:e4:3a:ec:fb:65,278511988,360,6024,278511628,278511988
16725,5,12,149,5745,-63,-97,34,5e:29:73:5b:30:00,278516290,272,4030,278516018,278516290
16726,5,12,149,5745,-64,-97,33,0a:e1:ab:b3:c3:a6,278524766,272,8204,278524494,278524766
16727,5,12,149,5745,-61,-97,36,76:d6:6a:bb:b3:f5,278525151,272,113,278524879,278525151
16728,5,12,149,5745,-59,-97,38,3a:de:b0:2e:cd:45,278532083,272,6660,278531811,278532083
16729,5,12,149,5745,-76,-97,21,3e:ef:29:c7:4b:17,278533310,272,955,278533038,278533310
16730,5,12,149,5745,-70,-97,27,f6:0a:5c:59:72:df,278541620,280,8030,278541340,278541620
16731,5,12,149,5745,-58,-97,39,4a:ea:3c:f4:ce:b2,278547299,468,5211,278546831,278547299
16732,5,12,149,5745,-74,-97,23,aa:b6:ae:27:64:4e,278549173,468,1406,278548705,278549173
16733,5,12,149,5745,-91,-97,6,7e:05:42:11:d2:ec,278551299,440,1686,278550859,278551299
16734,5,12,149,5745,-85,-97,12,9a:24:38:da:96:bb,278551743,272,172,278551471,278551743
16735,5,12,149,5745,-86,-97,11,9a:24:38:da:96:bb,278552138,824,-429,278551314,278552138
16736,5,12,149,5745,-72,-97,25,d2:00:04:7e:2c:ab,278553835,412,1285,278553423,278553835
16737,5,12,149,5745,-89,-97,8,42:d2:d9:2b:ac:61,278555932,452,1645,278555480,278555932
16738,5,12,149,5745,-59,-97,38,3a:de:b0:2e:cd:45,278558594,468,2194,278558126,278558594
16739,5,24,149,5745,-86,-97,11,,278559603,32,977,278559571,278559603
16740,5,12,149,5745,-58,-97,39,0a:b9:b7:b1:4d:fa,278560030,468,-41,278559562,278560030
16741,5,24,149,5745,-86,-97,11,,278560649,28,591,278560621,278560649
16742,5,12,149,5745,-70,-97,27,f6:0a:5c:59:72:df,278560963,476,-162,278560487,278560963
16743,5,24,149,5745,-69,-97,28,,278561488,28,497,278561460,278561488
16744,5,24,149,5745,-86,-97,11,,278561532,28,16,278561504,278561532
16745,5,24,149,5745,-87,-97,10,,278561641,28,81,278561613,278561641
16746,5,12,149,5745,-71,-97,26,b6:90:18:f6:b1:d4,278562965,468,856,278562497,278562965
16747,5,24,149,5745,-70,-97,27,,278563947,28,954,278563919,278563947
16748,5,24,149,5745,-86,-97,11,,278563991,28,16,278563963,278563991
16749,5,12,149,5745,-67,-97,30,0a:e1:ab:b3:c3:a6,278564116,468,-343,278563648,278564116
16750,5,24,149,5745,-87,-97,10,,278564588,28,444,278564560,278564588
16751,5,24,149,5745,-87,-97,10,,278564697,28,81,278564669,278564697
16752,5,24,149,5745,-69,-97,28,,278564851,28,126,278564823,278564851
16753,5,24,149,5745,-87,-97,10,,278564895,28,16,278564867,278564895
16754,5,24,149,5745,-86,-97,11,,278565023,32,96,278564991,278565023
16755,5,12,149,5745,-63,-97,34,76:d6:6a:bb:b3:f5,278565116,468,-375,278564648,278565116
16756,5,12,149,5745,-68,-97,29,22:ec:75:a8:8a:31,278565697,516,65,278565181,278565697
16757,5,12,149,5745,-74,-97,23,3e:ef:29:c7:4b:17,278566519,468,354,278566051,278566519
16758,5,12,149,5745,-65,-97,32,a6:92:ad:b7:76:65,278568338,484,1335,278567854,278568338
16759,5,12,149,5745,-51,-97,46,3e:d1:9b:c7:a4:de,278570459,544,1577,278569915,278570459
16760,5,12,149,5745,-65,-97,32,f2:da:61:dd:98:c5,278571057,468,130,278570589,278571057
16761,5,12,149,5745,-67,-97,30,22:ec:75:a8:8a:31,278579099,244,7798,278578855,278579099
16762,5,12,149,5745,-66,-97,31,f2:da:61:dd:98:c5,278581591,272,2220,278581319,278581591
16763,5,12,149,5745,-50,-97,47,3e:d1:9b:c7:a4:de,278596577,272,14714,278596305,278596577
16764,5,12,149,5745,-70,-97,27,b6:90:18:f6:b1:d4,278597164,272,315,278596892,278597164
16765,5,12,149,5745,-66,-97,31,9e:1f:b0:a7:b8:90,278611844,284,14396,278611560,278611844
16766,5,6,149,5745,-86,-97,11,54:e4:3a:ec:fb:65,278614388,360,2184,278614028,278614388
16767,5,12,149,5745,-65,-97,32,a6:92:ad:b7:76:65,278623386,284,8714,278623102,278623386
16768,5,12,149,5745,-64,-97,33,5e:29:73:5b:30:00,278633291,272,9633,278633019,278633291
16769,5,12,149,5745,-52,-97,45,3e:d1:9b:c7:a4:de,278636126,544,2291,278635582,278636126
16770,5,12,149,5745,-72,-97,25,72:d1:72:1d:22:a1,278639003,284,2593,278638719,278639003
16771,5,12,149,5745,-71,-97,26,56:68:e2:c2:8d:d5,278641166,280,1883,278640886,278641166
16772,5,12,149,5745,-54,-97,43,3a:de:b0:2e:cd:45,278653379,272,11941,278653107,278653379
16773,5,12,149,5745,-71,-97,26,0a:e1:ab:b3:c3:a6,278653703,272,52,278653431,278653703
16774,5,12,149,5745,-86,-97,11,9a:24:38:da:96:bb,278664845,272,10870,278664573,278664845
16775,5,12,149,5745,-67,-97,30,22:ec:75:a8:8a:31,278678762,244,13673,278678518,278678762
16776,5,12,149,5745,-55,-97,42,3e:d1:9b:c7:a4:de,278688168,272,9134,278687896,278688168
16777,5,12,149,5745,-88,-97,9,42:d2:d9:2b:ac:61,278688469,256,45,278688213,278688469
16778,5,12,149,5745,-55,-97,42,3e:d1:9b:c7:a4:de,278691743,544,2730,278691199,278691743
16779,5,12,149,5745,-74,-97,23,f2:da:61:dd:98:c5,278698863,272,6848,278698591,278698863
16780,5,6,149,5745,-86,-97,11,54:e4:3a:ec:fb:65,278716789,360,17566,278716429,278716789
16781,5,12,149,5745,-58,-97,39,76:d6:6a:bb:b3:f5,278718656,272,1595,278718384,278718656
16782,5,12,149,5745,-62,-97,35,9e:1f:b0:a7:b8:90,278724161,284,5221,278723877,278724161
16783,5,24,149,5745,-83,-97,14,,278729967,32,5774,278729935,278729967
16784,5,12,149,5745,-61,-97,36,a6:92:ad:b7:76:65,278739820,284,9569,278739536,278739820
16785,5,12,149,5745,-65,-97,32,fa:44:8d:e1:c7:1b,278741070,244,1006,278740826,278741070
16786,5,12,149,5745,-72,-97,25,72:d1:72:1d:22:a1,278741411,284,57,278741127,278741411
16787,5,12,149,5745,-72,-97,25,b6:90:18:f6:b1:d4,278741785,272,102,278741513,278741785
16788,5,12,149,5745,-70,-97,27,56:68:e2:c2:8d:d5,278743531,280,1466,278743251,278743531
16789,5,24,149,5745,-82,-97,15,,278744190,32,627,278744158,278744190
16790,5,24,149,5745,-82,-97,15,,278744644,32,422,278744612,278744644
16791,5,24,149,5745,-83,-97,14,,278745098,28,426,278745070,278745098
16792,5,24,149,5745,-82,-97,15,,278745145,28,19,278745117,278745145
16793,5,24,149,5745,-81,-97,16,,278745254,32,77,278745222,278745254
16794,5,12,149,5745,-53,-97,44,4a:ea:3c:f4:ce:b2,278745357,468,-365,278744889,278745357
16795,5,24,149,5745,-82,-97,15,,278749319,28,3934,278749291,278749319
16796,5,12,149,5745,-60,-97,37,5e:29:73:5b:30:00,278750299,272,708,278750027,278750299
16797,5,24,149,5745,-82,-97,15,,278750659,28,332,278750631,278750659
16798,5,24,149,5745,-82,-97,15,,278752591,28,1904,278752563,278752591
16799,5,12,149,5745,-89,-97,8,7e:05:42:11:d2:ec,278760262,244,7427,278760018,278760262
16800,5,6,149,5745,-80,-97,17,5e:3a:b2:76:5d:6d,278779638,108,19268,278779530,278779638
16801,5,12,149,5745,-83,-97,14,9a:24:38:da:96:bb,278779740,272,-170,278779468,278779740
16802,5,6,149,5745,-80,-97,17,,278780275,44,491,278780231,278780275
16803,5,12,149,5745,-75,-97,22,3e:ef:29:c7:4b:17,278794874,272,14327,278794602,278794874
16804,5,12,149,5745,-66,-97,31,22:ec:75:a8:8a:31,278795917,244,799,278795673,278795917
16805,5,6,149,5745,-79,-97,18,5e:3a:b2:76:5d:6d,278799676,108,3651,278799568,278799676
16806,5,6,149,5745,-69,-97,28,,278800007,52,279,278799955,278800007
16807,5,6,149,5745,-68,-97,29,,278800299,52,240,278800247,278800299
16808,5,6,149,5745,-81,-97,16,,278800367,44,24,278800323,278800367
16809,5,12,149,5745,-50,-97,47,3e:d1:9b:c7:a4:de,278800952,272,313,278800680,278800952
16810,5,6,149,5745,-85,-97,12,54:e4:3a:ec:fb:65,278801535,352,231,278801183,278801535
16811,5,12,149,5745,-90,-97,7,42:d2:d9:2b:ac:61,278801925,256,134,278801669,278801925
16812,5,6,149,5745,-84,-97,13,54:e4:3a:ec:fb:65,278802438,352,161,278802086,278802438
16813,5,6,149,5745,-79,-97,18,,278802809,44,327,278802765,278802809
16814,5,24,149,5745,-82,-97,15,,278805088,32,2247,278805056,278805088
16815,5,12,149,5745,-67,-97,30,0a:e1:ab:b3:c3:a6,278813630,272,8270,278813358,278813630
16816,5,6,149,5745,-83,-97,14,54:e4:3a:ec:fb:65,278819189,360,5199,278818829,278819189
16817,5,12,149,5745,-68,-97,29,f2:da:61:dd:98:c5,278820147,272,686,278819875,278820147
16818,5,12,149,5745,-60,-97,37,3a:de:b0:2e:cd:45,278820514,272,95,278820242,278820514
16819,5,12,149,5745,-58,-97,39,76:d6:6a:bb:b3:f5,278821473,272,687,278821201,278821473
16820,5,24,149,5745,-83,-97,14,,278822648,32,1143,278822616,278822648
16821,5,24,149,5745,-83,-97,14,,278823063,28,387,278823035,278823063
16822,5,24,149,5745,-86,-97,11,,278832388,28,9297,278832360,278832388
16823,5,24,149,5745,-83,-97,14,,278832432,28,16,278832404,278832432
16824,5,24,149,5745,-83,-97,14,,278832540,32,76,278832508,278832540
16825,5,12,149,5745,-67,-97,30,9e:1f:b0:a7:b8:90,278836401,284,3577,278836117,278836401
16826,5,12,149,5745,-67,-97,30,b6:90:18:f6:b1:d4,278843614,272,6941,278843342,278843614
16827,5,12,149,5745,-64,-97,33,fa:44:8d:e1:c7:1b,278844019,244,161,278843775,278844019
16828,5,12,149,5745,-71,-97,26,72:d1:72:1d:22:a1,278844472,284,169,278844188,278844472
16829,5,12,149,5745,-74,-97,23,56:68:e2:c2:8d:d5,278845727,280,975,278845447,278845727
16830,5,24,149,5745,-85,-97,12,,278850860,28,5105,278850832,278850860
16831,5,24,149,5745,-86,-97,11,,278850905,28,17,278850877,278850905
16832,5,24,149,5745,-85,-97,12,,278851012,32,75,278850980,278851012
16833,5,12,149,5745,-92,-97,5,c6:71:4f:a2:d1:86,278854952,244,3696,278854708,278854952
16834,5,12,149,5745,-65,-97,32,a6:92:ad:b7:76:65,278858267,284,3031,278857983,278858267
16835,5,6,149,5745,-93,-97,4,e2:9b:0b:46:9f:de,278859129,256,606,278858873,278859129
16836,5,12,149,5745,-91,-97,6,7e:05:42:11:d2:ec,278862272,244,2899,278862028,278862272
16837,5,12,149,5745,-63,-97,34,5e:29:73:5b:30:00,278864656,272,2112,278864384,278864656
16838,5,24,149,5745,-85,-97,12,,278866589,32,1901,278866557,278866589
16839,5,12,149,5745,-83,-97,14,9a:24:38:da:96:bb,278888466,272,21605,278888194,278888466
16840,5,12,149,5745,-66,-97,31,f6:0a:5c:59:72:df,278895799,280,7053,278895519,278895799
16841,5,12,149,5745,-74,-97,23,3e:ef:29:c7:4b:17,278897221,272,1150,278896949,278897221
16842,5,24,149,5745,-86,-97,11,,278903047,28,5798,278903019,278903047
16843,5,24,149,5745,-83,-97,14,,278903094,28,19,278903066,278903094
16844,5,24,149,5745,-84,-97,13,,278903206,32,80,278903174,278903206
16845,5,24,149,5745,-86,-97,11,,278906017,32,2779,278905985,278906017
16846,5,24,149,5745,-86,-97,11,,278908373,28,2328,278908345,278908373
16847,5,24,149,5745,-84,-97,13,,278908419,28,18,278908391,278908419
16848,5,24,149,5745,-84,-97,13,,278908533,32,82,278908501,278908533
16849,5,12,149,5745,-50,-97,47,3e:d1:9b:c7:a4:de,278912685,272,3880,278912413,278912685
16850,5,12,149,5745,-63,-97,34,22:ec:75:a8:8a:31,278912981,244,52,278912737,278912981
16851,5,12,149,5745,-89,-97,8,42:d2:d9:2b:ac:61,278915469,256,2232,278915213,278915469
16852,5,12,149,5745,-66,-97,31,0a:e1:ab:b3:c3:a6,278916049,272,308,278915777,278916049
16853,5,24,149,5745,-87,-97,10,,278919554,28,3477,278919526,278919554
16854,5,24,149,5745,-83,-97,14,,278919600,28,18,278919572,278919600
16855,5,24,149,5745,-84,-97,13,,278919710,32,78,278919678,278919710
16856,5,6,149,5745,-86,-97,11,54:e4:3a:ec:fb:65,278921590,360,1520,278921230,278921590
16857,5,12,149,5745,-66,-97,31,f2:da:61:dd:98:c5,278922485,272,623,278922213,278922485
16858,5,12,149,5745,-57,-97,40,76:d6:6a:bb:b3:f5,278922822,272,65,278922550,278922822
16859,5,12,149,5745,-58,-97,39,3a:de:b0:2e:cd:45,278923136,272,42,278922864,278923136
16860,5,24,149,5745,-87,-97,10,,278928393,28,5229,278928365,278928393
16861,5,24,149,5745,-84,-97,13,,278928439,28,18,278928411,278928439
16862,5,24,149,5745,-84,-97,13,,278928549,32,78,278928517,278928549
16863,5,12,149,5745,-65,-97,32,fa:44:8d:e1:c7:1b,278945818,244,17025,278945574,278945818
16864,5,12,149,5745,-72,-97,25,72:d1:72:1d:22:a1,278946152,284,50,278945868,278946152
16865,5,12,149,5745,-69,-97,28,b6:90:18:f6:b1:d4,278946948,272,524,278946676,278946948
16866,5,12,149,5745,-71,-97,26,56:68:e2:c2:8d:d5,278947515,280,287,278947235,278947515
16867,5,12,149,5745,-65,-97,32,9e:1f:b0:a7:b8:90,278954811,284,7012,278954527,278954811
16868,5,12,149,5745,-68,-97,29,a6:92:ad:b7:76:65,278960089,284,4994,278959805,278960089
16869,5,12,149,5745,-91,-97,6,7e:05:42:11:d2:ec,278963213,244,2880,278962969,278963213
16870,5,12,149,5745,-60,-97,37,5e:29:73:5b:30:00,278976768,272,13283,278976496,278976768
16871,5,24,149,5745,-88,-97,9,,278984941,28,8145,278984913,278984941
16872,5,24,149,5745,-89,-97,8,,278985143,28,174,278985115,278985143
16873,5,12,149,5745,-75,-97,22,3e:ef:29:c7:4b:17,278989856,272,4441,278989584,278989856
16874,5,12,149,5745,-58,-97,39,76:d6:6a:bb:b3:f5,278990288,272,160,278990016,278990288
16875,5,12,149,5745,-68,-97,29,0a:e1:ab:b3:c3:a6,278991830,272,1270,278991558,278991830
16876,5,12,149,5745,-57,-97,40,3a:de:b0:2e:cd:45,278993873,272,1771,278993601,278993873
16877,5,12,149,5745,-66,-97,31,f6:0a:5c:59:72:df,278997547,280,3394,278997267,278997547
16878,5,12,149,5745,-83,-97,14,9a:24:38:da:96:bb,278999072,272,1253,278998800,278999072
16879,5,6,149,5745,-70,-97,27,,279004022,52,4898,279003970,279004022
16880,5,6,149,5745,-88,-97,9,,279004090,44,24,279004046,279004090
16881,5,24,149,5745,-88,-97,9,,279004208,28,90,279004180,279004208
16882,5,12,149,5745,-65,-97,32,fa:44:8d:e1:c7:1b,279006520,244,2068,279006276,279006520
16883,5,12,149,5745,-72,-97,25,72:d1:72:1d:22:a1,279009104,480,2104,279008624,279009104
16884,5,12,149,5745,-68,-97,29,a6:92:ad:b7:76:65,279009663,484,75,279009179,279009663
16885,5,12,149,5745,-68,-97,29,b6:90:18:f6:b1:d4,279014855,468,4724,279014387,279014855
16886,5,12,149,5745,-60,-97,37,5e:29:73:5b:30:00,279015375,540,-20,279014835,279015375
16887,5,12,149,5745,-76,-97,21,3e:ef:29:c7:4b:17,279015950,468,107,279015482,279015950
16888,5,12,149,5745,-86,-97,11,42:d2:d9:2b:ac:61,279016569,452,167,279016117,279016569
16889,5,12,149,5745,-69,-97,28,9e:1f:b0:a7:b8:90,279019224,480,2175,279018744,279019224
16890,5,12,149,5745,-65,-97,32,fa:44:8d:e1:c7:1b,279021097,412,1461,279020685,279021097
16891,5,12,149,5745,-68,-97,29,22:ec:75:a8:8a:31,279021579,516,-34,279021063,279021579
16892,5,12,149,5745,-71,-97,26,56:68:e2:c2:8d:d5,279022804,280,945,279022524,279022804
16893,5,12,149,5745,-53,-97,44,3e:d1:9b:c7:a4:de,279023128,544,-220,279022584,279023128
16894,5,12,149,5745,-71,-97,26,72:d1:72:1d:22:a1,279023707,284,295,279023423,279023707
16895,5,12,149,5745,-70,-97,27,f2:da:61:dd:98:c5,279024118,272,139,279023846,279024118
16896,5,12,149,5745,-86,-97,11,42:d2:d9:2b:ac:61,279024425,256,51,279024169,279024425
16897,5,12,149,5745,-71,-97,26,56:68:e2:c2:8d:d5,279024742,476,-159,279024266,279024742
16898,5,12,149,5745,-66,-97,31,f6:0a:5c:59:72:df,279029820,476,4602,279029344,279029820
16899,5,12,149,5745,-72,-97,25,0a:e1:ab:b3:c3:a6,279031131,468,843,279030663,279031131
16900,5,12,149,5745,-70,-97,27,f2:da:61:dd:98:c5,279031643,468,44,279031175,279031643
16901,5,12,149,5745,-57,-97,40,3a:de:b0:2e:cd:45,279034098,468,1987,279033630,279034098
16902,5,12,149,5745,-69,-97,28,22:ec:75:a8:8a:31,279038025,244,3683,279037781,279038025
16903,5,12,149,5745,-53,-97,44,3e:d1:9b:c7:a4:de,279038780,272,483,279038508,279038780
16904,5,12,149,5745,-61,-97,36,76:d6:6a:bb:b3:f5,279045280,468,6032,279044812,279045280
16905,5,24,149,5745,-87,-97,10,,279053843,32,8531,279053811,279053843
16906,5,12,149,5745,-68,-97,29,b6:90:18:f6:b1:d4,279055826,272,1711,279055554,279055826
16907,5,12,149,5745,-69,-97,28,9e:1f:b0:a7:b8:90,279057275,284,1165,279056991,279057275
16908,5,6,149,5745,-75,-97,22,,279061537,52,4210,279061485,279061537
16909,5,6,149,5745,-87,-97,10,,279061605,44,24,279061561,279061605
16910,5,24,149,5745,-87,-97,10,,279061723,28,90,279061695,279061723
16911,5,12,149,5745,-66,-97,31,a6:92:ad:b7:76:65,279070677,284,8670,279070393,279070677
16912,5,12,149,5745,-69,-97,28,72:d1:72:1d:22:a1,279072301,480,1144,279071821,279072301
16913,5,24,149,5745,-86,-97,11,,279073174,28,845,279073146,279073174
16914,5,24,149,5745,-91,-97,6,,279073218,28,16,279073190,279073218
16915,5,12,149,5745,-65,-97,32,a6:92:ad:b7:76:65,279073563,484,-139,279073079,279073563
16916,5,12,149,5745,-67,-97,30,b6:90:18:f6:b1:d4,279077376,468,3345,279076908,279077376
16917,5,12,149,5745,-87,-97,10,42:d2:d9:2b:ac:61,279079510,452,1682,279079058,279079510
16918,5,12,149,5745,-69,-97,28,0a:e1:ab:b3:c3:a6,279080326,468,348,279079858,279080326
16919,5,12,149,5745,-77,-97,20,3e:ef:29:c7:4b:17,279080828,468,34,279080360,279080828
16920,5,12,149,5745,-66,-97,31,aa:b6:ae:27:64:4e,279081332,468,36,279080864,279081332
16921,5,12,149,5745,-71,-97,26,f2:da:61:dd:98:c5,279082194,468,394,279081726,279082194
16922,5,12,149,5745,-83,-97,14,9a:24:38:da:96:bb,279082706,824,-312,279081882,279082706
16923,5,12,149,5745,-69,-97,28,9e:1f:b0:a7:b8:90,279083609,480,423,279083129,279083609
16924,5,12,149,5745,-64,-97,33,fa:44:8d:e1:c7:1b,279084714,440,665,279084274,279084714
16925,5,12,149,5745,-60,-97,37,5e:29:73:5b:30:00,279085197,540,-57,279084657,279085197
16926,5,12,149,5745,-60,-97,37,3a:de:b0:2e:cd:45,279086483,468,818,279086015,279086483
16927,5,12,149,5745,-71,-97,26,56:68:e2:c2:8d:d5,279087480,476,521,279087004,279087480
16928,5,12,149,5745,-69,-97,28,0a:e1:ab:b3:c3:a6,279088396,272,644,279088124,279088396
16929,5,12,149,5745,-51,-97,46,3e:d1:9b:c7:a4:de,279088756,544,-184,279088212,279088756
16930,5,12,149,5745,-65,-97,32,fa:44:8d:e1:c7:1b,279089426,360,310,279089066,279089426
16931,5,12,149,5745,-61,-97,36,76:d6:6a:bb:b3:f5,279094484,468,4590,279094016,279094484
16932,5,12,149,5745,-68,-97,29,f6:0a:5c:59:72:df,279095004,476,44,279094528,279095004
16933,5,12,149,5745,-61,-97,36,76:d6:6a:bb:b3:f5,279103354,272,8078,279103082,279103354
16934,5,12,149,5745,-76,-97,21,3e:ef:29:c7:4b:17,279103660,272,34,279103388,279103660
16935,5,12,149,5745,-62,-97,35,3a:de:b0:2e:cd:45,279105280,272,1348,279105008,279105280
16936,5,12,149,5745,-59,-97,38,5e:29:73:5b:30:00,279105639,272,87,279105367,279105639
16937,5,12,149,5745,-68,-97,29,f6:0a:5c:59:72:df,279108429,280,2510,279108149,279108429
16938,5,12,149,5745,-92,-97,5,02:af:71:9e:85:a6,279110246,212,1605,279110034,279110246
16939,5,12,149,5745,-83,-97,14,9a:24:38:da:96:bb,279111798,272,1280,279111526,279111798
16940,5,12,149,5745,-93,-97,4,02:af:71:9e:85:a6,279113061,212,1051,279112849,279113061
16941,5,12,149,5745,-92,-97,5,02:af:71:9e:85:a6,279113685,212,412,279113473,279113685
16942,5,12,149,5745,-91,-97,6,02:af:71:9e:85:a6,279113985,212,88,279113773,279113985
16943,5,12,149,5745,-93,-97,4,02:af:71:9e:85:a6,279114564,212,367,279114352,279114564
16944,5,12,149,5745,-65,-97,32,fa:44:8d:e1:c7:1b,279121599,244,6791,279121355,279121599
16945,5,6,149,5745,-87,-97,10,54:e4:3a:ec:fb:65,279126391,360,4432,279126031,279126391
16946,5,12,149,5745,-50,-97,47,3e:d1:9b:c7:a4:de,279138312,272,11649,279138040,279138312
16947,5,12,149,5745,-65,-97,32,fa:44:8d:e1:c7:1b,279140663,440,1911,279140223,279140663
16948,5,12,149,5745,-69,-97,28,22:ec:75:a8:8a:31,279142019,244,1112,279141775,279142019
16949,5,12,149,5745,-70,-97,27,56:68:e2:c2:8d:d5,279150813,280,8514,279150533,279150813
16950,5,12,149,5745,-87,-97,10,42:d2:d9:2b:ac:61,279151315,256,246,279151059,279151315
16951,5,12,149,5745,-71,-97,26,72:d1:72:1d:22:a1,279153697,284,2098,279153413,279153697
16952,5,12,149,5745,-69,-97,28,f2:da:61:dd:98:c5,279154212,272,243,279153940,279154212
16953,5,12,149,5745,-66,-97,31,9e:1f:b0:a7:b8:90,279176894,284,22398,279176610,279176894
16954,5,24,149,5745,-85,-97,12,,279190026,32,13100,279189994,279190026
16955,5,24,149,5745,-84,-97,13,,279190337,32,279,279190305,279190337
16956,5,24,149,5745,-84,-97,13,,279190649,28,284,279190621,279190649
16957,5,6,149,5745,-75,-97,22,,279191138,52,437,279191086,279191138
16958,5,6,149,5745,-85,-97,12,,279191206,44,24,279191162,279191206
16959,5,6,149,5745,-76,-97,21,,279191530,52,272,279191478,279191530
16960,5,6,149,5745,-84,-97,13,,279191598,44,24,279191554,279191598
16961,5,24,149,5745,-85,-97,12,,279191716,28,90,279191688,279191716
16962,5,12,149,5745,-92,-97,5,02:af:71:9e:85:a6,279206078,440,13922,279205638,279206078
16963,5,12,149,5745,-59,-97,38,5e:29:73:5b:30:00,279206791,272,441,279206519,279206791
16964,5,12,149,5745,-71,-97,26,0a:e1:ab:b3:c3:a6,279215825,272,8762,279215553,279215825
16965,5,12,149,5745,-76,-97,21,3e:ef:29:c7:4b:17,279216689,272,592,279216417,279216689
16966,5,12,149,5745,-61,-97,36,3a:de:b0:2e:cd:45,279217424,272,463,279217152,279217424
16967,5,12,149,5745,-61,-97,36,76:d6:6a:bb:b3:f5,279223419,272,5723,279223147,279223419
16968,5,12,149,5745,-84,-97,13,9a:24:38:da:96:bb,279224158,272,467,279223886,279224158
16969,5,6,149,5745,-83,-97,14,54:e4:3a:ec:fb:65,279228791,360,4273,279228431,279228791
16970,5,12,149,5745,-64,-97,33,fa:44:8d:e1:c7:1b,279243305,244,14270,279243061,279243305
16971,5,12,149,5745,-67,-97,30,a6:92:ad:b7:76:65,279251965,284,8376,279251681,279251965
16972,5,12,149,5745,-69,-97,28,56:68:e2:c2:8d:d5,279252785,280,540,279252505,279252785
16973,5,12,149,5745,-68,-97,29,b6:90:18:f6:b1:d4,279253281,272,224,279253009,279253281
16974,5,12,149,5745,-87,-97,10,42:d2:d9:2b:ac:61,279254652,256,1115,279254396,279254652
16975,5,12,149,5745,-48,-97,49,3e:d1:9b:c7:a4:de,279255336,272,412,279255064,279255336
16976,5,12,149,5745,-69,-97,28,22:ec:75:a8:8a:31,279259161,244,3581,279258917,279259161
16977,5,12,149,5745,-75,-97,22,72:d1:72:1d:22:a1,279265772,284,6327,279265488,279265772
16978,5,12,149,5745,-69,-97,28,f2:da:61:dd:98:c5,279266774,272,730,279266502,279266774
16979,5,12,149,5745,-57,-97,40,4a:ea:3c:f4:ce:b2,279279456,468,12214,279278988,279279456
16980,5,12,149,5745,-67,-97,30,9e:1f:b0:a7:b8:90,279289753,284,10013,279289469,279289753
16981,5,12,149,5745,-91,-97,6,02:af:71:9e:85:a6,279291876,440,1683,279291436,279291876
16982,5,12,149,5745,-59,-97,38,5e:29:73:5b:30:00,279319599,272,27451,279319327,279319599
16983,5,12,149,5745,-70,-97,27,0a:e1:ab:b3:c3:a6,279329588,272,9717,279329316,279329588
16984,5,12,149,5745,-61,-97,36,3a:de:b0:2e:cd:45,279329949,272,89,279329677,279329949
16985,5,6,149,5745,-84,-97,13,54:e4:3a:ec:fb:65,279331192,360,883,279330832,279331192
16986,5,12,149,5745,-86,-97,11,9a:24:38:da:96:bb,279336928,272,5464,279336656,279336928
16987,5,12,149,5745,-58,-97,39,76:d6:6a:bb:b3:f5,279339553,272,2353,279339281,279339553
16988,5,12,149,5745,-68,-97,29,a6:92:ad:b7:76:65,279354331,284,14494,279354047,279354331
16989,5,12,149,5745,-64,-97,33,fa:44:8d:e1:c7:1b,279355091,244,516,279354847,279355091
16990,5,12,149,5745,-66,-97,31,b6:90:18:f6:b1:d4,279355668,272,305,279355396,279355668
16991,5,12,149,5745,-71,-97,26,56:68:e2:c2:8d:d5,279365267,280,9319,279364987,279365267
16992,5,12,149,5745,-87,-97,10,42:d2:d9:2b:ac:61,279367361,256,1838,279367105,279367361
16993,5,12,149,5745,-67,-97,30,f6:0a:5c:59:72:df,279368670,280,1029,279368390,279368670
16994,5,12,149,5745,-49,-97,48,3e:d1:9b:c7:a4:de,279372286,272,3344,279372014,279372286
16995,5,12,149,5745,-67,-97,30,22:ec:75:a8:8a:31,279374932,244,2402,279374688,279374932
16996,5,12,149,5745,-73,-97,24,72:d1:72:1d:22:a1,279388571,284,13355,279388287,279388571
16997,5,12,149,5745,-66,-97,31,b6:90:18:f6:b1:d4,279404742,272,15899,279404470,279404742
16998,5,12,149,5745,-74,-97,23,3e:ef:29:c7:4b:17,279409278,272,4264,279409006,279409278
16999,5,12,149,5745,-69,-97,28,a6:92:ad:b7:76:65,279413433,284,3871,279413149,279413433
17000,5,6,149,5745,-86,-97,11,54:e4:3a:ec:fb:65,279433593,360,19800,279433233,279433593
17001,5,12,149,5745,-68,-97,29,f2:da:61:dd:98:c5,279434370,272,505,279434098,279434370
17002,5,12,149,5745,-65,-97,32,9e:1f:b0:a7:b8:90,279435181,284,527,279434897,279435181
17003,5,12,149,5745,-58,-97,39,5e:29:73:5b:30:00,279437414,272,1961,279437142,279437414
17004,5,12,149,5745,-72,-97,25,0a:e1:ab:b3:c3:a6,279440165,272,2479,279439893,279440165
17005,5,12,149,5745,-59,-97,38,3a:de:b0:2e:cd:45,279443139,272,2702,279442867,279443139
17006,5,12,149,5745,-59,-97,38,76:d6:6a:bb:b3:f5,279448094,272,4683,279447822,279448094
17007,5,12,149,5745,-74,-97,23,3e:ef:29:c7:4b:17,279448544,272,178,279448272,279448544
17008,5,12,149,5745,-90,-97,7,02:af:71:9e:85:a6,279449840,244,1052,279449596,279449840
17009,5,12,149,5745,-71,-97,26,f6:0a:5c:59:72:df,279450893,280,773,279450613,279450893
17010,5,12,149,5745,-72,-97,25,fa:44:8d:e1:c7:1b,279465239,244,14102,279464995,279465239
17011,5,12,149,5745,-69,-97,28,a6:92:ad:b7:76:65,279466467,484,744,279465983,279466467
17012,5,12,149,5745,-88,-97,9,42:d2:d9:2b:ac:61,279467022,256,299,279466766,279467022
17013,5,12,149,5745,-63,-97,34,fa:44:8d:e1:c7:1b,279469095,440,1633,279468655,279469095
17014,5,12,149,5745,-91,-97,6,02:af:71:9e:85:a6,279469923,212,616,279469711,279469923
17015,5,12,149,5745,-90,-97,7,02:af:71:9e:85:a6,279470233,212,98,279470021,279470233
17016,5,12,149,5745,-91,-97,6,02:af:71:9e:85:a6,279470568,212,123,279470356,279470568
17017,5,12,149,5745,-91,-97,6,02:af:71:9e:85:a6,279470869,212,89,279470657,279470869
17018,5,12,149,5745,-92,-97,5,02:af:71:9e:85:a6,279471169,212,88,279470957,279471169
17019,5,12,149,5745,-89,-97,8,02:af:71:9e:85:a6,279471479,212,98,279471267,279471479
17020,5,12,149,5745,-66,-97,31,b6:90:18:f6:b1:d4,279471953,468,6,279471485,279471953
17021,5,12,149,5745,-59,-97,38,3a:de:b0:2e:cd:45,279473582,468,1161,279473114,279473582
17022,5,12,149,5745,-71,-97,26,0a:e1:ab:b3:c3:a6,279474102,468,52,279473634,279474102
17023,5,12,149,5745,-73,-97,24,3e:ef:29:c7:4b:17,279474622,468,52,279474154,279474622
17024,5,12,149,5745,-68,-97,29,f2:da:61:dd:98:c5,279475655,468,565,279475187,279475655
17025,5,12,149,5745,-62,-97,35,fa:44:8d:e1:c7:1b,279476837,216,966,279476621,279476837
17026,5,12,149,5745,-59,-97,38,5e:29:73:5b:30:00,279481350,540,3973,279480810,279481350
17027,5,12,149,5745,-73,-97,24,72:d1:72:1d:22:a1,279482043,284,409,279481759,279482043
17028,5,12,149,5745,-67,-97,30,22:ec:75:a8:8a:31,279482846,516,287,279482330,279482846
17029,5,12,149,5745,-69,-97,28,f2:da:61:dd:98:c5,279483450,272,332,279483178,279483450
17030,5,12,149,5745,-49,-97,48,3e:d1:9b:c7:a4:de,279483757,544,-237,279483213,279483757
17031,5,12,149,5745,-72,-97,25,56:68:e2:c2:8d:d5,279484533,476,300,279484057,279484533
17032,5,12,149,5745,-64,-97,33,9e:1f:b0:a7:b8:90,279486042,480,1029,279485562,279486042
17033,5,12,149,5745,-59,-97,38,76:d6:6a:bb:b3:f5,279488150,468,1640,279487682,279488150
17034,5,12,149,5745,-71,-97,26,f6:0a:5c:59:72:df,279488940,476,314,279488464,279488940
17035,5,12,149,5745,-73,-97,24,72:d1:72:1d:22:a1,279491549,480,2129,279491069,279491549
17036,5,12,149,5745,-67,-97,30,22:ec:75:a8:8a:31,279497055,244,5262,279496811,279497055
17037,5,12,149,5745,-49,-97,48,3e:d1:9b:c7:a4:de,279497468,272,141,279497196,279497468
17038,5,12,149,5745,-66,-97,31,b6:90:18:f6:b1:d4,279498964,272,1224,279498692,279498964
17039,5,12,149,5745,-69,-97,28,a6:92:ad:b7:76:65,279513259,284,14011,279512975,279513259
17040,5,12,149,5745,-90,-97,7,02:af:71:9e:85:a6,279530471,440,16772,279530031,279530471
17041,5,12,149,5745,-67,-97,30,a6:92:ad:b7:76:65,279532037,484,1082,279531553,279532037
17042,5,12,149,5745,-62,-97,35,4a:ea:3c:f4:ce:b2,279533906,468,1401,279533438,279533906
17043,5,12,149,5745,-62,-97,35,fa:44:8d:e1:c7:1b,279534426,440,80,279533986,279534426
17044,5,6,149,5745,-86,-97,11,54:e4:3a:ec:fb:65,279535993,360,1207,279535633,279535993
17045,5,12,149,5745,-93,-97,4,42:d2:d9:2b:ac:61,279538227,452,1782,279537775,279538227
17046,5,12,149,5745,-64,-97,33,9e:1f:b0:a7:b8:90,279541979,284,3468,279541695,279541979
17047,5,12,149,5745,-90,-97,7,02:af:71:9e:85:a6,279546270,212,4079,279546058,279546270
17048,5,12,149,5745,-89,-97,8,02:af:71:9e:85:a6,279546597,212,115,279546385,279546597
17049,5,12,149,5745,-90,-97,7,02:af:71:9e:85:a6,279546907,212,98,279546695,279546907
17050,5,12,149,5745,-59,-97,38,3a:de:b0:2e:cd:45,279547554,272,375,279547282,279547554
17051,5,12,149,5745,-59,-97,38,3a:de:b0:2e:cd:45,279548329,468,307,279547861,279548329
17052,5,12,149,5745,-90,-97,7,02:af:71:9e:85:a6,279549033,212,492,279548821,279549033
17053,5,12,149,5745,-89,-97,8,02:af:71:9e:85:a6,279549343,212,98,279549131,279549343
17054,5,12,149,5745,-60,-97,37,5e:29:73:5b:30:00,279553330,272,3715,279553058,279553330
17055,5,12,149,5745,-71,-97,26,0a:e1:ab:b3:c3:a6,279554941,272,1339,279554669,279554941
17056,5,12,149,5745,-74,-97,23,3e:ef:29:c7:4b:17,279561035,272,5822,279560763,279561035
17057,5,12,149,5745,-62,-97,35,4a:ea:3c:f4:ce:b2,279565020,272,3713,279564748,279565020
17058,5,12,149,5745,-61,-97,36,76:d6:6a:bb:b3:f5,279567930,272,2638,279567658,279567930
17059,5,12,149,5745,-62,-97,35,fa:44:8d:e1:c7:1b,279580305,244,12131,279580061,279580305
17060,5,12,149,5745,-92,-97,5,42:d2:d9:2b:ac:61,279582320,256,1759,279582064,279582320
17061,5,24,149,5745,-84,-97,13,,279586542,32,4190,279586510,279586542
17062,5,12,149,5745,-68,-97,29,f2:da:61:dd:98:c5,279597293,272,10479,279597021,279597293
17063,5,12,149,5745,-66,-97,31,a6:92:ad:b7:76:65,279597635,484,-142,279597151,279597635
17064,5,12,149,5745,-63,-97,34,fa:44:8d:e1:c7:1b,279599531,440,1456,279599091,279599531
17065,5,12,149,5745,-90,-97,7,7e:05:42:11:d2:ec,279601939,440,1968,279601499,279601939
17066,5,12,149,5745,-68,-97,29,b6:90:18:f6:b1:d4,279602998,468,591,279602530,279602998
17067,5,12,149,5745,-74,-97,23,3e:ef:29:c7:4b:17,279604294,468,828,279603826,279604294
17068,5,12,149,5745,-72,-97,25,0a:e1:ab:b3:c3:a6,279604796,468,34,279604328,279604796
17069,5,12,149,5745,-72,-97,25,aa:b6:ae:27:64:4e,279605307,468,43,279604839,279605307
17070,5,12,149,5745,-68,-97,29,f2:da:61:dd:98:c5,279608770,468,2995,279608302,279608770
17071,5,12,149,5745,-63,-97,34,5e:29:73:5b:30:00,279609452,540,142,279608912,279609452
17072,5,12,149,5745,-55,-97,42,0a:b9:b7:b1:4d:fa,279610080,468,160,279609612,279610080
17073,5,12,149,5745,-67,-97,30,22:ec:75:a8:8a:31,279612147,244,1823,279611903,279612147
17074,5,12,149,5745,-49,-97,48,3e:d1:9b:c7:a4:de,279613096,272,677,279612824,279613096
17075,5,12,149,5745,-68,-97,29,b6:90:18:f6:b1:d4,279613532,272,164,279613260,279613532
17076,5,12,149,5745,-67,-97,30,22:ec:75:a8:8a:31,279613856,516,-192,279613340,279613856
17077,5,12,149,5745,-59,-97,38,3a:de:b0:2e:cd:45,279614453,468,129,279613985,279614453
17078,5,12,149,5745,-88,-97,9,02:af:71:9e:85:a6,279615432,212,767,279615220,279615432
17079,5,12,149,5745,-49,-97,48,3e:d1:9b:c7:a4:de,279615773,544,-203,279615229,279615773
17080,5,12,149,5745,-90,-97,7,02:af:71:9e:85:a6,279617327,440,1114,279616887,279617327
17081,5,12,149,5745,-62,-97,35,76:d6:6a:bb:b3:f5,279617951,468,156,279617483,279617951
17082,5,12,149,5745,-91,-97,6,42:d2:d9:2b:ac:61,279622883,452,4480,279622431,279622883
17083,5,12,149,5745,-65,-97,32,a6:92:ad:b7:76:65,279627649,284,4482,279627365,279627649
17084,5,12,149,5745,-84,-97,13,9a:24:38:da:96:bb,279635400,272,7479,279635128,279635400
17085,5,6,149,5745,-87,-97,10,54:e4:3a:ec:fb:65,279638393,360,2633,279638033,279638393
17086,5,12,149,5745,-64,-97,33,9e:1f:b0:a7:b8:90,279639533,284,856,279639249,279639533
17087,5,12,149,5745,-80,-97,17,d2:00:04:7e:2c:ab,279646519,272,6714,279646247,279646519
17088,5,12,149,5745,-76,-97,21,72:d1:72:1d:22:a1,279663032,284,16229,279662748,279663032
17089,5,12,149,5745,-73,-97,24,56:68:e2:c2:8d:d5,279665081,280,1769,279664801,279665081
17090,5,12,149,5745,-62,-97,35,fa:44:8d:e1:c7:1b,279665585,440,64,279665145,279665585
17091,5,12,149,5745,-64,-97,33,5e:29:73:5b:30:00,279670247,272,4390,279669975,279670247
17092,5,12,149,5745,-58,-97,39,3a:de:b0:2e:cd:45,279673145,272,2626,279672873,279673145
17093,5,12,149,5745,-70,-97,27,0a:e1:ab:b3:c3:a6,279673566,272,149,279673294,279673566
17094,5,12,149,5745,-73,-97,24,3e:ef:29:c7:4b:17,279675474,272,1636,279675202,279675474
17095,5,12,149,5745,-64,-97,33,76:d6:6a:bb:b3:f5,279682277,272,6531,279682005,279682277
17096,5,12,149,5745,-79,-97,18,d2:00:04:7e:2c:ab,279686479,412,3790,279686067,279686479
17097,5,12,149,5745,-62,-97,35,fa:44:8d:e1:c7:1b,279694577,244,7854,279694333,279694577
17098,5,12,149,5745,-90,-97,7,42:d2:d9:2b:ac:61,279706928,256,12095,279706672,279706928
17099,5,12,149,5745,-50,-97,47,3e:d1:9b:c7:a4:de,279713830,272,6630,279713558,279713830
17100,5,12,149,5745,-69,-97,28,22:ec:75:a8:8a:31,279716701,244,2627,279716457,279716701
17101,5,12,149,5745,-70,-97,27,f2:da:61:dd:98:c5,279719968,272,2995,279719696,279719968
17102,5,12,149,5745,-87,-97,10,02:af:71:9e:85:a6,279738437,440,18029,279737997,279738437
17103,5,6,149,5745,-88,-97,9,54:e4:3a:ec:fb:65,279740794,360,1997,279740434,279740794
17104,5,12,149,5745,-66,-97,31,9e:1f:b0:a7:b8:90,279741915,284,837,279741631,279741915
17105,5,12,149,5745,-84,-97,13,9a:24:38:da:96:bb,279747513,272,5326,279747241,279747513
17106,5,12,149,5745,-65,-97,32,a6:92:ad:b7:76:65,279763949,284,16152,279763665,279763949
17107,5,12,149,5745,-67,-97,30,b6:90:18:f6:b1:d4,279765436,272,1215,279765164,279765436
17108,5,12,149,5745,-73,-97,24,56:68:e2:c2:8d:d5,279765848,280,132,279765568,279765848
17109,5,12,149,5745,-76,-97,21,72:d1:72:1d:22:a1,279766202,284,70,279765918,279766202
17110,5,12,149,5745,-78,-97,19,d2:00:04:7e:2c:ab,279766798,244,352,279766554,279766798
17111,5,24,149,5745,-86,-97,11,,279778494,28,11668,279778466,279778494
17112,5,24,149,5745,-83,-97,14,,279778538,28,16,279778510,279778538
17113,5,24,149,5745,-84,-97,13,,279778646,32,76,279778614,279778646
17114,5,12,149,5745,-63,-97,34,5e:29:73:5b:30:00,279786148,272,7230,279785876,279786148
17115,5,24,149,5745,-84,-97,13,,279794782,28,8606,279794754,279794782
17116,5,24,149,5745,-88,-97,9,,279794826,28,16,279794798,279794826
17117,5,24,149,5745,-87,-97,10,,279794934,32,76,279794902,279794934
17118,5,24,149,5745,-87,-97,10,,279797766,28,2804,279797738,279797766
17119,5,24,149,5745,-84,-97,13,,279797810,28,16,279797782,279797810
17120,5,24,149,5745,-85,-97,12,,279797918,32,76,279797886,279797918
17121,5,12,149,5745,-65,-97,32,f6:0a:5c:59:72:df,279805625,280,7427,279805345,279805625
17122,5,24,149,5745,-84,-97,13,,279806688,32,1031,279806656,279806688
17123,5,12,149,5745,-61,-97,36,4a:ea:3c:f4:ce:b2,279808691,272,1731,279808419,279808691
17124,5,12,149,5745,-90,-97,7,02:af:71:9e:85:a6,279809049,244,114,279808805,279809049
17125,5,12,149,5745,-89,-97,8,02:af:71:9e:85:a6,279813199,440,3710,279812759,279813199
17126,5,12,149,5745,-73,-97,24,3e:ef:29:c7:4b:17,279818854,272,5383,279818582,279818854
17127,5,12,149,5745,-88,-97,9,42:d2:d9:2b:ac:61,279820812,256,1702,279820556,279820812
17128,5,24,149,5745,-85,-97,12,,279824615,28,3775,279824587,279824615
17129,5,12,149,5745,-48,-97,49,3e:d1:9b:c7:a4:de,279827555,272,2668,279827283,279827555
17130,5,12,149,5745,-71,-97,26,22:ec:75:a8:8a:31,279829062,244,1263,279828818,279829062
17131,5,12,149,5745,-72,-97,25,0a:e1:ab:b3:c3:a6,279837778,272,8444,279837506,279837778
17132,5,6,149,5745,-86,-97,11,54:e4:3a:ec:fb:65,279843195,360,5057,279842835,279843195
17133,5,12,149,5745,-54,-97,43,3a:de:b0:2e:cd:45,279843866,272,399,279843594,279843866
17134,5,12,149,5745,-61,-97,36,76:d6:6a:bb:b3:f5,279844240,272,102,279843968,279844240
17135,5,12,149,5745,-72,-97,25,f2:da:61:dd:98:c5,279845005,272,493,279844733,279845005
17136,5,12,149,5745,-67,-97,30,9e:1f:b0:a7:b8:90,279860324,284,15035,279860040,279860324
17137,5,12,149,5745,-85,-97,12,9a:24:38:da:96:bb,279863846,272,3250,279863574,279863846
17138,5,12,149,5745,-68,-97,29,a6:92:ad:b7:76:65,279866595,284,2465,279866311,279866595
17139,5,12,149,5745,-67,-97,30,b6:90:18:f6:b1:d4,279867601,272,734,279867329,279867601
17140,5,12,149,5745,-61,-97,36,fa:44:8d:e1:c7:1b,279868108,244,263,279867864,279868108
17141,5,12,149,5745,-72,-97,25,72:d1:72:1d:22:a1,279868376,284,-16,279868092,279868376
17142,5,24,149,5745,-88,-97,9,,279868913,32,505,279868881,279868913
17143,5,12,149,5745,-72,-97,25,56:68:e2:c2:8d:d5,279870507,280,1314,279870227,279870507
17144,5,12,149,5745,-79,-97,18,d2:00:04:7e:2c:ab,279878356,244,7605,279878112,279878356
17145,5,12,149,5745,-63,-97,34,5e:29:73:5b:30:00,279903561,272,24933,279903289,279903561
17146,5,12,149,5745,-72,-97,25,3e:ef:29:c7:4b:17,279919995,272,16162,279919723,279919995
17147,5,6,149,5745,-68,-97,29,,279923944,52,3897,279923892,279923944
17148,5,6,149,5745,-87,-97,10,,279924012,44,24,279923968,279924012
17149,5,24,149,5745,-87,-97,10,,279924130,28,90,279924102,279924130
17150,5,12,149,5745,-88,-97,9,42:d2:d9:2b:ac:61,279934555,256,10169,279934299,279934555
17151,5,12,149,5745,-64,-97,33,f6:0a:5c:59:72:df,279937383,280,2548,279937103,279937383
17152,5,12,149,5745,-67,-97,30,0a:e1:ab:b3:c3:a6,279939939,272,2284,279939667,279939939
17153,5,24,149,5745,-87,-97,10,,279941972,28,2005,279941944,279941972
17154,5,12,149,5745,-53,-97,44,3e:d1:9b:c7:a4:de,279943496,272,1252,279943224,279943496
17155,5,12,149,5745,-64,-97,33,76:d6:6a:bb:b3:f5,279945620,272,1852,279945348,279945620
17156,5,12,149,5745,-67,-97,30,22:ec:75:a8:8a:31,279945969,244,105,279945725,279945969
17157,5,12,149,5745,-55,-97,42,3a:de:b0:2e:cd:45,279946267,272,26,279945995,279946267
17158,5,12,149,5745,-71,-97,26,f2:da:61:dd:98:c5,279946600,272,61,279946328,279946600
17159,5,24,149,5745,-86,-97,11,,279947346,32,714,279947314,279947346
17160,5,12,149,5745,-67,-97,30,b6:90:18:f6:b1:d4,279969967,272,22349,279969695,279969967
17161,5,12,149,5745,-62,-97,35,fa:44:8d:e1:c7:1b,279970383,244,172,279970139,279970383
17162,5,12,149,5745,-72,-97,25,56:68:e2:c2:8d:d5,279970661,280,-2,279970381,279970661
17163,5,12,149,5745,-73,-97,24,72:d1:72:1d:22:a1,279971022,284,77,279970738,279971022
17164,5,12,149,5745,-67,-97,30,9e:1f:b0:a7:b8:90,279977867,284,6561,279977583,279977867
17165,5,6,149,5745,-70,-97,27,,279985605,52,7686,279985553,279985605
17166,5,6,149,5745,-85,-97,12,,279985673,44,24,279985629,279985673
17167,5,24,149,5745,-86,-97,11,,279985791,28,90,279985763,279985791
17168,5,12,149,5745,-69,-97,28,a6:92:ad:b7:76:65,279986139,284,64,279985855,279986139
17169,5,12,149,5745,-77,-97,20,d2:00:04:7e:2c:ab,280001799,244,15416,280001555,280001799
17170,5,12,149,5745,-56,-97,41,3a:de:b0:2e:cd:45,280005781,272,3710,280005509,280005781
17171,5,12,149,5745,-68,-97,29,0a:e1:ab:b3:c3:a6,280006105,272,52,280005833,280006105
17172,5,12,149,5745,-61,-97,36,5e:29:73:5b:30:00,280015423,272,9046,280015151,280015423
17173,5,12,149,5745,-74,-97,23,3e:ef:29:c7:4b:17,280022346,272,6651,280022074,280022346
17174,5,12,149,5745,-63,-97,34,76:d6:6a:bb:b3:f5,280024097,272,1479,280023825,280024097
17175,5,12,149,5745,-56,-97,41,4a:ea:3c:f4:ce:b2,280026052,272,1683,280025780,280026052
17176,5,12,149,5745,-61,-97,36,fa:44:8d:e1:c7:1b,280038054,244,11758,280037810,280038054
17177,5,12,149,5745,-72,-97,25,56:68:e2:c2:8d:d5,280041581,280,3247,280041301,280041581
17178,5,12,149,5745,-84,-97,13,9a:24:38:da:96:bb,280042358,272,505,280042086,280042358
17179,5,12,149,5745,-90,-97,7,42:d2:d9:2b:ac:61,280043509,256,895,280043253,280043509
17180,5,6,149,5745,-84,-97,13,54:e4:3a:ec:fb:65,280047996,360,4127,280047636,280047996
17181,5,12,149,5745,-71,-97,26,f2:da:61:dd:98:c5,280056103,272,7835,280055831,280056103
17182,5,12,149,5745,-72,-97,25,72:d1:72:1d:22:a1,280057615,284,1228,280057331,280057615
17183,5,12,149,5745,-69,-97,28,a6:92:ad:b7:76:65,280057942,484,-157,280057458,280057942
17184,5,12,149,5745,-60,-97,37,fa:44:8d:e1:c7:1b,280059155,440,773,280058715,280059155
17185,5,12,149,5745,-90,-97,7,02:af:71:9e:85:a6,280061371,212,2004,280061159,280061371
17186,5,12,149,5745,-90,-97,7,02:af:71:9e:85:a6,280061698,212,115,280061486,280061698
17187,5,12,149,5745,-55,-97,42,4a:ea:3c:f4:ce:b2,280061993,468,-173,280061525,280061993
17188,5,6,149,5745,-68,-97,29,,280062537,52,492,280062485,280062537
17189,5,6,149,5745,-69,-97,28,,280062682,52,93,280062630,280062682
17190,5,12,149,5745,-91,-97,6,02:af:71:9e:85:a6,280062824,212,-70,280062612,280062824
17191,5,6,149,5745,-69,-97,28,,280063270,52,394,280063218,280063270
17192,5,6,149,5745,-69,-97,28,,280063459,52,137,280063407,280063459
17193,5,12,149,5745,-67,-97,30,b6:90:18:f6:b1:d4,280063628,468,-299,280063160,280063628
17194,5,12,149,5745,-75,-97,22,3e:ef:29:c7:4b:17,280064177,468,81,280063709,280064177
17195,5,12,149,5745,-69,-97,28,0a:e1:ab:b3:c3:a6,280064769,468,124,280064301,280064769
17196,5,6,149,5745,-85,-97,12,,280065275,44,462,280065231,280065275
17197,5,24,149,5745,-85,-97,12,,280065392,28,89,280065364,280065392
17198,5,12,149,5745,-70,-97,27,f2:da:61:dd:98:c5,280067597,468,1737,280067129,280067597
17199,5,12,149,5745,-61,-97,36,5e:29:73:5b:30:00,280068203,540,66,280067663,280068203
17200,5,12,149,5745,-74,-97,23,d2:00:04:7e:2c:ab,280069884,440,1241,280069444,280069884
17201,5,12,149,5745,-68,-97,29,22:ec:75:a8:8a:31,280070367,516,-33,280069851,280070367
17202,5,12,149,5745,-68,-97,29,22:ec:75:a8:8a:31,280070900,244,289,280070656,280070900
17203,5,12,149,5745,-52,-97,45,3e:d1:9b:c7:a4:de,280071215,272,43,280070943,280071215
17204,5,12,149,5745,-66,-97,31,9e:1f:b0:a7:b8:90,280072323,284,824,280072039,280072323
17205,5,12,149,5745,-66,-97,31,b6:90:18:f6:b1:d4,280072650,272,55,280072378,280072650
17206,5,12,149,5745,-52,-97,45,3e:d1:9b:c7:a4:de,280072983,544,-211,280072439,280072983
17207,5,12,149,5745,-58,-97,39,3a:de:b0:2e:cd:45,280074074,468,623,280073606,280074074
17208,5,12,149,5745,-65,-97,32,9e:1f:b0:a7:b8:90,280077763,480,3209,280077283,280077763
17209,5,12,149,5745,-72,-97,25,72:d1:72:1d:22:a1,280081921,480,3678,280081441,280081921
17210,5,12,149,5745,-91,-97,6,42:d2:d9:2b:ac:61,280083520,452,1147,280083068,280083520
17211,5,12,149,5745,-86,-97,11,9a:24:38:da:96:bb,280084866,272,1074,280084594,280084866
17212,5,12,149,5745,-68,-97,29,a6:92:ad:b7:76:65,280086703,284,1553,280086419,280086703
17213,5,12,149,5745,-68,-97,29,0a:e1:ab:b3:c3:a6,280104813,272,17838,280104541,280104813
17214,5,12,149,5745,-59,-97,38,3a:de:b0:2e:cd:45,280105128,272,43,280104856,280105128
17215,5,12,149,5745,-72,-97,25,d2:00:04:7e:2c:ab,280105462,244,90,280105218,280105462
17216,5,12,149,5745,-75,-97,22,3e:ef:29:c7:4b:17,280119223,272,13489,280118951,280119223
17217,5,12,149,5745,-66,-97,31,a6:92:ad:b7:76:65,280122183,484,2476,280121699,280122183
17218,5,12,149,5745,-53,-97,44,4a:ea:3c:f4:ce:b2,280124139,468,1488,280123671,280124139
17219,5,12,149,5745,-65,-97,32,b6:90:18:f6:b1:d4,280126075,468,1468,280125607,280126075
17220,5,12,149,5745,-53,-97,44,4a:ea:3c:f4:ce:b2,280126857,272,510,280126585,280126857
17221,5,12,149,5745,-74,-97,23,3e:ef:29:c7:4b:17,280128306,468,981,280127838,280128306
17222,5,12,149,5745,-65,-97,32,76:d6:6a:bb:b3:f5,280128932,268,358,280128664,280128932
17223,5,12,149,5745,-67,-97,30,0a:e1:ab:b3:c3:a6,280129261,468,-139,280128793,280129261
17224,5,12,149,5745,-84,-97,13,9a:24:38:da:96:bb,280129772,824,-313,280128948,280129772
17225,5,12,149,5745,-71,-97,26,aa:b6:ae:27:64:4e,280132030,468,1790,280131562,280132030
17226,5,12,149,5745,-58,-97,39,fa:44:8d:e1:c7:1b,280132659,360,269,280132299,280132659
17227,5,12,149,5745,-61,-97,36,5e:29:73:5b:30:00,280134007,540,808,280133467,280134007
17228,5,12,149,5745,-58,-97,39,0a:b9:b7:b1:4d:fa,280134626,468,151,280134158,280134626
17229,5,12,149,5745,-70,-97,27,22:ec:75:a8:8a:31,280135279,516,137,280134763,280135279
17230,5,12,149,5745,-72,-97,25,56:68:e2:c2:8d:d5,280135856,476,101,280135380,280135856
17231,5,12,149,5745,-65,-97,32,76:d6:6a:bb:b3:f5,280136394,272,266,280136122,280136394
17232,5,12,149,5745,-71,-97,26,aa:b6:ae:27:64:4e,280136763,268,101,280136495,280136763
17233,5,12,149,5745,-72,-97,25,56:68:e2:c2:8d:d5,280137083,280,40,280136803,280137083
17234,5,12,149,5745,-51,-97,46,3e:d1:9b:c7:a4:de,280137476,544,-151,280136932,280137476
17235,5,12,149,5745,-62,-97,35,5e:29:73:5b:30:00,280138063,272,315,280137791,280138063
17236,5,12,149,5745,-58,-97,39,fa:44:8d:e1:c7:1b,280138468,244,161,280138224,280138468
17237,5,12,149,5745,-61,-97,36,3a:de:b0:2e:cd:45,280139072,468,136,280138604,280139072
17238,5,12,149,5745,-90,-97,7,02:af:71:9e:85:a6,280140202,244,886,280139958,280140202
17239,5,12,149,5745,-70,-97,27,d2:00:04:7e:2c:ab,280140836,380,254,280140456,280140836
17240,5,12,149,5745,-65,-97,32,9e:1f:b0:a7:b8:90,280141250,480,-66,280140770,280141250
17241,5,12,149,5745,-70,-97,27,f6:0a:5c:59:72:df,280143162,476,1436,280142686,280143162
17242,5,12,149,5745,-65,-97,32,76:d6:6a:bb:b3:f5,280143710,468,80,280143242,280143710
17243,5,12,149,5745,-72,-97,25,72:d1:72:1d:22:a1,280145141,480,951,280144661,280145141
17244,5,12,149,5745,-92,-97,5,42:d2:d9:2b:ac:61,280147393,452,1800,280146941,280147393
17245,5,6,149,5745,-87,-97,10,54:e4:3a:ec:fb:65,280150396,360,2643,280150036,280150396
17246,5,12,149,5745,-73,-97,24,72:d1:72:1d:22:a1,280153809,284,3129,280153525,280153809
17247,5,12,149,5745,-91,-97,6,42:d2:d9:2b:ac:61,280154564,256,499,280154308,280154564
17248,5,12,149,5745,-52,-97,45,3e:d1:9b:c7:a4:de,280169962,272,15126,280169690,280169962
17249,5,12,149,5745,-68,-97,29,22:ec:75:a8:8a:31,280171172,244,966,280170928,280171172
17250,5,12,149,5745,-70,-97,27,f2:da:61:dd:98:c5,280171974,272,530,280171702,280171974
17251,5,12,149,5745,-58,-97,39,fa:44:8d:e1:c7:1b,280189569,440,17155,280189129,280189569
17252,5,12,149,5745,-88,-97,9,02:af:71:9e:85:a6,280196309,440,6300,280195869,280196309
17253,5,12,149,5745,-64,-97,33,b6:90:18:f6:b1:d4,280197459,272,878,280197187,280197459
17254,5,12,149,5745,-69,-97,28,d2:00:04:7e:2c:ab,280199099,440,1200,280198659,280199099
17255,5,12,149,5745,-66,-97,31,9e:1f:b0:a7:b8:90,280201377,284,1994,280201093,280201377
17256,5,12,149,5745,-69,-97,28,d2:00:04:7e:2c:ab,280202527,244,906,280202283,280202527
17257,5,12,149,5745,-67,-97,30,a6:92:ad:b7:76:65,280203807,284,996,280203523,280203807
17258,5,12,149,5745,-62,-97,35,3a:de:b0:2e:cd:45,280230684,272,26605,280230412,280230684
17259,5,12,149,5745,-69,-97,28,0a:e1:ab:b3:c3:a6,280231134,272,178,280230862,280231134
17260,5,12,149,5745,-71,-97,26,3e:ef:29:c7:4b:17,280240292,272,8886,280240020,280240292
17261,5,12,149,5745,-63,-97,34,5e:29:73:5b:30:00,280241930,272,1366,280241658,280241930
17262,5,12,149,5745,-89,-97,8,02:af:71:9e:85:a6,280251484,244,9310,280251240,280251484
17263,5,6,149,5745,-86,-97,11,54:e4:3a:ec:fb:65,280252797,360,953,280252437,280252797
17264,5,12,149,5745,-91,-97,6,02:af:71:9e:85:a6,280253384,440,147,280252944,280253384
17265,5,12,149,5745,-55,-97,42,4a:ea:3c:f4:ce:b2,280253878,272,222,280253606,280253878
17266,5,12,149,5745,-62,-97,35,76:d6:6a:bb:b3:f5,280254562,272,412,280254290,280254562
17267,5,12,149,5745,-66,-97,31,f6:0a:5c:59:72:df,280260147,280,5305,280259867,280260147
17268,5,12,149,5745,-68,-97,29,56:68:e2:c2:8d:d5,280265861,280,5434,280265581,280265861
17269,5,12,149,5745,-62,-97,35,fa:44:8d:e1:c7:1b,280266289,244,184,280266045,280266289
17270,5,12,149,5745,-77,-97,20,72:d1:72:1d:22:a1,280282551,284,15978,280282267,280282551
17271,5,12,149,5745,-53,-97,44,3e:d1:9b:c7:a4:de,280285041,272,2218,280284769,280285041
17272,5,12,149,5745,-68,-97,29,22:ec:75:a8:8a:31,280287059,244,1774,280286815,280287059
17273,5,6,149,5745,-89,-97,8,74:a2:e6:10:22:f0,280300700,168,13473,280300532,280300700
17274,5,6,149,5745,-90,-97,7,74:a2:e6:10:22:f0,280308316,132,7484,280308184,280308316
17275,5,12,149,5745,-85,-97,12,9a:24:38:da:96:bb,280312710,272,4122,280312438,280312710
17276,5,12,149,5745,-92,-97,5,02:af:71:9e:85:a6,280330395,440,17245,280329955,280330395
17277,5,12,149,5745,-70,-97,27,0a:e1:ab:b3:c3:a6,280342807,272,12140,280342535,280342807
17278,5,6,149,5745,-86,-97,11,54:e4:3a:ec:fb:65,280355197,360,12030,280354837,280355197
17279,5,12,149,5745,-62,-97,35,3a:de:b0:2e:cd:45,280356017,272,548,280355745,280356017
17280,5,12,149,5745,-68,-97,29,f2:da:61:dd:98:c5,280356402,272,113,280356130,280356402
17281,5,12,149,5745,-63,-97,34,9e:1f:b0:a7:b8:90,280358570,284,1884,280358286,280358570
17282,5,12,149,5745,-61,-97,36,5e:29:73:5b:30:00,280359861,272,1019,280359589,280359861
17283,5,12,149,5745,-58,-97,39,76:d6:6a:bb:b3:f5,280366999,272,6866,280366727,280366999
17284,5,12,149,5745,-69,-97,28,56:68:e2:c2:8d:d5,280375730,280,8451,280375450,280375730
17285,5,12,149,5745,-67,-97,30,a6:92:ad:b7:76:65,280378540,284,2526,280378256,280378540
17286,5,12,149,5745,-59,-97,38,fa:44:8d:e1:c7:1b,280378905,244,121,280378661,280378905
17287,5,12,149,5745,-76,-97,21,d2:00:04:7e:2c:ab,280379750,244,601,280379506,280379750
17288,5,12,149,5745,-67,-97,30,b6:90:18:f6:b1:d4,280380518,268,500,280380250,280380518
17289,5,12,149,5745,-77,-97,20,72:d1:72:1d:22:a1,280392312,284,11510,280392028,280392312
17290,5,12,149,5745,-53,-97,44,3e:d1:9b:c7:a4:de,280402038,272,9454,280401766,280402038
17291,5,12,149,5745,-67,-97,30,22:ec:75:a8:8a:31,280404124,244,1842,280403880,280404124
17292,5,12,149,5745,-83,-97,14,9a:24:38:da:96:bb,280421241,272,16845,280420969,280421241
17293,5,12,149,5745,-72,-97,25,3e:ef:29:c7:4b:17,280433436,272,11923,280433164,280433436
17294,5,12,149,5745,-70,-97,27,0a:e1:ab:b3:c3:a6,280456301,268,22597,280456033,280456301
17295,5,6,149,5745,-86,-97,11,54:e4:3a:ec:fb:65,280457597,360,936,280457237,280457597
17296,5,12,149,5745,-62,-97,35,3a:de:b0:2e:cd:45,280458343,272,474,280458071,280458343
17297,5,12,149,5745,-67,-97,30,f2:da:61:dd:98:c5,280458737,272,122,280458465,280458737
17298,5,12,149,5745,-69,-97,28,9e:1f:b0:a7:b8:90,280460386,284,1365,280460102,280460386
17299,5,24,149,5745,-83,-97,14,,280461175,28,761,280461147,280461175
17300,5,24,149,5745,-82,-97,15,,280461220,28,17,280461192,280461220
17301,5,24,149,5745,-83,-97,14,,280461328,32,76,280461296,280461328
17302,5,12,149,5745,-72,-97,25,3e:ef:29:c7:4b:17,280472589,272,10989,280472317,280472589
17303,5,12,149,5745,-57,-97,40,76:d6:6a:bb:b3:f5,280473244,268,387,280472976,280473244
17304,5,12,149,5745,-62,-97,35,5e:29:73:5b:30:00,280476866,272,3350,280476594,280476866
17305,5,24,149,5745,-84,-97,13,,280479046,28,2152,280479018,280479046
17306,5,24,149,5745,-84,-97,13,,280479090,28,16,280479062,280479090
17307,5,24,149,5745,-83,-97,14,,280479198,32,76,280479166,280479198
17308,5,12,149,5745,-69,-97,28,a6:92:ad:b7:76:65,280480884,284,1402,280480600,280480884
17309,5,12,149,5745,-75,-97,22,d2:00:04:7e:2c:ab,280481901,244,773,280481657,280481901
17310,5,12,149,5745,-67,-97,30,b6:90:18:f6:b1:d4,280482822,268,653,280482554,280482822
17311,5,12,149,5745,-72,-97,25,56:68:e2:c2:8d:d5,280489098,280,5996,280488818,280489098
17312,5,12,149,5745,-63,-97,34,fa:44:8d:e1:c7:1b,280491882,244,2540,280491638,280491882
17313,5,12,149,5745,-91,-97,6,42:d2:d9:2b:ac:61,280495013,256,2875,280494757,280495013
17314,5,12,149,5745,-90,-97,7,02:af:71:9e:85:a6,280499103,244,3846,280498859,280499103
17315,5,12,149,5745,-68,-97,29,f2:da:61:dd:98:c5,280500695,272,1320,280500423,280500695
17316,5,12,149,5745,-72,-97,25,72:d1:72:1d:22:a1,280501199,284,220,280500915,280501199
17317,5,12,149,5745,-67,-97,30,b6:90:18:f6:b1:d4,280513709,268,12242,280513441,280513709
17318,5,12,149,5745,-63,-97,34,fa:44:8d:e1:c7:1b,280517234,440,3085,280516794,280517234
17319,5,12,149,5745,-70,-97,27,0a:e1:ab:b3:c3:a6,280518881,268,1379,280518613,280518881
17320,5,12,149,5745,-57,-97,40,4a:ea:3c:f4:ce:b2,280519220,468,-129,280518752,280519220
17321,5,12,149,5745,-64,-97,33,3a:de:b0:2e:cd:45,280523509,268,4021,280523241,280523509
17322,5,12,149,5745,-67,-97,30,b6:90:18:f6:b1:d4,280524047,268,270,280523779,280524047
17323,5,12,149,5745,-67,-97,30,f2:da:61:dd:98:c5,280526230,468,1715,280525762,280526230
17324,5,12,149,5745,-61,-97,36,fa:44:8d:e1:c7:1b,280526849,160,459,280526689,280526849
17325,5,12,149,5745,-73,-97,24,d2:00:04:7e:2c:ab,280527072,440,-217,280526632,280527072
17326,5,12,149,5745,-61,-97,36,5e:29:73:5b:30:00,280527600,540,-12,280527060,280527600
17327,5,12,149,5745,-72,-97,25,0a:e1:ab:b3:c3:a6,280528257,132,525,280528125,280528257
17328,5,12,149,5745,-69,-97,28,22:ec:75:a8:8a:31,280528828,244,327,280528584,280528828
17329,5,12,149,5745,-59,-97,38,76:d6:6a:bb:b3:f5,280529197,268,101,280528929,280529197
17330,5,12,149,5745,-70,-97,27,56:68:e2:c2:8d:d5,280529527,476,-146,280529051,280529527
17331,5,12,149,5745,-56,-97,41,3e:d1:9b:c7:a4:de,280530082,272,283,280529810,280530082
17332,5,12,149,5745,-67,-97,30,9e:1f:b0:a7:b8:90,280531298,284,932,280531014,280531298
17333,5,12,149,5745,-55,-97,42,3e:d1:9b:c7:a4:de,280532090,544,248,280531546,280532090
17334,5,12,149,5745,-68,-97,29,f6:0a:5c:59:72:df,280537645,476,5079,280537169,280537645
17335,5,12,149,5745,-67,-97,30,9e:1f:b0:a7:b8:90,280538740,480,615,280538260,280538740
17336,5,12,149,5745,-76,-97,21,72:d1:72:1d:22:a1,280540158,480,938,280539678,280540158
17337,5,12,149,5745,-72,-97,25,d2:00:04:7e:2c:ab,280546788,244,6386,280546544,280546788
17338,5,6,149,5745,-87,-97,10,54:e4:3a:ec:fb:65,280559998,360,12850,280559638,280559998
17339,5,12,149,5745,-71,-97,26,0a:e1:ab:b3:c3:a6,280563471,268,3205,280563203,280563471
17340,5,12,149,5745,-65,-97,32,3a:de:b0:2e:cd:45,280563802,268,63,280563534,280563802
17341,5,24,149,5745,-86,-97,11,,280570317,28,6487,280570289,280570317
17342,5,24,149,5745,-84,-97,13,,280570361,28,16,280570333,280570361
17343,5,24,149,5745,-84,-97,13,,280570470,32,77,280570438,280570470
17344,5,12,149,5745,-57,-97,40,4a:ea:3c:f4:ce:b2,280575666,272,4924,280575394,280575666
17345,5,12,149,5745,-61,-97,36,fa:44:8d:e1:c7:1b,280582519,440,6413,280582079,280582519
17346,5,12,149,5745,-64,-97,33,3a:de:b0:2e:cd:45,280583237,268,450,280582969,280583237
17347,5,24,149,5745,-84,-97,13,,280587968,28,4703,280587940,280587968
17348,5,24,149,5745,-86,-97,11,,280588012,28,16,280587984,280588012
17349,5,24,149,5745,-87,-97,10,,280588119,32,75,280588087,280588119
17350,5,12,149,5745,-73,-97,24,d2:00:04:7e:2c:ab,280593055,440,4496,280592615,280593055
17351,5,12,149,5745,-64,-97,33,5e:29:73:5b:30:00,280593884,272,557,280593612,280593884
17352,5,12,149,5745,-63,-97,34,fa:44:8d:e1:c7:1b,280595672,244,1544,280595428,280595672
17353,5,12,149,5745,-59,-97,38,76:d6:6a:bb:b3:f5,280596012,268,72,280595744,280596012
17354,5,12,149,5745,-89,-97,8,42:d2:d9:2b:ac:61,280597002,256,734,280596746,280597002
17355,5,12,149,5745,-69,-97,28,56:68:e2:c2:8d:d5,280599115,280,1833,280598835,280599115
17356,5,12,149,5745,-65,-97,32,f6:0a:5c:59:72:df,280599827,280,432,280599547,280599827
17357,5,12,149,5745,-90,-97,7,42:d2:d9:2b:ac:61,280605512,452,5233,280605060,280605512
17358,5,12,149,5745,-70,-97,27,f2:da:61:dd:98:c5,280621518,272,15734,280621246,280621518
17359,5,12,149,5745,-89,-97,8,02:af:71:9e:85:a6,280630620,244,8858,280630376,280630620
17360,5,12,149,5745,-66,-97,31,22:ec:75:a8:8a:31,280643527,244,12663,280643283,280643527
17361,5,12,149,5745,-90,-97,7,,280644080,32,521,280644048,280644080
17362,5,12,149,5745,-50,-97,47,3e:d1:9b:c7:a4:de,280644877,272,525,280644605,280644877
17363,5,12,149,5745,-64,-97,33,b6:90:18:f6:b1:d4,280645184,268,39,280644916,280645184
17364,5,12,149,5745,-90,-97,7,02:af:71:9e:85:a6,280647825,212,2429,280647613,280647825
17365,5,12,149,5745,-63,-97,34,3a:de:b0:2e:cd:45,280648577,268,484,280648309,280648577
17366,5,12,149,5745,-58,-97,39,4a:ea:3c:f4:ce:b2,280648933,468,-112,280648465,280648933
17367,5,12,149,5745,-70,-97,27,0a:e1:ab:b3:c3:a6,280650247,268,1046,280649979,280650247
17368,5,12,149,5745,-72,-97,25,3e:ef:29:c7:4b:17,280654248,468,3533,280653780,280654248
17369,5,12,149,5745,-67,-97,30,a6:92:ad:b7:76:65,280654858,484,126,280654374,280654858
17370,5,12,149,5745,-71,-97,26,f2:da:61:dd:98:c5,280655376,468,50,280654908,280655376
17371,5,12,149,5745,-64,-97,33,b6:90:18:f6:b1:d4,280656616,268,972,280656348,280656616
17372,5,12,149,5745,-61,-97,36,0a:b9:b7:b1:4d:fa,280658367,468,1283,280657899,280658367
17373,5,12,149,5745,-66,-97,31,9e:1f:b0:a7:b8:90,280658913,284,262,280658629,280658913
17374,5,12,149,5745,-58,-97,39,76:d6:6a:bb:b3:f5,280659233,268,52,280658965,280659233
17375,5,12,149,5745,-64,-97,33,5e:29:73:5b:30:00,280660811,540,1038,280660271,280660811
17376,5,12,149,5745,-71,-97,26,d2:00:04:7e:2c:ab,280661422,244,367,280661178,280661422
17377,5,12,149,5745,-66,-97,31,22:ec:75:a8:8a:31,280662232,516,294,280661716,280662232
17378,5,12,149,5745,-51,-97,46,3e:d1:9b:c7:a4:de,280662791,544,15,280662247,280662791
17379,5,6,149,5745,-87,-97,10,54:e4:3a:ec:fb:65,280663367,360,216,280663007,280663367
17380,5,12,149,5745,-91,-97,6,02:af:71:9e:85:a6,280669381,440,5574,280668941,280669381
17381,5,12,149,5745,-68,-97,29,0a:e1:ab:b3:c3:a6,280677582,268,7933,280677314,280677582
17382,5,12,149,5745,-63,-97,34,3a:de:b0:2e:cd:45,280677984,268,134,280677716,280677984
17383,5,12,149,5745,-64,-97,33,fa:44:8d:e1:c7:1b,280681356,440,2932,280680916,280681356
17384,5,12,149,5745,-87,-97,10,9a:24:38:da:96:bb,280685981,272,4353,280685709,280685981
17385,5,12,149,5745,-73,-97,24,72:d1:72:1d:22:a1,280687059,284,794,280686775,280687059
17386,5,12,149,5745,-57,-97,40,4a:ea:3c:f4:ce:b2,280687647,272,316,280687375,280687647
17387,5,12,149,5745,-59,-97,38,76:d6:6a:bb:b3:f5,280692876,268,4961,280692608,280692876
17388,5,12,149,5745,-71,-97,26,3e:ef:29:c7:4b:17,280693205,272,57,280692933,280693205
17389,5,12,149,5745,-65,-97,32,5e:29:73:5b:30:00,280706695,272,13218,280706423,280706695
17390,5,12,149,5745,-68,-97,29,f6:0a:5c:59:72:df,280713095,280,6120,280712815,280713095
17391,5,12,149,5745,-72,-97,25,d2:00:04:7e:2c:ab,280723980,440,10445,280723540,280723980
17392,5,12,149,5745,-67,-97,30,fa:44:8d:e1:c7:1b,280724474,244,250,280724230,280724474
17393,5,12,149,5745,-91,-97,6,42:d2:d9:2b:ac:61,280727019,256,2289,280726763,280727019
17394,5,12,149,5745,-69,-97,28,f2:da:61:dd:98:c5,280734814,272,7523,280734542,280734814
17395,5,12,149,5745,-50,-97,47,3e:d1:9b:c7:a4:de,280746382,272,11296,280746110,280746382
17396,5,12,149,5745,-67,-97,30,22:ec:75:a8:8a:31,280746978,244,352,280746734,280746978
17397,5,6,149,5745,-87,-97,10,54:e4:3a:ec:fb:65,280752896,352,5566,280752544,280752896
17398,5,12,149,5745,-62,-97,35,b6:90:18:f6:b1:d4,280754598,268,1434,280754330,280754598
17399,5,6,149,5745,-86,-97,11,54:e4:3a:ec:fb:65,280763159,352,8209,280762807,280763159
17400,5,6,149,5745,-87,-97,10,54:e4:3a:ec:fb:65,280764799,360,1280,280764439,280764799
17401,5,12,149,5745,-69,-97,28,9e:1f:b0:a7:b8:90,280776400,284,11317,280776116,280776400
17402,5,12,149,5745,-73,-97,24,d2:00:04:7e:2c:ab,280787379,244,10735,280787135,280787379
17403,5,12,149,5745,-72,-97,25,72:d1:72:1d:22:a1,280789665,284,2002,280789381,280789665
17404,5,12,149,5745,-74,-97,23,56:68:e2:c2:8d:d5,280791387,280,1442,280791107,280791387
17405,5,24,149,5745,-86,-97,11,,280806846,32,15427,280806814,280806846
17406,5,24,149,5745,-86,-97,11,,280807330,32,452,280807298,280807330
17407,5,12,149,5745,-60,-97,37,5e:29:73:5b:30:00,280822716,272,15114,280822444,280822716
17408,5,24,149,5745,-86,-97,11,,280823961,28,1217,280823933,280823961
17409,5,24,149,5745,-85,-97,12,,280830632,32,6639,280830600,280830632
17410,5,12,149,5745,-86,-97,11,02:af:71:9e:85:a6,280831183,244,307,280830939,280831183
17411,5,24,149,5745,-86,-97,11,,280832063,32,848,280832031,280832063
17412,5,24,149,5745,-86,-97,11,,280832598,28,507,280832570,280832598
17413,5,12,149,5745,-72,-97,25,3e:ef:29:c7:4b:17,280843296,272,10426,280843024,280843296
17414,5,12,149,5745,-70,-97,27,0a:e1:ab:b3:c3:a6,280861814,268,18250,280861546,280861814
17415,5,12,149,5745,-52,-97,45,3e:d1:9b:c7:a4:de,280863412,272,1326,280863140,280863412
17416,5,12,149,5745,-66,-97,31,22:ec:75:a8:8a:31,280863707,244,51,280863463,280863707
17417,5,6,149,5745,-86,-97,11,54:e4:3a:ec:fb:65,280867200,360,3133,280866840,280867200
17418,5,24,149,5745,-86,-97,11,,280867795,32,563,280867763,280867795
17419,5,24,149,5745,-84,-97,13,,280867913,32,86,280867881,280867913
17420,5,12,149,5745,-57,-97,40,3a:de:b0:2e:cd:45,280868101,268,-80,280867833,280868101
17421,5,12,149,5745,-72,-97,25,f2:da:61:dd:98:c5,280868628,272,255,280868356,280868628
17422,5,12,149,5745,-63,-97,34,76:d6:6a:bb:b3:f5,280869523,268,627,280869255,280869523
17423,5,12,149,5745,-88,-97,9,02:af:71:9e:85:a6,280876649,440,6686,280876209,280876649
17424,5,6,149,5745,-67,-97,30,,280877783,52,1082,280877731,280877783
17425,5,6,149,5745,-85,-97,12,,280877851,44,24,280877807,280877851
17426,5,24,149,5745,-84,-97,13,,280877968,28,89,280877940,280877968
17427,5,12,149,5745,-65,-97,32,9e:1f:b0:a7:b8:90,280884369,284,6117,280884085,280884369
17428,5,12,149,5745,-65,-97,32,b6:90:18:f6:b1:d4,280891704,268,7067,280891436,280891704
17429,5,12,149,5745,-68,-97,29,fa:44:8d:e1:c7:1b,280892107,244,159,280891863,280892107
17430,5,12,149,5745,-71,-97,26,72:d1:72:1d:22:a1,280892425,284,34,280892141,280892425
17431,5,12,149,5745,-74,-97,23,d2:00:04:7e:2c:ab,280892779,244,110,280892535,280892779
17432,5,12,149,5745,-73,-97,24,56:68:e2:c2:8d:d5,280893921,280,862,280893641,280893921
17433,5,12,149,5745,-87,-97,10,42:d2:d9:2b:ac:61,280904190,256,10013,280903934,280904190
17434,5,12,149,5745,-84,-97,13,9a:24:38:da:96:bb,280915803,272,11341,280915531,280915803
17435,5,6,149,5745,-67,-97,30,,280924707,52,8852,280924655,280924707
17436,5,6,149,5745,-83,-97,14,,280924775,44,24,280924731,280924775
17437,5,24,149,5745,-83,-97,14,,280924892,28,89,280924864,280924892
17438,5,12,149,5745,-55,-97,42,4a:ea:3c:f4:ce:b2,280928228,268,3068,280927960,280928228
17439,5,12,149,5745,-61,-97,36,5e:29:73:5b:30:00,280939685,272,11185,280939413,280939685
17440,5,24,149,5745,-83,-97,14,,280944802,32,5085,280944770,280944802
17441,5,24,149,5745,-82,-97,15,,280945257,32,423,280945225,280945257
17442,5,12,149,5745,-70,-97,27,3e:ef:29:c7:4b:17,280945701,272,172,280945429,280945701
17443,5,24,149,5745,-83,-97,14,,280946088,28,359,280946060,280946088
17444,5,12,149,5745,-70,-97,27,0a:e1:ab:b3:c3:a6,280964075,268,17719,280963807,280964075
17445,5,12,149,5745,-61,-97,36,76:d6:6a:bb:b3:f5,280969810,268,5467,280969542,280969810
17446,5,12,149,5745,-70,-97,27,f2:da:61:dd:98:c5,280970545,272,463,280970273,280970545
17447,5,12,149,5745,-60,-97,37,3a:de:b0:2e:cd:45,280972457,268,1644,280972189,280972457
17448,5,12,149,5745,-53,-97,44,3e:d1:9b:c7:a4:de,280978377,272,5648,280978105,280978377
17449,5,12,149,5745,-68,-97,29,22:ec:75:a8:8a:31,280980713,244,2092,280980469,280980713
17450,5,12,149,5745,-67,-97,30,fa:44:8d:e1:c7:1b,280993212,244,12255,280992968,280993212
17451,5,12,149,5745,-65,-97,32,b6:90:18:f6:b1:d4,280994133,268,653,280993865,280994133
17452,5,12,149,5745,-78,-97,19,72:d1:72:1d:22:a1,280994617,284,200,280994333,280994617
17453,5,12,149,5745,-74,-97,23,56:68:e2:c2:8d:d5,280995248,280,351,280994968,280995248
17454,5,6,149,5745,-69,-97,28,,281000015,52,4715,280999963,281000015
17455,5,6,149,5745,-83,-97,14,,281000084,44,25,281000040,281000084
17456,5,24,149,5745,-83,-97,14,,281000201,28,89,281000173,281000201
17457,5,12,149,5745,-75,-97,22,d2:00:04:7e:2c:ab,281005593,244,5148,281005349,281005593
17458,5,12,149,5745,-90,-97,7,42:d2:d9:2b:ac:61,281006649,256,800,281006393,281006649
17459,5,12,149,5745,-71,-97,26,3e:ef:29:c7:4b:17,281046931,272,40010,281046659,281046931
17460,5,12,149,5745,-53,-97,44,4a:ea:3c:f4:ce:b2,281048247,268,1048,281047979,281048247
17461,5,12,149,5745,-74,-97,23,56:68:e2:c2:8d:d5,281050241,280,1714,281049961,281050241
17462,5,12,149,5745,-62,-97,35,5e:29:73:5b:30:00,281051572,272,1059,281051300,281051572
17463,5,6,149,5745,-70,-97,27,,281061483,52,9859,281061431,281061483
17464,5,6,149,5745,-83,-97,14,,281061551,44,24,281061507,281061551
17465,5,24,149,5745,-84,-97,13,,281061668,28,89,281061640,281061668
17466,5,12,149,5745,-67,-97,30,fa:44:8d:e1:c7:1b,281064285,244,2373,281064041,281064285
17467,5,12,149,5745,-91,-97,6,42:d2:d9:2b:ac:61,281066320,256,1779,281066064,281066320
17468,5,12,149,5745,-71,-97,26,0a:e1:ab:b3:c3:a6,281066754,268,166,281066486,281066754
17469,5,12,149,5745,-76,-97,21,72:d1:72:1d:22:a1,281071590,284,4552,281071306,281071590
17470,5,12,149,5745,-60,-97,37,3a:de:b0:2e:cd:45,281072229,268,371,281071961,281072229
17471,5,12,149,5745,-61,-97,36,76:d6:6a:bb:b3:f5,281072770,268,273,281072502,281072770
17472,5,12,149,5745,-67,-97,30,9e:1f:b0:a7:b8:90,281073133,284,79,281072849,281073133
17473,5,12,149,5745,-62,-97,35,76:d6:6a:bb:b3:f5,281087152,132,13887,281087020,281087152
17474,5,12,149,5745,-71,-97,26,0a:e1:ab:b3:c3:a6,281088427,132,1143,281088295,281088427
17475,5,12,149,5745,-66,-97,31,b6:90:18:f6:b1:d4,281089061,268,366,281088793,281089061
17476,5,12,149,5745,-74,-97,23,d2:00:04:7e:2c:ab,281091090,380,1649,281090710,281091090
17477,5,12,149,5745,-65,-97,32,22:ec:75:a8:8a:31,281102364,244,11030,281102120,281102364
17478,5,12,149,5745,-55,-97,42,3e:d1:9b:c7:a4:de,281103174,272,538,281102902,281103174
17479,5,12,149,5745,-67,-97,30,9e:1f:b0:a7:b8:90,281104345,284,887,281104061,281104345
17480,5,12,149,5745,-74,-97,23,d2:00:04:7e:2c:ab,281104974,244,385,281104730,281104974
17481,5,12,149,5745,-70,-97,27,0a:e1:ab:b3:c3:a6,281107283,268,2041,281107015,281107283
17482,5,12,149,5745,-60,-97,37,3a:de:b0:2e:cd:45,281107711,268,160,281107443,281107711
17483,5,12,149,5745,-71,-97,26,3e:ef:29:c7:4b:17,281112945,468,4766,281112477,281112945
17484,5,12,149,5745,-69,-97,28,f2:da:61:dd:98:c5,281114391,468,978,281113923,281114391
17485,5,12,149,5745,-66,-97,31,b6:90:18:f6:b1:d4,281115577,268,918,281115309,281115577
17486,5,12,149,5745,-64,-97,33,5e:29:73:5b:30:00,281116765,540,648,281116225,281116765
17487,5,12,149,5745,-61,-97,36,76:d6:6a:bb:b3:f5,281117431,268,398,281117163,281117431
17488,5,12,149,5745,-73,-97,24,d2:00:04:7e:2c:ab,281118594,440,723,281118154,281118594
17489,5,12,149,5745,-66,-97,31,22:ec:75:a8:8a:31,281119086,516,-24,281118570,281119086
17490,5,12,149,5745,-70,-97,27,0a:e1:ab:b3:c3:a6,281119853,268,499,281119585,281119853
17491,5,12,149,5745,-54,-97,43,3e:d1:9b:c7:a4:de,281120281,544,-116,281119737,281120281
17492,5,12,149,5745,-60,-97,37,3a:de:b0:2e:cd:45,281120888,268,339,281120620,281120888
17493,5,12,149,5745,-74,-97,23,56:68:e2:c2:8d:d5,281121316,476,-48,281120840,281121316
17494,5,12,149,5745,-67,-97,30,fa:44:8d:e1:c7:1b,281122381,440,625,281121941,281122381
17495,5,12,149,5745,-67,-97,30,9e:1f:b0:a7:b8:90,281123791,480,930,281123311,281123791
17496,5,12,149,5745,-53,-97,44,4a:ea:3c:f4:ce:b2,281126295,268,2236,281126027,281126295
17497,5,12,149,5745,-68,-97,29,f6:0a:5c:59:72:df,281126902,476,131,281126426,281126902
17498,5,12,149,5745,-74,-97,23,72:d1:72:1d:22:a1,281127923,480,541,281127443,281127923
17499,5,12,149,5745,-88,-97,9,42:d2:d9:2b:ac:61,281129976,452,1601,281129524,281129976
17500,5,12,149,5745,-86,-97,11,9a:24:38:da:96:bb,281135332,272,5084,281135060,281135332
17501,5,12,149,5745,-53,-97,44,4a:ea:3c:f4:ce:b2,281138391,268,2791,281138123,281138391
17502,5,12,149,5745,-62,-97,35,76:d6:6a:bb:b3:f5,281151607,268,12948,281151339,281151607
17503,5,12,149,5745,-70,-97,27,3e:ef:29:c7:4b:17,281151945,272,66,281151673,281151945
17504,5,12,149,5745,-74,-97,23,56:68:e2:c2:8d:d5,281153413,280,1188,281153133,281153413
17505,5,12,149,5745,-68,-97,29,f6:0a:5c:59:72:df,281154060,280,367,281153780,281154060
17506,5,12,149,5745,-65,-97,32,fa:44:8d:e1:c7:1b,281169090,244,14786,281168846,281169090
17507,5,12,149,5745,-73,-97,24,72:d1:72:1d:22:a1,281169565,284,191,281169281,281169565
17508,5,12,149,5745,-66,-97,31,5e:29:73:5b:30:00,281170124,272,287,281169852,281170124
17509,5,12,149,5745,-68,-97,29,f2:da:61:dd:98:c5,281170594,272,198,281170322,281170594
17510,5,12,149,5745,-70,-97,27,0a:e1:ab:b3:c3:a6,281172513,268,1651,281172245,281172513
17511,5,12,149,5745,-61,-97,36,3a:de:b0:2e:cd:45,281173049,268,268,281172781,281173049
17512,5,12,149,5745,-61,-97,36,3a:de:b0:2e:cd:45,281174098,152,897,281173946,281174098
17513,5,6,149,5745,-88,-97,9,54:e4:3a:ec:fb:65,281174401,360,-57,281174041,281174401
17514,5,12,149,5745,-89,-97,8,42:d2:d9:2b:ac:61,281175336,360,575,281174976,281175336
17515,5,12,149,5745,-89,-97,8,42:d2:d9:2b:ac:61,281176550,452,762,281176098,281176550
17516,5,12,149,5745,-70,-97,27,3e:ef:29:c7:4b:17,281177598,468,580,281177130,281177598
17517,5,12,149,5745,-93,-97,4,7e:05:42:11:d2:ec,281179457,440,1419,281179017,281179457
17518,5,12,149,5745,-68,-97,29,a6:92:ad:b7:76:65,281179931,484,-10,281179447,281179931
17519,5,12,149,5745,-68,-97,29,f2:da:61:dd:98:c5,281180449,468,50,281179981,281180449
17520,5,12,149,5745,-62,-97,35,76:d6:6a:bb:b3:f5,281181996,132,1415,281181864,281181996
17521,5,12,149,5745,-62,-97,35,76:d6:6a:bb:b3:f5,281182180,268,-84,281181912,281182180
17522,5,12,149,5745,-66,-97,31,5e:29:73:5b:30:00,281182482,540,-238,281181942,281182482
17523,5,12,149,5745,-73,-97,24,d2:00:04:7e:2c:ab,281183111,440,189,281182671,281183111
17524,5,12,149,5745,-54,-97,43,4a:ea:3c:f4:ce:b2,281183630,132,387,281183498,281183630
17525,5,12,149,5745,-66,-97,31,22:ec:75:a8:8a:31,281183833,516,-313,281183317,281183833
17526,5,12,149,5745,-69,-97,28,aa:b6:ae:27:64:4e,281184384,268,283,281184116,281184384
17527,5,12,149,5745,-75,-97,22,56:68:e2:c2:8d:d5,281184695,476,-165,281184219,281184695
17528,5,12,149,5745,-53,-97,44,3e:d1:9b:c7:a4:de,281186195,544,956,281185651,281186195
17529,5,12,149,5745,-73,-97,24,d2:00:04:7e:2c:ab,281188214,104,1915,281188110,281188214
17530,5,12,149,5745,-73,-97,24,d2:00:04:7e:2c:ab,281188363,380,-231,281187983,281188363
17531,5,12,149,5745,-65,-97,32,fa:44:8d:e1:c7:1b,281188824,440,21,281188384,281188824
17532,5,12,149,5745,-67,-97,30,9e:1f:b0:a7:b8:90,281189933,480,629,281189453,281189933
17533,5,12,149,5745,-54,-97,43,4a:ea:3c:f4:ce:b2,281190907,268,706,281190639,281190907
17534,5,12,149,5745,-70,-97,27,f6:0a:5c:59:72:df,281191298,476,-85,281190822,281191298
17535,5,12,149,5745,-73,-97,24,72:d1:72:1d:22:a1,281194099,480,2321,281193619,281194099
17536,5,12,149,5745,-65,-97,32,b6:90:18:f6:b1:d4,281201595,268,7228,281201327,281201595
17537,5,12,149,5745,-66,-97,31,22:ec:75:a8:8a:31,281217791,244,15952,281217547,281217791
17538,5,12,149,5745,-53,-97,44,3e:d1:9b:c7:a4:de,281218592,272,529,281218320,281218592
17539,5,12,149,5745,-73,-97,24,d2:00:04:7e:2c:ab,281219384,244,548,281219140,281219384
17540,5,12,149,5745,-67,-97,30,9e:1f:b0:a7:b8:90,281219815,284,147,281219531,281219815
17541,5,12,149,5745,-73,-97,24,d2:00:04:7e:2c:ab,281247900,440,27645,281247460,281247900
17542,5,12,149,5745,-71,-97,26,0a:e1:ab:b3:c3:a6,281249315,268,1147,281249047,281249315
17543,5,12,149,5745,-60,-97,37,3a:de:b0:2e:cd:45,281252451,268,2868,281252183,281252451
17544,5,12,149,5745,-74,-97,23,56:68:e2:c2:8d:d5,281276415,280,23684,281276135,281276415
17545,5,6,149,5745,-88,-97,9,54:e4:3a:ec:fb:65,281276802,360,27,281276442,281276802
17546,5,12,149,5745,-64,-97,33,76:d6:6a:bb:b3:f5,281281323,268,4253,281281055,281281323
17547,5,12,149,5745,-66,-97,31,fa:44:8d:e1:c7:1b,281290689,244,9122,281290445,281290689
17548,5,12,149,5745,-89,-97,8,42:d2:d9:2b:ac:61,281291714,256,769,281291458,281291714
17549,5,12,149,5745,-74,-97,23,72:d1:72:1d:22:a1,281297479,284,5481,281297195,281297479
17550,5,12,149,5745,-64,-97,33,b6:90:18:f6:b1:d4,281313234,268,15487,281312966,281313234
17551,5,12,149,5745,-54,-97,43,3e:d1:9b:c7:a4:de,281320939,272,7433,281320667,281320939
17552,5,12,149,5745,-65,-97,32,22:ec:75:a8:8a:31,281322292,244,1109,281322048,281322292
17553,5,12,149,5745,-73,-97,24,d2:00:04:7e:2c:ab,281344031,244,21495,281343787,281344031
17554,5,12,149,5745,-86,-97,11,02:af:71:9e:85:a6,281351099,244,6824,281350855,281351099
17555,5,12,149,5745,-71,-97,26,3e:ef:29:c7:4b:17,281354819,272,3448,281354547,281354819
17556,5,12,149,5745,-84,-97,13,9a:24:38:da:96:bb,281370120,272,15029,281369848,281370120
17557,5,12,149,5745,-70,-97,27,0a:e1:ab:b3:c3:a6,281373702,268,3314,281373434,281373702
17558,5,12,149,5745,-89,-97,8,7e:05:42:11:d2:ec,281376088,440,1946,281375648,281376088
17559,5,12,149,5745,-60,-97,37,4a:ea:3c:f4:ce:b2,281377181,268,825,281376913,281377181
17560,5,6,149,5745,-86,-97,11,54:e4:3a:ec:fb:65,281379203,360,1662,281378843,281379203
17561,5,12,149,5745,-58,-97,39,3a:de:b0:2e:cd:45,281379814,268,343,281379546,281379814
17562,5,12,149,5745,-69,-97,28,f2:da:61:dd:98:c5,281380177,272,91,281379905,281380177
17563,5,12,149,5745,-64,-97,33,9e:1f:b0:a7:b8:90,281381088,284,627,281380804,281381088
17564,5,12,149,5745,-87,-97,10,02:af:71:9e:85:a6,281382022,244,690,281381778,281382022
17565,5,12,149,5745,-86,-97,11,02:af:71:9e:85:a6,281386900,440,4438,281386460,281386900
17566,5,12,149,5745,-62,-97,35,76:d6:6a:bb:b3:f5,281391723,268,4555,281391455,281391723
17567,5,12,149,5745,-63,-97,34,5e:29:73:5b:30:00,281399309,272,7314,281399037,281399309
17568,5,12,149,5745,-66,-97,31,fa:44:8d:e1:c7:1b,281404266,244,4713,281404022,281404266
17569,5,12,149,5745,-74,-97,23,56:68:e2:c2:8d:d5,281405903,280,1357,281405623,281405903
17570,5,12,149,5745,-75,-97,22,72:d1:72:1d:22:a1,281409603,284,3416,281409319,281409603
17571,5,12,149,5745,-89,-97,8,42:d2:d9:2b:ac:61,281417373,256,7514,281417117,281417373
17572,5,12,149,5745,-53,-97,44,3e:d1:9b:c7:a4:de,281437929,272,20284,281437657,281437929
17573,5,12,149,5745,-68,-97,29,22:ec:75:a8:8a:31,281439246,244,1073,281439002,281439246
17574,5,12,149,5745,-72,-97,25,3e:ef:29:c7:4b:17,281457451,272,17933,281457179,281457451
17575,5,12,149,5745,-82,-97,15,9a:24:38:da:96:bb,281472402,272,14679,281472130,281472402
17576,5,12,149,5745,-68,-97,29,0a:e1:ab:b3:c3:a6,281476091,268,3421,281475823,281476091
17577,5,6,149,5745,-84,-97,13,54:e4:3a:ec:fb:65,281481603,360,5152,281481243,281481603
17578,5,12,149,5745,-67,-97,30,9e:1f:b0:a7:b8:90,281481999,284,112,281481715,281481999
17579,5,12,149,5745,-67,-97,30,f2:da:61:dd:98:c5,281482323,272,52,281482051,281482323
17580,5,12,149,5745,-58,-97,39,3a:de:b0:2e:cd:45,281482737,268,146,281482469,281482737
17581,5,12,149,5745,-72,-97,25,3e:ef:29:c7:4b:17,281505159,272,22150,281504887,281505159
17582,5,12,149,5745,-66,-97,31,b6:90:18:f6:b1:d4,281506027,268,600,281505759,281506027
17583,5,12,149,5745,-76,-97,21,d2:00:04:7e:2c:ab,281506464,244,193,281506220,281506464
17584,5,12,149,5745,-73,-97,24,56:68:e2:c2:8d:d5,281507210,280,466,281506930,281507210
17585,5,12,149,5745,-68,-97,29,f6:0a:5c:59:72:df,281511627,280,4137,281511347,281511627
17586,5,12,149,5745,-60,-97,37,76:d6:6a:bb:b3:f5,281513724,268,1829,281513456,281513724
17587,5,12,149,5745,-62,-97,35,5e:29:73:5b:30:00,281517312,272,3316,281517040,281517312
17588,5,12,149,5745,-66,-97,31,fa:44:8d:e1:c7:1b,281518047,244,491,281517803,281518047
17589,5,12,149,5745,-73,-97,24,72:d1:72:1d:22:a1,281518327,284,-4,281518043,281518327
17590,5,12,149,5745,-90,-97,7,42:d2:d9:2b:ac:61,281519742,256,1159,281519486,281519742
17591,5,12,149,5745,-65,-97,32,f2:da:61:dd:98:c5,281523767,272,3753,281523495,281523767
17592,5,12,149,5745,-65,-97,32,b6:90:18:f6:b1:d4,281548421,268,24386,281548153,281548421
17593,5,12,149,5745,-67,-97,30,22:ec:75:a8:8a:31,281561016,244,12351,281560772,281561016
17594,5,12,149,5745,-52,-97,45,3e:d1:9b:c7:a4:de,281561915,272,627,281561643,281561915
17595,5,12,149,5745,-69,-97,28,9e:1f:b0:a7:b8:90,281562997,284,798,281562713,281562997
17596,5,12,149,5745,-69,-97,28,0a:e1:ab:b3:c3:a6,281567340,268,4075,281567072,281567340
17597,5,12,149,5745,-57,-97,40,3a:de:b0:2e:cd:45,281567775,268,167,281567507,281567775
17598,5,12,149,5745,-91,-97,6,42:d2:d9:2b:ac:61,281572389,360,4254,281572029,281572389
17599,5,12,149,5745,-92,-97,5,42:d2:d9:2b:ac:61,281573468,452,627,281573016,281573468
17600,5,12,149,5745,-72,-97,25,3e:ef:29:c7:4b:17,281573954,468,18,281573486,281573954
17601,5,12,149,5745,-65,-97,32,b6:90:18:f6:b1:d4,281574539,268,317,281574271,281574539
17602,5,12,149,5745,-59,-97,38,76:d6:6a:bb:b3:f5,281576391,268,1584,281576123,281576391
17603,5,12,149,5745,-69,-97,28,0a:e1:ab:b3:c3:a6,281578601,268,1942,281578333,281578601
17604,5,12,149,5745,-61,-97,36,5e:29:73:5b:30:00,281578921,540,-220,281578381,281578921
17605,5,12,149,5745,-56,-97,41,3a:de:b0:2e:cd:45,281579583,268,394,281579315,281579583
17606,5,12,149,5745,-73,-97,24,56:68:e2:c2:8d:d5,281580817,476,758,281580341,281580817
17607,5,12,149,5745,-52,-97,45,3e:d1:9b:c7:a4:de,281581444,544,83,281580900,281581444
17608,5,12,149,5745,-88,-97,9,02:af:71:9e:85:a6,281582049,440,165,281581609,281582049
17609,5,12,149,5745,-85,-97,12,9a:24:38:da:96:bb,281583318,272,997,281583046,281583318
17610,5,12,149,5745,-68,-97,29,f6:0a:5c:59:72:df,281584298,476,504,281583822,281584298
17611,5,12,149,5745,-56,-97,41,4a:ea:3c:f4:ce:b2,281585977,268,1411,281585709,281585977
17612,5,12,149,5745,-56,-97,41,4a:ea:3c:f4:ce:b2,281586361,268,116,281586093,281586361
17613,5,12,149,5745,-67,-97,30,9e:1f:b0:a7:b8:90,281586664,480,-177,281586184,281586664
17614,5,24,149,5745,-85,-97,12,,281588687,32,1991,281588655,281588687
17615,5,12,149,5745,-73,-97,24,72:d1:72:1d:22:a1,281588907,480,-260,281588427,281588907
17616,5,12,149,5745,-73,-97,24,56:68:e2:c2:8d:d5,281595211,280,6024,281594931,281595211
17617,5,12,149,5745,-56,-97,41,4a:ea:3c:f4:ce:b2,281598740,268,3261,281598472,281598740
17618,5,12,149,5745,-69,-97,28,f6:0a:5c:59:72:df,281610031,280,11011,281609751,281610031
17619,5,12,149,5745,-59,-97,38,76:d6:6a:bb:b3:f5,281610410,268,111,281610142,281610410
17620,5,12,149,5745,-61,-97,36,5e:29:73:5b:30:00,281631158,272,20476,281630886,281631158
17621,5,12,149,5745,-57,-97,40,3a:de:b0:2e:cd:45,281631627,268,201,281631359,281631627
17622,5,12,149,5745,-72,-97,25,72:d1:72:1d:22:a1,281639618,284,7707,281639334,281639618
17623,5,12,149,5745,-88,-97,9,02:af:71:9e:85:a6,281640159,440,101,281639719,281640159
17624,5,12,149,5745,-89,-97,8,42:d2:d9:2b:ac:61,281641251,256,836,281640995,281641251
17625,5,12,149,5745,-55,-97,42,4a:ea:3c:f4:ce:b2,281648346,268,6827,281648078,281648346
17626,5,12,149,5745,-90,-97,7,7e:05:42:11:d2:ec,281652669,440,3883,281652229,281652669
17627,5,12,149,5745,-66,-97,31,b6:90:18:f6:b1:d4,281656787,268,3850,281656519,281656787
17628,5,12,149,5745,-53,-97,44,3e:d1:9b:c7:a4:de,281666882,272,9823,281666610,281666882
17629,5,12,149,5745,-66,-97,31,22:ec:75:a8:8a:31,281668296,244,1170,281668052,281668296
17630,5,12,149,5745,-90,-97,7,7e:05:42:11:d2:ec,281678527,244,9987,281678283,281678527
17631,5,6,149,5745,-85,-97,12,54:e4:3a:ec:fb:65,281686404,360,7517,281686044,281686404
17632,5,12,149,5745,-62,-97,35,9e:1f:b0:a7:b8:90,281690993,284,4305,281690709,281690993
17633,5,12,149,5745,-68,-97,29,0a:e1:ab:b3:c3:a6,281693374,268,2113,281693106,281693374
17634,5,12,149,5745,-58,-97,39,3a:de:b0:2e:cd:45,281693739,268,97,281693471,281693739
17635,5,12,149,5745,-89,-97,8,9a:24:38:da:96:bb,281695124,272,1113,281694852,281695124
17636,5,12,149,5745,-58,-97,39,3a:de:b0:2e:cd:45,281697147,268,1755,281696879,281697147
17637,5,12,149,5745,-64,-97,33,f2:da:61:dd:98:c5,281697800,468,185,281697332,281697800
17638,5,12,149,5745,-68,-97,29,0a:e1:ab:b3:c3:a6,281698465,268,397,281698197,281698465
17639,5,12,149,5745,-56,-97,41,4a:ea:3c:f4:ce:b2,281698813,268,80,281698545,281698813
17640,5,12,149,5745,-65,-97,32,22:ec:75:a8:8a:31,281700330,516,1001,281699814,281700330
17641,5,12,149,5745,-71,-97,26,3e:ef:29:c7:4b:17,281702493,468,1695,281702025,281702493
17642,5,12,149,5745,-68,-97,29,a6:92:ad:b7:76:65,281703670,484,693,281703186,281703670
17643,5,12,149,5745,-65,-97,32,b6:90:18:f6:b1:d4,281704216,268,278,281703948,281704216
17644,5,12,149,5745,-87,-97,10,02:af:71:9e:85:a6,281704593,440,-63,281704153,281704593
17645,5,12,149,5745,-58,-97,39,0a:b9:b7:b1:4d:fa,281706957,468,1896,281706489,281706957
17646,5,12,149,5745,-58,-97,39,76:d6:6a:bb:b3:f5,281707470,268,245,281707202,281707470
17647,5,12,149,5745,-61,-97,36,5e:29:73:5b:30:00,281708267,540,257,281707727,281708267
17648,5,12,149,5745,-69,-97,28,aa:b6:ae:27:64:4e,281710977,268,2442,281710709,281710977
17649,5,12,149,5745,-74,-97,23,d2:00:04:7e:2c:ab,281712533,440,1116,281712093,281712533
17650,5,12,149,5745,-54,-97,43,3e:d1:9b:c7:a4:de,281713006,544,-71,281712462,281713006
17651,5,12,149,5745,-56,-97,41,4a:ea:3c:f4:ce:b2,281714101,268,827,281713833,281714101
17652,5,12,149,5745,-58,-97,39,76:d6:6a:bb:b3:f5,281724580,268,10211,281724312,281724580
17653,5,12,149,5745,-70,-97,27,3e:ef:29:c7:4b:17,281724909,272,57,281724637,281724909
17654,5,12,149,5745,-71,-97,26,56:68:e2:c2:8d:d5,281725366,280,177,281725086,281725366
17655,5,12,149,5745,-61,-97,36,5e:29:73:5b:30:00,281744470,272,18832,281744198,281744470
17656,5,12,149,5745,-64,-97,33,b6:90:18:f6:b1:d4,281758677,268,13939,281758409,281758677
17657,5,12,149,5745,-88,-97,9,02:af:71:9e:85:a6,281775311,440,16194,281774871,281775311
17658,5,12,149,5745,-55,-97,42,3e:d1:9b:c7:a4:de,281781932,272,6349,281781660,281781932
17659,5,12,149,5745,-64,-97,33,b6:90:18:f6:b1:d4,281782267,268,67,281781999,281782267
17660,5,12,149,5745,-66,-97,31,22:ec:75:a8:8a:31,281784793,244,2282,281784549,281784793
17661,5,6,149,5745,-89,-97,8,54:e4:3a:ec:fb:65,281788804,360,3651,281788444,281788804
17662,5,12,149,5745,-63,-97,34,9e:1f:b0:a7:b8:90,281802798,284,13710,281802514,281802798
17663,5,24,149,5745,-84,-97,13,,281805758,32,2928,281805726,281805758
17664,5,12,149,5745,-90,-97,7,7e:05:42:11:d2:ec,281806175,244,173,281805931,281806175
17665,5,12,149,5745,-88,-97,9,9a:24:38:da:96:bb,281807984,272,1537,281807712,281807984
17666,5,12,149,5745,-70,-97,27,72:d1:72:1d:22:a1,281813525,284,5257,281813241,281813525
17667,5,12,149,5745,-56,-97,41,4a:ea:3c:f4:ce:b2,281825255,268,11462,281824987,281825255
17668,5,24,149,5745,-84,-97,13,,281826610,32,1323,281826578,281826610
17669,5,24,149,5745,-84,-97,13,,281826978,28,340,281826950,281826978
17670,5,24,149,5745,-85,-97,12,,281827932,32,922,281827900,281827932
17671,5,24,149,5745,-84,-97,13,,281828673,32,709,281828641,281828673
17672,5,24,149,5745,-85,-97,12,,281829235,32,530,281829203,281829235
17673,5,24,149,5745,-85,-97,12,,281829797,28,534,281829769,281829797
17674,5,6,149,5745,-69,-97,28,,281832183,52,2334,281832131,281832183
17675,5,6,149,5745,-85,-97,12,,281832252,44,25,281832208,281832252
17676,5,24,149,5745,-84,-97,13,,281832369,28,89,281832341,281832369
17677,5,6,149,5745,-69,-97,28,,281832502,52,81,281832450,281832502
17678,5,6,149,5745,-85,-97,12,,281832570,44,24,281832526,281832570
17679,5,24,149,5745,-84,-97,13,,281832688,28,90,281832660,281832688
17680,5,12,149,5745,-63,-97,34,b6:90:18:f6:b1:d4,281841687,268,8731,281841419,281841687
17681,5,24,149,5745,-85,-97,12,,281843233,28,1518,281843205,281843233
17682,5,12,149,5745,-61,-97,36,5e:29:73:5b:30:00,281860600,272,17095,281860328,281860600
17683,5,12,149,5745,-70,-97,27,3e:ef:29:c7:4b:17,281866812,272,5940,281866540,281866812
17684,5,24,149,5745,-84,-97,13,,281867620,32,776,281867588,281867620
17685,5,24,149,5745,-84,-97,13,,281867963,28,315,281867935,281867963
17686,5,12,149,5745,-63,-97,34,b6:90:18:f6:b1:d4,281873753,268,5522,281873485,281873753
17687,5,12,149,5745,-72,-97,25,0a:e1:ab:b3:c3:a6,281885767,268,11746,281885499,281885767
17688,5,12,149,5745,-57,-97,40,76:d6:6a:bb:b3:f5,281891530,268,5495,281891262,281891530
17689,5,12,149,5745,-63,-97,34,3a:de:b0:2e:cd:45,281892592,268,794,281892324,281892592
17690,5,12,149,5745,-54,-97,43,3e:d1:9b:c7:a4:de,281898399,272,5535,281898127,281898399
17691,5,12,149,5745,-66,-97,31,22:ec:75:a8:8a:31,281901865,244,3222,281901621,281901865
17692,5,12,149,5745,-63,-97,34,b6:90:18:f6:b1:d4,281907306,268,5173,281907038,281907306
17693,5,12,149,5745,-65,-97,32,9e:1f:b0:a7:b8:90,281909861,284,2271,281909577,281909861
17694,5,12,149,5745,-70,-97,27,72:d1:72:1d:22:a1,281915941,284,5796,281915657,281915941
17695,5,12,149,5745,-68,-97,29,56:68:e2:c2:8d:d5,281917895,280,1674,281917615,281917895
17696,5,6,149,5745,-68,-97,29,,281921451,52,3504,281921399,281921451
17697,5,6,149,5745,-85,-97,12,,281921519,44,24,281921475,281921519
17698,5,24,149,5745,-85,-97,12,,281921637,28,90,281921609,281921637
17699,5,6,149,5745,-68,-97,29,,281921950,52,261,281921898,281921950
17700,5,6,149,5745,-84,-97,13,,281922019,44,25,281921975,281922019
17701,5,24,149,5745,-85,-97,12,,281922136,28,89,281922108,281922136
17702,5,6,149,5745,-68,-97,29,,281922287,52,99,281922235,281922287
17703,5,6,149,5745,-85,-97,12,,281922355,44,24,281922311,281922355
17704,5,24,149,5745,-85,-97,12,,281922473,28,90,281922445,281922473
17705,5,12,149,5745,-89,-97,8,42:d2:d9:2b:ac:61,281929267,256,6538,281929011,281929267
17706,5,12,149,5745,-92,-97,5,7e:05:42:11:d2:ec,281934272,244,4761,281934028,281934272
17707,5,24,149,5745,-85,-97,12,,281938936,32,4632,281938904,281938936
17708,5,24,149,5745,-85,-97,12,,281939372,32,404,281939340,281939372
17709,5,24,149,5745,-86,-97,11,,281939809,28,409,281939781,281939809
17710,5,24,149,5745,-85,-97,12,,281940398,28,561,281940370,281940398
17711,5,12,149,5745,-84,-97,13,9a:24:38:da:96:bb,281954341,272,13671,281954069,281954341
17712,5,24,149,5745,-84,-97,13,,281960767,32,6394,281960735,281960767
17713,5,12,149,5745,-69,-97,28,f6:0a:5c:59:72:df,281968783,280,7736,281968503,281968783
17714,5,12,149,5745,-70,-97,27,3e:ef:29:c7:4b:17,281969108,272,53,281968836,281969108
17715,5,12,149,5745,-64,-97,33,5e:29:73:5b:30:00,281977589,272,8209,281977317,281977589
17716,5,6,149,5745,-66,-97,31,,281981360,52,3719,281981308,281981360
17717,5,6,149,5745,-85,-97,12,,281981428,44,24,281981384,281981428
17718,5,24,149,5745,-85,-97,12,,281981545,28,89,281981517,281981545
17719,5,6,149,5745,-67,-97,30,,281981653,52,56,281981601,281981653
17720,5,6,149,5745,-85,-97,12,,281981721,44,24,281981677,281981721
17721,5,24,149,5745,-86,-97,11,,281981846,32,93,281981814,281981846
17722,5,12,149,5745,-72,-97,25,0a:e1:ab:b3:c3:a6,281988116,268,6002,281987848,281988116
17723,5,6,149,5745,-89,-97,8,54:e4:3a:ec:fb:65,281993606,360,5130,281993246,281993606
17724,5,12,149,5745,-65,-97,32,b6:90:18:f6:b1:d4,281995239,268,1365,281994971,281995239
17725,5,12,149,5745,-62,-97,35,3a:de:b0:2e:cd:45,281995604,268,97,281995336,281995604
17726,5,12,149,5745,-51,-97,46,3e:d1:9b:c7:a4:de,282011686,272,15810,282011414,282011686
17727,5,12,149,5745,-71,-97,26,72:d1:72:1d:22:a1,282018212,284,6242,282017928,282018212
17728,5,12,149,5745,-66,-97,31,22:ec:75:a8:8a:31,282018902,244,446,282018658,282018902
17729,5,12,149,5745,-68,-97,29,56:68:e2:c2:8d:d5,282020312,280,1130,282020032,282020312
17730,5,12,149,5745,-89,-97,8,42:d2:d9:2b:ac:61,282031431,256,10863,282031175,282031431
17731,5,12,149,5745,-83,-97,14,9a:24:38:da:96:bb,282032652,272,949,282032380,282032652
17732,5,12,149,5745,-71,-97,26,3e:ef:29:c7:4b:17,282072361,272,39437,282072089,282072361
17733,5,12,149,5745,-64,-97,33,5e:29:73:5b:30:00,282089532,272,16899,282089260,282089532
17734,5,12,149,5745,-70,-97,27,0a:e1:ab:b3:c3:a6,282090810,268,1010,282090542,282090810
17735,5,12,149,5745,-58,-97,39,76:d6:6a:bb:b3:f5,282095875,268,4797,282095607,282095875
17736,5,12,149,5745,-64,-97,33,3a:de:b0:2e:cd:45,282096733,268,590,282096465,282096733
17737,5,12,149,5745,-62,-97,35,9e:1f:b0:a7:b8:90,282097687,284,670,282097403,282097687
17738,5,12,149,5745,-68,-97,29,b6:90:18:f6:b1:d4,282120473,268,22518,282120205,282120473
17739,5,12,149,5745,-71,-97,26,72:d1:72:1d:22:a1,282120927,284,170,282120643,282120927
17740,5,12,149,5745,-69,-97,28,56:68:e2:c2:8d:d5,282121333,280,126,282121053,282121333
17741,5,12,149,5745,-48,-97,49,3e:d1:9b:c7:a4:de,282123604,272,1999,282123332,282123604
17742,5,12,149,5745,-89,-97,8,42:d2:d9:2b:ac:61,282133314,256,9454,282133058,282133314
17743,5,12,149,5745,-91,-97,6,7e:05:42:11:d2:ec,282138895,244,5337,282138651,282138895
17744,5,12,149,5745,-63,-97,34,9e:1f:b0:a7:b8:90,282139708,284,529,282139424,282139708
17745,5,12,149,5745,-67,-97,30,22:ec:75:a8:8a:31,282150868,244,10916,282150624,282150868
17746,5,12,149,5745,-71,-97,26,0a:e1:ab:b3:c3:a6,282152109,268,973,282151841,282152109
17747,5,12,149,5745,-61,-97,36,3a:de:b0:2e:cd:45,282152475,268,98,282152207,282152475
17748,5,12,149,5745,-71,-97,26,0a:e1:ab:b3:c3:a6,282156143,268,3400,282155875,282156143
17749,5,12,149,5745,-67,-97,30,22:ec:75:a8:8a:31,282157802,516,1143,282157286,282157802
17750,5,12,149,5745,-61,-97,36,3a:de:b0:2e:cd:45,282158480,268,410,282158212,282158480
17751,5,12,149,5745,-49,-97,48,3e:d1:9b:c7:a4:de,282159008,544,-16,282158464,282159008
17752,5,12,149,5745,-89,-97,8,42:d2:d9:2b:ac:61,282161410,452,1950,282160958,282161410
17753,5,12,149,5745,-72,-97,25,3e:ef:29:c7:4b:17,282163507,468,1629,282163039,282163507
17754,5,12,149,5745,-63,-97,34,5e:29:73:5b:30:00,282166165,540,2118,282165625,282166165
17755,5,12,149,5745,-69,-97,28,56:68:e2:c2:8d:d5,282167730,476,1089,282167254,282167730
17756,5,12,149,5745,-58,-97,39,76:d6:6a:bb:b3:f5,282168294,268,296,282168026,282168294
17757,5,12,149,5745,-70,-97,27,56:68:e2:c2:8d:d5,282168623,280,49,282168343,282168623
17758,5,12,149,5745,-69,-97,28,b6:90:18:f6:b1:d4,282169633,268,742,282169365,282169633
17759,5,12,149,5745,-91,-97,6,02:af:71:9e:85:a6,282170697,440,624,282170257,282170697
17760,5,12,149,5745,-90,-97,7,7e:05:42:11:d2:ec,282175162,440,4025,282174722,282175162
17761,5,12,149,5745,-65,-97,32,9e:1f:b0:a7:b8:90,282175708,480,66,282175228,282175708
17762,5,12,149,5745,-54,-97,43,4a:ea:3c:f4:ce:b2,282176222,268,246,282175954,282176222
17763,5,12,149,5745,-68,-97,29,f6:0a:5c:59:72:df,282177075,476,377,282176599,282177075
17764,5,12,149,5745,-69,-97,28,72:d1:72:1d:22:a1,282177622,480,67,282177142,282177622
17765,5,12,149,5745,-58,-97,39,76:d6:6a:bb:b3:f5,282183286,268,5396,282183018,282183286
17766,5,12,149,5745,-68,-97,29,f6:0a:5c:59:72:df,282183624,280,58,282183344,282183624
17767,5,12,149,5745,-71,-97,26,3e:ef:29:c7:4b:17,282183939,272,43,282183667,282183939
17768,5,12,149,5745,-67,-97,30,72:d1:72:1d:22:a1,282185550,284,1327,282185266,282185550
17769,5,12,149,5745,-90,-97,7,42:d2:d9:2b:ac:61,282186753,256,947,282186497,282186753
17770,5,6,149,5745,-84,-97,13,54:e4:3a:ec:fb:65,282198407,360,11294,282198047,282198407
17771,5,12,149,5745,-70,-97,27,b6:90:18:f6:b1:d4,282217418,268,18743,282217150,282217418
17772,5,12,149,5745,-63,-97,34,5e:29:73:5b:30:00,282218774,272,1084,282218502,282218774
17773,5,12,149,5745,-72,-97,25,0a:e1:ab:b3:c3:a6,282219109,268,67,282218841,282219109
17774,5,12,149,5745,-71,-97,26,f2:da:61:dd:98:c5,282222048,468,2471,282221580,282222048
17775,5,12,149,5745,-66,-97,31,22:ec:75:a8:8a:31,282222612,516,48,282222096,282222612
17776,5,12,149,5745,-52,-97,45,3e:d1:9b:c7:a4:de,282224434,544,1278,282223890,282224434
17777,5,12,149,5745,-70,-97,27,f6:0a:5c:59:72:df,282225985,128,1423,282225857,282225985
17778,5,12,149,5745,-66,-97,31,9e:1f:b0:a7:b8:90,282226201,480,-264,282225721,282226201
17779,5,12,149,5745,-84,-97,13,9a:24:38:da:96:bb,282226725,824,-300,282225901,282226725
17780,5,12,149,5745,-72,-97,25,3e:ef:29:c7:4b:17,282228071,468,878,282227603,282228071
17781,5,12,149,5745,-70,-97,27,f6:0a:5c:59:72:df,282228591,476,44,282228115,282228591
17782,5,12,149,5745,-62,-97,35,0a:b9:b7:b1:4d:fa,282232021,132,3298,282231889,282232021
17783,5,12,149,5745,-60,-97,37,76:d6:6a:bb:b3:f5,282232243,268,-46,282231975,282232243
17784,5,12,149,5745,-68,-97,29,a6:92:ad:b7:76:65,282232572,484,-155,282232088,282232572
17785,5,12,149,5745,-69,-97,28,56:68:e2:c2:8d:d5,282233099,476,51,282232623,282233099
17786,5,12,149,5745,-69,-97,28,b6:90:18:f6:b1:d4,282234619,268,1252,282234351,282234619
17787,5,12,149,5745,-61,-97,36,3a:de:b0:2e:cd:45,282235435,268,548,282235167,282235435
17788,5,12,149,5745,-63,-97,34,5e:29:73:5b:30:00,282236298,540,323,282235758,282236298
17789,5,12,149,5745,-56,-97,41,4a:ea:3c:f4:ce:b2,282236963,268,397,282236695,282236963
17790,5,12,149,5745,-78,-97,19,d2:00:04:7e:2c:ab,282238381,440,978,282237941,282238381
17791,5,12,149,5745,-90,-97,7,7e:05:42:11:d2:ec,282239284,440,463,282238844,282239284
17792,5,12,149,5745,-62,-97,35,0a:b9:b7:b1:4d:fa,282240092,268,540,282239824,282240092
17793,5,12,149,5745,-65,-97,32,72:d1:72:1d:22:a1,282241140,480,568,282240660,282241140
17794,5,12,149,5745,-69,-97,28,aa:b6:ae:27:64:4e,282245938,268,4530,282245670,282245938
17795,5,12,149,5745,-54,-97,43,3e:d1:9b:c7:a4:de,282249923,272,3713,282249651,282249923
17796,5,12,149,5745,-66,-97,31,9e:1f:b0:a7:b8:90,282250798,284,591,282250514,282250798
17797,5,12,149,5745,-91,-97,6,7e:05:42:11:d2:ec,282251507,244,465,282251263,282251507
17798,5,12,149,5745,-85,-97,12,9a:24:38:da:96:bb,282256135,272,4356,282255863,282256135
17799,5,12,149,5745,-56,-97,41,4a:ea:3c:f4:ce:b2,282259874,268,3471,282259606,282259874
17800,5,12,149,5745,-66,-97,31,22:ec:75:a8:8a:31,282266368,244,6250,282266124,282266368
17801,5,12,149,5745,-75,-97,22,0a:e1:ab:b3:c3:a6,282267133,268,497,282266865,282267133
17802,5,12,149,5745,-60,-97,37,3a:de:b0:2e:cd:45,282267705,268,304,282267437,282267705
17803,5,12,149,5745,-68,-97,29,56:68:e2:c2:8d:d5,282296274,280,28289,282295994,282296274
17804,5,12,149,5745,-63,-97,34,76:d6:6a:bb:b3:f5,282298436,268,1894,282298168,282298436
17805,5,12,149,5745,-72,-97,25,3e:ef:29:c7:4b:17,282299430,272,722,282299158,282299430
17806,5,12,149,5745,-69,-97,28,b6:90:18:f6:b1:d4,282300178,268,480,282299910,282300178
17807,5,6,149,5745,-86,-97,11,54:e4:3a:ec:fb:65,282300807,360,269,282300447,282300807
17808,5,12,149,5745,-67,-97,30,72:d1:72:1d:22:a1,282312637,284,11546,282312353,282312637
17809,5,12,149,5745,-63,-97,34,5e:29:73:5b:30:00,282318060,272,5151,282317788,282318060
17810,5,12,149,5745,-71,-97,26,b6:90:18:f6:b1:d4,282332507,268,14179,282332239,282332507
17811,5,12,149,5745,-57,-97,40,3e:d1:9b:c7:a4:de,282353277,272,20498,282353005,282353277
17812,5,12,149,5745,-65,-97,32,22:ec:75:a8:8a:31,282360911,244,7390,282360667,282360911
17813,5,12,149,5745,-71,-97,26,b6:90:18:f6:b1:d4,282366086,268,4907,282365818,282366086
17814,5,12,149,5745,-84,-97,13,9a:24:38:da:96:bb,282369158,272,2800,282368886,282369158
17815,5,12,149,5745,-68,-97,29,0a:e1:ab:b3:c3:a6,282397660,268,28234,282397392,282397660
17816,5,6,149,5745,-86,-97,11,54:e4:3a:ec:fb:65,282403208,360,5188,282402848,282403208
17817,5,12,149,5745,-55,-97,42,3a:de:b0:2e:cd:45,282404424,268,948,282404156,282404424
17818,5,12,149,5745,-65,-97,32,9e:1f:b0:a7:b8:90,282405049,284,341,282404765,282405049
17819,5,12,149,5745,-60,-97,37,76:d6:6a:bb:b3:f5,282411613,268,6296,282411345,282411613
17820,5,12,149,5745,-72,-97,25,72:d1:72:1d:22:a1,282425606,284,13709,282425322,282425606
17821,5,12,149,5745,-67,-97,30,f6:0a:5c:59:72:df,282426241,280,355,282425961,282426241
17822,5,12,149,5745,-70,-97,27,56:68:e2:c2:8d:d5,282429930,280,3409,282429650,282429930
17823,5,12,149,5745,-66,-97,31,b6:90:18:f6:b1:d4,282430354,268,156,282430086,282430354
17824,5,12,149,5745,-66,-97,31,b6:90:18:f6:b1:d4,282431628,268,1006,282431360,282431628
17825,5,12,149,5745,-60,-97,37,5e:29:73:5b:30:00,282434888,272,2988,282434616,282434888
17826,5,12,149,5745,-90,-97,7,42:d2:d9:2b:ac:61,282441147,256,6003,282440891,282441147
17827,5,12,149,5745,-57,-97,40,3e:d1:9b:c7:a4:de,282470240,272,28821,282469968,282470240
17828,5,12,149,5745,-65,-97,32,22:ec:75:a8:8a:31,282476978,244,6494,282476734,282476978
17829,5,12,149,5745,-72,-97,25,3e:ef:29:c7:4b:17,282481588,272,4338,282481316,282481588
17830,5,12,149,5745,-84,-97,13,9a:24:38:da:96:bb,282486111,272,4251,282485839,282486111
17831,5,12,149,5745,-69,-97,28,0a:e1:ab:b3:c3:a6,282500059,268,13680,282499791,282500059
17832,5,6,149,5745,-85,-97,12,54:e4:3a:ec:fb:65,282505609,360,5190,282505249,282505609
17833,5,12,149,5745,-58,-97,39,3a:de:b0:2e:cd:45,282507098,268,1221,282506830,282507098
17834,5,12,149,5745,-66,-97,31,9e:1f:b0:a7:b8:90,282508263,284,881,282507979,282508263
17835,5,12,149,5745,-56,-97,41,4a:ea:3c:f4:ce:b2,282509357,268,826,282509089,282509357
17836,5,12,149,5745,-60,-97,37,76:d6:6a:bb:b3:f5,282521987,268,12362,282521719,282521987
17837,5,12,149,5745,-70,-97,27,56:68:e2:c2:8d:d5,282530947,280,8680,282530667,282530947
17838,5,12,149,5745,-73,-97,24,72:d1:72:1d:22:a1,282538596,284,7365,282538312,282538596
17839,5,12,149,5745,-90,-97,7,42:d2:d9:2b:ac:61,282543732,256,4880,282543476,282543732
17840,5,12,149,5745,-67,-97,30,f6:0a:5c:59:72:df,282546807,280,2795,282546527,282546807
17841,5,12,149,5745,-58,-97,39,5e:29:73:5b:30:00,282551742,272,4663,282551470,282551742
17842,5,12,149,5745,-64,-97,33,b6:90:18:f6:b1:d4,282559663,268,7653,282559395,282559663
17843,5,12,149,5745,-72,-97,25,3e:ef:29:c7:4b:17,282582647,272,22712,282582375,282582647
17844,5,12,149,5745,-53,-97,44,3e:d1:9b:c7:a4:de,282587076,272,4157,282586804,282587076
17845,5,12,149,5745,-84,-97,13,9a:24:38:da:96:bb,282593583,272,6235,282593311,282593583
17846,5,12,149,5745,-68,-97,29,9e:1f:b0:a7:b8:90,282598902,284,5035,282598618,282598902
17847,5,12,149,5745,-64,-97,33,4a:ea:3c:f4:ce:b2,282602272,268,3102,282602004,282602272
17848,5,6,149,5745,-85,-97,12,54:e4:3a:ec:fb:65,282608009,360,5377,282607649,282608009
17849,5,12,149,5745,-66,-97,31,22:ec:75:a8:8a:31,282609612,244,1359,282609368,282609612
17850,5,12,149,5745,-72,-97,25,0a:e1:ab:b3:c3:a6,282610794,268,914,282610526,282610794
17851,5,12,149,5745,-69,-97,28,56:68:e2:c2:8d:d5,282611096,280,22,282610816,282611096
17852,5,12,149,5745,-62,-97,35,3a:de:b0:2e:cd:45,282611420,268,56,282611152,282611420
17853,5,12,149,5745,-74,-97,23,0a:e1:ab:b3:c3:a6,282613316,268,1628,282613048,282613316
17854,5,12,149,5745,-66,-97,31,22:ec:75:a8:8a:31,282617654,516,3822,282617138,282617654
17855,5,12,149,5745,-63,-97,34,3a:de:b0:2e:cd:45,282618278,152,472,282618126,282618278
17856,5,12,149,5745,-51,-97,46,3e:d1:9b:c7:a4:de,282619274,544,452,282618730,282619274
17857,5,12,149,5745,-68,-97,29,f6:0a:5c:59:72:df,282619960,128,558,282619832,282619960
17858,5,12,149,5745,-70,-97,27,3e:ef:29:c7:4b:17,282620520,468,92,282620052,282620520
17859,5,12,149,5745,-68,-97,29,f6:0a:5c:59:72:df,282621103,476,107,282620627,282621103
17860,5,12,149,5745,-66,-97,31,9e:1f:b0:a7:b8:90,282621631,480,48,282621151,282621631
17861,5,12,149,5745,-57,-97,40,76:d6:6a:bb:b3:f5,282625661,268,3762,282625393,282625661
17862,5,12,149,5745,-64,-97,33,a6:92:ad:b7:76:65,282626091,484,-54,282625607,282626091
17863,5,12,149,5745,-57,-97,40,76:d6:6a:bb:b3:f5,282626845,268,486,282626577,282626845
17864,5,12,149,5745,-68,-97,29,56:68:e2:c2:8d:d5,282627336,476,15,282626860,282627336
17865,5,12,149,5745,-56,-97,41,76:d6:6a:bb:b3:f5,282627984,132,516,282627852,282627984
17866,5,12,149,5745,-87,-97,10,02:af:71:9e:85:a6,282628438,440,14,282627998,282628438
17867,5,12,149,5745,-72,-97,25,0a:e1:ab:b3:c3:a6,282629207,132,637,282629075,282629207
17868,5,12,149,5745,-65,-97,32,b6:90:18:f6:b1:d4,282630156,268,681,282629888,282630156
17869,5,12,149,5745,-61,-97,36,4a:ea:3c:f4:ce:b2,282631974,268,1550,282631706,282631974
17870,5,12,149,5745,-69,-97,28,72:d1:72:1d:22:a1,282635808,480,3354,282635328,282635808
17871,5,12,149,5745,-70,-97,27,f6:0a:5c:59:72:df,282640176,280,4088,282639896,282640176
17872,5,12,149,5745,-71,-97,26,3e:ef:29:c7:4b:17,282642210,272,1762,282641938,282642210
17873,5,12,149,5745,-68,-97,29,72:d1:72:1d:22:a1,282644039,284,1545,282643755,282644039
17874,5,12,149,5745,-88,-97,9,42:d2:d9:2b:ac:61,282644857,256,562,282644601,282644857
17875,5,12,149,5745,-66,-97,31,b6:90:18:f6:b1:d4,282660151,268,15026,282659883,282660151
17876,5,12,149,5745,-66,-97,31,5e:29:73:5b:30:00,282667234,272,6811,282666962,282667234
17877,5,12,149,5745,-65,-97,32,a6:92:ad:b7:76:65,282688622,484,20904,282688138,282688622
17878,5,12,149,5745,-90,-97,7,02:af:71:9e:85:a6,282692614,440,3552,282692174,282692614
17879,5,12,149,5745,-90,-97,7,7e:05:42:11:d2:ec,282693841,244,983,282693597,282693841
17880,5,12,149,5745,-68,-97,29,b6:90:18:f6:b1:d4,282694174,268,65,282693906,282694174
17881,5,12,149,5745,-56,-97,41,3a:de:b0:2e:cd:45,282694504,240,90,282694264,282694504
17882,5,12,149,5745,-58,-97,39,4a:ea:3c:f4:ce:b2,282694849,268,77,282694581,282694849
17883,5,12,149,5745,-70,-97,27,f2:da:61:dd:98:c5,282700751,268,5634,282700483,282700751
17884,5,12,149,5745,-52,-97,45,3e:d1:9b:c7:a4:de,282704356,272,3333,282704084,282704356
17885,5,12,149,5745,-66,-97,31,22:ec:75:a8:8a:31,282708776,244,4176,282708532,282708776
17886,5,6,149,5745,-85,-97,12,54:e4:3a:ec:fb:65,282710409,360,1273,282710049,282710409
17887,5,12,149,5745,-58,-97,39,4a:ea:3c:f4:ce:b2,282714311,268,3634,282714043,282714311
17888,5,12,149,5745,-67,-97,30,9e:1f:b0:a7:b8:90,282714720,284,125,282714436,282714720
17889,5,12,149,5745,-73,-97,24,0a:e1:ab:b3:c3:a6,282717471,268,2483,282717203,282717471
17890,5,12,149,5745,-63,-97,34,a6:92:ad:b7:76:65,282724469,284,6714,282724185,282724469
17891,5,12,149,5745,-70,-97,27,f2:da:61:dd:98:c5,282726956,268,2219,282726688,282726956
17892,5,12,149,5745,-84,-97,13,9a:24:38:da:96:bb,282728828,272,1600,282728556,282728828
17893,5,12,149,5745,-69,-97,28,56:68:e2:c2:8d:d5,282739607,280,10499,282739327,282739607
17894,5,12,149,5745,-56,-97,41,76:d6:6a:bb:b3:f5,282740596,268,721,282740328,282740596
17895,5,12,149,5745,-70,-97,27,3e:ef:29:c7:4b:17,282741567,272,699,282741295,282741567
17896,5,12,149,5745,-73,-97,24,0a:e1:ab:b3:c3:a6,282743238,268,1403,282742970,282743238
17897,5,12,149,5745,-70,-97,27,f2:da:61:dd:98:c5,282749482,268,5976,282749214,282749482
17898,5,12,149,5745,-69,-97,28,22:ec:75:a8:8a:31,282749812,516,-186,282749296,282749812
17899,5,12,149,5745,-54,-97,43,3e:d1:9b:c7:a4:de,282751432,544,1076,282750888,282751432
17900,5,12,149,5745,-64,-97,33,a6:92:ad:b7:76:65,282754431,484,2515,282753947,282754431
17901,5,12,149,5745,-71,-97,26,3e:ef:29:c7:4b:17,282755302,468,403,282754834,282755302
17902,5,12,149,5745,-56,-97,41,76:d6:6a:bb:b3:f5,282756870,268,1300,282756602,282756870
17903,5,12,149,5745,-90,-97,7,02:af:71:9e:85:a6,282758735,440,1425,282758295,282758735
17904,5,12,149,5745,-87,-97,10,42:d2:d9:2b:ac:61,282760068,256,1077,282759812,282760068
17905,5,12,149,5745,-58,-97,39,4a:ea:3c:f4:ce:b2,282760467,268,131,282760199,282760467
17906,5,12,149,5745,-58,-97,39,0a:b9:b7:b1:4d:fa,282761853,268,1118,282761585,282761853
17907,5,12,149,5745,-66,-97,31,5e:29:73:5b:30:00,282762992,540,599,282762452,282762992
17908,5,12,149,5745,-68,-97,29,b6:90:18:f6:b1:d4,282765421,268,2161,282765153,282765421
17909,5,12,149,5745,-68,-97,29,b6:90:18:f6:b1:d4,282774490,268,8801,282774222,282774490
17910,5,12,149,5745,-65,-97,32,5e:29:73:5b:30:00,282792969,272,18207,282792697,282792969
17911,5,6,149,5745,-83,-97,14,54:e4:3a:ec:fb:65,282812810,360,19481,282812450,282812810
17912,5,12,149,5745,-55,-97,42,3e:d1:9b:c7:a4:de,282816819,272,3737,282816547,282816819
17913,5,12,149,5745,-84,-97,13,9a:24:38:da:96:bb,282818234,272,1143,282817962,282818234
17914,5,24,149,5745,-87,-97,10,,282820887,28,2625,282820859,282820887
17915,5,12,149,5745,-67,-97,30,22:ec:75:a8:8a:31,282824497,244,3366,282824253,282824497
17916,5,12,149,5745,-66,-97,31,9e:1f:b0:a7:b8:90,282826849,284,2068,282826565,282826849
17917,5,12,149,5745,-68,-97,29,72:d1:72:1d:22:a1,282837490,284,10357,282837206,282837490
17918,5,12,149,5745,-65,-97,32,a6:92:ad:b7:76:65,282844360,284,6586,282844076,282844360
17919,5,12,149,5745,-67,-97,30,0a:e1:ab:b3:c3:a6,282845990,268,1362,282845722,282845990
17920,5,12,149,5745,-68,-97,29,56:68:e2:c2:8d:d5,282850904,280,4634,282850624,282850904
17921,5,24,149,5745,-87,-97,10,,282869618,32,18682,282869586,282869618
17922,5,12,149,5745,-73,-97,24,3e:ef:29:c7:4b:17,282870279,272,389,282870007,282870279
17923,5,12,149,5745,-70,-97,27,f6:0a:5c:59:72:df,282885198,280,14639,282884918,282885198
17924,5,12,149,5745,-65,-97,32,5e:29:73:5b:30:00,282896341,272,10871,282896069,282896341
17925,5,12,149,5745,-58,-97,39,76:d6:6a:bb:b3:f5,282915474,268,18865,282915206,282915474
17926,5,12,149,5745,-68,-97,29,f2:da:61:dd:98:c5,282916110,268,368,282915842,282916110
17927,5,24,149,5745,-68,-97,29,,282916794,28,656,282916766,282916794
17928,5,24,149,5745,-86,-97,11,,282916839,28,17,282916811,282916839
17929,5,24,149,5745,-87,-97,10,,282916946,28,79,282916918,282916946
17930,5,12,149,5745,-64,-97,33,9e:1f:b0:a7:b8:90,282934015,284,16785,282933731,282934015
17931,5,12,149,5745,-52,-97,45,3e:d1:9b:c7:a4:de,282934351,272,64,282934079,282934351
17932,5,12,149,5745,-82,-97,15,9a:24:38:da:96:bb,282934686,272,63,282934414,282934686
17933,5,24,149,5745,-86,-97,11,,282938040,28,3326,282938012,282938040
17934,5,12,149,5745,-68,-97,29,b6:90:18:f6:b1:d4,282939817,268,1509,282939549,282939817
17935,5,12,149,5745,-67,-97,30,72:d1:72:1d:22:a1,282940309,284,208,282940025,282940309
17936,5,12,149,5745,-68,-97,29,22:ec:75:a8:8a:31,282941582,244,1029,282941338,282941582
17937,5,12,149,5745,-90,-97,7,42:d2:d9:2b:ac:61,282952912,256,11074,282952656,282952912
17938,5,12,149,5745,-68,-97,29,a6:92:ad:b7:76:65,282953638,284,442,282953354,282953638
17939,5,12,149,5745,-57,-97,40,4a:ea:3c:f4:ce:b2,282953959,268,53,282953691,282953959
17940,5,12,149,5745,-72,-97,25,3e:ef:29:c7:4b:17,282984609,272,30378,282984337,282984609
17941,5,24,149,5745,-69,-97,28,,282992964,28,8327,282992936,282992964
17942,5,24,149,5745,-87,-97,10,,282993008,28,16,282992980,282993008
17943,5,24,149,5745,-69,-97,28,,282993250,28,214,282993222,282993250
17944,5,24,149,5745,-86,-97,11,,282993294,28,16,282993266,282993294
17945,5,24,149,5745,-87,-97,10,,282993411,32,85,282993379,282993411
17946,5,12,149,5745,-63,-97,34,5e:29:73:5b:30:00,283009785,272,16102,283009513,283009785
17947,5,12,149,5745,-73,-97,24,0a:e1:ab:b3:c3:a6,283012040,268,1987,283011772,283012040
17948,5,6,149,5745,-85,-97,12,54:e4:3a:ec:fb:65,283017611,360,5211,283017251,283017611
17949,5,12,149,5745,-69,-97,28,f2:da:61:dd:98:c5,283018415,268,536,283018147,283018415
17950,5,12,149,5745,-68,-97,29,b6:90:18:f6:b1:d4,283042025,268,23342,283041757,283042025
17951,5,12,149,5745,-74,-97,23,72:d1:72:1d:22:a1,283042425,284,116,283042141,283042425
17952,5,12,149,5745,-81,-97,16,9a:24:38:da:96:bb,283043810,272,1113,283043538,283043810
17953,5,12,149,5745,-71,-97,26,56:68:e2:c2:8d:d5,283044325,280,235,283044045,283044325
17954,5,24,149,5745,-85,-97,12,,283049408,32,5051,283049376,283049408
17955,5,24,149,5745,-85,-97,12,,283049952,32,512,283049920,283049952
17956,5,24,149,5745,-86,-97,11,,283050497,28,517,283050469,283050497
17957,5,12,149,5745,-51,-97,46,3e:d1:9b:c7:a4:de,283051101,272,332,283050829,283051101
17958,5,12,149,5745,-90,-97,7,c6:71:4f:a2:d1:86,283053033,244,1688,283052789,283053033
17959,5,12,149,5745,-86,-97,11,42:d2:d9:2b:ac:61,283053637,256,348,283053381,283053637
17960,5,12,149,5745,-65,-97,32,22:ec:75:a8:8a:31,283058897,244,5016,283058653,283058897
17961,5,12,149,5745,-89,-97,8,7e:05:42:11:d2:ec,283060518,244,1377,283060274,283060518
17962,5,12,149,5745,-74,-97,23,3e:ef:29:c7:4b:17,283103017,272,42227,283102745,283103017
17963,5,12,149,5745,-71,-97,26,0a:e1:ab:b3:c3:a6,283114335,268,11050,283114067,283114335
17964,5,6,149,5745,-88,-97,9,54:e4:3a:ec:fb:65,283120012,360,5317,283119652,283120012
17965,5,12,149,5745,-73,-97,24,f2:da:61:dd:98:c5,283120727,268,447,283120459,283120727
17966,5,12,149,5745,-64,-97,33,9e:1f:b0:a7:b8:90,283121397,284,386,283121113,283121397
17967,5,12,149,5745,-63,-97,34,5e:29:73:5b:30:00,283123888,272,2219,283123616,283123888
17968,5,12,149,5745,-68,-97,29,a6:92:ad:b7:76:65,283142410,284,18238,283142126,283142410
17969,5,12,149,5745,-73,-97,24,b6:90:18:f6:b1:d4,283145127,268,2449,283144859,283145127
17970,5,12,149,5745,-71,-97,26,72:d1:72:1d:22:a1,283145430,284,19,283145146,283145430
17971,5,12,149,5745,-72,-97,25,56:68:e2:c2:8d:d5,283146052,280,342,283145772,283146052
17972,5,12,149,5745,-89,-97,8,c6:71:4f:a2:d1:86,283155514,244,9218,283155270,283155514
17973,5,12,149,5745,-91,-97,6,42:d2:d9:2b:ac:61,283157492,256,1722,283157236,283157492
17974,5,12,149,5745,-92,-97,5,7e:05:42:11:d2:ec,283160981,244,3245,283160737,283160981
17975,5,12,149,5745,-57,-97,40,3e:d1:9b:c7:a4:de,283162876,272,1623,283162604,283162876
17976,5,12,149,5745,-66,-97,31,9e:1f:b0:a7:b8:90,283168053,284,4893,283167769,283168053
17977,5,12,149,5745,-67,-97,30,22:ec:75:a8:8a:31,283170482,244,2185,283170238,283170482
17978,5,12,149,5745,-68,-97,29,a6:92:ad:b7:76:65,283183725,284,12959,283183441,283183725
17979,5,12,149,5745,-70,-97,27,0a:e1:ab:b3:c3:a6,283186353,268,2360,283186085,283186353
17980,5,12,149,5745,-69,-97,28,f2:da:61:dd:98:c5,283187125,268,504,283186857,283187125
17981,5,12,149,5745,-72,-97,25,56:68:e2:c2:8d:d5,283187769,280,364,283187489,283187769
17982,5,12,149,5745,-75,-97,22,3e:ef:29:c7:4b:17,283199231,272,11190,283198959,283199231
17983,5,12,149,5745,-74,-97,23,72:d1:72:1d:22:a1,283201105,284,1590,283200821,283201105
17984,5,12,149,5745,-69,-97,28,0a:e1:ab:b3:c3:a6,283203457,268,2084,283203189,283203457
17985,5,12,149,5745,-65,-97,32,22:ec:75:a8:8a:31,283206366,516,2393,283205850,283206366
17986,5,12,149,5745,-55,-97,42,3e:d1:9b:c7:a4:de,283208054,544,1144,283207510,283208054
17987,5,12,149,5745,-66,-97,31,9e:1f:b0:a7:b8:90,283208687,480,153,283208207,283208687
17988,5,12,149,5745,-69,-97,28,f2:da:61:dd:98:c5,283210048,268,1093,283209780,283210048
17989,5,12,149,5745,-70,-97,27,f6:0a:5c:59:72:df,283210455,280,127,283210175,283210455
17990,5,12,149,5745,-70,-97,27,f6:0a:5c:59:72:df,283213309,476,2378,283212833,283213309
17991,5,12,149,5745,-73,-97,24,56:68:e2:c2:8d:d5,283216271,476,2486,283215795,283216271
17992,5,12,149,5745,-69,-97,28,a6:92:ad:b7:76:65,283216970,484,215,283216486,283216970
17993,5,12,149,5745,-90,-97,7,42:d2:d9:2b:ac:61,283218175,256,949,283217919,283218175
17994,5,12,149,5745,-64,-97,33,5e:29:73:5b:30:00,283219049,540,334,283218509,283219049
17995,5,12,149,5745,-74,-97,23,3e:ef:29:c7:4b:17,283221289,468,1772,283220821,283221289
17996,5,6,149,5745,-84,-97,13,54:e4:3a:ec:fb:65,283222412,360,763,283222052,283222412
17997,5,12,149,5745,-65,-97,32,b6:90:18:f6:b1:d4,283226307,268,3627,283226039,283226307
17998,5,12,149,5745,-74,-97,23,72:d1:72:1d:22:a1,283226638,480,-149,283226158,283226638
17999,5,12,149,5745,-65,-97,32,b6:90:18:f6:b1:d4,283233197,268,6291,283232929,283233197
18000,5,12,149,5745,-61,-97,36,5e:29:73:5b:30:00,283251256,272,17787,283250984,283251256
18001,5,12,149,5745,-64,-97,33,9e:1f:b0:a7:b8:90,283266351,284,14811,283266067,283266351
18002,5,12,149,5745,-85,-97,12,9a:24:38:da:96:bb,283267065,272,442,283266793,283267065
18003,5,12,149,5745,-70,-97,27,0a:e1:ab:b3:c3:a6,283267452,268,119,283267184,283267452
18004,5,12,149,5745,-89,-97,8,7e:05:42:11:d2:ec,283269428,244,1732,283269184,283269428
18005,5,12,149,5745,-66,-97,31,22:ec:75:a8:8a:31,283271915,516,1971,283271399,283271915
18006,5,12,149,5745,-54,-97,43,3e:d1:9b:c7:a4:de,283273037,544,578,283272493,283273037
18007,5,12,149,5745,-72,-97,25,f2:da:61:dd:98:c5,283273617,268,312,283273349,283273617
18008,5,12,149,5745,-65,-97,32,9e:1f:b0:a7:b8:90,283273947,480,-150,283273467,283273947
18009,5,12,149,5745,-86,-97,11,9a:24:38:da:96:bb,283274471,824,-300,283273647,283274471
18010,5,12,149,5745,-72,-97,25,f2:da:61:dd:98:c5,283275365,132,762,283275233,283275365
18011,5,12,149,5745,-74,-97,23,f6:0a:5c:59:72:df,283277621,476,1780,283277145,283277621
18012,5,12,149,5745,-74,-97,23,56:68:e2:c2:8d:d5,283278725,476,628,283278249,283278725
18013,5,12,149,5745,-89,-97,8,7e:05:42:11:d2:ec,283279435,360,350,283279075,283279435
18014,5,12,149,5745,-67,-97,30,a6:92:ad:b7:76:65,283281213,484,1294,283280729,283281213
18015,5,12,149,5745,-54,-97,43,3e:d1:9b:c7:a4:de,283282353,272,868,283282081,283282353
18016,5,12,149,5745,-71,-97,26,0a:e1:ab:b3:c3:a6,283282696,268,75,283282428,283282696
18017,5,12,149,5745,-73,-97,24,f2:da:61:dd:98:c5,283284188,268,1224,283283920,283284188
18018,5,12,149,5745,-63,-97,34,5e:29:73:5b:30:00,283284490,540,-238,283283950,283284490
18019,5,12,149,5745,-67,-97,30,a6:92:ad:b7:76:65,283285091,284,317,283284807,283285091
18020,5,12,149,5745,-72,-97,25,3e:ef:29:c7:4b:17,283285447,468,-112,283284979,283285447
18021,5,12,149,5745,-91,-97,6,42:d2:d9:2b:ac:61,283288846,452,2947,283288394,283288846
18022,5,12,149,5745,-59,-97,38,0a:b9:b7:b1:4d:fa,283289332,268,218,283289064,283289332
18023,5,12,149,5745,-66,-97,31,b6:90:18:f6:b1:d4,283289678,268,78,283289410,283289678
18024,5,12,149,5745,-71,-97,26,72:d1:72:1d:22:a1,283290252,480,94,283289772,283290252
18025,5,12,149,5745,-66,-97,31,22:ec:75:a8:8a:31,283297877,244,7381,283297633,283297877
18026,5,12,149,5745,-75,-97,22,56:68:e2:c2:8d:d5,283299689,280,1532,283299409,283299689
18027,5,12,149,5745,-71,-97,26,3e:ef:29:c7:4b:17,283314202,272,14241,283313930,283314202
18028,5,12,149,5745,-70,-97,27,72:d1:72:1d:22:a1,283317125,284,2639,283316841,283317125
18029,5,6,149,5745,-84,-97,13,54:e4:3a:ec:fb:65,283324813,360,7328,283324453,283324813
18030,5,12,149,5745,-71,-97,26,f6:0a:5c:59:72:df,283333926,280,8833,283333646,283333926
18031,5,12,149,5745,-66,-97,31,b6:90:18:f6:b1:d4,283348416,268,14222,283348148,283348416
18032,5,12,149,5745,-72,-97,25,3e:ef:29:c7:4b:17,283350321,468,1437,283349853,283350321
18033,5,12,149,5745,-65,-97,32,5e:29:73:5b:30:00,283353158,272,2565,283352886,283353158
18034,5,12,149,5745,-84,-97,13,9a:24:38:da:96:bb,283380377,272,26947,283380105,283380377
18035,5,12,149,5745,-56,-97,41,3e:d1:9b:c7:a4:de,283392773,272,12124,283392501,283392773
18036,5,12,149,5745,-63,-97,34,9e:1f:b0:a7:b8:90,283398888,284,5831,283398604,283398888
18037,5,12,149,5745,-64,-97,33,22:ec:75:a8:8a:31,283401621,244,2489,283401377,283401621
18038,5,12,149,5745,-66,-97,31,a6:92:ad:b7:76:65,283408176,284,6271,283407892,283408176
18039,5,12,149,5745,-69,-97,28,0a:e1:ab:b3:c3:a6,283409464,268,1020,283409196,283409464
18040,5,12,149,5745,-73,-97,24,f2:da:61:dd:98:c5,283410987,268,1255,283410719,283410987
18041,5,12,149,5745,-74,-97,23,d2:00:04:7e:2c:ab,283412928,412,1529,283412516,283412928
18042,5,12,149,5745,-73,-97,24,56:68:e2:c2:8d:d5,283415966,280,2758,283415686,283415966
18043,5,12,149,5745,-69,-97,28,3e:ef:29:c7:4b:17,283416759,468,325,283416291,283416759
18044,5,6,149,5745,-84,-97,13,54:e4:3a:ec:fb:65,283427213,360,10094,283426853,283427213
18045,5,12,149,5745,-68,-97,29,3e:ef:29:c7:4b:17,283428598,272,1113,283428326,283428598
18046,5,12,149,5745,-71,-97,26,72:d1:72:1d:22:a1,283440558,284,11676,283440274,283440558
18047,5,12,149,5745,-91,-97,6,42:d2:d9:2b:ac:61,283446177,256,5363,283445921,283446177
18048,5,12,149,5745,-67,-97,30,b6:90:18:f6:b1:d4,283461701,268,15256,283461433,283461701
18049,5,12,149,5745,-64,-97,33,5e:29:73:5b:30:00,283470035,272,8062,283469763,283470035
18050,5,12,149,5745,-68,-97,29,3e:ef:29:c7:4b:17,283482245,468,11742,283481777,283482245
18051,5,12,149,5745,-84,-97,13,9a:24:38:da:96:bb,283494738,272,12221,283494466,283494738
18052,5,12,149,5745,-53,-97,44,3e:d1:9b:c7:a4:de,283508188,272,13178,283507916,283508188
18053,5,12,149,5745,-71,-97,26,22:ec:75:a8:8a:31,283514006,244,5574,283513762,283514006
18054,5,12,149,5745,-70,-97,27,0a:e1:ab:b3:c3:a6,283522306,268,8032,283522038,283522306
18055,5,12,149,5745,-70,-97,27,f2:da:61:dd:98:c5,283523953,268,1379,283523685,283523953
18056,5,6,149,5745,-84,-97,13,54:e4:3a:ec:fb:65,283529614,360,5301,283529254,283529614
18057,5,12,149,5745,-66,-97,31,9e:1f:b0:a7:b8:90,283530959,284,1061,283530675,283530959
18058,5,24,149,5745,-71,-97,26,,283545368,28,14381,283545340,283545368
18059,5,24,149,5745,-88,-97,9,,283545412,28,16,283545384,283545412
18060,5,24,149,5745,-87,-97,10,,283545520,28,80,283545492,283545520
18061,5,12,149,5745,-66,-97,31,a6:92:ad:b7:76:65,283552806,284,7002,283552522,283552806
18062,5,12,149,5745,-75,-97,22,72:d1:72:1d:22:a1,283553306,284,216,283553022,283553306
18063,5,12,149,5745,-70,-97,27,3e:ef:29:c7:4b:17,283553642,272,64,283553370,283553642
18064,5,12,149,5745,-70,-97,27,56:68:e2:c2:8d:d5,283556324,280,2402,283556044,283556324
18065,5,12,149,5745,-89,-97,8,42:d2:d9:2b:ac:61,283567138,256,10558,283566882,283567138
18066,5,12,149,5745,-66,-97,31,b6:90:18:f6:b1:d4,283570711,268,3305,283570443,283570711
18067,5,12,149,5745,-63,-97,34,5e:29:73:5b:30:00,283586065,272,15082,283585793,283586065
18068,5,12,149,5745,-82,-97,15,9a:24:38:da:96:bb,283603966,272,17629,283603694,283603966
18069,5,12,149,5745,-88,-97,9,7e:05:42:11:d2:ec,283615905,244,11695,283615661,283615905
18070,5,12,149,5745,-53,-97,44,3e:d1:9b:c7:a4:de,283621534,272,5357,283621262,283621534
18071,5,12,149,5745,-67,-97,30,22:ec:75:a8:8a:31,283631337,244,9559,283631093,283631337
18072,5,6,149,5745,-85,-97,12,54:e4:3a:ec:fb:65,283632014,360,317,283631654,283632014
18073,5,12,149,5745,-69,-97,28,9e:1f:b0:a7:b8:90,283633427,284,1129,283633143,283633427
18074,5,12,149,5745,-66,-97,31,a6:92:ad:b7:76:65,283634021,284,310,283633737,283634021
18075,5,12,149,5745,-71,-97,26,0a:e1:ab:b3:c3:a6,283634429,268,140,283634161,283634429
18076,5,12,149,5745,-71,-97,26,f2:da:61:dd:98:c5,283636622,268,1925,283636354,283636622
18077,5,12,149,5745,-70,-97,27,56:68:e2:c2:8d:d5,283642210,280,5308,283641930,283642210
18078,5,12,149,5745,-72,-97,25,3e:ef:29:c7:4b:17,283657954,272,15472,283657682,283657954
18079,5,12,149,5745,-75,-97,22,72:d1:72:1d:22:a1,283659763,284,1525,283659479,283659763
18080,5,12,149,5745,-91,-97,6,42:d2:d9:2b:ac:61,283660671,256,652,283660415,283660671
18081,5,12,149,5745,-72,-97,25,0a:e1:ab:b3:c3:a6,283661044,268,105,283660776,283661044
18082,5,12,149,5745,-72,-97,25,f6:0a:5c:59:72:df,283664156,280,2832,283663876,283664156
18083,5,12,149,5745,-53,-97,44,3e:d1:9b:c7:a4:de,283666746,544,2046,283666202,283666746
18084,5,12,149,5745,-68,-97,29,22:ec:75:a8:8a:31,283667342,516,80,283666826,283667342
18085,5,12,149,5745,-69,-97,28,9e:1f:b0:a7:b8:90,283667892,480,70,283667412,283667892
18086,5,12,149,5745,-70,-97,27,f2:da:61:dd:98:c5,283669389,268,1229,283669121,283669389
18087,5,12,149,5745,-74,-97,23,f6:0a:5c:59:72:df,283670029,476,164,283669553,283670029
18088,5,12,149,5745,-71,-97,26,56:68:e2:c2:8d:d5,283672366,476,1861,283671890,283672366
18089,5,12,149,5745,-65,-97,32,b6:90:18:f6:b1:d4,283675528,268,2894,283675260,283675528
18090,5,12,149,5745,-60,-97,37,5e:29:73:5b:30:00,283680740,540,4672,283680200,283680740
18091,5,12,149,5745,-71,-97,26,3e:ef:29:c7:4b:17,283681746,468,538,283681278,283681746
18092,5,12,149,5745,-92,-97,5,42:d2:d9:2b:ac:61,283683463,452,1265,283683011,283683463
18093,5,12,149,5745,-65,-97,32,b6:90:18:f6:b1:d4,283684444,268,713,283684176,283684444
18094,5,12,149,5745,-74,-97,23,72:d1:72:1d:22:a1,283684801,480,-123,283684321,283684801
18095,5,24,149,5745,-85,-97,12,,283695118,28,10289,283695090,283695118
18096,5,24,149,5745,-84,-97,13,,283695162,28,16,283695134,283695162
18097,5,24,149,5745,-85,-97,12,,283695271,32,77,283695239,283695271
18098,5,12,149,5745,-61,-97,36,5e:29:73:5b:30:00,283710546,272,15003,283710274,283710546
18099,5,24,149,5745,-84,-97,13,,283713362,28,2788,283713334,283713362
18100,5,24,149,5745,-85,-97,12,,283713407,28,17,283713379,283713407
18101,5,24,149,5745,-84,-97,13,,283713515,32,76,283713483,283713515
18102,5,12,149,5745,-85,-97,12,9a:24:38:da:96:bb,283716389,272,2602,283716117,283716389
18103,5,12,149,5745,-67,-97,30,f2:da:61:dd:98:c5,283734371,268,17714,283734103,283734371
18104,5,6,149,5745,-85,-97,12,54:e4:3a:ec:fb:65,283734671,360,-60,283734311,283734671
18105,5,12,149,5745,-52,-97,45,3e:d1:9b:c7:a4:de,283738544,272,3601,283738272,283738544
18106,5,12,149,5745,-67,-97,30,f2:da:61:dd:98:c5,283742290,268,3478,283742022,283742290
18107,5,12,149,5745,-69,-97,28,9e:1f:b0:a7:b8:90,283742692,284,118,283742408,283742692
18108,5,12,149,5745,-70,-97,27,22:ec:75:a8:8a:31,283748438,244,5502,283748194,283748438
18109,5,12,149,5745,-73,-97,24,56:68:e2:c2:8d:d5,283754520,280,5802,283754240,283754520
18110,5,12,149,5745,-70,-97,27,0a:e1:ab:b3:c3:a6,283756593,268,1805,283756325,283756593
18111,5,12,149,5745,-92,-97,5,42:d2:d9:2b:ac:61,283783735,256,26886,283783479,283783735
18112,5,12,149,5745,-66,-97,31,b6:90:18:f6:b1:d4,283790199,268,6196,283789931,283790199
18113,5,12,149,5745,-71,-97,26,0a:e1:ab:b3:c3:a6,283791671,268,1204,283791403,283791671
18114,5,12,149,5745,-68,-97,29,f6:0a:5c:59:72:df,283793225,280,1274,283792945,283793225
18115,5,12,149,5745,-78,-97,19,d2:00:04:7e:2c:ab,283795890,440,2225,283795450,283795890
18116,5,12,149,5745,-69,-97,28,22:ec:75:a8:8a:31,283798473,516,2067,283797957,283798473
18117,5,12,149,5745,-52,-97,45,3e:d1:9b:c7:a4:de,283799698,544,681,283799154,283799698
18118,5,12,149,5745,-65,-97,32,f2:da:61:dd:98:c5,283800278,268,312,283800010,283800278
18119,5,12,149,5745,-62,-97,35,5e:29:73:5b:30:00,283809607,540,8789,283809067,283809607
18120,5,12,149,5745,-60,-97,37,0a:b9:b7:b1:4d:fa,283812147,268,2272,283811879,283812147
18121,5,12,149,5745,-67,-97,30,a6:92:ad:b7:76:65,283813147,484,516,283812663,283813147
18122,5,12,149,5745,-66,-97,31,b6:90:18:f6:b1:d4,283814786,268,1371,283814518,283814786
18123,5,12,149,5745,-62,-97,35,5e:29:73:5b:30:00,283824330,272,9272,283824058,283824330
18124,5,24,149,5745,-85,-97,12,,283826653,32,2291,283826621,283826653
18125,5,12,149,5745,-85,-97,12,9a:24:38:da:96:bb,283827418,272,493,283827146,283827418
18126,5,6,149,5745,-85,-97,12,54:e4:3a:ec:fb:65,283836815,360,9037,283836455,283836815
18127,5,24,149,5745,-86,-97,11,,283842254,32,5407,283842222,283842254
18128,5,24,149,5745,-86,-97,11,,283842505,28,223,283842477,283842505
18129,5,24,149,5745,-86,-97,11,,283842707,28,174,283842679,283842707
18130,5,24,149,5745,-86,-97,11,,283842842,28,107,283842814,283842842
18131,5,12,149,5745,-51,-97,46,3e:d1:9b:c7:a4:de,283852675,272,9561,283852403,283852675
18132,5,12,149,5745,-67,-97,30,9e:1f:b0:a7:b8:90,283854317,284,1358,283854033,283854317
18133,5,12,149,5745,-90,-97,7,7e:05:42:11:d2:ec,283858265,244,3704,283858021,283858265
18134,5,12,149,5745,-69,-97,28,72:d1:72:1d:22:a1,283861748,284,3199,283861464,283861748
18135,5,12,149,5745,-69,-97,28,22:ec:75:a8:8a:31,283865521,244,3529,283865277,283865521
18136,5,12,149,5745,-69,-97,28,56:68:e2:c2:8d:d5,283866312,280,511,283866032,283866312
18137,5,12,149,5745,-70,-97,27,0a:e1:ab:b3:c3:a6,283866863,268,283,283866595,283866863
18138,5,12,149,5745,-66,-97,31,f2:da:61:dd:98:c5,283868181,268,1050,283867913,283868181
18139,5,12,149,5745,-91,-97,6,7e:05:42:11:d2:ec,283877307,412,8714,283876895,283877307
18140,5,12,149,5745,-64,-97,33,5e:29:73:5b:30:00,283926990,272,49411,283926718,283926990
18141,5,24,149,5745,-84,-97,13,,283932343,28,5325,283932315,283932343
18142,5,24,149,5745,-83,-97,14,,283932390,28,19,283932362,283932390
18143,5,24,149,5745,-83,-97,14,,283932503,32,81,283932471,283932503
18144,5,6,149,5745,-84,-97,13,54:e4:3a:ec:fb:65,283939216,360,6353,283938856,283939216
18145,5,12,149,5745,-84,-97,13,9a:24:38:da:96:bb,283940500,272,1012,283940228,283940500
18146,5,12,149,5745,-64,-97,33,b6:90:18:f6:b1:d4,283963735,268,22967,283963467,283963735
18147,5,12,149,5745,-68,-97,29,72:d1:72:1d:22:a1,283964136,284,117,283963852,283964136
18148,5,12,149,5745,-52,-97,45,3e:d1:9b:c7:a4:de,283969761,272,5353,283969489,283969761
18149,5,12,149,5745,-90,-97,7,42:d2:d9:2b:ac:61,283976264,256,6247,283976008,283976264
18150,5,12,149,5745,-69,-97,28,56:68:e2:c2:8d:d5,283978123,280,1579,283977843,283978123
18151,5,12,149,5745,-69,-97,28,22:ec:75:a8:8a:31,283981294,244,2927,283981050,283981294
18152,5,24,149,5745,-84,-97,13,,284016770,32,35444,284016738,284016770
18153,5,24,149,5745,-83,-97,14,,284026249,32,9447,284026217,284026249
18154,5,24,149,5745,-85,-97,12,,284026685,32,404,284026653,284026685
18155,5,24,149,5745,-85,-97,12,,284027122,28,409,284027094,284027122
18156,5,24,149,5745,-82,-97,15,,284027168,28,18,284027140,284027168
18157,5,24,149,5745,-83,-97,14,,284027277,32,77,284027245,284027277
18158,5,12,149,5745,-72,-97,25,0a:e1:ab:b3:c3:a6,284035650,268,8105,284035382,284035650
18159,5,6,149,5745,-84,-97,13,54:e4:3a:ec:fb:65,284041616,360,5606,284041256,284041616
18160,5,12,149,5745,-70,-97,27,f2:da:61:dd:98:c5,284042389,268,505,284042121,284042389
18161,5,12,149,5745,-68,-97,29,9e:1f:b0:a7:b8:90,284042948,284,275,284042664,284042948
18162,5,12,149,5745,-62,-97,35,5e:29:73:5b:30:00,284044554,272,1334,284044282,284044554
18163,5,12,149,5745,-81,-97,16,9a:24:38:da:96:bb,284062700,272,17874,284062428,284062700
18164,5,12,149,5745,-65,-97,32,b6:90:18:f6:b1:d4,284066244,268,3276,284065976,284066244
18165,5,12,149,5745,-69,-97,28,72:d1:72:1d:22:a1,284066773,284,245,284066489,284066773
18166,5,12,149,5745,-92,-97,5,42:d2:d9:2b:ac:61,284078523,256,11494,284078267,284078523
18167,5,12,149,5745,-57,-97,40,3e:d1:9b:c7:a4:de,284082602,272,3807,284082330,284082602
18168,5,12,149,5745,-67,-97,30,22:ec:75:a8:8a:31,284092954,244,10108,284092710,284092954
18169,5,6,149,5745,-82,-97,15,34:7d:f6:81:74:23,284133047,164,39929,284132883,284133047
18170,5,12,149,5745,-74,-97,23,0a:e1:ab:b3:c3:a6,284138804,268,5489,284138536,284138804
18171,5,6,149,5745,-88,-97,9,54:e4:3a:ec:fb:65,284144017,360,4853,284143657,284144017
18172,5,12,149,5745,-73,-97,24,f2:da:61:dd:98:c5,284145021,268,736,284144753,284145021
18173,5,12,149,5745,-67,-97,30,9e:1f:b0:a7:b8:90,284145425,284,120,284145141,284145425
18174,5,24,149,5745,-85,-97,12,,284148947,32,3490,284148915,284148947
18175,5,24,149,5745,-85,-97,12,,284149303,28,328,284149275,284149303
18176,5,12,149,5745,-61,-97,36,5e:29:73:5b:30:00,284160403,272,10828,284160131,284160403
18177,5,12,149,5745,-69,-97,28,72:d1:72:1d:22:a1,284168400,284,7713,284168116,284168400
18178,5,12,149,5745,-64,-97,33,b6:90:18:f6:b1:d4,284168747,268,79,284168479,284168747
18179,5,12,149,5745,-70,-97,27,56:68:e2:c2:8d:d5,284169443,280,416,284169163,284169443
18180,5,12,149,5745,-91,-97,6,42:d2:d9:2b:ac:61,284181997,256,12298,284181741,284181997
18181,5,12,149,5745,-54,-97,43,3e:d1:9b:c7:a4:de,284194463,272,12194,284194191,284194463
18182,5,12,149,5745,-73,-97,24,0a:e1:ab:b3:c3:a6,284196557,268,1826,284196289,284196557
18183,5,12,149,5745,-68,-97,29,9e:1f:b0:a7:b8:90,284197104,284,263,284196820,284197104
18184,5,12,149,5745,-73,-97,24,f2:da:61:dd:98:c5,284200748,268,3376,284200480,284200748
18185,5,12,149,5745,-70,-97,27,56:68:e2:c2:8d:d5,284205083,280,4055,284204803,284205083
18186,5,12,149,5745,-67,-97,30,22:ec:75:a8:8a:31,284205827,244,500,284205583,284205827
18187,5,12,149,5745,-89,-97,8,9a:24:38:da:96:bb,284234381,272,28282,284234109,284234381
18188,5,12,149,5745,-70,-97,27,f6:0a:5c:59:72:df,284234807,280,146,284234527,284234807
18189,5,12,149,5745,-69,-97,28,72:d1:72:1d:22:a1,284235905,284,814,284235621,284235905
18190,5,12,149,5745,-91,-97,6,42:d2:d9:2b:ac:61,284237604,256,1443,284237348,284237604
18191,5,6,149,5745,-87,-97,10,54:e4:3a:ec:fb:65,284246417,360,8453,284246057,284246417
18192,5,12,149,5745,-65,-97,32,b6:90:18:f6:b1:d4,284248974,268,2289,284248706,284248974
18193,5,12,149,5745,-72,-97,25,0a:e1:ab:b3:c3:a6,284251761,268,2519,284251493,284251761
18194,5,12,149,5745,-69,-97,28,9e:1f:b0:a7:b8:90,284252371,452,158,284251919,284252371
18195,5,12,149,5745,-66,-97,31,22:ec:75:a8:8a:31,284254268,516,1381,284253752,284254268
18196,5,12,149,5745,-52,-97,45,3e:d1:9b:c7:a4:de,284256609,544,1797,284256065,284256609
18197,5,12,149,5745,-70,-97,27,f6:0a:5c:59:72:df,284260771,476,3686,284260295,284260771
18198,5,12,149,5745,-69,-97,28,f2:da:61:dd:98:c5,284261335,268,296,284261067,284261335
18199,5,12,149,5745,-72,-97,25,56:68:e2:c2:8d:d5,284262006,476,195,284261530,284262006
18200,5,12,149,5745,-65,-97,32,5e:29:73:5b:30:00,284268096,540,5550,284267556,284268096
18201,5,12,149,5745,-68,-97,29,72:d1:72:1d:22:a1,284274395,480,5819,284273915,284274395
18202,5,12,149,5745,-66,-97,31,b6:90:18:f6:b1:d4,284275244,268,581,284274976,284275244
18203,5,12,149,5745,-88,-97,9,9a:24:38:da:96:bb,284276953,272,1437,284276681,284276953
18204,5,12,149,5745,-64,-97,33,5e:29:73:5b:30:00,284283135,272,5910,284282863,284283135
18205,5,12,149,5745,-72,-97,25,0a:e1:ab:b3:c3:a6,284298877,268,15474,284298609,284298877
18206,5,12,149,5745,-67,-97,30,f2:da:61:dd:98:c5,284299702,268,557,284299434,284299702
18207,5,12,149,5745,-66,-97,31,9e:1f:b0:a7:b8:90,284300006,284,20,284299722,284300006
18208,5,12,149,5745,-55,-97,42,3e:d1:9b:c7:a4:de,284314392,272,14114,284314120,284314392
18209,5,12,149,5745,-73,-97,24,56:68:e2:c2:8d:d5,284314933,280,261,284314653,284314933
18210,5,12,149,5745,-71,-97,26,0a:e1:ab:b3:c3:a6,284315555,268,354,284315287,284315555
18211,5,12,149,5745,-67,-97,30,9e:1f:b0:a7:b8:90,284316750,452,743,284316298,284316750
18212,5,12,149,5745,-66,-97,31,22:ec:75:a8:8a:31,284319683,516,2417,284319167,284319683
18213,5,12,149,5745,-76,-97,21,d2:00:04:7e:2c:ab,284320451,440,328,284320011,284320451
18214,5,12,149,5745,-55,-97,42,3e:d1:9b:c7:a4:de,284321691,544,696,284321147,284321691
18215,5,12,149,5745,-67,-97,30,9e:1f:b0:a7:b8:90,284322397,152,554,284322245,284322397
18216,5,12,149,5745,-85,-97,12,9a:24:38:da:96:bb,284322602,824,-619,284321778,284322602
18217,5,24,149,5745,-85,-97,12,,284325034,28,2404,284325006,284325034
18218,5,12,149,5745,-68,-97,29,f2:da:61:dd:98:c5,284325079,268,-223,284324811,284325079
18219,5,12,149,5745,-72,-97,25,f6:0a:5c:59:72:df,284325360,476,-195,284324884,284325360
18220,5,12,149,5745,-52,-97,45,0a:b9:b7:b1:4d:fa,284326880,132,1388,284326748,284326880
18221,5,12,149,5745,-73,-97,24,56:68:e2:c2:8d:d5,284327128,476,-228,284326652,284327128
18222,5,12,149,5745,-90,-97,7,7e:05:42:11:d2:ec,284327612,360,124,284327252,284327612
18223,5,12,149,5745,-66,-97,31,22:ec:75:a8:8a:31,284329852,244,1996,284329608,284329852
18224,5,12,149,5745,-66,-97,31,72:d1:72:1d:22:a1,284331463,284,1327,284331179,284331463
18225,5,12,149,5745,-63,-97,34,5e:29:73:5b:30:00,284333690,540,1687,284333150,284333690
18226,5,24,149,5745,-87,-97,10,,284334969,28,1251,284334941,284334969
18227,5,24,149,5745,-85,-97,12,,284335012,28,15,284334984,284335012
18228,5,24,149,5745,-85,-97,12,,284335121,32,77,284335089,284335121
18229,5,12,149,5745,-52,-97,45,0a:b9:b7:b1:4d:fa,284335187,268,-202,284334919,284335187
18230,5,12,149,5745,-66,-97,31,a6:92:ad:b7:76:65,284336848,484,1177,284336364,284336848
18231,5,12,149,5745,-93,-97,4,42:d2:d9:2b:ac:61,284337427,452,127,284336975,284337427
18232,5,12,149,5745,-64,-97,33,b6:90:18:f6:b1:d4,284337913,268,218,284337645,284337913
18233,5,12,149,5745,-66,-97,31,72:d1:72:1d:22:a1,284338343,480,-50,284337863,284338343
18234,5,12,149,5745,-91,-97,6,7e:05:42:11:d2:ec,284340853,440,2070,284340413,284340853
18235,5,12,149,5745,-72,-97,25,f6:0a:5c:59:72:df,284346859,280,5726,284346579,284346859
18236,5,12,149,5745,-92,-97,5,42:d2:d9:2b:ac:61,284348639,256,1524,284348383,284348639
18237,5,6,149,5745,-88,-97,9,54:e4:3a:ec:fb:65,284348927,360,-72,284348567,284348927
18238,5,12,149,5745,-63,-97,34,b6:90:18:f6:b1:d4,284364004,268,14809,284363736,284364004
18239,5,12,149,5745,-72,-97,25,0a:e1:ab:b3:c3:a6,284380488,268,16216,284380220,284380488
18240,5,12,149,5745,-62,-97,35,5e:29:73:5b:30:00,284389366,272,8606,284389094,284389366
18241,5,12,149,5745,-89,-97,8,9a:24:38:da:96:bb,284390039,272,401,284389767,284390039
18242,5,12,149,5745,-74,-97,23,0a:e1:ab:b3:c3:a6,284412944,268,22637,284412676,284412944
18243,5,12,149,5745,-63,-97,34,9e:1f:b0:a7:b8:90,284421811,284,8583,284421527,284421811
18244,5,12,149,5745,-52,-97,45,3e:d1:9b:c7:a4:de,284422839,272,756,284422567,284422839
18245,5,12,149,5745,-69,-97,28,f2:da:61:dd:98:c5,284426436,268,3329,284426168,284426436
18246,5,12,149,5745,-72,-97,25,56:68:e2:c2:8d:d5,284431166,280,4450,284430886,284431166
18247,5,12,149,5745,-65,-97,32,22:ec:75:a8:8a:31,284433819,244,2409,284433575,284433819
18248,5,12,149,5745,-73,-97,24,0a:e1:ab:b3:c3:a6,284445987,268,11900,284445719,284445987
18249,5,6,149,5745,-84,-97,13,54:e4:3a:ec:fb:65,284451219,360,4872,284450859,284451219
18250,5,12,149,5745,-72,-97,25,72:d1:72:1d:22:a1,284458589,284,7086,284458305,284458589
18251,5,12,149,5745,-59,-97,38,fa:44:8d:e1:c7:1b,284475209,272,16348,284474937,284475209
18252,5,24,149,5745,-89,-97,8,,284481085,28,5848,284481057,284481085
18253,5,24,149,5745,-85,-97,12,,284481128,28,15,284481100,284481128
18254,5,24,149,5745,-88,-97,9,,284481237,32,77,284481205,284481237
18255,5,12,149,5745,-66,-97,31,b6:90:18:f6:b1:d4,284484376,268,2871,284484108,284484376
18256,5,12,149,5745,-91,-97,6,42:d2:d9:2b:ac:61,284488238,256,3606,284487982,284488238
18257,5,12,149,5745,-82,-97,15,9a:24:38:da:96:bb,284505727,272,17217,284505455,284505727
18258,5,12,149,5745,-65,-97,32,5e:29:73:5b:30:00,284506643,272,644,284506371,284506643
18259,5,24,149,5745,-88,-97,9,,284508991,28,2320,284508963,284508991
18260,5,24,149,5745,-88,-97,9,,284509035,28,16,284509007,284509035
18261,5,24,149,5745,-88,-97,9,,284509142,32,75,284509110,284509142
18262,5,12,149,5745,-72,-97,25,0a:e1:ab:b3:c3:a6,284511584,268,2174,284511316,284511584
18263,5,24,149,5745,-89,-97,8,,284512022,28,410,284511994,284512022
18264,5,24,149,5745,-87,-97,10,,284512066,28,16,284512038,284512066
18265,5,24,149,5745,-86,-97,11,,284512174,32,76,284512142,284512174
18266,5,12,149,5745,-70,-97,27,0a:e1:ab:b3:c3:a6,284527652,268,15210,284527384,284527652
18267,5,24,149,5745,-89,-97,8,,284530781,28,3101,284530753,284530781
18268,5,24,149,5745,-88,-97,9,,284530825,28,16,284530797,284530825
18269,5,24,149,5745,-88,-97,9,,284530933,32,76,284530901,284530933
18270,5,12,149,5745,-49,-97,48,3e:d1:9b:c7:a4:de,284534085,272,2880,284533813,284534085
18271,5,24,149,5745,-88,-97,9,,284549240,28,15127,284549212,284549240
18272,5,24,149,5745,-87,-97,10,,284549285,28,17,284549257,284549285
18273,5,24,149,5745,-87,-97,10,,284549392,32,75,284549360,284549392
18274,5,12,149,5745,-64,-97,33,22:ec:75:a8:8a:31,284551863,244,2227,284551619,284551863
18275,5,6,149,5745,-85,-97,12,54:e4:3a:ec:fb:65,284553619,360,1396,284553259,284553619
18276,5,12,149,5745,-67,-97,30,f2:da:61:dd:98:c5,284554392,268,505,284554124,284554392
18277,5,12,149,5745,-66,-97,31,9e:1f:b0:a7:b8:90,284554804,284,128,284554520,284554804
18278,5,12,149,5745,-72,-97,25,72:d1:72:1d:22:a1,284571684,284,16596,284571400,284571684
18279,5,12,149,5745,-61,-97,36,fa:44:8d:e1:c7:1b,284577702,272,5746,284577430,284577702
18280,5,12,149,5745,-70,-97,27,56:68:e2:c2:8d:d5,284578961,280,979,284578681,284578961
18281,5,12,149,5745,-92,-97,5,42:d2:d9:2b:ac:61,284591675,256,12458,284591419,284591675
18282,5,12,149,5745,-67,-97,30,f6:0a:5c:59:72:df,284592327,280,372,284592047,284592327
18283,5,12,149,5745,-66,-97,31,b6:90:18:f6:b1:d4,284594222,268,1627,284593954,284594222
18284,5,12,149,5745,-86,-97,11,9a:24:38:da:96:bb,284614330,272,19836,284614058,284614330
18285,5,12,149,5745,-64,-97,33,5e:29:73:5b:30:00,284623708,272,9106,284623436,284623708
18286,5,12,149,5745,-69,-97,28,0a:e1:ab:b3:c3:a6,284645542,268,21566,284645274,284645542
18287,5,12,149,5745,-50,-97,47,3e:d1:9b:c7:a4:de,284652102,272,6288,284651830,284652102
18288,5,6,149,5745,-87,-97,10,54:e4:3a:ec:fb:65,284656019,360,3557,284655659,284656019
18289,5,12,149,5745,-70,-97,27,f2:da:61:dd:98:c5,284656783,268,496,284656515,284656783
18290,5,12,149,5745,-67,-97,30,9e:1f:b0:a7:b8:90,284657221,284,154,284656937,284657221
18291,5,12,149,5745,-65,-97,32,22:ec:75:a8:8a:31,284668948,244,11483,284668704,284668948
18292,5,12,149,5745,-62,-97,35,fa:44:8d:e1:c7:1b,284680368,272,11148,284680096,284680368
18293,5,12,149,5745,-70,-97,27,56:68:e2:c2:8d:d5,284682535,280,1887,284682255,284682535
18294,5,12,149,5745,-70,-97,27,72:d1:72:1d:22:a1,284684750,284,1931,284684466,284684750
18295,5,12,149,5745,-68,-97,29,f6:0a:5c:59:72:df,284692119,280,7089,284691839,284692119
18296,5,12,149,5745,-91,-97,6,42:d2:d9:2b:ac:61,284695625,256,3250,284695369,284695625
18297,5,12,149,5745,-66,-97,31,0a:e1:ab:b3:c3:a6,284709452,268,13559,284709184,284709452
18298,5,12,149,5745,-67,-97,30,9e:1f:b0:a7:b8:90,284711406,452,1502,284710954,284711406
18299,5,12,149,5745,-67,-97,30,9e:1f:b0:a7:b8:90,284715908,152,4350,284715756,284715908
18300,5,12,149,5745,-65,-97,32,22:ec:75:a8:8a:31,284716140,516,-284,284715624,284716140
18301,5,12,149,5745,-53,-97,44,3e:d1:9b:c7:a4:de,284717713,544,1029,284717169,284717713
18302,5,12,149,5745,-62,-97,35,fa:44:8d:e1:c7:1b,284718339,436,190,284717903,284718339
18303,5,12,149,5745,-74,-97,23,f2:da:61:dd:98:c5,284719475,268,868,284719207,284719475
18304,5,12,149,5745,-68,-97,29,f6:0a:5c:59:72:df,284720132,476,181,284719656,284720132
18305,5,12,149,5745,-72,-97,25,56:68:e2:c2:8d:d5,284722181,476,1573,284721705,284722181
18306,5,12,149,5745,-84,-97,13,9a:24:38:da:96:bb,284725482,272,3029,284725210,284725482
18307,5,12,149,5745,-65,-97,32,5e:29:73:5b:30:00,284728875,540,2853,284728335,284728875
18308,5,12,149,5745,-63,-97,34,a6:92:ad:b7:76:65,284729575,484,216,284729091,284729575
18309,5,12,149,5745,-68,-97,29,0a:e1:ab:b3:c3:a6,284731202,132,1495,284731070,284731202
18310,5,12,149,5745,-74,-97,23,72:d1:72:1d:22:a1,284731628,480,-54,284731148,284731628
18311,5,12,149,5745,-90,-97,7,42:d2:d9:2b:ac:61,284732374,452,294,284731922,284732374
18312,5,12,149,5745,-64,-97,33,5e:29:73:5b:30:00,284741877,272,9231,284741605,284741877
18313,5,24,149,5745,-86,-97,11,,284753859,32,11950,284753827,284753859
18314,5,12,149,5745,-70,-97,27,0a:e1:ab:b3:c3:a6,284757645,268,3518,284757377,284757645
18315,5,12,149,5745,-71,-97,26,56:68:e2:c2:8d:d5,284758200,280,275,284757920,284758200
18316,5,12,149,5745,-74,-97,23,f2:da:61:dd:98:c5,284758532,268,64,284758264,284758532
18317,5,12,149,5745,-64,-97,33,9e:1f:b0:a7:b8:90,284758836,284,20,284758552,284758836
18318,5,12,149,5745,-50,-97,47,3e:d1:9b:c7:a4:de,284765418,272,6310,284765146,284765418
18319,5,24,149,5745,-86,-97,11,,284771842,28,6396,284771814,284771842
18320,5,24,149,5745,-86,-97,11,,284771886,28,16,284771858,284771886
18321,5,24,149,5745,-86,-97,11,,284771994,32,76,284771962,284771994
18322,5,12,149,5745,-71,-97,26,0a:e1:ab:b3:c3:a6,284773704,268,1442,284773436,284773704
18323,5,12,149,5745,-66,-97,31,22:ec:75:a8:8a:31,284781899,244,7951,284781655,284781899
18324,5,12,149,5745,-73,-97,24,f2:da:61:dd:98:c5,284783077,268,910,284782809,284783077
18325,5,12,149,5745,-61,-97,36,fa:44:8d:e1:c7:1b,284784108,412,619,284783696,284784108
18326,5,12,149,5745,-61,-97,36,fa:44:8d:e1:c7:1b,284790494,244,6142,284790250,284790494
18327,5,12,149,5745,-62,-97,35,a6:92:ad:b7:76:65,284798294,484,7316,284797810,284798294
18328,5,12,149,5745,-89,-97,8,42:d2:d9:2b:ac:61,284812368,256,13818,284812112,284812368
18329,5,12,149,5745,-61,-97,36,a6:92:ad:b7:76:65,284823950,284,11298,284823666,284823950
18330,5,12,149,5745,-86,-97,11,9a:24:38:da:96:bb,284837142,272,12920,284836870,284837142
18331,5,12,149,5745,-66,-97,31,0a:e1:ab:b3:c3:a6,284839284,268,1874,284839016,284839284
18332,5,12,149,5745,-72,-97,25,d2:00:04:7e:2c:ab,284842242,440,2518,284841802,284842242
18333,5,12,149,5745,-61,-97,36,fa:44:8d:e1:c7:1b,284842991,440,309,284842551,284842991
18334,5,12,149,5745,-49,-97,48,3e:d1:9b:c7:a4:de,284848057,544,4522,284847513,284848057
18335,5,12,149,5745,-72,-97,25,f2:da:61:dd:98:c5,284848637,268,312,284848369,284848637
18336,5,12,149,5745,-88,-97,9,9a:24:38:da:96:bb,284849231,824,-230,284848407,284849231
18337,5,12,149,5745,-64,-97,33,22:ec:75:a8:8a:31,284851947,516,2200,284851431,284851947
18338,5,12,149,5745,-91,-97,6,7e:05:42:11:d2:ec,284852516,440,129,284852076,284852516
18339,5,12,149,5745,-67,-97,30,0a:e1:ab:b3:c3:a6,284855593,268,2809,284855325,284855593
18340,5,12,149,5745,-66,-97,31,5e:29:73:5b:30:00,284856733,272,868,284856461,284856733
18341,5,12,149,5745,-65,-97,32,b6:90:18:f6:b1:d4,284858039,268,1038,284857771,284858039
18342,5,12,149,5745,-66,-97,31,5e:29:73:5b:30:00,284859439,540,860,284858899,284859439
18343,5,12,149,5745,-54,-97,43,0a:b9:b7:b1:4d:fa,284860023,268,316,284859755,284860023
18344,5,6,149,5745,-84,-97,13,54:e4:3a:ec:fb:65,284860840,360,457,284860480,284860840
18345,5,12,149,5745,-62,-97,35,a6:92:ad:b7:76:65,284863834,484,2510,284863350,284863834
18346,5,12,149,5745,-74,-97,23,f2:da:61:dd:98:c5,284872704,268,8602,284872436,284872704
18347,5,12,149,5745,-67,-97,30,9e:1f:b0:a7:b8:90,284873995,284,1007,284873711,284873995
18348,5,12,149,5745,-72,-97,25,56:68:e2:c2:8d:d5,284886264,280,11989,284885984,284886264
18349,5,12,149,5745,-49,-97,48,3e:d1:9b:c7:a4:de,284888712,272,2176,284888440,284888712
18350,5,12,149,5745,-66,-97,31,22:ec:75:a8:8a:31,284896162,244,7206,284895918,284896162
18351,5,12,149,5745,-73,-97,24,0a:e1:ab:b3:c3:a6,284904756,268,8326,284904488,284904756
18352,5,12,149,5745,-60,-97,37,fa:44:8d:e1:c7:1b,284905077,244,77,284904833,284905077
18353,5,12,149,5745,-92,-97,5,42:d2:d9:2b:ac:61,284914786,256,9453,284914530,284914786
18354,5,12,149,5745,-59,-97,38,fa:44:8d:e1:c7:1b,284923988,440,8762,284923548,284923988
18355,5,12,149,5745,-62,-97,35,a6:92:ad:b7:76:65,284944504,284,20232,284944220,284944504
18356,5,12,149,5745,-84,-97,13,9a:24:38:da:96:bb,284950093,272,5317,284949821,284950093
18357,5,6,149,5745,-87,-97,10,54:e4:3a:ec:fb:65,284963221,360,12768,284962861,284963221
18358,5,12,149,5745,-64,-97,33,5e:29:73:5b:30:00,284965151,272,1658,284964879,284965151
18359,5,12,149,5745,-71,-97,26,0a:e1:ab:b3:c3:a6,284969923,268,4504,284969655,284969923
18360,5,12,149,5745,-71,-97,26,0a:e1:ab:b3:c3:a6,284970288,268,97,284970020,284970288
18361,5,24,149,5745,-90,-97,7,,284977895,28,7579,284977867,284977895
18362,5,24,149,5745,-84,-97,13,,284977939,28,16,284977911,284977939
18363,5,24,149,5745,-84,-97,13,,284978048,32,77,284978016,284978048
18364,5,12,149,5745,-69,-97,28,56:68:e2:c2:8d:d5,284988143,280,9815,284987863,284988143
18365,5,24,149,5745,-84,-97,13,,284992444,32,4269,284992412,284992444
18366,5,12,149,5745,-56,-97,41,3e:d1:9b:c7:a4:de,284995320,272,2604,284995048,284995320
18367,5,24,149,5745,-85,-97,12,,284998116,28,2768,284998088,284998116
18368,5,24,149,5745,-90,-97,7,,284998268,32,120,284998236,284998268
18369,5,24,149,5745,-84,-97,13,,285006292,32,7992,285006260,285006292
18370,5,24,149,5745,-84,-97,13,,285006660,28,340,285006632,285006660
18371,5,12,149,5745,-67,-97,30,22:ec:75:a8:8a:31,285013357,244,6453,285013113,285013357
18372,5,12,149,5745,-74,-97,23,0a:e1:ab:b3:c3:a6,285035793,268,22168,285035525,285035793
18373,5,12,149,5745,-68,-97,29,f6:0a:5c:59:72:df,285048991,280,12918,285048711,285048991
18374,5,6,149,5745,-88,-97,9,54:e4:3a:ec:fb:65,285065622,360,16271,285065262,285065622
18375,5,12,149,5745,-70,-97,27,f2:da:61:dd:98:c5,285066529,268,639,285066261,285066529
18376,5,12,149,5745,-65,-97,32,9e:1f:b0:a7:b8:90,285067019,284,206,285066735,285067019
18377,5,12,149,5745,-65,-97,32,5e:29:73:5b:30:00,285082204,272,14913,285081932,285082204
18378,5,12,149,5745,-69,-97,28,0a:e1:ab:b3:c3:a6,285085085,268,2613,285084817,285085085
18379,5,12,149,5745,-64,-97,33,a6:92:ad:b7:76:65,285088817,284,3448,285088533,285088817
18380,5,12,149,5745,-62,-97,35,fa:44:8d:e1:c7:1b,285089826,244,765,285089582,285089826
18381,5,12,149,5745,-87,-97,10,42:d2:d9:2b:ac:61,285102596,256,12514,285102340,285102596
18382,5,12,149,5745,-70,-97,27,56:68:e2:c2:8d:d5,285108445,280,5569,285108165,285108445
18383,5,12,149,5745,-56,-97,41,3e:d1:9b:c7:a4:de,285111026,272,2309,285110754,285111026
18384,5,12,149,5745,-72,-97,25,22:ec:75:a8:8a:31,285127187,244,15917,285126943,285127187
18385,5,6,149,5745,-86,-97,11,54:e4:3a:ec:fb:65,285168154,360,40607,285167794,285168154
18386,5,12,149,5745,-72,-97,25,f2:da:61:dd:98:c5,285168800,268,378,285168532,285168800
18387,5,12,149,5745,-65,-97,32,9e:1f:b0:a7:b8:90,285170874,284,1790,285170590,285170874
18388,5,12,149,5745,-82,-97,15,9a:24:38:da:96:bb,285177738,272,6592,285177466,285177738
18389,5,12,149,5745,-63,-97,34,a6:92:ad:b7:76:65,285191137,284,13115,285190853,285191137
18390,5,12,149,5745,-63,-97,34,fa:44:8d:e1:c7:1b,285192222,244,841,285191978,285192222
18391,5,12,149,5745,-65,-97,32,5e:29:73:5b:30:00,285199257,272,6763,285198985,285199257
18392,5,24,149,5745,-89,-97,8,,285203373,28,4088,285203345,285203373
18393,5,24,149,5745,-89,-97,8,,285203481,32,76,285203449,285203481
18394,5,12,149,5745,-91,-97,6,42:d2:d9:2b:ac:61,285205471,256,1734,285205215,285205471
18395,5,6,149,5745,-91,-97,6,78:ba:f9:d6:f1:d0,285208980,168,3341,285208812,285208980
18396,5,6,149,5745,-92,-97,5,78:ba:f9:d6:f1:d0,285216433,132,7321,285216301,285216433
18397,5,24,149,5745,-89,-97,8,,285221623,28,5162,285221595,285221623
18398,5,24,149,5745,-89,-97,8,,285221667,28,16,285221639,285221667
18399,5,12,149,5745,-54,-97,43,3e:d1:9b:c7:a4:de,285222945,272,1006,285222673,285222945
18400,5,12,149,5745,-70,-97,27,56:68:e2:c2:8d:d5,285225250,280,2025,285224970,285225250
18401,5,12,149,5745,-64,-97,33,fa:44:8d:e1:c7:1b,285243088,244,17594,285242844,285243088
18402,5,12,149,5745,-91,-97,6,42:d2:d9:2b:ac:61,285257708,256,14364,285257452,285257708
18403,5,12,149,5745,-72,-97,25,0a:e1:ab:b3:c3:a6,285265002,268,7026,285264734,285265002
18404,5,6,149,5745,-84,-97,13,54:e4:3a:ec:fb:65,285270423,360,5061,285270063,285270423
18405,5,12,149,5745,-70,-97,27,f2:da:61:dd:98:c5,285270900,268,209,285270632,285270900
18406,5,12,149,5745,-66,-97,31,9e:1f:b0:a7:b8:90,285271656,284,472,285271372,285271656
18407,5,12,149,5745,-62,-97,35,a6:92:ad:b7:76:65,285282017,284,10077,285281733,285282017
18408,5,12,149,5745,-84,-97,13,9a:24:38:da:96:bb,285285378,272,3089,285285106,285285378
18409,5,12,149,5745,-66,-97,31,9e:1f:b0:a7:b8:90,285299735,452,13905,285299283,285299735
18410,5,12,149,5745,-62,-97,35,a6:92:ad:b7:76:65,285304847,484,4628,285304363,285304847
18411,5,12,149,5745,-70,-97,27,f2:da:61:dd:98:c5,285307246,268,2131,285306978,285307246
18412,5,12,149,5745,-74,-97,23,0a:e1:ab:b3:c3:a6,285307604,268,90,285307336,285307604
18413,5,12,149,5745,-56,-97,41,3e:d1:9b:c7:a4:de,285309238,544,1090,285308694,285309238
18414,5,12,149,5745,-71,-97,26,f6:0a:5c:59:72:df,285310734,476,1020,285310258,285310734
18415,5,12,149,5745,-68,-97,29,22:ec:75:a8:8a:31,285313434,516,2184,285312918,285313434
18416,5,12,149,5745,-73,-97,24,0a:e1:ab:b3:c3:a6,285313984,268,282,285313716,285313984
18417,5,12,149,5745,-70,-97,27,56:68:e2:c2:8d:d5,285314339,476,-121,285313863,285314339
18418,5,12,149,5745,-70,-97,27,56:68:e2:c2:8d:d5,285314832,280,213,285314552,285314832
18419,5,12,149,5745,-66,-97,31,9e:1f:b0:a7:b8:90,285315155,284,39,285314871,285315155
18420,5,12,149,5745,-71,-97,26,f2:da:61:dd:98:c5,285315475,268,52,285315207,285315475
18421,5,12,149,5745,-66,-97,31,5e:29:73:5b:30:00,285316416,540,401,285315876,285316416
18422,5,12,149,5745,-66,-97,31,fa:44:8d:e1:c7:1b,285320751,440,3895,285320311,285320751
18423,5,12,149,5745,-65,-97,32,5e:29:73:5b:30:00,285331755,272,10732,285331483,285331755
18424,5,12,149,5745,-54,-97,43,3e:d1:9b:c7:a4:de,285347800,272,15773,285347528,285347800
18425,5,12,149,5745,-67,-97,30,fa:44:8d:e1:c7:1b,285348108,244,64,285347864,285348108
18426,5,12,149,5745,-71,-97,26,56:68:e2:c2:8d:d5,285362735,476,14151,285362259,285362735
18427,5,12,149,5745,-83,-97,14,9a:24:38:da:96:bb,285364397,824,838,285363573,285364397
18428,5,12,149,5745,-66,-97,31,9e:1f:b0:a7:b8:90,285365282,452,433,285364830,285365282
18429,5,12,149,5745,-72,-97,25,0a:e1:ab:b3:c3:a6,285365770,268,220,285365502,285365770
18430,5,12,149,5745,-71,-97,26,72:d1:72:1d:22:a1,285368453,480,2203,285367973,285368453
18431,5,12,149,5745,-72,-97,25,f6:0a:5c:59:72:df,285368976,280,243,285368696,285368976
18432,5,12,149,5745,-62,-97,35,a6:92:ad:b7:76:65,285370219,484,759,285369735,285370219
18433,5,12,149,5745,-74,-97,23,f6:0a:5c:59:72:df,285371786,280,1287,285371506,285371786
18434,5,12,149,5745,-71,-97,26,f2:da:61:dd:98:c5,285372190,132,272,285372058,285372190
18435,5,6,149,5745,-83,-97,14,54:e4:3a:ec:fb:65,285372847,360,297,285372487,285372847
18436,5,12,149,5745,-53,-97,44,3e:d1:9b:c7:a4:de,285374220,544,829,285373676,285374220
18437,5,12,149,5745,-67,-97,30,fa:44:8d:e1:c7:1b,285376729,104,2405,285376625,285376729
18438,5,12,149,5745,-66,-97,31,fa:44:8d:e1:c7:1b,285376904,360,-185,285376544,285376904
18439,5,12,149,5745,-62,-97,35,a6:92:ad:b7:76:65,285380780,284,3592,285380496,285380780
18440,5,12,149,5745,-66,-97,31,b6:90:18:f6:b1:d4,285382234,268,1186,285381966,285382234
18441,5,12,149,5745,-71,-97,26,f2:da:61:dd:98:c5,285383022,268,520,285382754,285383022
18442,5,12,149,5745,-67,-97,30,fa:44:8d:e1:c7:1b,285383684,440,222,285383244,285383684
18443,5,12,149,5745,-74,-97,23,f6:0a:5c:59:72:df,285384248,476,88,285383772,285384248
18444,5,12,149,5745,-90,-97,7,42:d2:d9:2b:ac:61,285386147,452,1447,285385695,285386147
18445,5,12,149,5745,-56,-97,41,0a:b9:b7:b1:4d:fa,285390375,268,3960,285390107,285390375
18446,5,12,149,5745,-82,-97,15,9a:24:38:da:96:bb,285401203,272,10556,285400931,285401203
18447,5,24,149,5745,-88,-97,9,,285428261,28,27030,285428233,285428261
18448,5,24,149,5745,-87,-97,10,,285428305,28,16,285428277,285428305
18449,5,24,149,5745,-87,-97,10,,285428414,32,77,285428382,285428414
18450,5,12,149,5745,-65,-97,32,5e:29:73:5b:30:00,285428805,272,119,285428533,285428805
18451,5,12,149,5745,-70,-97,27,0a:e1:ab:b3:c3:a6,285440318,268,11245,285440050,285440318
18452,5,12,149,5745,-69,-97,28,f2:da:61:dd:98:c5,285444571,268,3985,285444303,285444571
18453,5,24,149,5745,-87,-97,10,,285446062,28,1463,285446034,285446062
18454,5,24,149,5745,-87,-97,10,,285446107,28,17,285446079,285446107
18455,5,24,149,5745,-87,-97,10,,285446215,32,76,285446183,285446215
18456,5,12,149,5745,-69,-97,28,9e:1f:b0:a7:b8:90,285446340,284,-159,285446056,285446340
18457,5,12,149,5745,-71,-97,26,56:68:e2:c2:8d:d5,285449028,280,2408,285448748,285449028
18458,5,12,149,5745,-67,-97,30,fa:44:8d:e1:c7:1b,285450442,440,974,285450002,285450442
18459,5,24,149,5745,-86,-97,11,,285451053,28,583,285451025,285451053
18460,5,24,149,5745,-77,-97,20,,285451097,28,16,285451069,285451097
18461,5,24,149,5745,-80,-97,17,,285451205,32,76,285451173,285451205
18462,5,24,149,5745,-80,-97,17,,285452481,28,1248,285452453,285452481
18463,5,24,149,5745,-85,-97,12,,285452525,28,16,285452497,285452525
18464,5,24,149,5745,-86,-97,11,,285452633,32,76,285452601,285452633
18465,5,12,149,5745,-54,-97,43,3e:d1:9b:c7:a4:de,285452699,272,-206,285452427,285452699
18466,5,24,149,5745,-79,-97,18,,285453032,28,305,285453004,285453032
18467,5,24,149,5745,-86,-97,11,,285453076,28,16,285453048,285453076
18468,5,24,149,5745,-86,-97,11,,285453184,32,76,285453152,285453184
18469,5,12,149,5745,-67,-97,30,fa:44:8d:e1:c7:1b,285461935,244,8507,285461691,285461935
18470,5,6,149,5745,-85,-97,12,54:e4:3a:ec:fb:65,285475224,360,12929,285474864,285475224
18471,5,12,149,5745,-91,-97,6,42:d2:d9:2b:ac:61,285483321,256,7841,285483065,285483321
18472,5,12,149,5745,-70,-97,27,f6:0a:5c:59:72:df,285494498,280,10897,285494218,285494498
18473,5,12,149,5745,-65,-97,32,a6:92:ad:b7:76:65,285508012,284,13230,285507728,285508012
18474,5,12,149,5745,-86,-97,11,9a:24:38:da:96:bb,285514225,272,5941,285513953,285514225
18475,5,24,149,5745,-84,-97,13,,285521240,32,6983,285521208,285521240
18476,5,24,149,5745,-77,-97,20,66:48:51:4e:71:fa,285521358,328,-210,285521030,285521358
18477,5,24,149,5745,-84,-97,13,,285521819,28,433,285521791,285521819
18478,5,24,149,5745,-78,-97,19,,285521863,28,16,285521835,285521863
18479,5,24,149,5745,-79,-97,18,,285521970,32,75,285521938,285521970
18480,5,24,149,5745,-78,-97,19,,285523268,28,1270,285523240,285523268
18481,5,24,149,5745,-83,-97,14,,285523312,28,16,285523284,285523312
18482,5,24,149,5745,-84,-97,13,,285523419,32,75,285523387,285523419
18483,5,12,149,5745,-64,-97,33,5e:29:73:5b:30:00,285546774,272,23083,285546502,285546774
18484,5,12,149,5745,-54,-97,43,3e:d1:9b:c7:a4:de,285569903,272,22857,285569631,285569903
18485,5,24,149,5745,-70,-97,27,,285572387,28,2456,285572359,285572387
18486,5,24,149,5745,-83,-97,14,,285572431,28,16,285572403,285572431
18487,5,24,149,5745,-83,-97,14,,285572539,28,80,285572511,285572539
18488,5,12,149,5745,-92,-97,5,7e:05:42:11:d2:ec,285573087,440,108,285572647,285573087
18489,5,24,149,5745,-84,-97,13,,285576755,28,3640,285576727,285576755
18490,5,6,149,5745,-84,-97,13,54:e4:3a:ec:fb:65,285577670,360,555,285577310,285577670
18491,5,12,149,5745,-69,-97,28,f2:da:61:dd:98:c5,285578575,268,637,285578307,285578575
18492,5,12,149,5745,-67,-97,30,9e:1f:b0:a7:b8:90,285579136,284,277,285578852,285579136
18493,5,24,149,5745,-83,-97,14,,285583726,32,4558,285583694,285583726
18494,5,24,149,5745,-78,-97,19,66:48:51:4e:71:fa,285583843,328,-211,285583515,285583843
18495,5,24,149,5745,-83,-97,14,,285584340,28,469,285584312,285584340
18496,5,24,149,5745,-78,-97,19,,285584384,28,16,285584356,285584384
18497,5,24,149,5745,-78,-97,19,,285584492,32,76,285584460,285584492
18498,5,12,149,5745,-68,-97,29,fa:44:8d:e1:c7:1b,285602200,244,17464,285601956,285602200
18499,5,12,149,5745,-71,-97,26,56:68:e2:c2:8d:d5,285604315,280,1835,285604035,285604315
18500,5,12,149,5745,-87,-97,10,42:d2:d9:2b:ac:61,285614594,256,10023,285614338,285614594
18501,5,12,149,5745,-62,-97,35,a6:92:ad:b7:76:65,285616830,284,1952,285616546,285616830
18502,5,12,149,5745,-82,-97,15,9a:24:38:da:96:bb,285629687,272,12585,285629415,285629687
18503,5,24,149,5745,-86,-97,11,,285654677,28,24962,285654649,285654677
18504,5,24,149,5745,-83,-97,14,,285654721,28,16,285654693,285654721
18505,5,24,149,5745,-84,-97,13,,285654829,32,76,285654797,285654829
18506,5,12,149,5745,-63,-97,34,5e:29:73:5b:30:00,285663847,272,8746,285663575,285663847
18507,5,24,149,5745,-84,-97,13,,285672490,28,8615,285672462,285672490
18508,5,24,149,5745,-86,-97,11,,285672534,28,16,285672506,285672534
18509,5,24,149,5745,-85,-97,12,,285672642,32,76,285672610,285672642
18510,5,12,149,5745,-72,-97,25,0a:e1:ab:b3:c3:a6,285673753,268,843,285673485,285673753
18511,5,6,149,5745,-85,-97,12,54:e4:3a:ec:fb:65,285680025,360,5912,285679665,285680025
18512,5,12,149,5745,-73,-97,24,f2:da:61:dd:98:c5,285680752,268,459,285680484,285680752
18513,5,12,149,5745,-67,-97,30,9e:1f:b0:a7:b8:90,285682712,284,1676,285682428,285682712
18514,5,12,149,5745,-55,-97,42,3e:d1:9b:c7:a4:de,285686232,272,3248,285685960,285686232
18515,5,12,149,5745,-67,-97,30,22:ec:75:a8:8a:31,285695739,244,9263,285695495,285695739
18516,5,12,149,5745,-67,-97,30,fa:44:8d:e1:c7:1b,285704654,244,8671,285704410,285704654
18517,5,12,149,5745,-70,-97,27,56:68:e2:c2:8d:d5,285705293,280,359,285705013,285705293
18518,5,12,149,5745,-87,-97,10,42:d2:d9:2b:ac:61,285716796,256,11247,285716540,285716796
18519,5,12,149,5745,-64,-97,33,a6:92:ad:b7:76:65,285734918,284,17838,285734634,285734918
18520,5,12,149,5745,-84,-97,13,9a:24:38:da:96:bb,285740829,272,5639,285740557,285740829
18521,5,12,149,5745,-70,-97,27,0a:e1:ab:b3:c3:a6,285756414,268,15317,285756146,285756414
18522,5,12,149,5745,-70,-97,27,0a:e1:ab:b3:c3:a6,285760136,268,3454,285759868,285760136
18523,5,12,149,5745,-85,-97,12,9a:24:38:da:96:bb,285760560,824,-400,285759736,285760560
18524,5,12,149,5745,-70,-97,27,56:68:e2:c2:8d:d5,285761450,476,414,285760974,285761450
18525,5,12,149,5745,-70,-97,27,72:d1:72:1d:22:a1,285761962,480,32,285761482,285761962
18526,5,12,149,5745,-65,-97,32,a6:92:ad:b7:76:65,285763439,484,993,285762955,285763439
18527,5,12,149,5745,-70,-97,27,f6:0a:5c:59:72:df,285766477,280,2758,285766197,285766477
18528,5,12,149,5745,-67,-97,30,22:ec:75:a8:8a:31,285767520,516,527,285767004,285767520
18529,5,12,149,5745,-53,-97,44,3e:d1:9b:c7:a4:de,285769495,544,1431,285768951,285769495
18530,5,12,149,5745,-66,-97,31,9e:1f:b0:a7:b8:90,285773053,284,3274,285772769,285773053
18531,5,12,149,5745,-70,-97,27,56:68:e2:c2:8d:d5,285773390,280,57,285773110,285773390
18532,5,12,149,5745,-71,-97,26,f2:da:61:dd:98:c5,285774829,268,1171,285774561,285774829
18533,5,12,149,5745,-66,-97,31,fa:44:8d:e1:c7:1b,285778459,440,3190,285778019,285778459
18534,5,12,149,5745,-66,-97,31,5e:29:73:5b:30:00,285781991,540,2992,285781451,285781991
18535,5,12,149,5745,-67,-97,30,9e:1f:b0:a7:b8:90,285782567,452,124,285782115,285782567
18536,5,6,149,5745,-85,-97,12,54:e4:3a:ec:fb:65,285783051,360,124,285782691,285783051
18537,5,12,149,5745,-66,-97,31,5e:29:73:5b:30:00,285790467,272,7144,285790195,285790467
18538,5,12,149,5745,-53,-97,44,3e:d1:9b:c7:a4:de,285806270,272,15531,285805998,285806270
18539,5,12,149,5745,-65,-97,32,fa:44:8d:e1:c7:1b,285806605,244,91,285806361,285806605
18540,5,12,149,5745,-69,-97,28,22:ec:75:a8:8a:31,285810635,244,3786,285810391,285810635
18541,5,12,149,5745,-63,-97,34,b6:90:18:f6:b1:d4,285821435,268,10532,285821167,285821435
18542,5,12,149,5745,-69,-97,28,f6:0a:5c:59:72:df,285830817,280,9102,285830537,285830817
18543,5,12,149,5745,-89,-97,8,42:d2:d9:2b:ac:61,285834263,260,3186,285834003,285834263
18544,5,12,149,5745,-68,-97,29,a6:92:ad:b7:76:65,285839519,284,4972,285839235,285839519
18545,5,12,149,5745,-71,-97,26,f2:da:61:dd:98:c5,285841764,268,1977,285841496,285841764
18546,5,12,149,5745,-62,-97,35,fa:44:8d:e1:c7:1b,285842255,440,51,285841815,285842255
18547,5,12,149,5745,-90,-97,7,7e:05:42:11:d2:ec,285843700,440,1005,285843260,285843700
18548,5,12,149,5745,-65,-97,32,5e:29:73:5b:30:00,285845205,540,965,285844665,285845205
18549,5,12,149,5745,-69,-97,28,a6:92:ad:b7:76:65,285845805,484,116,285845321,285845805
18550,5,12,149,5745,-62,-97,35,b6:90:18:f6:b1:d4,285871286,268,25213,285871018,285871286
18551,5,6,149,5745,-85,-97,12,54:e4:3a:ec:fb:65,285884826,360,13180,285884466,285884826
18552,5,12,149,5745,-62,-97,35,b6:90:18:f6:b1:d4,285886802,268,1708,285886534,285886802
18553,5,12,149,5745,-69,-97,28,0a:e1:ab:b3:c3:a6,285887743,268,673,285887475,285887743
18554,5,12,149,5745,-71,-97,26,f2:da:61:dd:98:c5,285889280,268,1269,285889012,285889280
18555,5,12,149,5745,-69,-97,28,0a:e1:ab:b3:c3:a6,285890429,268,881,285890161,285890429
18556,5,12,149,5745,-86,-97,11,9a:24:38:da:96:bb,285890852,824,-401,285890028,285890852
18557,5,12,149,5745,-69,-97,28,56:68:e2:c2:8d:d5,285897790,280,6658,285897510,285897790
18558,5,12,149,5745,-68,-97,29,9e:1f:b0:a7:b8:90,285898962,284,888,285898678,285898962
18559,5,12,149,5745,-52,-97,45,3e:d1:9b:c7:a4:de,285900135,544,629,285899591,285900135
18560,5,12,149,5745,-67,-97,30,22:ec:75:a8:8a:31,285901197,516,546,285900681,285901197
18561,5,12,149,5745,-89,-97,8,7e:05:42:11:d2:ec,285904003,440,2366,285903563,285904003
18562,5,12,149,5745,-66,-97,31,5e:29:73:5b:30:00,285905154,272,879,285904882,285905154
18563,5,12,149,5745,-71,-97,26,f2:da:61:dd:98:c5,285906929,268,1507,285906661,285906929
18564,5,12,149,5745,-61,-97,36,fa:44:8d:e1:c7:1b,285907384,440,15,285906944,285907384
18565,5,12,149,5745,-65,-97,32,5e:29:73:5b:30:00,285909732,540,1808,285909192,285909732
18566,5,12,149,5745,-68,-97,29,a6:92:ad:b7:76:65,285911696,484,1480,285911212,285911696
18567,5,12,149,5745,-72,-97,25,d2:00:04:7e:2c:ab,285912423,440,287,285911983,285912423
18568,5,12,149,5745,-58,-97,39,0a:b9:b7:b1:4d:fa,285916326,268,3635,285916058,285916326
18569,5,12,149,5745,-51,-97,46,3e:d1:9b:c7:a4:de,285920049,272,3451,285919777,285920049
18570,5,12,149,5745,-61,-97,36,fa:44:8d:e1:c7:1b,285920662,244,369,285920418,285920662
18571,5,12,149,5745,-61,-97,36,4a:86:35:36:74:b8,285926739,116,5961,285926623,285926739
18572,5,12,149,5745,-61,-97,36,4a:86:35:36:74:b8,285926979,104,136,285926875,285926979
18573,5,12,149,5745,-61,-97,36,4a:86:35:36:74:b8,285927225,116,130,285927109,285927225
18574,5,12,149,5745,-62,-97,35,4a:86:35:36:74:b8,285927403,104,74,285927299,285927403
18575,5,12,149,5745,-62,-97,35,4a:86:35:36:74:b8,285927649,152,94,285927497,285927649
18576,5,12,149,5745,-62,-97,35,4a:86:35:36:74:b8,285927863,152,62,285927711,285927863
18577,5,12,149,5745,-61,-97,36,4a:86:35:36:74:b8,285928121,104,154,285928017,285928121
18578,5,12,149,5745,-61,-97,36,4a:86:35:36:74:b8,285928340,152,67,285928188,285928340
18579,5,12,149,5745,-61,-97,36,4a:86:35:36:74:b8,285928545,152,53,285928393,285928545
18580,5,12,149,5745,-88,-97,9,42:d2:d9:2b:ac:61,285935310,260,6505,285935050,285935310
18581,5,12,149,5745,-68,-97,29,22:ec:75:a8:8a:31,285936435,244,881,285936191,285936435
18582,5,24,149,5745,-84,-97,13,,285962331,28,25868,285962303,285962331
18583,5,24,149,5745,-85,-97,12,,285962375,28,16,285962347,285962375
18584,5,24,149,5745,-85,-97,12,,285962484,32,77,285962452,285962484
18585,5,12,149,5745,-67,-97,30,a6:92:ad:b7:76:65,285964452,284,1684,285964168,285964452
18586,5,12,149,5745,-85,-97,12,9a:24:38:da:96:bb,285965195,272,471,285964923,285965195
18587,5,12,149,5745,-61,-97,36,fa:44:8d:e1:c7:1b,285973501,440,7866,285973061,285973501
18588,5,12,149,5745,-67,-97,30,5e:29:73:5b:30:00,285975784,540,1743,285975244,285975784
18589,5,6,149,5745,-86,-97,11,54:e4:3a:ec:fb:65,285987226,360,11082,285986866,285987226
18590,5,24,149,5745,-86,-97,11,,285990292,28,3038,285990264,285990292
18591,5,24,149,5745,-84,-97,13,,285990336,28,16,285990308,285990336
18592,5,24,149,5745,-83,-97,14,,285990444,32,76,285990412,285990444
18593,5,12,149,5745,-62,-97,35,b6:90:18:f6:b1:d4,285991973,268,1261,285991705,285991973
18594,5,24,149,5745,-83,-97,14,,285993229,28,1228,285993201,285993229
18595,5,24,149,5745,-86,-97,11,,285993274,28,17,285993246,285993274
18596,5,12,149,5745,-60,-97,37,4a:86:35:36:74:b8,286003454,268,9912,286003186,286003454
18597,5,12,149,5745,-69,-97,28,56:68:e2:c2:8d:d5,286009550,280,5816,286009270,286009550
18598,5,12,149,5745,-68,-97,29,5e:29:73:5b:30:00,286019889,272,10067,286019617,286019889
18599,5,12,149,5745,-50,-97,47,3e:d1:9b:c7:a4:de,286023740,272,3579,286023468,286023740
18600,5,12,149,5745,-62,-97,35,fa:44:8d:e1:c7:1b,286035204,244,11220,286034960,286035204
18601,5,12,149,5745,-68,-97,29,22:ec:75:a8:8a:31,286038945,244,3497,286038701,286038945
18602,5,12,149,5745,-69,-97,28,5e:29:73:5b:30:00,286041360,540,1875,286040820,286041360
18603,5,24,149,5745,-83,-97,14,,286078187,28,36799,286078159,286078187
18604,5,24,149,5745,-86,-97,11,,286078231,28,16,286078203,286078231
18605,5,24,149,5745,-86,-97,11,,286078340,32,77,286078308,286078340
18606,5,12,149,5745,-83,-97,14,9a:24:38:da:96:bb,286080288,272,1676,286080016,286080288
18607,5,6,149,5745,-89,-97,8,54:e4:3a:ec:fb:65,286089627,360,8979,286089267,286089627
18608,5,12,149,5745,-72,-97,25,f2:da:61:dd:98:c5,286090504,268,609,286090236,286090504
18609,5,24,149,5745,-85,-97,12,,286096379,28,5847,286096351,286096379
18610,5,24,149,5745,-83,-97,14,,286096424,28,17,286096396,286096424
18611,5,24,149,5745,-84,-97,13,,286096531,32,75,286096499,286096531
18612,5,12,149,5745,-67,-97,30,5e:29:73:5b:30:00,286106350,540,9279,286105810,286106350
18613,5,12,149,5745,-65,-97,32,a6:92:ad:b7:76:65,286112982,284,6348,286112698,286112982
18614,5,12,149,5745,-60,-97,37,b6:90:18:f6:b1:d4,286114123,268,873,286113855,286114123
18615,5,12,149,5745,-70,-97,27,56:68:e2:c2:8d:d5,286121856,280,7453,286121576,286121856
18616,5,12,149,5745,-92,-97,5,c6:71:4f:a2:d1:86,286125083,244,2983,286124839,286125083
18617,5,12,149,5745,-89,-97,8,42:d2:d9:2b:ac:61,286126506,260,1163,286126246,286126506
18618,5,12,149,5745,-67,-97,30,5e:29:73:5b:30:00,286135401,272,8623,286135129,286135401
18619,5,12,149,5745,-51,-97,46,3e:d1:9b:c7:a4:de,286140925,272,5252,286140653,286140925
18620,5,12,149,5745,-68,-97,29,22:ec:75:a8:8a:31,286152680,244,11511,286152436,286152680
18621,5,12,149,5745,-67,-97,30,f6:0a:5c:59:72:df,286165689,280,12729,286165409,286165689
18622,5,12,149,5745,-75,-97,22,0a:e1:ab:b3:c3:a6,286186506,268,20549,286186238,286186506
18623,5,12,149,5745,-84,-97,13,9a:24:38:da:96:bb,286189020,272,2242,286188748,286189020
18624,5,6,149,5745,-89,-97,8,54:e4:3a:ec:fb:65,286192027,360,2647,286191667,286192027
18625,5,12,149,5745,-71,-97,26,f2:da:61:dd:98:c5,286192770,268,475,286192502,286192770
18626,5,12,149,5745,-63,-97,34,4a:86:35:36:74:b8,286193133,268,95,286192865,286193133
18627,5,12,149,5745,-68,-97,29,a6:92:ad:b7:76:65,286215260,284,21843,286214976,286215260
18628,5,12,149,5745,-59,-97,38,b6:90:18:f6:b1:d4,286216386,268,858,286216118,286216386
18629,5,12,149,5745,-64,-97,33,fa:44:8d:e1:c7:1b,286216719,244,89,286216475,286216719
18630,5,12,149,5745,-91,-97,6,c6:71:4f:a2:d1:86,286227239,244,10276,286226995,286227239
18631,5,12,149,5745,-65,-97,32,5e:29:73:5b:30:00,286228771,272,1260,286228499,286228771
18632,5,12,149,5745,-87,-97,10,42:d2:d9:2b:ac:61,286229507,260,476,286229247,286229507
18633,5,12,149,5745,-71,-97,26,56:68:e2:c2:8d:d5,286230981,280,1194,286230701,286230981
18634,5,12,149,5745,-92,-97,5,7e:05:42:11:d2:ec,286234899,244,3674,286234655,286234899
18635,5,12,149,5745,-53,-97,44,3e:d1:9b:c7:a4:de,286257875,272,22704,286257603,286257875
18636,5,12,149,5745,-67,-97,30,22:ec:75:a8:8a:31,286267426,244,9307,286267182,286267426
18637,5,12,149,5745,-73,-97,24,0a:e1:ab:b3:c3:a6,286289929,268,22235,286289661,286289929
18638,5,12,149,5745,-72,-97,25,f2:da:61:dd:98:c5,286294012,268,3815,286293744,286294012
18639,5,6,149,5745,-87,-97,10,54:e4:3a:ec:fb:65,286294583,360,211,286294223,286294583
18640,5,12,149,5745,-59,-97,38,4a:86:35:36:74:b8,286295714,268,863,286295446,286295714
18641,5,12,149,5745,-67,-97,30,b6:90:18:f6:b1:d4,286318555,268,22573,286318287,286318555
18642,5,12,149,5745,-64,-97,33,fa:44:8d:e1:c7:1b,286318883,244,84,286318639,286318883
18643,5,12,149,5745,-91,-97,6,7e:05:42:11:d2:ec,286330895,244,11768,286330651,286330895
18644,5,12,149,5745,-73,-97,24,0a:e1:ab:b3:c3:a6,286333482,268,2319,286333214,286333482
18645,5,12,149,5745,-90,-97,7,42:d2:d9:2b:ac:61,286333838,260,96,286333578,286333838
18646,5,12,149,5745,-58,-97,39,b6:90:18:f6:b1:d4,286346045,268,11939,286345777,286346045
18647,5,12,149,5745,-70,-97,27,56:68:e2:c2:8d:d5,286346599,280,274,286346319,286346599
18648,5,12,149,5745,-58,-97,39,4a:86:35:36:74:b8,286346969,268,102,286346701,286346969
18649,5,12,149,5745,-69,-97,28,f2:da:61:dd:98:c5,286347550,268,313,286347282,286347550
18650,5,12,149,5745,-66,-97,31,5e:29:73:5b:30:00,286347862,272,40,286347590,286347862
18651,5,12,149,5745,-70,-97,27,56:68:e2:c2:8d:d5,286348330,476,-8,286347854,286348330
18652,5,12,149,5745,-89,-97,8,42:d2:d9:2b:ac:61,286349892,456,1106,286349436,286349892
18653,5,12,149,5745,-72,-97,25,0a:e1:ab:b3:c3:a6,286350429,268,269,286350161,286350429
18654,5,12,149,5745,-51,-97,46,3e:d1:9b:c7:a4:de,286357181,544,6208,286356637,286357181
18655,5,12,149,5745,-67,-97,30,22:ec:75:a8:8a:31,286357778,516,81,286357262,286357778
18656,5,12,149,5745,-63,-97,34,fa:44:8d:e1:c7:1b,286362971,244,4949,286362727,286362971
18657,5,12,149,5745,-61,-97,36,fa:44:8d:e1:c7:1b,286366426,440,3015,286365986,286366426
18658,5,12,149,5745,-69,-97,28,f2:da:61:dd:98:c5,286368844,268,2150,286368576,286368844
18659,5,12,149,5745,-65,-97,32,a6:92:ad:b7:76:65,286371813,484,2485,286371329,286371813
18660,5,12,149,5745,-57,-97,40,4a:86:35:36:74:b8,286372819,268,738,286372551,286372819
18661,5,12,149,5745,-50,-97,47,3e:d1:9b:c7:a4:de,286378845,272,5754,286378573,286378845
18662,5,12,149,5745,-69,-97,28,f6:0a:5c:59:72:df,286379466,280,341,286379186,286379466
18663,5,12,149,5745,-90,-97,7,42:d2:d9:2b:ac:61,286380323,260,597,286380063,286380323
18664,5,12,149,5745,-68,-97,29,22:ec:75:a8:8a:31,286394694,244,14127,286394450,286394694
18665,5,12,149,5745,-64,-97,33,a6:92:ad:b7:76:65,286396805,284,1827,286396521,286396805
18666,5,12,149,5745,-59,-97,38,b6:90:18:f6:b1:d4,286410971,268,13898,286410703,286410971
18667,5,12,149,5745,-69,-97,28,56:68:e2:c2:8d:d5,286411417,476,-30,286410941,286411417
18668,5,12,149,5745,-86,-97,11,9a:24:38:da:96:bb,286412759,272,1070,286412487,286412759
18669,5,12,149,5745,-70,-97,27,0a:e1:ab:b3:c3:a6,286413767,268,740,286413499,286413767
18670,5,12,149,5745,-87,-97,10,9a:24:38:da:96:bb,286414191,824,-400,286413367,286414191
18671,5,12,149,5745,-57,-97,40,4a:86:35:36:74:b8,286415732,156,1385,286415576,286415732
18672,5,12,149,5745,-69,-97,28,72:d1:72:1d:22:a1,286417199,480,987,286416719,286417199
18673,5,12,149,5745,-71,-97,26,f6:0a:5c:59:72:df,286420605,280,3126,286420325,286420605
18674,5,12,149,5745,-68,-97,29,22:ec:75:a8:8a:31,286423001,516,1880,286422485,286423001
18675,5,12,149,5745,-51,-97,46,3e:d1:9b:c7:a4:de,286423579,544,34,286423035,286423579
18676,5,12,149,5745,-57,-97,40,0a:b9:b7:b1:4d:fa,286426037,132,2326,286425905,286426037
18677,5,12,149,5745,-61,-97,36,fa:44:8d:e1:c7:1b,286427358,360,961,286426998,286427358
18678,5,12,149,5745,-59,-97,38,b6:90:18:f6:b1:d4,286427916,268,290,286427648,286427916
18679,5,12,149,5745,-92,-97,5,7e:05:42:11:d2:ec,286428228,440,-128,286427788,286428228
18680,5,12,149,5745,-90,-97,7,7e:05:42:11:d2:ec,286428684,244,212,286428440,286428684
18681,5,12,149,5745,-72,-97,25,f2:da:61:dd:98:c5,286431395,268,2443,286431127,286431395
18682,5,12,149,5745,-70,-97,27,f6:0a:5c:59:72:df,286432607,476,736,286432131,286432607
18683,5,12,149,5745,-61,-97,36,fa:44:8d:e1:c7:1b,286433154,440,107,286432714,286433154
18684,5,12,149,5745,-65,-97,32,5e:29:73:5b:30:00,286434007,540,313,286433467,286434007
18685,5,12,149,5745,-64,-97,33,a6:92:ad:b7:76:65,286434671,484,180,286434187,286434671
18686,5,12,149,5745,-57,-97,40,4a:86:35:36:74:b8,286435722,268,783,286435454,286435722
18687,5,12,149,5745,-57,-97,40,0a:b9:b7:b1:4d:fa,286441496,268,5506,286441228,286441496
18688,5,12,149,5745,-71,-97,26,0a:e1:ab:b3:c3:a6,286444419,268,2655,286444151,286444419
18689,5,12,149,5745,-69,-97,28,56:68:e2:c2:8d:d5,286444873,280,174,286444593,286444873
18690,5,12,149,5745,-73,-97,24,f2:da:61:dd:98:c5,286446133,268,992,286445865,286446133
18691,5,12,149,5745,-56,-97,41,4a:86:35:36:74:b8,286461825,268,15424,286461557,286461825
18692,5,12,149,5745,-66,-97,31,5e:29:73:5b:30:00,286462683,272,586,286462411,286462683
18693,5,12,149,5745,-60,-97,37,fa:44:8d:e1:c7:1b,286477653,244,14726,286477409,286477653
18694,5,12,149,5745,-51,-97,46,3e:d1:9b:c7:a4:de,286484013,272,6088,286483741,286484013
18695,5,12,149,5745,-71,-97,26,22:ec:75:a8:8a:31,286496828,244,12571,286496584,286496828
18696,5,12,149,5745,-59,-97,38,fa:44:8d:e1:c7:1b,286497170,440,-98,286496730,286497170
18697,5,6,149,5745,-90,-97,7,54:e4:3a:ec:fb:65,286499229,360,1699,286498869,286499229
18698,5,12,149,5745,-69,-97,28,5e:29:73:5b:30:00,286500049,540,280,286499509,286500049
18699,5,12,149,5745,-57,-97,40,4a:86:35:36:74:b8,286501290,268,973,286501022,286501290
18700,5,12,149,5745,-92,-97,5,42:d2:d9:2b:ac:61,286505460,260,3910,286505200,286505460
18701,5,12,149,5745,-64,-97,33,a6:92:ad:b7:76:65,286523604,284,17860,286523320,286523604
18702,5,12,149,5745,-84,-97,13,9a:24:38:da:96:bb,286525721,272,1845,286525449,286525721
18703,5,12,149,5745,-89,-97,8,7e:05:42:11:d2:ec,286552080,244,26115,286551836,286552080
18704,5,12,149,5745,-62,-97,35,5e:29:73:5b:30:00,286565592,540,12972,286565052,286565592
18705,5,12,149,5745,-71,-97,26,f2:da:61:dd:98:c5,286573050,268,7190,286572782,286573050
18706,5,12,149,5745,-62,-97,35,5e:29:73:5b:30:00,286576925,272,3603,286576653,286576925
18707,5,12,149,5745,-60,-97,37,4a:86:35:36:74:b8,286582901,268,5708,286582633,286582901
18708,5,12,149,5745,-73,-97,24,0a:e1:ab:b3:c3:a6,286596038,268,12869,286595770,286596038
18709,5,12,149,5745,-60,-97,37,fa:44:8d:e1:c7:1b,286599986,244,3704,286599742,286599986
18710,5,12,149,5745,-51,-97,46,3e:d1:9b:c7:a4:de,286600425,272,167,286600153,286600425
18711,5,6,149,5745,-85,-97,12,54:e4:3a:ec:fb:65,286601630,360,845,286601270,286601630
18712,5,12,149,5745,-69,-97,28,22:ec:75:a8:8a:31,286612627,244,10753,286612383,286612627
18713,5,12,149,5745,-68,-97,29,f6:0a:5c:59:72:df,286615960,280,3053,286615680,286615960
18714,5,12,149,5745,-91,-97,6,42:d2:d9:2b:ac:61,286619109,260,2889,286618849,286619109
18715,5,12,149,5745,-62,-97,35,b6:90:18:f6:b1:d4,286627249,268,7872,286626981,286627249
18716,5,12,149,5745,-72,-97,25,56:68:e2:c2:8d:d5,286628332,280,803,286628052,286628332
18717,5,12,149,5745,-67,-97,30,5e:29:73:5b:30:00,286631211,540,2339,286630671,286631211
18718,5,12,149,5745,-64,-97,33,a6:92:ad:b7:76:65,286636655,284,5160,286636371,286636655
18719,5,12,149,5745,-66,-97,31,5e:29:73:5b:30:00,286679865,272,42938,286679593,286679865
18720,5,12,149,5745,-71,-97,26,0a:e1:ab:b3:c3:a6,286699043,268,18910,286698775,286699043
18721,5,6,149,5745,-89,-97,8,54:e4:3a:ec:fb:65,286704030,360,4627,286703670,286704030
18722,5,12,149,5745,-69,-97,28,f2:da:61:dd:98:c5,286705183,268,885,286704915,286705183
18723,5,12,149,5745,-59,-97,38,4a:86:35:36:74:b8,286705521,268,70,286705253,286705521
18724,5,12,149,5745,-56,-97,41,3e:d1:9b:c7:a4:de,286714160,272,8367,286713888,286714160
18725,5,12,149,5745,-62,-97,35,fa:44:8d:e1:c7:1b,286728609,244,14205,286728365,286728609
18726,5,12,149,5745,-70,-97,27,56:68:e2:c2:8d:d5,286728941,280,52,286728661,286728941
18727,5,12,149,5745,-67,-97,30,22:ec:75:a8:8a:31,286729674,244,489,286729430,286729674
18728,5,12,149,5745,-63,-97,34,b6:90:18:f6:b1:d4,286730748,268,806,286730480,286730748
18729,5,12,149,5745,-91,-97,6,42:d2:d9:2b:ac:61,286742243,260,11235,286741983,286742243
18730,5,12,149,5745,-83,-97,14,9a:24:38:da:96:bb,286754431,272,11916,286754159,286754431
18731,5,12,149,5745,-66,-97,31,a6:92:ad:b7:76:65,286758903,284,4188,286758619,286758903
18732,5,12,149,5745,-90,-97,7,7e:05:42:11:d2:ec,286778576,244,19429,286778332,286778576
18733,5,12,149,5745,-62,-97,35,b6:90:18:f6:b1:d4,286782336,268,3492,286782068,286782336
18734,5,12,149,5745,-75,-97,22,0a:e1:ab:b3:c3:a6,286784459,268,1855,286784191,286784459
18735,5,12,149,5745,-69,-97,28,f2:da:61:dd:98:c5,286791750,268,7023,286791482,286791750
18736,5,12,149,5745,-71,-97,26,56:68:e2:c2:8d:d5,286792177,280,147,286791897,286792177
18737,5,12,149,5745,-61,-97,36,b6:90:18:f6:b1:d4,286804319,268,11874,286804051,286804319
18738,5,12,149,5745,-58,-97,39,4a:86:35:36:74:b8,286805693,268,1106,286805425,286805693
18739,5,12,149,5745,-64,-97,33,5e:29:73:5b:30:00,286806322,272,357,286806050,286806322
18740,5,12,149,5745,-72,-97,25,0a:e1:ab:b3:c3:a6,286806747,268,157,286806479,286806747
18741,5,12,149,5745,-72,-97,25,56:68:e2:c2:8d:d5,286807385,476,162,286806909,286807385
18742,5,12,149,5745,-64,-97,33,5e:29:73:5b:30:00,286807974,540,49,286807434,286807974
18743,5,12,149,5745,-90,-97,7,42:d2:d9:2b:ac:61,286809107,456,677,286808651,286809107
18744,5,12,149,5745,-70,-97,27,72:d1:72:1d:22:a1,286810496,480,909,286810016,286810496
18745,5,12,149,5745,-58,-97,39,4a:86:35:36:74:b8,286811706,176,1034,286811530,286811706
18746,5,12,149,5745,-66,-97,31,f6:0a:5c:59:72:df,286814689,280,2703,286814409,286814689
18747,5,12,149,5745,-66,-97,31,f6:0a:5c:59:72:df,286814987,268,30,286814719,286814987
18748,5,12,149,5745,-70,-97,27,f2:da:61:dd:98:c5,286815418,132,299,286815286,286815418
18749,5,12,149,5745,-73,-97,24,56:68:e2:c2:8d:d5,286817008,268,1322,286816740,286817008
18750,5,12,149,5745,-67,-97,30,22:ec:75:a8:8a:31,286818783,516,1259,286818267,286818783
18751,5,12,149,5745,-89,-97,8,7e:05:42:11:d2:ec,286821268,440,2045,286820828,286821268
18752,5,12,149,5745,-67,-97,30,fa:44:8d:e1:c7:1b,286821743,244,231,286821499,286821743
18753,5,12,149,5745,-54,-97,43,3e:d1:9b:c7:a4:de,286822183,544,-104,286821639,286822183
18754,5,12,149,5745,-67,-97,30,fa:44:8d:e1:c7:1b,286825802,440,3179,286825362,286825802
18755,5,12,149,5745,-71,-97,26,f2:da:61:dd:98:c5,286826330,268,260,286826062,286826330
18756,5,12,149,5745,-69,-97,28,f6:0a:5c:59:72:df,286826744,476,-62,286826268,286826744
18757,5,12,149,5745,-69,-97,28,f6:0a:5c:59:72:df,286827237,280,213,286826957,286827237
18758,5,12,149,5745,-66,-97,31,a6:92:ad:b7:76:65,286829639,484,1918,286829155,286829639
18759,5,12,149,5745,-56,-97,41,4a:86:35:36:74:b8,286830195,268,288,286829927,286830195
18760,5,12,149,5745,-54,-97,43,3e:d1:9b:c7:a4:de,286837589,272,7122,286837317,286837589
18761,5,12,149,5745,-88,-97,9,42:d2:d9:2b:ac:61,286838889,260,1040,286838629,286838889
18762,5,12,149,5745,-65,-97,32,22:ec:75:a8:8a:31,286853460,244,14327,286853216,286853460
18763,5,12,149,5745,-66,-97,31,a6:92:ad:b7:76:65,286855785,284,2041,286855501,286855785
18764,5,12,149,5745,-86,-97,11,9a:24:38:da:96:bb,286862762,272,6705,286862490,286862762
18765,5,12,149,5745,-71,-97,26,0a:e1:ab:b3:c3:a6,286873706,268,10676,286873438,286873706
18766,5,12,149,5745,-62,-97,35,b6:90:18:f6:b1:d4,286877500,268,3526,286877232,286877500
18767,5,12,149,5745,-63,-97,34,22:ec:75:a8:8a:31,286884692,516,6676,286884176,286884692
18768,5,12,149,5745,-62,-97,35,b6:90:18:f6:b1:d4,286886512,268,1552,286886244,286886512
18769,5,12,149,5745,-89,-97,8,7e:05:42:11:d2:ec,286887031,244,275,286886787,286887031
18770,5,12,149,5745,-53,-97,44,3e:d1:9b:c7:a4:de,286887804,544,229,286887260,286887804
18771,5,12,149,5745,-60,-97,37,fa:44:8d:e1:c7:1b,286889743,440,1499,286889303,286889743
18772,5,12,149,5745,-72,-97,25,f2:da:61:dd:98:c5,286890307,268,296,286890039,286890307
18773,5,12,149,5745,-90,-97,7,7e:05:42:11:d2:ec,286890789,440,42,286890349,286890789
18774,5,12,149,5745,-55,-97,42,4a:86:35:36:74:b8,286894002,268,2945,286893734,286894002
18775,5,12,149,5745,-65,-97,32,a6:92:ad:b7:76:65,286894322,484,-164,286893838,286894322
18776,5,12,149,5745,-73,-97,24,f2:da:61:dd:98:c5,286904227,268,9637,286903959,286904227
18777,5,12,149,5745,-73,-97,24,56:68:e2:c2:8d:d5,286907643,280,3136,286907363,286907643
18778,5,6,149,5745,-88,-97,9,54:e4:3a:ec:fb:65,286908831,360,828,286908471,286908831
18779,5,12,149,5745,-64,-97,33,5e:29:73:5b:30:00,286911827,272,2724,286911555,286911827
18780,5,24,149,5745,-89,-97,8,,286912183,28,328,286912155,286912183
18781,5,24,149,5745,-89,-97,8,,286912227,28,16,286912199,286912227
18782,5,24,149,5745,-89,-97,8,,286912336,32,77,286912304,286912336
18783,5,12,149,5745,-55,-97,42,4a:86:35:36:74:b8,286920583,268,7979,286920315,286920583
18784,5,24,149,5745,-90,-97,7,,286930196,28,9585,286930168,286930196
18785,5,24,149,5745,-87,-97,10,,286930240,28,16,286930212,286930240
18786,5,24,149,5745,-88,-97,9,,286930348,32,76,286930316,286930348
18787,5,12,149,5745,-70,-97,27,72:d1:72:1d:22:a1,286930442,284,-190,286930158,286930442
18788,5,12,149,5745,-58,-97,39,fa:44:8d:e1:c7:1b,286936384,244,5698,286936140,286936384
18789,5,12,149,5745,-87,-97,10,9a:24:38:da:96:bb,286938945,824,1737,286938121,286938945
18790,5,12,149,5745,-66,-97,31,5e:29:73:5b:30:00,286939821,540,336,286939281,286939821
18791,5,12,149,5745,-73,-97,24,0a:e1:ab:b3:c3:a6,286940442,268,353,286940174,286940442
18792,5,12,149,5745,-64,-97,33,b6:90:18:f6:b1:d4,286943255,268,2545,286942987,286943255
18793,5,24,149,5745,-87,-97,10,,286945783,32,2496,286945751,286945783
18794,5,24,149,5745,-88,-97,9,,286946188,28,377,286946160,286946188
18795,5,24,149,5745,-89,-97,8,,286947268,32,1048,286947236,286947268
18796,5,12,149,5745,-64,-97,33,22:ec:75:a8:8a:31,286949162,516,1378,286948646,286949162
18797,5,12,149,5745,-66,-97,31,f6:0a:5c:59:72:df,286951456,280,2014,286951176,286951456
18798,5,12,149,5745,-51,-97,46,3e:d1:9b:c7:a4:de,286952326,272,598,286952054,286952326
18799,5,12,149,5745,-51,-97,46,3e:d1:9b:c7:a4:de,286952893,544,23,286952349,286952893
18800,5,12,149,5745,-58,-97,39,fa:44:8d:e1:c7:1b,286953590,440,257,286953150,286953590
18801,5,12,149,5745,-70,-97,27,f2:da:61:dd:98:c5,286955756,268,1898,286955488,286955756
18802,5,12,149,5745,-90,-97,7,7e:05:42:11:d2:ec,286957275,440,1079,286956835,286957275
18803,5,12,149,5745,-90,-97,7,42:d2:d9:2b:ac:61,286958573,248,1050,286958325,286958573
18804,5,12,149,5745,-55,-97,42,4a:86:35:36:74:b8,286960055,268,1214,286959787,286960055
18805,5,12,149,5745,-64,-97,33,a6:92:ad:b7:76:65,286960375,484,-164,286959891,286960375
18806,5,12,149,5745,-58,-97,39,0a:b9:b7:b1:4d:fa,286963884,268,3241,286963616,286963884
18807,5,12,149,5745,-65,-97,32,22:ec:75:a8:8a:31,286967795,244,3667,286967551,286967795
18808,5,12,149,5745,-63,-97,34,a6:92:ad:b7:76:65,286969855,284,1776,286969571,286969855
18809,5,12,149,5745,-86,-97,11,9a:24:38:da:96:bb,286974960,272,4833,286974688,286974960
18810,5,12,149,5745,-89,-97,8,7e:05:42:11:d2:ec,286986191,244,10987,286985947,286986191
18811,5,12,149,5745,-70,-97,27,0a:e1:ab:b3:c3:a6,287004847,268,18388,287004579,287004847
18812,5,6,149,5745,-85,-97,12,54:e4:3a:ec:fb:65,287011232,360,6025,287010872,287011232
18813,5,12,149,5745,-68,-97,29,b6:90:18:f6:b1:d4,287012585,268,1085,287012317,287012585
18814,5,12,149,5745,-66,-97,31,22:ec:75:a8:8a:31,287013769,516,668,287013253,287013769
18815,5,12,149,5745,-58,-97,39,4a:86:35:36:74:b8,287018542,268,4505,287018274,287018542
18816,5,12,149,5745,-50,-97,47,3e:d1:9b:c7:a4:de,287018862,544,-224,287018318,287018862
18817,5,12,149,5745,-68,-97,29,f2:da:61:dd:98:c5,287023071,268,3941,287022803,287023071
18818,5,12,149,5745,-58,-97,39,4a:86:35:36:74:b8,287025588,268,2249,287025320,287025588
18819,5,12,149,5745,-65,-97,32,5e:29:73:5b:30:00,287028863,272,3003,287028591,287028863
18820,5,12,149,5745,-68,-97,29,56:68:e2:c2:8d:d5,287037944,280,8801,287037664,287037944
18821,5,12,149,5745,-70,-97,27,72:d1:72:1d:22:a1,287042559,284,4331,287042275,287042559
18822,5,12,149,5745,-62,-97,35,fa:44:8d:e1:c7:1b,287048656,244,5853,287048412,287048656
18823,5,12,149,5745,-63,-97,34,f6:0a:5c:59:72:df,287065838,280,16902,287065558,287065838
18824,5,12,149,5745,-51,-97,46,3e:d1:9b:c7:a4:de,287066971,272,861,287066699,287066971
18825,5,12,149,5745,-69,-97,28,0a:e1:ab:b3:c3:a6,287070311,268,3072,287070043,287070311
18826,5,12,149,5745,-66,-97,31,22:ec:75:a8:8a:31,287079513,516,8686,287078997,287079513
18827,5,12,149,5745,-66,-97,31,22:ec:75:a8:8a:31,287082426,244,2669,287082182,287082426
18828,5,12,149,5745,-52,-97,45,3e:d1:9b:c7:a4:de,287085027,544,2057,287084483,287085027
18829,5,12,149,5745,-86,-97,11,9a:24:38:da:96:bb,287088502,272,3203,287088230,287088502
18830,5,6,149,5745,-87,-97,10,54:e4:3a:ec:fb:65,287113716,360,24854,287113356,287113716
18831,5,24,149,5745,-85,-97,12,,287134749,32,21001,287134717,287134749
18832,5,24,149,5745,-85,-97,12,,287135313,32,532,287135281,287135313
18833,5,12,149,5745,-69,-97,28,0a:e1:ab:b3:c3:a6,287135897,268,316,287135629,287135897
18834,5,12,149,5745,-63,-97,34,a6:92:ad:b7:76:65,287136753,284,572,287136469,287136753
18835,5,12,149,5745,-68,-97,29,b6:90:18:f6:b1:d4,287138168,268,1147,287137900,287138168
18836,5,12,149,5745,-69,-97,28,56:68:e2:c2:8d:d5,287139388,280,940,287139108,287139388
18837,5,12,149,5745,-64,-97,33,22:ec:75:a8:8a:31,287145183,516,5279,287144667,287145183
18838,5,12,149,5745,-68,-97,29,5e:29:73:5b:30:00,287145946,272,491,287145674,287145946
18839,5,24,149,5745,-85,-97,12,,287148529,28,2555,287148501,287148529
18840,5,12,149,5745,-52,-97,45,3e:d1:9b:c7:a4:de,287150036,544,963,287149492,287150036
18841,5,12,149,5745,-89,-97,8,42:d2:d9:2b:ac:61,287150616,248,332,287150368,287150616
18842,5,24,149,5745,-84,-97,13,,287152945,28,2301,287152917,287152945
18843,5,12,149,5745,-71,-97,26,72:d1:72:1d:22:a1,287154596,284,1367,287154312,287154596
18844,5,12,149,5745,-53,-97,44,3e:d1:9b:c7:a4:de,287182493,272,27625,287182221,287182493
18845,5,12,149,5745,-64,-97,33,22:ec:75:a8:8a:31,287182835,244,98,287182591,287182835
18846,5,24,149,5745,-84,-97,13,,287196690,32,13823,287196658,287196690
18847,5,12,149,5745,-81,-97,16,9a:24:38:da:96:bb,287204014,272,7052,287203742,287204014
18848,5,12,149,5745,-73,-97,24,d2:00:04:7e:2c:ab,287207132,244,2874,287206888,287207132
18849,5,6,149,5745,-86,-97,11,54:e4:3a:ec:fb:65,287216033,360,8541,287215673,287216033
18850,5,12,149,5745,-58,-97,39,4a:86:35:36:74:b8,287216666,268,365,287216398,287216666
18851,5,12,149,5745,-69,-97,28,f2:da:61:dd:98:c5,287219095,268,2161,287218827,287219095
18852,5,12,149,5745,-68,-97,29,a6:92:ad:b7:76:65,287239055,284,19676,287238771,287239055
18853,5,12,149,5745,-66,-97,31,b6:90:18:f6:b1:d4,287240488,268,1165,287240220,287240488
18854,5,12,149,5745,-66,-97,31,fa:44:8d:e1:c7:1b,287240872,244,140,287240628,287240872
18855,5,12,149,5745,-70,-97,27,56:68:e2:c2:8d:d5,287241265,280,113,287240985,287241265
18856,5,12,149,5745,-90,-97,7,7e:05:42:11:d2:ec,287259065,244,17556,287258821,287259065
18857,5,12,149,5745,-66,-97,31,5e:29:73:5b:30:00,287261452,272,2115,287261180,287261452
18858,5,12,149,5745,-56,-97,41,3e:d1:9b:c7:a4:de,287280590,272,18866,287280318,287280590
18859,5,12,149,5745,-64,-97,33,f6:0a:5c:59:72:df,287288334,280,7464,287288054,287288334
18860,5,12,149,5745,-67,-97,30,22:ec:75:a8:8a:31,287292330,244,3752,287292086,287292330
18861,5,6,149,5745,-85,-97,12,54:e4:3a:ec:fb:65,287318433,360,25743,287318073,287318433
18862,5,12,149,5745,-58,-97,39,4a:86:35:36:74:b8,287319821,268,1120,287319553,287319821
18863,5,12,149,5745,-70,-97,27,f2:da:61:dd:98:c5,287320860,268,771,287320592,287320860
18864,5,12,149,5745,-66,-97,31,a6:92:ad:b7:76:65,287342675,284,21531,287342391,287342675
18865,5,12,149,5745,-77,-97,20,d2:00:04:7e:2c:ab,287342995,244,76,287342751,287342995
18866,5,12,149,5745,-72,-97,25,72:d1:72:1d:22:a1,287343275,284,-4,287342991,287343275
18867,5,12,149,5745,-65,-97,32,b6:90:18:f6:b1:d4,287343658,268,115,287343390,287343658
18868,5,12,149,5745,-89,-97,8,42:d2:d9:2b:ac:61,287355671,248,11765,287355423,287355671
18869,5,12,149,5745,-71,-97,26,56:68:e2:c2:8d:d5,287359558,280,3607,287359278,287359558
18870,5,12,149,5745,-90,-97,7,7e:05:42:11:d2:ec,287360839,244,1037,287360595,287360839
18871,5,12,149,5745,-72,-97,25,f2:da:61:dd:98:c5,287364133,268,3026,287363865,287364133
18872,5,12,149,5745,-57,-97,40,4a:86:35:36:74:b8,287369707,268,5306,287369439,287369707
18873,5,12,149,5745,-65,-97,32,5e:29:73:5b:30:00,287373606,272,3627,287373334,287373606
18874,5,12,149,5745,-73,-97,24,72:d1:72:1d:22:a1,287382148,284,8258,287381864,287382148
18875,5,12,149,5745,-64,-97,33,f6:0a:5c:59:72:df,287387920,280,5492,287387640,287387920
18876,5,12,149,5745,-72,-97,25,56:68:e2:c2:8d:d5,287395759,476,7363,287395283,287395759
18877,5,12,149,5745,-65,-97,32,5e:29:73:5b:30:00,287396278,540,-21,287395738,287396278
18878,5,12,149,5745,-73,-97,24,72:d1:72:1d:22:a1,287403703,480,6945,287403223,287403703
18879,5,12,149,5745,-67,-97,30,b6:90:18:f6:b1:d4,287404209,268,238,287403941,287404209
18880,5,12,149,5745,-73,-97,24,d2:00:04:7e:2c:ab,287407042,440,2393,287406602,287407042
18881,5,12,149,5745,-65,-97,32,22:ec:75:a8:8a:31,287408367,516,809,287407851,287408367
18882,5,12,149,5745,-88,-97,9,42:d2:d9:2b:ac:61,287409536,444,725,287409092,287409536
18883,5,12,149,5745,-55,-97,42,3e:d1:9b:c7:a4:de,287410996,272,1188,287410724,287410996
18884,5,12,149,5745,-55,-97,42,3e:d1:9b:c7:a4:de,287411806,544,266,287411262,287411806
18885,5,12,149,5745,-91,-97,6,42:d2:d9:2b:ac:61,287412465,248,411,287412217,287412465
18886,5,12,149,5745,-67,-97,30,a6:92:ad:b7:76:65,287412747,284,-2,287412463,287412747
18887,5,12,149,5745,-69,-97,28,f2:da:61:dd:98:c5,287414559,268,1544,287414291,287414559
18888,5,12,149,5745,-91,-97,6,7e:05:42:11:d2:ec,287416249,440,1250,287415809,287416249
18889,5,12,149,5745,-65,-97,32,f6:0a:5c:59:72:df,287416809,476,84,287416333,287416809
18890,5,12,149,5745,-56,-97,41,4a:86:35:36:74:b8,287419211,268,2134,287418943,287419211
18891,5,12,149,5745,-67,-97,30,a6:92:ad:b7:76:65,287420926,484,1231,287420442,287420926
18892,5,12,149,5745,-86,-97,11,9a:24:38:da:96:bb,287424170,272,2972,287423898,287424170
18893,5,12,149,5745,-66,-97,31,22:ec:75:a8:8a:31,287426547,244,2133,287426303,287426547
18894,5,12,149,5745,-73,-97,24,d2:00:04:7e:2c:ab,287428231,244,1440,287427987,287428231
18895,5,12,149,5745,-65,-97,32,b6:90:18:f6:b1:d4,287444063,268,15564,287443795,287444063
18896,5,12,149,5745,-90,-97,7,7e:05:42:11:d2:ec,287444482,244,175,287444238,287444482
18897,5,12,149,5745,-72,-97,25,56:68:e2:c2:8d:d5,287460627,476,15669,287460151,287460627
18898,5,12,149,5745,-68,-97,29,f2:da:61:dd:98:c5,287461759,268,864,287461491,287461759
18899,5,12,149,5745,-86,-97,11,9a:24:38:da:96:bb,287462177,824,-406,287461353,287462177
18900,5,12,149,5745,-71,-97,26,72:d1:72:1d:22:a1,287467047,480,4390,287466567,287467047
18901,5,12,149,5745,-65,-97,32,b6:90:18:f6:b1:d4,287467563,268,248,287467295,287467563
18902,5,12,149,5745,-66,-97,31,f6:0a:5c:59:72:df,287468887,268,1056,287468619,287468887
18903,5,12,149,5745,-66,-97,31,f6:0a:5c:59:72:df,287469173,144,142,287469029,287469173
18904,5,12,149,5745,-72,-97,25,56:68:e2:c2:8d:d5,287469436,268,-5,287469168,287469436
18905,5,12,149,5745,-71,-97,26,d2:00:04:7e:2c:ab,287472428,440,2552,287471988,287472428
18906,5,12,149,5745,-67,-97,30,22:ec:75:a8:8a:31,287472929,516,-15,287472413,287472929
18907,5,12,149,5745,-90,-97,7,42:d2:d9:2b:ac:61,287475223,444,1850,287474779,287475223
18908,5,12,149,5745,-57,-97,40,4a:86:35:36:74:b8,287477258,268,1767,287476990,287477258
18909,5,12,149,5745,-54,-97,43,3e:d1:9b:c7:a4:de,287477587,544,-215,287477043,287477587
18910,5,12,149,5745,-71,-97,26,d2:00:04:7e:2c:ab,287479907,380,1940,287479527,287479907
18911,5,12,149,5745,-68,-97,29,f2:da:61:dd:98:c5,287480357,268,182,287480089,287480357
18912,5,12,149,5745,-67,-97,30,f6:0a:5c:59:72:df,287480794,476,-39,287480318,287480794
18913,5,12,149,5745,-57,-97,40,4a:86:35:36:74:b8,287484348,268,3286,287484080,287484348
18914,5,12,149,5745,-65,-97,32,a6:92:ad:b7:76:65,287486045,484,1213,287485561,287486045
18915,5,12,149,5745,-59,-97,38,0a:b9:b7:b1:4d:fa,287487373,268,1060,287487105,287487373
18916,5,12,149,5745,-66,-97,31,5e:29:73:5b:30:00,287494446,272,6801,287494174,287494446
18917,5,12,149,5745,-71,-97,26,72:d1:72:1d:22:a1,287495771,284,1041,287495487,287495771
18918,5,24,149,5745,-88,-97,9,,287498547,32,2744,287498515,287498547
18919,5,12,149,5745,-67,-97,30,f6:0a:5c:59:72:df,287499887,280,1060,287499607,287499887
18920,5,12,149,5745,-91,-97,6,42:d2:d9:2b:ac:61,287511352,248,11217,287511104,287511352
18921,5,6,149,5745,-90,-97,7,54:e4:3a:ec:fb:65,287523235,360,11523,287522875,287523235
18922,5,12,149,5745,-69,-97,28,22:ec:75:a8:8a:31,287524897,244,1418,287524653,287524897
18923,5,12,149,5745,-53,-97,44,3e:d1:9b:c7:a4:de,287525824,272,655,287525552,287525824
18924,5,12,149,5745,-86,-97,11,9a:24:38:da:96:bb,287537058,272,10962,287536786,287537058
18925,5,12,149,5745,-72,-97,25,d2:00:04:7e:2c:ab,287537344,440,-154,287536904,287537344
18926,5,12,149,5745,-69,-97,28,22:ec:75:a8:8a:31,287537881,516,21,287537365,287537881
18927,5,24,149,5745,-87,-97,10,,287538477,32,564,287538445,287538477
18928,5,24,149,5745,-87,-97,10,,287538818,28,313,287538790,287538818
18929,5,12,149,5745,-64,-97,33,a6:92:ad:b7:76:65,287539360,284,258,287539076,287539360
18930,5,12,149,5745,-52,-97,45,3e:d1:9b:c7:a4:de,287542820,544,2916,287542276,287542820
18931,5,12,149,5745,-73,-97,24,d2:00:04:7e:2c:ab,287543515,244,451,287543271,287543515
18932,5,12,149,5745,-56,-97,41,4a:86:35:36:74:b8,287549790,268,6007,287549522,287549790
18933,5,24,149,5745,-86,-97,11,,287590647,32,40825,287590615,287590647
18934,5,12,149,5745,-71,-97,26,f2:da:61:dd:98:c5,287593296,268,2381,287593028,287593296
18935,5,12,149,5745,-65,-97,32,5e:29:73:5b:30:00,287603133,272,9565,287602861,287603133
18936,5,12,149,5745,-55,-97,42,4a:86:35:36:74:b8,287603567,268,166,287603299,287603567
18937,5,12,149,5745,-68,-97,29,22:ec:75:a8:8a:31,287603914,516,-169,287603398,287603914
18938,5,12,149,5745,-71,-97,26,72:d1:72:1d:22:a1,287606194,284,1996,287605910,287606194
18939,5,12,149,5745,-50,-97,47,3e:d1:9b:c7:a4:de,287608730,544,1992,287608186,287608730
18940,5,12,149,5745,-50,-97,47,3e:d1:9b:c7:a4:de,287624060,272,15058,287623788,287624060
18941,5,6,149,5745,-85,-97,12,54:e4:3a:ec:fb:65,287625635,360,1215,287625275,287625635
18942,5,12,149,5745,-89,-97,8,42:d2:d9:2b:ac:61,287638851,248,12968,287638603,287638851
18943,5,12,149,5745,-67,-97,30,22:ec:75:a8:8a:31,287639882,244,787,287639638,287639882
18944,5,24,149,5745,-84,-97,13,,287647846,28,7936,287647818,287647846
18945,5,24,149,5745,-84,-97,13,,287647890,28,16,287647862,287647890
18946,5,24,149,5745,-85,-97,12,,287647998,32,76,287647966,287647998
18947,5,12,149,5745,-62,-97,35,b6:90:18:f6:b1:d4,287650179,268,1913,287649911,287650179
18948,5,12,149,5745,-70,-97,27,56:68:e2:c2:8d:d5,287652318,280,1859,287652038,287652318
18949,5,12,149,5745,-65,-97,32,a6:92:ad:b7:76:65,287652924,284,322,287652640,287652924
18950,5,12,149,5745,-87,-97,10,9a:24:38:da:96:bb,287654733,272,1537,287654461,287654733
18951,5,12,149,5745,-76,-97,21,d2:00:04:7e:2c:ab,287658981,244,4004,287658737,287658981
18952,5,12,149,5745,-68,-97,29,22:ec:75:a8:8a:31,287668916,516,9419,287668400,287668916
18953,5,12,149,5745,-51,-97,46,3e:d1:9b:c7:a4:de,287674640,544,5180,287674096,287674640
18954,5,24,149,5745,-83,-97,14,,287675778,28,1110,287675750,287675778
18955,5,24,149,5745,-85,-97,12,,287675823,28,17,287675795,287675823
18956,5,24,149,5745,-85,-97,12,,287675930,32,75,287675898,287675930
18957,5,24,149,5745,-85,-97,12,,287679215,28,3257,287679187,287679215
18958,5,24,149,5745,-83,-97,14,,287679259,28,16,287679231,287679259
18959,5,24,149,5745,-82,-97,15,,287679368,32,77,287679336,287679368
18960,5,12,149,5745,-61,-97,36,5e:29:73:5b:30:00,287716500,272,36860,287716228,287716500
18961,5,24,149,5745,-82,-97,15,,287720419,28,3891,287720391,287720419
18962,5,24,149,5745,-78,-97,19,,287720466,28,19,287720438,287720466
18963,5,24,149,5745,-78,-97,19,,287720579,32,81,287720547,287720579
18964,5,6,149,5745,-86,-97,11,54:e4:3a:ec:fb:65,287728061,360,7122,287727701,287728061
18965,5,12,149,5745,-53,-97,44,3e:d1:9b:c7:a4:de,287728449,272,116,287728177,287728449
18966,5,12,149,5745,-54,-97,43,4a:86:35:36:74:b8,287728873,268,156,287728605,287728873
18967,5,12,149,5745,-71,-97,26,f2:da:61:dd:98:c5,287729596,268,455,287729328,287729596
18968,5,24,149,5745,-68,-97,29,,287730806,28,1182,287730778,287730806
18969,5,24,149,5745,-82,-97,15,,287730850,28,16,287730822,287730850
18970,5,24,149,5745,-82,-97,15,,287730966,32,84,287730934,287730966
18971,5,12,149,5745,-68,-97,29,f6:0a:5c:59:72:df,287736400,280,5154,287736120,287736400
18972,5,12,149,5745,-69,-97,28,22:ec:75:a8:8a:31,287740170,244,3526,287739926,287740170
18973,5,12,149,5745,-70,-97,27,72:d1:72:1d:22:a1,287752689,284,12235,287752405,287752689
18974,5,12,149,5745,-62,-97,35,b6:90:18:f6:b1:d4,287753029,268,72,287752761,287753029
18975,5,12,149,5745,-70,-97,27,56:68:e2:c2:8d:d5,287753401,280,92,287753121,287753401
18976,5,24,149,5745,-82,-97,15,,287757762,32,4329,287757730,287757762
18977,5,12,149,5745,-85,-97,12,9a:24:38:da:96:bb,287761403,272,3369,287761131,287761403
18978,5,12,149,5745,-64,-97,33,a6:92:ad:b7:76:65,287763369,284,1682,287763085,287763369
18979,5,12,149,5745,-77,-97,20,d2:00:04:7e:2c:ab,287767264,244,3651,287767020,287767264
18980,5,24,149,5745,-81,-97,16,,287789762,32,22466,287789730,287789762
18981,5,12,149,5745,-60,-97,37,b6:90:18:f6:b1:d4,287797061,268,7031,287796793,287797061
18982,5,12,149,5745,-69,-97,28,56:68:e2:c2:8d:d5,287805670,280,8329,287805390,287805670
18983,5,24,149,5745,-81,-97,16,,287809230,32,3528,287809198,287809230
18984,5,24,149,5745,-82,-97,15,,287809528,32,266,287809496,287809528
18985,5,24,149,5745,-82,-97,15,,287826627,32,17067,287826595,287826627
18986,5,24,149,5745,-82,-97,15,,287826987,28,332,287826959,287826987
18987,5,24,149,5745,-81,-97,16,,287828513,28,1498,287828485,287828513
18988,5,6,149,5745,-88,-97,9,54:e4:3a:ec:fb:65,287830436,360,1563,287830076,287830436
18989,5,12,149,5745,-55,-97,42,4a:86:35:36:74:b8,287830985,268,281,287830717,287830985
18990,5,12,149,5745,-68,-97,29,72:d1:72:1d:22:a1,287832174,284,905,287831890,287832174
18991,5,12,149,5745,-74,-97,23,f2:da:61:dd:98:c5,287833211,268,769,287832943,287833211
18992,5,12,149,5745,-72,-97,25,f6:0a:5c:59:72:df,287837540,280,4049,287837260,287837540
18993,5,24,149,5745,-82,-97,15,,287845635,32,8063,287845603,287845635
18994,5,24,149,5745,-82,-97,15,,287846017,32,350,287845985,287846017
18995,5,24,149,5745,-82,-97,15,,287846399,28,354,287846371,287846399
18996,5,24,149,5745,-81,-97,16,,287846445,28,18,287846417,287846445
18997,5,24,149,5745,-80,-97,17,,287846555,32,78,287846523,287846555
18998,5,12,149,5745,-52,-97,45,3e:d1:9b:c7:a4:de,287853452,272,6625,287853180,287853452
18999,5,12,149,5745,-64,-97,33,5e:29:73:5b:30:00,287854892,272,1168,287854620,287854892
19000,5,12,149,5745,-64,-97,33,5e:29:73:5b:30:00,287855433,540,1,287854893,287855433
19001,5,12,149,5745,-67,-97,30,22:ec:75:a8:8a:31,287860051,516,4102,287859535,287860051
19002,5,12,149,5745,-68,-97,29,72:d1:72:1d:22:a1,287861970,480,1439,287861490,287861970
19003,5,12,149,5745,-68,-97,29,56:68:e2:c2:8d:d5,287862503,476,57,287862027,287862503
19004,5,12,149,5745,-60,-97,37,b6:90:18:f6:b1:d4,287863014,268,243,287862746,287863014
19005,5,12,149,5745,-52,-97,45,3e:d1:9b:c7:a4:de,287863335,544,-223,287862791,287863335
19006,5,12,149,5745,-71,-97,26,f6:0a:5c:59:72:df,287863967,144,488,287863823,287863967
19007,5,12,149,5745,-76,-97,21,d2:00:04:7e:2c:ab,287866072,440,1665,287865632,287866072
19008,5,12,149,5745,-67,-97,30,22:ec:75:a8:8a:31,287869218,244,2902,287868974,287869218
19009,5,24,149,5745,-82,-97,15,,287870222,32,972,287870190,287870222
19010,5,24,149,5745,-82,-97,15,,287870340,32,86,287870308,287870340
19011,5,12,149,5745,-76,-97,21,d2:00:04:7e:2c:ab,287870799,244,215,287870555,287870799
19012,5,12,149,5745,-90,-97,7,42:d2:d9:2b:ac:61,287871703,444,460,287871259,287871703
19013,5,12,149,5745,-87,-97,10,9a:24:38:da:96:bb,287872655,272,680,287872383,287872655
19014,5,12,149,5745,-73,-97,24,f6:0a:5c:59:72:df,287876288,476,3157,287875812,287876288
19015,5,12,149,5745,-55,-97,42,4a:86:35:36:74:b8,287877655,268,1099,287877387,287877655
19016,5,12,149,5745,-72,-97,25,f2:da:61:dd:98:c5,287882439,268,4516,287882171,287882439
19017,5,12,149,5745,-61,-97,36,b6:90:18:f6:b1:d4,287902793,268,20086,287902525,287902793
19018,5,12,149,5745,-69,-97,28,56:68:e2:c2:8d:d5,287904023,280,950,287903743,287904023
19019,5,12,149,5745,-55,-97,42,4a:86:35:36:74:b8,287919589,268,15298,287919321,287919589
19020,5,12,149,5745,-62,-97,35,b6:90:18:f6:b1:d4,287926328,268,6471,287926060,287926328
19021,5,12,149,5745,-74,-97,23,d2:00:04:7e:2c:ab,287930475,440,3707,287930035,287930475
19022,5,6,149,5745,-83,-97,14,54:e4:3a:ec:fb:65,287932836,360,2001,287932476,287932836
19023,5,12,149,5745,-72,-97,25,f2:da:61:dd:98:c5,287933305,268,201,287933037,287933305
19024,5,12,149,5745,-55,-97,42,4a:86:35:36:74:b8,287943102,268,9529,287942834,287943102
19025,5,12,149,5745,-70,-97,27,72:d1:72:1d:22:a1,287944638,284,1252,287944354,287944638
19026,5,12,149,5745,-63,-97,34,5e:29:73:5b:30:00,287951237,272,6327,287950965,287951237
19027,5,12,149,5745,-53,-97,44,3e:d1:9b:c7:a4:de,287958721,272,7212,287958449,287958721
19028,5,12,149,5745,-88,-97,9,42:d2:d9:2b:ac:61,287978848,248,19879,287978600,287978848
19029,5,12,149,5745,-64,-97,33,22:ec:75:a8:8a:31,287983631,244,4539,287983387,287983631
19030,5,12,149,5745,-89,-97,8,9a:24:38:da:96:bb,287984254,272,351,287983982,287984254
19031,5,12,149,5745,-72,-97,25,d2:00:04:7e:2c:ab,287985414,244,916,287985170,287985414
19032,5,12,149,5745,-64,-97,33,5e:29:73:5b:30:00,287988211,540,2257,287987671,287988211
19033,5,12,149,5745,-63,-97,34,a6:92:ad:b7:76:65,287988803,484,108,287988319,287988803
19034,5,12,149,5745,-62,-97,35,b6:90:18:f6:b1:d4,287991765,268,2694,287991497,287991765
19035,5,12,149,5745,-87,-97,10,9a:24:38:da:96:bb,287993894,824,1305,287993070,287993894
19036,5,12,149,5745,-64,-97,33,22:ec:75:a8:8a:31,287995087,516,677,287994571,287995087
19037,5,12,149,5745,-72,-97,25,d2:00:04:7e:2c:ab,287995855,440,328,287995415,287995855
19038,5,12,149,5745,-52,-97,45,3e:d1:9b:c7:a4:de,287996383,544,-16,287995839,287996383
19039,5,12,149,5745,-70,-97,27,f2:da:61:dd:98:c5,287999141,268,2490,287998873,287999141
19040,5,12,149,5745,-56,-97,41,4a:86:35:36:74:b8,288008559,268,9150,288008291,288008559
19041,5,12,149,5745,-57,-97,40,0a:b9:b7:b1:4d:fa,288013244,268,4417,288012976,288013244
19042,5,12,149,5745,-62,-97,35,b6:90:18:f6:b1:d4,288017011,268,3499,288016743,288017011
19043,5,12,149,5745,-56,-97,41,4a:86:35:36:74:b8,288034576,268,17297,288034308,288034576
19044,5,12,149,5745,-69,-97,28,f2:da:61:dd:98:c5,288035068,268,224,288034800,288035068
19045,5,6,149,5745,-83,-97,14,54:e4:3a:ec:fb:65,288035445,360,17,288035085,288035445
19046,5,6,149,5745,-70,-97,27,72:92:80:96:6f:66,288048545,168,12932,288048377,288048545
19047,5,6,149,5745,-70,-97,27,72:92:80:96:6f:66,288048731,156,30,288048575,288048731
19048,5,12,149,5745,-70,-97,27,72:d1:72:1d:22:a1,288057611,284,8596,288057327,288057611
19049,5,6,149,5745,-69,-97,28,72:92:80:96:6f:66,288058433,168,654,288058265,288058433
19050,5,6,149,5745,-69,-97,28,72:92:80:96:6f:66,288058618,156,29,288058462,288058618
19051,5,12,149,5745,-71,-97,26,d2:00:04:7e:2c:ab,288061540,440,2482,288061100,288061540
19052,5,12,149,5745,-66,-97,31,56:68:e2:c2:8d:d5,288062050,280,230,288061770,288062050
19053,5,12,149,5745,-66,-97,31,5e:29:73:5b:30:00,288068268,272,5946,288067996,288068268
19054,5,12,149,5745,-57,-97,40,4a:86:35:36:74:b8,288074093,268,5557,288073825,288074093
19055,5,12,149,5745,-51,-97,46,3e:d1:9b:c7:a4:de,288075686,272,1321,288075414,288075686
19056,5,12,149,5745,-64,-97,33,22:ec:75:a8:8a:31,288085676,244,9746,288085432,288085676
19057,5,12,149,5745,-90,-97,7,9a:24:38:da:96:bb,288096615,272,10667,288096343,288096615
19058,5,12,149,5745,-72,-97,25,d2:00:04:7e:2c:ab,288100113,244,3254,288099869,288100113
19059,5,24,149,5745,-83,-97,14,,288101929,28,1788,288101901,288101929
19060,5,24,149,5745,-84,-97,13,,288101973,28,16,288101945,288101973
19061,5,24,149,5745,-84,-97,13,,288102085,32,80,288102053,288102085
19062,5,24,149,5745,-84,-97,13,,288129941,28,27828,288129913,288129941
19063,5,24,149,5745,-83,-97,14,,288129985,28,16,288129957,288129985
19064,5,24,149,5745,-83,-97,14,,288130093,32,76,288130061,288130093
19065,5,24,149,5745,-84,-97,13,,288130286,28,165,288130258,288130286
19066,5,24,149,5745,-83,-97,14,,288130330,28,16,288130302,288130330
19067,5,24,149,5745,-84,-97,13,,288130437,32,75,288130405,288130437
19068,5,24,149,5745,-83,-97,14,,288132954,28,2489,288132926,288132954
19069,5,24,149,5745,-84,-97,13,,288132998,28,16,288132970,288132998
19070,5,24,149,5745,-83,-97,14,,288133110,32,80,288133078,288133110
19071,5,6,149,5745,-86,-97,11,54:e4:3a:ec:fb:65,288137638,360,4168,288137278,288137638
19072,5,12,149,5745,-63,-97,34,b6:90:18:f6:b1:d4,288162020,268,24114,288161752,288162020
19073,5,12,149,5745,-66,-97,31,56:68:e2:c2:8d:d5,288162718,280,418,288162438,288162718
19074,5,12,149,5745,-72,-97,25,72:d1:72:1d:22:a1,288169964,284,6962,288169680,288169964
19075,5,12,149,5745,-90,-97,7,42:d2:d9:2b:ac:61,288175756,248,5544,288175508,288175756
19076,5,12,149,5745,-66,-97,31,5e:29:73:5b:30:00,288183004,272,6976,288182732,288183004
19077,5,12,149,5745,-50,-97,47,3e:d1:9b:c7:a4:de,288192834,272,9558,288192562,288192834
19078,5,12,149,5745,-66,-97,31,f6:0a:5c:59:72:df,288195167,280,2053,288194887,288195167
19079,5,12,149,5745,-65,-97,32,22:ec:75:a8:8a:31,288199772,244,4361,288199528,288199772
19080,5,12,149,5745,-90,-97,7,9a:24:38:da:96:bb,288208520,272,8476,288208248,288208520
19081,5,6,149,5745,-85,-97,12,54:e4:3a:ec:fb:65,288240038,360,31158,288239678,288240038
19082,5,12,149,5745,-57,-97,40,4a:86:35:36:74:b8,288240633,268,327,288240365,288240633
19083,5,12,149,5745,-71,-97,26,f2:da:61:dd:98:c5,288240989,268,88,288240721,288240989
19084,5,12,149,5745,-62,-97,35,b6:90:18:f6:b1:d4,288264410,268,23153,288264142,288264410
19085,5,12,149,5745,-76,-97,21,d2:00:04:7e:2c:ab,288266317,244,1663,288266073,288266317
19086,5,12,149,5745,-68,-97,29,56:68:e2:c2:8d:d5,288266773,280,176,288266493,288266773
19087,5,12,149,5745,-91,-97,6,42:d2:d9:2b:ac:61,288278149,248,11128,288277901,288278149
19088,5,12,149,5745,-71,-97,26,72:d1:72:1d:22:a1,288280956,284,2523,288280672,288280956
19089,5,12,149,5745,-63,-97,34,5e:29:73:5b:30:00,288300239,272,19011,288299967,288300239
19090,5,12,149,5745,-48,-97,49,3e:d1:9b:c7:a4:de,288309761,272,9250,288309489,288309761
19091,5,12,149,5745,-64,-97,33,22:ec:75:a8:8a:31,288317632,244,7627,288317388,288317632
19092,5,12,149,5745,-87,-97,10,9a:24:38:da:96:bb,288321570,272,3666,288321298,288321570
19093,5,12,149,5745,-65,-97,32,f6:0a:5c:59:72:df,288330651,280,8801,288330371,288330651
19094,5,6,149,5745,-87,-97,10,54:e4:3a:ec:fb:65,288342439,360,11428,288342079,288342439
19095,5,12,149,5745,-57,-97,40,4a:86:35:36:74:b8,288342997,268,290,288342729,288342997
19096,5,12,149,5745,-73,-97,24,f2:da:61:dd:98:c5,288343360,268,95,288343092,288343360
19097,5,12,149,5745,-77,-97,20,d2:00:04:7e:2c:ab,288366346,244,22742,288366102,288366346
19098,5,12,149,5745,-68,-97,29,56:68:e2:c2:8d:d5,288367363,280,737,288367083,288367363
19099,5,12,149,5745,-65,-97,32,b6:90:18:f6:b1:d4,288367696,268,65,288367428,288367696
19100,5,12,149,5745,-91,-97,6,42:d2:d9:2b:ac:61,288379789,248,11845,288379541,288379789
19101,5,12,149,5745,-56,-97,41,4a:86:35:36:74:b8,288385410,268,5353,288385142,288385410
19102,5,12,149,5745,-71,-97,26,f2:da:61:dd:98:c5,288386324,268,646,288386056,288386324
19103,5,12,149,5745,-71,-97,26,72:d1:72:1d:22:a1,288398957,284,12349,288398673,288398957
19104,5,12,149,5745,-62,-97,35,5e:29:73:5b:30:00,288412168,272,12939,288411896,288412168
19105,5,12,149,5745,-89,-97,8,42:d2:d9:2b:ac:61,288431659,248,19243,288431411,288431659
19106,5,12,149,5745,-89,-97,8,9a:24:38:da:96:bb,288433012,272,1081,288432740,288433012
19107,5,12,149,5745,-65,-97,32,22:ec:75:a8:8a:31,288442334,244,9078,288442090,288442334
19108,5,12,149,5745,-52,-97,45,3e:d1:9b:c7:a4:de,288442657,544,-221,288442113,288442657
19109,5,12,149,5745,-52,-97,45,3e:d1:9b:c7:a4:de,288443289,272,360,288443017,288443289
19110,5,12,149,5745,-77,-97,20,d2:00:04:7e:2c:ab,288444622,244,1089,288444378,288444622
19111,5,12,149,5745,-64,-97,33,5e:29:73:5b:30:00,288444936,540,-226,288444396,288444936
19112,5,12,149,5745,-77,-97,20,d2:00:04:7e:2c:ab,288445510,440,134,288445070,288445510
19113,5,12,149,5745,-67,-97,30,56:68:e2:c2:8d:d5,288446002,476,16,288445526,288446002
19114,5,12,149,5745,-56,-97,41,4a:86:35:36:74:b8,288446514,268,244,288446246,288446514
19115,5,12,149,5745,-64,-97,33,b6:90:18:f6:b1:d4,288450710,268,3928,288450442,288450710
19116,5,12,149,5745,-65,-97,32,22:ec:75:a8:8a:31,288453091,516,1865,288452575,288453091
19117,5,12,149,5745,-71,-97,26,72:d1:72:1d:22:a1,288454687,480,1116,288454207,288454687
19118,5,12,149,5745,-69,-97,28,f2:da:61:dd:98:c5,288458675,268,3720,288458407,288458675
19119,5,12,149,5745,-63,-97,34,b6:90:18:f6:b1:d4,288460102,268,1159,288459834,288460102
19120,5,12,149,5745,-90,-97,7,42:d2:d9:2b:ac:61,288461595,452,1041,288461143,288461595
19121,5,12,149,5745,-65,-97,32,f6:0a:5c:59:72:df,288464594,476,2523,288464118,288464594
19122,5,12,149,5745,-67,-97,30,56:68:e2:c2:8d:d5,288476548,280,11674,288476268,288476548
19123,5,12,149,5745,-56,-97,41,4a:86:35:36:74:b8,288493351,268,16535,288493083,288493351
19124,5,12,149,5745,-70,-97,27,f2:da:61:dd:98:c5,288493878,268,259,288493610,288493878
19125,5,12,149,5745,-72,-97,25,72:d1:72:1d:22:a1,288496404,284,2242,288496120,288496404
19126,5,12,149,5745,-54,-97,43,3e:d1:9b:c7:a4:de,288508320,544,11372,288507776,288508320
19127,5,12,149,5745,-68,-97,29,56:68:e2:c2:8d:d5,288508907,476,111,288508431,288508907
19128,5,12,149,5745,-68,-97,29,5e:29:73:5b:30:00,288509435,540,-12,288508895,288509435
19129,5,12,149,5745,-56,-97,41,4a:86:35:36:74:b8,288510011,268,308,288509743,288510011
19130,5,12,149,5745,-76,-97,21,d2:00:04:7e:2c:ab,288510324,440,-127,288509884,288510324
19131,5,12,149,5745,-62,-97,35,b6:90:18:f6:b1:d4,288513095,268,2503,288512827,288513095
19132,5,12,149,5745,-67,-97,30,a6:92:ad:b7:76:65,288514192,484,613,288513708,288514192
19133,5,12,149,5745,-71,-97,26,72:d1:72:1d:22:a1,288517942,480,3270,288517462,288517942
19134,5,12,149,5745,-67,-97,30,22:ec:75:a8:8a:31,288518481,516,23,288517965,288518481
19135,5,12,149,5745,-66,-97,31,f6:0a:5c:59:72:df,288519094,128,485,288518966,288519094
19136,5,12,149,5745,-68,-97,29,f6:0a:5c:59:72:df,288519775,280,401,288519495,288519775
19137,5,12,149,5745,-71,-97,26,f2:da:61:dd:98:c5,288521076,268,1033,288520808,288521076
19138,5,12,149,5745,-68,-97,29,f6:0a:5c:59:72:df,288523672,476,2120,288523196,288523672
19139,5,12,149,5745,-88,-97,9,42:d2:d9:2b:ac:61,288524763,452,639,288524311,288524763
19140,5,12,149,5745,-76,-97,21,d2:00:04:7e:2c:ab,288525888,104,1021,288525784,288525888
19141,5,12,149,5745,-76,-97,21,d2:00:04:7e:2c:ab,288526153,380,-115,288525773,288526153
19142,5,12,149,5745,-89,-97,8,7e:05:42:11:d2:ec,288532259,440,5666,288531819,288532259
19143,5,12,149,5745,-61,-97,36,0a:b9:b7:b1:4d:fa,288536241,268,3714,288535973,288536241
19144,5,12,149,5745,-54,-97,43,3e:d1:9b:c7:a4:de,288541538,272,5025,288541266,288541538
19145,5,12,149,5745,-67,-97,30,5e:29:73:5b:30:00,288543050,272,1240,288542778,288543050
19146,5,12,149,5745,-88,-97,9,42:d2:d9:2b:ac:61,288543374,256,68,288543118,288543374
19147,5,12,149,5745,-87,-97,10,9a:24:38:da:96:bb,288544101,272,455,288543829,288544101
19148,5,24,149,5745,-85,-97,12,,288545189,32,1056,288545157,288545189
19149,5,6,149,5745,-85,-97,12,54:e4:3a:ec:fb:65,288547240,360,1691,288546880,288547240
19150,5,12,149,5745,-68,-97,29,22:ec:75:a8:8a:31,288557909,244,10425,288557665,288557909
19151,5,12,149,5745,-74,-97,23,d2:00:04:7e:2c:ab,288559359,244,1206,288559115,288559359
19152,5,24,149,5745,-85,-97,12,,288562787,28,3400,288562759,288562787
19153,5,24,149,5745,-89,-97,8,,288562832,28,17,288562804,288562832
19154,5,12,149,5745,-55,-97,42,4a:86:35:36:74:b8,288574670,268,11570,288574402,288574670
19155,5,12,149,5745,-73,-97,24,d2:00:04:7e:2c:ab,288575027,440,-83,288574587,288575027
19156,5,12,149,5745,-60,-97,37,b6:90:18:f6:b1:d4,288587497,268,12202,288587229,288587497
19157,5,12,149,5745,-67,-97,30,56:68:e2:c2:8d:d5,288591483,280,3706,288591203,288591483
19158,5,12,149,5745,-54,-97,43,4a:86:35:36:74:b8,288607711,268,15960,288607443,288607711
19159,5,12,149,5745,-71,-97,26,f2:da:61:dd:98:c5,288611102,268,3123,288610834,288611102
19160,5,12,149,5745,-71,-97,26,72:d1:72:1d:22:a1,288620563,284,9177,288620279,288620563
19161,5,12,149,5745,-65,-97,32,5e:29:73:5b:30:00,288638865,272,18030,288638593,288638865
19162,5,12,149,5745,-65,-97,32,f6:0a:5c:59:72:df,288649216,280,10071,288648936,288649216
19163,5,6,149,5745,-87,-97,10,54:e4:3a:ec:fb:65,288649640,360,64,288649280,288649640
19164,5,12,149,5745,-51,-97,46,3e:d1:9b:c7:a4:de,288651233,272,1321,288650961,288651233
19165,5,12,149,5745,-88,-97,9,9a:24:38:da:96:bb,288656040,272,4535,288655768,288656040
19166,5,12,149,5745,-71,-97,26,22:ec:75:a8:8a:31,288658806,244,2522,288658562,288658806
19167,5,12,149,5745,-65,-97,32,6a:1e:a4:f8:14:49,288673003,444,13753,288672559,288673003
19168,5,12,149,5745,-75,-97,22,d2:00:04:7e:2c:ab,288678661,244,5414,288678417,288678661
19169,5,12,149,5745,-90,-97,7,42:d2:d9:2b:ac:61,288687584,256,8667,288687328,288687584
19170,5,12,149,5745,-90,-97,7,7e:05:42:11:d2:ec,288724036,440,36012,288723596,288724036
19171,5,24,149,5745,-87,-97,10,,288740814,28,16750,288740786,288740814
19172,5,24,149,5745,-65,-97,32,,288742667,28,1825,288742639,288742667
19173,5,24,149,5745,-86,-97,11,,288742711,28,16,288742683,288742711
19174,5,24,149,5745,-85,-97,12,,288742820,28,81,288742792,288742820
19175,5,6,149,5745,-87,-97,10,54:e4:3a:ec:fb:65,288752041,360,8861,288751681,288752041
19176,5,12,149,5745,-55,-97,42,4a:86:35:36:74:b8,288752798,268,489,288752530,288752798
19177,5,12,149,5745,-69,-97,28,f2:da:61:dd:98:c5,288753135,268,69,288752867,288753135
19178,5,12,149,5745,-65,-97,32,6a:1e:a4:f8:14:49,288755460,284,2041,288755176,288755460
19179,5,12,149,5745,-61,-97,36,5e:29:73:5b:30:00,288756789,272,1057,288756517,288756789
19180,5,24,149,5745,-87,-97,10,,288758383,28,1566,288758355,288758383
19181,5,12,149,5745,-54,-97,43,3e:d1:9b:c7:a4:de,288763983,272,5328,288763711,288763983
19182,5,12,149,5745,-89,-97,8,9a:24:38:da:96:bb,288768821,272,4566,288768549,288768821
19183,5,12,149,5745,-67,-97,30,22:ec:75:a8:8a:31,288775871,244,6806,288775627,288775871
19184,5,12,149,5745,-58,-97,39,b6:90:18:f6:b1:d4,288776546,268,407,288776278,288776546
19185,5,12,149,5745,-67,-97,30,72:d1:72:1d:22:a1,288776904,284,74,288776620,288776904
19186,5,12,149,5745,-67,-97,30,56:68:e2:c2:8d:d5,288777258,280,74,288776978,288777258
19187,5,12,149,5745,-73,-97,24,d2:00:04:7e:2c:ab,288788544,244,11042,288788300,288788544
19188,5,12,149,5745,-87,-97,10,42:d2:d9:2b:ac:61,288789029,256,229,288788773,288789029
19189,5,24,149,5745,-87,-97,10,,288796314,32,7253,288796282,288796314
19190,5,24,149,5745,-86,-97,11,,288812914,28,16572,288812886,288812914
19191,5,6,149,5745,-87,-97,10,54:e4:3a:ec:fb:65,288854442,360,41168,288854082,288854442
19192,5,12,149,5745,-54,-97,43,4a:86:35:36:74:b8,288854925,268,215,288854657,288854925
19193,5,12,149,5745,-69,-97,28,f2:da:61:dd:98:c5,288855570,268,377,288855302,288855570
19194,5,24,149,5745,-84,-97,13,,288857970,32,2368,288857938,288857970
19195,5,12,149,5745,-66,-97,31,6a:1e:a4:f8:14:49,288865256,284,7002,288864972,288865256
19196,5,12,149,5745,-65,-97,32,5e:29:73:5b:30:00,288874047,272,8519,288873775,288874047
19197,5,12,149,5745,-59,-97,38,b6:90:18:f6:b1:d4,288877991,268,3676,288877723,288877991
19198,5,12,149,5745,-66,-97,31,72:d1:72:1d:22:a1,288878412,284,137,288878128,288878412
19199,5,12,149,5745,-65,-97,32,56:68:e2:c2:8d:d5,288881707,280,3015,288881427,288881707
19200,5,12,149,5745,-70,-97,27,22:ec:75:a8:8a:31,288901105,244,19154,288900861,288901105
19201,5,12,149,5745,-52,-97,45,3e:d1:9b:c7:a4:de,288901968,272,591,288901696,288901968
19202,5,12,149,5745,-52,-97,45,3e:d1:9b:c7:a4:de,288902715,544,203,288902171,288902715
19203,5,12,149,5745,-72,-97,25,d2:00:04:7e:2c:ab,288903294,244,335,288903050,288903294
19204,5,12,149,5745,-73,-97,24,d2:00:04:7e:2c:ab,288903557,440,-177,288903117,288903557
19205,5,12,149,5745,-60,-97,37,b6:90:18:f6:b1:d4,288905936,268,2111,288905668,288905936
19206,5,12,149,5745,-53,-97,44,4a:86:35:36:74:b8,288910298,268,4094,288910030,288910298
19207,5,12,149,5745,-67,-97,30,f6:0a:5c:59:72:df,288910681,128,255,288910553,288910681
19208,5,12,149,5745,-66,-97,31,72:d1:72:1d:22:a1,288910845,480,-316,288910365,288910845
19209,5,12,149,5745,-86,-97,11,9a:24:38:da:96:bb,288913043,824,1374,288912219,288913043
19210,5,12,149,5745,-70,-97,27,22:ec:75:a8:8a:31,288914047,516,488,288913531,288914047
19211,5,12,149,5745,-64,-97,33,56:68:e2:c2:8d:d5,288914832,476,309,288914356,288914832
19212,5,12,149,5745,-69,-97,28,5e:29:73:5b:30:00,288916215,540,843,288915675,288916215
19213,5,12,149,5745,-66,-97,31,f6:0a:5c:59:72:df,288916816,476,125,288916340,288916816
19214,5,12,149,5745,-60,-97,37,b6:90:18:f6:b1:d4,288918299,268,1215,288918031,288918299
19215,5,12,149,5745,-66,-97,31,6a:1e:a4:f8:14:49,288918763,480,-16,288918283,288918763
19216,5,12,149,5745,-65,-97,32,56:68:e2:c2:8d:d5,288919278,280,235,288918998,288919278
19217,5,12,149,5745,-73,-97,24,f2:da:61:dd:98:c5,288919637,268,91,288919369,288919637
19218,5,12,149,5745,-54,-97,43,4a:86:35:36:74:b8,288935362,268,15457,288935094,288935362
19219,5,12,149,5745,-72,-97,25,f2:da:61:dd:98:c5,288935826,268,196,288935558,288935826
19220,5,12,149,5745,-64,-97,33,72:d1:72:1d:22:a1,288954542,284,18432,288954258,288954542
19221,5,6,149,5745,-84,-97,13,54:e4:3a:ec:fb:65,288956842,360,1940,288956482,288956842
19222,5,12,149,5745,-71,-97,26,d2:00:04:7e:2c:ab,288968020,440,10738,288967580,288968020
19223,5,12,149,5745,-68,-97,29,6a:1e:a4:f8:14:49,288968611,284,307,288968327,288968611
19224,5,12,149,5745,-61,-97,36,b6:90:18:f6:b1:d4,288971773,268,2894,288971505,288971773
19225,5,12,149,5745,-57,-97,40,4a:86:35:36:74:b8,288974093,268,2052,288973825,288974093
19226,5,12,149,5745,-68,-97,29,6a:1e:a4:f8:14:49,288980695,480,6122,288980215,288980695
19227,5,12,149,5745,-64,-97,33,5e:29:73:5b:30:00,288990918,272,9951,288990646,288990918
19228,5,12,149,5745,-64,-97,33,f6:0a:5c:59:72:df,288992360,280,1162,288992080,288992360
19229,5,12,149,5745,-49,-97,48,3e:d1:9b:c7:a4:de,288998092,272,5460,288997820,288998092
19230,5,12,149,5745,-91,-97,6,42:d2:d9:2b:ac:61,289003829,256,5481,289003573,289003829
19231,5,12,149,5745,-69,-97,28,22:ec:75:a8:8a:31,289006237,244,2164,289005993,289006237
19232,5,12,149,5745,-73,-97,24,d2:00:04:7e:2c:ab,289018027,244,11546,289017783,289018027
19233,5,24,149,5745,-86,-97,11,,289026549,28,8494,289026521,289026549
19234,5,24,149,5745,-86,-97,11,,289026593,28,16,289026565,289026593
19235,5,24,149,5745,-86,-97,11,,289026701,32,76,289026669,289026701
19236,5,24,149,5745,-85,-97,12,,289026921,28,192,289026893,289026921
19237,5,24,149,5745,-86,-97,11,,289026965,28,16,289026937,289026965
19238,5,24,149,5745,-86,-97,11,,289027077,32,80,289027045,289027077
19239,5,24,149,5745,-86,-97,11,,289027161,28,56,289027133,289027161
19240,5,24,149,5745,-85,-97,12,,289027206,28,17,289027178,289027206
19241,5,24,149,5745,-85,-97,12,,289027321,32,83,289027289,289027321
19242,5,24,149,5745,-86,-97,11,,289028908,28,1559,289028880,289028908
19243,5,24,149,5745,-87,-97,10,,289028952,28,16,289028924,289028952
19244,5,24,149,5745,-86,-97,11,,289029061,32,77,289029029,289029061
19245,5,12,149,5745,-61,-97,36,b6:90:18:f6:b1:d4,289033147,268,3818,289032879,289033147
19246,5,12,149,5745,-72,-97,25,d2:00:04:7e:2c:ab,289033541,440,-46,289033101,289033541
19247,5,12,149,5745,-54,-97,43,3e:d1:9b:c7:a4:de,289034271,544,186,289033727,289034271
19248,5,24,149,5745,-85,-97,12,,289036353,28,2054,289036325,289036353
19249,5,24,149,5745,-85,-97,12,,289036397,28,16,289036369,289036397
19250,5,24,149,5745,-85,-97,12,,289036509,32,80,289036477,289036509
19251,5,12,149,5745,-59,-97,38,0a:b9:b7:b1:4d:fa,289037035,268,258,289036767,289037035
19252,5,12,149,5745,-61,-97,36,b6:90:18:f6:b1:d4,289037566,268,263,289037298,289037566
19253,5,12,149,5745,-65,-97,32,a6:92:ad:b7:76:65,289037877,484,-173,289037393,289037877
19254,5,12,149,5745,-55,-97,42,4a:86:35:36:74:b8,289039720,268,1575,289039452,289039720
19255,5,24,149,5745,-86,-97,11,,289041445,28,1697,289041417,289041445
19256,5,24,149,5745,-85,-97,12,,289041490,28,17,289041462,289041490
19257,5,24,149,5745,-85,-97,12,,289041598,32,76,289041566,289041598
19258,5,12,149,5745,-67,-97,30,22:ec:75:a8:8a:31,289042916,516,802,289042400,289042916
19259,5,12,149,5745,-89,-97,8,9a:24:38:da:96:bb,289044934,824,1194,289044110,289044934
19260,5,12,149,5745,-67,-97,30,6a:1e:a4:f8:14:49,289046216,480,802,289045736,289046216
19261,5,12,149,5745,-67,-97,30,5e:29:73:5b:30:00,289047648,540,892,289047108,289047648
19262,5,24,149,5745,-85,-97,12,,289049263,28,1587,289049235,289049263
19263,5,24,149,5745,-86,-97,11,,289049307,28,16,289049279,289049307
19264,5,24,149,5745,-86,-97,11,,289049415,32,76,289049383,289049415
19265,5,12,149,5745,-55,-97,42,4a:86:35:36:74:b8,289050157,268,474,289049889,289050157
19266,5,12,149,5745,-67,-97,30,f2:da:61:dd:98:c5,289050657,268,232,289050389,289050657
19267,5,12,149,5745,-68,-97,29,f2:da:61:dd:98:c5,289051058,268,133,289050790,289051058
19268,5,24,149,5745,-86,-97,11,,289051649,28,563,289051621,289051649
19269,5,24,149,5745,-85,-97,12,,289051694,28,17,289051666,289051694
19270,5,24,149,5745,-85,-97,12,,289051802,32,76,289051770,289051802
19271,5,24,149,5745,-85,-97,12,,289056616,28,4786,289056588,289056616
19272,5,24,149,5745,-85,-97,12,,289056661,28,17,289056633,289056661
19273,5,24,149,5745,-86,-97,11,,289056768,32,75,289056736,289056768
19274,5,24,149,5745,-86,-97,11,,289056880,32,80,289056848,289056880
19275,5,6,149,5745,-86,-97,11,54:e4:3a:ec:fb:65,289059242,360,2002,289058882,289059242
19276,5,24,149,5745,-86,-97,11,,289060365,28,1095,289060337,289060365
19277,5,24,149,5745,-85,-97,12,,289060410,28,17,289060382,289060410
19278,5,24,149,5745,-85,-97,12,,289060522,32,80,289060490,289060522
19279,5,24,149,5745,-87,-97,10,,289064693,28,4143,289064665,289064693
19280,5,24,149,5745,-85,-97,12,,289064737,28,16,289064709,289064737
19281,5,24,149,5745,-85,-97,12,,289064845,32,76,289064813,289064845
19282,5,12,149,5745,-87,-97,10,9a:24:38:da:96:bb,289076494,272,11377,289076222,289076494
19283,5,24,149,5745,-84,-97,13,,289078663,28,2141,289078635,289078663
19284,5,24,149,5745,-86,-97,11,,289078708,28,17,289078680,289078708
19285,5,24,149,5745,-87,-97,10,,289078815,32,75,289078783,289078815
19286,5,12,149,5745,-64,-97,33,6a:1e:a4:f8:14:49,289083729,284,4630,289083445,289083729
19287,5,12,149,5745,-69,-97,28,72:d1:72:1d:22:a1,289084218,284,205,289083934,289084218
19288,5,12,149,5745,-68,-97,29,56:68:e2:c2:8d:d5,289085975,280,1477,289085695,289085975
19289,5,12,149,5745,-73,-97,24,d2:00:04:7e:2c:ab,289098601,440,12186,289098161,289098601
19290,5,12,149,5745,-65,-97,32,f6:0a:5c:59:72:df,289101209,280,2328,289100929,289101209
19291,5,12,149,5745,-67,-97,30,5e:29:73:5b:30:00,289104793,272,3312,289104521,289104793
19292,5,12,149,5745,-65,-97,32,6a:1e:a4:f8:14:49,289111831,480,6558,289111351,289111831
19293,5,12,149,5745,-89,-97,8,42:d2:d9:2b:ac:61,289113191,256,1104,289112935,289113191
19294,5,12,149,5745,-51,-97,46,3e:d1:9b:c7:a4:de,289115028,272,1565,289114756,289115028
19295,5,12,149,5745,-69,-97,28,22:ec:75:a8:8a:31,289128555,244,13283,289128311,289128555
19296,5,12,149,5745,-71,-97,26,d2:00:04:7e:2c:ab,289131661,244,2862,289131417,289131661
19297,5,24,149,5745,-83,-97,14,,289150508,28,18819,289150480,289150508
19298,5,24,149,5745,-85,-97,12,,289150552,28,16,289150524,289150552
19299,5,24,149,5745,-85,-97,12,,289150668,32,84,289150636,289150668
19300,5,24,149,5745,-85,-97,12,,289150846,28,150,289150818,289150846
19301,5,24,149,5745,-85,-97,12,,289150890,28,16,289150862,289150890
19302,5,24,149,5745,-84,-97,13,,289150998,32,76,289150966,289150998
19303,5,12,149,5745,-65,-97,32,b6:90:18:f6:b1:d4,289152204,268,938,289151936,289152204
19304,5,24,149,5745,-84,-97,13,,289153586,28,1354,289153558,289153586
19305,5,24,149,5745,-84,-97,13,,289153630,28,16,289153602,289153630
19306,5,24,149,5745,-84,-97,13,,289153738,32,76,289153706,289153738
19307,5,24,149,5745,-85,-97,12,,289157875,28,4109,289157847,289157875
19308,5,24,149,5745,-85,-97,12,,289157919,28,16,289157891,289157919
19309,5,24,149,5745,-84,-97,13,,289158027,32,76,289157995,289158027
19310,5,6,149,5745,-89,-97,8,54:e4:3a:ec:fb:65,289161643,360,3256,289161283,289161643
19311,5,24,149,5745,-85,-97,12,,289171481,28,9810,289171453,289171481
19312,5,24,149,5745,-85,-97,12,,289171526,28,17,289171498,289171526
19313,5,24,149,5745,-86,-97,11,,289171634,32,76,289171602,289171634
19314,5,12,149,5745,-63,-97,34,4a:86:35:36:74:b8,289173626,268,1724,289173358,289173626
19315,5,12,149,5745,-68,-97,29,f2:da:61:dd:98:c5,289174857,268,963,289174589,289174857
19316,5,12,149,5745,-71,-97,26,72:d1:72:1d:22:a1,289186424,284,11283,289186140,289186424
19317,5,12,149,5745,-67,-97,30,56:68:e2:c2:8d:d5,289188372,280,1668,289188092,289188372
19318,5,12,149,5745,-68,-97,29,6a:1e:a4:f8:14:49,289204649,284,15993,289204365,289204649
19319,5,12,149,5745,-68,-97,29,5e:29:73:5b:30:00,289220801,272,15880,289220529,289220801
19320,5,24,149,5745,-69,-97,28,,289228291,28,7462,289228263,289228291
19321,5,24,149,5745,-84,-97,13,,289228335,28,16,289228307,289228335
19322,5,24,149,5745,-85,-97,12,,289228443,28,80,289228415,289228443
19323,5,12,149,5745,-47,-97,50,3e:d1:9b:c7:a4:de,289232018,272,3303,289231746,289232018
19324,5,12,149,5745,-64,-97,33,22:ec:75:a8:8a:31,289244599,244,12337,289244355,289244599
19325,5,24,149,5745,-85,-97,12,,289244949,28,322,289244921,289244949
19326,5,12,149,5745,-88,-97,9,7e:05:42:11:d2:ec,289250615,440,5226,289250175,289250615
19327,5,6,149,5745,-87,-97,10,54:e4:3a:ec:fb:65,289264044,360,13069,289263684,289264044
19328,5,12,149,5745,-53,-97,44,4a:86:35:36:74:b8,289280329,268,16017,289280061,289280329
19329,5,24,149,5745,-85,-97,12,,289286446,28,6089,289286418,289286446
19330,5,24,149,5745,-84,-97,13,,289286490,28,16,289286462,289286490
19331,5,24,149,5745,-84,-97,13,,289286598,32,76,289286566,289286598
19332,5,12,149,5745,-72,-97,25,d2:00:04:7e:2c:ab,289288454,244,1612,289288210,289288454
19333,5,12,149,5745,-63,-97,34,b6:90:18:f6:b1:d4,289288904,268,182,289288636,289288904
19334,5,12,149,5745,-68,-97,29,56:68:e2:c2:8d:d5,289289450,280,266,289289170,289289450
19335,5,24,149,5745,-72,-97,25,,289290440,28,962,289290412,289290440
19336,5,24,149,5745,-84,-97,13,,289290484,28,16,289290456,289290484
19337,5,24,149,5745,-85,-97,12,,289290592,28,80,289290564,289290592
19338,5,12,149,5745,-90,-97,7,42:d2:d9:2b:ac:61,289302381,256,11533,289302125,289302381
19339,5,12,149,5745,-84,-97,13,9a:24:38:da:96:bb,289304840,272,2187,289304568,289304840
19340,5,12,149,5745,-66,-97,31,72:d1:72:1d:22:a1,289305323,284,199,289305039,289305323
19341,5,24,149,5745,-83,-97,14,,289306333,28,982,289306305,289306333
19342,5,24,149,5745,-84,-97,13,,289306377,28,16,289306349,289306377
19343,5,24,149,5745,-85,-97,12,,289306486,32,77,289306454,289306486
19344,5,12,149,5745,-65,-97,32,5e:29:73:5b:30:00,289337678,272,30920,289337406,289337678
19345,5,24,149,5745,-68,-97,29,,289338299,28,593,289338271,289338299
19346,5,24,149,5745,-83,-97,14,,289338343,28,16,289338315,289338343
19347,5,24,149,5745,-83,-97,14,,289338451,28,80,289338423,289338451
19348,5,12,149,5745,-49,-97,48,3e:d1:9b:c7:a4:de,289347628,272,8905,289347356,289347628
19349,5,24,149,5745,-84,-97,13,,289355842,28,8186,289355814,289355842
19350,5,24,149,5745,-84,-97,13,,289356098,28,228,289356070,289356098
19351,5,12,149,5745,-62,-97,35,22:ec:75:a8:8a:31,289362431,244,6089,289362187,289362431
19352,5,12,149,5745,-65,-97,32,6a:1e:a4:f8:14:49,289362709,284,-6,289362425,289362709
19353,5,6,149,5745,-86,-97,11,54:e4:3a:ec:fb:65,289366444,360,3375,289366084,289366444
19354,5,12,149,5745,-68,-97,29,f2:da:61:dd:98:c5,289367291,268,579,289367023,289367291
19355,5,24,149,5745,-87,-97,10,,289378056,28,10737,289378028,289378056
19356,5,24,149,5745,-87,-97,10,,289378452,28,368,289378424,289378452
19357,5,24,149,5745,-87,-97,10,,289379101,28,621,289379073,289379101
19358,5,24,149,5745,-84,-97,13,,289379408,32,275,289379376,289379408
19359,5,24,149,5745,-85,-97,12,,289379907,32,467,289379875,289379907
19360,5,24,149,5745,-84,-97,13,,289380407,28,472,289380379,289380407
19361,5,24,149,5745,-83,-97,14,,289381221,28,786,289381193,289381221
19362,5,24,149,5745,-84,-97,13,,289381333,32,80,289381301,289381333
19363,5,12,149,5745,-74,-97,23,d2:00:04:7e:2c:ab,289390246,244,8669,289390002,289390246
19364,5,12,149,5745,-62,-97,35,b6:90:18:f6:b1:d4,289391059,268,545,289390791,289391059
19365,5,12,149,5745,-72,-97,25,56:68:e2:c2:8d:d5,289392000,280,661,289391720,289392000
19366,5,24,149,5745,-68,-97,29,,289398701,28,6673,289398673,289398701
19367,5,24,149,5745,-83,-97,14,,289398746,28,17,289398718,289398746
19368,5,24,149,5745,-84,-97,13,,289398854,28,80,289398826,289398854
19369,5,24,149,5745,-84,-97,13,,289399294,28,412,289399266,289399294
19370,5,24,149,5745,-88,-97,9,,289399338,28,16,289399310,289399338
19371,5,24,149,5745,-87,-97,10,,289399446,32,76,289399414,289399446
19372,5,12,149,5745,-88,-97,9,42:d2:d9:2b:ac:61,289404483,256,4781,289404227,289404483
19373,5,12,149,5745,-72,-97,25,72:d1:72:1d:22:a1,289407179,284,2412,289406895,289407179
19374,5,24,149,5745,-68,-97,29,,289429347,28,22140,289429319,289429347
19375,5,24,149,5745,-84,-97,13,,289429391,28,16,289429363,289429391
19376,5,24,149,5745,-83,-97,14,,289429499,28,80,289429471,289429499
19377,5,12,149,5745,-64,-97,33,5e:29:73:5b:30:00,289449001,272,19230,289448729,289449001
19378,5,12,149,5745,-87,-97,10,42:d2:d9:2b:ac:61,289457449,256,8192,289457193,289457449
19379,5,12,149,5745,-51,-97,46,3e:d1:9b:c7:a4:de,289459742,272,2021,289459470,289459742
19380,5,12,149,5745,-66,-97,31,6a:1e:a4:f8:14:49,289464381,284,4355,289464097,289464381
19381,5,12,149,5745,-69,-97,28,f2:da:61:dd:98:c5,289468711,268,4062,289468443,289468711
19382,5,6,149,5745,-90,-97,7,54:e4:3a:ec:fb:65,289469089,360,18,289468729,289469089
19383,5,12,149,5745,-49,-97,48,4a:86:35:36:74:b8,289469593,268,236,289469325,289469593
19384,5,12,149,5745,-70,-97,27,d2:00:04:7e:2c:ab,289477714,244,7877,289477470,289477714
19385,5,12,149,5745,-62,-97,35,22:ec:75:a8:8a:31,289490943,244,12985,289490699,289490943
19386,5,12,149,5745,-62,-97,35,b6:90:18:f6:b1:d4,289491547,268,336,289491279,289491547
19387,5,12,149,5745,-52,-97,45,3e:d1:9b:c7:a4:de,289491849,544,-242,289491305,289491849
19388,5,12,149,5745,-73,-97,24,56:68:e2:c2:8d:d5,289492438,280,309,289492158,289492438
19389,5,12,149,5745,-70,-97,27,d2:00:04:7e:2c:ab,289495292,440,2414,289494852,289495292
19390,5,12,149,5745,-63,-97,34,b6:90:18:f6:b1:d4,289498005,268,2445,289497737,289498005
19391,5,12,149,5745,-69,-97,28,72:d1:72:1d:22:a1,289498534,480,49,289498054,289498534
19392,5,12,149,5745,-49,-97,48,4a:86:35:36:74:b8,289499373,268,571,289499105,289499373
19393,5,12,149,5745,-61,-97,36,22:ec:75:a8:8a:31,289502249,516,2360,289501733,289502249
19394,5,12,149,5745,-62,-97,35,5e:29:73:5b:30:00,289503628,540,839,289503088,289503628
19395,5,12,149,5745,-66,-97,31,6a:1e:a4:f8:14:49,289505300,480,1192,289504820,289505300
19396,5,12,149,5745,-91,-97,6,42:d2:d9:2b:ac:61,289506983,452,1231,289506531,289506983
19397,5,12,149,5745,-72,-97,25,56:68:e2:c2:8d:d5,289507506,476,47,289507030,289507506
19398,5,12,149,5745,-70,-97,27,f2:da:61:dd:98:c5,289508061,268,287,289507793,289508061
19399,5,12,149,5745,-67,-97,30,f6:0a:5c:59:72:df,289508528,476,-9,289508052,289508528
19400,5,12,149,5745,-50,-97,47,4a:86:35:36:74:b8,289509238,268,442,289508970,289509238
19401,5,12,149,5745,-69,-97,28,72:d1:72:1d:22:a1,289509541,284,19,289509257,289509541
19402,5,12,149,5745,-70,-97,27,f2:da:61:dd:98:c5,289509895,268,86,289509627,289509895
19403,5,24,149,5745,-85,-97,12,,289511505,28,1582,289511477,289511505
19404,5,24,149,5745,-82,-97,15,,289511549,28,16,289511521,289511549
19405,5,24,149,5745,-82,-97,15,,289511657,32,76,289511625,289511657
19406,5,12,149,5745,-86,-97,11,9a:24:38:da:96:bb,289524785,272,12856,289524513,289524785
19407,5,12,149,5745,-67,-97,30,6a:1e:a4:f8:14:49,289525739,284,670,289525455,289525739
19408,5,24,149,5745,-82,-97,15,,289529588,28,3821,289529560,289529588
19409,5,24,149,5745,-85,-97,12,,289529633,28,17,289529605,289529633
19410,5,24,149,5745,-86,-97,11,,289529741,32,76,289529709,289529741
19411,5,12,149,5745,-68,-97,29,f6:0a:5c:59:72:df,289546578,280,16557,289546298,289546578
19412,5,12,149,5745,-49,-97,48,3e:d1:9b:c7:a4:de,289556855,544,9733,289556311,289556855
19413,5,12,149,5745,-88,-97,9,42:d2:d9:2b:ac:61,289558416,256,1305,289558160,289558416
19414,5,12,149,5745,-71,-97,26,d2:00:04:7e:2c:ab,289559639,440,783,289559199,289559639
19415,5,12,149,5745,-64,-97,33,b6:90:18:f6:b1:d4,289561194,268,1287,289560926,289561194
19416,5,12,149,5745,-56,-97,41,0a:b9:b7:b1:4d:fa,289561542,268,80,289561274,289561542
19417,5,12,149,5745,-66,-97,31,72:d1:72:1d:22:a1,289562060,480,38,289561580,289562060
19418,5,12,149,5745,-66,-97,31,a6:92:ad:b7:76:65,289562592,484,48,289562108,289562592
19419,5,12,149,5745,-53,-97,44,4a:86:35:36:74:b8,289564713,268,1853,289564445,289564713
19420,5,12,149,5745,-63,-97,34,22:ec:75:a8:8a:31,289566924,516,1695,289566408,289566924
19421,5,12,149,5745,-63,-97,34,5e:29:73:5b:30:00,289569329,540,1865,289568789,289569329
19422,5,12,149,5745,-70,-97,27,56:68:e2:c2:8d:d5,289569999,476,194,289569523,289569999
19423,5,12,149,5745,-65,-97,32,6a:1e:a4:f8:14:49,289570689,480,210,289570209,289570689
19424,5,12,149,5745,-71,-97,26,f6:0a:5c:59:72:df,289571536,476,371,289571060,289571536
19425,5,12,149,5745,-71,-97,26,f2:da:61:dd:98:c5,289572533,268,729,289572265,289572533
19426,5,12,149,5745,-87,-97,10,42:d2:d9:2b:ac:61,289573250,452,265,289572798,289573250
19427,5,12,149,5745,-71,-97,26,d2:00:04:7e:2c:ab,289574201,244,707,289573957,289574201
19428,5,12,149,5745,-63,-97,34,5e:29:73:5b:30:00,289575314,272,841,289575042,289575314
19429,5,12,149,5745,-92,-97,5,7e:05:42:11:d2:ec,289585263,440,9509,289584823,289585263
19430,5,12,149,5745,-63,-97,34,b6:90:18:f6:b1:d4,289589841,268,4310,289589573,289589841
19431,5,12,149,5745,-49,-97,48,3e:d1:9b:c7:a4:de,289590152,272,39,289589880,289590152
19432,5,12,149,5745,-69,-97,28,56:68:e2:c2:8d:d5,289590783,280,351,289590503,289590783
19433,5,24,149,5745,-87,-97,10,,289603672,28,12861,289603644,289603672
19434,5,24,149,5745,-82,-97,15,,289603716,28,16,289603688,289603716
19435,5,24,149,5745,-82,-97,15,,289603825,32,77,289603793,289603825
19436,5,12,149,5745,-64,-97,33,22:ec:75:a8:8a:31,289606474,244,2405,289606230,289606474
19437,5,12,149,5745,-64,-97,33,6a:1e:a4:f8:14:49,289610066,380,3212,289609686,289610066
19438,5,24,149,5745,-82,-97,15,,289621957,28,11863,289621929,289621957
19439,5,24,149,5745,-88,-97,9,,289622002,28,17,289621974,289622002
19440,5,24,149,5745,-86,-97,11,,289622110,32,76,289622078,289622110
19441,5,12,149,5745,-57,-97,40,4a:86:35:36:74:b8,289634784,268,12406,289634516,289634784
19442,5,12,149,5745,-72,-97,25,f2:da:61:dd:98:c5,289635687,268,635,289635419,289635687
19443,5,12,149,5745,-63,-97,34,6a:1e:a4:f8:14:49,289636079,480,-88,289635599,289636079
19444,5,12,149,5745,-87,-97,10,9a:24:38:da:96:bb,289637738,272,1387,289637466,289637738
19445,5,12,149,5745,-67,-97,30,72:d1:72:1d:22:a1,289638219,284,197,289637935,289638219
19446,5,12,149,5745,-63,-97,34,6a:1e:a4:f8:14:49,289640355,284,1852,289640071,289640355
19447,5,6,149,5745,-87,-97,10,54:e4:3a:ec:fb:65,289673646,360,32931,289673286,289673646
19448,5,12,149,5745,-62,-97,35,5e:29:73:5b:30:00,289679289,272,5371,289679017,289679289
19449,5,12,149,5745,-91,-97,6,42:d2:d9:2b:ac:61,289683976,256,4431,289683720,289683976
19450,5,12,149,5745,-51,-97,46,3e:d1:9b:c7:a4:de,289685375,272,1127,289685103,289685375
19451,5,12,149,5745,-70,-97,27,d2:00:04:7e:2c:ab,289699465,244,13846,289699221,289699465
19452,5,12,149,5745,-62,-97,35,22:ec:75:a8:8a:31,289703903,244,4194,289703659,289703903
19453,5,12,149,5745,-62,-97,35,b6:90:18:f6:b1:d4,289710036,268,5865,289709768,289710036
19454,5,12,149,5745,-68,-97,29,56:68:e2:c2:8d:d5,289712642,280,2326,289712362,289712642
19455,5,24,149,5745,-85,-97,12,,289735782,28,23112,289735754,289735782
19456,5,24,149,5745,-82,-97,15,,289735826,28,16,289735798,289735826
19457,5,24,149,5745,-82,-97,15,,289735934,32,76,289735902,289735934
19458,5,12,149,5745,-85,-97,12,9a:24:38:da:96:bb,289753337,272,17131,289753065,289753337
19459,5,24,149,5745,-81,-97,16,,289754233,28,868,289754205,289754233
19460,5,24,149,5745,-83,-97,14,,289754277,28,16,289754249,289754277
19461,5,24,149,5745,-84,-97,13,,289754385,32,76,289754353,289754385
19462,5,12,149,5745,-66,-97,31,6a:1e:a4:f8:14:49,289768159,284,13490,289767875,289768159
19463,5,6,149,5745,-90,-97,7,54:e4:3a:ec:fb:65,289776046,360,7527,289775686,289776046
19464,5,12,149,5745,-70,-97,27,f2:da:61:dd:98:c5,289776795,268,481,289776527,289776795
19465,5,12,149,5745,-56,-97,41,4a:86:35:36:74:b8,289777176,268,113,289776908,289777176
19466,5,12,149,5745,-64,-97,33,5e:29:73:5b:30:00,289796292,272,18844,289796020,289796292
19467,5,24,149,5745,-81,-97,16,,289796970,32,646,289796938,289796970
19468,5,12,149,5745,-73,-97,24,72:d1:72:1d:22:a1,289800258,284,3004,289799974,289800258
19469,5,12,149,5745,-52,-97,45,3e:d1:9b:c7:a4:de,289803055,272,2525,289802783,289803055
19470,5,12,149,5745,-70,-97,27,d2:00:04:7e:2c:ab,289812416,244,9117,289812172,289812416
19471,5,12,149,5745,-90,-97,7,42:d2:d9:2b:ac:61,289813748,256,1076,289813492,289813748
19472,5,24,149,5745,-80,-97,17,,289815048,32,1268,289815016,289815048
19473,5,24,149,5745,-80,-97,17,,289815416,28,340,289815388,289815416
19474,5,12,149,5745,-65,-97,32,22:ec:75:a8:8a:31,289820967,244,5307,289820723,289820967
19475,5,24,149,5745,-82,-97,15,,289828134,28,7139,289828106,289828134
19476,5,24,149,5745,-80,-97,17,,289828178,28,16,289828150,289828178
19477,5,24,149,5745,-80,-97,17,,289828287,32,77,289828255,289828287
19478,5,24,149,5745,-81,-97,16,,289845778,28,17463,289845750,289845778
19479,5,24,149,5745,-83,-97,14,,289845822,28,16,289845794,289845822
19480,5,24,149,5745,-84,-97,13,,289845930,32,76,289845898,289845930
19481,5,24,149,5745,-81,-97,16,,289857996,32,12034,289857964,289857996
19482,5,12,149,5745,-86,-97,11,9a:24:38:da:96:bb,289862063,272,3795,289861791,289862063
19483,5,12,149,5745,-67,-97,30,6a:1e:a4:f8:14:49,289878068,284,15721,289877784,289878068
19484,5,6,149,5745,-89,-97,8,54:e4:3a:ec:fb:65,289878447,360,19,289878087,289878447
19485,5,12,149,5745,-69,-97,28,f2:da:61:dd:98:c5,289879395,268,680,289879127,289879395
19486,5,12,149,5745,-53,-97,44,4a:86:35:36:74:b8,289879839,268,176,289879571,289879839
19487,5,12,149,5745,-72,-97,25,72:d1:72:1d:22:a1,289903092,284,22969,289902808,289903092
19488,5,12,149,5745,-60,-97,37,b6:90:18:f6:b1:d4,289903405,268,45,289903137,289903405
19489,5,12,149,5745,-68,-97,29,56:68:e2:c2:8d:d5,289905128,280,1443,289904848,289905128
19490,5,12,149,5745,-66,-97,31,f6:0a:5c:59:72:df,289912647,280,7239,289912367,289912647
19491,5,12,149,5745,-64,-97,33,5e:29:73:5b:30:00,289913352,272,433,289913080,289913352
19492,5,12,149,5745,-91,-97,6,42:d2:d9:2b:ac:61,289916401,256,2793,289916145,289916401
19493,5,12,149,5745,-53,-97,44,3e:d1:9b:c7:a4:de,289918718,272,2045,289918446,289918718
19494,5,24,149,5745,-71,-97,26,,289923658,28,4912,289923630,289923658
19495,5,24,149,5745,-80,-97,17,,289923702,28,16,289923674,289923702
19496,5,24,149,5745,-80,-97,17,,289923810,28,80,289923782,289923810
19497,5,12,149,5745,-60,-97,37,b6:90:18:f6:b1:d4,289935641,268,11563,289935373,289935641
19498,5,12,149,5745,-70,-97,27,d2:00:04:7e:2c:ab,289936755,244,870,289936511,289936755
19499,5,12,149,5745,-68,-97,29,56:68:e2:c2:8d:d5,289939445,280,2410,289939165,289939445
19500,5,24,149,5745,-80,-97,17,,289941949,32,2472,289941917,289941949
19501,5,24,149,5745,-81,-97,16,,289942457,32,476,289942425,289942457
19502,5,24,149,5745,-81,-97,16,,289942966,28,481,289942938,289942966
19503,5,12,149,5745,-67,-97,30,22:ec:75:a8:8a:31,289949713,244,6503,289949469,289949713
19504,5,12,149,5745,-54,-97,43,4a:86:35:36:74:b8,289951405,268,1424,289951137,289951405
19505,5,12,149,5745,-53,-97,44,3e:d1:9b:c7:a4:de,289951752,544,-197,289951208,289951752
19506,5,12,149,5745,-72,-97,25,72:d1:72:1d:22:a1,289956814,480,4582,289956334,289956814
19507,5,12,149,5745,-67,-97,30,f6:0a:5c:59:72:df,289958254,128,1312,289958126,289958254
19508,5,12,149,5745,-54,-97,43,4a:86:35:36:74:b8,289958676,176,246,289958500,289958676
19509,5,12,149,5745,-55,-97,42,4a:86:35:36:74:b8,289960624,268,1680,289960356,289960624
19510,5,12,149,5745,-67,-97,30,22:ec:75:a8:8a:31,289961639,516,499,289961123,289961639
19511,5,12,149,5745,-62,-97,35,5e:29:73:5b:30:00,289964371,540,2192,289963831,289964371
19512,5,12,149,5745,-67,-97,30,f6:0a:5c:59:72:df,289965035,476,188,289964559,289965035
19513,5,12,149,5745,-91,-97,6,42:d2:d9:2b:ac:61,289965869,452,382,289965417,289965869
19514,5,12,149,5745,-68,-97,29,6a:1e:a4:f8:14:49,289966508,380,259,289966128,289966508
19515,5,12,149,5745,-72,-97,25,72:d1:72:1d:22:a1,289967512,284,720,289967228,289967512
19516,5,12,149,5745,-69,-97,28,f2:da:61:dd:98:c5,289968742,268,962,289968474,289968742
19517,5,12,149,5745,-87,-97,10,9a:24:38:da:96:bb,289973521,272,4507,289973249,289973521
19518,5,24,149,5745,-80,-97,17,,289979403,28,5854,289979375,289979403
19519,5,24,149,5745,-85,-97,12,,289979447,28,16,289979419,289979447
19520,5,24,149,5745,-85,-97,12,,289979555,32,76,289979523,289979555
19521,5,6,149,5745,-87,-97,10,54:e4:3a:ec:fb:65,289981026,360,1111,289980666,289981026
19522,5,12,149,5745,-69,-97,28,6a:1e:a4:f8:14:49,289984456,284,3146,289984172,289984456
19523,5,12,149,5745,-69,-97,28,f6:0a:5c:59:72:df,289997971,280,13235,289997691,289997971
19524,5,24,149,5745,-71,-97,26,,289998309,28,310,289998281,289998309
19525,5,24,149,5745,-80,-97,17,,289998353,28,16,289998325,289998353
19526,5,24,149,5745,-80,-97,17,,289998461,28,80,289998433,289998461
19527,5,12,149,5745,-55,-97,42,4a:86:35:36:74:b8,290023102,268,24373,290022834,290023102
19528,5,12,149,5745,-61,-97,36,5e:29:73:5b:30:00,290027224,272,3850,290026952,290027224
19529,5,12,149,5745,-67,-97,30,6a:1e:a4:f8:14:49,290029465,480,1761,290028985,290029465
19530,5,12,149,5745,-54,-97,43,3e:d1:9b:c7:a4:de,290032617,272,2880,290032345,290032617
19531,5,12,149,5745,-67,-97,30,56:68:e2:c2:8d:d5,290052070,280,19173,290051790,290052070
19532,5,12,149,5745,-66,-97,31,22:ec:75:a8:8a:31,290053281,244,967,290053037,290053281
19533,5,24,149,5745,-85,-97,12,,290053713,28,404,290053685,290053713
19534,5,24,149,5745,-80,-97,17,,290053757,28,16,290053729,290053757
19535,5,24,149,5745,-80,-97,17,,290053865,32,76,290053833,290053865
19536,5,12,149,5745,-55,-97,42,4a:86:35:36:74:b8,290066134,268,12001,290065866,290066134
19537,5,12,149,5745,-89,-97,8,7e:05:42:11:d2:ec,290066907,244,529,290066663,290066907
19538,5,24,149,5745,-80,-97,17,,290072149,28,5214,290072121,290072149
19539,5,24,149,5745,-85,-97,12,,290072193,28,16,290072165,290072193
19540,5,24,149,5745,-85,-97,12,,290072301,32,76,290072269,290072301
19541,5,12,149,5745,-55,-97,42,3e:d1:9b:c7:a4:de,290081687,544,8842,290081143,290081687
19542,5,12,149,5745,-70,-97,27,f2:da:61:dd:98:c5,290082933,268,978,290082665,290082933
19543,5,6,149,5745,-87,-97,10,54:e4:3a:ec:fb:65,290083248,360,-45,290082888,290083248
19544,5,12,149,5745,-59,-97,38,0a:b9:b7:b1:4d:fa,290084027,268,511,290083759,290084027
19545,5,24,149,5745,-85,-97,12,,290084402,28,347,290084374,290084402
19546,5,24,149,5745,-80,-97,17,,290084446,28,16,290084418,290084446
19547,5,24,149,5745,-81,-97,16,,290084554,32,76,290084522,290084554
19548,5,12,149,5745,-86,-97,11,9a:24:38:da:96:bb,290085791,272,965,290085519,290085791
19549,5,12,149,5745,-70,-97,27,a6:92:ad:b7:76:65,290086871,484,596,290086387,290086871
19550,5,12,149,5745,-55,-97,42,4a:86:35:36:74:b8,290088300,268,1161,290088032,290088300
19551,5,12,149,5745,-59,-97,38,b6:90:18:f6:b1:d4,290088649,268,81,290088381,290088649
19552,5,12,149,5745,-73,-97,24,72:d1:72:1d:22:a1,290089339,284,406,290089055,290089339
19553,5,12,149,5745,-66,-97,31,22:ec:75:a8:8a:31,290093041,516,3186,290092525,290093041
19554,5,12,149,5745,-86,-97,11,9a:24:38:da:96:bb,290093729,824,-136,290092905,290093729
19555,5,12,149,5745,-66,-97,31,6a:1e:a4:f8:14:49,290095028,480,819,290094548,290095028
19556,5,12,149,5745,-63,-97,34,5e:29:73:5b:30:00,290096451,540,883,290095911,290096451
19557,5,12,149,5745,-88,-97,9,7e:05:42:11:d2:ec,290097500,440,609,290097060,290097500
19558,5,12,149,5745,-70,-97,27,f2:da:61:dd:98:c5,290098535,268,767,290098267,290098535
19559,5,12,149,5745,-66,-97,31,6a:1e:a4:f8:14:49,290099125,284,306,290098841,290099125
19560,5,24,149,5745,-81,-97,16,,290102643,28,3490,290102615,290102643
19561,5,24,149,5745,-84,-97,13,,290102687,28,16,290102659,290102687
19562,5,24,149,5745,-85,-97,12,,290102795,32,76,290102763,290102795
19563,5,12,149,5745,-89,-97,8,42:d2:d9:2b:ac:61,290133608,256,30557,290133352,290133608
19564,5,12,149,5745,-65,-97,32,5e:29:73:5b:30:00,290141582,272,7702,290141310,290141582
19565,5,12,149,5745,-56,-97,41,3e:d1:9b:c7:a4:de,290149962,272,8108,290149690,290149962
19566,5,12,149,5745,-66,-97,31,6a:1e:a4:f8:14:49,290160400,480,9958,290159920,290160400
19567,5,12,149,5745,-66,-97,31,22:ec:75:a8:8a:31,290168320,244,7676,290168076,290168320
19568,5,6,149,5745,-87,-97,10,54:e4:3a:ec:fb:65,290185649,360,16969,290185289,290185649
19569,5,24,149,5745,-85,-97,12,,290187030,28,1353,290187002,290187030
19570,5,24,149,5745,-80,-97,17,,290187074,28,16,290187046,290187074
19571,5,24,149,5745,-79,-97,18,,290187182,32,76,290187150,290187182
19572,5,12,149,5745,-56,-97,41,4a:86:35:36:74:b8,290190750,268,3300,290190482,290190750
19573,5,12,149,5745,-72,-97,25,f2:da:61:dd:98:c5,290191269,268,251,290191001,290191269
19574,5,12,149,5745,-86,-97,11,9a:24:38:da:96:bb,290199667,272,8126,290199395,290199667
19575,5,12,149,5745,-90,-97,7,7e:05:42:11:d2:ec,290200639,244,728,290200395,290200639
19576,5,12,149,5745,-73,-97,24,72:d1:72:1d:22:a1,290202128,284,1205,290201844,290202128
19577,5,24,149,5745,-80,-97,17,,290205243,28,3087,290205215,290205243
19578,5,24,149,5745,-85,-97,12,,290205287,28,16,290205259,290205287
19579,5,24,149,5745,-85,-97,12,,290205395,32,76,290205363,290205395
19580,5,12,149,5745,-68,-97,29,56:68:e2:c2:8d:d5,290212375,280,6700,290212095,290212375
19581,5,12,149,5745,-64,-97,33,6a:1e:a4:f8:14:49,290227467,284,14808,290227183,290227467
19582,5,12,149,5745,-66,-97,31,5e:29:73:5b:30:00,290258464,272,30725,290258192,290258464
19583,5,12,149,5745,-55,-97,42,3e:d1:9b:c7:a4:de,290266567,272,7831,290266295,290266567
19584,5,24,149,5745,-81,-97,16,,290278272,32,11673,290278240,290278272
19585,5,12,149,5745,-67,-97,30,22:ec:75:a8:8a:31,290286302,244,7786,290286058,290286302
19586,5,6,149,5745,-89,-97,8,54:e4:3a:ec:fb:65,290288049,360,1387,290287689,290288049
19587,5,24,149,5745,-80,-97,17,,290296659,28,8582,290296631,290296659
19588,5,24,149,5745,-87,-97,10,,290296703,28,16,290296675,290296703
19589,5,12,149,5745,-55,-97,42,4a:86:35:36:74:b8,290301103,268,4132,290300835,290301103
19590,5,12,149,5745,-71,-97,26,f2:da:61:dd:98:c5,290301531,268,160,290301263,290301531
19591,5,12,149,5745,-68,-97,29,56:68:e2:c2:8d:d5,290313522,280,11711,290313242,290313522
19592,5,12,149,5745,-73,-97,24,72:d1:72:1d:22:a1,290315061,284,1255,290314777,290315061
19593,5,12,149,5745,-84,-97,13,9a:24:38:da:96:bb,290316050,272,717,290315778,290316050
19594,5,12,149,5745,-89,-97,8,42:d2:d9:2b:ac:61,290326558,256,10252,290326302,290326558
19595,5,12,149,5745,-89,-97,8,7e:05:42:11:d2:ec,290330976,244,4174,290330732,290330976
19596,5,12,149,5745,-66,-97,31,f6:0a:5c:59:72:df,290358374,280,27118,290358094,290358374
19597,5,12,149,5745,-65,-97,32,5e:29:73:5b:30:00,290375030,272,16384,290374758,290375030
19598,5,12,149,5745,-57,-97,40,3e:d1:9b:c7:a4:de,290383848,272,8546,290383576,290383848
19599,5,12,149,5745,-63,-97,34,6a:1e:a4:f8:14:49,290387631,284,3499,290387347,290387631
19600,5,6,149,5745,-89,-97,8,54:e4:3a:ec:fb:65,290390449,360,2458,290390089,290390449
19601,5,12,149,5745,-67,-97,30,22:ec:75:a8:8a:31,290403432,244,12739,290403188,290403432
19602,5,24,149,5745,-86,-97,11,,290411529,28,8069,290411501,290411529
19603,5,24,149,5745,-81,-97,16,,290411573,28,16,290411545,290411573
19604,5,24,149,5745,-81,-97,16,,290411682,32,77,290411650,290411682
19605,5,12,149,5745,-68,-97,29,56:68:e2:c2:8d:d5,290415958,280,3996,290415678,290415958
19606,5,12,149,5745,-85,-97,12,9a:24:38:da:96:bb,290424170,272,7940,290423898,290424170
19607,5,12,149,5745,-70,-97,27,72:d1:72:1d:22:a1,290427602,284,3148,290427318,290427602
19608,5,12,149,5745,-88,-97,9,42:d2:d9:2b:ac:61,290428645,256,787,290428389,290428645
19609,5,24,149,5745,-82,-97,15,,290429567,28,894,290429539,290429567
19610,5,24,149,5745,-86,-97,11,,290429612,28,17,290429584,290429612
19611,5,24,149,5745,-87,-97,10,,290429720,32,76,290429688,290429720
19612,5,12,149,5745,-87,-97,10,7e:05:42:11:d2:ec,290432482,244,2518,290432238,290432482
19613,5,12,149,5745,-90,-97,7,42:d2:d9:2b:ac:61,290478393,256,45655,290478137,290478393
19614,5,12,149,5745,-62,-97,35,5e:29:73:5b:30:00,290487267,272,8602,290486995,290487267
19615,5,12,149,5745,-65,-97,32,6a:1e:a4:f8:14:49,290488957,284,1406,290488673,290488957
19616,5,6,149,5745,-89,-97,8,54:e4:3a:ec:fb:65,290492850,360,3533,290492490,290492850
19617,5,12,149,5745,-72,-97,25,f2:da:61:dd:98:c5,290493444,268,326,290493176,290493444
19618,5,12,149,5745,-55,-97,42,4a:86:35:36:74:b8,290494132,268,420,290493864,290494132
19619,5,12,149,5745,-57,-97,40,3e:d1:9b:c7:a4:de,290495680,272,1276,290495408,290495680
19620,5,24,149,5745,-85,-97,12,,290500249,28,4541,290500221,290500249
19621,5,24,149,5745,-81,-97,16,,290500293,28,16,290500265,290500293
19622,5,24,149,5745,-81,-97,16,,290500402,32,77,290500370,290500402
19623,5,12,149,5745,-65,-97,32,22:ec:75:a8:8a:31,290515233,244,14587,290514989,290515233
19624,5,24,149,5745,-81,-97,16,,290518698,28,3437,290518670,290518698
19625,5,24,149,5745,-85,-97,12,,290518742,28,16,290518714,290518742
19626,5,24,149,5745,-84,-97,13,,290518850,32,76,290518818,290518850
19627,5,12,149,5745,-68,-97,29,56:68:e2:c2:8d:d5,290518970,280,-160,290518690,290518970
19628,5,12,149,5745,-88,-97,9,7e:05:42:11:d2:ec,290526485,244,7271,290526241,290526485
19629,5,12,149,5745,-55,-97,42,4a:86:35:36:74:b8,290527592,268,839,290527324,290527592
19630,5,12,149,5745,-73,-97,24,f2:da:61:dd:98:c5,290528074,268,214,290527806,290528074
19631,5,12,149,5745,-87,-97,10,9a:24:38:da:96:bb,290535020,272,6674,290534748,290535020
19632,5,12,149,5745,-57,-97,40,3e:d1:9b:c7:a4:de,290540136,544,4572,290539592,290540136
19633,5,12,149,5745,-68,-97,29,72:d1:72:1d:22:a1,290540788,284,368,290540504,290540788
19634,5,12,149,5745,-65,-97,32,6a:1e:a4:f8:14:49,290541511,284,439,290541227,290541511
19635,5,12,149,5745,-68,-97,29,72:d1:72:1d:22:a1,290546925,480,4934,290546445,290546925
19636,5,12,149,5745,-55,-97,42,4a:86:35:36:74:b8,290550113,268,2920,290549845,290550113
19637,5,12,149,5745,-64,-97,33,22:ec:75:a8:8a:31,290550841,516,212,290550325,290550841
19638,5,12,149,5745,-66,-97,31,5e:29:73:5b:30:00,290552579,540,1198,290552039,290552579
19639,5,12,149,5745,-69,-97,28,56:68:e2:c2:8d:d5,290553928,476,873,290553452,290553928
19640,5,12,149,5745,-65,-97,32,6a:1e:a4:f8:14:49,290556619,480,2211,290556139,290556619
19641,5,12,149,5745,-65,-97,32,f6:0a:5c:59:72:df,290557105,476,10,290556629,290557105
19642,5,12,149,5745,-71,-97,26,f2:da:61:dd:98:c5,290558561,268,1188,290558293,290558561
19643,5,6,149,5745,-74,-97,23,48:e7:da:41:38:ff,290562233,80,3592,290562153,290562233
19644,5,6,149,5745,-74,-97,23,48:e7:da:41:38:ff,290562368,220,-85,290562148,290562368
19645,5,6,149,5745,-74,-97,23,48:e7:da:41:38:ff,290562652,92,192,290562560,290562652
19646,5,6,149,5745,-74,-97,23,48:e7:da:41:38:ff,290562781,236,-107,290562545,290562781
19647,5,12,149,5745,-65,-97,32,f6:0a:5c:59:72:df,290572683,280,9622,290572403,290572683
19648,5,6,149,5745,-89,-97,8,54:e4:3a:ec:fb:65,290595251,360,22208,290594891,290595251
19649,5,12,149,5745,-55,-97,42,3e:d1:9b:c7:a4:de,290605512,544,9717,290604968,290605512
19650,5,12,149,5745,-69,-97,28,56:68:e2:c2:8d:d5,290606603,280,811,290606323,290606603
19651,5,12,149,5745,-66,-97,31,5e:29:73:5b:30:00,290607521,272,646,290607249,290607521
19652,5,12,149,5745,-54,-97,43,0a:b9:b7:b1:4d:fa,290608475,268,686,290608207,290608475
19653,5,12,149,5745,-64,-97,33,a6:92:ad:b7:76:65,290609910,484,951,290609426,290609910
19654,5,12,149,5745,-65,-97,32,72:d1:72:1d:22:a1,290610799,480,409,290610319,290610799
19655,5,12,149,5745,-59,-97,38,b6:90:18:f6:b1:d4,290611954,268,887,290611686,290611954
19656,5,12,149,5745,-54,-97,43,4a:86:35:36:74:b8,290612685,268,463,290612417,290612685
19657,5,12,149,5745,-62,-97,35,22:ec:75:a8:8a:31,290615117,516,1916,290614601,290615117
19658,5,12,149,5745,-69,-97,28,f6:0a:5c:59:72:df,290615775,128,530,290615647,290615775
19659,5,12,149,5745,-69,-97,28,f6:0a:5c:59:72:df,290615921,268,-122,290615653,290615921
19660,5,12,149,5745,-70,-97,27,56:68:e2:c2:8d:d5,290616268,268,79,290616000,290616268
19661,5,12,149,5745,-66,-97,31,5e:29:73:5b:30:00,290618023,540,1215,290617483,290618023
19662,5,12,149,5745,-69,-97,28,56:68:e2:c2:8d:d5,290619030,476,531,290618554,290619030
19663,5,12,149,5745,-70,-97,27,f6:0a:5c:59:72:df,290620779,476,1273,290620303,290620779
19664,5,12,149,5745,-70,-97,27,f2:da:61:dd:98:c5,290621431,268,384,290621163,290621431
19665,5,12,149,5745,-69,-97,28,6a:1e:a4:f8:14:49,290621901,480,-10,290621421,290621901
19666,5,12,149,5745,-53,-97,44,3e:d1:9b:c7:a4:de,290622442,272,269,290622170,290622442
19667,5,12,149,5745,-62,-97,35,22:ec:75:a8:8a:31,290637800,244,15114,290637556,290637800
19668,5,12,149,5745,-53,-97,44,4a:86:35:36:74:b8,290639258,268,1190,290638990,290639258
19669,5,12,149,5745,-65,-97,32,72:d1:72:1d:22:a1,290639607,284,65,290639323,290639607
19670,5,12,149,5745,-71,-97,26,f2:da:61:dd:98:c5,290639943,268,68,290639675,290639943
19671,5,12,149,5745,-88,-97,9,9a:24:38:da:96:bb,290647897,272,7682,290647625,290647897
19672,5,12,149,5745,-70,-97,27,6a:1e:a4:f8:14:49,290656600,284,8419,290656316,290656600
19673,5,6,149,5745,-88,-97,9,54:e4:3a:ec:fb:65,290697651,360,40691,290697291,290697651
19674,5,12,149,5745,-90,-97,7,42:d2:d9:2b:ac:61,290705104,256,7197,290704848,290705104
19675,5,12,149,5745,-64,-97,33,5e:29:73:5b:30:00,290715877,272,10501,290715605,290715877
19676,5,12,149,5745,-48,-97,49,3e:d1:9b:c7:a4:de,290725381,272,9232,290725109,290725381
19677,5,12,149,5745,-70,-97,27,56:68:e2:c2:8d:d5,290729503,280,3842,290729223,290729503
19678,5,12,149,5745,-64,-97,33,22:ec:75:a8:8a:31,290745089,244,15342,290744845,290745089
19679,5,24,149,5745,-87,-97,10,,290795533,32,50412,290795501,290795533
19680,5,24,149,5745,-85,-97,12,,290795994,32,429,290795962,290795994
19681,5,12,149,5745,-70,-97,27,6a:1e:a4:f8:14:49,290797248,284,970,290796964,290797248
19682,5,6,149,5745,-89,-97,8,54:e4:3a:ec:fb:65,290800052,360,2444,290799692,290800052
19683,5,12,149,5745,-54,-97,43,4a:86:35:36:74:b8,290800626,268,306,290800358,290800626
19684,5,12,149,5745,-74,-97,23,f2:da:61:dd:98:c5,290801013,268,119,290800745,290801013
19685,5,24,149,5745,-84,-97,13,,290812635,28,11594,290812607,290812635
19686,5,12,149,5745,-68,-97,29,f6:0a:5c:59:72:df,290816385,280,3470,290816105,290816385
19687,5,12,149,5745,-68,-97,29,72:d1:72:1d:22:a1,290825129,284,8460,290824845,290825129
19688,5,12,149,5745,-64,-97,33,5e:29:73:5b:30:00,290832823,272,7422,290832551,290832823
19689,5,12,149,5745,-90,-97,7,42:d2:d9:2b:ac:61,290838079,256,5000,290837823,290838079
19690,5,12,149,5745,-71,-97,26,56:68:e2:c2:8d:d5,290839386,280,1027,290839106,290839386
19691,5,12,149,5745,-47,-97,50,3e:d1:9b:c7:a4:de,290840504,272,846,290840232,290840504
19692,5,12,149,5745,-92,-97,5,7e:05:42:11:d2:ec,290842739,244,1991,290842495,290842739
19693,5,24,149,5745,-87,-97,10,,290844958,28,2191,290844930,290844958
19694,5,24,149,5745,-86,-97,11,,290845002,28,16,290844974,290845002
19695,5,24,149,5745,-88,-97,9,,290845110,32,76,290845078,290845110
19696,5,24,149,5745,-88,-97,9,,290856662,32,11520,290856630,290856662
19697,5,24,149,5745,-87,-97,10,,290856780,32,86,290856748,290856780
19698,5,12,149,5745,-64,-97,33,22:ec:75:a8:8a:31,290862015,244,4991,290861771,290862015
19699,5,24,149,5745,-87,-97,10,,290862894,28,851,290862866,290862894
19700,5,24,149,5745,-86,-97,11,,290862938,28,16,290862910,290862938
19701,5,24,149,5745,-86,-97,11,,290863046,32,76,290863014,290863046
19702,5,12,149,5745,-86,-97,11,9a:24:38:da:96:bb,290877145,272,13827,290876873,290877145
19703,5,12,149,5745,-66,-97,31,6a:1e:a4:f8:14:49,290898776,284,21347,290898492,290898776
19704,5,12,149,5745,-76,-97,21,d2:00:04:7e:2c:ab,290899149,412,-39,290898737,290899149
19705,5,6,149,5745,-87,-97,10,54:e4:3a:ec:fb:65,290902452,360,2943,290902092,290902452
19706,5,12,149,5745,-54,-97,43,4a:86:35:36:74:b8,290903263,268,543,290902995,290903263
19707,5,12,149,5745,-68,-97,29,f2:da:61:dd:98:c5,290903736,268,205,290903468,290903736
19708,5,24,149,5745,-67,-97,30,,290918722,28,14958,290918694,290918722
19709,5,24,149,5745,-85,-97,12,,290918766,28,16,290918738,290918766
19710,5,24,149,5745,-86,-97,11,,290918875,28,81,290918847,290918875
19711,5,24,149,5745,-85,-97,12,,290924129,28,5226,290924101,290924129
19712,5,24,149,5745,-86,-97,11,,290924173,28,16,290924145,290924173
19713,5,24,149,5745,-86,-97,11,,290924282,32,77,290924250,290924282
19714,5,12,149,5745,-67,-97,30,72:d1:72:1d:22:a1,290926846,284,2280,290926562,290926846
19715,5,12,149,5745,-68,-97,29,f6:0a:5c:59:72:df,290935198,280,8072,290934918,290935198
19716,5,24,149,5745,-87,-97,10,,290936089,28,863,290936061,290936089
19717,5,12,149,5745,-87,-97,10,42:d2:d9:2b:ac:61,290939718,256,3373,290939462,290939718
19718,5,24,149,5745,-87,-97,10,,290941684,28,1938,290941656,290941684
19719,5,24,149,5745,-85,-97,12,,290941728,28,16,290941700,290941728
19720,5,24,149,5745,-85,-97,12,,290941835,32,75,290941803,290941835
19721,5,12,149,5745,-91,-97,6,7e:05:42:11:d2:ec,290944333,244,2254,290944089,290944333
19722,5,12,149,5745,-62,-97,35,5e:29:73:5b:30:00,290947888,272,3283,290947616,290947888
19723,5,12,149,5745,-57,-97,40,3e:d1:9b:c7:a4:de,290957454,272,9294,290957182,290957454
19724,5,12,149,5745,-70,-97,27,56:68:e2:c2:8d:d5,290961108,280,3374,290960828,290961108
19725,5,12,149,5745,-57,-97,40,4a:86:35:36:74:b8,290980538,268,19162,290980270,290980538
19726,5,24,149,5745,-67,-97,30,,290980845,28,279,290980817,290980845
19727,5,24,149,5745,-85,-97,12,,290980889,28,16,290980861,290980889
19728,5,24,149,5745,-85,-97,12,,290980998,28,81,290980970,290980998
19729,5,12,149,5745,-72,-97,25,72:d1:72:1d:22:a1,290985199,284,3917,290984915,290985199
19730,5,12,149,5745,-87,-97,10,9a:24:38:da:96:bb,290985746,272,275,290985474,290985746
19731,5,12,149,5745,-66,-97,31,f2:da:61:dd:98:c5,290986502,268,488,290986234,290986502
19732,5,12,149,5745,-65,-97,32,22:ec:75:a8:8a:31,290998322,244,11576,290998078,290998322
19733,5,12,149,5745,-53,-97,44,3e:d1:9b:c7:a4:de,290999546,544,680,290999002,290999546
19734,5,12,149,5745,-66,-97,31,6a:1e:a4:f8:14:49,291000277,284,447,290999993,291000277
19735,5,12,149,5745,-72,-97,25,72:d1:72:1d:22:a1,291004726,480,3969,291004246,291004726
19736,5,12,149,5745,-58,-97,39,4a:86:35:36:74:b8,291006177,268,1183,291005909,291006177
19737,5,12,149,5745,-90,-97,7,9a:24:38:da:96:bb,291008046,824,1045,291007222,291008046
19738,5,12,149,5745,-70,-97,27,56:68:e2:c2:8d:d5,291009108,268,794,291008840,291009108
19739,5,12,149,5745,-68,-97,29,f6:0a:5c:59:72:df,291009563,268,187,291009295,291009563
19740,5,12,149,5745,-65,-97,32,22:ec:75:a8:8a:31,291010073,516,-6,291009557,291010073
19741,5,12,149,5745,-67,-97,30,f6:0a:5c:59:72:df,291015571,476,5022,291015095,291015571
19742,5,12,149,5745,-67,-97,30,f2:da:61:dd:98:c5,291017089,268,1250,291016821,291017089
19743,5,12,149,5745,-90,-97,7,42:d2:d9:2b:ac:61,291017412,452,-129,291016960,291017412
19744,5,12,149,5745,-65,-97,32,6a:1e:a4:f8:14:49,291027908,480,10016,291027428,291027908
19745,5,12,149,5745,-68,-97,29,f6:0a:5c:59:72:df,291029801,280,1613,291029521,291029801
19746,5,12,149,5745,-89,-97,8,42:d2:d9:2b:ac:61,291033114,256,3057,291032858,291033114
19747,5,12,149,5745,-73,-97,24,56:68:e2:c2:8d:d5,291049754,280,16360,291049474,291049754
19748,5,12,149,5745,-66,-97,31,5e:29:73:5b:30:00,291063789,272,13763,291063517,291063789
19749,5,12,149,5745,-62,-97,35,4a:86:35:36:74:b8,291071747,268,7690,291071479,291071747
19750,5,12,149,5745,-91,-97,6,7e:05:42:11:d2:ec,291072069,440,-118,291071629,291072069
19751,5,12,149,5745,-51,-97,46,3e:d1:9b:c7:a4:de,291074392,272,2051,291074120,291074392
19752,5,12,149,5745,-62,-97,35,4a:86:35:36:74:b8,291082030,268,7370,291081762,291082030
19753,5,12,149,5745,-66,-97,31,6a:1e:a4:f8:14:49,291088822,480,6312,291088342,291088822
19754,5,12,149,5745,-65,-97,32,22:ec:75:a8:8a:31,291092918,244,3852,291092674,291092918
19755,5,12,149,5745,-71,-97,26,f2:da:61:dd:98:c5,291093313,268,127,291093045,291093313
19756,5,12,149,5745,-85,-97,12,9a:24:38:da:96:bb,291097289,272,3704,291097017,291097289
19757,5,12,149,5745,-90,-97,7,7e:05:42:11:d2:ec,291098711,244,1178,291098467,291098711
19758,5,12,149,5745,-70,-97,27,72:d1:72:1d:22:a1,291105158,284,6163,291104874,291105158
19759,5,6,149,5745,-87,-97,10,54:e4:3a:ec:fb:65,291107253,360,1735,291106893,291107253
19760,5,12,149,5745,-69,-97,28,6a:1e:a4:f8:14:49,291115399,284,7862,291115115,291115399
19761,5,12,149,5745,-53,-97,44,3e:d1:9b:c7:a4:de,291131117,544,15174,291130573,291131117
19762,5,12,149,5745,-66,-97,31,22:ec:75:a8:8a:31,291132352,516,719,291131836,291132352
19763,5,12,149,5745,-58,-97,39,0a:b9:b7:b1:4d:fa,291134181,268,1561,291133913,291134181
19764,5,12,149,5745,-70,-97,27,a6:92:ad:b7:76:65,291135167,484,502,291134683,291135167
19765,5,12,149,5745,-67,-97,30,b6:90:18:f6:b1:d4,291136848,268,1413,291136580,291136848
19766,5,12,149,5745,-59,-97,38,4a:86:35:36:74:b8,291137664,268,548,291137396,291137664
19767,5,12,149,5745,-88,-97,9,9a:24:38:da:96:bb,291139145,824,657,291138321,291139145
19768,5,12,149,5745,-65,-97,32,5e:29:73:5b:30:00,291145067,540,5382,291144527,291145067
19769,5,12,149,5745,-69,-97,28,f2:da:61:dd:98:c5,291145643,268,308,291145375,291145643
19770,5,12,149,5745,-68,-97,29,6a:1e:a4:f8:14:49,291154490,480,8367,291154010,291154490
19771,5,12,149,5745,-88,-97,9,42:d2:d9:2b:ac:61,291158523,256,3777,291158267,291158523
19772,5,12,149,5745,-64,-97,33,5e:29:73:5b:30:00,291181797,272,23002,291181525,291181797
19773,5,12,149,5745,-53,-97,44,3e:d1:9b:c7:a4:de,291188789,272,6720,291188517,291188789
19774,5,12,149,5745,-64,-97,33,22:ec:75:a8:8a:31,291207741,244,18708,291207497,291207741
19775,5,6,149,5745,-87,-97,10,54:e4:3a:ec:fb:65,291209654,360,1553,291209294,291209654
19776,5,12,149,5745,-58,-97,39,4a:86:35:36:74:b8,291210718,268,796,291210450,291210718
19777,5,12,149,5745,-67,-97,30,f2:da:61:dd:98:c5,291211099,268,113,291210831,291211099
19778,5,12,149,5745,-91,-97,6,7e:05:42:11:d2:ec,291212785,244,1442,291212541,291212785
19779,5,12,149,5745,-87,-97,10,9a:24:38:da:96:bb,291231628,272,18571,291231356,291231628
19780,5,12,149,5745,-71,-97,26,72:d1:72:1d:22:a1,291234322,284,2410,291234038,291234322
19781,5,12,149,5745,-71,-97,26,56:68:e2:c2:8d:d5,291236323,280,1721,291236043,291236323
19782,5,12,149,5745,-68,-97,29,f6:0a:5c:59:72:df,291277250,280,40647,291276970,291277250
19783,5,24,149,5745,-69,-97,28,,291283853,28,6575,291283825,291283853
19784,5,24,149,5745,-83,-97,14,,291283897,28,16,291283869,291283897
19785,5,24,149,5745,-84,-97,13,,291284006,28,81,291283978,291284006
19786,5,12,149,5745,-67,-97,30,5e:29:73:5b:30:00,291293041,272,8763,291292769,291293041
19787,5,12,149,5745,-53,-97,44,3e:d1:9b:c7:a4:de,291306027,272,12714,291305755,291306027
19788,5,12,149,5745,-67,-97,30,6a:1e:a4:f8:14:49,291309340,284,3029,291309056,291309340
19789,5,6,149,5745,-89,-97,8,54:e4:3a:ec:fb:65,291312054,360,2354,291311694,291312054
19790,5,24,149,5745,-85,-97,12,,291313088,32,1002,291313056,291313088
19791,5,24,149,5745,-86,-97,11,,291313363,32,243,291313331,291313363
19792,5,24,149,5745,-85,-97,12,,291313925,28,534,291313897,291313925
19793,5,24,149,5745,-86,-97,11,,291314181,28,228,291314153,291314181
19794,5,24,149,5745,-86,-97,11,,291314383,28,174,291314355,291314383
19795,5,12,149,5745,-58,-97,39,4a:86:35:36:74:b8,291323197,268,8546,291322929,291323197
19796,5,12,149,5745,-86,-97,11,9a:24:38:da:96:bb,291323518,272,49,291323246,291323518
19797,5,12,149,5745,-69,-97,28,f2:da:61:dd:98:c5,291323894,268,108,291323626,291323894
19798,5,12,149,5745,-67,-97,30,22:ec:75:a8:8a:31,291324982,244,844,291324738,291324982
19799,5,12,149,5745,-68,-97,29,72:d1:72:1d:22:a1,291336978,284,11712,291336694,291336978
19800,5,12,149,5745,-71,-97,26,56:68:e2:c2:8d:d5,291337350,280,92,291337070,291337350
19801,5,12,149,5745,-91,-97,6,42:d2:d9:2b:ac:61,291350702,256,13096,291350446,291350702
19802,5,12,149,5745,-88,-97,9,7e:05:42:11:d2:ec,291353636,244,2690,291353392,291353636
19803,5,6,149,5745,-69,-97,28,,291360504,52,6816,291360452,291360504
19804,5,6,149,5745,-86,-97,11,,291360572,44,24,291360528,291360572
19805,5,24,149,5745,-85,-97,12,,291360690,28,90,291360662,291360690
19806,5,12,149,5745,-68,-97,29,f6:0a:5c:59:72:df,291397070,280,36100,291396790,291397070
19807,5,12,149,5745,-66,-97,31,5e:29:73:5b:30:00,291406573,272,9231,291406301,291406573
19808,5,12,149,5745,-67,-97,30,6a:1e:a4:f8:14:49,291411648,284,4791,291411364,291411648
19809,5,6,149,5745,-85,-97,12,54:e4:3a:ec:fb:65,291414455,360,2447,291414095,291414455
19810,5,12,149,5745,-48,-97,49,3e:d1:9b:c7:a4:de,291421250,272,6523,291420978,291421250
19811,5,12,149,5745,-56,-97,41,4a:86:35:36:74:b8,291430742,268,9224,291430474,291430742
19812,5,12,149,5745,-68,-97,29,f2:da:61:dd:98:c5,291431080,268,70,291430812,291431080
19813,5,12,149,5745,-87,-97,10,9a:24:38:da:96:bb,291438496,272,7144,291438224,291438496
19814,5,12,149,5745,-72,-97,25,72:d1:72:1d:22:a1,291439133,284,353,291438849,291439133
19815,5,12,149,5745,-73,-97,24,56:68:e2:c2:8d:d5,291439998,280,585,291439718,291439998
19816,5,12,149,5745,-69,-97,28,22:ec:75:a8:8a:31,291442190,244,1948,291441946,291442190
19817,5,12,149,5745,-90,-97,7,42:d2:d9:2b:ac:61,291452371,256,9925,291452115,291452371
19818,5,12,149,5745,-87,-97,10,7e:05:42:11:d2:ec,291457541,244,4926,291457297,291457541
19819,5,12,149,5745,-68,-97,29,6a:1e:a4:f8:14:49,291513880,284,56055,291513596,291513880
19820,5,6,149,5745,-89,-97,8,54:e4:3a:ec:fb:65,291516855,360,2615,291516495,291516855
19821,5,12,149,5745,-64,-97,33,5e:29:73:5b:30:00,291518396,272,1269,291518124,291518396
19822,5,12,149,5745,-52,-97,45,3e:d1:9b:c7:a4:de,291533705,272,15037,291533433,291533705
19823,5,12,149,5745,-68,-97,29,56:68:e2:c2:8d:d5,291542792,280,8807,291542512,291542792
19824,5,12,149,5745,-70,-97,27,f2:da:61:dd:98:c5,291549316,268,6256,291549048,291549316
19825,5,12,149,5745,-55,-97,42,4a:86:35:36:74:b8,291550119,268,535,291549851,291550119
19826,5,12,149,5745,-68,-97,29,22:ec:75:a8:8a:31,291553935,244,3572,291553691,291553935
19827,5,12,149,5745,-88,-97,9,42:d2:d9:2b:ac:61,291554311,256,120,291554055,291554311
19828,5,12,149,5745,-70,-97,27,72:d1:72:1d:22:a1,291557745,284,3150,291557461,291557745
19829,5,12,149,5745,-89,-97,8,7e:05:42:11:d2:ec,291559230,244,1241,291558986,291559230
19830,5,12,149,5745,-67,-97,30,6a:1e:a4:f8:14:49,291568244,284,8730,291567960,291568244
19831,5,12,149,5745,-68,-97,29,22:ec:75:a8:8a:31,291590522,516,21762,291590006,291590522
19832,5,12,149,5745,-70,-97,27,72:d1:72:1d:22:a1,291593531,480,2529,291593051,291593531
19833,5,12,149,5745,-53,-97,44,3e:d1:9b:c7:a4:de,291594909,544,834,291594365,291594909
19834,5,12,149,5745,-54,-97,43,4a:86:35:36:74:b8,291596441,268,1264,291596173,291596441
19835,5,12,149,5745,-68,-97,29,f6:0a:5c:59:72:df,291599720,280,2999,291599440,291599720
19836,5,12,149,5745,-68,-97,29,5e:29:73:5b:30:00,291600702,540,442,291600162,291600702
19837,5,12,149,5745,-88,-97,9,42:d2:d9:2b:ac:61,291603903,452,2749,291603451,291603903
19838,5,12,149,5745,-68,-97,29,f6:0a:5c:59:72:df,291604532,476,153,291604056,291604532
19839,5,12,149,5745,-71,-97,26,f2:da:61:dd:98:c5,291605042,268,242,291604774,291605042
19840,5,12,149,5745,-69,-97,28,56:68:e2:c2:8d:d5,291605344,476,-174,291604868,291605344
19841,5,12,149,5745,-88,-97,9,42:d2:d9:2b:ac:61,291606411,256,811,291606155,291606411
19842,5,12,149,5745,-68,-97,29,6a:1e:a4:f8:14:49,291613593,480,6702,291613113,291613593
19843,5,6,149,5745,-86,-97,11,54:e4:3a:ec:fb:65,291619256,360,5303,291618896,291619256
19844,5,12,149,5745,-70,-97,27,56:68:e2:c2:8d:d5,291622293,280,2757,291622013,291622293
19845,5,12,149,5745,-65,-97,32,5e:29:73:5b:30:00,291639962,272,17397,291639690,291639962
19846,5,12,149,5745,-54,-97,43,3e:d1:9b:c7:a4:de,291654585,272,14351,291654313,291654585
19847,5,12,149,5745,-69,-97,28,72:d1:72:1d:22:a1,291654893,284,24,291654609,291654893
19848,5,12,149,5745,-56,-97,41,4a:86:35:36:74:b8,291655213,268,52,291654945,291655213
19849,5,12,149,5745,-89,-97,8,7e:05:42:11:d2:ec,291656028,244,571,291655784,291656028
19850,5,12,149,5745,-71,-97,26,56:68:e2:c2:8d:d5,291656351,476,-153,291655875,291656351
19851,5,12,149,5745,-69,-97,28,72:d1:72:1d:22:a1,291659103,480,2272,291658623,291659103
19852,5,12,149,5745,-54,-97,43,3e:d1:9b:c7:a4:de,291660134,544,487,291659590,291660134
19853,5,12,149,5745,-87,-97,10,42:d2:d9:2b:ac:61,291660750,452,164,291660298,291660750
19854,5,12,149,5745,-59,-97,38,0a:b9:b7:b1:4d:fa,291661821,268,803,291661553,291661821
19855,5,12,149,5745,-56,-97,41,4a:86:35:36:74:b8,291662133,268,44,291661865,291662133
19856,5,12,149,5745,-88,-97,9,9a:24:38:da:96:bb,291662843,824,-114,291662019,291662843
19857,5,12,149,5745,-66,-97,31,a6:92:ad:b7:76:65,291664065,484,738,291663581,291664065
19858,5,12,149,5745,-68,-97,29,b6:90:18:f6:b1:d4,291664621,268,288,291664353,291664621
19859,5,12,149,5745,-68,-97,29,6a:1e:a4:f8:14:49,291666192,380,1191,291665812,291666192
19860,5,12,149,5745,-70,-97,27,f2:da:61:dd:98:c5,291668173,268,1713,291667905,291668173
19861,5,12,149,5745,-68,-97,29,6a:1e:a4:f8:14:49,291671931,284,3474,291671647,291671931
19862,5,12,149,5745,-66,-97,31,5e:29:73:5b:30:00,291672277,540,-194,291671737,291672277
19863,5,12,149,5745,-74,-97,23,d2:00:04:7e:2c:ab,291672869,440,152,291672429,291672869
19864,5,12,149,5745,-74,-97,23,f6:0a:5c:59:72:df,291675846,476,2501,291675370,291675846
19865,5,12,149,5745,-74,-97,23,d2:00:04:7e:2c:ab,291678001,104,2051,291677897,291678001
19866,5,12,149,5745,-73,-97,24,d2:00:04:7e:2c:ab,291678375,380,-6,291677995,291678375
19867,5,12,149,5745,-68,-97,29,6a:1e:a4:f8:14:49,291678825,480,-30,291678345,291678825
19868,5,24,149,5745,-86,-97,11,,291679347,28,494,291679319,291679347
19869,5,24,149,5745,-86,-97,11,,291679391,28,16,291679363,291679391
19870,5,24,149,5745,-86,-97,11,,291679639,28,220,291679611,291679639
19871,5,24,149,5745,-86,-97,11,,291679683,28,16,291679655,291679683
19872,5,24,149,5745,-87,-97,10,,291679795,32,80,291679763,291679795
19873,5,12,149,5745,-67,-97,30,22:ec:75:a8:8a:31,291686405,244,6366,291686161,291686405
19874,5,24,149,5745,-87,-97,10,,291690071,28,3638,291690043,291690071
19875,5,24,149,5745,-86,-97,11,,291690116,28,17,291690088,291690116
19876,5,24,149,5745,-86,-97,11,,291690224,32,76,291690192,291690224
19877,5,24,149,5745,-86,-97,11,,291690353,28,101,291690325,291690353
19878,5,24,149,5745,-86,-97,11,,291690397,28,16,291690369,291690397
19879,5,24,149,5745,-86,-97,11,,291690505,32,76,291690473,291690505
19880,5,24,149,5745,-86,-97,11,,291697576,28,7043,291697548,291697576
19881,5,24,149,5745,-87,-97,10,,291697620,28,16,291697592,291697620
19882,5,24,149,5745,-86,-97,11,,291697728,32,76,291697696,291697728
19883,5,24,149,5745,-86,-97,11,,291698360,28,604,291698332,291698360
19884,5,24,149,5745,-86,-97,11,,291698404,28,16,291698376,291698404
19885,5,24,149,5745,-87,-97,10,,291698516,32,80,291698484,291698516
19886,5,24,149,5745,-86,-97,11,,291699028,28,484,291699000,291699028
19887,5,24,149,5745,-86,-97,11,,291699072,28,16,291699044,291699072
19888,5,24,149,5745,-89,-97,8,,291699181,32,77,291699149,291699181
19889,5,24,149,5745,-87,-97,10,,291699709,28,500,291699681,291699709
19890,5,24,149,5745,-87,-97,10,,291699753,28,16,291699725,291699753
19891,5,24,149,5745,-86,-97,11,,291699861,32,76,291699829,291699861
19892,5,24,149,5745,-87,-97,10,,291700080,28,191,291700052,291700080
19893,5,24,149,5745,-86,-97,11,,291700124,28,16,291700096,291700124
19894,5,24,149,5745,-86,-97,11,,291700236,32,80,291700204,291700236
19895,5,24,149,5745,-86,-97,11,,291702387,28,2123,291702359,291702387
19896,5,24,149,5745,-86,-97,11,,291702431,28,16,291702403,291702431
19897,5,24,149,5745,-86,-97,11,,291702551,32,88,291702519,291702551
19898,5,24,149,5745,-86,-97,11,,291703489,28,910,291703461,291703489
19899,5,24,149,5745,-85,-97,12,,291703533,28,16,291703505,291703533
19900,5,24,149,5745,-86,-97,11,,291703642,32,77,291703610,291703642
19901,5,24,149,5745,-85,-97,12,,291718987,28,15317,291718959,291718987
19902,5,24,149,5745,-86,-97,11,,291719032,28,17,291719004,291719032
19903,5,24,149,5745,-85,-97,12,,291719144,32,80,291719112,291719144
19904,5,24,149,5745,-86,-97,11,,291720281,28,1109,291720253,291720281
19905,5,24,149,5745,-85,-97,12,,291720325,28,16,291720297,291720325
19906,5,24,149,5745,-85,-97,12,,291720437,32,80,291720405,291720437
19907,5,24,149,5745,-86,-97,11,,291720647,28,182,291720619,291720647
19908,5,24,149,5745,-85,-97,12,,291720691,28,16,291720663,291720691
19909,5,24,149,5745,-85,-97,12,,291720799,32,76,291720767,291720799
19910,5,6,149,5745,-84,-97,13,54:e4:3a:ec:fb:65,291721656,360,497,291721296,291721656
19911,5,24,149,5745,-85,-97,12,,291723571,28,1887,291723543,291723571
19912,5,24,149,5745,-86,-97,11,,291723615,28,16,291723587,291723615
19913,5,24,149,5745,-86,-97,11,,291723736,32,89,291723704,291723736
19914,5,24,149,5745,-85,-97,12,,291724524,28,760,291724496,291724524
19915,5,24,149,5745,-86,-97,11,,291724569,28,17,291724541,291724569
19916,5,24,149,5745,-86,-97,11,,291724681,32,80,291724649,291724681
19917,5,12,149,5745,-71,-97,26,f6:0a:5c:59:72:df,291724831,280,-130,291724551,291724831
19918,5,12,149,5745,-87,-97,10,42:d2:d9:2b:ac:61,291734200,256,9113,291733944,291734200
19919,5,12,149,5745,-73,-97,24,56:68:e2:c2:8d:d5,291737807,280,3327,291737527,291737807
19920,5,24,149,5745,-87,-97,10,,291744679,28,6844,291744651,291744679
19921,5,24,149,5745,-85,-97,12,,291744723,28,16,291744695,291744723
19922,5,24,149,5745,-86,-97,11,,291744842,32,87,291744810,291744842
19923,5,24,149,5745,-87,-97,10,,291745020,28,150,291744992,291745020
19924,5,24,149,5745,-86,-97,11,,291745064,28,16,291745036,291745064
19925,5,24,149,5745,-87,-97,10,,291745180,32,84,291745148,291745180
19926,5,24,149,5745,-86,-97,11,,291745298,32,86,291745266,291745298
19927,5,24,149,5745,-85,-97,12,,291747966,28,2640,291747938,291747966
19928,5,24,149,5745,-86,-97,11,,291748011,28,17,291747983,291748011
19929,5,12,149,5745,-66,-97,31,5e:29:73:5b:30:00,291748060,272,-223,291747788,291748060
19930,5,24,149,5745,-85,-97,12,,291748440,32,348,291748408,291748440
19931,5,24,149,5745,-86,-97,11,,291759396,28,10928,291759368,291759396
19932,5,24,149,5745,-87,-97,10,,291759440,28,16,291759412,291759440
19933,5,24,149,5745,-86,-97,11,,291759549,32,77,291759517,291759549
19934,5,24,149,5745,-86,-97,11,,291759660,32,79,291759628,291759660
19935,5,24,149,5745,-86,-97,11,,291762306,28,2618,291762278,291762306
19936,5,24,149,5745,-86,-97,11,,291762350,28,16,291762322,291762350
19937,5,24,149,5745,-85,-97,12,,291762458,32,76,291762426,291762458
19938,5,12,149,5745,-50,-97,47,3e:d1:9b:c7:a4:de,291763388,272,658,291763116,291763388
19939,5,24,149,5745,-86,-97,11,,291763740,28,324,291763712,291763740
19940,5,24,149,5745,-87,-97,10,,291763784,28,16,291763756,291763784
19941,5,24,149,5745,-86,-97,11,,291763899,32,83,291763867,291763899
19942,5,24,149,5745,-86,-97,11,,291765820,28,1893,291765792,291765820
19943,5,24,149,5745,-86,-97,11,,291765864,28,16,291765836,291765864
19944,5,24,149,5745,-87,-97,10,,291766149,28,257,291766121,291766149
19945,5,24,149,5745,-86,-97,11,,291766193,28,16,291766165,291766193
19946,5,24,149,5745,-85,-97,12,,291766306,32,81,291766274,291766306
19947,5,24,149,5745,-86,-97,11,,291767688,28,1354,291767660,291767688
19948,5,24,149,5745,-86,-97,11,,291767732,28,16,291767704,291767732
19949,5,24,149,5745,-86,-97,11,,291767841,32,77,291767809,291767841
19950,5,24,149,5745,-87,-97,10,,291768814,28,945,291768786,291768814
19951,5,24,149,5745,-85,-97,12,,291768858,28,16,291768830,291768858
19952,5,24,149,5745,-87,-97,10,,291768971,32,81,291768939,291768971
19953,5,24,149,5745,-86,-97,11,,291780057,28,11058,291780029,291780057
19954,5,24,149,5745,-87,-97,10,,291780101,28,16,291780073,291780101
19955,5,24,149,5745,-87,-97,10,,291780209,32,76,291780177,291780209
19956,5,12,149,5745,-67,-97,30,22:ec:75:a8:8a:31,291782379,244,1926,291782135,291782379
19957,5,24,149,5745,-85,-97,12,,291785711,28,3304,291785683,291785711
19958,5,24,149,5745,-86,-97,11,,291785755,28,16,291785727,291785755
19959,5,24,149,5745,-87,-97,10,,291785863,32,76,291785831,291785863
19960,5,24,149,5745,-86,-97,11,,291788810,28,2919,291788782,291788810
19961,5,24,149,5745,-86,-97,11,,291788854,28,16,291788826,291788854
19962,5,24,149,5745,-87,-97,10,,291788973,32,87,291788941,291788973
19963,5,24,149,5745,-85,-97,12,,291789140,28,139,291789112,291789140
19964,5,24,149,5745,-87,-97,10,,291789184,28,16,291789156,291789184
19965,5,24,149,5745,-86,-97,11,,291789299,32,83,291789267,291789299
19966,5,24,149,5745,-86,-97,11,,291789420,28,93,291789392,291789420
19967,5,24,149,5745,-87,-97,10,,291789464,28,16,291789436,291789464
19968,5,24,149,5745,-87,-97,10,,291789572,32,76,291789540,291789572
19969,5,24,149,5745,-85,-97,12,,291789750,28,150,291789722,291789750
19970,5,24,149,5745,-86,-97,11,,291789794,28,16,291789766,291789794
19971,5,24,149,5745,-87,-97,10,,291789902,32,76,291789870,291789902
19972,5,24,149,5745,-87,-97,10,,291792205,28,2275,291792177,291792205
19973,5,24,149,5745,-86,-97,11,,291792249,28,16,291792221,291792249
19974,5,24,149,5745,-85,-97,12,,291792381,32,100,291792349,291792381
19975,5,12,149,5745,-70,-97,27,6a:1e:a4:f8:14:49,291793006,284,341,291792722,291793006
19976,5,24,149,5745,-87,-97,10,,291800034,28,7000,291800006,291800034
19977,5,24,149,5745,-85,-97,12,,291800078,28,16,291800050,291800078
19978,5,24,149,5745,-85,-97,12,,291800187,32,77,291800155,291800187
19979,5,24,149,5745,-85,-97,12,,291800723,32,504,291800691,291800723
19980,5,24,149,5745,-86,-97,11,,291805374,28,4623,291805346,291805374
19981,5,24,149,5745,-87,-97,10,,291805418,28,16,291805390,291805418
19982,5,24,149,5745,-87,-97,10,,291805526,32,76,291805494,291805526
19983,5,24,149,5745,-85,-97,12,,291806184,28,630,291806156,291806184
19984,5,24,149,5745,-87,-97,10,,291806229,28,17,291806201,291806229
19985,5,24,149,5745,-86,-97,11,,291806336,32,75,291806304,291806336
19986,5,24,149,5745,-88,-97,9,,291808245,28,1881,291808217,291808245
19987,5,24,149,5745,-85,-97,12,,291808290,28,17,291808262,291808290
19988,5,24,149,5745,-84,-97,13,,291808398,32,76,291808366,291808398
19989,5,24,149,5745,-84,-97,13,,291817540,28,9114,291817512,291817540
19990,5,6,149,5745,-86,-97,11,54:e4:3a:ec:fb:65,291824057,360,6157,291823697,291824057
19991,5,12,149,5745,-55,-97,42,4a:86:35:36:74:b8,291824724,268,399,291824456,291824724
19992,5,12,149,5745,-70,-97,27,f2:da:61:dd:98:c5,291825593,268,601,291825325,291825593
19993,5,24,149,5745,-84,-97,13,,291826054,28,433,291826026,291826054
19994,5,24,149,5745,-88,-97,9,,291826098,28,16,291826070,291826098
19995,5,24,149,5745,-88,-97,9,,291826205,32,75,291826173,291826205
19996,5,24,149,5745,-85,-97,12,,291826723,28,490,291826695,291826723
19997,5,6,149,5745,-70,-97,27,,291830140,52,3365,291830088,291830140
19998,5,6,149,5745,-84,-97,13,,291830208,44,24,291830164,291830208
19999,5,24,149,5745,-85,-97,12,,291830326,28,90,291830298,291830326
20000,5,6,149,5745,-70,-97,27,,291830505,52,127,291830453,291830505
20001,5,6,149,5745,-85,-97,12,,291830573,44,24,291830529,291830573
20002,5,24,149,5745,-85,-97,12,,291830690,28,89,291830662,291830690
20003,5,24,149,5745,-84,-97,13,,291846993,28,16275,291846965,291846993
20004,5,12,149,5745,-72,-97,25,72:d1:72:1d:22:a1,291848894,284,1617,291848610,291848894
20005,5,12,149,5745,-71,-97,26,56:68:e2:c2:8d:d5,291851136,280,1962,291850856,291851136
20006,5,12,149,5745,-89,-97,8,42:d2:d9:2b:ac:61,291861709,256,10317,291861453,291861709
20007,5,24,149,5745,-85,-97,12,,291862983,32,1242,291862951,291862983
20008,5,12,149,5745,-66,-97,31,5e:29:73:5b:30:00,291864841,272,1586,291864569,291864841
20009,5,24,149,5745,-85,-97,12,,291869956,28,5087,291869928,291869956
20010,5,24,149,5745,-88,-97,9,,291870000,28,16,291869972,291870000
20011,5,24,149,5745,-88,-97,9,,291870108,32,76,291870076,291870108
20012,5,24,149,5745,-84,-97,13,,291870801,28,665,291870773,291870801
20013,5,24,149,5745,-87,-97,10,,291870845,28,16,291870817,291870845
20014,5,24,149,5745,-88,-97,9,,291870953,32,76,291870921,291870953
20015,5,24,149,5745,-84,-97,13,,291871095,28,114,291871067,291871095
20016,5,24,149,5745,-87,-97,10,,291871139,28,16,291871111,291871139
20017,5,24,149,5745,-88,-97,9,,291871247,32,76,291871215,291871247
20018,5,24,149,5745,-89,-97,8,,291873049,28,1774,291873021,291873049
20019,5,24,149,5745,-85,-97,12,,291873094,28,17,291873066,291873094
20020,5,24,149,5745,-85,-97,12,,291873202,32,76,291873170,291873202
20021,5,12,149,5745,-53,-97,44,3e:d1:9b:c7:a4:de,291880376,272,6902,291880104,291880376
20022,5,12,149,5745,-88,-97,9,7e:05:42:11:d2:ec,291882470,244,1850,291882226,291882470
20023,5,12,149,5745,-85,-97,12,9a:24:38:da:96:bb,291883187,272,445,291882915,291883187
20024,5,12,149,5745,-70,-97,27,22:ec:75:a8:8a:31,291900126,244,16695,291899882,291900126
20025,5,24,149,5745,-84,-97,13,,291901835,28,1681,291901807,291901835
20026,5,24,149,5745,-87,-97,10,,291901880,28,17,291901852,291901880
20027,5,24,149,5745,-87,-97,10,,291901995,32,83,291901963,291901995
20028,5,24,149,5745,-84,-97,13,,291902182,28,159,291902154,291902182
20029,5,24,149,5745,-87,-97,10,,291902226,28,16,291902198,291902226
20030,5,24,149,5745,-88,-97,9,,291902335,32,77,291902303,291902335
20031,5,24,149,5745,-87,-97,10,,291902707,28,344,291902679,291902707
20032,5,24,149,5745,-85,-97,12,,291902751,28,16,291902723,291902751
20033,5,24,149,5745,-84,-97,13,,291902860,32,77,291902828,291902860
20034,5,24,149,5745,-88,-97,9,,291904341,28,1453,291904313,291904341
20035,5,24,149,5745,-85,-97,12,,291904385,28,16,291904357,291904385
20036,5,24,149,5745,-84,-97,13,,291904493,32,76,291904461,291904493
20037,5,24,149,5745,-84,-97,13,,291904903,28,382,291904875,291904903
20038,5,24,149,5745,-87,-97,10,,291904948,28,17,291904920,291904948
20039,5,24,149,5745,-87,-97,10,,291905055,32,75,291905023,291905055
20040,5,24,149,5745,-84,-97,13,,291905477,28,394,291905449,291905477
20041,5,24,149,5745,-87,-97,10,,291905522,28,17,291905494,291905522
20042,5,24,149,5745,-88,-97,9,,291905629,32,75,291905597,291905629
20043,5,24,149,5745,-87,-97,10,,291907804,28,2147,291907776,291907804
20044,5,24,149,5745,-84,-97,13,,291907848,28,16,291907820,291907848
20045,5,24,149,5745,-85,-97,12,,291907957,32,77,291907925,291907957
20046,5,6,149,5745,-69,-97,28,,291917033,52,9024,291916981,291917033
20047,5,6,149,5745,-85,-97,12,,291917101,44,24,291917057,291917101
20048,5,24,149,5745,-85,-97,12,,291917219,28,90,291917191,291917219
20049,5,6,149,5745,-71,-97,26,,291917562,52,291,291917510,291917562
20050,5,6,149,5745,-84,-97,13,,291917630,44,24,291917586,291917630
20051,5,24,149,5745,-85,-97,12,,291917747,28,89,291917719,291917747
20052,5,6,149,5745,-69,-97,28,,291917846,52,47,291917794,291917846
20053,5,6,149,5745,-84,-97,13,,291917914,44,24,291917870,291917914
20054,5,24,149,5745,-85,-97,12,,291918032,28,90,291918004,291918032
20055,5,12,149,5745,-67,-97,30,6a:1e:a4:f8:14:49,291923730,284,5414,291923446,291923730
20056,5,6,149,5745,-87,-97,10,54:e4:3a:ec:fb:65,291926457,360,2367,291926097,291926457
20057,5,12,149,5745,-56,-97,41,4a:86:35:36:74:b8,291927240,268,515,291926972,291927240
20058,5,12,149,5745,-67,-97,30,f2:da:61:dd:98:c5,291927550,268,42,291927282,291927550
20059,5,6,149,5745,-74,-97,23,24:f6:77:10:02:c8,291929925,100,2275,291929825,291929925
20060,5,6,149,5745,-74,-97,23,24:f6:77:10:02:c8,291930042,92,25,291929950,291930042
20061,5,6,149,5745,-74,-97,23,24:f6:77:10:02:c8,291930151,92,17,291930059,291930151
20062,5,24,149,5745,-84,-97,13,,291934185,32,4002,291934153,291934185
20063,5,24,149,5745,-84,-97,13,,291934685,32,468,291934653,291934685
20064,5,24,149,5745,-84,-97,13,,291935184,28,471,291935156,291935184
20065,5,24,149,5745,-84,-97,13,,291935536,28,324,291935508,291935536
20066,5,24,149,5745,-86,-97,11,,291936911,28,1347,291936883,291936911
20067,5,24,149,5745,-84,-97,13,,291936955,28,16,291936927,291936955
20068,5,24,149,5745,-84,-97,13,,291937063,32,76,291937031,291937063
20069,5,6,149,5745,-73,-97,24,24:f6:77:10:02:c8,291949701,100,12538,291949601,291949701
20070,5,6,149,5745,-73,-97,24,24:f6:77:10:02:c8,291949818,92,25,291949726,291949818
20071,5,6,149,5745,-73,-97,24,24:f6:77:10:02:c8,291949926,92,16,291949834,291949926
20072,5,12,149,5745,-68,-97,29,72:d1:72:1d:22:a1,291951084,284,874,291950800,291951084
20073,5,12,149,5745,-70,-97,27,56:68:e2:c2:8d:d5,291963013,280,11649,291962733,291963013
20074,5,12,149,5745,-91,-97,6,42:d2:d9:2b:ac:61,291964395,256,1126,291964139,291964395
20075,5,6,149,5745,-71,-97,26,,291976616,52,12169,291976564,291976616
20076,5,6,149,5745,-85,-97,12,,291976685,44,25,291976641,291976685
20077,5,24,149,5745,-84,-97,13,,291976802,28,89,291976774,291976802
20078,5,12,149,5745,-65,-97,32,5e:29:73:5b:30:00,291982081,272,5007,291981809,291982081
20079,5,24,149,5745,-84,-97,13,,291985349,28,3240,291985321,291985349
20080,5,24,149,5745,-86,-97,11,,291985393,28,16,291985365,291985393
20081,5,24,149,5745,-87,-97,10,,291985501,32,76,291985469,291985501
20082,5,6,149,5745,-71,-97,26,,291991714,52,6161,291991662,291991714
20083,5,6,149,5745,-84,-97,13,,291991783,44,25,291991739,291991783
20084,5,24,149,5745,-84,-97,13,,291991900,28,89,291991872,291991900
20085,5,6,149,5745,-71,-97,26,,291992097,52,145,291992045,291992097
20086,5,6,149,5745,-84,-97,13,,291992165,44,24,291992121,291992165
20087,5,24,149,5745,-84,-97,13,,291992283,28,90,291992255,291992283
20088,5,12,149,5745,-56,-97,41,3e:d1:9b:c7:a4:de,291996093,272,3538,291995821,291996093
20089,5,12,149,5745,-87,-97,10,9a:24:38:da:96:bb,291998659,272,2294,291998387,291998659
20090,5,12,149,5745,-67,-97,30,72:d1:72:1d:22:a1,292007424,284,8481,292007140,292007424
20091,5,12,149,5745,-67,-97,30,22:ec:75:a8:8a:31,292013524,244,5856,292013280,292013524
20092,5,12,149,5745,-72,-97,25,6a:1e:a4:f8:14:49,292026023,284,12215,292025739,292026023
20093,5,6,149,5745,-87,-97,10,54:e4:3a:ec:fb:65,292028858,360,2475,292028498,292028858
20094,5,24,149,5745,-87,-97,10,,292029365,28,479,292029337,292029365
20095,5,24,149,5745,-83,-97,14,,292029409,28,16,292029381,292029409
20096,5,24,149,5745,-83,-97,14,,292029517,32,76,292029485,292029517
20097,5,12,149,5745,-53,-97,44,4a:86:35:36:74:b8,292033342,268,3557,292033074,292033342
20098,5,12,149,5745,-71,-97,26,f2:da:61:dd:98:c5,292033968,268,358,292033700,292033968
20099,5,24,149,5745,-83,-97,14,,292047068,28,13072,292047040,292047068
20100,5,24,149,5745,-86,-97,11,,292047112,28,16,292047084,292047112
20101,5,24,149,5745,-86,-97,11,,292047220,32,76,292047188,292047220
20102,5,12,149,5745,-88,-97,9,42:d2:d9:2b:ac:61,292048867,256,1391,292048611,292048867
20103,5,12,149,5745,-67,-97,30,22:ec:75:a8:8a:31,292050143,516,760,292049627,292050143
20104,5,12,149,5745,-69,-97,28,56:68:e2:c2:8d:d5,292052178,476,1559,292051702,292052178
20105,5,12,149,5745,-56,-97,41,3e:d1:9b:c7:a4:de,292052805,544,83,292052261,292052805
20106,5,12,149,5745,-69,-97,28,f6:0a:5c:59:72:df,292053726,280,641,292053446,292053726
20107,5,12,149,5745,-70,-97,27,6a:1e:a4:f8:14:49,292056714,480,2508,292056234,292056714
20108,5,12,149,5745,-72,-97,25,6a:1e:a4:f8:14:49,292061553,380,4459,292061173,292061553
20109,5,12,149,5745,-72,-97,25,f2:da:61:dd:98:c5,292062491,268,670,292062223,292062491
20110,5,12,149,5745,-69,-97,28,72:d1:72:1d:22:a1,292063315,480,344,292062835,292063315
20111,5,12,149,5745,-53,-97,44,4a:86:35:36:74:b8,292063849,268,266,292063581,292063849
20112,5,12,149,5745,-69,-97,28,56:68:e2:c2:8d:d5,292064664,280,535,292064384,292064664
20113,5,24,149,5745,-83,-97,14,,292066110,32,1414,292066078,292066110
20114,5,24,149,5745,-83,-97,14,,292066756,28,618,292066728,292066756
20115,5,6,149,5745,-92,-97,5,,292066916,68,92,292066848,292066916
20116,5,24,149,5745,-83,-97,14,,292068173,32,1225,292068141,292068173
20117,5,12,149,5745,-65,-97,32,5e:29:73:5b:30:00,292068554,540,-159,292068014,292068554
20118,5,12,149,5745,-69,-97,28,f6:0a:5c:59:72:df,292070465,476,1435,292069989,292070465
20119,5,12,149,5745,-54,-97,43,4a:86:35:36:74:b8,292098158,268,27425,292097890,292098158
20120,5,12,149,5745,-65,-97,32,5e:29:73:5b:30:00,292099324,272,894,292099052,292099324
20121,5,12,149,5745,-53,-97,44,3e:d1:9b:c7:a4:de,292111002,272,11406,292110730,292111002
20122,5,12,149,5745,-73,-97,24,6a:1e:a4:f8:14:49,292114332,284,3046,292114048,292114332
20123,5,12,149,5745,-74,-97,23,6a:1e:a4:f8:14:49,292120816,480,6004,292120336,292120816
20124,5,12,149,5745,-68,-97,29,b6:90:18:f6:b1:d4,292124804,268,3720,292124536,292124804
20125,5,12,149,5745,-69,-97,28,72:d1:72:1d:22:a1,292125677,284,589,292125393,292125677
20126,5,6,149,5745,-89,-97,8,54:e4:3a:ec:fb:65,292131259,360,5222,292130899,292131259
20127,5,12,149,5745,-71,-97,26,f2:da:61:dd:98:c5,292132031,268,504,292131763,292132031
20128,5,12,149,5745,-70,-97,27,22:ec:75:a8:8a:31,292139020,244,6745,292138776,292139020
20129,5,12,149,5745,-55,-97,42,4a:86:35:36:74:b8,292144529,268,5241,292144261,292144529
20130,5,12,149,5745,-67,-97,30,b6:90:18:f6:b1:d4,292162376,268,17579,292162108,292162376
20131,5,12,149,5745,-74,-97,23,d2:00:04:7e:2c:ab,292169835,380,7079,292169455,292169835
20132,5,12,149,5745,-87,-97,10,42:d2:d9:2b:ac:61,292175802,256,5711,292175546,292175802
20133,5,12,149,5745,-69,-97,28,22:ec:75:a8:8a:31,292180709,516,4391,292180193,292180709
20134,5,12,149,5745,-90,-97,7,7e:05:42:11:d2:ec,292182573,244,1620,292182329,292182573
20135,5,12,149,5745,-68,-97,29,f6:0a:5c:59:72:df,292183404,280,551,292183124,292183404
20136,5,12,149,5745,-61,-97,36,0a:b9:b7:b1:4d:fa,292184177,268,505,292183909,292184177
20137,5,12,149,5745,-72,-97,25,6a:1e:a4:f8:14:49,292186036,480,1379,292185556,292186036
20138,5,12,149,5745,-53,-97,44,3e:d1:9b:c7:a4:de,292186559,544,-21,292186015,292186559
20139,5,12,149,5745,-65,-97,32,b6:90:18:f6:b1:d4,292188124,268,1297,292187856,292188124
20140,5,12,149,5745,-66,-97,31,a6:92:ad:b7:76:65,292188444,484,-164,292187960,292188444
20141,5,12,149,5745,-90,-97,7,9a:24:38:da:96:bb,292191804,824,2536,292190980,292191804
20142,5,12,149,5745,-57,-97,40,4a:86:35:36:74:b8,292193562,268,1490,292193294,292193562
20143,5,12,149,5745,-69,-97,28,f2:da:61:dd:98:c5,292193863,268,33,292193595,292193863
20144,5,12,149,5745,-65,-97,32,5e:29:73:5b:30:00,292197793,540,3390,292197253,292197793
20145,5,12,149,5745,-73,-97,24,d2:00:04:7e:2c:ab,292198430,440,197,292197990,292198430
20146,5,12,149,5745,-90,-97,7,7e:05:42:11:d2:ec,292203621,412,4779,292203209,292203621
20147,5,12,149,5745,-58,-97,39,4a:86:35:36:74:b8,292211975,268,8086,292211707,292211975
20148,5,12,149,5745,-68,-97,29,f2:da:61:dd:98:c5,292212412,268,169,292212144,292212412
20149,5,12,149,5745,-65,-97,32,5e:29:73:5b:30:00,292213317,272,633,292213045,292213317
20150,5,12,149,5745,-87,-97,10,9a:24:38:da:96:bb,292221167,272,7578,292220895,292221167
20151,5,12,149,5745,-53,-97,44,3e:d1:9b:c7:a4:de,292228907,272,7468,292228635,292228907
20152,5,12,149,5745,-72,-97,25,6a:1e:a4:f8:14:49,292229402,284,211,292229118,292229402
20153,5,6,149,5745,-86,-97,11,54:e4:3a:ec:fb:65,292233659,360,3897,292233299,292233659
20154,5,12,149,5745,-68,-97,29,22:ec:75:a8:8a:31,292252120,244,18217,292251876,292252120
20155,5,24,149,5745,-87,-97,10,,292254268,28,2120,292254240,292254268
20156,5,24,149,5745,-87,-97,10,,292254313,28,17,292254285,292254313
20157,5,24,149,5745,-87,-97,10,,292254421,32,76,292254389,292254421
20158,5,12,149,5745,-72,-97,25,72:d1:72:1d:22:a1,292258582,284,3877,292258298,292258582
20159,5,12,149,5745,-70,-97,27,56:68:e2:c2:8d:d5,292258927,280,65,292258647,292258927
20160,5,12,149,5745,-89,-97,8,7e:05:42:11:d2:ec,292269261,412,9922,292268849,292269261
20161,5,24,149,5745,-86,-97,11,,292273889,28,4600,292273861,292273889
20162,5,24,149,5745,-85,-97,12,,292273933,28,16,292273905,292273933
20163,5,24,149,5745,-85,-97,12,,292274041,32,76,292274009,292274041
20164,5,12,149,5745,-88,-97,9,42:d2:d9:2b:ac:61,292288109,256,13812,292287853,292288109
20165,5,12,149,5745,-89,-97,8,7e:05:42:11:d2:ec,292298251,244,9898,292298007,292298251
20166,5,12,149,5745,-64,-97,33,5e:29:73:5b:30:00,292323108,272,24585,292322836,292323108
20167,5,12,149,5745,-90,-97,7,9a:24:38:da:96:bb,292333882,272,10502,292333610,292333882
20168,5,6,149,5745,-87,-97,10,54:e4:3a:ec:fb:65,292336060,360,1818,292335700,292336060
20169,5,12,149,5745,-56,-97,41,4a:86:35:36:74:b8,292337457,268,1129,292337189,292337457
20170,5,12,149,5745,-51,-97,46,3e:d1:9b:c7:a4:de,292340229,272,2500,292339957,292340229
20171,5,12,149,5745,-70,-97,27,f2:da:61:dd:98:c5,292340555,268,58,292340287,292340555
20172,5,12,149,5745,-65,-97,32,b6:90:18:f6:b1:d4,292360128,268,19305,292359860,292360128
20173,5,12,149,5745,-72,-97,25,72:d1:72:1d:22:a1,292360753,284,341,292360469,292360753
20174,5,12,149,5745,-70,-97,27,56:68:e2:c2:8d:d5,292362804,280,1771,292362524,292362804
20175,5,12,149,5745,-68,-97,29,22:ec:75:a8:8a:31,292369389,244,6341,292369145,292369389
20176,5,12,149,5745,-65,-97,32,6a:1e:a4:f8:14:49,292435028,284,65355,292434744,292435028
20177,5,6,149,5745,-87,-97,10,54:e4:3a:ec:fb:65,292438460,360,3072,292438100,292438460
20178,5,12,149,5745,-66,-97,31,5e:29:73:5b:30:00,292440772,272,2040,292440500,292440772
20179,5,12,149,5745,-59,-97,38,4a:86:35:36:74:b8,292450258,268,9218,292449990,292450258
20180,5,12,149,5745,-68,-97,29,f2:da:61:dd:98:c5,292451783,268,1257,292451515,292451783
20181,5,12,149,5745,-85,-97,12,9a:24:38:da:96:bb,292452330,272,275,292452058,292452330
20182,5,12,149,5745,-55,-97,42,3e:d1:9b:c7:a4:de,292457482,272,4880,292457210,292457482
20183,5,12,149,5745,-63,-97,34,b6:90:18:f6:b1:d4,292462924,268,5174,292462656,292462924
20184,5,12,149,5745,-70,-97,27,72:d1:72:1d:22:a1,292463309,284,101,292463025,292463309
20185,5,24,149,5745,-87,-97,10,,292463753,28,416,292463725,292463753
20186,5,24,149,5745,-84,-97,13,,292463797,28,16,292463769,292463797
20187,5,24,149,5745,-84,-97,13,,292463906,32,77,292463874,292463906
20188,5,24,149,5745,-87,-97,10,,292464875,28,941,292464847,292464875
20189,5,24,149,5745,-84,-97,13,,292464919,28,16,292464891,292464919
20190,5,24,149,5745,-85,-97,12,,292465027,32,76,292464995,292465027
20191,5,24,149,5745,-85,-97,12,,292465237,28,182,292465209,292465237
20192,5,24,149,5745,-87,-97,10,,292465282,28,17,292465254,292465282
20193,5,24,149,5745,-88,-97,9,,292465389,32,75,292465357,292465389
20194,5,12,149,5745,-74,-97,23,56:68:e2:c2:8d:d5,292465456,280,-213,292465176,292465456
20195,5,24,149,5745,-84,-97,13,,292466204,28,720,292466176,292466204
20196,5,24,149,5745,-87,-97,10,,292466249,28,17,292466221,292466249
20197,5,24,149,5745,-87,-97,10,,292466360,32,79,292466328,292466360
20198,5,24,149,5745,-87,-97,10,,292469155,28,2767,292469127,292469155
20199,5,24,149,5745,-85,-97,12,,292469200,28,17,292469172,292469200
20200,5,24,149,5745,-84,-97,13,,292469320,32,88,292469288,292469320
20201,5,24,149,5745,-88,-97,9,,292470327,28,979,292470299,292470327
20202,5,24,149,5745,-84,-97,13,,292470372,28,17,292470344,292470372
20203,5,24,149,5745,-84,-97,13,,292470504,32,100,292470472,292470504
20204,5,12,149,5745,-91,-97,6,42:d2:d9:2b:ac:61,292476356,256,5596,292476100,292476356
20205,5,24,149,5745,-87,-97,10,,292478390,28,2006,292478362,292478390
20206,5,24,149,5745,-85,-97,12,,292478434,28,16,292478406,292478434
20207,5,24,149,5745,-85,-97,12,,292478542,32,76,292478510,292478542
20208,5,12,149,5745,-67,-97,30,22:ec:75:a8:8a:31,292485164,244,6378,292484920,292485164
20209,5,24,149,5745,-85,-97,12,,292490296,28,5104,292490268,292490296
20210,5,24,149,5745,-88,-97,9,,292490340,28,16,292490312,292490340
20211,5,24,149,5745,-89,-97,8,,292490459,32,87,292490427,292490459
20212,5,24,149,5745,-88,-97,9,,292490578,32,87,292490546,292490578
20213,5,24,149,5745,-85,-97,12,,292491017,28,411,292490989,292491017
20214,5,24,149,5745,-89,-97,8,,292491061,28,16,292491033,292491061
20215,5,24,149,5745,-88,-97,9,,292491169,32,76,292491137,292491169
20216,5,24,149,5745,-88,-97,9,,292491281,32,80,292491249,292491281
20217,5,24,149,5745,-88,-97,9,,292493631,28,2322,292493603,292493631
20218,5,24,149,5745,-86,-97,11,,292493675,28,16,292493647,292493675
20219,5,24,149,5745,-85,-97,12,,292493788,32,81,292493756,292493788
20220,5,24,149,5745,-85,-97,12,,292496688,28,2872,292496660,292496688
20221,5,24,149,5745,-88,-97,9,,292496732,28,16,292496704,292496732
20222,5,24,149,5745,-86,-97,11,,292507373,28,10613,292507345,292507373
20223,5,24,149,5745,-87,-97,10,,292507417,28,16,292507389,292507417
20224,5,24,149,5745,-89,-97,8,,292507524,32,75,292507492,292507524
20225,5,24,149,5745,-89,-97,8,,292507636,32,80,292507604,292507636
20226,5,24,149,5745,-88,-97,9,,292510289,28,2625,292510261,292510289
20227,5,24,149,5745,-86,-97,11,,292510334,28,17,292510306,292510334
20228,5,24,149,5745,-86,-97,11,,292510442,32,76,292510410,292510442
20229,5,24,149,5745,-88,-97,9,,292536603,28,26133,292536575,292536603
20230,5,24,149,5745,-86,-97,11,,292536647,28,16,292536619,292536647
20231,5,24,149,5745,-86,-97,11,,292536756,32,77,292536724,292536756
20232,5,12,149,5745,-65,-97,32,6a:1e:a4:f8:14:49,292538080,284,1040,292537796,292538080
20233,5,24,149,5745,-90,-97,7,,292539174,28,1066,292539146,292539174
20234,5,24,149,5745,-87,-97,10,,292539219,28,17,292539191,292539219
20235,5,24,149,5745,-87,-97,10,,292539327,32,76,292539295,292539327
20236,5,6,149,5745,-86,-97,11,54:e4:3a:ec:fb:65,292540861,360,1174,292540501,292540861
20237,5,24,149,5745,-85,-97,12,,292553743,28,12854,292553715,292553743
20238,5,24,149,5745,-86,-97,11,,292553787,28,16,292553759,292553787
20239,5,24,149,5745,-87,-97,10,,292553895,32,76,292553863,292553895
20240,5,12,149,5745,-62,-97,35,4a:86:35:36:74:b8,292557004,268,2841,292556736,292557004
20241,5,12,149,5745,-68,-97,29,5e:29:73:5b:30:00,292558374,272,1098,292558102,292558374
20242,5,24,149,5745,-87,-97,10,,292559610,28,1208,292559582,292559610
20243,5,24,149,5745,-86,-97,11,,292559654,28,16,292559626,292559654
20244,5,24,149,5745,-86,-97,11,,292559773,32,87,292559741,292559773
20245,5,24,149,5745,-87,-97,10,,292559946,28,145,292559918,292559946
20246,5,24,149,5745,-87,-97,10,,292559990,28,16,292559962,292559990
20247,5,24,149,5745,-86,-97,11,,292560105,32,83,292560073,292560105
20248,5,24,149,5745,-87,-97,10,,292560491,28,358,292560463,292560491
20249,5,24,149,5745,-87,-97,10,,292560535,28,16,292560507,292560535
20250,5,24,149,5745,-87,-97,10,,292560647,32,80,292560615,292560647
20251,5,24,149,5745,-88,-97,9,,292561892,28,1217,292561864,292561892
20252,5,24,149,5745,-87,-97,10,,292561936,28,16,292561908,292561936
20253,5,24,149,5745,-86,-97,11,,292562044,32,76,292562012,292562044
20254,5,24,149,5745,-87,-97,10,,292562574,28,502,292562546,292562574
20255,5,24,149,5745,-86,-97,11,,292562618,28,16,292562590,292562618
20256,5,24,149,5745,-87,-97,10,,292562726,32,76,292562694,292562726
20257,5,24,149,5745,-87,-97,10,,292562838,28,84,292562810,292562838
20258,5,24,149,5745,-88,-97,9,,292562882,28,16,292562854,292562882
20259,5,24,149,5745,-87,-97,10,,292562994,32,80,292562962,292562994
20260,5,24,149,5745,-88,-97,9,,292563114,28,92,292563086,292563114
20261,5,24,149,5745,-87,-97,10,,292563159,28,17,292563131,292563159
20262,5,24,149,5745,-88,-97,9,,292563267,32,76,292563235,292563267
20263,5,24,149,5745,-87,-97,10,,292565517,28,2222,292565489,292565517
20264,5,24,149,5745,-87,-97,10,,292565561,28,16,292565533,292565561
20265,5,24,149,5745,-87,-97,10,,292565669,32,76,292565637,292565669
20266,5,12,149,5745,-74,-97,23,56:68:e2:c2:8d:d5,292566012,280,63,292565732,292566012
20267,5,12,149,5745,-68,-97,29,b6:90:18:f6:b1:d4,292566517,268,237,292566249,292566517
20268,5,12,149,5745,-55,-97,42,3e:d1:9b:c7:a4:de,292569350,272,2561,292569078,292569350
20269,5,12,149,5745,-68,-97,29,f2:da:61:dd:98:c5,292573495,268,3877,292573227,292573495
20270,5,24,149,5745,-88,-97,9,,292576175,28,2652,292576147,292576175
20271,5,24,149,5745,-86,-97,11,,292576220,28,17,292576192,292576220
20272,5,24,149,5745,-86,-97,11,,292576331,32,79,292576299,292576331
20273,5,12,149,5745,-88,-97,9,42:d2:d9:2b:ac:61,292578080,256,1493,292577824,292578080
20274,5,24,149,5745,-85,-97,12,,292581179,28,3071,292581151,292581179
20275,5,24,149,5745,-87,-97,10,,292581224,28,17,292581196,292581224
20276,5,24,149,5745,-87,-97,10,,292581332,32,76,292581300,292581332
20277,5,12,149,5745,-69,-97,28,72:d1:72:1d:22:a1,292581680,284,64,292581396,292581680
20278,5,12,149,5745,-65,-97,32,6a:1e:a4:f8:14:49,292583099,284,1135,292582815,292583099
20279,5,24,149,5745,-87,-97,10,,292596912,28,13785,292596884,292596912
20280,5,24,149,5745,-86,-97,11,,292596957,28,17,292596929,292596957
20281,5,24,149,5745,-86,-97,11,,292597065,32,76,292597033,292597065
20282,5,12,149,5745,-69,-97,28,22:ec:75:a8:8a:31,292597185,244,-124,292596941,292597185
20283,5,24,149,5745,-87,-97,10,,292599681,28,2468,292599653,292599681
20284,5,24,149,5745,-87,-97,10,,292599725,28,16,292599697,292599725
20285,5,24,149,5745,-87,-97,10,,292599833,32,76,292599801,292599833
20286,5,24,149,5745,-87,-97,10,,292600510,28,649,292600482,292600510
20287,5,24,149,5745,-86,-97,11,,292600554,28,16,292600526,292600554
20288,5,24,149,5745,-87,-97,10,,292600666,32,80,292600634,292600666
20289,5,24,149,5745,-87,-97,10,,292601003,28,309,292600975,292601003
20290,5,24,149,5745,-87,-97,10,,292601048,28,17,292601020,292601048
20291,5,24,149,5745,-88,-97,9,,292601164,32,84,292601132,292601164
20292,5,24,149,5745,-86,-97,11,,292601293,28,101,292601265,292601293
20293,5,24,149,5745,-86,-97,11,,292601337,28,16,292601309,292601337
20294,5,24,149,5745,-86,-97,11,,292601445,32,76,292601413,292601445
20295,5,24,149,5745,-87,-97,10,,292603366,28,1893,292603338,292603366
20296,5,24,149,5745,-87,-97,10,,292603410,28,16,292603382,292603410
20297,5,24,149,5745,-87,-97,10,,292603519,32,77,292603487,292603519
20298,5,24,149,5745,-85,-97,12,,292619314,28,15767,292619286,292619314
20299,5,24,149,5745,-86,-97,11,,292619358,28,16,292619330,292619358
20300,5,24,149,5745,-86,-97,11,,292619477,32,87,292619445,292619477
20301,5,12,149,5745,-68,-97,29,b6:90:18:f6:b1:d4,292621805,268,2060,292621537,292621805
20302,5,24,149,5745,-86,-97,11,,292622198,28,365,292622170,292622198
20303,5,24,149,5745,-85,-97,12,,292622242,28,16,292622214,292622242
20304,5,24,149,5745,-85,-97,12,,292622350,32,76,292622318,292622350
20305,5,12,149,5745,-66,-97,31,f6:0a:5c:59:72:df,292624917,280,2287,292624637,292624917
20306,5,12,149,5745,-85,-97,12,9a:24:38:da:96:bb,292625354,272,165,292625082,292625354
20307,5,12,149,5745,-89,-97,8,42:d2:d9:2b:ac:61,292625719,256,109,292625463,292625719
20308,5,24,149,5745,-87,-97,10,,292628987,28,3240,292628959,292628987
20309,5,24,149,5745,-85,-97,12,,292629031,28,16,292629003,292629031
20310,5,24,149,5745,-85,-97,12,,292629140,32,77,292629108,292629140
20311,5,12,149,5745,-70,-97,27,22:ec:75:a8:8a:31,292638073,516,8417,292637557,292638073
20312,5,12,149,5745,-72,-97,25,56:68:e2:c2:8d:d5,292638659,280,306,292638379,292638659
20313,5,12,149,5745,-72,-97,25,56:68:e2:c2:8d:d5,292642125,476,2990,292641649,292642125
20314,5,24,149,5745,-84,-97,13,,292642752,28,599,292642724,292642752
20315,5,24,149,5745,-86,-97,11,,292642796,28,16,292642768,292642796
20316,5,24,149,5745,-87,-97,10,,292642904,32,76,292642872,292642904
20317,5,12,149,5745,-51,-97,46,3e:d1:9b:c7:a4:de,292643015,544,-433,292642471,292643015
20318,5,6,149,5745,-84,-97,13,54:e4:3a:ec:fb:65,292643591,360,216,292643231,292643591
20319,5,12,149,5745,-88,-97,9,42:d2:d9:2b:ac:61,292646020,452,1977,292645568,292646020
20320,5,12,149,5745,-66,-97,31,b6:90:18:f6:b1:d4,292647341,268,1053,292647073,292647341
20321,5,12,149,5745,-66,-97,31,6a:1e:a4:f8:14:49,292648624,480,803,292648144,292648624
20322,5,12,149,5745,-69,-97,28,f2:da:61:dd:98:c5,292653892,268,5000,292653624,292653892
20323,5,12,149,5745,-57,-97,40,4a:86:35:36:74:b8,292654239,268,79,292653971,292654239
20324,5,12,149,5745,-69,-97,28,72:d1:72:1d:22:a1,292655658,480,939,292655178,292655658
20325,5,12,149,5745,-67,-97,30,5e:29:73:5b:30:00,292656181,540,-17,292655641,292656181
20326,5,12,149,5745,-63,-97,34,f6:0a:5c:59:72:df,292660495,476,3838,292660019,292660495
20327,5,12,149,5745,-88,-97,9,7e:05:42:11:d2:ec,292665440,440,4505,292665000,292665440
20328,5,12,149,5745,-85,-97,12,9a:24:38:da:96:bb,292669176,272,3464,292668904,292669176
20329,5,12,149,5745,-68,-97,29,72:d1:72:1d:22:a1,292670558,284,1098,292670274,292670558
20330,5,12,149,5745,-57,-97,40,4a:86:35:36:74:b8,292670895,268,69,292670627,292670895
20331,5,12,149,5745,-69,-97,28,f2:da:61:dd:98:c5,292671197,268,34,292670929,292671197
20332,5,12,149,5745,-63,-97,34,6a:1e:a4:f8:14:49,292688239,284,16758,292687955,292688239
20333,5,12,149,5745,-51,-97,46,3e:d1:9b:c7:a4:de,292703210,272,14699,292702938,292703210
20334,5,12,149,5745,-67,-97,30,22:ec:75:a8:8a:31,292703561,516,-165,292703045,292703561
20335,5,24,149,5745,-86,-97,11,,292704488,28,899,292704460,292704488
20336,5,24,149,5745,-87,-97,10,,292704532,28,16,292704504,292704532
20337,5,24,149,5745,-87,-97,10,,292704640,32,76,292704608,292704640
20338,5,12,149,5745,-75,-97,22,56:68:e2:c2:8d:d5,292704878,476,-238,292704402,292704878
20339,5,12,149,5745,-51,-97,46,3e:d1:9b:c7:a4:de,292708699,544,3277,292708155,292708699
20340,5,12,149,5745,-86,-97,11,42:d2:d9:2b:ac:61,292709479,452,328,292709027,292709479
20341,5,12,149,5745,-57,-97,40,0a:b9:b7:b1:4d:fa,292710109,268,362,292709841,292710109
20342,5,12,149,5745,-66,-97,31,6a:1e:a4:f8:14:49,292710466,480,-123,292709986,292710466
20343,5,12,149,5745,-67,-97,30,b6:90:18:f6:b1:d4,292711975,268,1241,292711707,292711975
20344,5,12,149,5745,-68,-97,29,a6:92:ad:b7:76:65,292712732,484,273,292712248,292712732
20345,5,12,149,5745,-85,-97,12,9a:24:38:da:96:bb,292713449,824,-107,292712625,292713449
20346,5,12,149,5745,-67,-97,30,f2:da:61:dd:98:c5,292716433,268,2716,292716165,292716433
20347,5,12,149,5745,-61,-97,36,4a:86:35:36:74:b8,292717608,268,907,292717340,292717608
20348,5,12,149,5745,-69,-97,28,22:ec:75:a8:8a:31,292718719,244,867,292718475,292718719
20349,5,12,149,5745,-65,-97,32,5e:29:73:5b:30:00,292720853,540,1594,292720313,292720853
20350,5,12,149,5745,-74,-97,23,d2:00:04:7e:2c:ab,292722405,440,1112,292721965,292722405
20351,5,24,149,5745,-87,-97,10,,292722897,28,464,292722869,292722897
20352,5,24,149,5745,-85,-97,12,,292722941,28,16,292722913,292722941
20353,5,24,149,5745,-85,-97,12,,292723049,32,76,292723017,292723049
20354,5,12,149,5745,-65,-97,32,f6:0a:5c:59:72:df,292723727,476,202,292723251,292723727
20355,5,12,149,5745,-89,-97,8,7e:05:42:11:d2:ec,292729945,440,5778,292729505,292729945
20356,5,12,149,5745,-74,-97,23,56:68:e2:c2:8d:d5,292736440,280,6215,292736160,292736440
20357,5,12,149,5745,-65,-97,32,f6:0a:5c:59:72:df,292736817,280,97,292736537,292736817
20358,5,12,149,5745,-90,-97,7,42:d2:d9:2b:ac:61,292737149,256,76,292736893,292737149
20359,5,6,149,5745,-89,-97,8,54:e4:3a:ec:fb:65,292745662,360,8153,292745302,292745662
20360,5,12,149,5745,-84,-97,13,9a:24:38:da:96:bb,292782718,272,36784,292782446,292782718
20361,5,12,149,5745,-64,-97,33,5e:29:73:5b:30:00,292786759,272,3769,292786487,292786759
20362,5,12,149,5745,-57,-97,40,4a:86:35:36:74:b8,292788738,268,1711,292788470,292788738
20363,5,12,149,5745,-68,-97,29,f2:da:61:dd:98:c5,292791641,268,2635,292791373,292791641
20364,5,24,149,5745,-84,-97,13,,292796954,28,5285,292796926,292796954
20365,5,24,149,5745,-83,-97,14,,292796998,28,16,292796970,292796998
20366,5,24,149,5745,-83,-97,14,,292797107,32,77,292797075,292797107
20367,5,12,149,5745,-70,-97,27,72:d1:72:1d:22:a1,292797227,284,-164,292796943,292797227
20368,5,12,149,5745,-52,-97,45,3e:d1:9b:c7:a4:de,292798943,272,1444,292798671,292798943
20369,5,12,149,5745,-65,-97,32,6a:1e:a4:f8:14:49,292807789,284,8562,292807505,292807789
20370,5,24,149,5745,-83,-97,14,,292811087,28,3270,292811059,292811087
20371,5,24,149,5745,-84,-97,13,,292811131,28,16,292811103,292811131
20372,5,24,149,5745,-84,-97,13,,292811239,32,76,292811207,292811239
20373,5,12,149,5745,-63,-97,34,22:ec:75:a8:8a:31,292826019,244,14536,292825775,292826019
20374,5,24,149,5745,-84,-97,13,,292840508,28,14461,292840480,292840508
20375,5,24,149,5745,-83,-97,14,,292840552,28,16,292840524,292840552
20376,5,24,149,5745,-83,-97,14,,292840661,32,77,292840629,292840661
20377,5,6,149,5745,-88,-97,9,54:e4:3a:ec:fb:65,292848062,360,7041,292847702,292848062
20378,5,24,149,5745,-83,-97,14,,292855346,28,7256,292855318,292855346
20379,5,24,149,5745,-84,-97,13,,292855391,28,17,292855363,292855391
20380,5,24,149,5745,-84,-97,13,,292855509,32,86,292855477,292855509
20381,5,24,149,5745,-83,-97,14,,292855720,28,183,292855692,292855720
20382,5,24,149,5745,-85,-97,12,,292855764,28,16,292855736,292855764
20383,5,24,149,5745,-85,-97,12,,292855876,32,80,292855844,292855876
20384,5,24,149,5745,-83,-97,14,,292858339,28,2435,292858311,292858339
20385,5,24,149,5745,-85,-97,12,,292858383,28,16,292858355,292858383
20386,5,24,149,5745,-84,-97,13,,292858491,32,76,292858459,292858491
20387,5,24,149,5745,-83,-97,14,,292858653,28,134,292858625,292858653
20388,5,24,149,5745,-84,-97,13,,292858697,28,16,292858669,292858697
20389,5,24,149,5745,-84,-97,13,,292858805,32,76,292858773,292858805
20390,5,24,149,5745,-85,-97,12,,292858908,28,75,292858880,292858908
20391,5,24,149,5745,-83,-97,14,,292858952,28,16,292858924,292858952
20392,5,24,149,5745,-84,-97,13,,292859060,32,76,292859028,292859060
20393,5,12,149,5745,-70,-97,27,56:68:e2:c2:8d:d5,292861647,280,2307,292861367,292861647
20394,5,24,149,5745,-85,-97,12,,292862015,28,340,292861987,292862015
20395,5,24,149,5745,-82,-97,15,,292862059,28,16,292862031,292862059
20396,5,24,149,5745,-84,-97,13,,292862365,28,278,292862337,292862365
20397,5,24,149,5745,-83,-97,14,,292862410,28,17,292862382,292862410
20398,5,24,149,5745,-84,-97,13,,292862518,32,76,292862486,292862518
20399,5,12,149,5745,-63,-97,34,b6:90:18:f6:b1:d4,292872478,268,9692,292872210,292872478
20400,5,12,149,5745,-90,-97,7,42:d2:d9:2b:ac:61,292886209,256,13475,292885953,292886209
20401,5,24,149,5745,-85,-97,12,,292886571,28,334,292886543,292886571
20402,5,24,149,5745,-86,-97,11,,292886615,28,16,292886587,292886615
20403,5,24,149,5745,-85,-97,12,,292886723,32,76,292886691,292886723
20404,5,24,149,5745,-85,-97,12,,292898712,28,11961,292898684,292898712
20405,5,24,149,5745,-86,-97,11,,292898756,28,16,292898728,292898756
20406,5,12,149,5745,-64,-97,33,5e:29:73:5b:30:00,292904041,272,5013,292903769,292904041
20407,5,12,149,5745,-55,-97,42,3e:d1:9b:c7:a4:de,292914680,272,10367,292914408,292914680
20408,5,6,149,5745,-67,-97,30,,292915243,52,511,292915191,292915243
20409,5,6,149,5745,-83,-97,14,,292915311,44,24,292915267,292915311
20410,5,24,149,5745,-83,-97,14,,292915429,28,90,292915401,292915429
20411,5,24,149,5745,-85,-97,12,,292915545,28,88,292915517,292915545
20412,5,24,149,5745,-84,-97,13,,292915589,28,16,292915561,292915589
20413,5,24,149,5745,-84,-97,13,,292915697,32,76,292915665,292915697
20414,5,24,149,5745,-86,-97,11,,292927945,28,12220,292927917,292927945
20415,5,24,149,5745,-82,-97,15,,292927989,28,16,292927961,292927989
20416,5,24,149,5745,-82,-97,15,,292928097,32,76,292928065,292928097
20417,5,24,149,5745,-82,-97,15,,292930526,28,2401,292930498,292930526
20418,5,24,149,5745,-86,-97,11,,292930570,28,16,292930542,292930570
20419,5,24,149,5745,-86,-97,11,,292930678,32,76,292930646,292930678
20420,5,24,149,5745,-83,-97,14,,292940043,28,9337,292940015,292940043
20421,5,12,149,5745,-65,-97,32,22:ec:75:a8:8a:31,292943784,244,3497,292943540,292943784
20422,5,24,149,5745,-82,-97,15,,292945840,28,2028,292945812,292945840
20423,5,24,149,5745,-87,-97,10,,292945884,28,16,292945856,292945884
20424,5,24,149,5745,-87,-97,10,,292945992,32,76,292945960,292945992
20425,5,12,149,5745,-68,-97,29,6a:1e:a4:f8:14:49,292946496,284,220,292946212,292946496
20426,5,6,149,5745,-88,-97,9,54:e4:3a:ec:fb:65,292950463,360,3607,292950103,292950463
20427,5,12,149,5745,-69,-97,28,f2:da:61:dd:98:c5,292951351,268,620,292951083,292951351
20428,5,12,149,5745,-57,-97,40,4a:86:35:36:74:b8,292952415,268,796,292952147,292952415
20429,5,24,149,5745,-87,-97,10,,292961274,28,8831,292961246,292961274
20430,5,24,149,5745,-87,-97,10,,292961841,28,539,292961813,292961841
20431,5,24,149,5745,-86,-97,11,,292962318,28,449,292962290,292962318
20432,5,24,149,5745,-87,-97,10,,292963407,28,1061,292963379,292963407
20433,5,24,149,5745,-82,-97,15,,292963451,28,16,292963423,292963451
20434,5,24,149,5745,-83,-97,14,,292963564,32,81,292963532,292963564
20435,5,24,149,5745,-84,-97,13,,292971101,28,7509,292971073,292971101
20436,5,24,149,5745,-85,-97,12,,292971146,28,17,292971118,292971146
20437,5,24,149,5745,-85,-97,12,,292971264,32,86,292971232,292971264
20438,5,24,149,5745,-83,-97,14,,292971450,28,158,292971422,292971450
20439,5,24,149,5745,-86,-97,11,,292971494,28,16,292971466,292971494
20440,5,24,149,5745,-84,-97,13,,292971606,32,80,292971574,292971606
20441,5,12,149,5745,-69,-97,28,56:68:e2:c2:8d:d5,292971967,280,81,292971687,292971967
20442,5,24,149,5745,-84,-97,13,,292974583,28,2588,292974555,292974583
20443,5,24,149,5745,-85,-97,12,,292974627,28,16,292974599,292974627
20444,5,24,149,5745,-84,-97,13,,292974735,32,76,292974703,292974735
20445,5,24,149,5745,-85,-97,12,,292974991,28,228,292974963,292974991
20446,5,24,149,5745,-86,-97,11,,292975095,32,72,292975063,292975095
20447,5,12,149,5745,-63,-97,34,b6:90:18:f6:b1:d4,292975197,268,-166,292974929,292975197
20448,5,24,149,5745,-83,-97,14,,292975503,28,278,292975475,292975503
20449,5,24,149,5745,-84,-97,13,,292975611,32,76,292975579,292975611
20450,5,12,149,5745,-73,-97,24,72:d1:72:1d:22:a1,292975686,284,-209,292975402,292975686
20451,5,24,149,5745,-85,-97,12,,292977523,28,1809,292977495,292977523
20452,5,24,149,5745,-84,-97,13,,292977568,28,17,292977540,292977568
20453,5,24,149,5745,-84,-97,13,,292977676,32,76,292977644,292977676
20454,5,12,149,5745,-68,-97,29,f6:0a:5c:59:72:df,292981089,280,3133,292980809,292981089
20455,5,12,149,5745,-87,-97,10,42:d2:d9:2b:ac:61,292988422,256,7077,292988166,292988422
20456,5,6,149,5745,-68,-97,29,,292990990,52,2516,292990938,292990990
20457,5,6,149,5745,-83,-97,14,,292991058,44,24,292991014,292991058
20458,5,24,149,5745,-84,-97,13,,292991176,28,90,292991148,292991176
20459,5,12,149,5745,-90,-97,7,7e:05:42:11:d2:ec,292993812,244,2392,292993568,292993812
20460,5,24,149,5745,-85,-97,12,,293004318,28,10478,293004290,293004318
20461,5,24,149,5745,-83,-97,14,,293004362,28,16,293004334,293004362
20462,5,24,149,5745,-83,-97,14,,293004470,32,76,293004438,293004470
20463,5,12,149,5745,-87,-97,10,9a:24:38:da:96:bb,293007498,272,2756,293007226,293007498
20464,5,24,149,5745,-81,-97,16,,293014583,28,7057,293014555,293014583
20465,5,24,149,5745,-86,-97,11,,293014627,28,16,293014599,293014627
20466,5,24,149,5745,-85,-97,12,,293014735,32,76,293014703,293014735
20467,5,12,149,5745,-67,-97,30,5e:29:73:5b:30:00,293021135,272,6128,293020863,293021135
20468,5,12,149,5745,-53,-97,44,3e:d1:9b:c7:a4:de,293031406,272,9999,293031134,293031406
20469,5,24,149,5745,-85,-97,12,,293031748,28,314,293031720,293031748
20470,5,24,149,5745,-82,-97,15,,293031792,28,16,293031764,293031792
20471,5,24,149,5745,-81,-97,16,,293031900,32,76,293031868,293031900
20472,5,24,149,5745,-85,-97,12,,293035547,28,3619,293035519,293035547
20473,5,24,149,5745,-81,-97,16,,293035591,28,16,293035563,293035591
20474,5,24,149,5745,-81,-97,16,,293035703,32,80,293035671,293035703
20475,5,24,149,5745,-81,-97,16,,293036915,28,1184,293036887,293036915
20476,5,24,149,5745,-85,-97,12,,293036959,28,16,293036931,293036959
20477,5,24,149,5745,-86,-97,11,,293037067,32,76,293037035,293037067
20478,5,24,149,5745,-81,-97,16,,293037259,28,164,293037231,293037259
20479,5,24,149,5745,-84,-97,13,,293037304,28,17,293037276,293037304
20480,5,24,149,5745,-85,-97,12,,293037415,32,79,293037383,293037415
20481,5,24,149,5745,-85,-97,12,,293037735,28,292,293037707,293037735
20482,5,24,149,5745,-81,-97,16,,293037779,28,16,293037751,293037779
20483,5,24,149,5745,-81,-97,16,,293037891,32,80,293037859,293037891
20484,5,24,149,5745,-85,-97,12,,293038740,28,821,293038712,293038740
20485,5,24,149,5745,-81,-97,16,,293038784,28,16,293038756,293038784
20486,5,24,149,5745,-82,-97,15,,293038896,32,80,293038864,293038896
20487,5,24,149,5745,-81,-97,16,,293039057,28,133,293039029,293039057
20488,5,24,149,5745,-85,-97,12,,293039101,28,16,293039073,293039101
20489,5,24,149,5745,-85,-97,12,,293039213,32,80,293039181,293039213
20490,5,24,149,5745,-82,-97,15,,293039315,28,74,293039287,293039315
20491,5,24,149,5745,-85,-97,12,,293039359,28,16,293039331,293039359
20492,5,24,149,5745,-85,-97,12,,293039467,32,76,293039435,293039467
20493,5,24,149,5745,-85,-97,12,,293039966,28,471,293039938,293039966
20494,5,24,149,5745,-81,-97,16,,293040010,28,16,293039982,293040010
20495,5,24,149,5745,-81,-97,16,,293040131,32,89,293040099,293040131
20496,5,24,149,5745,-85,-97,12,,293041754,28,1595,293041726,293041754
20497,5,24,149,5745,-82,-97,15,,293041798,28,16,293041770,293041798
20498,5,24,149,5745,-82,-97,15,,293041907,32,77,293041875,293041907
20499,5,24,149,5745,-84,-97,13,,293044870,28,2935,293044842,293044870
20500,5,24,149,5745,-81,-97,16,,293044914,28,16,293044886,293044914
20501,5,24,149,5745,-81,-97,16,,293045034,32,88,293045002,293045034
20502,5,24,149,5745,-81,-97,16,,293047400,28,2338,293047372,293047400
20503,5,24,149,5745,-85,-97,12,,293047444,28,16,293047416,293047444
20504,5,24,149,5745,-85,-97,12,,293047552,32,76,293047520,293047552
20505,5,24,149,5745,-81,-97,16,,293047681,28,101,293047653,293047681
20506,5,24,149,5745,-85,-97,12,,293047725,28,16,293047697,293047725
20507,5,24,149,5745,-85,-97,12,,293047833,32,76,293047801,293047833
20508,5,24,149,5745,-84,-97,13,,293047981,28,120,293047953,293047981
20509,5,24,149,5745,-82,-97,15,,293048025,28,16,293047997,293048025
20510,5,24,149,5745,-82,-97,15,,293048141,32,84,293048109,293048141
20511,5,12,149,5745,-65,-97,32,6a:1e:a4:f8:14:49,293048541,284,116,293048257,293048541
20512,5,24,149,5745,-85,-97,12,,293049239,28,670,293049211,293049239
20513,5,24,149,5745,-81,-97,16,,293049283,28,16,293049255,293049283
20514,5,24,149,5745,-82,-97,15,,293049392,32,77,293049360,293049392
20515,5,12,149,5745,-70,-97,27,f2:da:61:dd:98:c5,293052744,268,3084,293052476,293052744
20516,5,6,149,5745,-90,-97,7,54:e4:3a:ec:fb:65,293053121,360,17,293052761,293053121
20517,5,24,149,5745,-82,-97,15,,293053536,28,387,293053508,293053536
20518,5,24,149,5745,-86,-97,11,,293053580,28,16,293053552,293053580
20519,5,24,149,5745,-86,-97,11,,293053688,32,76,293053656,293053688
20520,5,12,149,5745,-57,-97,40,4a:86:35:36:74:b8,293054205,268,249,293053937,293054205
20521,5,24,149,5745,-82,-97,15,,293054534,28,301,293054506,293054534
20522,5,24,149,5745,-85,-97,12,,293054578,28,16,293054550,293054578
20523,5,24,149,5745,-86,-97,11,,293054693,32,83,293054661,293054693
20524,5,24,149,5745,-82,-97,15,,293054868,28,147,293054840,293054868
20525,5,24,149,5745,-85,-97,12,,293054913,28,17,293054885,293054913
20526,5,24,149,5745,-86,-97,11,,293055021,32,76,293054989,293055021
20527,5,24,149,5745,-84,-97,13,,293055756,28,707,293055728,293055756
20528,5,24,149,5745,-82,-97,15,,293055800,28,16,293055772,293055800
20529,5,24,149,5745,-83,-97,14,,293055908,32,76,293055876,293055908
20530,5,24,149,5745,-85,-97,12,,293056990,28,1054,293056962,293056990
20531,5,24,149,5745,-82,-97,15,,293057033,28,15,293057005,293057033
20532,5,24,149,5745,-82,-97,15,,293057142,32,77,293057110,293057142
20533,5,24,149,5745,-85,-97,12,,293058106,28,936,293058078,293058106
20534,5,24,149,5745,-82,-97,15,,293058150,28,16,293058122,293058150
20535,5,24,149,5745,-82,-97,15,,293058263,32,81,293058231,293058263
20536,5,12,149,5745,-64,-97,33,22:ec:75:a8:8a:31,293059559,244,1052,293059315,293059559
20537,5,24,149,5745,-83,-97,14,,293062380,28,2793,293062352,293062380
20538,5,24,149,5745,-85,-97,12,,293062424,28,16,293062396,293062424
20539,5,24,149,5745,-85,-97,12,,293062543,32,87,293062511,293062543
20540,5,24,149,5745,-83,-97,14,,293062728,28,157,293062700,293062728
20541,5,24,149,5745,-84,-97,13,,293062773,28,17,293062745,293062773
20542,5,24,149,5745,-85,-97,12,,293062888,32,83,293062856,293062888
20543,5,24,149,5745,-83,-97,14,,293063044,28,128,293063016,293063044
20544,5,24,149,5745,-85,-97,12,,293063088,28,16,293063060,293063088
20545,5,24,149,5745,-86,-97,11,,293063195,32,75,293063163,293063195
20546,5,24,149,5745,-84,-97,13,,293064614,28,1391,293064586,293064614
20547,5,24,149,5745,-85,-97,12,,293064658,28,16,293064630,293064658
20548,5,24,149,5745,-86,-97,11,,293064766,32,76,293064734,293064766
20549,5,24,149,5745,-85,-97,12,,293065759,28,965,293065731,293065759
20550,5,24,149,5745,-83,-97,14,,293066019,28,232,293065991,293066019
20551,5,24,149,5745,-85,-97,12,,293066063,28,16,293066035,293066063
20552,5,24,149,5745,-85,-97,12,,293066182,32,87,293066150,293066182
20553,5,24,149,5745,-83,-97,14,,293066675,28,465,293066647,293066675
20554,5,24,149,5745,-86,-97,11,,293066720,28,17,293066692,293066720
20555,5,24,149,5745,-86,-97,11,,293066835,32,83,293066803,293066835
20556,5,24,149,5745,-82,-97,15,,293066993,28,130,293066965,293066993
20557,5,24,149,5745,-86,-97,11,,293067037,28,16,293067009,293067037
20558,5,24,149,5745,-85,-97,12,,293067145,32,76,293067113,293067145
20559,5,24,149,5745,-85,-97,12,,293067518,28,345,293067490,293067518
20560,5,24,149,5745,-83,-97,14,,293067562,28,16,293067534,293067562
20561,5,24,149,5745,-83,-97,14,,293067695,32,101,293067663,293067695
20562,5,24,149,5745,-82,-97,15,,293067833,28,110,293067805,293067833
20563,5,24,149,5745,-85,-97,12,,293067877,28,16,293067849,293067877
20564,5,24,149,5745,-85,-97,12,,293068007,32,98,293067975,293068007
20565,5,24,149,5745,-84,-97,13,,293068255,28,220,293068227,293068255
20566,5,24,149,5745,-85,-97,12,,293068299,28,16,293068271,293068299
20567,5,24,149,5745,-86,-97,11,,293068540,32,209,293068508,293068540
20568,5,24,149,5745,-83,-97,14,,293068707,28,139,293068679,293068707
20569,5,24,149,5745,-85,-97,12,,293068751,28,16,293068723,293068751
20570,5,24,149,5745,-85,-97,12,,293068870,32,87,293068838,293068870
20571,5,24,149,5745,-85,-97,12,,293069044,28,146,293069016,293069044
20572,5,24,149,5745,-84,-97,13,,293069088,28,16,293069060,293069088
20573,5,24,149,5745,-83,-97,14,,293069209,32,89,293069177,293069209
20574,5,24,149,5745,-86,-97,11,,293069988,28,751,293069960,293069988
20575,5,24,149,5745,-84,-97,13,,293070033,28,17,293070005,293070033
20576,5,24,149,5745,-84,-97,13,,293070153,32,88,293070121,293070153
20577,5,24,149,5745,-82,-97,15,,293071499,28,1318,293071471,293071499
20578,5,24,149,5745,-86,-97,11,,293071543,28,16,293071515,293071543
20579,5,24,149,5745,-86,-97,11,,293071663,32,88,293071631,293071663
20580,5,24,149,5745,-86,-97,11,,293071748,28,57,293071720,293071748
20581,5,24,149,5745,-83,-97,14,,293071792,28,16,293071764,293071792
20582,5,24,149,5745,-84,-97,13,,293071904,32,80,293071872,293071904
20583,5,24,149,5745,-84,-97,13,,293072024,28,92,293071996,293072024
20584,5,24,149,5745,-85,-97,12,,293072068,28,16,293072040,293072068
20585,5,24,149,5745,-85,-97,12,,293072187,32,87,293072155,293072187
20586,5,24,149,5745,-84,-97,13,,293072584,28,369,293072556,293072584
20587,5,24,149,5745,-87,-97,10,,293072628,28,16,293072600,293072628
20588,5,24,149,5745,-86,-97,11,,293072746,32,86,293072714,293072746
20589,5,24,149,5745,-83,-97,14,,293072917,28,143,293072889,293072917
20590,5,24,149,5745,-85,-97,12,,293072961,28,16,293072933,293072961
20591,5,24,149,5745,-86,-97,11,,293073080,32,87,293073048,293073080
20592,5,24,149,5745,-83,-97,14,,293073164,28,56,293073136,293073164
20593,5,24,149,5745,-86,-97,11,,293073208,28,16,293073180,293073208
20594,5,24,149,5745,-86,-97,11,,293073316,32,76,293073284,293073316
20595,5,24,149,5745,-85,-97,12,,293073455,28,111,293073427,293073455
20596,5,24,149,5745,-83,-97,14,,293073499,28,16,293073471,293073499
20597,5,24,149,5745,-83,-97,14,,293073608,32,77,293073576,293073608
20598,5,24,149,5745,-83,-97,14,,293073737,28,101,293073709,293073737
20599,5,24,149,5745,-86,-97,11,,293073781,28,16,293073753,293073781
20600,5,24,149,5745,-86,-97,11,,293073900,32,87,293073868,293073900
20601,5,24,149,5745,-86,-97,11,,293074855,28,927,293074827,293074855
20602,5,24,149,5745,-84,-97,13,,293074900,28,17,293074872,293074900
20603,5,24,149,5745,-83,-97,14,,293075012,32,80,293074980,293075012
20604,5,24,149,5745,-83,-97,14,,293076237,32,1193,293076205,293076237
20605,5,12,149,5745,-62,-97,35,b6:90:18:f6:b1:d4,293080393,268,3888,293080125,293080393
20606,5,12,149,5745,-67,-97,30,f6:0a:5c:59:72:df,293080731,280,58,293080451,293080731
20607,5,24,149,5745,-83,-97,14,,293081072,28,313,293081044,293081072
20608,5,24,149,5745,-86,-97,11,,293081116,28,16,293081088,293081116
20609,5,24,149,5745,-86,-97,11,,293081223,32,75,293081191,293081223
20610,5,24,149,5745,-83,-97,14,,293081512,28,261,293081484,293081512
20611,5,24,149,5745,-85,-97,12,,293081557,28,17,293081529,293081557
20612,5,24,149,5745,-86,-97,11,,293081664,32,75,293081632,293081664
20613,5,24,149,5745,-83,-97,14,,293081830,28,138,293081802,293081830
20614,5,24,149,5745,-86,-97,11,,293081874,28,16,293081846,293081874
20615,5,24,149,5745,-87,-97,10,,293081982,32,76,293081950,293081982
20616,5,24,149,5745,-84,-97,13,,293082137,28,127,293082109,293082137
20617,5,24,149,5745,-86,-97,11,,293082182,28,17,293082154,293082182
20618,5,24,149,5745,-86,-97,11,,293082289,32,75,293082257,293082289
20619,5,12,149,5745,-67,-97,30,72:d1:72:1d:22:a1,293083129,284,556,293082845,293083129
20620,5,12,149,5745,-88,-97,9,42:d2:d9:2b:ac:61,293083717,256,332,293083461,293083717
20621,5,24,149,5745,-83,-97,14,,293084124,28,379,293084096,293084124
20622,5,24,149,5745,-86,-97,11,,293084169,28,17,293084141,293084169
20623,5,24,149,5745,-87,-97,10,,293084288,32,87,293084256,293084288
20624,5,24,149,5745,-86,-97,11,,293084753,28,437,293084725,293084753
20625,5,24,149,5745,-84,-97,13,,293084797,28,16,293084769,293084797
20626,5,24,149,5745,-83,-97,14,,293084905,32,76,293084873,293084905
20627,5,12,149,5745,-89,-97,8,7e:05:42:11:d2:ec,293085161,244,12,293084917,293085161
20628,5,24,149,5745,-86,-97,11,,293086140,28,951,293086112,293086140
20629,5,24,149,5745,-83,-97,14,,293086184,28,16,293086156,293086184
20630,5,24,149,5745,-83,-97,14,,293086293,32,77,293086261,293086293
20631,5,12,149,5745,-70,-97,27,56:68:e2:c2:8d:d5,293086935,280,362,293086655,293086935
20632,5,24,149,5745,-84,-97,13,,293087437,28,474,293087409,293087437
20633,5,24,149,5745,-86,-97,11,,293087482,28,17,293087454,293087482
20634,5,24,149,5745,-86,-97,11,,293087600,32,86,293087568,293087600
20635,5,24,149,5745,-84,-97,13,,293087805,28,177,293087777,293087805
20636,5,24,149,5745,-86,-97,11,,293087849,28,16,293087821,293087849
20637,5,24,149,5745,-87,-97,10,,293087964,32,83,293087932,293087964
20638,5,24,149,5745,-87,-97,10,,293090192,28,2200,293090164,293090192
20639,5,24,149,5745,-85,-97,12,,293090236,28,16,293090208,293090236
20640,5,24,149,5745,-83,-97,14,,293090345,32,77,293090313,293090345
20641,5,24,149,5745,-87,-97,10,,293094077,28,3704,293094049,293094077
20642,5,24,149,5745,-84,-97,13,,293094121,28,16,293094093,293094121
20643,5,24,149,5745,-83,-97,14,,293094229,32,76,293094197,293094229
20644,5,24,149,5745,-87,-97,10,,293096332,28,2075,293096304,293096332
20645,5,24,149,5745,-83,-97,14,,293096375,28,15,293096347,293096375
20646,5,24,149,5745,-83,-97,14,,293096488,32,81,293096456,293096488
20647,5,24,149,5745,-88,-97,9,,293098697,28,2181,293098669,293098697
20648,5,24,149,5745,-83,-97,14,,293098741,28,16,293098713,293098741
20649,5,24,149,5745,-84,-97,13,,293098849,32,76,293098817,293098849
20650,5,12,149,5745,-63,-97,34,22:ec:75:a8:8a:31,293099782,516,417,293099266,293099782
20651,5,24,149,5745,-84,-97,13,,293100413,28,603,293100385,293100413
20652,5,24,149,5745,-87,-97,10,,293100457,28,16,293100429,293100457
20653,5,24,149,5745,-86,-97,11,,293100565,32,76,293100533,293100565
20654,5,24,149,5745,-83,-97,14,,293100676,28,83,293100648,293100676
20655,5,24,149,5745,-88,-97,9,,293100720,28,16,293100692,293100720
20656,5,24,149,5745,-88,-97,9,,293100831,32,79,293100799,293100831
20657,5,24,149,5745,-88,-97,9,,293100935,28,76,293100907,293100935
20658,5,24,149,5745,-83,-97,14,,293100978,28,15,293100950,293100978
20659,5,24,149,5745,-84,-97,13,,293101091,32,81,293101059,293101091
20660,5,24,149,5745,-87,-97,10,,293102625,28,1506,293102597,293102625
20661,5,24,149,5745,-84,-97,13,,293102669,28,16,293102641,293102669
20662,5,24,149,5745,-84,-97,13,,293102778,32,77,293102746,293102778
20663,5,12,149,5745,-71,-97,26,56:68:e2:c2:8d:d5,293104044,476,790,293103568,293104044
20664,5,12,149,5745,-52,-97,45,3e:d1:9b:c7:a4:de,293104555,544,-33,293104011,293104555
20665,5,12,149,5745,-87,-97,10,42:d2:d9:2b:ac:61,293105273,452,266,293104821,293105273
20666,5,12,149,5745,-61,-97,36,b6:90:18:f6:b1:d4,293106389,268,848,293106121,293106389
20667,5,12,149,5745,-89,-97,8,9a:24:38:da:96:bb,293107598,824,385,293106774,293107598
20668,5,12,149,5745,-70,-97,27,6a:1e:a4:f8:14:49,293108456,480,378,293107976,293108456
20669,5,24,149,5745,-85,-97,12,,293110595,28,2111,293110567,293110595
20670,5,24,149,5745,-89,-97,8,,293110638,28,15,293110610,293110638
20671,5,24,149,5745,-87,-97,10,,293110747,32,77,293110715,293110747
20672,5,12,149,5745,-58,-97,39,4a:86:35:36:74:b8,293111173,268,158,293110905,293111173
20673,5,12,149,5745,-68,-97,29,f2:da:61:dd:98:c5,293111475,268,34,293111207,293111475
20674,5,24,149,5745,-84,-97,13,,293111798,28,295,293111770,293111798
20675,5,24,149,5745,-88,-97,9,,293111842,28,16,293111814,293111842
20676,5,24,149,5745,-89,-97,8,,293111961,32,87,293111929,293111961
20677,5,24,149,5745,-84,-97,13,,293112129,28,140,293112101,293112129
20678,5,24,149,5745,-87,-97,10,,293112173,28,16,293112145,293112173
20679,5,24,149,5745,-88,-97,9,,293112288,32,83,293112256,293112288
20680,5,12,149,5745,-59,-97,38,4a:86:35:36:74:b8,293113093,268,537,293112825,293113093
20681,5,12,149,5745,-67,-97,30,72:d1:72:1d:22:a1,293113414,480,-159,293112934,293113414
20682,5,12,149,5745,-68,-97,29,f2:da:61:dd:98:c5,293113937,268,255,293113669,293113937
20683,5,24,149,5745,-85,-97,12,,293114330,28,365,293114302,293114330
20684,5,24,149,5745,-88,-97,9,,293114375,28,17,293114347,293114375
20685,5,24,149,5745,-84,-97,13,,293114683,28,280,293114655,293114683
20686,5,24,149,5745,-87,-97,10,,293114846,32,131,293114814,293114846
20687,5,24,149,5745,-84,-97,13,,293115046,28,172,293115018,293115046
20688,5,24,149,5745,-85,-97,12,,293115352,28,278,293115324,293115352
20689,5,24,149,5745,-89,-97,8,,293115396,28,16,293115368,293115396
20690,5,24,149,5745,-84,-97,13,,293115925,28,501,293115897,293115925
20691,5,24,149,5745,-84,-97,13,,293116252,28,299,293116224,293116252
20692,5,12,149,5745,-65,-97,32,5e:29:73:5b:30:00,293116639,540,-153,293116099,293116639
20693,5,24,149,5745,-85,-97,12,,293117417,28,750,293117389,293117417
20694,5,12,149,5745,-89,-97,8,9a:24:38:da:96:bb,293117997,272,308,293117725,293117997
20695,5,12,149,5745,-65,-97,32,f6:0a:5c:59:72:df,293118713,476,240,293118237,293118713
20696,5,24,149,5745,-85,-97,12,,293122326,28,3585,293122298,293122326
20697,5,24,149,5745,-86,-97,11,,293122438,32,80,293122406,293122438
20698,5,24,149,5745,-85,-97,12,,293123461,28,995,293123433,293123461
20699,5,24,149,5745,-85,-97,12,,293123573,32,80,293123541,293123573
20700,5,24,149,5745,-88,-97,9,,293124536,28,935,293124508,293124536
20701,5,24,149,5745,-84,-97,13,,293124580,28,16,293124552,293124580
20702,5,24,149,5745,-85,-97,12,,293124693,32,81,293124661,293124693
20703,5,24,149,5745,-88,-97,9,,293125638,28,917,293125610,293125638
20704,5,24,149,5745,-85,-97,12,,293125682,28,16,293125654,293125682
20705,5,24,149,5745,-85,-97,12,,293125803,32,89,293125771,293125803
20706,5,12,149,5745,-67,-97,30,72:d1:72:1d:22:a1,293129464,284,3377,293129180,293129464
20707,5,24,149,5745,-86,-97,11,,293130959,28,1467,293130931,293130959
20708,5,24,149,5745,-88,-97,9,,293131003,28,16,293130975,293131003
20709,5,12,149,5745,-69,-97,28,6a:1e:a4:f8:14:49,293131180,284,-107,293130896,293131180
20710,5,24,149,5745,-88,-97,9,,293131567,32,355,293131535,293131567
20711,5,24,149,5745,-86,-97,11,,293133424,28,1829,293133396,293133424
20712,5,24,149,5745,-88,-97,9,,293133468,28,16,293133440,293133468
20713,5,24,149,5745,-89,-97,8,,293133691,28,195,293133663,293133691
20714,5,24,149,5745,-86,-97,11,,293133736,28,17,293133708,293133736
20715,5,24,149,5745,-87,-97,10,,293133848,32,80,293133816,293133848
20716,5,24,149,5745,-86,-97,11,,293133915,28,39,293133887,293133915
20717,5,24,149,5745,-89,-97,8,,293133959,28,16,293133931,293133959
20718,5,24,149,5745,-89,-97,8,,293134943,28,956,293134915,293134943
20719,5,24,149,5745,-87,-97,10,,293134987,28,16,293134959,293134987
20720,5,24,149,5745,-87,-97,10,,293135099,32,80,293135067,293135099
20721,5,24,149,5745,-85,-97,12,,293135450,28,323,293135422,293135450
20722,5,24,149,5745,-86,-97,11,,293135806,28,328,293135778,293135806
20723,5,24,149,5745,-90,-97,7,,293135851,28,17,293135823,293135851
20724,5,24,149,5745,-86,-97,11,,293136203,28,324,293136175,293136203
20725,5,24,149,5745,-89,-97,8,,293136355,32,120,293136323,293136355
20726,5,24,149,5745,-85,-97,12,,293136772,28,389,293136744,293136772
20727,5,24,149,5745,-88,-97,9,,293136816,28,16,293136788,293136816
20728,5,24,149,5745,-87,-97,10,,293137020,28,176,293136992,293137020
20729,5,24,149,5745,-90,-97,7,,293137064,28,16,293137036,293137064
20730,5,24,149,5745,-87,-97,10,,293137239,28,147,293137211,293137239
20731,5,24,149,5745,-89,-97,8,,293137413,32,142,293137381,293137413
20732,5,24,149,5745,-87,-97,10,,293138205,28,764,293138177,293138205
20733,5,24,149,5745,-88,-97,9,,293138249,28,16,293138221,293138249
20734,5,24,149,5745,-88,-97,9,,293138379,32,98,293138347,293138379
20735,5,24,149,5745,-86,-97,11,,293138499,28,92,293138471,293138499
20736,5,24,149,5745,-89,-97,8,,293138651,32,120,293138619,293138651
20737,5,24,149,5745,-87,-97,10,,293138753,28,74,293138725,293138753
20738,5,24,149,5745,-87,-97,10,,293138797,28,16,293138769,293138797
20739,5,24,149,5745,-89,-97,8,,293139375,28,550,293139347,293139375
20740,5,24,149,5745,-85,-97,12,,293139419,28,16,293139391,293139419
20741,5,24,149,5745,-86,-97,11,,293139563,32,112,293139531,293139563
20742,5,24,149,5745,-86,-97,11,,293139798,28,207,293139770,293139798
20743,5,24,149,5745,-89,-97,8,,293139842,28,16,293139814,293139842
20744,5,24,149,5745,-87,-97,10,,293139961,32,87,293139929,293139961
20745,5,24,149,5745,-87,-97,10,,293140119,28,130,293140091,293140119
20746,5,24,149,5745,-90,-97,7,,293140293,32,142,293140261,293140293
20747,5,24,149,5745,-86,-97,11,,293141299,28,978,293141271,293141299
20748,5,24,149,5745,-89,-97,8,,293141343,28,16,293141315,293141343
20749,5,24,149,5745,-88,-97,9,,293141473,32,98,293141441,293141473
20750,5,24,149,5745,-86,-97,11,,293141625,28,124,293141597,293141625
20751,5,24,149,5745,-87,-97,10,,293141669,28,16,293141641,293141669
20752,5,24,149,5745,-89,-97,8,,293141799,32,98,293141767,293141799
20753,5,24,149,5745,-88,-97,9,,293141928,28,101,293141900,293141928
20754,5,24,149,5745,-87,-97,10,,293141973,28,17,293141945,293141973
20755,5,24,149,5745,-87,-97,10,,293142085,32,80,293142053,293142085
20756,5,24,149,5745,-86,-97,11,,293142816,28,703,293142788,293142816
20757,5,24,149,5745,-88,-97,9,,293142861,28,17,293142833,293142861
20758,5,24,149,5745,-88,-97,9,,293142994,32,101,293142962,293142994
20759,5,24,149,5745,-86,-97,11,,293143151,28,129,293143123,293143151
20760,5,24,149,5745,-87,-97,10,,293143195,28,16,293143167,293143195
20761,5,24,149,5745,-88,-97,9,,293143314,32,87,293143282,293143314
20762,5,24,149,5745,-90,-97,7,,293145860,28,2518,293145832,293145860
20763,5,24,149,5745,-85,-97,12,,293145904,28,16,293145876,293145904
20764,5,24,149,5745,-86,-97,11,,293146013,32,77,293145981,293146013
20765,5,12,149,5745,-55,-97,42,3e:d1:9b:c7:a4:de,293146430,272,145,293146158,293146430
20766,5,24,149,5745,-88,-97,9,,293147241,28,783,293147213,293147241
20767,5,24,149,5745,-87,-97,10,,293147285,28,16,293147257,293147285
20768,5,24,149,5745,-86,-97,11,,293147393,32,76,293147361,293147393
20769,5,24,149,5745,-87,-97,10,,293147650,28,229,293147622,293147650
20770,5,24,149,5745,-88,-97,9,,293147694,28,16,293147666,293147694
20771,5,24,149,5745,-88,-97,9,,293147802,32,76,293147770,293147802
20772,5,12,149,5745,-63,-97,34,5e:29:73:5b:30:00,293148230,272,156,293147958,293148230
20773,5,24,149,5745,-86,-97,11,,293148801,28,543,293148773,293148801
20774,5,24,149,5745,-87,-97,10,,293148910,32,77,293148878,293148910
20775,5,24,149,5745,-89,-97,8,,293149939,28,1001,293149911,293149939
20776,5,24,149,5745,-86,-97,11,,293149983,28,16,293149955,293149983
20777,5,24,149,5745,-86,-97,11,,293150115,32,100,293150083,293150115
20778,5,24,149,5745,-86,-97,11,,293153053,28,2910,293153025,293153053
20779,5,24,149,5745,-88,-97,9,,293153097,28,16,293153069,293153097
20780,5,24,149,5745,-88,-97,9,,293153205,32,76,293153173,293153205
20781,5,6,149,5745,-91,-97,6,54:e4:3a:ec:fb:65,293155264,360,1699,293154904,293155264
20782,5,24,149,5745,-86,-97,11,,293163949,28,8657,293163921,293163949
20783,5,24,149,5745,-88,-97,9,,293163993,28,16,293163965,293163993
20784,5,24,149,5745,-88,-97,9,,293164108,32,83,293164076,293164108
20785,5,12,149,5745,-68,-97,29,a6:92:ad:b7:76:65,293165092,484,500,293164608,293165092
20786,5,24,149,5745,-87,-97,10,,293165692,28,572,293165664,293165692
20787,5,24,149,5745,-87,-97,10,,293165736,28,16,293165708,293165736
20788,5,24,149,5745,-88,-97,9,,293165843,32,75,293165811,293165843
20789,5,24,149,5745,-88,-97,9,,293167398,28,1527,293167370,293167398
20790,5,24,149,5745,-86,-97,11,,293167443,28,17,293167415,293167443
20791,5,24,149,5745,-86,-97,11,,293167551,32,76,293167519,293167551
20792,5,24,149,5745,-89,-97,8,,293168808,28,1229,293168780,293168808
20793,5,24,149,5745,-86,-97,11,,293168852,28,16,293168824,293168852
20794,5,24,149,5745,-86,-97,11,,293168961,32,77,293168929,293168961
20795,5,12,149,5745,-73,-97,24,6a:1e:a4:f8:14:49,293169135,480,-306,293168655,293169135
20796,5,24,149,5745,-86,-97,11,,293171454,28,2291,293171426,293171454
20797,5,24,149,5745,-88,-97,9,,293171498,28,16,293171470,293171498
20798,5,24,149,5745,-87,-97,10,,293171606,32,76,293171574,293171606
20799,5,24,149,5745,-85,-97,12,,293174327,28,2693,293174299,293174327
20800,5,24,149,5745,-88,-97,9,,293174371,28,16,293174343,293174371
20801,5,24,149,5745,-88,-97,9,,293174479,32,76,293174447,293174479
20802,5,12,149,5745,-64,-97,33,b6:90:18:f6:b1:d4,293175877,268,1130,293175609,293175877
20803,5,12,149,5745,-56,-97,41,4a:86:35:36:74:b8,293176478,268,333,293176210,293176478
20804,5,12,149,5745,-66,-97,31,22:ec:75:a8:8a:31,293176789,244,67,293176545,293176789
20805,5,24,149,5745,-87,-97,10,,293178472,28,1655,293178444,293178472
20806,5,24,149,5745,-86,-97,11,,293178517,28,17,293178489,293178517
20807,5,24,149,5745,-86,-97,11,,293178629,32,80,293178597,293178629
20808,5,12,149,5745,-65,-97,32,b6:90:18:f6:b1:d4,293178722,268,-175,293178454,293178722
20809,5,12,149,5745,-70,-97,27,56:68:e2:c2:8d:d5,293192667,280,13665,293192387,293192667
20810,5,24,149,5745,-88,-97,9,,293199987,28,7292,293199959,293199987
20811,5,24,149,5745,-85,-97,12,,293200032,28,17,293200004,293200032
20812,5,24,149,5745,-86,-97,11,,293200140,32,76,293200108,293200140
20813,5,12,149,5745,-89,-97,8,42:d2:d9:2b:ac:61,293200251,256,-145,293199995,293200251
20814,5,24,149,5745,-86,-97,11,,293201419,28,1140,293201391,293201419
20815,5,24,149,5745,-86,-97,11,,293201527,32,76,293201495,293201527
20816,5,24,149,5745,-87,-97,10,,293202516,28,961,293202488,293202516
20817,5,24,149,5745,-85,-97,12,,293202560,28,16,293202532,293202560
20818,5,24,149,5745,-85,-97,12,,293202669,32,77,293202637,293202669
20819,5,12,149,5745,-67,-97,30,a6:92:ad:b7:76:65,293212365,284,9412,293212081,293212365
20820,5,24,149,5745,-85,-97,12,,293215462,28,3069,293215434,293215462
20821,5,24,149,5745,-87,-97,10,,293215506,28,16,293215478,293215506
20822,5,24,149,5745,-86,-97,11,,293215615,32,77,293215583,293215615
20823,5,24,149,5745,-86,-97,11,,293218233,28,2590,293218205,293218233
20824,5,24,149,5745,-87,-97,10,,293218277,28,16,293218249,293218277
20825,5,24,149,5745,-85,-97,12,,293223492,28,5187,293223464,293223492
20826,5,24,149,5745,-87,-97,10,,293223536,28,16,293223508,293223536
20827,5,24,149,5745,-87,-97,10,,293223643,32,75,293223611,293223643
20828,5,12,149,5745,-56,-97,41,4a:86:35:36:74:b8,293227760,268,3849,293227492,293227760
20829,5,24,149,5745,-87,-97,10,,293228095,28,307,293228067,293228095
20830,5,24,149,5745,-85,-97,12,,293228139,28,16,293228111,293228139
20831,5,12,149,5745,-70,-97,27,f2:da:61:dd:98:c5,293228170,268,-237,293227902,293228170
20832,5,12,149,5745,-67,-97,30,22:ec:75:a8:8a:31,293230482,516,1796,293229966,293230482
20833,5,12,149,5745,-66,-97,31,a6:92:ad:b7:76:65,293231041,484,75,293230557,293231041
20834,5,12,149,5745,-62,-97,35,0a:b9:b7:b1:4d:fa,293233570,268,2261,293233302,293233570
20835,5,12,149,5745,-70,-97,27,6a:1e:a4:f8:14:49,293234615,480,565,293234135,293234615
20836,5,12,149,5745,-56,-97,41,3e:d1:9b:c7:a4:de,293235165,544,6,293234621,293235165
20837,5,12,149,5745,-91,-97,6,7e:05:42:11:d2:ec,293239502,440,3897,293239062,293239502
20838,5,12,149,5745,-75,-97,22,d2:00:04:7e:2c:ab,293240004,440,62,293239564,293240004
20839,5,12,149,5745,-64,-97,33,b6:90:18:f6:b1:d4,293241388,268,1116,293241120,293241388
20840,5,12,149,5745,-70,-97,27,f2:da:61:dd:98:c5,293242689,268,1033,293242421,293242689
20841,5,12,149,5745,-57,-97,40,4a:86:35:36:74:b8,293243018,268,61,293242750,293243018
20842,5,12,149,5745,-69,-97,28,6a:1e:a4:f8:14:49,293244850,284,1548,293244566,293244850
20843,5,12,149,5745,-62,-97,35,5e:29:73:5b:30:00,293248211,540,2821,293247671,293248211
20844,5,24,149,5745,-87,-97,10,,293251542,28,3303,293251514,293251542
20845,5,24,149,5745,-83,-97,14,,293251586,28,16,293251558,293251586
20846,5,24,149,5745,-84,-97,13,,293251699,32,81,293251667,293251699
20847,5,24,149,5745,-85,-97,12,,293252034,28,307,293252006,293252034
20848,5,24,149,5745,-87,-97,10,,293252078,28,16,293252050,293252078
20849,5,24,149,5745,-87,-97,10,,293252193,32,83,293252161,293252193
20850,5,24,149,5745,-84,-97,13,,293254926,28,2705,293254898,293254926
20851,5,24,149,5745,-86,-97,11,,293254970,28,16,293254942,293254970
20852,5,24,149,5745,-86,-97,11,,293255078,32,76,293255046,293255078
20853,5,24,149,5745,-84,-97,13,,293255247,28,141,293255219,293255247
20854,5,24,149,5745,-86,-97,11,,293255291,28,16,293255263,293255291
20855,5,24,149,5745,-87,-97,10,,293255399,32,76,293255367,293255399
20856,5,6,149,5745,-88,-97,9,54:e4:3a:ec:fb:65,293257664,360,1905,293257304,293257664
20857,5,24,149,5745,-87,-97,10,,293258135,28,443,293258107,293258135
20858,5,24,149,5745,-84,-97,13,,293258179,28,16,293258151,293258179
20859,5,24,149,5745,-84,-97,13,,293258288,32,77,293258256,293258288
20860,5,12,149,5745,-63,-97,34,5e:29:73:5b:30:00,293261761,272,3201,293261489,293261761
20861,5,24,149,5745,-86,-97,11,,293262658,28,869,293262630,293262658
20862,5,24,149,5745,-83,-97,14,,293262702,28,16,293262674,293262702
20863,5,24,149,5745,-84,-97,13,,293262810,32,76,293262778,293262810
20864,5,24,149,5745,-84,-97,13,,293265268,28,2430,293265240,293265268
20865,5,24,149,5745,-86,-97,11,,293265313,28,17,293265285,293265313
20866,5,24,149,5745,-85,-97,12,,293265421,32,76,293265389,293265421
20867,5,12,149,5745,-89,-97,8,9a:24:38:da:96:bb,293272208,272,6515,293271936,293272208
20868,5,24,149,5745,-83,-97,14,,293273819,28,1583,293273791,293273819
20869,5,24,149,5745,-85,-97,12,,293273863,28,16,293273835,293273863
20870,5,24,149,5745,-85,-97,12,,293273971,32,76,293273939,293273971
20871,5,24,149,5745,-84,-97,13,,293274083,32,80,293274051,293274083
20872,5,24,149,5745,-83,-97,14,,293276867,28,2756,293276839,293276867
20873,5,24,149,5745,-85,-97,12,,293276911,28,16,293276883,293276911
20874,5,24,149,5745,-86,-97,11,,293277020,32,77,293276988,293277020
20875,5,12,149,5745,-55,-97,42,3e:d1:9b:c7:a4:de,293277488,272,196,293277216,293277488
20876,5,24,149,5745,-85,-97,12,,293278403,28,887,293278375,293278403
20877,5,24,149,5745,-84,-97,13,,293278448,28,17,293278420,293278448
20878,5,24,149,5745,-83,-97,14,,293278556,32,76,293278524,293278556
20879,5,24,149,5745,-84,-97,13,,293281779,28,3195,293281751,293281779
20880,5,24,149,5745,-83,-97,14,,293281823,28,16,293281795,293281823
20881,5,24,149,5745,-83,-97,14,,293281932,32,77,293281900,293281932
20882,5,12,149,5745,-70,-97,27,72:d1:72:1d:22:a1,293282385,284,169,293282101,293282385
20883,5,12,149,5745,-69,-97,28,22:ec:75:a8:8a:31,293289535,244,6906,293289291,293289535
20884,5,12,149,5745,-63,-97,34,b6:90:18:f6:b1:d4,293303822,268,14019,293303554,293303822
20885,5,24,149,5745,-84,-97,13,,293309717,28,5867,293309689,293309717
20886,5,24,149,5745,-84,-97,13,,293309761,28,16,293309733,293309761
20887,5,24,149,5745,-83,-97,14,,293309869,32,76,293309837,293309869
20888,5,12,149,5745,-88,-97,9,42:d2:d9:2b:ac:61,293310847,256,722,293310591,293310847
20889,5,24,149,5745,-84,-97,13,,293315329,28,4454,293315301,293315329
20890,5,24,149,5745,-83,-97,14,,293315373,28,16,293315345,293315373
20891,5,24,149,5745,-83,-97,14,,293315492,32,87,293315460,293315492
20892,5,24,149,5745,-84,-97,13,,293318442,28,2922,293318414,293318442
20893,5,24,149,5745,-83,-97,14,,293318486,28,16,293318458,293318486
20894,5,24,149,5745,-84,-97,13,,293318594,32,76,293318562,293318594
20895,5,24,149,5745,-83,-97,14,,293318706,32,80,293318674,293318706
20896,5,24,149,5745,-84,-97,13,,293318977,28,243,293318949,293318977
20897,5,24,149,5745,-84,-97,13,,293319021,28,16,293318993,293319021
20898,5,24,149,5745,-85,-97,12,,293319129,32,76,293319097,293319129
20899,5,24,149,5745,-84,-97,13,,293322193,28,3036,293322165,293322193
20900,5,24,149,5745,-84,-97,13,,293322237,28,16,293322209,293322237
20901,5,24,149,5745,-84,-97,13,,293322346,32,77,293322314,293322346
20902,5,24,149,5745,-85,-97,12,,293328352,28,5978,293328324,293328352
20903,5,24,149,5745,-83,-97,14,,293328396,28,16,293328368,293328396
20904,5,24,149,5745,-83,-97,14,,293328505,32,77,293328473,293328505
20905,5,12,149,5745,-69,-97,28,a6:92:ad:b7:76:65,293332370,284,3581,293332086,293332370
20906,5,12,149,5745,-57,-97,40,4a:86:35:36:74:b8,293353820,268,21182,293353552,293353820
20907,5,12,149,5745,-69,-97,28,f2:da:61:dd:98:c5,293354620,268,532,293354352,293354620
20908,5,24,149,5745,-86,-97,11,,293358465,28,3817,293358437,293358465
20909,5,24,149,5745,-85,-97,12,,293358509,28,16,293358481,293358509
20910,5,24,149,5745,-84,-97,13,,293358617,32,76,293358585,293358617
20911,5,6,149,5745,-89,-97,8,54:e4:3a:ec:fb:65,293360065,360,1088,293359705,293360065
20912,5,12,149,5745,-64,-97,33,5e:29:73:5b:30:00,293362687,272,2350,293362415,293362687
20913,5,12,149,5745,-69,-97,28,6a:1e:a4:f8:14:49,293367719,284,4748,293367435,293367719
20914,5,12,149,5745,-53,-97,44,3e:d1:9b:c7:a4:de,293369318,272,1327,293369046,293369318
20915,5,24,149,5745,-85,-97,12,,293369741,28,395,293369713,293369741
20916,5,24,149,5745,-85,-97,12,,293369785,28,16,293369757,293369785
20917,5,24,149,5745,-85,-97,12,,293369894,32,77,293369862,293369894
20918,5,12,149,5745,-68,-97,29,72:d1:72:1d:22:a1,293384922,284,14744,293384638,293384922
20919,5,12,149,5745,-71,-97,26,56:68:e2:c2:8d:d5,293385241,280,39,293384961,293385241
20920,5,24,149,5745,-85,-97,12,,293387612,28,2343,293387584,293387612
20921,5,24,149,5745,-85,-97,12,,293387657,28,17,293387629,293387657
20922,5,24,149,5745,-85,-97,12,,293387764,32,75,293387732,293387764
20923,5,12,149,5745,-67,-97,30,22:ec:75:a8:8a:31,293406663,244,18655,293406419,293406663
20924,5,24,149,5745,-85,-97,12,,293412795,28,6104,293412767,293412795
20925,5,24,149,5745,-84,-97,13,,293412838,28,15,293412810,293412838
20926,5,24,149,5745,-85,-97,12,,293412947,32,77,293412915,293412947
20927,5,24,149,5745,-85,-97,12,,293413895,28,920,293413867,293413895
20928,5,24,149,5745,-84,-97,13,,293413939,28,16,293413911,293413939
20929,5,24,149,5745,-84,-97,13,,293414048,32,77,293414016,293414048
20930,5,12,149,5745,-87,-97,10,42:d2:d9:2b:ac:61,293425386,256,11082,293425130,293425386
20931,5,24,149,5745,-85,-97,12,,293428140,28,2726,293428112,293428140
20932,5,24,149,5745,-86,-97,11,,293428184,28,16,293428156,293428184
20933,5,24,149,5745,-86,-97,11,,293428292,32,76,293428260,293428292
20934,5,12,149,5745,-90,-97,7,7e:05:42:11:d2:ec,293436568,440,7836,293436128,293436568
20935,5,12,149,5745,-65,-97,32,f6:0a:5c:59:72:df,293438088,280,1240,293437808,293438088
20936,5,24,149,5745,-86,-97,11,,293461784,28,23668,293461756,293461784
20937,5,24,149,5745,-84,-97,13,,293461828,28,16,293461800,293461828
20938,5,24,149,5745,-85,-97,12,,293461937,32,77,293461905,293461937
20939,5,6,149,5745,-84,-97,13,54:e4:3a:ec:fb:65,293462466,360,169,293462106,293462466
20940,5,24,149,5745,-85,-97,12,,293466387,28,3893,293466359,293466387
20941,5,24,149,5745,-86,-97,11,,293466431,28,16,293466403,293466431
20942,5,24,149,5745,-86,-97,11,,293466543,32,80,293466511,293466543
20943,5,12,149,5745,-72,-97,25,f2:da:61:dd:98:c5,293467525,268,714,293467257,293467525
20944,5,12,149,5745,-53,-97,44,4a:86:35:36:74:b8,293468865,268,1072,293468597,293468865
20945,5,24,149,5745,-87,-97,10,,293469267,28,374,293469239,293469267
20946,5,24,149,5745,-84,-97,13,,293469311,28,16,293469283,293469311
20947,5,24,149,5745,-86,-97,11,,293469423,32,80,293469391,293469423
20948,5,24,149,5745,-85,-97,12,,293469517,28,66,293469489,293469517
20949,5,24,149,5745,-86,-97,11,,293469561,28,16,293469533,293469561
20950,5,24,149,5745,-86,-97,11,,293469669,32,76,293469637,293469669
20951,5,24,149,5745,-85,-97,12,,293469843,28,146,293469815,293469843
20952,5,24,149,5745,-86,-97,11,,293469887,28,16,293469859,293469887
20953,5,24,149,5745,-86,-97,11,,293469995,32,76,293469963,293469995
20954,5,12,149,5745,-66,-97,31,5e:29:73:5b:30:00,293474692,272,4425,293474420,293474692
20955,5,24,149,5745,-87,-97,10,,293482310,28,7590,293482282,293482310
20956,5,24,149,5745,-84,-97,13,,293482354,28,16,293482326,293482354
20957,5,24,149,5745,-85,-97,12,,293482462,32,76,293482430,293482462
20958,5,24,149,5745,-84,-97,13,,293483877,28,1387,293483849,293483877
20959,5,24,149,5745,-85,-97,12,,293483921,28,16,293483893,293483921
20960,5,24,149,5745,-85,-97,12,,293484029,32,76,293483997,293484029
20961,5,12,149,5745,-67,-97,30,a6:92:ad:b7:76:65,293484929,284,616,293484645,293484929
20962,5,12,149,5745,-64,-97,33,b6:90:18:f6:b1:d4,293486442,268,1245,293486174,293486442
20963,5,12,149,5745,-50,-97,47,3e:d1:9b:c7:a4:de,293487266,272,552,293486994,293487266
20964,5,12,149,5745,-70,-97,27,56:68:e2:c2:8d:d5,293489207,280,1661,293488927,293489207
20965,5,12,149,5745,-83,-97,14,9a:24:38:da:96:bb,293500436,272,10957,293500164,293500436
20966,5,24,149,5745,-85,-97,12,,293514957,28,14493,293514929,293514957
20967,5,24,149,5745,-84,-97,13,,293515002,28,17,293514974,293515002
20968,5,24,149,5745,-84,-97,13,,293515110,32,76,293515078,293515110
20969,5,12,149,5745,-69,-97,28,22:ec:75:a8:8a:31,293523475,244,8121,293523231,293523475
20970,5,12,149,5745,-84,-97,13,42:d2:d9:2b:ac:61,293539048,256,15317,293538792,293539048
20971,5,24,149,5745,-84,-97,13,,293559839,28,20763,293559811,293559839
20972,5,24,149,5745,-85,-97,12,,293559883,28,16,293559855,293559883
20973,5,24,149,5745,-85,-97,12,,293559992,32,77,293559960,293559992
20974,5,12,149,5745,-73,-97,24,6a:1e:a4:f8:14:49,293561479,284,1203,293561195,293561479
20975,5,6,149,5745,-87,-97,10,54:e4:3a:ec:fb:65,293564866,360,3027,293564506,293564866
20976,5,24,149,5745,-85,-97,12,,293574073,28,9179,293574045,293574073
20977,5,24,149,5745,-84,-97,13,,293574117,28,16,293574089,293574117
20978,5,24,149,5745,-84,-97,13,,293574225,32,76,293574193,293574225
20979,5,12,149,5745,-71,-97,26,f2:da:61:dd:98:c5,293577882,268,3389,293577614,293577882
20980,5,12,149,5745,-52,-97,45,4a:86:35:36:74:b8,293578677,268,527,293578409,293578677
20981,5,12,149,5745,-66,-97,31,a6:92:ad:b7:76:65,293587500,284,8539,293587216,293587500
20982,5,12,149,5745,-65,-97,32,5e:29:73:5b:30:00,293589133,272,1361,293588861,293589133
20983,5,12,149,5745,-65,-97,32,b6:90:18:f6:b1:d4,293589566,268,165,293589298,293589566
20984,5,12,149,5745,-73,-97,24,72:d1:72:1d:22:a1,293589869,284,19,293589585,293589869
20985,5,12,149,5745,-68,-97,29,56:68:e2:c2:8d:d5,293590418,280,269,293590138,293590418
20986,5,24,149,5745,-84,-97,13,,293602828,28,12382,293602800,293602828
20987,5,24,149,5745,-87,-97,10,,293602872,28,16,293602844,293602872
20988,5,24,149,5745,-86,-97,11,,293602981,32,77,293602949,293602981
20989,5,12,149,5745,-54,-97,43,3e:d1:9b:c7:a4:de,293604728,272,1475,293604456,293604728
20990,5,24,149,5745,-87,-97,10,,293608044,32,3284,293608012,293608044
20991,5,24,149,5745,-87,-97,10,,293608508,32,432,293608476,293608508
20992,5,24,149,5745,-88,-97,9,,293608972,28,436,293608944,293608972
20993,5,24,149,5745,-70,-97,27,,293609016,28,16,293608988,293609016
20994,5,24,149,5745,-88,-97,9,,293613520,28,4476,293613492,293613520
20995,5,24,149,5745,-83,-97,14,,293613564,28,16,293613536,293613564
20996,5,24,149,5745,-83,-97,14,,293613675,32,79,293613643,293613675
20997,5,24,149,5745,-84,-97,13,,293616883,28,3180,293616855,293616883
20998,5,24,149,5745,-88,-97,9,,293616927,28,16,293616899,293616927
20999,5,24,149,5745,-88,-97,9,,293617035,32,76,293617003,293617035
21000,5,24,149,5745,-87,-97,10,,293617932,28,869,293617904,293617932
21001,5,24,149,5745,-83,-97,14,,293617976,28,16,293617948,293617976
21002,5,24,149,5745,-83,-97,14,,293618084,32,76,293618052,293618084
21003,5,24,149,5745,-83,-97,14,,293618196,32,80,293618164,293618196
21004,5,24,149,5745,-83,-97,14,,293621087,28,2863,293621059,293621087
21005,5,24,149,5745,-87,-97,10,,293621131,28,16,293621103,293621131
21006,5,24,149,5745,-87,-97,10,,293621240,32,77,293621208,293621240
21007,5,24,149,5745,-83,-97,14,,293624210,28,2942,293624182,293624210
21008,5,24,149,5745,-87,-97,10,,293624255,28,17,293624227,293624255
21009,5,24,149,5745,-88,-97,9,,293624363,32,76,293624331,293624363
21010,5,12,149,5745,-66,-97,31,22:ec:75:a8:8a:31,293635572,244,10965,293635328,293635572
21011,5,12,149,5745,-65,-97,32,b6:90:18:f6:b1:d4,293635851,268,11,293635583,293635851
21012,5,24,149,5745,-88,-97,9,,293642850,28,6971,293642822,293642850
21013,5,24,149,5745,-84,-97,13,,293642894,28,16,293642866,293642894
21014,5,24,149,5745,-84,-97,13,,293643002,32,76,293642970,293643002
21015,5,12,149,5745,-68,-97,29,56:68:e2:c2:8d:d5,293646608,280,3326,293646328,293646608
21016,5,6,149,5745,-66,-97,31,,293652161,52,5501,293652109,293652161
21017,5,6,149,5745,-87,-97,10,,293652229,44,24,293652185,293652229
21018,5,24,149,5745,-88,-97,9,,293652347,28,90,293652319,293652347
21019,5,6,149,5745,-67,-97,30,,293652704,52,305,293652652,293652704
21020,5,6,149,5745,-88,-97,9,,293652771,44,23,293652727,293652771
21021,5,24,149,5745,-87,-97,10,,293652890,28,91,293652862,293652890
21022,5,12,149,5745,-84,-97,13,42:d2:d9:2b:ac:61,293653014,256,-132,293652758,293653014
21023,5,24,149,5745,-87,-97,10,,293655655,28,2613,293655627,293655655
21024,5,24,149,5745,-84,-97,13,,293655699,28,16,293655671,293655699
21025,5,24,149,5745,-84,-97,13,,293655807,32,76,293655775,293655807
21026,5,12,149,5745,-69,-97,28,6a:1e:a4:f8:14:49,293663233,284,7142,293662949,293663233
21027,5,24,149,5745,-89,-97,8,,293665340,28,2079,293665312,293665340
21028,5,24,149,5745,-84,-97,13,,293665385,28,17,293665357,293665385
21029,5,24,149,5745,-84,-97,13,,293665492,32,75,293665460,293665492
21030,5,24,149,5745,-88,-97,9,,293665665,28,145,293665637,293665665
21031,5,24,149,5745,-83,-97,14,,293665710,28,17,293665682,293665710
21032,5,24,149,5745,-84,-97,13,,293665817,32,75,293665785,293665817
21033,5,6,149,5745,-88,-97,9,54:e4:3a:ec:fb:65,293667267,360,1090,293666907,293667267
21034,5,12,149,5745,-66,-97,31,a6:92:ad:b7:76:65,293672043,284,4492,293671759,293672043
21035,5,12,149,5745,-70,-97,27,72:d1:72:1d:22:a1,293686363,284,14036,293686079,293686363
21036,5,12,149,5745,-67,-97,30,22:ec:75:a8:8a:31,293686690,516,-189,293686174,293686690
21037,5,12,149,5745,-53,-97,44,4a:86:35:36:74:b8,293687278,268,320,293687010,293687278
21038,5,12,149,5745,-71,-97,26,f2:da:61:dd:98:c5,293687634,268,88,293687366,293687634
21039,5,12,149,5745,-68,-97,29,56:68:e2:c2:8d:d5,293688158,476,48,293687682,293688158
21040,5,12,149,5745,-67,-97,30,a6:92:ad:b7:76:65,293691378,484,2736,293690894,293691378
21041,5,12,149,5745,-53,-97,44,3e:d1:9b:c7:a4:de,293691915,544,-7,293691371,293691915
21042,5,12,149,5745,-84,-97,13,42:d2:d9:2b:ac:61,293692512,452,145,293692060,293692512
21043,5,12,149,5745,-69,-97,28,6a:1e:a4:f8:14:49,293693610,480,618,293693130,293693610
21044,5,12,149,5745,-69,-97,28,f2:da:61:dd:98:c5,293701029,268,7151,293700761,293701029
21045,5,12,149,5745,-53,-97,44,4a:86:35:36:74:b8,293702240,268,943,293701972,293702240
21046,5,12,149,5745,-65,-97,32,b6:90:18:f6:b1:d4,293702732,268,224,293702464,293702732
21047,5,12,149,5745,-71,-97,26,6a:1e:a4:f8:14:49,293703682,284,666,293703398,293703682
21048,5,12,149,5745,-71,-97,26,72:d1:72:1d:22:a1,293704064,480,-98,293703584,293704064
21049,5,12,149,5745,-65,-97,32,5e:29:73:5b:30:00,293704614,540,10,293704074,293704614
21050,5,12,149,5745,-68,-97,29,f6:0a:5c:59:72:df,293708732,476,3642,293708256,293708732
21051,5,24,149,5745,-87,-97,10,,293714553,28,5793,293714525,293714553
21052,5,24,149,5745,-84,-97,13,,293714597,28,16,293714569,293714597
21053,5,24,149,5745,-85,-97,12,,293714705,32,76,293714673,293714705
21054,5,24,149,5745,-86,-97,11,,293714818,28,85,293714790,293714818
21055,5,24,149,5745,-87,-97,10,,293714862,28,16,293714834,293714862
21056,5,24,149,5745,-86,-97,11,,293714970,32,76,293714938,293714970
21057,5,24,149,5745,-84,-97,13,,293716879,28,1881,293716851,293716879
21058,5,24,149,5745,-87,-97,10,,293716923,28,16,293716895,293716923
21059,5,24,149,5745,-87,-97,10,,293717031,32,76,293716999,293717031
21060,5,12,149,5745,-90,-97,7,9a:24:38:da:96:bb,293719849,272,2546,293719577,293719849
21061,5,12,149,5745,-64,-97,33,5e:29:73:5b:30:00,293720503,272,382,293720231,293720503
21062,5,12,149,5745,-64,-97,33,b6:90:18:f6:b1:d4,293735218,268,14447,293734950,293735218
21063,5,12,149,5745,-53,-97,44,3e:d1:9b:c7:a4:de,293735736,272,246,293735464,293735736
21064,5,12,149,5745,-64,-97,33,22:ec:75:a8:8a:31,293752272,516,16020,293751756,293752272
21065,5,12,149,5745,-68,-97,29,56:68:e2:c2:8d:d5,293752849,280,297,293752569,293752849
21066,5,12,149,5745,-68,-97,29,56:68:e2:c2:8d:d5,293753776,476,451,293753300,293753776
21067,5,12,149,5745,-66,-97,31,a6:92:ad:b7:76:65,293755738,484,1478,293755254,293755738
21068,5,12,149,5745,-68,-97,29,f6:0a:5c:59:72:df,293756826,280,808,293756546,293756826
21069,5,12,149,5745,-54,-97,43,3e:d1:9b:c7:a4:de,293757149,544,-221,293756605,293757149
21070,5,12,149,5745,-82,-97,15,42:d2:d9:2b:ac:61,293758300,452,699,293757848,293758300
21071,5,12,149,5745,-60,-97,37,0a:b9:b7:b1:4d:fa,293758795,268,227,293758527,293758795
21072,5,12,149,5745,-73,-97,24,6a:1e:a4:f8:14:49,293759232,480,-43,293758752,293759232
21073,5,12,149,5745,-90,-97,7,7e:05:42:11:d2:ec,293761537,440,1865,293761097,293761537
21074,5,12,149,5745,-90,-97,7,7e:05:42:11:d2:ec,293762029,360,132,293761669,293762029
21075,5,12,149,5745,-68,-97,29,f2:da:61:dd:98:c5,293765013,268,2716,293764745,293765013
21076,5,12,149,5745,-64,-97,33,b6:90:18:f6:b1:d4,293765954,268,673,293765686,293765954
21077,5,12,149,5745,-55,-97,42,4a:86:35:36:74:b8,293766258,268,36,293765990,293766258
21078,5,12,149,5745,-64,-97,33,22:ec:75:a8:8a:31,293767191,244,689,293766947,293767191
21079,5,12,149,5745,-70,-97,27,72:d1:72:1d:22:a1,293767471,480,-200,293766991,293767471
21080,5,12,149,5745,-65,-97,32,5e:29:73:5b:30:00,293769281,540,1270,293768741,293769281
21081,5,12,149,5745,-65,-97,32,a6:92:ad:b7:76:65,293769864,284,299,293769580,293769864
21082,5,12,149,5745,-69,-97,28,f6:0a:5c:59:72:df,293772695,476,2355,293772219,293772695
21083,5,24,149,5745,-85,-97,12,,293775173,28,2450,293775145,293775173
21084,5,24,149,5745,-87,-97,10,,293775217,28,16,293775189,293775217
21085,5,24,149,5745,-87,-97,10,,293775326,32,77,293775294,293775326
21086,5,24,149,5745,-88,-97,9,,293789998,28,14644,293789970,293789998
21087,5,24,149,5745,-84,-97,13,,293790042,28,16,293790014,293790042
21088,5,24,149,5745,-86,-97,11,,293790150,32,76,293790118,293790150
21089,5,12,149,5745,-56,-97,41,4a:86:35:36:74:b8,293801772,268,11354,293801504,293801772
21090,5,12,149,5745,-72,-97,25,72:d1:72:1d:22:a1,293802076,284,20,293801792,293802076
21091,5,12,149,5745,-70,-97,27,f2:da:61:dd:98:c5,293802393,268,49,293802125,293802393
21092,5,12,149,5745,-68,-97,29,5e:29:73:5b:30:00,293813924,272,11259,293813652,293813924
21093,5,24,149,5745,-84,-97,13,,293820831,28,6879,293820803,293820831
21094,5,24,149,5745,-86,-97,11,,293820875,28,16,293820847,293820875
21095,5,24,149,5745,-86,-97,11,,293820983,32,76,293820951,293820983
21096,5,24,149,5745,-87,-97,10,,293825586,28,4575,293825558,293825586
21097,5,24,149,5745,-86,-97,11,,293825631,28,17,293825603,293825631
21098,5,24,149,5745,-85,-97,12,,293825742,32,79,293825710,293825742
21099,5,24,149,5745,-87,-97,10,,293829251,28,3481,293829223,293829251
21100,5,24,149,5745,-85,-97,12,,293829295,28,16,293829267,293829295
21101,5,24,149,5745,-85,-97,12,,293829403,32,76,293829371,293829403
21102,5,24,149,5745,-85,-97,12,,293829515,32,80,293829483,293829515
21103,5,12,149,5745,-71,-97,26,6a:1e:a4:f8:14:49,293831297,284,1498,293831013,293831297
21104,5,12,149,5745,-55,-97,42,3e:d1:9b:c7:a4:de,293831817,272,248,293831545,293831817
21105,5,12,149,5745,-90,-97,7,9a:24:38:da:96:bb,293833514,272,1425,293833242,293833514
21106,5,24,149,5745,-84,-97,13,,293839157,28,5615,293839129,293839157
21107,5,24,149,5745,-87,-97,10,,293839202,28,17,293839174,293839202
21108,5,24,149,5745,-85,-97,12,,293839309,32,75,293839277,293839309
21109,5,24,149,5745,-85,-97,12,,293840300,28,963,293840272,293840300
21110,5,24,149,5745,-87,-97,10,,293840344,28,16,293840316,293840344
21111,5,24,149,5745,-87,-97,10,,293840452,32,76,293840420,293840452
21112,5,12,149,5745,-67,-97,30,b6:90:18:f6:b1:d4,293861454,268,20734,293861186,293861454
21113,5,12,149,5745,-64,-97,33,22:ec:75:a8:8a:31,293865342,244,3644,293865098,293865342
21114,5,12,149,5745,-68,-97,29,56:68:e2:c2:8d:d5,293871636,280,6014,293871356,293871636
21115,5,6,149,5745,-88,-97,9,54:e4:3a:ec:fb:65,293872068,360,72,293871708,293872068
21116,5,24,149,5745,-85,-97,12,,293878941,28,6845,293878913,293878941
21117,5,24,149,5745,-84,-97,13,,293878985,28,16,293878957,293878985
21118,5,24,149,5745,-85,-97,12,,293879093,32,76,293879061,293879093
21119,5,12,149,5745,-85,-97,12,42:d2:d9:2b:ac:61,293879192,256,-157,293878936,293879192
21120,5,12,149,5745,-72,-97,25,f6:0a:5c:59:72:df,293885613,280,6141,293885333,293885613
21121,5,12,149,5745,-65,-97,32,a6:92:ad:b7:76:65,293895836,284,9939,293895552,293895836
21122,5,6,149,5745,-68,-97,29,,293928275,52,32387,293928223,293928275
21123,5,6,149,5745,-85,-97,12,,293928343,44,24,293928299,293928343
21124,5,24,149,5745,-85,-97,12,,293928461,28,90,293928433,293928461
21125,5,6,149,5745,-69,-97,28,,293928595,52,82,293928543,293928595
21126,5,6,149,5745,-85,-97,12,,293928663,44,24,293928619,293928663
21127,5,24,149,5745,-85,-97,12,,293928793,32,98,293928761,293928793
21128,5,6,149,5745,-69,-97,28,,293928905,52,60,293928853,293928905
21129,5,6,149,5745,-85,-97,12,,293928973,44,24,293928929,293928973
21130,5,24,149,5745,-86,-97,11,,293929103,32,98,293929071,293929103
21131,5,6,149,5745,-68,-97,29,,293929244,52,89,293929192,293929244
21132,5,6,149,5745,-85,-97,12,,293929312,44,24,293929268,293929312
21133,5,24,149,5745,-85,-97,12,,293929438,32,94,293929406,293929438
21134,5,12,149,5745,-65,-97,32,5e:29:73:5b:30:00,293931161,272,1451,293930889,293931161
21135,5,12,149,5745,-51,-97,46,3e:d1:9b:c7:a4:de,293949058,272,17625,293948786,293949058
21136,5,12,149,5745,-89,-97,8,7e:05:42:11:d2:ec,293958900,440,9402,293958460,293958900
21137,5,12,149,5745,-86,-97,11,9a:24:38:da:96:bb,293964723,272,5551,293964451,293964723
21138,5,12,149,5745,-70,-97,27,6a:1e:a4:f8:14:49,293971549,284,6542,293971265,293971549
21139,5,6,149,5745,-88,-97,9,54:e4:3a:ec:fb:65,293974468,360,2559,293974108,293974468
21140,5,12,149,5745,-53,-97,44,4a:86:35:36:74:b8,293975538,268,802,293975270,293975538
21141,5,12,149,5745,-70,-97,27,f2:da:61:dd:98:c5,293975973,268,167,293975705,293975973
21142,5,24,149,5745,-86,-97,11,,293977888,32,1883,293977856,293977888
21143,5,24,149,5745,-86,-97,11,,293978442,32,522,293978410,293978442
21144,5,24,149,5745,-87,-97,10,,293978995,28,525,293978967,293978995
21145,5,24,149,5745,-86,-97,11,,293979317,28,294,293979289,293979317
21146,5,24,149,5745,-87,-97,10,,293981028,28,1683,293981000,293981028
21147,5,24,149,5745,-71,-97,26,,293981072,28,16,293981044,293981072
21148,5,12,149,5745,-67,-97,30,22:ec:75:a8:8a:31,293981249,244,-67,293981005,293981249
21149,5,24,149,5745,-85,-97,12,,293984929,28,3652,293984901,293984929
21150,5,24,149,5745,-85,-97,12,,293987427,28,2470,293987399,293987427
21151,5,24,149,5745,-86,-97,11,,293996652,28,9197,293996624,293996652
21152,5,12,149,5745,-69,-97,28,72:d1:72:1d:22:a1,293999073,284,2137,293998789,293999073
21153,5,12,149,5745,-69,-97,28,b6:90:18:f6:b1:d4,293999387,268,46,293999119,293999387
21154,5,12,149,5745,-66,-97,31,56:68:e2:c2:8d:d5,294001165,280,1498,294000885,294001165
21155,5,12,149,5745,-70,-97,27,a6:92:ad:b7:76:65,294009567,284,8118,294009283,294009567
21156,5,12,149,5745,-84,-97,13,42:d2:d9:2b:ac:61,294012307,256,2484,294012051,294012307
21157,5,12,149,5745,-90,-97,7,1a:a8:50:6a:aa:97,294031372,244,18821,294031128,294031372
21158,5,12,149,5745,-65,-97,32,5e:29:73:5b:30:00,294048195,272,16551,294047923,294048195
21159,5,12,149,5745,-85,-97,12,9a:24:38:da:96:bb,294057042,272,8575,294056770,294057042
21160,5,12,149,5745,-52,-97,45,3e:d1:9b:c7:a4:de,294060960,272,3646,294060688,294060960
21161,5,24,149,5745,-70,-97,27,,294065979,28,4991,294065951,294065979
21162,5,24,149,5745,-85,-97,12,,294066023,28,16,294065995,294066023
21163,5,24,149,5745,-85,-97,12,,294066131,28,80,294066103,294066131
21164,5,24,149,5745,-86,-97,11,,294070865,32,4702,294070833,294070865
21165,5,24,149,5745,-85,-97,12,,294071392,32,495,294071360,294071392
21166,5,24,149,5745,-85,-97,12,,294071918,28,498,294071890,294071918
21167,5,12,149,5745,-55,-97,42,2a:07:ef:54:b5:55,294075553,380,3255,294075173,294075553
21168,5,6,149,5745,-86,-97,11,54:e4:3a:ec:fb:65,294076869,360,956,294076509,294076869
21169,5,12,149,5745,-56,-97,41,4a:86:35:36:74:b8,294078370,268,1233,294078102,294078370
21170,5,12,149,5745,-72,-97,25,f2:da:61:dd:98:c5,294078896,268,258,294078628,294078896
21171,5,24,149,5745,-84,-97,13,,294080620,28,1696,294080592,294080620
21172,5,24,149,5745,-70,-97,27,,294080664,28,16,294080636,294080664
21173,5,12,149,5745,-67,-97,30,22:ec:75:a8:8a:31,294098122,244,17214,294097878,294098122
21174,5,12,149,5745,-69,-97,28,b6:90:18:f6:b1:d4,294101491,268,3101,294101223,294101491
21175,5,12,149,5745,-69,-97,28,72:d1:72:1d:22:a1,294101803,284,28,294101519,294101803
21176,5,12,149,5745,-66,-97,31,56:68:e2:c2:8d:d5,294102185,280,102,294101905,294102185
21177,5,12,149,5745,-83,-97,14,42:d2:d9:2b:ac:61,294114739,256,12298,294114483,294114739
21178,5,12,149,5745,-70,-97,27,a6:92:ad:b7:76:65,294116054,284,1031,294115770,294116054
21179,5,12,149,5745,-66,-97,31,72:d1:72:1d:22:a1,294145095,284,28757,294144811,294145095
21180,5,12,149,5745,-57,-97,40,4a:86:35:36:74:b8,294145415,268,52,294145147,294145415
21181,5,12,149,5745,-56,-97,41,2a:07:ef:54:b5:55,294145746,244,87,294145502,294145746
21182,5,12,149,5745,-71,-97,26,f2:da:61:dd:98:c5,294146070,268,56,294145802,294146070
21183,5,12,149,5745,-64,-97,33,6a:1e:a4:f8:14:49,294146381,284,27,294146097,294146381
21184,5,12,149,5745,-89,-97,8,9a:24:38:da:96:bb,294146821,824,-384,294145997,294146821
21185,5,12,149,5745,-66,-97,31,22:ec:75:a8:8a:31,294147842,516,505,294147326,294147842
21186,5,12,149,5745,-66,-97,31,a6:92:ad:b7:76:65,294148698,484,372,294148214,294148698
21187,5,12,149,5745,-66,-97,31,56:68:e2:c2:8d:d5,294150899,476,1725,294150423,294150899
21188,5,12,149,5745,-54,-97,43,3e:d1:9b:c7:a4:de,294152344,544,901,294151800,294152344
21189,5,12,149,5745,-63,-97,34,6a:1e:a4:f8:14:49,294154613,480,1789,294154133,294154613
21190,5,12,149,5745,-67,-97,30,b6:90:18:f6:b1:d4,294158814,268,3933,294158546,294158814
21191,5,12,149,5745,-70,-97,27,f2:da:61:dd:98:c5,294160010,268,928,294159742,294160010
21192,5,12,149,5745,-64,-97,33,72:d1:72:1d:22:a1,294160312,480,-178,294159832,294160312
21193,5,12,149,5745,-57,-97,40,4a:86:35:36:74:b8,294161743,268,1163,294161475,294161743
21194,5,12,149,5745,-62,-97,35,5e:29:73:5b:30:00,294164937,540,2654,294164397,294164937
21195,5,12,149,5745,-66,-97,31,f6:0a:5c:59:72:df,294166879,476,1466,294166403,294166879
21196,5,12,149,5745,-85,-97,12,9a:24:38:da:96:bb,294167794,272,643,294167522,294167794
21197,5,12,149,5745,-58,-97,39,2a:07:ef:54:b5:55,294168496,440,262,294168056,294168496
21198,5,12,149,5745,-62,-97,35,5e:29:73:5b:30:00,294179246,272,10478,294178974,294179246
21199,5,6,149,5745,-88,-97,9,54:e4:3a:ec:fb:65,294179629,360,23,294179269,294179629
21200,5,12,149,5745,-67,-97,30,b6:90:18:f6:b1:d4,294193855,268,13958,294193587,294193855
21201,5,12,149,5745,-58,-97,39,3e:d1:9b:c7:a4:de,294195075,272,948,294194803,294195075
21202,5,12,149,5745,-69,-97,28,56:68:e2:c2:8d:d5,294195435,280,80,294195155,294195435
21203,5,12,149,5745,-67,-97,30,22:ec:75:a8:8a:31,294211283,244,15604,294211039,294211283
21204,5,12,149,5745,-69,-97,28,6a:1e:a4:f8:14:49,294217658,480,5895,294217178,294217658
21205,5,12,149,5745,-86,-97,11,42:d2:d9:2b:ac:61,294223864,256,5950,294223608,294223864
21206,5,12,149,5745,-64,-97,33,b6:90:18:f6:b1:d4,294224415,268,283,294224147,294224415
21207,5,12,149,5745,-58,-97,39,4a:86:35:36:74:b8,294225070,268,387,294224802,294225070
21208,5,12,149,5745,-66,-97,31,f6:0a:5c:59:72:df,294225770,280,420,294225490,294225770
21209,5,12,149,5745,-67,-97,30,a6:92:ad:b7:76:65,294228052,284,1998,294227768,294228052
21210,5,12,149,5745,-67,-97,30,a6:92:ad:b7:76:65,294230477,484,1941,294229993,294230477
21211,5,12,149,5745,-57,-97,40,2a:07:ef:54:b5:55,294234145,440,3228,294233705,294234145
21212,5,12,149,5745,-59,-97,38,4a:86:35:36:74:b8,294260236,268,25823,294259968,294260236
21213,5,12,149,5745,-73,-97,24,6a:1e:a4:f8:14:49,294261150,284,630,294260866,294261150
21214,5,12,149,5745,-89,-97,8,7e:05:42:11:d2:ec,294261577,244,183,294261333,294261577
21215,5,12,149,5745,-70,-97,27,f2:da:61:dd:98:c5,294262932,268,1087,294262664,294262932
21216,5,12,149,5745,-55,-97,42,2a:07:ef:54:b5:55,294264553,244,1377,294264309,294264553
21217,5,12,149,5745,-71,-97,26,72:d1:72:1d:22:a1,294264959,284,122,294264675,294264959
21218,5,12,149,5745,-92,-97,5,4e:72:d0:f1:a2:44,294279171,440,13772,294278731,294279171
21219,5,12,149,5745,-64,-97,33,0a:b9:b7:b1:4d:fa,294281918,268,2479,294281650,294281918
21220,5,12,149,5745,-55,-97,42,3e:d1:9b:c7:a4:de,294282229,544,-233,294281685,294282229
21221,5,12,149,5745,-68,-97,29,22:ec:75:a8:8a:31,294283282,516,537,294282766,294283282
21222,5,12,149,5745,-72,-97,25,6a:1e:a4:f8:14:49,294283877,480,115,294283397,294283877
21223,5,12,149,5745,-63,-97,34,b6:90:18:f6:b1:d4,294289874,268,5729,294289606,294289874
21224,5,12,149,5745,-60,-97,37,4a:86:35:36:74:b8,294290826,268,684,294290558,294290826
21225,5,12,149,5745,-69,-97,28,f2:da:61:dd:98:c5,294291155,268,61,294290887,294291155
21226,5,12,149,5745,-55,-97,42,3e:d1:9b:c7:a4:de,294292520,272,1093,294292248,294292520
21227,5,12,149,5745,-66,-97,31,5e:29:73:5b:30:00,294293942,272,1150,294293670,294293942
21228,5,12,149,5745,-70,-97,27,a6:92:ad:b7:76:65,294296016,484,1590,294295532,294296016
21229,5,12,149,5745,-66,-97,31,5e:29:73:5b:30:00,294296570,540,14,294296030,294296570
21230,5,12,149,5745,-65,-97,32,b6:90:18:f6:b1:d4,294308205,268,11367,294307937,294308205
21231,5,12,149,5745,-60,-97,37,2a:07:ef:54:b5:55,294314069,440,5424,294313629,294314069
21232,5,12,149,5745,-74,-97,23,56:68:e2:c2:8d:d5,294320659,280,6310,294320379,294320659
21233,5,12,149,5745,-67,-97,30,22:ec:75:a8:8a:31,294325147,244,4244,294324903,294325147
21234,5,12,149,5745,-87,-97,10,42:d2:d9:2b:ac:61,294335492,256,10089,294335236,294335492
21235,5,12,149,5745,-62,-97,35,f6:0a:5c:59:72:df,294346411,280,10639,294346131,294346411
21236,5,12,149,5745,-58,-97,39,2a:07:ef:54:b5:55,294347533,440,682,294347093,294347533
21237,5,12,149,5745,-68,-97,29,a6:92:ad:b7:76:65,294353501,284,5684,294353217,294353501
21238,5,12,149,5745,-59,-97,38,4a:86:35:36:74:b8,294381345,268,27576,294381077,294381345
21239,5,12,149,5745,-69,-97,28,f2:da:61:dd:98:c5,294381647,268,34,294381379,294381647
21240,5,6,149,5745,-87,-97,10,54:e4:3a:ec:fb:65,294384070,360,2063,294383710,294384070
21241,5,12,149,5745,-73,-97,24,6a:1e:a4:f8:14:49,294384885,284,531,294384601,294384885
21242,5,12,149,5745,-70,-97,27,5e:29:73:5b:30:00,294389703,272,4546,294389431,294389703
21243,5,12,149,5745,-85,-97,12,9a:24:38:da:96:bb,294393794,272,3819,294393522,294393794
21244,5,12,149,5745,-57,-97,40,3e:d1:9b:c7:a4:de,294402907,272,8841,294402635,294402907
21245,5,12,149,5745,-75,-97,22,72:d1:72:1d:22:a1,294408755,284,5564,294408471,294408755
21246,5,12,149,5745,-57,-97,40,2a:07:ef:54:b5:55,294412610,440,3415,294412170,294412610
21247,5,12,149,5745,-64,-97,33,b6:90:18:f6:b1:d4,294420321,268,7443,294420053,294420321
21248,5,12,149,5745,-67,-97,30,22:ec:75:a8:8a:31,294440865,244,20300,294440621,294440865
21249,5,6,149,5745,-61,-97,36,4a:35:77:e7:40:60,294457783,192,16726,294457591,294457783
21250,5,6,149,5745,-88,-97,9,54:e4:3a:ec:fb:65,294458574,352,439,294458222,294458574
21251,5,6,149,5745,-91,-97,6,54:e4:3a:ec:fb:65,294459005,352,79,294458653,294459005
21252,5,6,149,5745,-91,-97,6,54:e4:3a:ec:fb:65,294459941,352,584,294459589,294459941
21253,5,24,149,5745,-84,-97,13,,294476405,28,16436,294476377,294476405
21254,5,24,149,5745,-89,-97,8,,294476449,28,16,294476421,294476449
21255,5,24,149,5745,-87,-97,10,,294476557,32,76,294476525,294476557
21256,5,6,149,5745,-59,-97,38,4a:35:77:e7:40:60,294478921,192,2172,294478729,294478921
21257,5,6,149,5745,-90,-97,7,54:e4:3a:ec:fb:65,294479800,352,527,294479448,294479800
21258,5,6,149,5745,-91,-97,6,54:e4:3a:ec:fb:65,294481185,352,1033,294480833,294481185
21259,5,6,149,5745,-91,-97,6,54:e4:3a:ec:fb:65,294486471,360,4926,294486111,294486471
21260,5,12,149,5745,-89,-97,8,7e:05:42:11:d2:ec,294493619,244,6904,294493375,294493619
21261,5,12,149,5745,-69,-97,28,f2:da:61:dd:98:c5,294494143,268,256,294493875,294494143
21262,5,12,149,5745,-73,-97,24,6a:1e:a4:f8:14:49,294495138,284,711,294494854,294495138
21263,5,12,149,5745,-57,-97,40,4a:86:35:36:74:b8,294495503,268,97,294495235,294495503
21264,5,12,149,5745,-70,-97,27,5e:29:73:5b:30:00,294506732,272,10957,294506460,294506732
21265,5,12,149,5745,-66,-97,31,a6:92:ad:b7:76:65,294509639,284,2623,294509355,294509639
21266,5,12,149,5745,-70,-97,27,72:d1:72:1d:22:a1,294511198,284,1275,294510914,294511198
21267,5,12,149,5745,-69,-97,28,56:68:e2:c2:8d:d5,294513197,280,1719,294512917,294513197
21268,5,12,149,5745,-86,-97,11,9a:24:38:da:96:bb,294514629,272,1160,294514357,294514629
21269,5,12,149,5745,-61,-97,36,3e:d1:9b:c7:a4:de,294520119,272,5218,294519847,294520119
21270,5,12,149,5745,-88,-97,9,42:d2:d9:2b:ac:61,294524510,256,4135,294524254,294524510
21271,5,24,149,5745,-86,-97,11,,294533602,28,9064,294533574,294533602
21272,5,24,149,5745,-84,-97,13,,294533646,28,16,294533618,294533646
21273,5,24,149,5745,-84,-97,13,,294533754,32,76,294533722,294533754
21274,5,24,149,5745,-85,-97,12,,294547766,28,13984,294547738,294547766
21275,5,24,149,5745,-88,-97,9,,294547811,28,17,294547783,294547811
21276,5,24,149,5745,-87,-97,10,,294547918,32,75,294547886,294547918
21277,5,12,149,5745,-67,-97,30,22:ec:75:a8:8a:31,294557897,244,9735,294557653,294557897
21278,5,24,149,5745,-87,-97,10,,294577546,28,19621,294577518,294577546
21279,5,24,149,5745,-84,-97,13,,294577590,28,16,294577562,294577590
21280,5,24,149,5745,-83,-97,14,,294577698,32,76,294577666,294577698
21281,5,6,149,5745,-92,-97,5,54:e4:3a:ec:fb:65,294588872,360,10814,294588512,294588872
21282,5,24,149,5745,-83,-97,14,,294590392,28,1492,294590364,294590392
21283,5,24,149,5745,-89,-97,8,,294590437,28,17,294590409,294590437
21284,5,24,149,5745,-87,-97,10,,294590548,32,79,294590516,294590548
21285,5,24,149,5745,-87,-97,10,,294594016,28,3440,294593988,294594016
21286,5,24,149,5745,-84,-97,13,,294594060,28,16,294594032,294594060
21287,5,24,149,5745,-83,-97,14,,294594168,32,76,294594136,294594168
21288,5,12,149,5745,-72,-97,25,f2:da:61:dd:98:c5,294605796,268,11360,294605528,294605796
21289,5,12,149,5745,-57,-97,40,4a:86:35:36:74:b8,294606186,268,122,294605918,294606186
21290,5,12,149,5745,-66,-97,31,a6:92:ad:b7:76:65,294612022,284,5552,294611738,294612022
21291,5,12,149,5745,-69,-97,28,72:d1:72:1d:22:a1,294613563,284,1257,294613279,294613563
21292,5,12,149,5745,-62,-97,35,b6:90:18:f6:b1:d4,294614063,268,232,294613795,294614063
21293,5,12,149,5745,-67,-97,30,56:68:e2:c2:8d:d5,294615614,280,1271,294615334,294615614
21294,5,12,149,5745,-86,-97,11,9a:24:38:da:96:bb,294618056,272,2170,294617784,294618056
21295,5,12,149,5745,-68,-97,29,5e:29:73:5b:30:00,294623804,272,5476,294623532,294623804
21296,5,12,149,5745,-88,-97,9,42:d2:d9:2b:ac:61,294626007,256,1947,294625751,294626007
21297,5,24,149,5745,-82,-97,15,,294633640,28,7605,294633612,294633640
21298,5,24,149,5745,-87,-97,10,,294633685,28,17,294633657,294633685
21299,5,24,149,5745,-87,-97,10,,294633792,32,75,294633760,294633792
21300,5,24,149,5745,-88,-97,9,,294633896,28,76,294633868,294633896
21301,5,24,149,5745,-83,-97,14,,294633940,28,16,294633912,294633940
21302,5,24,149,5745,-82,-97,15,,294634052,32,80,294634020,294634052
21303,5,12,149,5745,-56,-97,41,3e:d1:9b:c7:a4:de,294634594,272,270,294634322,294634594
21304,5,24,149,5745,-82,-97,15,,294635344,28,722,294635316,294635344
21305,5,24,149,5745,-87,-97,10,,294635388,28,16,294635360,294635388
21306,5,24,149,5745,-87,-97,10,,294635496,32,76,294635464,294635496
21307,5,24,149,5745,-82,-97,15,,294635678,28,154,294635650,294635678
21308,5,24,149,5745,-87,-97,10,,294635722,28,16,294635694,294635722
21309,5,24,149,5745,-86,-97,11,,294635834,32,80,294635802,294635834
21310,5,24,149,5745,-86,-97,11,,294640193,28,4331,294640165,294640193
21311,5,24,149,5745,-82,-97,15,,294640237,28,16,294640209,294640237
21312,5,24,149,5745,-82,-97,15,,294640357,32,88,294640325,294640357
21313,5,24,149,5745,-85,-97,12,,294645196,28,4811,294645168,294645196
21314,5,24,149,5745,-81,-97,16,,294645241,28,17,294645213,294645241
21315,5,24,149,5745,-81,-97,16,,294645349,32,76,294645317,294645349
21316,5,12,149,5745,-73,-97,24,d2:00:04:7e:2c:ab,294649729,244,4136,294649485,294649729
21317,5,24,149,5745,-81,-97,16,,294661147,28,11390,294661119,294661147
21318,5,24,149,5745,-86,-97,11,,294661191,28,16,294661163,294661191
21319,5,24,149,5745,-86,-97,11,,294661310,32,87,294661278,294661310
21320,5,24,149,5745,-82,-97,15,,294661490,28,152,294661462,294661490
21321,5,24,149,5745,-86,-97,11,,294661534,28,16,294661506,294661534
21322,5,24,149,5745,-86,-97,11,,294661649,32,83,294661617,294661649
21323,5,24,149,5745,-81,-97,16,,294661823,28,146,294661795,294661823
21324,5,24,149,5745,-81,-97,16,,294662038,28,187,294662010,294662038
21325,5,24,149,5745,-86,-97,11,,294662083,28,17,294662055,294662083
21326,5,24,149,5745,-86,-97,11,,294662190,32,75,294662158,294662190
21327,5,24,149,5745,-88,-97,9,,294667074,28,4856,294667046,294667074
21328,5,24,149,5745,-83,-97,14,,294667118,28,16,294667090,294667118
21329,5,24,149,5745,-83,-97,14,,294667242,32,92,294667210,294667242
21330,5,12,149,5745,-65,-97,32,22:ec:75:a8:8a:31,294669400,244,1914,294669156,294669400
21331,5,12,149,5745,-87,-97,10,42:d2:d9:2b:ac:61,294676022,256,6366,294675766,294676022
21332,5,24,149,5745,-85,-97,12,,294681163,28,5113,294681135,294681163
21333,5,24,149,5745,-88,-97,9,,294681207,28,16,294681179,294681207
21334,5,24,149,5745,-86,-97,11,,294681417,28,182,294681389,294681417
21335,5,24,149,5745,-89,-97,8,,294681461,28,16,294681433,294681461
21336,5,24,149,5745,-88,-97,9,,294684004,28,2515,294683976,294684004
21337,5,24,149,5745,-88,-97,9,,294684158,28,126,294684130,294684158
21338,5,24,149,5745,-85,-97,12,,294684202,28,16,294684174,294684202
21339,5,24,149,5745,-85,-97,12,,294684310,32,76,294684278,294684310
21340,5,12,149,5745,-66,-97,31,6a:1e:a4:f8:14:49,294687128,284,2534,294686844,294687128
21341,5,6,149,5745,-90,-97,7,54:e4:3a:ec:fb:65,294691272,360,3784,294690912,294691272
21342,5,12,149,5745,-68,-97,29,f2:da:61:dd:98:c5,294707832,268,16292,294707564,294707832
21343,5,12,149,5745,-54,-97,43,4a:86:35:36:74:b8,294708195,268,95,294707927,294708195
21344,5,12,149,5745,-69,-97,28,a6:92:ad:b7:76:65,294715444,284,6965,294715160,294715444
21345,5,12,149,5745,-70,-97,27,56:68:e2:c2:8d:d5,294717191,280,1467,294716911,294717191
21346,5,24,149,5745,-87,-97,10,,294717559,28,340,294717531,294717559
21347,5,24,149,5745,-84,-97,13,,294717604,28,17,294717576,294717604
21348,5,24,149,5745,-84,-97,13,,294717716,32,80,294717684,294717716
21349,5,24,149,5745,-87,-97,10,,294718759,28,1015,294718731,294718759
21350,5,24,149,5745,-84,-97,13,,294718803,28,16,294718775,294718803
21351,5,24,149,5745,-85,-97,12,,294718912,32,77,294718880,294718912
21352,5,12,149,5745,-65,-97,32,b6:90:18:f6:b1:d4,294719689,268,509,294719421,294719689
21353,5,12,149,5745,-88,-97,9,7e:05:42:11:d2:ec,294720750,244,817,294720506,294720750
21354,5,12,149,5745,-68,-97,29,72:d1:72:1d:22:a1,294721091,284,57,294720807,294721091
21355,5,12,149,5745,-67,-97,30,6a:1e:a4:f8:14:49,294722858,284,1483,294722574,294722858
21356,5,24,149,5745,-83,-97,14,,294731458,28,8572,294731430,294731458
21357,5,24,149,5745,-87,-97,10,,294731502,28,16,294731474,294731502
21358,5,24,149,5745,-87,-97,10,,294731610,32,76,294731578,294731610
21359,5,24,149,5745,-84,-97,13,,294731739,28,101,294731711,294731739
21360,5,24,149,5745,-86,-97,11,,294731783,28,16,294731755,294731783
21361,5,24,149,5745,-86,-97,11,,294731898,32,83,294731866,294731898
21362,5,24,149,5745,-84,-97,13,,294733838,28,1912,294733810,294733838
21363,5,24,149,5745,-86,-97,11,,294733882,28,16,294733854,294733882
21364,5,24,149,5745,-86,-97,11,,294733990,32,76,294733958,294733990
21365,5,24,149,5745,-86,-97,11,,294734174,28,156,294734146,294734174
21366,5,24,149,5745,-83,-97,14,,294734218,28,16,294734190,294734218
21367,5,24,149,5745,-83,-97,14,,294734327,32,77,294734295,294734327
21368,5,12,149,5745,-69,-97,28,56:68:e2:c2:8d:d5,294736751,476,1948,294736275,294736751
21369,5,24,149,5745,-86,-97,11,,294737360,28,581,294737332,294737360
21370,5,24,149,5745,-83,-97,14,,294737404,28,16,294737376,294737404
21371,5,24,149,5745,-83,-97,14,,294737516,32,80,294737484,294737516
21372,5,12,149,5745,-68,-97,29,5e:29:73:5b:30:00,294737607,540,-449,294737067,294737607
21373,5,24,149,5745,-83,-97,14,,294738728,28,1093,294738700,294738728
21374,5,24,149,5745,-86,-97,11,,294738772,28,16,294738744,294738772
21375,5,24,149,5745,-86,-97,11,,294738884,32,80,294738852,294738884
21376,5,24,149,5745,-83,-97,14,,294739120,28,208,294739092,294739120
21377,5,24,149,5745,-85,-97,12,,294739164,28,16,294739136,294739164
21378,5,24,149,5745,-85,-97,12,,294739272,32,76,294739240,294739272
21379,5,12,149,5745,-63,-97,34,22:ec:75:a8:8a:31,294739384,516,-404,294738868,294739384
21380,5,24,149,5745,-85,-97,12,,294740024,28,612,294739996,294740024
21381,5,24,149,5745,-83,-97,14,,294740068,28,16,294740040,294740068
21382,5,24,149,5745,-85,-97,12,,294740321,28,225,294740293,294740321
21383,5,24,149,5745,-83,-97,14,,294740365,28,16,294740337,294740365
21384,5,12,149,5745,-53,-97,44,4a:86:35:36:74:b8,294740561,268,-72,294740293,294740561
21385,5,24,149,5745,-82,-97,15,,294741033,28,444,294741005,294741033
21386,5,24,149,5745,-83,-97,14,,294741145,32,80,294741113,294741145
21387,5,12,149,5745,-87,-97,10,42:d2:d9:2b:ac:61,294742011,452,414,294741559,294742011
21388,5,24,149,5745,-86,-97,11,,294742551,28,512,294742523,294742551
21389,5,24,149,5745,-83,-97,14,,294742596,28,17,294742568,294742596
21390,5,24,149,5745,-83,-97,14,,294742716,32,88,294742684,294742716
21391,5,24,149,5745,-83,-97,14,,294742839,32,91,294742807,294742839
21392,5,12,149,5745,-67,-97,30,6a:1e:a4:f8:14:49,294744948,480,1629,294744468,294744948
21393,5,12,149,5745,-67,-97,30,b6:90:18:f6:b1:d4,294745498,268,282,294745230,294745498
21394,5,12,149,5745,-69,-97,28,f2:da:61:dd:98:c5,294748698,268,2932,294748430,294748698
21395,5,12,149,5745,-66,-97,31,b6:90:18:f6:b1:d4,294750521,268,1555,294750253,294750521
21396,5,12,149,5745,-89,-97,8,7e:05:42:11:d2:ec,294750849,440,-112,294750409,294750849
21397,5,12,149,5745,-67,-97,30,72:d1:72:1d:22:a1,294752116,480,787,294751636,294752116
21398,5,12,149,5745,-68,-97,29,5e:29:73:5b:30:00,294752669,272,281,294752397,294752669
21399,5,12,149,5745,-73,-97,24,d2:00:04:7e:2c:ab,294753156,244,243,294752912,294753156
21400,5,12,149,5745,-57,-97,40,3e:d1:9b:c7:a4:de,294756957,544,3257,294756413,294756957
21401,5,12,149,5745,-69,-97,28,f6:0a:5c:59:72:df,294757669,476,236,294757193,294757669
21402,5,24,149,5745,-86,-97,11,,294761339,28,3642,294761311,294761339
21403,5,24,149,5745,-83,-97,14,,294761383,28,16,294761355,294761383
21404,5,24,149,5745,-83,-97,14,,294761491,32,76,294761459,294761491
21405,5,24,149,5745,-83,-97,14,,294764385,28,2866,294764357,294764385
21406,5,24,149,5745,-85,-97,12,,294764429,28,16,294764401,294764429
21407,5,24,149,5745,-86,-97,11,,294764548,32,87,294764516,294764548
21408,5,24,149,5745,-83,-97,14,,294764668,28,92,294764640,294764668
21409,5,24,149,5745,-86,-97,11,,294764712,28,16,294764684,294764712
21410,5,24,149,5745,-85,-97,12,,294764827,32,83,294764795,294764827
21411,5,24,149,5745,-82,-97,15,,294764999,28,144,294764971,294764999
21412,5,24,149,5745,-86,-97,11,,294765043,28,16,294765015,294765043
21413,5,24,149,5745,-85,-97,12,,294765151,32,76,294765119,294765151
21414,5,24,149,5745,-83,-97,14,,294765311,28,132,294765283,294765311
21415,5,24,149,5745,-86,-97,11,,294765355,28,16,294765327,294765355
21416,5,24,149,5745,-85,-97,12,,294765463,32,76,294765431,294765463
21417,5,24,149,5745,-83,-97,14,,294768854,28,3363,294768826,294768854
21418,5,12,149,5745,-58,-97,39,3e:d1:9b:c7:a4:de,294769094,272,-32,294768822,294769094
21419,5,24,149,5745,-82,-97,15,,294769399,28,277,294769371,294769399
21420,5,24,149,5745,-83,-97,14,,294769512,32,81,294769480,294769512
21421,5,12,149,5745,-69,-97,28,56:68:e2:c2:8d:d5,294769578,280,-214,294769298,294769578
21422,5,24,149,5745,-83,-97,14,,294770254,28,648,294770226,294770254
21423,5,24,149,5745,-86,-97,11,,294770298,28,16,294770270,294770298
21424,5,24,149,5745,-86,-97,11,,294770409,32,79,294770377,294770409
21425,5,12,149,5745,-66,-97,31,a6:92:ad:b7:76:65,294771223,484,330,294770739,294771223
21426,5,24,149,5745,-87,-97,10,,294771795,28,544,294771767,294771795
21427,5,24,149,5745,-82,-97,15,,294771839,28,16,294771811,294771839
21428,5,24,149,5745,-82,-97,15,,294771947,32,76,294771915,294771947
21429,5,24,149,5745,-82,-97,15,,294773192,28,1217,294773164,294773192
21430,5,24,149,5745,-85,-97,12,,294773236,28,16,294773208,294773236
21431,5,24,149,5745,-86,-97,11,,294773344,32,76,294773312,294773344
21432,5,24,149,5745,-83,-97,14,,294773864,28,492,294773836,294773864
21433,5,24,149,5745,-86,-97,11,,294773909,28,17,294773881,294773909
21434,5,24,149,5745,-86,-97,11,,294774020,32,79,294773988,294774020
21435,5,24,149,5745,-85,-97,12,,294774105,28,57,294774077,294774105
21436,5,24,149,5745,-82,-97,15,,294774149,28,16,294774121,294774149
21437,5,24,149,5745,-82,-97,15,,294774257,32,76,294774225,294774257
21438,5,24,149,5745,-86,-97,11,,294775094,28,809,294775066,294775094
21439,5,24,149,5745,-83,-97,14,,294775138,28,16,294775110,294775138
21440,5,24,149,5745,-82,-97,15,,294775246,32,76,294775214,294775246
21441,5,24,149,5745,-86,-97,11,,294776258,28,984,294776230,294776258
21442,5,24,149,5745,-82,-97,15,,294776302,28,16,294776274,294776302
21443,5,24,149,5745,-82,-97,15,,294776411,32,77,294776379,294776411
21444,5,24,149,5745,-83,-97,14,,294777734,28,1295,294777706,294777734
21445,5,24,149,5745,-86,-97,11,,294777778,28,16,294777750,294777778
21446,5,24,149,5745,-86,-97,11,,294777886,32,76,294777854,294777886
21447,5,24,149,5745,-83,-97,14,,294778066,28,152,294778038,294778066
21448,5,24,149,5745,-86,-97,11,,294778110,28,16,294778082,294778110
21449,5,24,149,5745,-87,-97,10,,294778218,32,76,294778186,294778218
21450,5,24,149,5745,-82,-97,15,,294780410,28,2164,294780382,294780410
21451,5,24,149,5745,-87,-97,10,,294780454,28,16,294780426,294780454
21452,5,24,149,5745,-86,-97,11,,294780572,32,86,294780540,294780572
21453,5,24,149,5745,-82,-97,15,,294780702,28,102,294780674,294780702
21454,5,24,149,5745,-88,-97,9,,294780746,28,16,294780718,294780746
21455,5,24,149,5745,-86,-97,11,,294780865,32,87,294780833,294780865
21456,5,24,149,5745,-83,-97,14,,294781006,28,113,294780978,294781006
21457,5,24,149,5745,-86,-97,11,,294781050,28,16,294781022,294781050
21458,5,24,149,5745,-86,-97,11,,294781168,32,86,294781136,294781168
21459,5,24,149,5745,-82,-97,15,,294781351,28,155,294781323,294781351
21460,5,24,149,5745,-87,-97,10,,294781396,28,17,294781368,294781396
21461,5,24,149,5745,-86,-97,11,,294781547,32,119,294781515,294781547
21462,5,24,149,5745,-82,-97,15,,294781745,28,170,294781717,294781745
21463,5,24,149,5745,-87,-97,10,,294781789,28,16,294781761,294781789
21464,5,24,149,5745,-86,-97,11,,294781897,32,76,294781865,294781897
21465,5,24,149,5745,-83,-97,14,,294782017,28,92,294781989,294782017
21466,5,24,149,5745,-87,-97,10,,294782061,28,16,294782033,294782061
21467,5,24,149,5745,-87,-97,10,,294782170,32,77,294782138,294782170
21468,5,24,149,5745,-82,-97,15,,294782298,28,100,294782270,294782298
21469,5,24,149,5745,-86,-97,11,,294782342,28,16,294782314,294782342
21470,5,12,149,5745,-67,-97,30,f6:0a:5c:59:72:df,294782804,280,182,294782524,294782804
21471,5,24,149,5745,-83,-97,14,,294783233,28,401,294783205,294783233
21472,5,24,149,5745,-87,-97,10,,294783277,28,16,294783249,294783277
21473,5,24,149,5745,-86,-97,11,,294783385,32,76,294783353,294783385
21474,5,24,149,5745,-86,-97,11,,294783470,28,57,294783442,294783470
21475,5,24,149,5745,-82,-97,15,,294783514,28,16,294783486,294783514
21476,5,24,149,5745,-83,-97,14,,294783627,32,81,294783595,294783627
21477,5,24,149,5745,-86,-97,11,,294784488,28,833,294784460,294784488
21478,5,24,149,5745,-82,-97,15,,294784532,28,16,294784504,294784532
21479,5,24,149,5745,-83,-97,14,,294784644,32,80,294784612,294784644
21480,5,12,149,5745,-65,-97,32,a6:92:ad:b7:76:65,294785222,284,294,294784938,294785222
21481,5,24,149,5745,-87,-97,10,,294785598,28,348,294785570,294785598
21482,5,24,149,5745,-82,-97,15,,294785641,28,15,294785613,294785641
21483,5,24,149,5745,-83,-97,14,,294785754,32,81,294785722,294785754
21484,5,12,149,5745,-90,-97,7,42:d2:d9:2b:ac:61,294785865,256,-145,294785609,294785865
21485,5,24,149,5745,-83,-97,14,,294787897,28,2004,294787869,294787897
21486,5,24,149,5745,-87,-97,10,,294787942,28,17,294787914,294787942
21487,5,24,149,5745,-88,-97,9,,294788050,32,76,294788018,294788050
21488,5,24,149,5745,-87,-97,10,,294788773,28,695,294788745,294788773
21489,5,24,149,5745,-83,-97,14,,294788817,28,16,294788789,294788817
21490,5,24,149,5745,-82,-97,15,,294788925,32,76,294788893,294788925
21491,5,24,149,5745,-86,-97,11,,294790081,28,1128,294790053,294790081
21492,5,24,149,5745,-83,-97,14,,294790125,28,16,294790097,294790125
21493,5,24,149,5745,-83,-97,14,,294790234,32,77,294790202,294790234
21494,5,6,149,5745,-90,-97,7,54:e4:3a:ec:fb:65,294793673,360,3079,294793313,294793673
21495,5,24,149,5745,-83,-97,14,,294797357,28,3656,294797329,294797357
21496,5,24,149,5745,-87,-97,10,,294797401,28,16,294797373,294797401
21497,5,24,149,5745,-87,-97,10,,294797509,32,76,294797477,294797509
21498,5,12,149,5745,-63,-97,34,22:ec:75:a8:8a:31,294799403,244,1650,294799159,294799403
21499,5,12,149,5745,-59,-97,38,2a:07:ef:54:b5:55,294799798,440,-45,294799358,294799798
21500,5,24,149,5745,-82,-97,15,,294800308,28,482,294800280,294800308
21501,5,24,149,5745,-87,-97,10,,294800352,28,16,294800324,294800352
21502,5,24,149,5745,-87,-97,10,,294800460,32,76,294800428,294800460
21503,5,12,149,5745,-68,-97,29,5e:29:73:5b:30:00,294801199,540,199,294800659,294801199
21504,5,24,149,5745,-83,-97,14,,294801894,28,667,294801866,294801894
21505,5,24,149,5745,-83,-97,14,,294802006,32,80,294801974,294802006
21506,5,12,149,5745,-69,-97,28,56:68:e2:c2:8d:d5,294802216,476,-266,294801740,294802216
21507,5,12,149,5745,-63,-97,34,22:ec:75:a8:8a:31,294804569,516,1837,294804053,294804569
21508,5,12,149,5745,-53,-97,44,4a:86:35:36:74:b8,294805148,268,311,294804880,294805148
21509,5,12,149,5745,-72,-97,25,d2:00:04:7e:2c:ab,294806220,440,632,294805780,294806220
21510,5,12,149,5745,-61,-97,36,0a:b9:b7:b1:4d:fa,294808287,268,1799,294808019,294808287
21511,5,12,149,5745,-66,-97,31,72:d1:72:1d:22:a1,294809099,480,332,294808619,294809099
21512,5,12,149,5745,-65,-97,32,b6:90:18:f6:b1:d4,294809615,268,248,294809347,294809615
21513,5,12,149,5745,-88,-97,9,7e:05:42:11:d2:ec,294813631,440,3576,294813191,294813631
21514,5,24,149,5745,-82,-97,15,,294814973,28,1314,294814945,294814973
21515,5,24,149,5745,-86,-97,11,,294815017,28,16,294814989,294815017
21516,5,24,149,5745,-86,-97,11,,294815125,32,76,294815093,294815125
21517,5,12,149,5745,-73,-97,24,d2:00:04:7e:2c:ab,294815820,380,315,294815440,294815820
21518,5,12,149,5745,-72,-97,25,6a:1e:a4:f8:14:49,294816463,480,163,294815983,294816463
21519,5,12,149,5745,-65,-97,32,72:d1:72:1d:22:a1,294816995,284,248,294816711,294816995
21520,5,12,149,5745,-74,-97,23,f2:da:61:dd:98:c5,294817628,268,365,294817360,294817628
21521,5,12,149,5745,-65,-97,32,a6:92:ad:b7:76:65,294820016,484,1904,294819532,294820016
21522,5,12,149,5745,-68,-97,29,f6:0a:5c:59:72:df,294820623,476,131,294820147,294820623
21523,5,12,149,5745,-60,-97,37,3e:d1:9b:c7:a4:de,294822033,544,866,294821489,294822033
21524,5,12,149,5745,-75,-97,22,f2:da:61:dd:98:c5,294822631,268,330,294822363,294822631
21525,5,24,149,5745,-82,-97,15,,294823488,28,829,294823460,294823488
21526,5,24,149,5745,-86,-97,11,,294823533,28,17,294823505,294823533
21527,5,24,149,5745,-85,-97,12,,294823640,32,75,294823608,294823640
21528,5,12,149,5745,-88,-97,9,7e:05:42:11:d2:ec,294824824,244,940,294824580,294824824
21529,5,24,149,5745,-86,-97,11,,294826456,28,1604,294826428,294826456
21530,5,24,149,5745,-86,-97,11,,294826807,28,323,294826779,294826807
21531,5,24,149,5745,-85,-97,12,,294826960,28,125,294826932,294826960
21532,5,24,149,5745,-85,-97,12,,294827536,28,548,294827508,294827536
21533,5,24,149,5745,-82,-97,15,,294827580,28,16,294827552,294827580
21534,5,24,149,5745,-83,-97,14,,294827692,32,80,294827660,294827692
21535,5,12,149,5745,-54,-97,43,4a:86:35:36:74:b8,294833347,268,5387,294833079,294833347
21536,5,12,149,5745,-72,-97,25,6a:1e:a4:f8:14:49,294834114,284,483,294833830,294834114
21537,5,12,149,5745,-90,-97,7,9a:24:38:da:96:bb,294838885,272,4499,294838613,294838885
21538,5,24,149,5745,-83,-97,14,,294841803,28,2890,294841775,294841803
21539,5,24,149,5745,-84,-97,13,,294841847,28,16,294841819,294841847
21540,5,24,149,5745,-85,-97,12,,294841955,32,76,294841923,294841955
21541,5,24,149,5745,-84,-97,13,,294849653,28,7670,294849625,294849653
21542,5,24,149,5745,-83,-97,14,,294849697,28,16,294849669,294849697
21543,5,24,149,5745,-82,-97,15,,294849806,32,77,294849774,294849806
21544,5,12,149,5745,-59,-97,38,3e:d1:9b:c7:a4:de,294861039,272,10961,294860767,294861039
21545,5,12,149,5745,-73,-97,24,d2:00:04:7e:2c:ab,294866569,244,5286,294866325,294866569
21546,5,12,149,5745,-68,-97,29,5e:29:73:5b:30:00,294866875,540,-234,294866335,294866875
21547,5,12,149,5745,-68,-97,29,5e:29:73:5b:30:00,294867432,272,285,294867160,294867432
21548,5,12,149,5745,-73,-97,24,d2:00:04:7e:2c:ab,294872199,440,4327,294871759,294872199
21549,5,12,149,5745,-63,-97,34,b6:90:18:f6:b1:d4,294880128,268,7661,294879860,294880128
21550,5,24,149,5745,-82,-97,15,,294883322,28,3166,294883294,294883322
21551,5,24,149,5745,-84,-97,13,,294883366,28,16,294883338,294883366
21552,5,24,149,5745,-85,-97,12,,294883478,32,80,294883446,294883478
21553,5,12,149,5745,-67,-97,30,56:68:e2:c2:8d:d5,294885859,280,2101,294885579,294885859
21554,5,24,149,5745,-85,-97,12,,294886218,28,331,294886190,294886218
21555,5,24,149,5745,-82,-97,15,,294886262,28,16,294886234,294886262
21556,5,24,149,5745,-82,-97,15,,294886370,32,76,294886338,294886370
21557,5,24,149,5745,-82,-97,15,,294887998,28,1600,294887970,294887998
21558,5,24,149,5745,-84,-97,13,,294888043,28,17,294888015,294888043
21559,5,24,149,5745,-84,-97,13,,294888151,32,76,294888119,294888151
21560,5,24,149,5745,-82,-97,15,,294888334,28,155,294888306,294888334
21561,5,24,149,5745,-84,-97,13,,294888379,28,17,294888351,294888379
21562,5,24,149,5745,-85,-97,12,,294888486,32,75,294888454,294888486
21563,5,24,149,5745,-84,-97,13,,294895947,28,7433,294895919,294895947
21564,5,24,149,5745,-81,-97,16,,294895991,28,16,294895963,294895991
21565,5,24,149,5745,-81,-97,16,,294896099,32,76,294896067,294896099
21566,5,12,149,5745,-66,-97,31,22:ec:75:a8:8a:31,294899424,244,3081,294899180,294899424
21567,5,12,149,5745,-88,-97,9,42:d2:d9:2b:ac:61,294900218,256,538,294899962,294900218
21568,5,12,149,5745,-64,-97,33,a6:92:ad:b7:76:65,294917674,284,17172,294917390,294917674
21569,5,24,149,5745,-81,-97,16,,294925810,28,8108,294925782,294925810
21570,5,24,149,5745,-87,-97,10,,294925855,28,17,294925827,294925855
21571,5,24,149,5745,-87,-97,10,,294925963,32,76,294925931,294925963
21572,5,12,149,5745,-71,-97,26,5e:29:73:5b:30:00,294932373,540,5870,294931833,294932373
21573,5,12,149,5745,-87,-97,10,7e:05:42:11:d2:ec,294941730,244,9113,294941486,294941730
21574,5,24,149,5745,-68,-97,29,,294944746,28,2988,294944718,294944746
21575,5,24,149,5745,-83,-97,14,,294944790,28,16,294944762,294944790
21576,5,24,149,5745,-83,-97,14,,294944898,28,80,294944870,294944898
21577,5,12,149,5745,-88,-97,9,9a:24:38:da:96:bb,294951846,272,6676,294951574,294951846
21578,5,12,149,5745,-61,-97,36,3e:d1:9b:c7:a4:de,294976419,272,24301,294976147,294976419
21579,5,12,149,5745,-73,-97,24,5e:29:73:5b:30:00,294982449,272,5758,294982177,294982449
21580,5,12,149,5745,-78,-97,19,d2:00:04:7e:2c:ab,294987495,244,4802,294987251,294987495
21581,5,12,149,5745,-70,-97,27,6a:1e:a4:f8:14:49,294995666,284,7887,294995382,294995666
21582,5,12,149,5745,-73,-97,24,5e:29:73:5b:30:00,294998045,540,1839,294997505,294998045
21583,5,6,149,5745,-91,-97,6,54:e4:3a:ec:fb:65,294998617,360,212,294998257,294998617
21584,5,12,149,5745,-53,-97,44,4a:86:35:36:74:b8,295000472,268,1587,295000204,295000472
21585,5,12,149,5745,-75,-97,22,f2:da:61:dd:98:c5,295000990,268,250,295000722,295000990
21586,5,24,149,5745,-89,-97,8,,295013449,28,12431,295013421,295013449
21587,5,24,149,5745,-87,-97,10,,295013494,28,17,295013466,295013494
21588,5,24,149,5745,-86,-97,11,,295013602,32,76,295013570,295013602
21589,5,12,149,5745,-71,-97,26,22:ec:75:a8:8a:31,295016485,244,2639,295016241,295016485
21590,5,12,149,5745,-62,-97,35,b6:90:18:f6:b1:d4,295022917,268,6164,295022649,295022917
21591,5,12,149,5745,-71,-97,26,72:d1:72:1d:22:a1,295023245,284,44,295022961,295023245
21592,5,12,149,5745,-76,-97,21,56:68:e2:c2:8d:d5,295023960,280,435,295023680,295023960
21593,5,24,149,5745,-87,-97,10,,295027631,28,3643,295027603,295027631
21594,5,24,149,5745,-89,-97,8,,295027675,28,16,295027647,295027675
21595,5,24,149,5745,-89,-97,8,,295027783,32,76,295027751,295027783
21596,5,12,149,5745,-66,-97,31,a6:92:ad:b7:76:65,295029638,284,1571,295029354,295029638
21597,5,24,149,5745,-89,-97,8,,295035758,28,6092,295035730,295035758
21598,5,24,149,5745,-87,-97,10,,295035802,28,16,295035774,295035802
21599,5,24,149,5745,-87,-97,10,,295035911,32,77,295035879,295035911
21600,5,12,149,5745,-89,-97,8,42:d2:d9:2b:ac:61,295036488,256,321,295036232,295036488
21601,5,12,149,5745,-92,-97,5,7e:05:42:11:d2:ec,295053211,244,16479,295052967,295053211
21602,5,12,149,5745,-87,-97,10,9a:24:38:da:96:bb,295067792,272,14309,295067520,295067792
21603,5,24,149,5745,-87,-97,10,,295071772,28,3952,295071744,295071772
21604,5,24,149,5745,-86,-97,11,,295071816,28,16,295071788,295071816
21605,5,24,149,5745,-87,-97,10,,295071928,32,80,295071896,295071928
21606,5,24,149,5745,-87,-97,10,,295076759,28,4803,295076731,295076759
21607,5,24,149,5745,-86,-97,11,,295076803,28,16,295076775,295076803
21608,5,24,149,5745,-87,-97,10,,295076921,32,86,295076889,295076921
21609,5,24,149,5745,-86,-97,11,,295077025,28,76,295076997,295077025
21610,5,24,149,5745,-87,-97,10,,295077069,28,16,295077041,295077069
21611,5,24,149,5745,-87,-97,10,,295077177,32,76,295077145,295077177
21612,5,12,149,5745,-71,-97,26,5e:29:73:5b:30:00,295077519,272,70,295077247,295077519
21613,5,24,149,5745,-86,-97,11,,295084045,28,6498,295084017,295084045
21614,5,24,149,5745,-85,-97,12,,295084162,28,89,295084134,295084162
21615,5,24,149,5745,-87,-97,10,,295084207,28,17,295084179,295084207
21616,5,24,149,5745,-88,-97,9,,295084315,32,76,295084283,295084315
21617,5,12,149,5745,-57,-97,40,3e:d1:9b:c7:a4:de,295092504,272,7917,295092232,295092504
21618,5,12,149,5745,-71,-97,26,6a:1e:a4:f8:14:49,295097458,284,4670,295097174,295097458
21619,5,6,149,5745,-91,-97,6,54:e4:3a:ec:fb:65,295100874,360,3056,295100514,295100874
21620,5,12,149,5745,-75,-97,22,f2:da:61:dd:98:c5,295101660,268,518,295101392,295101660
21621,5,12,149,5745,-52,-97,45,4a:86:35:36:74:b8,295102122,268,194,295101854,295102122
21622,5,24,149,5745,-85,-97,12,,295116076,28,13926,295116048,295116076
21623,5,24,149,5745,-85,-97,12,,295116120,28,16,295116092,295116120
21624,5,24,149,5745,-85,-97,12,,295116228,32,76,295116196,295116228
21625,5,12,149,5745,-72,-97,25,d2:00:04:7e:2c:ab,295124515,244,8043,295124271,295124515
21626,5,12,149,5745,-63,-97,34,b6:90:18:f6:b1:d4,295125234,268,451,295124966,295125234
21627,5,12,149,5745,-70,-97,27,72:d1:72:1d:22:a1,295125706,284,188,295125422,295125706
21628,5,12,149,5745,-69,-97,28,56:68:e2:c2:8d:d5,295126069,280,83,295125789,295126069
21629,5,12,149,5745,-67,-97,30,22:ec:75:a8:8a:31,295133541,244,7228,295133297,295133541
21630,5,12,149,5745,-88,-97,9,42:d2:d9:2b:ac:61,295138966,256,5169,295138710,295138966
21631,5,12,149,5745,-67,-97,30,f6:0a:5c:59:72:df,295139296,280,50,295139016,295139296
21632,5,12,149,5745,-66,-97,31,a6:92:ad:b7:76:65,295140064,284,484,295139780,295140064
21633,5,12,149,5745,-67,-97,30,72:d1:72:1d:22:a1,295169621,284,29273,295169337,295169621
21634,5,12,149,5745,-73,-97,24,f2:da:61:dd:98:c5,295173055,268,3166,295172787,295173055
21635,5,12,149,5745,-72,-97,25,6a:1e:a4:f8:14:49,295175128,284,1789,295174844,295175128
21636,5,12,149,5745,-90,-97,7,7e:05:42:11:d2:ec,295175460,244,88,295175216,295175460
21637,5,12,149,5745,-88,-97,9,9a:24:38:da:96:bb,295176176,272,444,295175904,295176176
21638,5,12,149,5745,-52,-97,45,4a:86:35:36:74:b8,295178879,268,2435,295178611,295178879
21639,5,12,149,5745,-87,-97,10,9a:24:38:da:96:bb,295192837,824,13134,295192013,295192837
21640,5,12,149,5745,-66,-97,31,2a:07:ef:54:b5:55,295196152,440,2875,295195712,295196152
21641,5,12,149,5745,-67,-97,30,f6:0a:5c:59:72:df,295196761,476,133,295196285,295196761
21642,5,12,149,5745,-52,-97,45,4a:86:35:36:74:b8,295198535,268,1506,295198267,295198535
21643,5,12,149,5745,-65,-97,32,22:ec:75:a8:8a:31,295200282,516,1231,295199766,295200282
21644,5,12,149,5745,-73,-97,24,d2:00:04:7e:2c:ab,295200897,440,175,295200457,295200897
21645,5,12,149,5745,-88,-97,9,42:d2:d9:2b:ac:61,295201741,452,392,295201289,295201741
21646,5,12,149,5745,-64,-97,33,72:d1:72:1d:22:a1,295202758,480,537,295202278,295202758
21647,5,6,149,5745,-91,-97,6,54:e4:3a:ec:fb:65,295203275,360,157,295202915,295203275
21648,5,12,149,5745,-66,-97,31,b6:90:18:f6:b1:d4,295205389,268,1846,295205121,295205389
21649,5,12,149,5745,-67,-97,30,b6:90:18:f6:b1:d4,295209288,268,3631,295209020,295209288
21650,5,12,149,5745,-73,-97,24,56:68:e2:c2:8d:d5,295210527,280,959,295210247,295210527
21651,5,12,149,5745,-74,-97,23,d2:00:04:7e:2c:ab,295210914,244,143,295210670,295210914
21652,5,12,149,5745,-67,-97,30,5e:29:73:5b:30:00,295211557,272,371,295211285,295211557
21653,5,12,149,5745,-70,-97,27,6a:1e:a4:f8:14:49,295211899,480,-138,295211419,295211899
21654,5,12,149,5745,-73,-97,24,d2:00:04:7e:2c:ab,295212511,104,508,295212407,295212511
21655,5,12,149,5745,-64,-97,33,a6:92:ad:b7:76:65,295213673,484,678,295213189,295213673
21656,5,12,149,5745,-66,-97,31,2a:07:ef:54:b5:55,295215798,380,1745,295215418,295215798
21657,5,12,149,5745,-60,-97,37,3e:d1:9b:c7:a4:de,295217752,544,1410,295217208,295217752
21658,5,12,149,5745,-74,-97,23,56:68:e2:c2:8d:d5,295221480,476,3252,295221004,295221480
21659,5,12,149,5745,-60,-97,37,3e:d1:9b:c7:a4:de,295226682,272,4930,295226410,295226682
21660,5,12,149,5745,-88,-97,9,42:d2:d9:2b:ac:61,295227216,256,278,295226960,295227216
21661,5,12,149,5745,-71,-97,26,f2:da:61:dd:98:c5,295231625,268,4141,295231357,295231625
21662,5,12,149,5745,-69,-97,28,f6:0a:5c:59:72:df,295238378,280,6473,295238098,295238378
21663,5,12,149,5745,-64,-97,33,a6:92:ad:b7:76:65,295244029,284,5367,295243745,295244029
21664,5,12,149,5745,-65,-97,32,22:ec:75:a8:8a:31,295247915,244,3642,295247671,295247915
21665,5,12,149,5745,-67,-97,30,5e:29:73:5b:30:00,295260154,540,11699,295259614,295260154
21666,5,12,149,5745,-74,-97,23,d2:00:04:7e:2c:ab,295264946,440,4352,295264506,295264946
21667,5,12,149,5745,-68,-97,29,b6:90:18:f6:b1:d4,295267879,268,2665,295267611,295267879
21668,5,12,149,5745,-63,-97,34,2a:07:ef:54:b5:55,295273986,440,5667,295273546,295273986
21669,5,12,149,5745,-68,-97,29,6a:1e:a4:f8:14:49,295275191,480,725,295274711,295275191
21670,5,12,149,5745,-68,-97,29,6a:1e:a4:f8:14:49,295276470,284,995,295276186,295276470
21671,5,12,149,5745,-63,-97,34,a6:92:ad:b7:76:65,295280097,484,3143,295279613,295280097
21672,5,12,149,5745,-64,-97,33,72:d1:72:1d:22:a1,295281822,284,1441,295281538,295281822
21673,5,12,149,5745,-75,-97,22,f2:da:61:dd:98:c5,295286018,268,3928,295285750,295286018
21674,5,12,149,5745,-51,-97,46,4a:86:35:36:74:b8,295289665,268,3379,295289397,295289665
21675,5,6,149,5745,-92,-97,5,54:e4:3a:ec:fb:65,295305675,360,15650,295305315,295305675
21676,5,12,149,5745,-88,-97,9,9a:24:38:da:96:bb,295309732,272,3785,295309460,295309732
21677,5,12,149,5745,-71,-97,26,5e:29:73:5b:30:00,295310122,272,118,295309850,295310122
21678,5,12,149,5745,-67,-97,30,b6:90:18:f6:b1:d4,295323969,268,13579,295323701,295323969
21679,5,12,149,5745,-68,-97,29,5e:29:73:5b:30:00,295325216,540,707,295324676,295325216
21680,5,12,149,5745,-61,-97,36,3e:d1:9b:c7:a4:de,295325790,272,302,295325518,295325790
21681,5,12,149,5745,-72,-97,25,d2:00:04:7e:2c:ab,295326105,244,71,295325861,295326105
21682,5,12,149,5745,-51,-97,46,4a:86:35:36:74:b8,295328417,268,2044,295328149,295328417
21683,5,12,149,5745,-72,-97,25,d2:00:04:7e:2c:ab,295330787,440,1930,295330347,295330787
21684,5,12,149,5745,-67,-97,30,22:ec:75:a8:8a:31,295331496,516,193,295330980,295331496
21685,5,12,149,5745,-67,-97,30,0a:b9:b7:b1:4d:fa,295332136,268,372,295331868,295332136
21686,5,12,149,5745,-73,-97,24,56:68:e2:c2:8d:d5,295333034,280,618,295332754,295333034
21687,5,12,149,5745,-67,-97,30,b6:90:18:f6:b1:d4,295333395,268,93,295333127,295333395
21688,5,12,149,5745,-65,-97,32,2a:07:ef:54:b5:55,295339537,440,5702,295339097,295339537
21689,5,12,149,5745,-70,-97,27,6a:1e:a4:f8:14:49,295340759,480,742,295340279,295340759
21690,5,12,149,5745,-62,-97,35,a6:92:ad:b7:76:65,295344378,484,3135,295343894,295344378
21691,5,12,149,5745,-70,-97,27,f2:da:61:dd:98:c5,295345807,268,1161,295345539,295345807
21692,5,12,149,5745,-61,-97,36,3e:d1:9b:c7:a4:de,295349034,544,2683,295348490,295349034
21693,5,12,149,5745,-87,-97,10,42:d2:d9:2b:ac:61,295354692,256,5402,295354436,295354692
21694,5,12,149,5745,-62,-97,35,a6:92:ad:b7:76:65,295358765,284,3789,295358481,295358765
21695,5,12,149,5745,-65,-97,32,22:ec:75:a8:8a:31,295373718,244,14709,295373474,295373718
21696,5,12,149,5745,-68,-97,29,5e:29:73:5b:30:00,295391176,540,16918,295390636,295391176
21697,5,12,149,5745,-72,-97,25,d2:00:04:7e:2c:ab,295396457,440,4841,295396017,295396457
21698,5,12,149,5745,-88,-97,9,9a:24:38:da:96:bb,295401290,272,4561,295401018,295401290
21699,5,12,149,5745,-64,-97,33,6a:1e:a4:f8:14:49,295403810,284,2236,295403526,295403810
21700,5,12,149,5745,-53,-97,44,4a:86:35:36:74:b8,295404191,268,113,295403923,295404191
21701,5,12,149,5745,-72,-97,25,f2:da:61:dd:98:c5,295405840,268,1381,295405572,295405840
21702,5,6,149,5745,-88,-97,9,54:e4:3a:ec:fb:65,295408076,360,1876,295407716,295408076
21703,5,12,149,5745,-71,-97,26,d2:00:04:7e:2c:ab,295423547,244,15227,295423303,295423547
21704,5,12,149,5745,-72,-97,25,5e:29:73:5b:30:00,295424609,272,790,295424337,295424609
21705,5,12,149,5745,-66,-97,31,b6:90:18:f6:b1:d4,295444341,268,19464,295444073,295444341
21706,5,6,149,5745,-80,-97,17,86:59:dc:f0:77:40,295444968,164,463,295444804,295444968
21707,5,6,149,5745,-88,-97,9,54:e4:3a:ec:fb:65,295445277,352,-43,295444925,295445277
21708,5,6,149,5745,-80,-97,17,,295445647,44,326,295445603,295445647
21709,5,12,149,5745,-70,-97,27,56:68:e2:c2:8d:d5,295447005,280,1078,295446725,295447005
21710,5,12,149,5745,-70,-97,27,5e:29:73:5b:30:00,295456770,540,9225,295456230,295456770
21711,5,12,149,5745,-62,-97,35,22:ec:75:a8:8a:31,295473137,244,16123,295472893,295473137
21712,5,12,149,5745,-65,-97,32,f6:0a:5c:59:72:df,295483995,280,10578,295483715,295483995
21713,5,24,149,5745,-68,-97,29,,295494183,28,10160,295494155,295494183
21714,5,24,149,5745,-83,-97,14,,295494227,28,16,295494199,295494227
21715,5,24,149,5745,-84,-97,13,,295494335,28,80,295494307,295494335
21716,5,24,149,5745,-68,-97,29,,295494525,28,162,295494497,295494525
21717,5,24,149,5745,-84,-97,13,,295494569,28,16,295494541,295494569
21718,5,24,149,5745,-84,-97,13,,295494677,28,80,295494649,295494677
21719,5,6,149,5745,-78,-97,19,86:59:dc:f0:77:40,295500174,164,5333,295500010,295500174
21720,5,6,149,5745,-89,-97,8,54:e4:3a:ec:fb:65,295500512,352,-14,295500160,295500512
21721,5,6,149,5745,-79,-97,18,,295500882,44,326,295500838,295500882
21722,5,6,149,5745,-89,-97,8,54:e4:3a:ec:fb:65,295510477,360,9235,295510117,295510477
21723,5,12,149,5745,-70,-97,27,6a:1e:a4:f8:14:49,295511793,284,1032,295511509,295511793
21724,5,12,149,5745,-85,-97,12,9a:24:38:da:96:bb,295516837,272,4772,295516565,295516837
21725,5,12,149,5745,-49,-97,48,4a:86:35:36:74:b8,295517694,268,589,295517426,295517694
21726,5,12,149,5745,-68,-97,29,f2:da:61:dd:98:c5,295518945,268,983,295518677,295518945
21727,5,12,149,5745,-66,-97,31,5e:29:73:5b:30:00,295522218,540,2733,295521678,295522218
21728,5,12,149,5745,-91,-97,6,7e:05:42:11:d2:ec,295532074,440,9416,295531634,295532074
21729,5,12,149,5745,-65,-97,32,a6:92:ad:b7:76:65,295534227,284,1869,295533943,295534227
21730,5,12,149,5745,-68,-97,29,72:d1:72:1d:22:a1,295534672,284,161,295534388,295534672
21731,5,12,149,5745,-67,-97,30,5e:29:73:5b:30:00,295539158,272,4214,295538886,295539158
21732,5,12,149,5745,-70,-97,27,d2:00:04:7e:2c:ab,295547058,244,7656,295546814,295547058
21733,5,12,149,5745,-88,-97,9,42:d2:d9:2b:ac:61,295548369,256,1055,295548113,295548369
21734,5,24,149,5745,-83,-97,14,,295549381,28,984,295549353,295549381
21735,5,12,149,5745,-56,-97,41,3e:d1:9b:c7:a4:de,295549828,272,175,295549556,295549828
21736,5,24,149,5745,-82,-97,15,,295551310,28,1454,295551282,295551310
21737,5,12,149,5745,-69,-97,28,22:ec:75:a8:8a:31,295590173,244,38619,295589929,295590173
21738,5,12,149,5745,-64,-97,33,f6:0a:5c:59:72:df,295596752,280,6299,295596472,295596752
21739,5,6,149,5745,-91,-97,6,54:e4:3a:ec:fb:65,295612877,360,15765,295612517,295612877
21740,5,12,149,5745,-68,-97,29,6a:1e:a4:f8:14:49,295621702,284,8541,295621418,295621702
21741,5,12,149,5745,-84,-97,13,9a:24:38:da:96:bb,295625418,272,3444,295625146,295625418
21742,5,12,149,5745,-53,-97,44,4a:86:35:36:74:b8,295629398,268,3712,295629130,295629398
21743,5,12,149,5745,-71,-97,26,f2:da:61:dd:98:c5,295629952,268,286,295629684,295629952
21744,5,12,149,5745,-66,-97,31,a6:92:ad:b7:76:65,295636001,284,5765,295635717,295636001
21745,5,12,149,5745,-70,-97,27,72:d1:72:1d:22:a1,295637556,284,1271,295637272,295637556
21746,5,12,149,5745,-65,-97,32,b6:90:18:f6:b1:d4,295638553,268,729,295638285,295638553
21747,5,12,149,5745,-66,-97,31,56:68:e2:c2:8d:d5,295639645,280,812,295639365,295639645
21748,5,12,149,5745,-67,-97,30,5e:29:73:5b:30:00,295642434,272,2517,295642162,295642434
21749,5,12,149,5745,-89,-97,8,42:d2:d9:2b:ac:61,295650965,256,8275,295650709,295650965
21750,5,12,149,5745,-54,-97,43,3e:d1:9b:c7:a4:de,295666939,272,15702,295666667,295666939
21751,5,12,149,5745,-66,-97,31,22:ec:75:a8:8a:31,295704089,244,36906,295703845,295704089
21752,5,6,149,5745,-89,-97,8,54:e4:3a:ec:fb:65,295715278,360,10829,295714918,295715278
21753,5,12,149,5745,-64,-97,33,a6:92:ad:b7:76:65,295737710,284,22148,295737426,295737710
21754,5,12,149,5745,-69,-97,28,d2:00:04:7e:2c:ab,295739316,244,1362,295739072,295739316
21755,5,12,149,5745,-60,-97,37,b6:90:18:f6:b1:d4,295739855,268,271,295739587,295739855
21756,5,12,149,5745,-64,-97,33,72:d1:72:1d:22:a1,295740375,284,236,295740091,295740375
21757,5,12,149,5745,-72,-97,25,56:68:e2:c2:8d:d5,295741125,280,470,295740845,295741125
21758,5,12,149,5745,-65,-97,32,6a:1e:a4:f8:14:49,295742364,284,955,295742080,295742364
21759,5,12,149,5745,-52,-97,45,4a:86:35:36:74:b8,295748493,268,5861,295748225,295748493
21760,5,12,149,5745,-73,-97,24,f2:da:61:dd:98:c5,295748831,268,70,295748563,295748831
21761,5,12,149,5745,-88,-97,9,42:d2:d9:2b:ac:61,295752500,256,3413,295752244,295752500
21762,5,12,149,5745,-67,-97,30,5e:29:73:5b:30:00,295754534,272,1762,295754262,295754534
21763,5,12,149,5745,-90,-97,7,de:be:a8:cd:79:57,295755964,284,1146,295755680,295755964
21764,5,24,149,5745,-85,-97,12,,295760179,28,4187,295760151,295760179
21765,5,24,149,5745,-84,-97,13,,295760223,28,16,295760195,295760223
21766,5,24,149,5745,-84,-97,13,,295760332,32,77,295760300,295760332
21767,5,12,149,5745,-68,-97,29,d2:00:04:7e:2c:ab,295769980,244,9404,295769736,295769980
21768,5,12,149,5745,-91,-97,6,3a:90:78:0e:4f:1f,295773619,284,3355,295773335,295773619
21769,5,24,149,5745,-84,-97,13,,295774554,28,907,295774526,295774554
21770,5,24,149,5745,-85,-97,12,,295774599,28,17,295774571,295774599
21771,5,24,149,5745,-85,-97,12,,295774707,32,76,295774675,295774707
21772,5,12,149,5745,-59,-97,38,b6:90:18:f6:b1:d4,295782711,268,7736,295782443,295782711
21773,5,24,149,5745,-86,-97,11,,295783031,28,292,295783003,295783031
21774,5,24,149,5745,-84,-97,13,,295783075,28,16,295783047,295783075
21775,5,24,149,5745,-83,-97,14,,295783183,32,76,295783151,295783183
21776,5,12,149,5745,-69,-97,28,56:68:e2:c2:8d:d5,295783862,280,399,295783582,295783862
21777,5,12,149,5745,-54,-97,43,4a:86:35:36:74:b8,295787291,268,3161,295787023,295787291
21778,5,12,149,5745,-61,-97,36,f6:0a:5c:59:72:df,295787710,476,-57,295787234,295787710
21779,5,12,149,5745,-89,-97,8,42:d2:d9:2b:ac:61,295789341,452,1179,295788889,295789341
21780,5,12,149,5745,-92,-97,5,de:be:a8:cd:79:57,295789881,480,60,295789401,295789881
21781,5,12,149,5745,-67,-97,30,d2:00:04:7e:2c:ab,295790513,440,192,295790073,295790513
21782,5,12,149,5745,-62,-97,35,72:d1:72:1d:22:a1,295793172,480,2179,295792692,295793172
21783,5,12,149,5745,-59,-97,38,b6:90:18:f6:b1:d4,295793705,268,265,295793437,295793705
21784,5,12,149,5745,-59,-97,38,2a:07:ef:54:b5:55,295799479,440,5334,295799039,295799479
21785,5,12,149,5745,-54,-97,43,3e:d1:9b:c7:a4:de,295799989,272,238,295799717,295799989
21786,5,12,149,5745,-90,-97,7,42:d2:d9:2b:ac:61,295800414,256,169,295800158,295800414
21787,5,12,149,5745,-54,-97,43,3e:d1:9b:c7:a4:de,295800911,544,-47,295800367,295800911
21788,5,12,149,5745,-69,-97,28,6a:1e:a4:f8:14:49,295803784,480,2393,295803304,295803784
21789,5,12,149,5745,-64,-97,33,a6:92:ad:b7:76:65,295804298,484,30,295803814,295804298
21790,5,12,149,5745,-69,-97,28,f2:da:61:dd:98:c5,295805485,268,919,295805217,295805485
21791,5,12,149,5745,-71,-97,26,56:68:e2:c2:8d:d5,295807495,476,1534,295807019,295807495
21792,5,12,149,5745,-91,-97,6,3a:90:78:0e:4f:1f,295809641,484,1662,295809157,295809641
21793,5,12,149,5745,-63,-97,34,a6:92:ad:b7:76:65,295817342,284,7417,295817058,295817342
21794,5,6,149,5745,-89,-97,8,54:e4:3a:ec:fb:65,295817678,360,-24,295817318,295817678
21795,5,12,149,5745,-62,-97,35,22:ec:75:a8:8a:31,295831922,244,14000,295831678,295831922
21796,5,12,149,5745,-70,-97,27,6a:1e:a4:f8:14:49,295833969,284,1763,295833685,295833969
21797,5,12,149,5745,-61,-97,36,72:d1:72:1d:22:a1,295834295,284,42,295834011,295834295
21798,5,12,149,5745,-85,-97,12,9a:24:38:da:96:bb,295846953,824,11834,295846129,295846953
21799,5,12,149,5745,-85,-97,12,9a:24:38:da:96:bb,295847795,272,570,295847523,295847795
21800,5,12,149,5745,-56,-97,41,4a:86:35:36:74:b8,295849001,268,938,295848733,295849001
21801,5,12,149,5745,-69,-97,28,f2:da:61:dd:98:c5,295849492,268,223,295849224,295849492
21802,5,12,149,5745,-64,-97,33,f6:0a:5c:59:72:df,295852210,476,2242,295851734,295852210
21803,5,12,149,5745,-55,-97,42,4a:86:35:36:74:b8,295853577,268,1099,295853309,295853577
21804,5,12,149,5745,-90,-97,7,42:d2:d9:2b:ac:61,295853957,452,-72,295853505,295853957
21805,5,12,149,5745,-68,-97,29,d2:00:04:7e:2c:ab,295854455,440,58,295854015,295854455
21806,5,12,149,5745,-55,-97,42,4a:86:35:36:74:b8,295855066,200,411,295854866,295855066
21807,5,12,149,5745,-63,-97,34,0a:b9:b7:b1:4d:fa,295855858,268,524,295855590,295855858
21808,5,12,149,5745,-57,-97,40,b6:90:18:f6:b1:d4,295857348,268,1222,295857080,295857348
21809,5,12,149,5745,-62,-97,35,72:d1:72:1d:22:a1,295858867,480,1039,295858387,295858867
21810,5,12,149,5745,-90,-97,7,7e:05:42:11:d2:ec,295859489,440,182,295859049,295859489
21811,5,12,149,5745,-71,-97,26,6a:1e:a4:f8:14:49,295860202,380,333,295859822,295860202
21812,5,12,149,5745,-91,-97,6,7e:05:42:11:d2:ec,295860664,360,102,295860304,295860664
21813,5,12,149,5745,-61,-97,36,2a:07:ef:54:b5:55,295862462,440,1358,295862022,295862462
21814,5,12,149,5745,-58,-97,39,3e:d1:9b:c7:a4:de,295866613,544,3607,295866069,295866613
21815,5,12,149,5745,-60,-97,37,a6:92:ad:b7:76:65,295868290,484,1193,295867806,295868290
21816,5,12,149,5745,-69,-97,28,f2:da:61:dd:98:c5,295868854,268,296,295868586,295868854
21817,5,12,149,5745,-70,-97,27,6a:1e:a4:f8:14:49,295869201,480,-133,295868721,295869201
21818,5,12,149,5745,-65,-97,32,5e:29:73:5b:30:00,295869769,540,28,295869229,295869769
21819,5,12,149,5745,-63,-97,34,22:ec:75:a8:8a:31,295870343,516,58,295869827,295870343
21820,5,12,149,5745,-91,-97,6,3a:90:78:0e:4f:1f,295871228,484,401,295870744,295871228
21821,5,12,149,5745,-71,-97,26,56:68:e2:c2:8d:d5,295872619,476,915,295872143,295872619
21822,5,12,149,5745,-69,-97,28,d2:00:04:7e:2c:ab,295873158,380,159,295872778,295873158
21823,5,12,149,5745,-56,-97,41,b6:90:18:f6:b1:d4,295880971,268,7545,295880703,295880971
21824,5,12,149,5745,-69,-97,28,d2:00:04:7e:2c:ab,295882274,244,1059,295882030,295882274
21825,5,12,149,5745,-64,-97,33,5e:29:73:5b:30:00,295883207,272,661,295882935,295883207
21826,5,12,149,5745,-92,-97,5,3a:90:78:0e:4f:1f,295886797,284,3306,295886513,295886797
21827,5,24,149,5745,-82,-97,15,,295887310,28,485,295887282,295887310
21828,5,24,149,5745,-83,-97,14,,295887354,28,16,295887326,295887354
21829,5,24,149,5745,-82,-97,15,,295887513,28,131,295887485,295887513
21830,5,24,149,5745,-83,-97,14,,295887558,28,17,295887530,295887558
21831,5,24,149,5745,-82,-97,15,,295887716,28,130,295887688,295887716
21832,5,24,149,5745,-83,-97,14,,295887760,28,16,295887732,295887760
21833,5,24,149,5745,-83,-97,14,,295887879,32,87,295887847,295887879
21834,5,24,149,5745,-81,-97,16,,295890234,28,2327,295890206,295890234
21835,5,24,149,5745,-83,-97,14,,295890279,28,17,295890251,295890279
21836,5,24,149,5745,-83,-97,14,,295890387,32,76,295890355,295890387
21837,5,24,149,5745,-81,-97,16,,295890552,28,137,295890524,295890552
21838,5,24,149,5745,-82,-97,15,,295890597,28,17,295890569,295890597
21839,5,24,149,5745,-83,-97,14,,295890704,32,75,295890672,295890704
21840,5,24,149,5745,-83,-97,14,,295890880,28,148,295890852,295890880
21841,5,24,149,5745,-82,-97,15,,295890924,28,16,295890896,295890924
21842,5,24,149,5745,-81,-97,16,,295891032,32,76,295891000,295891032
21843,5,24,149,5745,-83,-97,14,,295897623,28,6563,295897595,295897623
21844,5,24,149,5745,-82,-97,15,,295897667,28,16,295897639,295897667
21845,5,24,149,5745,-81,-97,16,,295897775,32,76,295897743,295897775
21846,5,12,149,5745,-57,-97,40,3e:d1:9b:c7:a4:de,295898480,272,433,295898208,295898480
21847,5,12,149,5745,-70,-97,27,56:68:e2:c2:8d:d5,295898877,280,117,295898597,295898877
21848,5,12,149,5745,-89,-97,8,de:be:a8:cd:79:57,295900685,284,1524,295900401,295900685
21849,5,12,149,5745,-91,-97,6,4e:72:d0:f1:a2:44,295912051,244,11122,295911807,295912051
21850,5,12,149,5745,-70,-97,27,d2:00:04:7e:2c:ab,295920252,440,7761,295919812,295920252
21851,5,12,149,5745,-87,-97,10,42:d2:d9:2b:ac:61,295927484,256,6976,295927228,295927484
21852,5,24,149,5745,-83,-97,14,,295929551,28,2039,295929523,295929551
21853,5,24,149,5745,-82,-97,15,,295929595,28,16,295929567,295929595
21854,5,24,149,5745,-82,-97,15,,295929703,32,76,295929671,295929703
21855,5,12,149,5745,-64,-97,33,f6:0a:5c:59:72:df,295931229,280,1246,295930949,295931229
21856,5,12,149,5745,-55,-97,42,3e:d1:9b:c7:a4:de,295931633,544,-140,295931089,295931633
21857,5,12,149,5745,-61,-97,36,a6:92:ad:b7:76:65,295933403,284,1486,295933119,295933403
21858,5,12,149,5745,-70,-97,27,f2:da:61:dd:98:c5,295933974,268,303,295933706,295933974
21859,5,12,149,5745,-64,-97,33,22:ec:75:a8:8a:31,295936032,516,1542,295935516,295936032
21860,5,12,149,5745,-64,-97,33,22:ec:75:a8:8a:31,295946332,244,10056,295946088,295946332
21861,5,24,149,5745,-68,-97,29,,295954416,28,8056,295954388,295954416
21862,5,24,149,5745,-82,-97,15,,295954461,28,17,295954433,295954461
21863,5,24,149,5745,-81,-97,16,,295954569,28,80,295954541,295954569
21864,5,12,149,5745,-69,-97,28,72:d1:72:1d:22:a1,295957053,284,2200,295956769,295957053
21865,5,12,149,5745,-67,-97,30,6a:1e:a4:f8:14:49,295958604,284,1267,295958320,295958604
21866,5,12,149,5745,-87,-97,10,9a:24:38:da:96:bb,295960986,272,2110,295960714,295960986
21867,5,12,149,5745,-69,-97,28,f2:da:61:dd:98:c5,295964587,268,3333,295964319,295964587
21868,5,12,149,5745,-65,-97,32,5e:29:73:5b:30:00,295983794,272,18935,295983522,295983794
21869,5,12,149,5745,-54,-97,43,3e:d1:9b:c7:a4:de,295996983,544,12645,295996439,295996983
21870,5,24,149,5745,-80,-97,17,,295998391,28,1380,295998363,295998391
21871,5,24,149,5745,-71,-97,26,,295998435,28,16,295998407,295998435
21872,5,24,149,5745,-72,-97,25,,295998543,32,76,295998511,295998543
21873,5,12,149,5745,-70,-97,27,f2:da:61:dd:98:c5,295998699,268,-112,295998431,295998699
21874,5,24,149,5745,-80,-97,17,,295998991,28,264,295998963,295998991
21875,5,24,149,5745,-72,-97,25,,295999035,28,16,295999007,295999035
21876,5,24,149,5745,-71,-97,26,,295999143,32,76,295999111,295999143
21877,5,24,149,5745,-72,-97,25,,295999840,28,669,295999812,295999840
21878,5,24,149,5745,-80,-97,17,,295999884,28,16,295999856,295999884
21879,5,24,149,5745,-72,-97,25,,296000110,28,198,296000082,296000110
21880,5,24,149,5745,-80,-97,17,,296000154,28,16,296000126,296000154
21881,5,24,149,5745,-80,-97,17,,296000262,32,76,296000230,296000262
21882,5,24,149,5745,-72,-97,25,,296000603,28,313,296000575,296000603
21883,5,24,149,5745,-80,-97,17,,296000647,28,16,296000619,296000647
21884,5,24,149,5745,-80,-97,17,,296000759,32,80,296000727,296000759
21885,5,12,149,5745,-72,-97,25,d2:00:04:7e:2c:ab,296000916,244,-87,296000672,296000916
21886,5,12,149,5745,-62,-97,35,22:ec:75:a8:8a:31,296001231,516,-201,296000715,296001231
21887,5,12,149,5745,-55,-97,42,3e:d1:9b:c7:a4:de,296012824,272,11321,296012552,296012824
21888,5,6,149,5745,-90,-97,7,54:e4:3a:ec:fb:65,296022479,360,9295,296022119,296022479
21889,5,12,149,5745,-49,-97,48,4a:86:35:36:74:b8,296023311,268,564,296023043,296023311
21890,5,24,149,5745,-81,-97,16,,296026793,28,3454,296026765,296026793
21891,5,24,149,5745,-80,-97,17,,296026837,28,16,296026809,296026837
21892,5,24,149,5745,-79,-97,18,,296026946,32,77,296026914,296026946
21893,5,12,149,5745,-90,-97,7,42:d2:d9:2b:ac:61,296033868,256,6666,296033612,296033868
21894,5,24,149,5745,-79,-97,18,,296041872,28,7976,296041844,296041872
21895,5,24,149,5745,-82,-97,15,,296041916,28,16,296041888,296041916
21896,5,24,149,5745,-82,-97,15,,296042024,32,76,296041992,296042024
21897,5,12,149,5745,-64,-97,33,f6:0a:5c:59:72:df,296043913,280,1609,296043633,296043913
21898,5,12,149,5745,-65,-97,32,a6:92:ad:b7:76:65,296046608,284,2411,296046324,296046608
21899,5,12,149,5745,-58,-97,39,b6:90:18:f6:b1:d4,296047722,268,846,296047454,296047722
21900,5,12,149,5745,-67,-97,30,56:68:e2:c2:8d:d5,296049264,280,1262,296048984,296049264
21901,5,24,149,5745,-82,-97,15,,296049948,28,656,296049920,296049948
21902,5,24,149,5745,-79,-97,18,,296049992,28,16,296049964,296049992
21903,5,24,149,5745,-79,-97,18,,296050100,32,76,296050068,296050100
21904,5,24,149,5745,-78,-97,19,,296055752,28,5624,296055724,296055752
21905,5,24,149,5745,-82,-97,15,,296055796,28,16,296055768,296055796
21906,5,24,149,5745,-82,-97,15,,296055904,32,76,296055872,296055904
21907,5,24,149,5745,-79,-97,18,,296056089,28,157,296056061,296056089
21908,5,24,149,5745,-82,-97,15,,296056133,28,16,296056105,296056133
21909,5,24,149,5745,-82,-97,15,,296056241,32,76,296056209,296056241
21910,5,12,149,5745,-88,-97,9,7e:05:42:11:d2:ec,296056344,440,-337,296055904,296056344
21911,5,24,149,5745,-82,-97,15,,296058133,28,1761,296058105,296058133
21912,5,24,149,5745,-79,-97,18,,296058177,28,16,296058149,296058177
21913,5,24,149,5745,-79,-97,18,,296058285,32,76,296058253,296058285
21914,5,12,149,5745,-63,-97,34,22:ec:75:a8:8a:31,296060962,244,2433,296060718,296060962
21915,5,12,149,5745,-57,-97,40,3e:d1:9b:c7:a4:de,296063112,544,1606,296062568,296063112
21916,5,24,149,5745,-82,-97,15,,296063762,28,622,296063734,296063762
21917,5,24,149,5745,-79,-97,18,,296063806,28,16,296063778,296063806
21918,5,24,149,5745,-79,-97,18,,296063915,32,77,296063883,296063915
21919,5,12,149,5745,-73,-97,24,f2:da:61:dd:98:c5,296064851,268,668,296064583,296064851
21920,5,12,149,5745,-63,-97,34,22:ec:75:a8:8a:31,296066590,516,1223,296066074,296066590
21921,5,24,149,5745,-78,-97,19,,296067212,28,594,296067184,296067212
21922,5,24,149,5745,-72,-97,25,,296067256,28,16,296067228,296067256
21923,5,24,149,5745,-73,-97,24,,296067364,32,76,296067332,296067364
21924,5,24,149,5745,-73,-97,24,,296068307,28,915,296068279,296068307
21925,5,24,149,5745,-79,-97,18,,296068351,28,16,296068323,296068351
21926,5,24,149,5745,-79,-97,18,,296068459,32,76,296068427,296068459
21927,5,12,149,5745,-73,-97,24,f2:da:61:dd:98:c5,296078881,268,10154,296078613,296078881
21928,5,24,149,5745,-82,-97,15,,296082442,28,3533,296082414,296082442
21929,5,24,149,5745,-79,-97,18,,296082486,28,16,296082458,296082486
21930,5,24,149,5745,-79,-97,18,,296082595,32,77,296082563,296082595
21931,5,24,149,5745,-79,-97,18,,296100336,28,17713,296100308,296100336
21932,5,24,149,5745,-83,-97,14,,296100381,28,17,296100353,296100381
21933,5,24,149,5745,-82,-97,15,,296100489,32,76,296100457,296100489
21934,5,12,149,5745,-68,-97,29,5e:29:73:5b:30:00,296101502,272,741,296101230,296101502
21935,5,24,149,5745,-78,-97,19,,296101845,28,315,296101817,296101845
21936,5,24,149,5745,-83,-97,14,,296101889,28,16,296101861,296101889
21937,5,24,149,5745,-82,-97,15,,296101997,32,76,296101965,296101997
21938,5,12,149,5745,-72,-97,25,d2:00:04:7e:2c:ab,296114551,244,12310,296114307,296114551
21939,5,12,149,5745,-52,-97,45,3e:d1:9b:c7:a4:de,296120679,272,5856,296120407,296120679
21940,5,12,149,5745,-68,-97,29,6a:1e:a4:f8:14:49,296121147,284,184,296120863,296121147
21941,5,12,149,5745,-50,-97,47,4a:86:35:36:74:b8,296124730,268,3315,296124462,296124730
21942,5,24,149,5745,-79,-97,18,,296128671,32,3909,296128639,296128671
21943,5,24,149,5745,-72,-97,25,66:48:51:4e:71:fa,296128788,328,-211,296128460,296128788
21944,5,24,149,5745,-79,-97,18,,296129277,28,461,296129249,296129277
21945,5,24,149,5745,-73,-97,24,,296129320,28,15,296129292,296129320
21946,5,24,149,5745,-73,-97,24,,296129428,32,76,296129396,296129428
21947,5,12,149,5745,-67,-97,30,72:d1:72:1d:22:a1,296149914,284,20202,296149630,296149914
21948,5,12,149,5745,-67,-97,30,56:68:e2:c2:8d:d5,296150277,280,83,296149997,296150277
21949,5,12,149,5745,-59,-97,38,b6:90:18:f6:b1:d4,296151292,268,747,296151024,296151292
21950,5,12,149,5745,-92,-97,5,46:28:71:6e:d2:2e,296154174,252,2630,296153922,296154174
21951,5,12,149,5745,-62,-97,35,22:ec:75:a8:8a:31,296155403,244,985,296155159,296155403
21952,5,12,149,5745,-64,-97,33,a6:92:ad:b7:76:65,296159727,284,4040,296159443,296159727
21953,5,12,149,5745,-87,-97,10,42:d2:d9:2b:ac:61,296162952,256,2969,296162696,296162952
21954,5,12,149,5745,-70,-97,27,72:d1:72:1d:22:a1,296184890,284,21654,296184606,296184890
21955,5,12,149,5745,-83,-97,14,9a:24:38:da:96:bb,296188958,272,3796,296188686,296188958
21956,5,12,149,5745,-53,-97,44,4a:86:35:36:74:b8,296194412,268,5186,296194144,296194412
21957,5,12,149,5745,-67,-97,30,5e:29:73:5b:30:00,296216471,272,21787,296216199,296216471
21958,5,12,149,5745,-66,-97,31,6a:1e:a4:f8:14:49,296223853,284,7098,296223569,296223853
21959,5,6,149,5745,-88,-97,9,54:e4:3a:ec:fb:65,296227280,360,3067,296226920,296227280
21960,5,12,149,5745,-69,-97,28,d2:00:04:7e:2c:ab,296228242,244,718,296227998,296228242
21961,5,12,149,5745,-69,-97,28,f2:da:61:dd:98:c5,296228529,268,19,296228261,296228529
21962,5,12,149,5745,-68,-97,29,56:68:e2:c2:8d:d5,296231450,280,2641,296231170,296231450
21963,5,12,149,5745,-58,-97,39,b6:90:18:f6:b1:d4,296241432,268,9714,296241164,296241432
21964,5,12,149,5745,-54,-97,43,3e:d1:9b:c7:a4:de,296242320,272,616,296242048,296242320
21965,5,12,149,5745,-89,-97,8,42:d2:d9:2b:ac:61,296242953,256,377,296242697,296242953
21966,5,12,149,5745,-92,-97,5,46:28:71:6e:d2:2e,296245752,252,2547,296245500,296245752
21967,5,12,149,5745,-63,-97,34,f6:0a:5c:59:72:df,296247369,476,1141,296246893,296247369
21968,5,12,149,5745,-52,-97,45,4a:86:35:36:74:b8,296247899,268,262,296247631,296247899
21969,5,12,149,5745,-69,-97,28,d2:00:04:7e:2c:ab,296248966,440,627,296248526,296248966
21970,5,12,149,5745,-88,-97,9,42:d2:d9:2b:ac:61,296249915,452,497,296249463,296249915
21971,5,6,149,5745,-71,-97,26,78:ba:f9:ec:ca:10,296251429,168,1346,296251261,296251429
21972,5,12,149,5745,-63,-97,34,f6:0a:5c:59:72:df,296252410,268,713,296252142,296252410
21973,5,12,149,5745,-68,-97,29,72:d1:72:1d:22:a1,296253083,480,193,296252603,296253083
21974,5,12,149,5745,-58,-97,39,b6:90:18:f6:b1:d4,296253643,268,292,296253375,296253643
21975,5,12,149,5745,-64,-97,33,f6:0a:5c:59:72:df,296253963,280,40,296253683,296253963
21976,5,6,149,5745,-66,-97,31,78:ba:f9:ec:ca:10,296254876,132,781,296254744,296254876
21977,5,12,149,5745,-65,-97,32,6a:1e:a4:f8:14:49,296255090,380,-166,296254710,296255090
21978,5,12,149,5745,-60,-97,37,2a:07:ef:54:b5:55,296257801,440,2271,296257361,296257801
21979,5,12,149,5745,-55,-97,42,3e:d1:9b:c7:a4:de,296262325,544,3980,296261781,296262325
21980,5,12,149,5745,-71,-97,26,f2:da:61:dd:98:c5,296263067,268,474,296262799,296263067
21981,5,12,149,5745,-66,-97,31,6a:1e:a4:f8:14:49,296264125,480,578,296263645,296264125
21982,5,12,149,5745,-69,-97,28,5e:29:73:5b:30:00,296264693,540,28,296264153,296264693
21983,5,12,149,5745,-64,-97,33,22:ec:75:a8:8a:31,296265818,516,609,296265302,296265818
21984,5,12,149,5745,-68,-97,29,56:68:e2:c2:8d:d5,296270193,268,4107,296269925,296270193
21985,5,12,149,5745,-92,-97,5,3a:90:78:0e:4f:1f,296270839,484,162,296270355,296270839
21986,5,12,149,5745,-63,-97,34,22:ec:75:a8:8a:31,296273976,244,2893,296273732,296273976
21987,5,12,149,5745,-69,-97,28,56:68:e2:c2:8d:d5,296284110,476,9658,296283634,296284110
21988,5,12,149,5745,-69,-97,28,72:d1:72:1d:22:a1,296292221,284,7827,296291937,296292221
21989,5,12,149,5745,-66,-97,31,6a:1e:a4:f8:14:49,296292693,284,188,296292409,296292693
21990,5,12,149,5745,-86,-97,11,9a:24:38:da:96:bb,296298072,272,5107,296297800,296298072
21991,5,12,149,5745,-71,-97,26,f2:da:61:dd:98:c5,296308186,268,9846,296307918,296308186
21992,5,12,149,5745,-68,-97,29,d2:00:04:7e:2c:ab,296313013,440,4387,296312573,296313013
21993,5,12,149,5745,-90,-97,7,de:be:a8:cd:79:57,296313514,480,21,296313034,296313514
21994,5,12,149,5745,-58,-97,39,b6:90:18:f6:b1:d4,296316422,268,2640,296316154,296316422
21995,5,12,149,5745,-50,-97,47,4a:86:35:36:74:b8,296319129,268,2439,296318861,296319129
21996,5,12,149,5745,-69,-97,28,d2:00:04:7e:2c:ab,296324651,244,5278,296324407,296324651
21997,5,12,149,5745,-55,-97,42,3e:d1:9b:c7:a4:de,296324956,544,-239,296324412,296324956
21998,5,12,149,5745,-70,-97,27,f2:da:61:dd:98:c5,296326418,268,1194,296326150,296326418
21999,5,12,149,5745,-65,-97,32,22:ec:75:a8:8a:31,296329303,516,2369,296328787,296329303
22000,5,6,149,5745,-89,-97,8,54:e4:3a:ec:fb:65,296329929,360,266,296329569,296329929
22001,5,12,149,5745,-61,-97,36,2a:07:ef:54:b5:55,296331176,440,807,296330736,296331176
22002,5,12,149,5745,-68,-97,29,5e:29:73:5b:30:00,296333290,272,1842,296333018,296333290
22003,5,12,149,5745,-57,-97,40,b6:90:18:f6:b1:d4,296339662,268,6104,296339394,296339662
22004,5,12,149,5745,-69,-97,28,56:68:e2:c2:8d:d5,296350638,280,10696,296350358,296350638
22005,5,12,149,5745,-53,-97,44,3e:d1:9b:c7:a4:de,296357189,272,6279,296356917,296357189
22006,5,12,149,5745,-93,-97,4,de:be:a8:cd:79:57,296359296,284,1823,296359012,296359296
22007,5,12,149,5745,-52,-97,45,4a:86:35:36:74:b8,296378460,268,18896,296378192,296378460
22008,5,12,149,5745,-69,-97,28,d2:00:04:7e:2c:ab,296379014,440,114,296378574,296379014
22009,5,12,149,5745,-65,-97,32,0a:b9:b7:b1:4d:fa,296379878,268,596,296379610,296379878
22010,5,12,149,5745,-56,-97,41,b6:90:18:f6:b1:d4,296382565,268,2419,296382297,296382565
22011,5,12,149,5745,-62,-97,35,a6:92:ad:b7:76:65,296388174,484,5125,296387690,296388174
22012,5,12,149,5745,-90,-97,7,46:16:4e:de:2f:e5,296388973,440,359,296388533,296388973
22013,5,12,149,5745,-90,-97,7,7e:05:42:11:d2:ec,296389447,440,34,296389007,296389447
22014,5,12,149,5745,-52,-97,45,3e:d1:9b:c7:a4:de,296390767,544,776,296390223,296390767
22015,5,12,149,5745,-70,-97,27,f2:da:61:dd:98:c5,296392465,268,1430,296392197,296392465
22016,5,12,149,5745,-62,-97,35,2a:07:ef:54:b5:55,296392803,440,-102,296392363,296392803
22017,5,12,149,5745,-65,-97,32,22:ec:75:a8:8a:31,296394275,516,956,296393759,296394275
22018,5,12,149,5745,-65,-97,32,5e:29:73:5b:30:00,296396978,540,2163,296396438,296396978
22019,5,12,149,5745,-53,-97,44,4a:86:35:36:74:b8,296406313,268,9067,296406045,296406313
22020,5,12,149,5745,-70,-97,27,f2:da:61:dd:98:c5,296407041,268,460,296406773,296407041
22021,5,12,149,5745,-88,-97,9,9a:24:38:da:96:bb,296409313,272,2000,296409041,296409313
22022,5,12,149,5745,-65,-97,32,6a:1e:a4:f8:14:49,296428701,284,19104,296428417,296428701
22023,5,6,149,5745,-87,-97,10,54:e4:3a:ec:fb:65,296432081,360,3020,296431721,296432081
22024,5,12,149,5745,-70,-97,27,d2:00:04:7e:2c:ab,296439332,244,7007,296439088,296439332
22025,5,12,149,5745,-70,-97,27,d2:00:04:7e:2c:ab,296444581,440,4809,296444141,296444581
22026,5,12,149,5745,-66,-97,31,5e:29:73:5b:30:00,296450202,272,5349,296449930,296450202
22027,5,12,149,5745,-52,-97,45,3e:d1:9b:c7:a4:de,296456313,544,5567,296455769,296456313
22028,5,12,149,5745,-70,-97,27,72:d1:72:1d:22:a1,296456965,284,368,296456681,296456965
22029,5,12,149,5745,-70,-97,27,f2:da:61:dd:98:c5,296458273,268,1040,296458005,296458273
22030,5,12,149,5745,-65,-97,32,22:ec:75:a8:8a:31,296460349,516,1560,296459833,296460349
22031,5,12,149,5745,-69,-97,28,56:68:e2:c2:8d:d5,296462501,280,1872,296462221,296462501
22032,5,12,149,5745,-55,-97,42,b6:90:18:f6:b1:d4,296464625,268,1856,296464357,296464625
22033,5,12,149,5745,-52,-97,45,3e:d1:9b:c7:a4:de,296471579,272,6682,296471307,296471579
22034,5,12,149,5745,-89,-97,8,42:d2:d9:2b:ac:61,296482243,260,10404,296481983,296482243
22035,5,12,149,5745,-65,-97,32,22:ec:75:a8:8a:31,296503389,244,20902,296503145,296503389
22036,5,12,149,5745,-72,-97,25,f2:da:61:dd:98:c5,296521192,268,17535,296520924,296521192
22037,5,12,149,5745,-53,-97,44,3e:d1:9b:c7:a4:de,296521522,544,-214,296520978,296521522
22038,5,12,149,5745,-87,-97,10,9a:24:38:da:96:bb,296522385,272,591,296522113,296522385
22039,5,12,149,5745,-73,-97,24,f2:da:61:dd:98:c5,296523465,268,812,296523197,296523465
22040,5,12,149,5745,-64,-97,33,22:ec:75:a8:8a:31,296525801,516,1820,296525285,296525801
22041,5,12,149,5745,-66,-97,31,6a:1e:a4:f8:14:49,296531111,284,5026,296530827,296531111
22042,5,12,149,5745,-54,-97,43,4a:86:35:36:74:b8,296532553,268,1174,296532285,296532553
22043,5,6,149,5745,-87,-97,10,54:e4:3a:ec:fb:65,296534482,360,1569,296534122,296534482
22044,5,24,149,5745,-82,-97,15,,296550859,28,16349,296550831,296550859
22045,5,24,149,5745,-82,-97,15,,296550903,28,16,296550875,296550903
22046,5,24,149,5745,-82,-97,15,,296551011,32,76,296550979,296551011
22047,5,12,149,5745,-69,-97,28,72:d1:72:1d:22:a1,296558699,284,7404,296558415,296558699
22048,5,12,149,5745,-71,-97,26,d2:00:04:7e:2c:ab,296565990,244,7047,296565746,296565990
22049,5,12,149,5745,-66,-97,31,5e:29:73:5b:30:00,296567155,272,893,296566883,296567155
22050,5,24,149,5745,-82,-97,15,,296569042,28,1859,296569014,296569042
22051,5,24,149,5745,-82,-97,15,,296569086,28,16,296569058,296569086
22052,5,24,149,5745,-81,-97,16,,296569194,32,76,296569162,296569194
22053,5,12,149,5745,-68,-97,29,56:68:e2:c2:8d:d5,296573900,280,4426,296573620,296573900
22054,5,12,149,5745,-55,-97,42,b6:90:18:f6:b1:d4,296576015,268,1847,296575747,296576015
22055,5,12,149,5745,-87,-97,10,7e:05:42:11:d2:ec,296583774,440,7319,296583334,296583774
22056,5,12,149,5745,-53,-97,44,3e:d1:9b:c7:a4:de,296586291,272,2245,296586019,296586291
22057,5,12,149,5745,-53,-97,44,3e:d1:9b:c7:a4:de,296586899,544,64,296586355,296586899
22058,5,12,149,5745,-91,-97,6,de:be:a8:cd:79:57,296587886,284,703,296587602,296587886
22059,5,12,149,5745,-73,-97,24,f2:da:61:dd:98:c5,296589288,268,1134,296589020,296589288
22060,5,12,149,5745,-61,-97,36,22:ec:75:a8:8a:31,296591414,516,1610,296590898,296591414
22061,5,24,149,5745,-82,-97,15,,296594566,28,3124,296594538,296594566
22062,5,24,149,5745,-82,-97,15,,296594610,28,16,296594582,296594610
22063,5,24,149,5745,-82,-97,15,,296594718,32,76,296594686,296594718
22064,5,12,149,5745,-92,-97,5,3a:90:78:0e:4f:1f,296594821,256,-153,296594565,296594821
22065,5,24,149,5745,-82,-97,15,,296612841,28,17992,296612813,296612841
22066,5,24,149,5745,-81,-97,16,,296612885,28,16,296612857,296612885
22067,5,24,149,5745,-82,-97,15,,296612993,32,76,296612961,296612993
22068,5,12,149,5745,-60,-97,37,22:ec:75:a8:8a:31,296618306,244,5069,296618062,296618306
22069,5,12,149,5745,-67,-97,30,6a:1e:a4:f8:14:49,296633160,284,14570,296632876,296633160
22070,5,6,149,5745,-88,-97,9,54:e4:3a:ec:fb:65,296636882,360,3362,296636522,296636882
22071,5,12,149,5745,-84,-97,13,9a:24:38:da:96:bb,296639320,272,2166,296639048,296639320
22072,5,12,149,5745,-52,-97,45,4a:86:35:36:74:b8,296645626,268,6038,296645358,296645626
22073,5,12,149,5745,-72,-97,25,f2:da:61:dd:98:c5,296650185,268,4291,296649917,296650185
22074,5,12,149,5745,-69,-97,28,72:d1:72:1d:22:a1,296661533,284,11064,296661249,296661533
22075,5,12,149,5745,-86,-97,11,42:d2:d9:2b:ac:61,296674772,260,12979,296674512,296674772
22076,5,12,149,5745,-71,-97,26,d2:00:04:7e:2c:ab,296677107,244,2091,296676863,296677107
22077,5,12,149,5745,-66,-97,31,5e:29:73:5b:30:00,296682311,272,4932,296682039,296682311
22078,5,12,149,5745,-51,-97,46,3e:d1:9b:c7:a4:de,296684342,272,1759,296684070,296684342
22079,5,12,149,5745,-93,-97,4,4e:72:d0:f1:a2:44,296710826,244,26240,296710582,296710826
22080,5,12,149,5745,-61,-97,36,22:ec:75:a8:8a:31,296720986,244,9916,296720742,296720986
22081,5,12,149,5745,-63,-97,34,f6:0a:5c:59:72:df,296722652,280,1386,296722372,296722652
22082,5,6,149,5745,-88,-97,9,54:e4:3a:ec:fb:65,296739283,360,16271,296738923,296739283
22083,5,12,149,5745,-84,-97,13,9a:24:38:da:96:bb,296745477,272,5922,296745205,296745477
22084,5,12,149,5745,-68,-97,29,6a:1e:a4:f8:14:49,296751930,284,6169,296751646,296751930
22085,5,12,149,5745,-54,-97,43,4a:86:35:36:74:b8,296756685,268,4487,296756417,296756685
22086,5,12,149,5745,-57,-97,40,b6:90:18:f6:b1:d4,296763467,268,6514,296763199,296763467
22087,5,12,149,5745,-67,-97,30,56:68:e2:c2:8d:d5,296764426,280,679,296764146,296764426
22088,5,12,149,5745,-69,-97,28,72:d1:72:1d:22:a1,296764948,284,238,296764664,296764948
22089,5,12,149,5745,-72,-97,25,f2:da:61:dd:98:c5,296772832,268,7616,296772564,296772832
22090,5,12,149,5745,-86,-97,11,42:d2:d9:2b:ac:61,296777680,260,4588,296777420,296777680
22091,5,12,149,5745,-91,-97,6,de:be:a8:cd:79:57,296780777,284,2813,296780493,296780777
22092,5,12,149,5745,-67,-97,30,5e:29:73:5b:30:00,296794487,272,13438,296794215,296794487
22093,5,12,149,5745,-55,-97,42,3e:d1:9b:c7:a4:de,296796080,272,1321,296795808,296796080
22094,5,12,149,5745,-73,-97,24,d2:00:04:7e:2c:ab,296796521,244,197,296796277,296796521
22095,5,12,149,5745,-68,-97,29,56:68:e2:c2:8d:d5,296798986,280,2185,296798706,296798986
22096,5,12,149,5745,-57,-97,40,b6:90:18:f6:b1:d4,296804334,268,5080,296804066,296804334
22097,5,12,149,5745,-91,-97,6,de:be:a8:cd:79:57,296806513,284,1895,296806229,296806513
22098,5,12,149,5745,-64,-97,33,f6:0a:5c:59:72:df,296817651,280,10858,296817371,296817651
22099,5,12,149,5745,-86,-97,11,42:d2:d9:2b:ac:61,296819795,260,1884,296819535,296819795
22100,5,12,149,5745,-66,-97,31,22:ec:75:a8:8a:31,296834705,516,14394,296834189,296834705
22101,5,12,149,5745,-63,-97,34,f6:0a:5c:59:72:df,296836463,476,1282,296835987,296836463
22102,5,12,149,5745,-52,-97,45,4a:86:35:36:74:b8,296838000,268,1269,296837732,296838000
22103,5,12,149,5745,-59,-97,38,3e:d1:9b:c7:a4:de,296840219,544,1675,296839675,296840219
22104,5,12,149,5745,-59,-97,38,2a:07:ef:54:b5:55,296840853,440,194,296840413,296840853
22105,5,12,149,5745,-57,-97,40,b6:90:18:f6:b1:d4,296841831,268,710,296841563,296841831
22106,5,12,149,5745,-74,-97,23,d2:00:04:7e:2c:ab,296842216,440,-55,296841776,296842216
22107,5,12,149,5745,-71,-97,26,72:d1:72:1d:22:a1,296843537,480,841,296843057,296843537
22108,5,12,149,5745,-66,-97,31,22:ec:75:a8:8a:31,296847423,244,3642,296847179,296847423
22109,5,12,149,5745,-71,-97,26,72:d1:72:1d:22:a1,296848988,284,1281,296848704,296848988
22110,5,12,149,5745,-67,-97,30,6a:1e:a4:f8:14:49,296849303,284,31,296849019,296849303
22111,5,12,149,5745,-85,-97,12,42:d2:d9:2b:ac:61,296851343,456,1584,296850887,296851343
22112,5,12,149,5745,-68,-97,29,5e:29:73:5b:30:00,296853194,540,1311,296852654,296853194
22113,5,12,149,5745,-69,-97,28,56:68:e2:c2:8d:d5,296855874,476,2204,296855398,296855874
22114,5,12,149,5745,-67,-97,30,6a:1e:a4:f8:14:49,296856403,480,49,296855923,296856403
22115,5,12,149,5745,-86,-97,11,9a:24:38:da:96:bb,296856944,272,269,296856672,296856944
22116,5,12,149,5745,-53,-97,44,4a:86:35:36:74:b8,296864802,268,7590,296864534,296864802
22117,5,12,149,5745,-72,-97,25,f2:da:61:dd:98:c5,296865302,268,232,296865034,296865302
22118,5,12,149,5745,-72,-97,25,f2:da:61:dd:98:c5,296867558,268,1988,296867290,296867558
22119,5,12,149,5745,-72,-97,25,d2:00:04:7e:2c:ab,296898091,244,30289,296897847,296898091
22120,5,12,149,5745,-64,-97,33,22:ec:75:a8:8a:31,296899548,516,941,296899032,296899548
22121,5,12,149,5745,-65,-97,32,f6:0a:5c:59:72:df,296900499,476,475,296900023,296900499
22122,5,12,149,5745,-71,-97,26,56:68:e2:c2:8d:d5,296901018,280,239,296900738,296901018
22123,5,12,149,5745,-55,-97,42,4a:86:35:36:74:b8,296901370,268,84,296901102,296901370
22124,5,12,149,5745,-62,-97,35,2a:07:ef:54:b5:55,296903150,440,1340,296902710,296903150
22125,5,12,149,5745,-58,-97,39,3e:d1:9b:c7:a4:de,296904578,544,884,296904034,296904578
22126,5,12,149,5745,-61,-97,36,0a:b9:b7:b1:4d:fa,296905642,268,796,296905374,296905642
22127,5,12,149,5745,-71,-97,26,56:68:e2:c2:8d:d5,296905999,268,89,296905731,296905999
22128,5,12,149,5745,-65,-97,32,f6:0a:5c:59:72:df,296906454,268,187,296906186,296906454
22129,5,12,149,5745,-69,-97,28,72:d1:72:1d:22:a1,296906784,480,-150,296906304,296906784
22130,5,12,149,5745,-58,-97,39,b6:90:18:f6:b1:d4,296907354,268,302,296907086,296907354
22131,5,12,149,5745,-88,-97,9,7e:05:42:11:d2:ec,296911021,440,3227,296910581,296911021
22132,5,12,149,5745,-92,-97,5,3a:90:78:0e:4f:1f,296912157,256,880,296911901,296912157
22133,5,12,149,5745,-64,-97,33,a6:92:ad:b7:76:65,296912791,484,150,296912307,296912791
22134,5,12,149,5745,-93,-97,4,42:43:08:e8:5d:e9,296913309,440,78,296912869,296913309
22135,5,12,149,5745,-58,-97,39,b6:90:18:f6:b1:d4,296913792,268,215,296913524,296913792
22136,5,12,149,5745,-72,-97,25,f2:da:61:dd:98:c5,296914778,268,718,296914510,296914778
22137,5,12,149,5745,-67,-97,30,5e:29:73:5b:30:00,296915701,272,651,296915429,296915701
22138,5,12,149,5745,-92,-97,5,de:be:a8:cd:79:57,296916148,284,163,296915864,296916148
22139,5,12,149,5745,-68,-97,29,6a:1e:a4:f8:14:49,296917696,480,1068,296917216,296917696
22140,5,12,149,5745,-68,-97,29,5e:29:73:5b:30:00,296918256,540,20,296917716,296918256
22141,5,12,149,5745,-86,-97,11,42:d2:d9:2b:ac:61,296918828,456,116,296918372,296918828
22142,5,12,149,5745,-73,-97,24,d2:00:04:7e:2c:ab,296920282,440,1014,296919842,296920282
22143,5,12,149,5745,-71,-97,26,56:68:e2:c2:8d:d5,296921333,476,575,296920857,296921333
22144,5,12,149,5745,-91,-97,6,de:be:a8:cd:79:57,296923182,480,1369,296922702,296923182
22145,5,12,149,5745,-92,-97,5,3a:90:78:0e:4f:1f,296924031,452,397,296923579,296924031
22146,5,12,149,5745,-87,-97,10,42:d2:d9:2b:ac:61,296932990,260,8699,296932730,296932990
22147,5,6,149,5745,-90,-97,7,54:e4:3a:ec:fb:65,296944084,360,10734,296943724,296944084
22148,5,12,149,5745,-63,-97,34,22:ec:75:a8:8a:31,296947279,244,2951,296947035,296947279
22149,5,12,149,5745,-91,-97,6,42:43:08:e8:5d:e9,296950409,244,2886,296950165,296950409
22150,5,12,149,5745,-86,-97,11,9a:24:38:da:96:bb,296969529,272,18848,296969257,296969529
22151,5,12,149,5745,-66,-97,31,6a:1e:a4:f8:14:49,296977726,284,7913,296977442,296977726
22152,5,12,149,5745,-71,-97,26,72:d1:72:1d:22:a1,296978297,284,287,296978013,296978297
22153,5,12,149,5745,-55,-97,42,4a:86:35:36:74:b8,296983668,268,5103,296983400,296983668
22154,5,12,149,5745,-71,-97,26,f2:da:61:dd:98:c5,296988923,268,4987,296988655,296988923
22155,5,12,149,5745,-69,-97,28,5e:29:73:5b:30:00,297024174,272,34979,297023902,297024174
22156,5,12,149,5745,-53,-97,44,3e:d1:9b:c7:a4:de,297025505,272,1059,297025233,297025505
22157,5,6,149,5745,-90,-97,7,54:e4:3a:ec:fb:65,297046485,360,20620,297046125,297046485
22158,5,12,149,5745,-89,-97,8,42:d2:d9:2b:ac:61,297054477,260,7732,297054217,297054477
22159,5,12,149,5745,-65,-97,32,22:ec:75:a8:8a:31,297063529,244,8808,297063285,297063529
22160,5,12,149,5745,-73,-97,24,d2:00:04:7e:2c:ab,297070912,244,7139,297070668,297070912
22161,5,12,149,5745,-57,-97,40,b6:90:18:f6:b1:d4,297071614,268,434,297071346,297071614
22162,5,12,149,5745,-67,-97,30,56:68:e2:c2:8d:d5,297073213,280,1319,297072933,297073213
22163,5,12,149,5745,-67,-97,30,2a:07:ef:54:b5:55,297073615,244,158,297073371,297073615
22164,5,12,149,5745,-87,-97,10,9a:24:38:da:96:bb,297081280,272,7393,297081008,297081280
22165,5,12,149,5745,-68,-97,29,72:d1:72:1d:22:a1,297087173,284,5609,297086889,297087173
22166,5,12,149,5745,-88,-97,9,7e:05:42:11:d2:ec,297106007,440,18394,297105567,297106007
22167,5,6,149,5745,-85,-97,12,74:a2:e6:07:08:d0,297114875,168,8700,297114707,297114875
22168,5,6,149,5745,-89,-97,8,74:a2:e6:07:08:d0,297118101,132,3094,297117969,297118101
22169,5,12,149,5745,-67,-97,30,5e:29:73:5b:30:00,297137303,272,18930,297137031,297137303
22170,5,12,149,5745,-52,-97,45,3e:d1:9b:c7:a4:de,297142808,272,5233,297142536,297142808
22171,5,12,149,5745,-69,-97,28,6a:1e:a4:f8:14:49,297146181,284,3089,297145897,297146181
22172,5,6,149,5745,-90,-97,7,54:e4:3a:ec:fb:65,297148885,360,2344,297148525,297148885
22173,5,12,149,5745,-52,-97,45,4a:86:35:36:74:b8,297150097,268,944,297149829,297150097
22174,5,12,149,5745,-71,-97,26,f2:da:61:dd:98:c5,297151701,268,1336,297151433,297151701
22175,5,12,149,5745,-62,-97,35,f6:0a:5c:59:72:df,297168310,280,16329,297168030,297168310
22176,5,12,149,5745,-75,-97,22,d2:00:04:7e:2c:ab,297172387,244,3833,297172143,297172387
22177,5,12,149,5745,-67,-97,30,56:68:e2:c2:8d:d5,297174349,280,1682,297174069,297174349
22178,5,12,149,5745,-59,-97,38,b6:90:18:f6:b1:d4,297175351,268,734,297175083,297175351
22179,5,12,149,5745,-64,-97,33,22:ec:75:a8:8a:31,297176462,244,867,297176218,297176462
22180,5,24,149,5745,-86,-97,11,,297184045,32,7551,297184013,297184045
22181,5,24,149,5745,-86,-97,11,,297184413,28,340,297184385,297184413
22182,5,24,149,5745,-85,-97,12,,297185360,32,915,297185328,297185360
22183,5,12,149,5745,-89,-97,8,42:d2:d9:2b:ac:61,297186965,260,1345,297186705,297186965
22184,5,12,149,5745,-86,-97,11,9a:24:38:da:96:bb,297193969,272,6732,297193697,297193969
22185,5,12,149,5745,-71,-97,26,6a:1e:a4:f8:14:49,297248589,284,54336,297248305,297248589
22186,5,6,149,5745,-90,-97,7,54:e4:3a:ec:fb:65,297251285,360,2336,297250925,297251285
22187,5,12,149,5745,-53,-97,44,4a:86:35:36:74:b8,297252611,268,1058,297252343,297252611
22188,5,12,149,5745,-73,-97,24,f2:da:61:dd:98:c5,297252992,268,113,297252724,297252992
22189,5,12,149,5745,-65,-97,32,5e:29:73:5b:30:00,297255267,272,2003,297254995,297255267
22190,5,12,149,5745,-56,-97,41,3e:d1:9b:c7:a4:de,297259362,272,3823,297259090,297259362
22191,5,12,149,5745,-59,-97,38,b6:90:18:f6:b1:d4,297261593,268,1963,297261325,297261593
22192,5,12,149,5745,-67,-97,30,72:d1:72:1d:22:a1,297277025,284,15148,297276741,297277025
22193,5,12,149,5745,-73,-97,24,d2:00:04:7e:2c:ab,297277478,244,209,297277234,297277478
22194,5,12,149,5745,-66,-97,31,56:68:e2:c2:8d:d5,297278044,280,286,297277764,297278044
22195,5,12,149,5745,-91,-97,6,42:d2:d9:2b:ac:61,297280909,260,2605,297280649,297280909
22196,5,12,149,5745,-71,-97,26,6a:1e:a4:f8:14:49,297291675,284,10482,297291391,297291675
22197,5,12,149,5745,-55,-97,42,4a:86:35:36:74:b8,297294236,268,2293,297293968,297294236
22198,5,12,149,5745,-65,-97,32,22:ec:75:a8:8a:31,297294538,516,-214,297294022,297294538
22199,5,12,149,5745,-64,-97,33,f6:0a:5c:59:72:df,297295124,476,110,297294648,297295124
22200,5,12,149,5745,-67,-97,30,2a:07:ef:54:b5:55,297298191,440,2627,297297751,297298191
22201,5,12,149,5745,-59,-97,38,b6:90:18:f6:b1:d4,297299628,268,1169,297299360,297299628
22202,5,12,149,5745,-59,-97,38,3e:d1:9b:c7:a4:de,297300822,544,650,297300278,297300822
22203,5,12,149,5745,-67,-97,30,72:d1:72:1d:22:a1,297301406,480,104,297300926,297301406
22204,5,12,149,5745,-87,-97,10,9a:24:38:da:96:bb,297304967,272,3289,297304695,297304967
22205,5,12,149,5745,-64,-97,33,22:ec:75:a8:8a:31,297306211,244,1000,297305967,297306211
22206,5,12,149,5745,-56,-97,41,4a:86:35:36:74:b8,297307625,268,1146,297307357,297307625
22207,5,12,149,5745,-66,-97,31,72:d1:72:1d:22:a1,297307983,284,74,297307699,297307983
22208,5,12,149,5745,-74,-97,23,f2:da:61:dd:98:c5,297309144,268,893,297308876,297309144
22209,5,12,149,5745,-67,-97,30,2a:07:ef:54:b5:55,297310308,284,880,297310024,297310308
22210,5,12,149,5745,-68,-97,29,2a:07:ef:54:b5:55,297310698,372,18,297310326,297310698
22211,5,12,149,5745,-73,-97,24,d2:00:04:7e:2c:ab,297311413,284,431,297311129,297311413
22212,5,12,149,5745,-72,-97,25,d2:00:04:7e:2c:ab,297311742,104,225,297311638,297311742
22213,5,12,149,5745,-91,-97,6,42:d2:d9:2b:ac:61,297312364,456,166,297311908,297312364
22214,5,12,149,5745,-72,-97,25,d2:00:04:7e:2c:ab,297314321,440,1517,297313881,297314321
22215,5,12,149,5745,-65,-97,32,5e:29:73:5b:30:00,297314795,540,-66,297314255,297314795
22216,5,12,149,5745,-71,-97,26,6a:1e:a4:f8:14:49,297315964,480,689,297315484,297315964
22217,5,12,149,5745,-67,-97,30,56:68:e2:c2:8d:d5,297317108,476,668,297316632,297317108
22218,5,12,149,5745,-91,-97,6,3a:90:78:0e:4f:1f,297323201,452,5641,297322749,297323201
22219,5,12,149,5745,-75,-97,22,f2:da:61:dd:98:c5,297324053,268,584,297323785,297324053
22220,5,12,149,5745,-71,-97,26,d2:00:04:7e:2c:ab,297341556,244,17259,297341312,297341556
22221,5,6,149,5745,-88,-97,9,54:e4:3a:ec:fb:65,297353686,360,11770,297353326,297353686
22222,5,6,149,5745,-79,-97,18,60:dd:8e:b5:da:79,297358652,216,4750,297358436,297358652
22223,5,6,149,5745,-89,-97,8,54:e4:3a:ec:fb:65,297359017,352,13,297358665,297359017
22224,5,6,149,5745,-80,-97,17,,297359385,44,324,297359341,297359385
22225,5,12,149,5745,-58,-97,39,b6:90:18:f6:b1:d4,297364947,268,5294,297364679,297364947
22226,5,12,149,5745,-57,-97,40,b6:90:18:f6:b1:d4,297371831,268,6616,297371563,297371831
22227,5,12,149,5745,-65,-97,32,5e:29:73:5b:30:00,297372356,272,253,297372084,297372356
22228,5,12,149,5745,-56,-97,41,3e:d1:9b:c7:a4:de,297377053,272,4425,297376781,297377053
22229,5,12,149,5745,-67,-97,30,2a:07:ef:54:b5:55,297378666,440,1173,297378226,297378666
22230,5,12,149,5745,-66,-97,31,56:68:e2:c2:8d:d5,297380399,280,1453,297380119,297380399
22231,5,12,149,5745,-71,-97,26,d2:00:04:7e:2c:ab,297387723,412,6912,297387311,297387723
22232,5,12,149,5745,-90,-97,7,42:d2:d9:2b:ac:61,297394606,260,6623,297394346,297394606
22233,5,12,149,5745,-88,-97,9,7e:05:42:11:d2:ec,297406143,244,11293,297405899,297406143
22234,5,12,149,5745,-86,-97,11,9a:24:38:da:96:bb,297416658,272,10243,297416386,297416658
22235,5,12,149,5745,-70,-97,27,6a:1e:a4:f8:14:49,297419401,284,2459,297419117,297419401
22236,5,12,149,5745,-63,-97,34,22:ec:75:a8:8a:31,297420803,244,1158,297420559,297420803
22237,5,12,149,5745,-54,-97,43,4a:86:35:36:74:b8,297422217,268,1146,297421949,297422217
22238,5,12,149,5745,-64,-97,33,22:ec:75:a8:8a:31,297424032,516,1299,297423516,297424032
22239,5,12,149,5745,-54,-97,43,4a:86:35:36:74:b8,297427806,268,3506,297427538,297427806
22240,5,12,149,5745,-66,-97,31,0a:b9:b7:b1:4d:fa,297428270,268,196,297428002,297428270
22241,5,12,149,5745,-57,-97,40,b6:90:18:f6:b1:d4,297431352,268,2814,297431084,297431352
22242,5,12,149,5745,-59,-97,38,3e:d1:9b:c7:a4:de,297431708,544,-188,297431164,297431708
22243,5,12,149,5745,-70,-97,27,d2:00:04:7e:2c:ab,297433304,412,1184,297432892,297433304
22244,5,12,149,5745,-63,-97,34,a6:92:ad:b7:76:65,297437411,484,3623,297436927,297437411
22245,5,12,149,5745,-69,-97,28,f2:da:61:dd:98:c5,297438993,268,1314,297438725,297438993
22246,5,12,149,5745,-88,-97,9,9a:24:38:da:96:bb,297439332,824,-485,297438508,297439332
22247,5,12,149,5745,-69,-97,28,f2:da:61:dd:98:c5,297441378,268,1778,297441110,297441378
22248,5,12,149,5745,-64,-97,33,2a:07:ef:54:b5:55,297444596,440,2778,297444156,297444596
22249,5,12,149,5745,-93,-97,4,de:be:a8:cd:79:57,297447744,480,2668,297447264,297447744
22250,5,12,149,5745,-70,-97,27,d2:00:04:7e:2c:ab,297455143,244,7155,297454899,297455143
22251,5,6,149,5745,-90,-97,7,54:e4:3a:ec:fb:65,297456086,360,583,297455726,297456086
22252,5,12,149,5745,-57,-97,40,b6:90:18:f6:b1:d4,297470506,268,14152,297470238,297470506
22253,5,12,149,5745,-64,-97,33,72:d1:72:1d:22:a1,297480661,284,9871,297480377,297480661
22254,5,12,149,5745,-66,-97,31,56:68:e2:c2:8d:d5,297481361,280,420,297481081,297481361
22255,5,12,149,5745,-64,-97,33,5e:29:73:5b:30:00,297489177,272,7544,297488905,297489177
22256,5,12,149,5745,-59,-97,38,3e:d1:9b:c7:a4:de,297489551,272,102,297489279,297489551
22257,5,12,149,5745,-93,-97,4,de:be:a8:cd:79:57,297490141,284,306,297489857,297490141
22258,5,12,149,5745,-90,-97,7,42:d2:d9:2b:ac:61,297505580,260,15179,297505320,297505580
22259,5,12,149,5745,-65,-97,32,f6:0a:5c:59:72:df,297506245,280,385,297505965,297506245
22260,5,12,149,5745,-61,-97,36,22:ec:75:a8:8a:31,297519602,244,13113,297519358,297519602
22261,5,12,149,5745,-88,-97,9,9a:24:38:da:96:bb,297529441,272,9567,297529169,297529441
22262,5,12,149,5745,-54,-97,43,4a:86:35:36:74:b8,297549468,268,19759,297549200,297549468
22263,5,12,149,5745,-68,-97,29,6a:1e:a4:f8:14:49,297555647,284,5895,297555363,297555647
22264,5,12,149,5745,-72,-97,25,f2:da:61:dd:98:c5,297557831,268,1916,297557563,297557831
22265,5,6,149,5745,-88,-97,9,54:e4:3a:ec:fb:65,297558487,360,296,297558127,297558487
22266,5,12,149,5745,-69,-97,28,72:d1:72:1d:22:a1,297583161,284,24390,297582877,297583161
22267,5,12,149,5745,-69,-97,28,56:68:e2:c2:8d:d5,297583678,280,237,297583398,297583678
22268,5,6,149,5745,-64,-97,33,f0:b6:1e:7d:79:f9,297598307,220,14409,297598087,297598307
22269,5,12,149,5745,-59,-97,38,b6:90:18:f6:b1:d4,297599033,268,458,297598765,297599033
22270,5,12,149,5745,-55,-97,42,3e:d1:9b:c7:a4:de,297603185,272,3880,297602913,297603185
22271,5,12,149,5745,-63,-97,34,5e:29:73:5b:30:00,297604065,272,608,297603793,297604065
22272,5,12,149,5745,-86,-97,11,7e:05:42:11:d2:ec,297605425,244,1116,297605181,297605425
22273,5,12,149,5745,-92,-97,5,de:be:a8:cd:79:57,297612113,284,6404,297611829,297612113
22274,5,6,149,5745,-64,-97,33,f0:b6:1e:7d:79:f9,297613318,220,985,297613098,297613318
22275,5,12,149,5745,-63,-97,34,f6:0a:5c:59:72:df,297616390,280,2792,297616110,297616390
22276,5,12,149,5745,-63,-97,34,22:ec:75:a8:8a:31,297636839,244,20205,297636595,297636839
22277,5,12,149,5745,-87,-97,10,9a:24:38:da:96:bb,297641163,272,4052,297640891,297641163
22278,5,6,149,5745,-89,-97,8,54:e4:3a:ec:fb:65,297660888,360,19365,297660528,297660888
22279,5,12,149,5745,-66,-97,31,6a:1e:a4:f8:14:49,297661276,284,104,297660992,297661276
22280,5,12,149,5745,-52,-97,45,4a:86:35:36:74:b8,297663618,268,2074,297663350,297663618
22281,5,12,149,5745,-67,-97,30,f2:da:61:dd:98:c5,297671935,268,8049,297671667,297671935
22282,5,24,149,5745,-81,-97,16,,297677039,28,5076,297677011,297677039
22283,5,24,149,5745,-84,-97,13,,297677083,28,16,297677055,297677083
22284,5,24,149,5745,-84,-97,13,,297677196,32,81,297677164,297677196
22285,5,24,149,5745,-84,-97,13,,297678372,28,1148,297678344,297678372
22286,5,24,149,5745,-80,-97,17,,297678416,28,16,297678388,297678416
22287,5,24,149,5745,-81,-97,16,,297678524,32,76,297678492,297678524
22288,5,24,149,5745,-83,-97,14,,297678713,28,161,297678685,297678713
22289,5,24,149,5745,-81,-97,16,,297678758,28,17,297678730,297678758
22290,5,24,149,5745,-81,-97,16,,297678869,32,79,297678837,297678869
22291,5,24,149,5745,-81,-97,16,,297681695,28,2798,297681667,297681695
22292,5,24,149,5745,-83,-97,14,,297681739,28,16,297681711,297681739
22293,5,24,149,5745,-84,-97,13,,297681859,32,88,297681827,297681859
22294,5,24,149,5745,-81,-97,16,,297682936,28,1049,297682908,297682936
22295,5,24,149,5745,-84,-97,13,,297682980,28,16,297682952,297682980
22296,5,24,149,5745,-83,-97,14,,297683105,32,93,297683073,297683105
22297,5,24,149,5745,-80,-97,17,,297684164,28,1031,297684136,297684164
22298,5,24,149,5745,-83,-97,14,,297684208,28,16,297684180,297684208
22299,5,24,149,5745,-83,-97,14,,297684324,32,84,297684292,297684324
22300,5,12,149,5745,-68,-97,29,72:d1:72:1d:22:a1,297685480,284,872,297685196,297685480
22301,5,12,149,5745,-86,-97,11,42:d2:d9:2b:ac:61,297698842,260,13102,297698582,297698842
22302,5,12,149,5745,-68,-97,29,56:68:e2:c2:8d:d5,297703626,280,4504,297703346,297703626
22303,5,24,149,5745,-82,-97,15,,297703959,28,305,297703931,297703959
22304,5,24,149,5745,-80,-97,17,,297704003,28,16,297703975,297704003
22305,5,24,149,5745,-80,-97,17,,297704129,32,94,297704097,297704129
22306,5,24,149,5745,-82,-97,15,,297704516,28,359,297704488,297704516
22307,5,24,149,5745,-80,-97,17,,297704560,28,16,297704532,297704560
22308,5,24,149,5745,-80,-97,17,,297704668,32,76,297704636,297704668
22309,5,24,149,5745,-80,-97,17,,297704780,32,80,297704748,297704780
22310,5,12,149,5745,-86,-97,11,7e:05:42:11:d2:ec,297704846,244,-178,297704602,297704846
22311,5,24,149,5745,-80,-97,17,,297707076,28,2202,297707048,297707076
22312,5,24,149,5745,-81,-97,16,,297707120,28,16,297707092,297707120
22313,5,24,149,5745,-82,-97,15,,297707233,32,81,297707201,297707233
22314,5,12,149,5745,-66,-97,31,5e:29:73:5b:30:00,297720157,272,12652,297719885,297720157
22315,5,12,149,5745,-56,-97,41,3e:d1:9b:c7:a4:de,297720517,272,88,297720245,297720517
22316,5,24,149,5745,-81,-97,16,,297721682,28,1137,297721654,297721682
22317,5,24,149,5745,-80,-97,17,,297721726,28,16,297721698,297721726
22318,5,24,149,5745,-80,-97,17,,297721834,32,76,297721802,297721834
22319,5,24,149,5745,-81,-97,16,,297721946,32,80,297721914,297721946
22320,5,24,149,5745,-80,-97,17,,297724613,28,2639,297724585,297724613
22321,5,24,149,5745,-82,-97,15,,297724657,28,16,297724629,297724657
22322,5,24,149,5745,-81,-97,16,,297724766,32,77,297724734,297724766
22323,5,12,149,5745,-64,-97,33,22:ec:75:a8:8a:31,297751495,244,26485,297751251,297751495
22324,5,24,149,5745,-81,-97,16,,297753464,28,1941,297753436,297753464
22325,5,24,149,5745,-84,-97,13,,297753508,28,16,297753480,297753508
22326,5,24,149,5745,-84,-97,13,,297753617,32,77,297753585,297753617
22327,5,12,149,5745,-86,-97,11,9a:24:38:da:96:bb,297753902,272,13,297753630,297753902
22328,5,12,149,5745,-64,-97,33,6a:1e:a4:f8:14:49,297760447,284,6261,297760163,297760447
22329,5,6,149,5745,-90,-97,7,54:e4:3a:ec:fb:65,297763288,360,2481,297762928,297763288
22330,5,12,149,5745,-52,-97,45,4a:86:35:36:74:b8,297776120,268,12564,297775852,297776120
22331,5,12,149,5745,-73,-97,24,f2:da:61:dd:98:c5,297782377,268,5989,297782109,297782377
22332,5,12,149,5745,-57,-97,40,b6:90:18:f6:b1:d4,297787551,268,4906,297787283,297787551
22333,5,12,149,5745,-71,-97,26,72:d1:72:1d:22:a1,297788008,284,173,297787724,297788008
22334,5,24,149,5745,-84,-97,13,,297800981,32,12941,297800949,297800981
22335,5,12,149,5745,-87,-97,10,42:d2:d9:2b:ac:61,297801125,260,-116,297800865,297801125
22336,5,24,149,5745,-84,-97,13,,297801909,32,752,297801877,297801909
22337,5,12,149,5745,-68,-97,29,56:68:e2:c2:8d:d5,297804340,280,2151,297804060,297804340
22338,5,12,149,5745,-88,-97,9,7e:05:42:11:d2:ec,297806248,244,1664,297806004,297806248
22339,5,24,149,5745,-85,-97,12,,297818800,32,12520,297818768,297818800
22340,5,24,149,5745,-83,-97,14,,297819078,28,250,297819050,297819078
22341,5,12,149,5745,-57,-97,40,b6:90:18:f6:b1:d4,297825054,268,5708,297824786,297825054
22342,5,12,149,5745,-64,-97,33,5e:29:73:5b:30:00,297831959,272,6633,297831687,297831959
22343,5,12,149,5745,-55,-97,42,3e:d1:9b:c7:a4:de,297832259,272,28,297831987,297832259
22344,5,24,149,5745,-85,-97,12,,297841383,28,9096,297841355,297841383
22345,5,24,149,5745,-80,-97,17,,297841427,28,16,297841399,297841427
22346,5,24,149,5745,-80,-97,17,,297841556,32,97,297841524,297841556
22347,5,24,149,5745,-85,-97,12,,297841833,28,249,297841805,297841833
22348,5,24,149,5745,-85,-97,12,,297841950,28,89,297841922,297841950
22349,5,24,149,5745,-80,-97,17,,297841994,28,16,297841966,297841994
22350,5,24,149,5745,-80,-97,17,,297842220,32,194,297842188,297842220
22351,5,24,149,5745,-85,-97,12,,297846752,28,4504,297846724,297846752
22352,5,24,149,5745,-80,-97,17,,297846796,28,16,297846768,297846796
22353,5,24,149,5745,-80,-97,17,,297846915,32,87,297846883,297846915
22354,5,24,149,5745,-80,-97,17,,297847037,32,90,297847005,297847037
22355,5,24,149,5745,-84,-97,13,,297847177,28,112,297847149,297847177
22356,5,24,149,5745,-81,-97,16,,297847221,28,16,297847193,297847221
22357,5,24,149,5745,-80,-97,17,,297847340,32,87,297847308,297847340
22358,5,24,149,5745,-80,-97,17,,297847696,28,328,297847668,297847696
22359,5,24,149,5745,-85,-97,12,,297847740,28,16,297847712,297847740
22360,5,24,149,5745,-85,-97,12,,297847869,32,97,297847837,297847869
22361,5,24,149,5745,-85,-97,12,,297848485,28,588,297848457,297848485
22362,5,24,149,5745,-80,-97,17,,297848529,28,16,297848501,297848529
22363,5,24,149,5745,-80,-97,17,,297848648,32,87,297848616,297848648
22364,5,24,149,5745,-85,-97,12,,297848829,28,153,297848801,297848829
22365,5,24,149,5745,-80,-97,17,,297848873,28,16,297848845,297848873
22366,5,24,149,5745,-80,-97,17,,297848981,32,76,297848949,297848981
22367,5,12,149,5745,-87,-97,10,42:d2:d9:2b:ac:61,297849210,260,-31,297848950,297849210
22368,5,24,149,5745,-80,-97,17,,297849576,28,338,297849548,297849576
22369,5,24,149,5745,-80,-97,17,,297849801,28,197,297849773,297849801
22370,5,24,149,5745,-80,-97,17,,297850404,28,575,297850376,297850404
22371,5,24,149,5745,-85,-97,12,,297850448,28,16,297850420,297850448
22372,5,24,149,5745,-84,-97,13,,297850560,32,80,297850528,297850560
22373,5,12,149,5745,-66,-97,31,6a:1e:a4:f8:14:49,297861657,284,10813,297861373,297861657
22374,5,24,149,5745,-84,-97,13,,297862089,28,404,297862061,297862089
22375,5,24,149,5745,-80,-97,17,,297862133,28,16,297862105,297862133
22376,5,24,149,5745,-80,-97,17,,297862241,32,76,297862209,297862241
22377,5,24,149,5745,-84,-97,13,,297863056,32,783,297863024,297863056
22378,5,24,149,5745,-83,-97,14,,297863173,32,85,297863141,297863173
22379,5,12,149,5745,-84,-97,13,9a:24:38:da:96:bb,297864773,272,1328,297864501,297864773
22380,5,6,149,5745,-89,-97,8,54:e4:3a:ec:fb:65,297865689,360,556,297865329,297865689
22381,5,12,149,5745,-89,-97,8,7e:05:42:11:d2:ec,297866470,244,537,297866226,297866470
22382,5,12,149,5745,-63,-97,34,22:ec:75:a8:8a:31,297879629,244,12915,297879385,297879629
22383,5,24,149,5745,-80,-97,17,,297879934,28,277,297879906,297879934
22384,5,24,149,5745,-84,-97,13,,297879978,28,16,297879950,297879978
22385,5,24,149,5745,-84,-97,13,,297880087,32,77,297880055,297880087
22386,5,12,149,5745,-52,-97,45,4a:86:35:36:74:b8,297880464,268,109,297880196,297880464
22387,5,12,149,5745,-65,-97,32,72:d1:72:1d:22:a1,297881164,284,416,297880880,297881164
22388,5,12,149,5745,-69,-97,28,f2:da:61:dd:98:c5,297881482,268,50,297881214,297881482
22389,5,12,149,5745,-63,-97,34,22:ec:75:a8:8a:31,297882378,516,380,297881862,297882378
22390,5,12,149,5745,-61,-97,36,f6:0a:5c:59:72:df,297884850,476,1996,297884374,297884850
22391,5,12,149,5745,-51,-97,46,4a:86:35:36:74:b8,297886424,268,1306,297886156,297886424
22392,5,12,149,5745,-59,-97,38,3e:d1:9b:c7:a4:de,297891269,544,4301,297890725,297891269
22393,5,12,149,5745,-65,-97,32,72:d1:72:1d:22:a1,297891867,480,118,297891387,297891867
22394,5,12,149,5745,-90,-97,7,42:d2:d9:2b:ac:61,297898927,456,6604,297898471,297898927
22395,5,12,149,5745,-68,-97,29,f2:da:61:dd:98:c5,297900623,268,1428,297900355,297900623
22396,5,12,149,5745,-68,-97,29,6a:1e:a4:f8:14:49,297901618,480,515,297901138,297901618
22397,5,12,149,5745,-65,-97,32,5e:29:73:5b:30:00,297902186,540,28,297901646,297902186
22398,5,12,149,5745,-59,-97,38,b6:90:18:f6:b1:d4,297903318,268,864,297903050,297903318
22399,5,12,149,5745,-64,-97,33,2a:07:ef:54:b5:55,297903872,440,114,297903432,297903872
22400,5,12,149,5745,-67,-97,30,56:68:e2:c2:8d:d5,297907118,476,2770,297906642,297907118
22401,5,12,149,5745,-92,-97,5,3a:90:78:0e:4f:1f,297910392,452,2822,297909940,297910392
22402,5,24,149,5745,-84,-97,13,,297913462,32,3038,297913430,297913462
22403,5,12,149,5745,-67,-97,30,56:68:e2:c2:8d:d5,297913813,280,71,297913533,297913813
22404,5,24,149,5745,-83,-97,14,,297920405,32,6560,297920373,297920405
22405,5,24,149,5745,-84,-97,13,,297920737,28,304,297920709,297920737
22406,5,24,149,5745,-83,-97,14,,297922066,32,1297,297922034,297922066
22407,5,24,149,5745,-83,-97,14,,297922537,32,439,297922505,297922537
22408,5,12,149,5745,-91,-97,6,3a:90:78:0e:4f:1f,297926683,256,3890,297926427,297926683
22409,5,24,149,5745,-84,-97,13,,297928211,28,1500,297928183,297928211
22410,5,24,149,5745,-83,-97,14,,297929219,32,976,297929187,297929219
22411,5,12,149,5745,-60,-97,37,b6:90:18:f6:b1:d4,297929435,268,-52,297929167,297929435
22412,5,24,149,5745,-83,-97,14,,297930638,32,1171,297930606,297930638
22413,5,24,149,5745,-82,-97,15,,297935995,28,5329,297935967,297935995
22414,5,12,149,5745,-64,-97,33,f6:0a:5c:59:72:df,297939634,280,3359,297939354,297939634
22415,5,12,149,5745,-63,-97,34,22:ec:75:a8:8a:31,297947636,516,7486,297947120,297947636
22416,5,12,149,5745,-66,-97,31,f6:0a:5c:59:72:df,297948320,476,208,297947844,297948320
22417,5,12,149,5745,-87,-97,10,42:d2:d9:2b:ac:61,297949416,260,836,297949156,297949416
22418,5,12,149,5745,-64,-97,33,5e:29:73:5b:30:00,297954149,540,4193,297953609,297954149
22419,5,12,149,5745,-67,-97,30,72:d1:72:1d:22:a1,297955328,480,699,297954848,297955328
22420,5,12,149,5745,-53,-97,44,3e:d1:9b:c7:a4:de,297956697,544,825,297956153,297956697
22421,5,12,149,5745,-64,-97,33,a6:92:ad:b7:76:65,297962580,484,5399,297962096,297962580
22422,5,12,149,5745,-54,-97,43,3e:d1:9b:c7:a4:de,297963089,272,237,297962817,297963089
22423,5,12,149,5745,-64,-97,33,5e:29:73:5b:30:00,297964035,272,674,297963763,297964035
22424,5,12,149,5745,-69,-97,28,6a:1e:a4:f8:14:49,297964350,284,31,297964066,297964350
22425,5,12,149,5745,-61,-97,36,b6:90:18:f6:b1:d4,297965342,268,724,297965074,297965342
22426,5,24,149,5745,-66,-97,31,,297966698,28,1328,297966670,297966698
22427,5,24,149,5745,-82,-97,15,,297966741,28,15,297966713,297966741
22428,5,24,149,5745,-81,-97,16,,297966850,28,81,297966822,297966850
22429,5,12,149,5745,-65,-97,32,2a:07:ef:54:b5:55,297966957,440,-333,297966517,297966957
22430,5,12,149,5745,-66,-97,31,f2:da:61:dd:98:c5,297967838,268,613,297967570,297967838
22431,5,6,149,5745,-86,-97,11,54:e4:3a:ec:fb:65,297968215,360,17,297967855,297968215
22432,5,12,149,5745,-48,-97,49,4a:86:35:36:74:b8,297969520,268,1037,297969252,297969520
22433,5,12,149,5745,-68,-97,29,56:68:e2:c2:8d:d5,297969921,476,-75,297969445,297969921
22434,5,12,149,5745,-61,-97,36,0a:b9:b7:b1:4d:fa,297971404,268,1215,297971136,297971404
22435,5,12,149,5745,-90,-97,7,3a:90:78:0e:4f:1f,297972821,452,965,297972369,297972821
22436,5,12,149,5745,-85,-97,12,9a:24:38:da:96:bb,297977545,272,4452,297977273,297977545
22437,5,12,149,5745,-68,-97,29,72:d1:72:1d:22:a1,297978797,284,968,297978513,297978797
22438,5,12,149,5745,-91,-97,6,7e:05:42:11:d2:ec,297979764,244,723,297979520,297979764
22439,5,12,149,5745,-64,-97,33,22:ec:75:a8:8a:31,297995126,244,15118,297994882,297995126
22440,5,12,149,5745,-49,-97,48,4a:86:35:36:74:b8,297995648,268,254,297995380,297995648
22441,5,12,149,5745,-67,-97,30,f2:da:61:dd:98:c5,297996067,268,151,297995799,297996067
22442,5,12,149,5745,-67,-97,30,2a:07:ef:54:b5:55,298031930,440,35423,298031490,298031930
22443,5,12,149,5745,-66,-97,31,56:68:e2:c2:8d:d5,298035410,280,3200,298035130,298035410
22444,5,24,149,5745,-81,-97,16,,298046256,28,10818,298046228,298046256
22445,5,24,149,5745,-81,-97,16,,298046300,28,16,298046272,298046300
22446,5,24,149,5745,-81,-97,16,,298046412,32,80,298046380,298046412
22447,5,24,149,5745,-81,-97,16,,298047667,28,1227,298047639,298047667
22448,5,24,149,5745,-82,-97,15,,298047711,28,16,298047683,298047711
22449,5,24,149,5745,-82,-97,15,,298047822,32,79,298047790,298047822
22450,5,24,149,5745,-81,-97,16,,298048013,28,163,298047985,298048013
22451,5,24,149,5745,-82,-97,15,,298048058,28,17,298048030,298048058
22452,5,24,149,5745,-82,-97,15,,298048166,32,76,298048134,298048166
22453,5,12,149,5745,-59,-97,38,b6:90:18:f6:b1:d4,298048331,268,-103,298048063,298048331
22454,5,24,149,5745,-81,-97,16,,298050260,28,1901,298050232,298050260
22455,5,24,149,5745,-81,-97,16,,298050304,28,16,298050276,298050304
22456,5,24,149,5745,-81,-97,16,,298050412,32,76,298050380,298050412
22457,5,24,149,5745,-82,-97,15,,298058147,28,7707,298058119,298058147
22458,5,24,149,5745,-81,-97,16,,298058192,28,17,298058164,298058192
22459,5,24,149,5745,-82,-97,15,,298058300,32,76,298058268,298058300
22460,5,12,149,5745,-54,-97,43,3e:d1:9b:c7:a4:de,298058366,272,-206,298058094,298058366
22461,5,12,149,5745,-65,-97,32,5e:29:73:5b:30:00,298059613,272,975,298059341,298059613
22462,5,24,149,5745,-82,-97,15,,298060552,28,911,298060524,298060552
22463,5,24,149,5745,-81,-97,16,,298060596,28,16,298060568,298060596
22464,5,24,149,5745,-81,-97,16,,298060717,32,89,298060685,298060717
22465,5,24,149,5745,-80,-97,17,,298068453,28,7708,298068425,298068453
22466,5,24,149,5745,-82,-97,15,,298068497,28,16,298068469,298068497
22467,5,24,149,5745,-81,-97,16,,298068605,32,76,298068573,298068605
22468,5,24,149,5745,-82,-97,15,,298069217,28,584,298069189,298069217
22469,5,24,149,5745,-81,-97,16,,298069261,28,16,298069233,298069261
22470,5,24,149,5745,-82,-97,15,,298069369,32,76,298069337,298069369
22471,5,6,149,5745,-86,-97,11,54:e4:3a:ec:fb:65,298070490,360,761,298070130,298070490
22472,5,24,149,5745,-81,-97,16,,298071358,28,840,298071330,298071358
22473,5,24,149,5745,-81,-97,16,,298071402,28,16,298071374,298071402
22474,5,24,149,5745,-81,-97,16,,298071511,32,77,298071479,298071511
22475,5,24,149,5745,-82,-97,15,,298072515,28,976,298072487,298072515
22476,5,24,149,5745,-81,-97,16,,298072558,28,15,298072530,298072558
22477,5,24,149,5745,-81,-97,16,,298072683,32,93,298072651,298072683
22478,5,12,149,5745,-86,-97,11,42:d2:d9:2b:ac:61,298074849,260,1906,298074589,298074849
22479,5,24,149,5745,-81,-97,16,,298080382,28,5505,298080354,298080382
22480,5,24,149,5745,-81,-97,16,,298080426,28,16,298080398,298080426
22481,5,24,149,5745,-81,-97,16,,298080534,32,76,298080502,298080534
22482,5,24,149,5745,-81,-97,16,,298080698,28,136,298080670,298080698
22483,5,24,149,5745,-81,-97,16,,298080742,28,16,298080714,298080742
22484,5,24,149,5745,-81,-97,16,,298080850,32,76,298080818,298080850
22485,5,24,149,5745,-81,-97,16,,298081015,28,137,298080987,298081015
22486,5,24,149,5745,-81,-97,16,,298081059,28,16,298081031,298081059
22487,5,24,149,5745,-81,-97,16,,298081196,32,105,298081164,298081196
22488,5,24,149,5745,-80,-97,17,,298081352,28,128,298081324,298081352
22489,5,24,149,5745,-81,-97,16,,298081396,28,16,298081368,298081396
22490,5,24,149,5745,-81,-97,16,,298081529,32,101,298081497,298081529
22491,5,24,149,5745,-80,-97,17,,298081704,28,147,298081676,298081704
22492,5,24,149,5745,-81,-97,16,,298081748,28,16,298081720,298081748
22493,5,24,149,5745,-82,-97,15,,298081863,32,83,298081831,298081863
22494,5,24,149,5745,-81,-97,16,,298083287,28,1396,298083259,298083287
22495,5,24,149,5745,-80,-97,17,,298083331,28,16,298083303,298083331
22496,5,24,149,5745,-81,-97,16,,298083447,32,84,298083415,298083447
22497,5,24,149,5745,-81,-97,16,,298084422,28,947,298084394,298084422
22498,5,24,149,5745,-81,-97,16,,298084466,28,16,298084438,298084466
22499,5,24,149,5745,-80,-97,17,,298084574,32,76,298084542,298084574
22500,5,12,149,5745,-84,-97,13,9a:24:38:da:96:bb,298089893,272,5047,298089621,298089893
22501,5,12,149,5745,-63,-97,34,22:ec:75:a8:8a:31,298092716,244,2579,298092472,298092716
22502,5,12,149,5745,-89,-97,8,7e:05:42:11:d2:ec,298097843,244,4883,298097599,298097843
22503,5,12,149,5745,-67,-97,30,72:d1:72:1d:22:a1,298105738,284,7611,298105454,298105738
22504,5,24,149,5745,-83,-97,14,,298128299,28,22533,298128271,298128299
22505,5,24,149,5745,-82,-97,15,,298128343,28,16,298128315,298128343
22506,5,24,149,5745,-82,-97,15,,298128455,32,80,298128423,298128455
22507,5,24,149,5745,-82,-97,15,,298129678,28,1195,298129650,298129678
22508,5,24,149,5745,-82,-97,15,,298129723,28,17,298129695,298129723
22509,5,24,149,5745,-82,-97,15,,298129831,32,76,298129799,298129831
22510,5,24,149,5745,-82,-97,15,,298130054,28,195,298130026,298130054
22511,5,24,149,5745,-82,-97,15,,298130098,28,16,298130070,298130098
22512,5,24,149,5745,-82,-97,15,,298130210,32,80,298130178,298130210
22513,5,24,149,5745,-83,-97,14,,298132716,28,2478,298132688,298132716
22514,5,24,149,5745,-82,-97,15,,298132760,28,16,298132732,298132760
22515,5,24,149,5745,-82,-97,15,,298132868,32,76,298132836,298132868
22516,5,24,149,5745,-82,-97,15,,298132974,28,78,298132946,298132974
22517,5,24,149,5745,-82,-97,15,,298133018,28,16,298132990,298133018
22518,5,24,149,5745,-83,-97,14,,298133127,32,77,298133095,298133127
22519,5,24,149,5745,-83,-97,14,,298149158,28,16003,298149130,298149158
22520,5,24,149,5745,-84,-97,13,,298149203,28,17,298149175,298149203
22521,5,24,149,5745,-83,-97,14,,298149311,32,76,298149279,298149311
22522,5,24,149,5745,-83,-97,14,,298151916,28,2577,298151888,298151916
22523,5,24,149,5745,-83,-97,14,,298151960,28,16,298151932,298151960
22524,5,24,149,5745,-83,-97,14,,298152080,32,88,298152048,298152080
22525,5,24,149,5745,-83,-97,14,,298168035,28,15927,298168007,298168035
22526,5,24,149,5745,-84,-97,13,,298168080,28,17,298168052,298168080
22527,5,24,149,5745,-84,-97,13,,298168188,32,76,298168156,298168188
22528,5,24,149,5745,-83,-97,14,,298168371,28,155,298168343,298168371
22529,5,24,149,5745,-84,-97,13,,298168416,28,17,298168388,298168416
22530,5,24,149,5745,-84,-97,13,,298168534,32,86,298168502,298168534
22531,5,24,149,5745,-82,-97,15,,298168727,28,165,298168699,298168727
22532,5,24,149,5745,-84,-97,13,,298168772,28,17,298168744,298168772
22533,5,24,149,5745,-84,-97,13,,298168905,32,101,298168873,298168905
22534,5,24,149,5745,-82,-97,15,,298169069,28,136,298169041,298169069
22535,5,24,149,5745,-84,-97,13,,298169113,28,16,298169085,298169113
22536,5,24,149,5745,-84,-97,13,,298169232,32,87,298169200,298169232
22537,5,24,149,5745,-83,-97,14,,298170938,28,1678,298170910,298170938
22538,5,24,149,5745,-82,-97,15,,298170982,28,16,298170954,298170982
22539,5,24,149,5745,-83,-97,14,,298171090,32,76,298171058,298171090
22540,5,24,149,5745,-83,-97,14,,298171768,28,650,298171740,298171768
22541,5,24,149,5745,-83,-97,14,,298171812,28,16,298171784,298171812
22542,5,24,149,5745,-84,-97,13,,298171923,32,79,298171891,298171923
22543,5,24,149,5745,-84,-97,13,,298172072,28,121,298172044,298172072
22544,5,24,149,5745,-82,-97,15,,298172116,28,16,298172088,298172116
22545,5,24,149,5745,-83,-97,14,,298172224,32,76,298172192,298172224
22546,5,6,149,5745,-91,-97,6,54:e4:3a:ec:fb:65,298172891,360,307,298172531,298172891
22547,5,24,149,5745,-84,-97,13,,298173732,28,813,298173704,298173732
22548,5,24,149,5745,-82,-97,15,,298173776,28,16,298173748,298173776
22549,5,12,149,5745,-67,-97,30,f2:da:61:dd:98:c5,298173846,268,-198,298173578,298173846
22550,5,12,149,5745,-51,-97,46,4a:86:35:36:74:b8,298174308,268,194,298174040,298174308
22551,5,24,149,5745,-84,-97,13,,298175600,28,1264,298175572,298175600
22552,5,24,149,5745,-83,-97,14,,298175644,28,16,298175616,298175644
22553,5,24,149,5745,-82,-97,15,,298175753,32,77,298175721,298175753
22554,5,12,149,5745,-59,-97,38,3e:d1:9b:c7:a4:de,298175819,272,-206,298175547,298175819
22555,5,24,149,5745,-83,-97,14,,298176752,28,905,298176724,298176752
22556,5,24,149,5745,-83,-97,14,,298176797,28,17,298176769,298176797
22557,5,24,149,5745,-83,-97,14,,298176917,32,88,298176885,298176917
22558,5,12,149,5745,-66,-97,31,5e:29:73:5b:30:00,298177510,272,321,298177238,298177510
22559,5,24,149,5745,-82,-97,15,,298191980,28,14442,298191952,298191980
22560,5,24,149,5745,-84,-97,13,,298192024,28,16,298191996,298192024
22561,5,24,149,5745,-84,-97,13,,298192132,32,76,298192100,298192132
22562,5,24,149,5745,-83,-97,14,,298192434,28,274,298192406,298192434
22563,5,24,149,5745,-84,-97,13,,298192479,28,17,298192451,298192479
22564,5,24,149,5745,-84,-97,13,,298192586,32,75,298192554,298192586
22565,5,24,149,5745,-82,-97,15,,298193092,28,478,298193064,298193092
22566,5,24,149,5745,-83,-97,14,,298193136,28,16,298193108,298193136
22567,5,24,149,5745,-84,-97,13,,298193251,32,83,298193219,298193251
22568,5,24,149,5745,-82,-97,15,,298193434,28,155,298193406,298193434
22569,5,24,149,5745,-83,-97,14,,298193478,28,16,298193450,298193478
22570,5,24,149,5745,-83,-97,14,,298193586,32,76,298193554,298193586
22571,5,24,149,5745,-82,-97,15,,298193977,28,363,298193949,298193977
22572,5,24,149,5745,-83,-97,14,,298194021,28,16,298193993,298194021
22573,5,24,149,5745,-84,-97,13,,298194133,32,80,298194101,298194133
22574,5,24,149,5745,-83,-97,14,,298194340,28,179,298194312,298194340
22575,5,24,149,5745,-82,-97,15,,298194384,28,16,298194356,298194384
22576,5,24,149,5745,-82,-97,15,,298194493,32,77,298194461,298194493
22577,5,24,149,5745,-84,-97,13,,298195878,28,1357,298195850,298195878
22578,5,24,149,5745,-82,-97,15,,298195922,28,16,298195894,298195922
22579,5,24,149,5745,-82,-97,15,,298196034,32,80,298196002,298196034
22580,5,12,149,5745,-56,-97,41,b6:90:18:f6:b1:d4,298197232,268,930,298196964,298197232
22581,5,12,149,5745,-68,-97,29,56:68:e2:c2:8d:d5,298198450,280,938,298198170,298198450
22582,5,12,149,5745,-81,-97,16,9a:24:38:da:96:bb,298205249,272,6527,298204977,298205249
22583,5,12,149,5745,-63,-97,34,22:ec:75:a8:8a:31,298208616,244,3123,298208372,298208616
22584,5,12,149,5745,-84,-97,13,42:d2:d9:2b:ac:61,298210696,260,1820,298210436,298210696
22585,5,12,149,5745,-66,-97,31,72:d1:72:1d:22:a1,298213645,284,2665,298213361,298213645
22586,5,12,149,5745,-90,-97,7,de:be:a8:cd:79:57,298220998,284,7069,298220714,298220998
22587,5,24,149,5745,-82,-97,15,,298252640,28,31614,298252612,298252640
22588,5,24,149,5745,-82,-97,15,,298252685,28,17,298252657,298252685
22589,5,24,149,5745,-83,-97,14,,298252793,32,76,298252761,298252793
22590,5,12,149,5745,-65,-97,32,6a:1e:a4:f8:14:49,298272416,284,19339,298272132,298272416
22591,5,6,149,5745,-90,-97,7,54:e4:3a:ec:fb:65,298275291,360,2515,298274931,298275291
22592,5,12,149,5745,-53,-97,44,4a:86:35:36:74:b8,298275891,268,332,298275623,298275891
22593,5,12,149,5745,-71,-97,26,f2:da:61:dd:98:c5,298276328,268,169,298276060,298276328
22594,5,12,149,5745,-55,-97,42,3e:d1:9b:c7:a4:de,298290397,272,13797,298290125,298290397
22595,5,12,149,5745,-67,-97,30,f6:0a:5c:59:72:df,298291074,280,397,298290794,298291074
22596,5,12,149,5745,-67,-97,30,5e:29:73:5b:30:00,298294541,272,3195,298294269,298294541
22597,5,12,149,5745,-53,-97,44,b6:90:18:f6:b1:d4,298299811,268,5002,298299543,298299811
22598,5,12,149,5745,-67,-97,30,56:68:e2:c2:8d:d5,298305867,280,5776,298305587,298305867
22599,5,12,149,5745,-72,-97,25,d2:00:04:7e:2c:ab,298309467,244,3356,298309223,298309467
22600,5,12,149,5745,-88,-97,9,42:d2:d9:2b:ac:61,298313324,260,3597,298313064,298313324
22601,5,12,149,5745,-67,-97,30,72:d1:72:1d:22:a1,298315597,284,1989,298315313,298315597
22602,5,12,149,5745,-67,-97,30,6a:1e:a4:f8:14:49,298318148,284,2267,298317864,298318148
22603,5,12,149,5745,-88,-97,9,7e:05:42:11:d2:ec,298324464,244,6072,298324220,298324464
22604,5,12,149,5745,-61,-97,36,22:ec:75:a8:8a:31,298338352,244,13644,298338108,298338352
22605,5,12,149,5745,-67,-97,30,72:d1:72:1d:22:a1,298338991,480,159,298338511,298338991
22606,5,12,149,5745,-52,-97,45,4a:86:35:36:74:b8,298339777,268,518,298339509,298339777
22607,5,12,149,5745,-91,-97,6,de:be:a8:cd:79:57,298341320,480,1063,298340840,298341320
22608,5,12,149,5745,-60,-97,37,22:ec:75:a8:8a:31,298341852,516,16,298341336,298341852
22609,5,12,149,5745,-67,-97,30,6a:1e:a4:f8:14:49,298344535,480,2203,298344055,298344535
22610,5,12,149,5745,-67,-97,30,5e:29:73:5b:30:00,298349153,540,4078,298348613,298349153
22611,5,12,149,5745,-72,-97,25,d2:00:04:7e:2c:ab,298352681,440,3088,298352241,298352681
22612,5,12,149,5745,-56,-97,41,3e:d1:9b:c7:a4:de,298353170,544,-55,298352626,298353170
22613,5,12,149,5745,-68,-97,29,56:68:e2:c2:8d:d5,298356741,280,3291,298356461,298356741
22614,5,12,149,5745,-68,-97,29,56:68:e2:c2:8d:d5,298357650,476,433,298357174,298357650
22615,5,12,149,5745,-89,-97,8,42:d2:d9:2b:ac:61,298358423,456,317,298357967,298358423
22616,5,12,149,5745,-71,-97,26,d2:00:04:7e:2c:ab,298359264,380,461,298358884,298359264
22617,5,12,149,5745,-54,-97,43,b6:90:18:f6:b1:d4,298359680,268,148,298359412,298359680
22618,5,12,149,5745,-68,-97,29,f6:0a:5c:59:72:df,298360315,476,159,298359839,298360315
22619,5,12,149,5745,-51,-97,46,4a:86:35:36:74:b8,298364408,268,3825,298364140,298364408
22620,5,12,149,5745,-89,-97,8,3a:90:78:0e:4f:1f,298372604,452,7744,298372152,298372604
22621,5,12,149,5745,-89,-97,8,3a:90:78:0e:4f:1f,298376456,256,3596,298376200,298376456
22622,5,6,149,5745,-87,-97,10,54:e4:3a:ec:fb:65,298377691,360,875,298377331,298377691
22623,5,12,149,5745,-54,-97,43,b6:90:18:f6:b1:d4,298388014,268,10055,298387746,298388014
22624,5,12,149,5745,-91,-97,6,de:be:a8:cd:79:57,298390701,284,2403,298390417,298390701
22625,5,12,149,5745,-53,-97,44,3e:d1:9b:c7:a4:de,298403441,272,12468,298403169,298403441
22626,5,12,149,5745,-65,-97,32,f6:0a:5c:59:72:df,298405135,280,1414,298404855,298405135
22627,5,12,149,5745,-64,-97,33,5e:29:73:5b:30:00,298409913,272,4506,298409641,298409913
22628,5,12,149,5745,-69,-97,28,d2:00:04:7e:2c:ab,298413955,440,3602,298413515,298413955
22629,5,12,149,5745,-69,-97,28,d2:00:04:7e:2c:ab,298422220,244,8021,298421976,298422220
22630,5,12,149,5745,-90,-97,7,42:d2:d9:2b:ac:61,298423267,260,787,298423007,298423267
22631,5,12,149,5745,-89,-97,8,7e:05:42:11:d2:ec,298427287,440,3580,298426847,298427287
22632,5,12,149,5745,-68,-97,29,6a:1e:a4:f8:14:49,298428696,284,1125,298428412,298428696
22633,5,12,149,5745,-88,-97,9,7e:05:42:11:d2:ec,298437848,244,8908,298437604,298437848
22634,5,12,149,5745,-61,-97,36,22:ec:75:a8:8a:31,298439725,244,1633,298439481,298439725
22635,5,12,149,5745,-67,-97,30,72:d1:72:1d:22:a1,298444390,284,4381,298444106,298444390
22636,5,12,149,5745,-48,-97,49,4a:86:35:36:74:b8,298455555,268,10897,298455287,298455555
22637,5,12,149,5745,-62,-97,35,22:ec:75:a8:8a:31,298472393,516,16322,298471877,298472393
22638,5,12,149,5745,-85,-97,12,9a:24:38:da:96:bb,298473276,824,59,298472452,298473276
22639,5,12,149,5745,-69,-97,28,d2:00:04:7e:2c:ab,298479632,440,5916,298479192,298479632
22640,5,6,149,5745,-89,-97,8,54:e4:3a:ec:fb:65,298480092,360,100,298479732,298480092
22641,5,12,149,5745,-67,-97,30,5e:29:73:5b:30:00,298481146,540,514,298480606,298481146
22642,5,12,149,5745,-56,-97,41,3e:d1:9b:c7:a4:de,298483569,544,1879,298483025,298483569
22643,5,12,149,5745,-65,-97,32,56:68:e2:c2:8d:d5,298484291,280,442,298484011,298484291
22644,5,12,149,5745,-55,-97,42,b6:90:18:f6:b1:d4,298485930,268,1371,298485662,298485930
22645,5,12,149,5745,-62,-97,35,a6:92:ad:b7:76:65,298486286,484,-128,298485802,298486286
22646,5,12,149,5745,-55,-97,42,b6:90:18:f6:b1:d4,298491656,268,5102,298491388,298491656
22647,5,12,149,5745,-89,-97,8,7e:05:42:11:d2:ec,298493024,468,900,298492556,298493024
22648,5,12,149,5745,-72,-97,25,f2:da:61:dd:98:c5,298493939,268,647,298493671,298493939
22649,5,12,149,5745,-47,-97,50,4a:86:35:36:74:b8,298495114,268,907,298494846,298495114
22650,5,12,149,5745,-56,-97,41,0a:b9:b7:b1:4d:fa,298495551,268,169,298495283,298495551
22651,5,12,149,5745,-93,-97,4,de:be:a8:cd:79:57,298505322,284,9487,298505038,298505322
22652,5,12,149,5745,-87,-97,10,9a:24:38:da:96:bb,298515330,272,9736,298515058,298515330
22653,5,12,149,5745,-60,-97,37,3e:d1:9b:c7:a4:de,298520459,272,4857,298520187,298520459
22654,5,12,149,5745,-70,-97,27,d2:00:04:7e:2c:ab,298521719,244,1016,298521475,298521719
22655,5,12,149,5745,-65,-97,32,5e:29:73:5b:30:00,298522133,272,142,298521861,298522133
22656,5,12,149,5745,-88,-97,9,42:d2:d9:2b:ac:61,298533977,260,11584,298533717,298533977
22657,5,12,149,5745,-70,-97,27,d2:00:04:7e:2c:ab,298544903,440,10486,298544463,298544903
22658,5,12,149,5745,-89,-97,8,7e:05:42:11:d2:ec,298551145,272,5970,298550873,298551145
22659,5,12,149,5745,-64,-97,33,22:ec:75:a8:8a:31,298557648,244,6259,298557404,298557648
22660,5,24,149,5745,-64,-97,33,,298564272,28,6596,298564244,298564272
22661,5,24,149,5745,-84,-97,13,,298564316,28,16,298564288,298564316
22662,5,24,149,5745,-83,-97,14,,298564424,28,80,298564396,298564424
22663,5,24,149,5745,-64,-97,33,,298564551,28,99,298564523,298564551
22664,5,24,149,5745,-84,-97,13,,298564595,28,16,298564567,298564595
22665,5,24,149,5745,-85,-97,12,,298564716,32,89,298564684,298564716
22666,5,24,149,5745,-65,-97,32,,298564829,28,85,298564801,298564829
22667,5,24,149,5745,-83,-97,14,,298564873,28,16,298564845,298564873
22668,5,24,149,5745,-84,-97,13,,298564981,28,80,298564953,298564981
22669,5,24,149,5745,-83,-97,14,,298566954,32,1941,298566922,298566954
22670,5,24,149,5745,-83,-97,14,,298567517,32,531,298567485,298567517
22671,5,24,149,5745,-84,-97,13,,298568079,28,534,298568051,298568079
22672,5,24,149,5745,-84,-97,13,,298568620,28,513,298568592,298568620
22673,5,24,149,5745,-83,-97,14,,298570837,28,2189,298570809,298570837
22674,5,12,149,5745,-67,-97,30,2a:07:ef:54:b5:55,298573198,244,2117,298572954,298573198
22675,5,12,149,5745,-47,-97,50,4a:86:35:36:74:b8,298573532,268,66,298573264,298573532
22676,5,12,149,5745,-72,-97,25,6a:1e:a4:f8:14:49,298579362,284,5546,298579078,298579362
22677,5,6,149,5745,-88,-97,9,54:e4:3a:ec:fb:65,298582492,360,2770,298582132,298582492
22678,5,12,149,5745,-68,-97,29,72:d1:72:1d:22:a1,298607062,284,24286,298606778,298607062
22679,5,12,149,5745,-67,-97,30,56:68:e2:c2:8d:d5,298609202,280,1860,298608922,298609202
22680,5,12,149,5745,-56,-97,41,b6:90:18:f6:b1:d4,298612809,268,3339,298612541,298612809
22681,5,12,149,5745,-92,-97,5,3a:90:78:0e:4f:1f,298621123,284,8030,298620839,298621123
22682,5,12,149,5745,-64,-97,33,f6:0a:5c:59:72:df,298626139,280,4736,298625859,298626139
22683,5,12,149,5745,-56,-97,41,3e:d1:9b:c7:a4:de,298630354,272,3943,298630082,298630354
22684,5,12,149,5745,-91,-97,6,de:be:a8:cd:79:57,298631590,284,952,298631306,298631590
22685,5,12,149,5745,-69,-97,28,5e:29:73:5b:30:00,298637872,272,6010,298637600,298637872
22686,5,12,149,5745,-71,-97,26,d2:00:04:7e:2c:ab,298647101,244,8985,298646857,298647101
22687,5,12,149,5745,-65,-97,32,22:ec:75:a8:8a:31,298670389,244,23044,298670145,298670389
22688,5,24,149,5745,-80,-97,17,,298676902,28,6485,298676874,298676902
22689,5,24,149,5745,-85,-97,12,,298676946,28,16,298676918,298676946
22690,5,24,149,5745,-85,-97,12,,298677059,32,81,298677027,298677059
22691,5,12,149,5745,-70,-97,27,6a:1e:a4:f8:14:49,298680490,284,3147,298680206,298680490
22692,5,6,149,5745,-89,-97,8,54:e4:3a:ec:fb:65,298684893,360,4043,298684533,298684893
22693,5,12,149,5745,-49,-97,48,4a:86:35:36:74:b8,298686331,268,1170,298686063,298686331
22694,5,24,149,5745,-84,-97,13,,298691096,28,4737,298691068,298691096
22695,5,24,149,5745,-80,-97,17,,298691140,28,16,298691112,298691140
22696,5,24,149,5745,-80,-97,17,,298691248,32,76,298691216,298691248
22697,5,12,149,5745,-68,-97,29,2a:07:ef:54:b5:55,298693146,244,1654,298692902,298693146
22698,5,24,149,5745,-80,-97,17,,298699121,28,5947,298699093,298699121
22699,5,24,149,5745,-85,-97,12,,298699165,28,16,298699137,298699165
22700,5,24,149,5745,-84,-97,13,,298699274,32,77,298699242,298699274
22701,5,12,149,5745,-65,-97,32,72:d1:72:1d:22:a1,298709498,284,9940,298709214,298709498
22702,5,12,149,5745,-69,-97,28,56:68:e2:c2:8d:d5,298710147,280,369,298709867,298710147
22703,5,12,149,5745,-59,-97,38,b6:90:18:f6:b1:d4,298721373,268,10958,298721105,298721373
22704,5,12,149,5745,-90,-97,7,42:d2:d9:2b:ac:61,298722652,260,1019,298722392,298722652
22705,5,12,149,5745,-87,-97,10,7e:05:42:11:d2:ec,298726184,272,3260,298725912,298726184
22706,5,12,149,5745,-63,-97,34,f6:0a:5c:59:72:df,298738682,280,12218,298738402,298738682
22707,5,12,149,5745,-54,-97,43,3e:d1:9b:c7:a4:de,298747696,272,8742,298747424,298747696
22708,5,24,149,5745,-84,-97,13,,298753897,28,6173,298753869,298753897
22709,5,24,149,5745,-81,-97,16,,298753941,28,16,298753913,298753941
22710,5,24,149,5745,-82,-97,15,,298754052,32,79,298754020,298754052
22711,5,12,149,5745,-67,-97,30,5e:29:73:5b:30:00,298754763,272,439,298754491,298754763
22712,5,24,149,5745,-81,-97,16,,298756914,28,2123,298756886,298756914
22713,5,24,149,5745,-84,-97,13,,298756958,28,16,298756930,298756958
22714,5,24,149,5745,-84,-97,13,,298757066,32,76,298757034,298757066
22715,5,24,149,5745,-85,-97,12,,298757132,28,38,298757104,298757132
22716,5,24,149,5745,-81,-97,16,,298757177,28,17,298757149,298757177
22717,5,24,149,5745,-81,-97,16,,298757296,32,87,298757264,298757296
22718,5,12,149,5745,-71,-97,26,d2:00:04:7e:2c:ab,298759773,244,2233,298759529,298759773
22719,5,24,149,5745,-82,-97,15,,298763869,28,4068,298763841,298763869
22720,5,24,149,5745,-84,-97,13,,298763913,28,16,298763885,298763913
22721,5,24,149,5745,-84,-97,13,,298764021,32,76,298763989,298764021
22722,5,12,149,5745,-81,-97,16,9a:24:38:da:96:bb,298768500,272,4207,298768228,298768500
22723,5,24,149,5745,-81,-97,16,,298776047,28,7519,298776019,298776047
22724,5,24,149,5745,-83,-97,14,,298776091,28,16,298776063,298776091
22725,5,24,149,5745,-83,-97,14,,298776200,32,77,298776168,298776200
22726,5,12,149,5745,-69,-97,28,6a:1e:a4:f8:14:49,298784409,284,7925,298784125,298784409
22727,5,12,149,5745,-66,-97,31,22:ec:75:a8:8a:31,298786185,244,1532,298785941,298786185
22728,5,6,149,5745,-89,-97,8,54:e4:3a:ec:fb:65,298787293,360,748,298786933,298787293
22729,5,24,149,5745,-83,-97,14,,298790389,28,3068,298790361,298790389
22730,5,24,149,5745,-80,-97,17,,298790433,28,16,298790405,298790433
22731,5,24,149,5745,-81,-97,16,,298790541,32,76,298790509,298790541
22732,5,24,149,5745,-80,-97,17,,298798343,28,7774,298798315,298798343
22733,5,24,149,5745,-80,-97,17,,298798550,28,179,298798522,298798550
22734,5,24,149,5745,-79,-97,18,,298798703,28,125,298798675,298798703
22735,5,12,149,5745,-50,-97,47,4a:86:35:36:74:b8,298798836,268,-135,298798568,298798836
22736,5,24,149,5745,-80,-97,17,,298799571,28,707,298799543,298799571
22737,5,24,149,5745,-84,-97,13,,298799800,32,197,298799768,298799800
22738,5,24,149,5745,-80,-97,17,,298801897,28,2069,298801869,298801897
22739,5,24,149,5745,-84,-97,13,,298801941,28,16,298801913,298801941
22740,5,24,149,5745,-83,-97,14,,298802054,32,81,298802022,298802054
22741,5,12,149,5745,-65,-97,32,72:d1:72:1d:22:a1,298812023,284,9685,298811739,298812023
22742,5,24,149,5745,-84,-97,13,,298816970,32,4915,298816938,298816970
22743,5,24,149,5745,-83,-97,14,,298817348,28,350,298817320,298817348
22744,5,6,149,5745,-89,-97,8,,298817508,68,92,298817440,298817508
22745,5,12,149,5745,-90,-97,7,42:d2:d9:2b:ac:61,298825213,260,7445,298824953,298825213
22746,5,12,149,5745,-87,-97,10,7e:05:42:11:d2:ec,298830042,272,4557,298829770,298830042
22747,5,24,149,5745,-85,-97,12,,298841391,28,11321,298841363,298841391
22748,5,24,149,5745,-80,-97,17,,298841435,28,16,298841407,298841435
22749,5,24,149,5745,-80,-97,17,,298841547,32,80,298841515,298841547
22750,5,24,149,5745,-84,-97,13,,298842743,28,1168,298842715,298842743
22751,5,24,149,5745,-80,-97,17,,298842787,28,16,298842759,298842787
22752,5,24,149,5745,-80,-97,17,,298842895,32,76,298842863,298842895
22753,5,24,149,5745,-80,-97,17,,298843007,32,80,298842975,298843007
22754,5,12,149,5745,-61,-97,36,b6:90:18:f6:b1:d4,298843460,268,185,298843192,298843460
22755,5,24,149,5745,-80,-97,17,,298844296,28,808,298844268,298844296
22756,5,24,149,5745,-84,-97,13,,298844340,28,16,298844312,298844340
22757,5,24,149,5745,-84,-97,13,,298844449,32,77,298844417,298844449
22758,5,24,149,5745,-80,-97,17,,298850765,28,6288,298850737,298850765
22759,5,24,149,5745,-85,-97,12,,298850808,28,15,298850780,298850808
22760,5,24,149,5745,-85,-97,12,,298850917,32,77,298850885,298850917
22761,5,12,149,5745,-58,-97,39,3e:d1:9b:c7:a4:de,298859468,272,8279,298859196,298859468
22762,5,24,149,5745,-84,-97,13,,298862456,28,2960,298862428,298862456
22763,5,24,149,5745,-80,-97,17,,298862500,28,16,298862472,298862500
22764,5,24,149,5745,-80,-97,17,,298862608,32,76,298862576,298862608
22765,5,24,149,5745,-84,-97,13,,298864815,32,2175,298864783,298864815
22766,5,12,149,5745,-64,-97,33,5e:29:73:5b:30:00,298866904,272,1817,298866632,298866904
22767,5,12,149,5745,-72,-97,25,d2:00:04:7e:2c:ab,298875113,244,7965,298874869,298875113
22768,5,12,149,5745,-90,-97,7,42:d2:d9:2b:ac:61,298877112,260,1739,298876852,298877112
22769,5,12,149,5745,-72,-97,25,6a:1e:a4:f8:14:49,298885644,284,8248,298885360,298885644
22770,5,12,149,5745,-88,-97,9,7e:05:42:11:d2:ec,298886182,272,266,298885910,298886182
22771,5,12,149,5745,-65,-97,32,2a:07:ef:54:b5:55,298888901,244,2475,298888657,298888901
22772,5,6,149,5745,-89,-97,8,54:e4:3a:ec:fb:65,298889694,360,433,298889334,298889694
22773,5,12,149,5745,-65,-97,32,22:ec:75:a8:8a:31,298898011,244,8073,298897767,298898011
22774,5,12,149,5745,-65,-97,32,2a:07:ef:54:b5:55,298898334,244,79,298898090,298898334
22775,5,12,149,5745,-50,-97,47,4a:86:35:36:74:b8,298905851,268,7249,298905583,298905851
22776,5,12,149,5745,-64,-97,33,72:d1:72:1d:22:a1,298915494,284,9359,298915210,298915494
22777,5,12,149,5745,-68,-97,29,56:68:e2:c2:8d:d5,298929681,280,13907,298929401,298929681
22778,5,12,149,5745,-64,-97,33,72:d1:72:1d:22:a1,298930942,480,781,298930462,298930942
22779,5,12,149,5745,-64,-97,33,22:ec:75:a8:8a:31,298931492,516,34,298930976,298931492
22780,5,12,149,5745,-65,-97,32,2a:07:ef:54:b5:55,298935273,440,3341,298934833,298935273
22781,5,12,149,5745,-67,-97,30,5e:29:73:5b:30:00,298936926,540,1113,298936386,298936926
22782,5,12,149,5745,-71,-97,26,6a:1e:a4:f8:14:49,298937509,480,103,298937029,298937509
22783,5,12,149,5745,-57,-97,40,3e:d1:9b:c7:a4:de,298939572,544,1519,298939028,298939572
22784,5,12,149,5745,-71,-97,26,d2:00:04:7e:2c:ab,298940195,440,183,298939755,298940195
22785,5,12,149,5745,-93,-97,4,3a:90:78:0e:4f:1f,298940696,284,217,298940412,298940696
22786,5,12,149,5745,-60,-97,37,b6:90:18:f6:b1:d4,298944627,268,3663,298944359,298944627
22787,5,12,149,5745,-69,-97,28,56:68:e2:c2:8d:d5,298948453,476,3350,298947977,298948453
22788,5,12,149,5745,-60,-97,37,b6:90:18:f6:b1:d4,298950112,268,1391,298949844,298950112
22789,5,12,149,5745,-62,-97,35,f6:0a:5c:59:72:df,298950872,280,480,298950592,298950872
22790,5,12,149,5745,-62,-97,35,f6:0a:5c:59:72:df,298951322,476,-26,298950846,298951322
22791,5,12,149,5745,-89,-97,8,42:d2:d9:2b:ac:61,298952207,488,397,298951719,298952207
22792,5,12,149,5745,-51,-97,46,4a:86:35:36:74:b8,298953016,268,541,298952748,298953016
22793,5,12,149,5745,-86,-97,11,9a:24:38:da:96:bb,298964530,272,11242,298964258,298964530
22794,5,12,149,5745,-90,-97,7,de:be:a8:cd:79:57,298967075,284,2261,298966791,298967075
22795,5,12,149,5745,-56,-97,41,3e:d1:9b:c7:a4:de,298978698,272,11351,298978426,298978698
22796,5,12,149,5745,-69,-97,28,6a:1e:a4:f8:14:49,298980053,284,1071,298979769,298980053
22797,5,12,149,5745,-72,-97,25,d2:00:04:7e:2c:ab,298980416,244,119,298980172,298980416
22798,5,12,149,5745,-88,-97,9,42:d2:d9:2b:ac:61,298982158,292,1450,298981866,298982158
22799,5,6,149,5745,-89,-97,8,54:e4:3a:ec:fb:65,298992094,360,9576,298991734,298992094
22800,5,12,149,5745,-65,-97,32,72:d1:72:1d:22:a1,298994835,480,2261,298994355,298994835
22801,5,12,149,5745,-65,-97,32,72:d1:72:1d:22:a1,298995333,284,214,298995049,298995333
22802,5,12,149,5745,-63,-97,34,22:ec:75:a8:8a:31,298995930,516,81,298995414,298995930
22803,5,12,149,5745,-84,-97,13,9a:24:38:da:96:bb,298999317,824,2563,298998493,298999317
22804,5,12,149,5745,-69,-97,28,2a:07:ef:54:b5:55,299000167,440,410,298999727,299000167
22805,5,12,149,5745,-69,-97,28,6a:1e:a4:f8:14:49,299000686,480,39,299000206,299000686
22806,5,12,149,5745,-67,-97,30,5e:29:73:5b:30:00,299002730,540,1504,299002190,299002730
22807,5,12,149,5745,-71,-97,26,d2:00:04:7e:2c:ab,299003872,440,702,299003432,299003872
22808,5,12,149,5745,-57,-97,40,3e:d1:9b:c7:a4:de,299004922,544,506,299004378,299004922
22809,5,12,149,5745,-59,-97,38,a6:92:ad:b7:76:65,299010837,484,5431,299010353,299010837
22810,5,12,149,5745,-52,-97,45,4a:86:35:36:74:b8,299011411,268,306,299011143,299011411
22811,5,12,149,5745,-68,-97,29,56:68:e2:c2:8d:d5,299011767,476,-120,299011291,299011767
22812,5,12,149,5745,-86,-97,11,7e:05:42:11:d2:ec,299012711,468,476,299012243,299012711
22813,5,12,149,5745,-63,-97,34,b6:90:18:f6:b1:d4,299014680,268,1701,299014412,299014680
22814,5,12,149,5745,-64,-97,33,f6:0a:5c:59:72:df,299016482,476,1326,299016006,299016482
22815,5,12,149,5745,-52,-97,45,4a:86:35:36:74:b8,299017920,268,1170,299017652,299017920
22816,5,12,149,5745,-68,-97,29,f2:da:61:dd:98:c5,299021102,268,2914,299020834,299021102
22817,5,12,149,5745,-61,-97,36,0a:b9:b7:b1:4d:fa,299021980,268,610,299021712,299021980
22818,5,12,149,5745,-87,-97,10,42:d2:d9:2b:ac:61,299022709,488,241,299022221,299022709
22819,5,12,149,5745,-63,-97,34,22:ec:75:a8:8a:31,299026508,244,3555,299026264,299026508
22820,5,12,149,5745,-68,-97,29,56:68:e2:c2:8d:d5,299027965,280,1177,299027685,299027965
22821,5,12,149,5745,-71,-97,26,2a:07:ef:54:b5:55,299028279,244,70,299028035,299028279
22822,5,12,149,5745,-72,-97,25,2a:07:ef:54:b5:55,299065722,440,37003,299065282,299065722
22823,5,24,149,5745,-80,-97,17,,299066295,28,545,299066267,299066295
22824,5,24,149,5745,-84,-97,13,,299066339,28,16,299066311,299066339
22825,5,24,149,5745,-84,-97,13,,299066448,32,77,299066416,299066448
22826,5,12,149,5745,-70,-97,27,d2:00:04:7e:2c:ab,299069516,440,2628,299069076,299069516
22827,5,12,149,5745,-61,-97,36,b6:90:18:f6:b1:d4,299070118,268,334,299069850,299070118
22828,5,12,149,5745,-60,-97,37,f6:0a:5c:59:72:df,299074916,280,4518,299074636,299074916
22829,5,12,149,5745,-85,-97,12,9a:24:38:da:96:bb,299076547,272,1359,299076275,299076547
22830,5,24,149,5745,-84,-97,13,,299080467,28,3892,299080439,299080467
22831,5,24,149,5745,-80,-97,17,,299080511,28,16,299080483,299080511
22832,5,24,149,5745,-80,-97,17,,299080619,32,76,299080587,299080619
22833,5,12,149,5745,-91,-97,6,de:be:a8:cd:79:57,299083167,284,2264,299082883,299083167
22834,5,24,149,5745,-79,-97,18,,299088092,28,4897,299088064,299088092
22835,5,24,149,5745,-80,-97,17,,299088488,28,368,299088460,299088488
22836,5,24,149,5745,-84,-97,13,,299088532,28,16,299088504,299088532
22837,5,24,149,5745,-84,-97,13,,299088641,32,77,299088609,299088641
22838,5,12,149,5745,-59,-97,38,3e:d1:9b:c7:a4:de,299089068,272,155,299088796,299089068
22839,5,12,149,5745,-70,-97,27,d2:00:04:7e:2c:ab,299093946,244,4634,299093702,299093946
22840,5,6,149,5745,-91,-97,6,54:e4:3a:ec:fb:65,299094495,360,189,299094135,299094495
22841,5,12,149,5745,-65,-97,32,5e:29:73:5b:30:00,299096388,272,1621,299096116,299096388
22842,5,12,149,5745,-91,-97,6,42:d2:d9:2b:ac:61,299102510,292,5830,299102218,299102510
22843,5,12,149,5745,-69,-97,28,6a:1e:a4:f8:14:49,299104006,284,1212,299103722,299104006
22844,5,12,149,5745,-89,-97,8,7e:05:42:11:d2:ec,299111039,272,6761,299110767,299111039
22845,5,12,149,5745,-67,-97,30,72:d1:72:1d:22:a1,299120904,284,9581,299120620,299120904
22846,5,12,149,5745,-64,-97,33,22:ec:75:a8:8a:31,299127632,244,6484,299127388,299127632
22847,5,24,149,5745,-84,-97,13,,299130905,28,3245,299130877,299130905
22848,5,24,149,5745,-80,-97,17,,299130949,28,16,299130921,299130949
22849,5,24,149,5745,-80,-97,17,,299131061,32,80,299131029,299131061
22850,5,24,149,5745,-84,-97,13,,299133825,28,2736,299133797,299133825
22851,5,24,149,5745,-80,-97,17,,299133869,28,16,299133841,299133869
22852,5,24,149,5745,-80,-97,17,,299133977,32,76,299133945,299133977
22853,5,24,149,5745,-84,-97,13,,299134139,28,134,299134111,299134139
22854,5,24,149,5745,-80,-97,17,,299134184,28,17,299134156,299134184
22855,5,24,149,5745,-80,-97,17,,299134292,32,76,299134260,299134292
22856,5,24,149,5745,-80,-97,17,,299134386,28,66,299134358,299134386
22857,5,24,149,5745,-83,-97,14,,299134430,28,16,299134402,299134430
22858,5,24,149,5745,-84,-97,13,,299134539,32,77,299134507,299134539
22859,5,24,149,5745,-79,-97,18,,299140709,28,6142,299140681,299140709
22860,5,24,149,5745,-84,-97,13,,299140754,28,17,299140726,299140754
22861,5,24,149,5745,-84,-97,13,,299140862,32,76,299140830,299140862
22862,5,12,149,5745,-67,-97,30,2a:07:ef:54:b5:55,299144669,244,3563,299144425,299144669
22863,5,24,149,5745,-84,-97,13,,299153269,28,8572,299153241,299153269
22864,5,24,149,5745,-79,-97,18,,299153313,28,16,299153285,299153313
22865,5,24,149,5745,-79,-97,18,,299153421,32,76,299153389,299153421
22866,5,12,149,5745,-83,-97,14,9a:24:38:da:96:bb,299192176,272,38483,299191904,299192176
22867,5,6,149,5745,-91,-97,6,54:e4:3a:ec:fb:65,299196895,360,4359,299196535,299196895
22868,5,12,149,5745,-46,-97,51,4a:86:35:36:74:b8,299198343,268,1180,299198075,299198343
22869,5,12,149,5745,-54,-97,43,3e:d1:9b:c7:a4:de,299205170,272,6555,299204898,299205170
22870,5,12,149,5745,-72,-97,25,d2:00:04:7e:2c:ab,299213117,244,7703,299212873,299213117
22871,5,12,149,5745,-63,-97,34,5e:29:73:5b:30:00,299213373,272,-16,299213101,299213373
22872,5,12,149,5745,-60,-97,37,b6:90:18:f6:b1:d4,299221635,268,7994,299221367,299221635
22873,5,12,149,5745,-69,-97,28,56:68:e2:c2:8d:d5,299224232,280,2317,299223952,299224232
22874,5,12,149,5745,-67,-97,30,72:d1:72:1d:22:a1,299233359,284,8843,299233075,299233359
22875,5,12,149,5745,-91,-97,6,42:d2:d9:2b:ac:61,299235091,292,1440,299234799,299235091
22876,5,12,149,5745,-90,-97,7,7e:05:42:11:d2:ec,299238729,272,3366,299238457,299238729
22877,5,12,149,5745,-66,-97,31,22:ec:75:a8:8a:31,299244724,244,5751,299244480,299244724
22878,5,24,149,5745,-78,-97,19,,299279014,28,34262,299278986,299279014
22879,5,24,149,5745,-84,-97,13,,299279058,28,16,299279030,299279058
22880,5,24,149,5745,-84,-97,13,,299279166,32,76,299279134,299279166
22881,5,24,149,5745,-83,-97,14,,299293263,28,14069,299293235,299293263
22882,5,24,149,5745,-79,-97,18,,299293307,28,16,299293279,299293307
22883,5,24,149,5745,-79,-97,18,,299293415,32,76,299293383,299293415
22884,5,12,149,5745,-67,-97,30,6a:1e:a4:f8:14:49,299295764,284,2065,299295480,299295764
22885,5,6,149,5745,-89,-97,8,54:e4:3a:ec:fb:65,299299296,360,3172,299298936,299299296
22886,5,12,149,5745,-46,-97,51,4a:86:35:36:74:b8,299299915,268,351,299299647,299299915
22887,5,12,149,5745,-63,-97,34,2a:07:ef:54:b5:55,299300924,244,765,299300680,299300924
22888,5,24,149,5745,-79,-97,18,,299301310,28,358,299301282,299301310
22889,5,24,149,5745,-84,-97,13,,299301354,28,16,299301326,299301354
22890,5,24,149,5745,-84,-97,13,,299301463,32,77,299301431,299301463
22891,5,24,149,5745,-79,-97,18,,299305653,28,4162,299305625,299305653
22892,5,24,149,5745,-83,-97,14,,299305697,28,16,299305669,299305697
22893,5,24,149,5745,-83,-97,14,,299305805,32,76,299305773,299305805
22894,5,12,149,5745,-52,-97,45,3e:d1:9b:c7:a4:de,299323044,272,16967,299322772,299323044
22895,5,12,149,5745,-59,-97,38,b6:90:18:f6:b1:d4,299323742,268,430,299323474,299323742
22896,5,24,149,5745,-84,-97,13,,299325115,28,1345,299325087,299325115
22897,5,24,149,5745,-80,-97,17,,299325160,28,17,299325132,299325160
22898,5,24,149,5745,-80,-97,17,,299325268,32,76,299325236,299325268
22899,5,12,149,5745,-70,-97,27,d2:00:04:7e:2c:ab,299325892,244,380,299325648,299325892
22900,5,12,149,5745,-71,-97,26,56:68:e2:c2:8d:d5,299327727,280,1555,299327447,299327727
22901,5,12,149,5745,-71,-97,26,6a:1e:a4:f8:14:49,299330445,284,2434,299330161,299330445
22902,5,12,149,5745,-64,-97,33,5e:29:73:5b:30:00,299330773,272,56,299330501,299330773
22903,5,12,149,5745,-92,-97,5,4e:72:d0:f1:a2:44,299335896,272,4851,299335624,299335896
22904,5,12,149,5745,-89,-97,8,42:d2:d9:2b:ac:61,299337051,292,863,299336759,299337051
22905,5,12,149,5745,-86,-97,11,de:be:a8:cd:79:57,299337413,284,78,299337129,299337413
22906,5,12,149,5745,-87,-97,10,7e:05:42:11:d2:ec,299342281,272,4596,299342009,299342281
22907,5,24,149,5745,-85,-97,12,,299343351,28,1042,299343323,299343351
22908,5,24,149,5745,-80,-97,17,,299343395,28,16,299343367,299343395
22909,5,24,149,5745,-80,-97,17,,299343507,32,80,299343475,299343507
22910,5,24,149,5745,-80,-97,17,,299346666,28,3131,299346638,299346666
22911,5,24,149,5745,-84,-97,13,,299346710,28,16,299346682,299346710
22912,5,24,149,5745,-84,-97,13,,299346819,32,77,299346787,299346819
22913,5,24,149,5745,-84,-97,13,,299346948,28,101,299346920,299346948
22914,5,24,149,5745,-80,-97,17,,299346992,28,16,299346964,299346992
22915,5,24,149,5745,-80,-97,17,,299347108,32,84,299347076,299347108
22916,5,24,149,5745,-80,-97,17,,299354684,28,7548,299354656,299354684
22917,5,24,149,5745,-85,-97,12,,299354728,28,16,299354700,299354728
22918,5,24,149,5745,-84,-97,13,,299354837,32,77,299354805,299354837
22919,5,12,149,5745,-69,-97,28,72:d1:72:1d:22:a1,299356801,284,1680,299356517,299356801
22920,5,12,149,5745,-67,-97,30,22:ec:75:a8:8a:31,299360006,244,2961,299359762,299360006
22921,5,12,149,5745,-48,-97,49,4a:86:35:36:74:b8,299362338,268,2064,299362070,299362338
22922,5,24,149,5745,-83,-97,14,,299364883,28,2517,299364855,299364883
22923,5,24,149,5745,-80,-97,17,,299364927,28,16,299364899,299364927
22924,5,24,149,5745,-80,-97,17,,299365035,32,76,299365003,299365035
22925,5,12,149,5745,-61,-97,36,2a:07:ef:54:b5:55,299372074,244,6795,299371830,299372074
22926,5,12,149,5745,-60,-97,37,b6:90:18:f6:b1:d4,299386974,268,14632,299386706,299386974
22927,5,12,149,5745,-70,-97,27,72:d1:72:1d:22:a1,299388358,480,904,299387878,299388358
22928,5,12,149,5745,-66,-97,31,22:ec:75:a8:8a:31,299389763,516,889,299389247,299389763
22929,5,12,149,5745,-83,-97,14,9a:24:38:da:96:bb,299392671,824,2084,299391847,299392671
22930,5,12,149,5745,-63,-97,34,2a:07:ef:54:b5:55,299393652,440,541,299393212,299393652
22931,5,12,149,5745,-70,-97,27,6a:1e:a4:f8:14:49,299397186,480,3054,299396706,299397186
22932,5,12,149,5745,-63,-97,34,f6:0a:5c:59:72:df,299397753,280,287,299397473,299397753
22933,5,12,149,5745,-71,-97,26,d2:00:04:7e:2c:ab,299398087,440,-106,299397647,299398087
22934,5,12,149,5745,-67,-97,30,5e:29:73:5b:30:00,299398588,540,-39,299398048,299398588
22935,5,12,149,5745,-60,-97,37,3e:d1:9b:c7:a4:de,299401367,544,2235,299400823,299401367
22936,5,6,149,5745,-90,-97,7,54:e4:3a:ec:fb:65,299401943,360,216,299401583,299401943
22937,5,12,149,5745,-71,-97,26,56:68:e2:c2:8d:d5,299407338,476,4919,299406862,299407338
22938,5,12,149,5745,-89,-97,8,7e:05:42:11:d2:ec,299407848,468,42,299407380,299407848
22939,5,12,149,5745,-90,-97,7,46:28:71:6e:d2:2e,299408925,284,793,299408641,299408925
22940,5,12,149,5745,-61,-97,36,b6:90:18:f6:b1:d4,299409304,268,111,299409036,299409304
22941,5,12,149,5745,-63,-97,34,f6:0a:5c:59:72:df,299409633,476,-147,299409157,299409633
22942,5,12,149,5745,-49,-97,48,4a:86:35:36:74:b8,299410919,268,1018,299410651,299410919
22943,5,12,149,5745,-91,-97,6,3a:90:78:0e:4f:1f,299411886,484,483,299411402,299411886
22944,5,12,149,5745,-71,-97,26,d2:00:04:7e:2c:ab,299412504,380,238,299412124,299412504
22945,5,24,149,5745,-80,-97,17,,299412972,28,440,299412944,299412972
22946,5,24,149,5745,-81,-97,16,,299413016,28,16,299412988,299413016
22947,5,24,149,5745,-81,-97,16,,299413125,32,77,299413093,299413125
22948,5,12,149,5745,-87,-97,10,de:be:a8:cd:79:57,299415177,480,1572,299414697,299415177
22949,5,12,149,5745,-89,-97,8,42:d2:d9:2b:ac:61,299418277,488,2612,299417789,299418277
22950,5,24,149,5745,-81,-97,16,,299427265,28,8960,299427237,299427265
22951,5,24,149,5745,-80,-97,17,,299427309,28,16,299427281,299427309
22952,5,24,149,5745,-80,-97,17,,299427417,32,76,299427385,299427417
22953,5,24,149,5745,-79,-97,18,,299435406,28,7961,299435378,299435406
22954,5,24,149,5745,-81,-97,16,,299435451,28,17,299435423,299435451
22955,5,24,149,5745,-81,-97,16,,299435559,32,76,299435527,299435559
22956,5,12,149,5745,-54,-97,43,3e:d1:9b:c7:a4:de,299438019,272,2188,299437747,299438019
22957,5,12,149,5745,-68,-97,29,6a:1e:a4:f8:14:49,299438442,284,139,299438158,299438442
22958,5,12,149,5745,-70,-97,27,d2:00:04:7e:2c:ab,299439148,244,462,299438904,299439148
22959,5,12,149,5745,-90,-97,7,42:d2:d9:2b:ac:61,299441038,292,1598,299440746,299441038
22960,5,12,149,5745,-65,-97,32,5e:29:73:5b:30:00,299444378,272,3068,299444106,299444378
22961,5,12,149,5745,-66,-97,31,2a:07:ef:54:b5:55,299458941,440,14123,299458501,299458941
22962,5,12,149,5745,-71,-97,26,d2:00:04:7e:2c:ab,299462673,440,3292,299462233,299462673
22963,5,12,149,5745,-68,-97,29,72:d1:72:1d:22:a1,299465066,284,2109,299464782,299465066
22964,5,12,149,5745,-67,-97,30,2a:07:ef:54:b5:55,299469776,244,4466,299469532,299469776
22965,5,12,149,5745,-87,-97,10,7e:05:42:11:d2:ec,299470841,468,597,299470373,299470841
22966,5,12,149,5745,-49,-97,48,4a:86:35:36:74:b8,299474085,268,2976,299473817,299474085
22967,5,24,149,5745,-80,-97,17,,299475289,28,1176,299475261,299475289
22968,5,24,149,5745,-81,-97,16,,299475334,28,17,299475306,299475334
22969,5,24,149,5745,-81,-97,16,,299475445,32,79,299475413,299475445
22970,5,12,149,5745,-64,-97,33,22:ec:75:a8:8a:31,299477520,244,1831,299477276,299477520
22971,5,24,149,5745,-80,-97,17,,299479582,28,2034,299479554,299479582
22972,5,24,149,5745,-81,-97,16,,299479626,28,16,299479598,299479626
22973,5,24,149,5745,-80,-97,17,,299479734,32,76,299479702,299479734
22974,5,24,149,5745,-81,-97,16,,299479936,28,174,299479908,299479936
22975,5,24,149,5745,-80,-97,17,,299479980,28,16,299479952,299479980
22976,5,24,149,5745,-80,-97,17,,299480089,32,77,299480057,299480089
22977,5,24,149,5745,-80,-97,17,,299480209,28,92,299480181,299480209
22978,5,24,149,5745,-81,-97,16,,299480253,28,16,299480225,299480253
22979,5,24,149,5745,-81,-97,16,,299480361,32,76,299480329,299480361
22980,5,24,149,5745,-81,-97,16,,299486244,28,5855,299486216,299486244
22981,5,24,149,5745,-80,-97,17,,299486288,28,16,299486260,299486288
22982,5,24,149,5745,-80,-97,17,,299486396,32,76,299486364,299486396
22983,5,12,149,5745,-71,-97,26,56:68:e2:c2:8d:d5,299495440,280,8764,299495160,299495440
22984,5,24,149,5745,-80,-97,17,,299499415,28,3947,299499387,299499415
22985,5,24,149,5745,-80,-97,17,,299499459,28,16,299499431,299499459
22986,5,24,149,5745,-80,-97,17,,299499567,32,76,299499535,299499567
22987,5,6,149,5745,-88,-97,9,54:e4:3a:ec:fb:65,299504098,360,4171,299503738,299504098
22988,5,24,149,5745,-81,-97,16,,299513629,28,9503,299513601,299513629
22989,5,24,149,5745,-81,-97,16,,299513673,28,16,299513645,299513673
22990,5,24,149,5745,-80,-97,17,,299513781,32,76,299513749,299513781
22991,5,24,149,5745,-81,-97,16,,299516572,28,2763,299516544,299516572
22992,5,24,149,5745,-80,-97,17,,299516734,28,134,299516706,299516734
22993,5,24,149,5745,-80,-97,17,,299517175,28,413,299517147,299517175
22994,5,24,149,5745,-81,-97,16,,299517328,28,125,299517300,299517328
22995,5,24,149,5745,-81,-97,16,,299517372,28,16,299517344,299517372
22996,5,24,149,5745,-81,-97,16,,299517485,32,81,299517453,299517485
22997,5,12,149,5745,-62,-97,35,b6:90:18:f6:b1:d4,299517992,268,239,299517724,299517992
22998,5,12,149,5745,-62,-97,35,f6:0a:5c:59:72:df,299522645,280,4373,299522365,299522645
22999,5,12,149,5745,-64,-97,33,22:ec:75:a8:8a:31,299522995,516,-166,299522479,299522995
23000,5,12,149,5745,-70,-97,27,2a:07:ef:54:b5:55,299524760,440,1325,299524320,299524760
23001,5,12,149,5745,-68,-97,29,5e:29:73:5b:30:00,299526538,540,1238,299525998,299526538
23002,5,24,149,5745,-80,-97,17,,299527924,28,1358,299527896,299527924
23003,5,24,149,5745,-81,-97,16,,299527969,28,17,299527941,299527969
23004,5,24,149,5745,-81,-97,16,,299528076,32,75,299528044,299528076
23005,5,12,149,5745,-68,-97,29,d2:00:04:7e:2c:ab,299528197,440,-319,299527757,299528197
23006,5,12,149,5745,-61,-97,36,3e:d1:9b:c7:a4:de,299532110,544,3369,299531566,299532110
23007,5,12,149,5745,-60,-97,37,a6:92:ad:b7:76:65,299534420,484,1826,299533936,299534420
23008,5,24,149,5745,-81,-97,16,,299535745,28,1297,299535717,299535745
23009,5,24,149,5745,-80,-97,17,,299535789,28,16,299535761,299535789
23010,5,24,149,5745,-82,-97,15,,299536059,28,242,299536031,299536059
23011,5,24,149,5745,-81,-97,16,,299536103,28,16,299536075,299536103
23012,5,24,149,5745,-81,-97,16,,299536212,32,77,299536180,299536212
23013,5,12,149,5745,-68,-97,29,d2:00:04:7e:2c:ab,299536290,244,-166,299536046,299536290
23014,5,12,149,5745,-62,-97,35,b6:90:18:f6:b1:d4,299540277,268,3719,299540009,299540277
23015,5,12,149,5745,-49,-97,48,4a:86:35:36:74:b8,299544006,268,3461,299543738,299544006
23016,5,12,149,5745,-70,-97,27,f2:da:61:dd:98:c5,299544803,268,529,299544535,299544803
23017,5,12,149,5745,-84,-97,13,9a:24:38:da:96:bb,299545178,824,-449,299544354,299545178
23018,5,12,149,5745,-65,-97,32,0a:b9:b7:b1:4d:fa,299546090,268,644,299545822,299546090
23019,5,24,149,5745,-82,-97,15,,299546362,28,244,299546334,299546362
23020,5,24,149,5745,-82,-97,15,,299546469,32,75,299546437,299546469
23021,5,24,149,5745,-82,-97,15,,299548884,28,2387,299548856,299548884
23022,5,24,149,5745,-80,-97,17,,299548929,28,17,299548901,299548929
23023,5,24,149,5745,-80,-97,17,,299549037,32,76,299549005,299549037
23024,5,12,149,5745,-89,-97,8,7e:05:42:11:d2:ec,299551983,272,2674,299551711,299551983
23025,5,6,149,5745,-64,-97,33,48:74:12:82:d8:d5,299553925,248,1694,299553677,299553925
23026,5,12,149,5745,-90,-97,7,42:d2:d9:2b:ac:61,299554541,292,324,299554249,299554541
23027,5,6,149,5745,-66,-97,31,48:74:12:82:d8:d5,299555306,256,509,299555050,299555306
23028,5,6,149,5745,-66,-97,31,48:74:12:82:d8:d5,299556461,260,895,299556201,299556461
23029,5,6,149,5745,-64,-97,33,48:74:12:82:d8:d5,299557503,260,782,299557243,299557503
23030,5,6,149,5745,-65,-97,32,48:74:12:82:d8:d5,299558536,264,769,299558272,299558536
23031,5,6,149,5745,-66,-97,31,48:74:12:82:d8:d5,299559744,268,940,299559476,299559744
23032,5,24,149,5745,-65,-97,32,,299560462,28,690,299560434,299560462
23033,5,24,149,5745,-79,-97,18,,299560506,28,16,299560478,299560506
23034,5,24,149,5745,-80,-97,17,,299560614,28,80,299560586,299560614
23035,5,6,149,5745,-66,-97,31,48:74:12:82:d8:d5,299560895,252,29,299560643,299560895
23036,5,6,149,5745,-63,-97,34,48:74:12:82:d8:d5,299562091,276,920,299561815,299562091
23037,5,12,149,5745,-87,-97,10,9a:24:38:da:96:bb,299562414,272,51,299562142,299562414
23038,5,12,149,5745,-91,-97,6,46:28:71:6e:d2:2e,299562709,252,43,299562457,299562709
23039,5,6,149,5745,-63,-97,34,48:74:12:82:d8:d5,299563150,260,181,299562890,299563150
23040,5,6,149,5745,-63,-97,34,48:74:12:82:d8:d5,299564264,252,862,299564012,299564264
23041,5,6,149,5745,-63,-97,34,48:74:12:82:d8:d5,299565298,264,770,299565034,299565298
23042,5,6,149,5745,-64,-97,33,48:74:12:82:d8:d5,299566434,260,876,299566174,299566434
23043,5,6,149,5745,-64,-97,33,48:74:12:82:d8:d5,299567638,268,936,299567370,299567638
23044,5,6,149,5745,-64,-97,33,48:74:12:82:d8:d5,299568788,264,886,299568524,299568788
23045,5,12,149,5745,-54,-97,43,3e:d1:9b:c7:a4:de,299569140,272,80,299568868,299569140
23046,5,6,149,5745,-64,-97,33,48:74:12:82:d8:d5,299569849,260,449,299569589,299569849
23047,5,24,149,5745,-80,-97,17,,299571010,28,1133,299570982,299571010
23048,5,12,149,5745,-64,-97,33,5e:29:73:5b:30:00,299571231,272,-51,299570959,299571231
23049,5,6,149,5745,-65,-97,32,48:74:12:82:d8:d5,299575260,248,3781,299575012,299575260
23050,5,6,149,5745,-65,-97,32,48:74:12:82:d8:d5,299576812,256,1296,299576556,299576812
23051,5,6,149,5745,-64,-97,33,48:74:12:82:d8:d5,299578039,260,967,299577779,299578039
23052,5,6,149,5745,-65,-97,32,48:74:12:82:d8:d5,299579072,260,773,299578812,299579072
23053,5,6,149,5745,-65,-97,32,48:74:12:82:d8:d5,299580285,264,949,299580021,299580285
23054,5,6,149,5745,-66,-97,31,48:74:12:82:d8:d5,299581403,268,850,299581135,299581403
23055,5,24,149,5745,-79,-97,18,,299581685,28,254,299581657,299581685
23056,5,24,149,5745,-82,-97,15,,299581729,28,16,299581701,299581729
23057,5,24,149,5745,-82,-97,15,,299581840,32,79,299581808,299581840
23058,5,6,149,5745,-65,-97,32,48:74:12:82:d8:d5,299582444,252,352,299582192,299582444
23059,5,6,149,5745,-66,-97,31,48:74:12:82:d8:d5,299583568,276,848,299583292,299583568
23060,5,24,149,5745,-79,-97,18,,299583890,28,294,299583862,299583890
23061,5,24,149,5745,-82,-97,15,,299583934,28,16,299583906,299583934
23062,5,24,149,5745,-82,-97,15,,299584049,32,83,299584017,299584049
23063,5,12,149,5745,-69,-97,28,2a:07:ef:54:b5:55,299584468,244,175,299584224,299584468
23064,5,24,149,5745,-81,-97,16,,299584846,28,350,299584818,299584846
23065,5,24,149,5745,-79,-97,18,,299584890,28,16,299584862,299584890
23066,5,24,149,5745,-79,-97,18,,299584998,32,76,299584966,299584998
23067,5,6,149,5745,-65,-97,32,48:74:12:82:d8:d5,299585071,260,-187,299584811,299585071
23068,5,6,149,5745,-65,-97,32,48:74:12:82:d8:d5,299586149,252,826,299585897,299586149
23069,5,6,149,5745,-65,-97,32,48:74:12:82:d8:d5,299587174,264,761,299586910,299587174
23070,5,6,149,5745,-65,-97,32,48:74:12:82:d8:d5,299588220,260,786,299587960,299588220
23071,5,6,149,5745,-65,-97,32,48:74:12:82:d8:d5,299589370,268,882,299589102,299589370
23072,5,12,149,5745,-70,-97,27,2a:07:ef:54:b5:55,299589963,440,153,299589523,299589963
23073,5,6,149,5745,-65,-97,32,48:74:12:82:d8:d5,299590524,264,297,299590260,299590524
23074,5,12,149,5745,-63,-97,34,22:ec:75:a8:8a:31,299591226,244,458,299590982,299591226
23075,5,6,149,5745,-65,-97,32,48:74:12:82:d8:d5,299591582,260,96,299591322,299591582
23076,5,24,149,5745,-83,-97,14,,299591924,28,314,299591896,299591924
23077,5,24,149,5745,-79,-97,18,,299591968,28,16,299591940,299591968
23078,5,24,149,5745,-79,-97,18,,299592076,32,76,299592044,299592076
23079,5,12,149,5745,-68,-97,29,d2:00:04:7e:2c:ab,299592845,440,329,299592405,299592845
23080,5,12,149,5745,-50,-97,47,4a:86:35:36:74:b8,299595831,268,2718,299595563,299595831
23081,5,12,149,5745,-66,-97,31,6a:1e:a4:f8:14:49,299603765,284,7650,299603481,299603765
23082,5,24,149,5745,-79,-97,18,,299604128,28,335,299604100,299604128
23083,5,24,149,5745,-82,-97,15,,299604172,28,16,299604144,299604172
23084,5,24,149,5745,-82,-97,15,,299604280,32,76,299604248,299604280
23085,5,6,149,5745,-89,-97,8,54:e4:3a:ec:fb:65,299606498,360,1858,299606138,299606498
23086,5,12,149,5745,-58,-97,39,b6:90:18:f6:b1:d4,299628360,268,21594,299628092,299628360
23087,5,12,149,5745,-66,-97,31,72:d1:72:1d:22:a1,299631354,284,2710,299631070,299631354
23088,5,12,149,5745,-66,-97,31,56:68:e2:c2:8d:d5,299633229,280,1595,299632949,299633229
23089,5,12,149,5745,-88,-97,9,de:be:a8:cd:79:57,299640550,284,7037,299640266,299640550
23090,5,12,149,5745,-58,-97,39,3e:d1:9b:c7:a4:de,299664684,272,23862,299664412,299664684
23091,5,12,149,5745,-69,-97,28,d2:00:04:7e:2c:ab,299665672,244,744,299665428,299665672
23092,5,12,149,5745,-65,-97,32,5e:29:73:5b:30:00,299673819,272,7875,299673547,299673819
23093,5,12,149,5745,-92,-97,5,46:28:71:6e:d2:2e,299679267,252,5196,299679015,299679267
23094,5,12,149,5745,-51,-97,46,4a:86:35:36:74:b8,299700177,268,20642,299699909,299700177
23095,5,12,149,5745,-68,-97,29,6a:1e:a4:f8:14:49,299706037,284,5576,299705753,299706037
23096,5,12,149,5745,-60,-97,37,22:ec:75:a8:8a:31,299708498,244,2217,299708254,299708498
23097,5,12,149,5745,-68,-97,29,2a:07:ef:54:b5:55,299709111,244,369,299708867,299709111
23098,5,12,149,5745,-69,-97,28,72:d1:72:1d:22:a1,299733246,284,23851,299732962,299733246
23099,5,12,149,5745,-65,-97,32,56:68:e2:c2:8d:d5,299734698,280,1172,299734418,299734698
23100,5,12,149,5745,-58,-97,39,b6:90:18:f6:b1:d4,299740485,268,5519,299740217,299740485
23101,5,12,149,5745,-89,-97,8,42:d2:d9:2b:ac:61,299746982,292,6205,299746690,299746982
23102,5,12,149,5745,-86,-97,11,7e:05:42:11:d2:ec,299751683,272,4429,299751411,299751683
23103,5,12,149,5745,-88,-97,9,de:be:a8:cd:79:57,299752363,284,396,299752079,299752363
23104,5,24,149,5745,-80,-97,17,,299779015,28,26624,299778987,299779015
23105,5,24,149,5745,-81,-97,16,,299779059,28,16,299779031,299779059
23106,5,24,149,5745,-81,-97,16,,299779171,32,80,299779139,299779171
23107,5,12,149,5745,-54,-97,43,3e:d1:9b:c7:a4:de,299781835,272,2392,299781563,299781835
23108,5,24,149,5745,-81,-97,16,,299787472,28,5609,299787444,299787472
23109,5,24,149,5745,-81,-97,16,,299787516,28,16,299787488,299787516
23110,5,24,149,5745,-80,-97,17,,299787624,32,76,299787592,299787624
23111,5,12,149,5745,-66,-97,31,5e:29:73:5b:30:00,299790860,272,2964,299790588,299790860
23112,5,24,149,5745,-81,-97,16,,299795013,28,4125,299794985,299795013
23113,5,24,149,5745,-81,-97,16,,299795057,28,16,299795029,299795057
23114,5,24,149,5745,-80,-97,17,,299795165,32,76,299795133,299795165
23115,5,24,149,5745,-80,-97,17,,299797802,28,2609,299797774,299797802
23116,5,24,149,5745,-81,-97,16,,299797846,28,16,299797818,299797846
23117,5,24,149,5745,-82,-97,15,,299797954,32,76,299797922,299797954
23118,5,24,149,5745,-82,-97,15,,299800043,32,2057,299800011,299800043
23119,5,12,149,5745,-67,-97,30,6a:1e:a4:f8:14:49,299808557,284,8230,299808273,299808557
23120,5,6,149,5745,-89,-97,8,54:e4:3a:ec:fb:65,299811299,360,2382,299810939,299811299
23121,5,12,149,5745,-52,-97,45,4a:86:35:36:74:b8,299813180,268,1613,299812912,299813180
23122,5,24,149,5745,-82,-97,15,,299818811,28,5603,299818783,299818811
23123,5,6,149,5745,-92,-97,5,,299818971,68,92,299818903,299818971
23124,5,12,149,5745,-69,-97,28,2a:07:ef:54:b5:55,299821688,244,2473,299821444,299821688
23125,5,12,149,5745,-65,-97,32,22:ec:75:a8:8a:31,299825584,244,3652,299825340,299825584
23126,5,12,149,5745,-67,-97,30,72:d1:72:1d:22:a1,299835976,284,10108,299835692,299835976
23127,5,12,149,5745,-70,-97,27,d2:00:04:7e:2c:ab,299836355,244,135,299836111,299836355
23128,5,12,149,5745,-64,-97,33,56:68:e2:c2:8d:d5,299838611,280,1976,299838331,299838611
23129,5,12,149,5745,-90,-97,7,42:d2:d9:2b:ac:61,299849182,292,10279,299848890,299849182
23130,5,12,149,5745,-88,-97,9,7e:05:42:11:d2:ec,299853763,272,4309,299853491,299853763
23131,5,12,149,5745,-62,-97,35,f6:0a:5c:59:72:df,299857938,280,3895,299857658,299857938
23132,5,24,149,5745,-81,-97,16,,299862281,32,4311,299862249,299862281
23133,5,12,149,5745,-53,-97,44,3e:d1:9b:c7:a4:de,299896409,272,33856,299896137,299896409
23134,5,12,149,5745,-66,-97,31,5e:29:73:5b:30:00,299902118,272,5437,299901846,299902118
23135,5,12,149,5745,-70,-97,27,6a:1e:a4:f8:14:49,299909605,284,7203,299909321,299909605
23136,5,6,149,5745,-87,-97,10,54:e4:3a:ec:fb:65,299913700,360,3735,299913340,299913700
23137,5,24,149,5745,-64,-97,33,,299914365,28,637,299914337,299914365
23138,5,24,149,5745,-80,-97,17,,299914410,28,17,299914382,299914410
23139,5,24,149,5745,-80,-97,17,,299914518,28,80,299914490,299914518
23140,5,12,149,5745,-51,-97,46,4a:86:35:36:74:b8,299926141,268,11355,299925873,299926141
23141,5,12,149,5745,-66,-97,31,2a:07:ef:54:b5:55,299928856,244,2471,299928612,299928856
23142,5,24,149,5745,-81,-97,16,,299932239,32,3351,299932207,299932239
23143,5,24,149,5745,-80,-97,17,,299932801,32,530,299932769,299932801
23144,5,24,149,5745,-80,-97,17,,299933364,28,535,299933336,299933364
23145,5,24,149,5745,-68,-97,29,,299933408,28,16,299933380,299933408
23146,5,12,149,5745,-63,-97,34,22:ec:75:a8:8a:31,299937392,244,3740,299937148,299937392
23147,5,12,149,5745,-65,-97,32,72:d1:72:1d:22:a1,299937681,284,5,299937397,299937681
23148,5,12,149,5745,-54,-97,43,b6:90:18:f6:b1:d4,299938001,268,52,299937733,299938001
23149,5,12,149,5745,-70,-97,27,d2:00:04:7e:2c:ab,299938609,244,364,299938365,299938609
23150,5,12,149,5745,-63,-97,34,56:68:e2:c2:8d:d5,299938941,280,52,299938661,299938941
23151,5,24,149,5745,-81,-97,16,,299940776,28,1807,299940748,299940776
23152,5,24,149,5745,-80,-97,17,,299940820,28,16,299940792,299940820
23153,5,24,149,5745,-80,-97,17,,299940929,32,77,299940897,299940929
23154,5,12,149,5745,-54,-97,43,b6:90:18:f6:b1:d4,299944960,268,3763,299944692,299944960
23155,5,12,149,5745,-90,-97,7,42:d2:d9:2b:ac:61,299951740,292,6488,299951448,299951740
23156,5,12,149,5745,-87,-97,10,de:be:a8:cd:79:57,299954539,284,2515,299954255,299954539
23157,5,12,149,5745,-88,-97,9,7e:05:42:11:d2:ec,299955304,272,493,299955032,299955304
23158,5,24,149,5745,-81,-97,16,,299956044,28,712,299956016,299956044
23159,5,24,149,5745,-80,-97,17,,299956088,28,16,299956060,299956088
23160,5,24,149,5745,-80,-97,17,,299956196,32,76,299956164,299956196
23161,5,12,149,5745,-63,-97,34,f6:0a:5c:59:72:df,299963307,280,6831,299963027,299963307
23162,5,12,149,5745,-90,-97,7,3a:90:78:0e:4f:1f,299972434,284,8843,299972150,299972434
23163,5,24,149,5745,-63,-97,34,,299975388,28,2926,299975360,299975388
23164,5,24,149,5745,-81,-97,16,,299975432,28,16,299975404,299975432
23165,5,24,149,5745,-81,-97,16,,299975540,28,80,299975512,299975540
23166,5,24,149,5745,-63,-97,34,,299975658,28,90,299975630,299975658
23167,5,24,149,5745,-81,-97,16,,299975702,28,16,299975674,299975702
23168,5,24,149,5745,-81,-97,16,,299975810,28,80,299975782,299975810
23169,5,12,149,5745,-64,-97,33,72:d1:72:1d:22:a1,299977583,480,1293,299977103,299977583
23170,5,12,149,5745,-92,-97,5,4e:72:d0:f1:a2:44,299978986,468,935,299978518,299978986
23171,5,12,149,5745,-61,-97,36,22:ec:75:a8:8a:31,299979524,516,22,299979008,299979524
23172,5,12,149,5745,-88,-97,9,de:be:a8:cd:79:57,299982723,284,2915,299982439,299982723
23173,5,12,149,5745,-67,-97,30,2a:07:ef:54:b5:55,299984088,440,925,299983648,299984088
23174,5,12,149,5745,-69,-97,28,6a:1e:a4:f8:14:49,299985832,480,1264,299985352,299985832
23175,5,12,149,5745,-66,-97,31,5e:29:73:5b:30:00,299986346,540,-26,299985806,299986346
23176,5,12,149,5745,-72,-97,25,d2:00:04:7e:2c:ab,299986920,440,134,299986480,299986920
23177,5,12,149,5745,-87,-97,10,7e:05:42:11:d2:ec,299987532,468,144,299987064,299987532
23178,5,12,149,5745,-57,-97,40,3e:d1:9b:c7:a4:de,299988562,544,486,299988018,299988562
23179,5,24,149,5745,-81,-97,16,,299991994,32,3400,299991962,299991994
23180,5,24,149,5745,-81,-97,16,,299992448,28,426,299992420,299992448
23181,5,12,149,5745,-64,-97,33,56:68:e2:c2:8d:d5,299994804,476,1880,299994328,299994804
23182,5,12,149,5745,-70,-97,27,d2:00:04:7e:2c:ab,299995325,244,277,299995081,299995325
23183,5,12,149,5745,-69,-97,28,6a:1e:a4:f8:14:49,299995630,284,21,299995346,299995630
23184,5,12,149,5745,-89,-97,8,42:d2:d9:2b:ac:61,299996776,292,854,299996484,299996776
23185,5,12,149,5745,-56,-97,41,b6:90:18:f6:b1:d4,299998253,268,1209,299997985,299998253
23186,5,12,149,5745,-62,-97,35,f6:0a:5c:59:72:df,300000696,476,1967,300000220,300000696
23187,5,12,149,5745,-90,-97,7,3a:90:78:0e:4f:1f,300001780,484,600,300001296,300001780
23188,5,12,149,5745,-52,-97,45,4a:86:35:36:74:b8,300003125,268,1077,300002857,300003125
23189,5,12,149,5745,-89,-97,8,de:be:a8:cd:79:57,300004587,480,982,300004107,300004587
23190,5,12,149,5745,-89,-97,8,42:d2:d9:2b:ac:61,300005771,488,696,300005283,300005771
23191,5,12,149,5745,-63,-97,34,72:d1:72:1d:22:a1,300010539,284,4484,300010255,300010539
23192,5,6,149,5745,-88,-97,9,54:e4:3a:ec:fb:65,300016100,360,5201,300015740,300016100
23193,5,12,149,5745,-52,-97,45,4a:86:35:36:74:b8,300027090,268,10722,300026822,300027090
23194,5,12,149,5745,-56,-97,41,3e:d1:9b:c7:a4:de,300027392,272,30,300027120,300027392
23195,5,12,149,5745,-67,-97,30,5e:29:73:5b:30:00,300029021,272,1357,300028749,300029021
23196,5,12,149,5745,-70,-97,27,2a:07:ef:54:b5:55,300043207,244,13942,300042963,300043207
23197,5,12,149,5745,-63,-97,34,72:d1:72:1d:22:a1,300043493,480,-194,300043013,300043493
23198,5,12,149,5745,-65,-97,32,56:68:e2:c2:8d:d5,300044035,280,262,300043755,300044035
23199,5,12,149,5745,-63,-97,34,22:ec:75:a8:8a:31,300044887,516,336,300044371,300044887
23200,5,12,149,5745,-70,-97,27,6a:1e:a4:f8:14:49,300048524,480,3157,300048044,300048524
23201,5,12,149,5745,-71,-97,26,2a:07:ef:54:b5:55,300049049,440,85,300048609,300049049
23202,5,12,149,5745,-65,-97,32,5e:29:73:5b:30:00,300051459,540,1870,300050919,300051459
23203,5,12,149,5745,-87,-97,10,7e:05:42:11:d2:ec,300052709,468,782,300052241,300052709
23204,5,12,149,5745,-69,-97,28,d2:00:04:7e:2c:ab,300053266,440,117,300052826,300053266
23205,5,12,149,5745,-57,-97,40,3e:d1:9b:c7:a4:de,300053776,544,-34,300053232,300053776
23206,5,24,149,5745,-64,-97,33,,300055492,28,1688,300055464,300055492
23207,5,24,149,5745,-80,-97,17,,300055536,28,16,300055508,300055536
23208,5,24,149,5745,-80,-97,17,,300055644,28,80,300055616,300055644
23209,5,12,149,5745,-87,-97,10,7e:05:42:11:d2:ec,300056474,360,470,300056114,300056474
23210,5,12,149,5745,-64,-97,33,22:ec:75:a8:8a:31,300058730,244,2012,300058486,300058730
23211,5,12,149,5745,-63,-97,34,a6:92:ad:b7:76:65,300059026,484,-188,300058542,300059026
23212,5,12,149,5745,-65,-97,32,56:68:e2:c2:8d:d5,300060139,476,637,300059663,300060139
23213,5,12,149,5745,-89,-97,8,3a:90:78:0e:4f:1f,300060987,484,364,300060503,300060987
23214,5,12,149,5745,-57,-97,40,b6:90:18:f6:b1:d4,300062450,268,1195,300062182,300062450
23215,5,12,149,5745,-88,-97,9,9a:24:38:da:96:bb,300064091,824,817,300063267,300064091
23216,5,12,149,5745,-65,-97,32,f6:0a:5c:59:72:df,300064931,476,364,300064455,300064931
23217,5,12,149,5745,-52,-97,45,4a:86:35:36:74:b8,300067009,268,1810,300066741,300067009
23218,5,12,149,5745,-68,-97,29,f2:da:61:dd:98:c5,300068256,268,979,300067988,300068256
23219,5,12,149,5745,-68,-97,29,0a:b9:b7:b1:4d:fa,300069071,268,547,300068803,300069071
23220,5,12,149,5745,-89,-97,8,42:d2:d9:2b:ac:61,300071058,484,1503,300070574,300071058
23221,5,12,149,5745,-58,-97,39,b6:90:18:f6:b1:d4,300075054,268,3728,300074786,300075054
23222,5,12,149,5745,-65,-97,32,f6:0a:5c:59:72:df,300075410,280,76,300075130,300075410
23223,5,12,149,5745,-92,-97,5,3a:90:78:0e:4f:1f,300085625,284,9931,300085341,300085625
23224,5,12,149,5745,-88,-97,9,de:be:a8:cd:79:57,300097853,284,11944,300097569,300097853
23225,5,24,149,5745,-79,-97,18,,300101735,28,3854,300101707,300101735
23226,5,24,149,5745,-81,-97,16,,300101779,28,16,300101751,300101779
23227,5,24,149,5745,-81,-97,16,,300101892,32,81,300101860,300101892
23228,5,24,149,5745,-79,-97,18,,300102902,28,982,300102874,300102902
23229,5,24,149,5745,-81,-97,16,,300102947,28,17,300102919,300102947
23230,5,24,149,5745,-81,-97,16,,300103059,32,80,300103027,300103059
23231,5,24,149,5745,-81,-97,16,,300103170,28,83,300103142,300103170
23232,5,24,149,5745,-80,-97,17,,300103214,28,16,300103186,300103214
23233,5,24,149,5745,-79,-97,18,,300103322,32,76,300103290,300103322
23234,5,24,149,5745,-81,-97,16,,300103506,28,156,300103478,300103506
23235,5,24,149,5745,-79,-97,18,,300103550,28,16,300103522,300103550
23236,5,24,149,5745,-79,-97,18,,300103662,32,80,300103630,300103662
23237,5,24,149,5745,-81,-97,16,,300104119,28,429,300104091,300104119
23238,5,24,149,5745,-79,-97,18,,300104163,28,16,300104135,300104163
23239,5,24,149,5745,-80,-97,17,,300104271,32,76,300104239,300104271
23240,5,24,149,5745,-81,-97,16,,300104451,28,152,300104423,300104451
23241,5,24,149,5745,-79,-97,18,,300104495,28,16,300104467,300104495
23242,5,24,149,5745,-80,-97,17,,300104607,32,80,300104575,300104607
23243,5,24,149,5745,-79,-97,18,,300106967,28,2332,300106939,300106967
23244,5,24,149,5745,-81,-97,16,,300107011,28,16,300106983,300107011
23245,5,24,149,5745,-82,-97,15,,300107131,32,88,300107099,300107131
23246,5,24,149,5745,-79,-97,18,,300108079,28,920,300108051,300108079
23247,5,24,149,5745,-81,-97,16,,300108123,28,16,300108095,300108123
23248,5,24,149,5745,-81,-97,16,,300108243,32,88,300108211,300108243
23249,5,24,149,5745,-79,-97,18,,300109195,28,924,300109167,300109195
23250,5,24,149,5745,-81,-97,16,,300109239,28,16,300109211,300109239
23251,5,24,149,5745,-81,-97,16,,300109351,32,80,300109319,300109351
23252,5,12,149,5745,-71,-97,26,d2:00:04:7e:2c:ab,300109733,244,138,300109489,300109733
23253,5,24,149,5745,-79,-97,18,,300110128,28,367,300110100,300110128
23254,5,24,149,5745,-81,-97,16,,300110172,28,16,300110144,300110172
23255,5,24,149,5745,-81,-97,16,,300110285,32,81,300110253,300110285
23256,5,12,149,5745,-66,-97,31,2a:07:ef:54:b5:55,300114269,440,3544,300113829,300114269
23257,5,12,149,5745,-71,-97,26,d2:00:04:7e:2c:ab,300117918,440,3209,300117478,300117918
23258,5,6,149,5745,-88,-97,9,54:e4:3a:ec:fb:65,300118501,360,223,300118141,300118501
23259,5,12,149,5745,-69,-97,28,6a:1e:a4:f8:14:49,300122956,284,4171,300122672,300122956
23260,5,12,149,5745,-89,-97,8,42:d2:d9:2b:ac:61,300125444,288,2200,300125156,300125444
23261,5,12,149,5745,-57,-97,40,3e:d1:9b:c7:a4:de,300125767,272,51,300125495,300125767
23262,5,24,149,5745,-82,-97,15,,300128875,28,3080,300128847,300128875
23263,5,24,149,5745,-79,-97,18,,300128919,28,16,300128891,300128919
23264,5,24,149,5745,-79,-97,18,,300129038,32,87,300129006,300129038
23265,5,24,149,5745,-81,-97,16,,300129512,28,446,300129484,300129512
23266,5,24,149,5745,-79,-97,18,,300129556,28,16,300129528,300129556
23267,5,24,149,5745,-79,-97,18,,300129678,32,90,300129646,300129678
23268,5,12,149,5745,-64,-97,33,5e:29:73:5b:30:00,300131337,272,1387,300131065,300131337
23269,5,24,149,5745,-79,-97,18,,300131901,28,536,300131873,300131901
23270,5,24,149,5745,-82,-97,15,,300131945,28,16,300131917,300131945
23271,5,24,149,5745,-82,-97,15,,300132057,32,80,300132025,300132057
23272,5,12,149,5745,-66,-97,31,72:d1:72:1d:22:a1,300135849,284,3508,300135565,300135849
23273,5,24,149,5745,-81,-97,16,,300142019,28,6142,300141991,300142019
23274,5,24,149,5745,-79,-97,18,,300142063,28,16,300142035,300142063
23275,5,24,149,5745,-79,-97,18,,300142171,32,76,300142139,300142171
23276,5,24,149,5745,-79,-97,18,,300142283,32,80,300142251,300142283
23277,5,24,149,5745,-79,-97,18,,300144701,28,2390,300144673,300144701
23278,5,24,149,5745,-81,-97,16,,300144745,28,16,300144717,300144745
23279,5,24,149,5745,-81,-97,16,,300144853,32,76,300144821,300144853
23280,5,24,149,5745,-81,-97,16,,300145797,28,916,300145769,300145797
23281,5,24,149,5745,-79,-97,18,,300145842,28,17,300145814,300145842
23282,5,24,149,5745,-79,-97,18,,300145950,32,76,300145918,300145950
23283,5,24,149,5745,-79,-97,18,,300146061,32,79,300146029,300146061
23284,5,24,149,5745,-79,-97,18,,300148222,28,2133,300148194,300148222
23285,5,24,149,5745,-81,-97,16,,300148266,28,16,300148238,300148266
23286,5,24,149,5745,-81,-97,16,,300148378,32,80,300148346,300148378
23287,5,24,149,5745,-79,-97,18,,300149430,28,1024,300149402,300149430
23288,5,24,149,5745,-81,-97,16,,300149474,28,16,300149446,300149474
23289,5,24,149,5745,-81,-97,16,,300149586,32,80,300149554,300149586
23290,5,12,149,5745,-65,-97,32,2a:07:ef:54:b5:55,300158292,244,8462,300158048,300158292
23291,5,24,149,5745,-81,-97,16,,300159247,28,927,300159219,300159247
23292,5,24,149,5745,-79,-97,18,,300159291,28,16,300159263,300159291
23293,5,24,149,5745,-79,-97,18,,300159409,32,86,300159377,300159409
23294,5,24,149,5745,-81,-97,16,,300160459,28,1022,300160431,300160459
23295,5,24,149,5745,-79,-97,18,,300160503,28,16,300160475,300160503
23296,5,24,149,5745,-79,-97,18,,300160632,32,97,300160600,300160632
23297,5,24,149,5745,-81,-97,16,,300160822,28,162,300160794,300160822
23298,5,24,149,5745,-79,-97,18,,300160867,28,17,300160839,300160867
23299,5,24,149,5745,-79,-97,18,,300160985,32,86,300160953,300160985
23300,5,24,149,5745,-81,-97,16,,300161148,28,135,300161120,300161148
23301,5,24,149,5745,-79,-97,18,,300161192,28,16,300161164,300161192
23302,5,24,149,5745,-79,-97,18,,300161300,32,76,300161268,300161300
23303,5,24,149,5745,-80,-97,17,,300161926,28,598,300161898,300161926
23304,5,24,149,5745,-79,-97,18,,300161970,28,16,300161942,300161970
23305,5,24,149,5745,-79,-97,18,,300162079,32,77,300162047,300162079
23306,5,24,149,5745,-79,-97,18,,300162490,28,383,300162462,300162490
23307,5,24,149,5745,-81,-97,16,,300162534,28,16,300162506,300162534
23308,5,24,149,5745,-81,-97,16,,300162642,32,76,300162610,300162642
23309,5,24,149,5745,-81,-97,16,,300163435,28,765,300163407,300163435
23310,5,24,149,5745,-79,-97,18,,300163479,28,16,300163451,300163479
23311,5,24,149,5745,-79,-97,18,,300163587,32,76,300163555,300163587
23312,5,24,149,5745,-79,-97,18,,300164703,28,1088,300164675,300164703
23313,5,24,149,5745,-81,-97,16,,300164747,28,16,300164719,300164747
23314,5,24,149,5745,-80,-97,17,,300164859,32,80,300164827,300164859
23315,5,12,149,5745,-65,-97,32,22:ec:75:a8:8a:31,300167200,244,2097,300166956,300167200
23316,5,24,149,5745,-80,-97,17,,300177113,28,9885,300177085,300177113
23317,5,24,149,5745,-79,-97,18,,300177157,28,16,300177129,300177157
23318,5,24,149,5745,-78,-97,19,,300177272,32,83,300177240,300177272
23319,5,24,149,5745,-78,-97,19,,300177384,32,80,300177352,300177384
23320,5,24,149,5745,-79,-97,18,,300180970,28,3558,300180942,300180970
23321,5,24,149,5745,-80,-97,17,,300181014,28,16,300180986,300181014
23322,5,24,149,5745,-80,-97,17,,300181123,32,77,300181091,300181123
23323,5,24,149,5745,-79,-97,18,,300195960,28,14809,300195932,300195960
23324,5,24,149,5745,-80,-97,17,,300196004,28,16,300195976,300196004
23325,5,24,149,5745,-80,-97,17,,300196112,32,76,300196080,300196112
23326,5,24,149,5745,-79,-97,18,,300207836,28,11696,300207808,300207836
23327,5,24,149,5745,-80,-97,17,,300207880,28,16,300207852,300207880
23328,5,24,149,5745,-79,-97,18,,300207989,32,77,300207957,300207989
23329,5,24,149,5745,-80,-97,17,,300215953,28,7936,300215925,300215953
23330,5,24,149,5745,-80,-97,17,,300215996,28,15,300215968,300215996
23331,5,24,149,5745,-79,-97,18,,300216112,32,84,300216080,300216112
23332,5,24,149,5745,-80,-97,17,,300216268,28,128,300216240,300216268
23333,5,24,149,5745,-80,-97,17,,300216312,28,16,300216284,300216312
23334,5,24,149,5745,-80,-97,17,,300216420,32,76,300216388,300216420
23335,5,24,149,5745,-80,-97,17,,300216578,28,130,300216550,300216578
23336,5,24,149,5745,-80,-97,17,,300216623,28,17,300216595,300216623
23337,5,24,149,5745,-80,-97,17,,300216731,32,76,300216699,300216731
23338,5,24,149,5745,-80,-97,17,,300219078,28,2319,300219050,300219078
23339,5,24,149,5745,-80,-97,17,,300219122,28,16,300219094,300219122
23340,5,24,149,5745,-80,-97,17,,300219230,32,76,300219198,300219230
23341,5,24,149,5745,-80,-97,17,,300220110,28,852,300220082,300220110
23342,5,24,149,5745,-80,-97,17,,300220154,28,16,300220126,300220154
23343,5,24,149,5745,-79,-97,18,,300220262,32,76,300220230,300220262
23344,5,6,149,5745,-89,-97,8,54:e4:3a:ec:fb:65,300220901,360,279,300220541,300220901
23345,5,12,149,5745,-51,-97,46,4a:86:35:36:74:b8,300221771,268,602,300221503,300221771
23346,5,24,149,5745,-80,-97,17,,300223963,28,2164,300223935,300223963
23347,5,24,149,5745,-80,-97,17,,300224007,28,16,300223979,300224007
23348,5,24,149,5745,-80,-97,17,,300224115,32,76,300224083,300224115
23349,5,24,149,5745,-80,-97,17,,300225033,28,890,300225005,300225033
23350,5,24,149,5745,-80,-97,17,,300225077,28,16,300225049,300225077
23351,5,24,149,5745,-79,-97,18,,300225185,32,76,300225153,300225185
23352,5,12,149,5745,-70,-97,27,6a:1e:a4:f8:14:49,300226463,284,994,300226179,300226463
23353,5,24,149,5745,-80,-97,17,,300226908,28,417,300226880,300226908
23354,5,24,149,5745,-80,-97,17,,300226952,28,16,300226924,300226952
23355,5,24,149,5745,-80,-97,17,,300227060,32,76,300227028,300227060
23356,5,24,149,5745,-79,-97,18,,300227953,28,865,300227925,300227953
23357,5,24,149,5745,-80,-97,17,,300227997,28,16,300227969,300227997
23358,5,24,149,5745,-80,-97,17,,300228110,32,81,300228078,300228110
23359,5,12,149,5745,-70,-97,27,d2:00:04:7e:2c:ab,300236199,244,7845,300235955,300236199
23360,5,12,149,5745,-85,-97,12,9a:24:38:da:96:bb,300240880,272,4409,300240608,300240880
23361,5,12,149,5745,-58,-97,39,3e:d1:9b:c7:a4:de,300243261,272,2109,300242989,300243261
23362,5,12,149,5745,-58,-97,39,b6:90:18:f6:b1:d4,300245315,268,1786,300245047,300245315
23363,5,12,149,5745,-91,-97,6,4e:72:d0:f1:a2:44,300247072,272,1485,300246800,300247072
23364,5,12,149,5745,-65,-97,32,5e:29:73:5b:30:00,300248241,272,897,300247969,300248241
23365,5,12,149,5745,-67,-97,30,72:d1:72:1d:22:a1,300248911,284,386,300248627,300248911
23366,5,12,149,5745,-90,-97,7,42:d2:d9:2b:ac:61,300259387,288,10188,300259099,300259387
23367,5,12,149,5745,-91,-97,6,de:be:a8:cd:79:57,300265435,284,5764,300265151,300265435
23368,5,24,149,5745,-81,-97,16,,300278329,28,12866,300278301,300278329
23369,5,24,149,5745,-80,-97,17,,300278374,28,17,300278346,300278374
23370,5,24,149,5745,-80,-97,17,,300278482,32,76,300278450,300278482
23371,5,12,149,5745,-65,-97,32,22:ec:75:a8:8a:31,300281716,244,2990,300281472,300281716
23372,5,24,149,5745,-80,-97,17,,300285697,28,3953,300285669,300285697
23373,5,24,149,5745,-81,-97,16,,300285741,28,16,300285713,300285741
23374,5,24,149,5745,-81,-97,16,,300285850,32,77,300285818,300285850
23375,5,24,149,5745,-82,-97,15,,300286639,28,761,300286611,300286639
23376,5,24,149,5745,-80,-97,17,,300286683,28,16,300286655,300286683
23377,5,24,149,5745,-80,-97,17,,300286799,32,84,300286767,300286799
23378,5,24,149,5745,-82,-97,15,,300286883,28,56,300286855,300286883
23379,5,24,149,5745,-81,-97,16,,300286927,28,16,300286899,300286927
23380,5,24,149,5745,-80,-97,17,,300287035,32,76,300287003,300287035
23381,5,24,149,5745,-81,-97,16,,300293019,28,5956,300292991,300293019
23382,5,24,149,5745,-81,-97,16,,300293063,28,16,300293035,300293063
23383,5,24,149,5745,-81,-97,16,,300293172,32,77,300293140,300293172
23384,5,24,149,5745,-81,-97,16,,300300216,28,7016,300300188,300300216
23385,5,24,149,5745,-81,-97,16,,300300260,28,16,300300232,300300260
23386,5,24,149,5745,-81,-97,16,,300300368,32,76,300300336,300300368
23387,5,24,149,5745,-81,-97,16,,300307482,28,7086,300307454,300307482
23388,5,24,149,5745,-81,-97,16,,300307527,28,17,300307499,300307527
23389,5,24,149,5745,-82,-97,15,,300307635,32,76,300307603,300307635
23390,5,12,149,5745,-64,-97,33,f6:0a:5c:59:72:df,300317428,280,9513,300317148,300317428
23391,5,24,149,5745,-81,-97,16,,300320160,28,2704,300320132,300320160
23392,5,24,149,5745,-81,-97,16,,300320204,28,16,300320176,300320204
23393,5,24,149,5745,-81,-97,16,,300320312,32,76,300320280,300320312
23394,5,12,149,5745,-51,-97,46,4a:86:35:36:74:b8,300323450,268,2870,300323182,300323450
23395,5,12,149,5745,-62,-97,35,2a:07:ef:54:b5:55,300323845,244,151,300323601,300323845
23396,5,12,149,5745,-69,-97,28,6a:1e:a4:f8:14:49,300335864,284,11735,300335580,300335864
23397,5,12,149,5745,-90,-97,7,3a:90:78:0e:4f:1f,300339293,284,3145,300339009,300339293
23398,5,12,149,5745,-69,-97,28,d2:00:04:7e:2c:ab,300346623,244,7086,300346379,300346623
23399,5,12,149,5745,-58,-97,39,b6:90:18:f6:b1:d4,300347734,268,843,300347466,300347734
23400,5,12,149,5745,-64,-97,33,56:68:e2:c2:8d:d5,300348487,280,473,300348207,300348487
23401,5,24,149,5745,-81,-97,16,,300354804,28,6289,300354776,300354804
23402,5,24,149,5745,-82,-97,15,,300354848,28,16,300354820,300354848
23403,5,24,149,5745,-81,-97,16,,300354960,32,80,300354928,300354960
23404,5,24,149,5745,-81,-97,16,,300358151,28,3163,300358123,300358151
23405,5,24,149,5745,-80,-97,17,,300358195,28,16,300358167,300358195
23406,5,24,149,5745,-81,-97,16,,300358304,32,77,300358272,300358304
23407,5,12,149,5745,-54,-97,43,3e:d1:9b:c7:a4:de,300358370,272,-206,300358098,300358370
23408,5,24,149,5745,-81,-97,16,,300358713,28,315,300358685,300358713
23409,5,24,149,5745,-81,-97,16,,300358757,28,16,300358729,300358757
23410,5,24,149,5745,-82,-97,15,,300358865,32,76,300358833,300358865
23411,5,24,149,5745,-80,-97,17,,300359048,28,155,300359020,300359048
23412,5,24,149,5745,-81,-97,16,,300359092,28,16,300359064,300359092
23413,5,24,149,5745,-82,-97,15,,300359200,32,76,300359168,300359200
23414,5,12,149,5745,-68,-97,29,72:d1:72:1d:22:a1,300360280,284,796,300359996,300360280
23415,5,12,149,5745,-89,-97,8,de:be:a8:cd:79:57,300361012,284,448,300360728,300361012
23416,5,12,149,5745,-87,-97,10,42:d2:d9:2b:ac:61,300361402,288,102,300361114,300361402
23417,5,12,149,5745,-67,-97,30,5e:29:73:5b:30:00,300365037,272,3363,300364765,300365037
23418,5,12,149,5745,-88,-97,9,7e:05:42:11:d2:ec,300366215,244,934,300365971,300366215
23419,5,24,149,5745,-82,-97,15,,300366638,28,395,300366610,300366638
23420,5,24,149,5745,-81,-97,16,,300366682,28,16,300366654,300366682
23421,5,24,149,5745,-81,-97,16,,300366790,32,76,300366758,300366790
23422,5,24,149,5745,-81,-97,16,,300370003,28,3185,300369975,300370003
23423,5,24,149,5745,-81,-97,16,,300370047,28,16,300370019,300370047
23424,5,24,149,5745,-81,-97,16,,300370155,32,76,300370123,300370155
23425,5,24,149,5745,-80,-97,17,,300376507,28,6324,300376479,300376507
23426,5,24,149,5745,-82,-97,15,,300376551,28,16,300376523,300376551
23427,5,24,149,5745,-81,-97,16,,300376659,32,76,300376627,300376659
23428,5,12,149,5745,-51,-97,46,4a:86:35:36:74:b8,300376752,268,-175,300376484,300376752
23429,5,12,149,5745,-63,-97,34,2a:07:ef:54:b5:55,300385935,244,8939,300385691,300385935
23430,5,12,149,5745,-63,-97,34,56:68:e2:c2:8d:d5,300396674,280,10459,300396394,300396674
23431,5,12,149,5745,-63,-97,34,22:ec:75:a8:8a:31,300399755,244,2837,300399511,300399755
23432,5,12,149,5745,-88,-97,9,7e:05:42:11:d2:ec,300413471,244,13472,300413227,300413471
23433,5,12,149,5745,-56,-97,41,b6:90:18:f6:b1:d4,300420887,268,7148,300420619,300420887
23434,5,12,149,5745,-93,-97,4,ce:c3:e4:21:bb:52,300424878,284,3707,300424594,300424878
23435,5,6,149,5745,-88,-97,9,54:e4:3a:ec:fb:65,300425702,360,464,300425342,300425702
23436,5,12,149,5745,-88,-97,9,3a:90:78:0e:4f:1f,300430359,284,4373,300430075,300430359
23437,5,12,149,5745,-70,-97,27,6a:1e:a4:f8:14:49,300437475,284,6832,300437191,300437475
23438,5,12,149,5745,-68,-97,29,72:d1:72:1d:22:a1,300438495,480,540,300438015,300438495
23439,5,12,149,5745,-64,-97,33,22:ec:75:a8:8a:31,300440363,516,1352,300439847,300440363
23440,5,12,149,5745,-90,-97,7,de:be:a8:cd:79:57,300441624,284,977,300441340,300441624
23441,5,24,149,5745,-82,-97,15,,300443058,28,1406,300443030,300443058
23442,5,24,149,5745,-81,-97,16,,300443102,28,16,300443074,300443102
23443,5,24,149,5745,-82,-97,15,,300443210,32,76,300443178,300443210
23444,5,12,149,5745,-88,-97,9,42:d2:d9:2b:ac:61,300443987,484,293,300443503,300443987
23445,5,12,149,5745,-70,-97,27,6a:1e:a4:f8:14:49,300445742,480,1275,300445262,300445742
23446,5,12,149,5745,-66,-97,31,5e:29:73:5b:30:00,300446275,540,-7,300445735,300446275
23447,5,12,149,5745,-57,-97,40,3e:d1:9b:c7:a4:de,300449703,544,2884,300449159,300449703
23448,5,12,149,5745,-64,-97,33,56:68:e2:c2:8d:d5,300455033,476,4854,300454557,300455033
23449,5,24,149,5745,-82,-97,15,,300457261,28,2200,300457233,300457261
23450,5,24,149,5745,-82,-97,15,,300457305,28,16,300457277,300457305
23451,5,24,149,5745,-83,-97,14,,300457413,32,76,300457381,300457413
23452,5,12,149,5745,-55,-97,42,b6:90:18:f6:b1:d4,300457731,268,50,300457463,300457731
23453,5,12,149,5745,-89,-97,8,9a:24:38:da:96:bb,300458149,272,146,300457877,300458149
23454,5,12,149,5745,-88,-97,9,3a:90:78:0e:4f:1f,300459638,484,1005,300459154,300459638
23455,5,12,149,5745,-62,-97,35,f6:0a:5c:59:72:df,300460228,476,114,300459752,300460228
23456,5,12,149,5745,-51,-97,46,4a:86:35:36:74:b8,300461202,268,706,300460934,300461202
23457,5,12,149,5745,-87,-97,10,7e:05:42:11:d2:ec,300463570,412,1956,300463158,300463570
23458,5,12,149,5745,-88,-97,9,de:be:a8:cd:79:57,300464339,480,289,300463859,300464339
23459,5,24,149,5745,-82,-97,15,,300465396,28,1029,300465368,300465396
23460,5,24,149,5745,-81,-97,16,,300465440,28,16,300465412,300465440
23461,5,24,149,5745,-82,-97,15,,300465549,32,77,300465517,300465549
23462,5,12,149,5745,-67,-97,30,72:d1:72:1d:22:a1,300468990,284,3157,300468706,300468990
23463,5,12,149,5745,-50,-97,47,4a:86:35:36:74:b8,300486049,268,16791,300485781,300486049
23464,5,12,149,5745,-58,-97,39,3e:d1:9b:c7:a4:de,300486580,272,259,300486308,300486580
23465,5,12,149,5745,-69,-97,28,5e:29:73:5b:30:00,300488327,272,1475,300488055,300488327
23466,5,12,149,5745,-64,-97,33,22:ec:75:a8:8a:31,300512888,244,24317,300512644,300512888
23467,5,12,149,5745,-64,-97,33,56:68:e2:c2:8d:d5,300515002,280,1834,300514722,300515002
23468,5,12,149,5745,-68,-97,29,f2:da:61:dd:98:c5,300523344,268,8074,300523076,300523344
23469,5,12,149,5745,-87,-97,10,7e:05:42:11:d2:ec,300527074,412,3318,300526662,300527074
23470,5,6,149,5745,-89,-97,8,54:e4:3a:ec:fb:65,300528102,360,668,300527742,300528102
23471,5,12,149,5745,-54,-97,43,b6:90:18:f6:b1:d4,300530921,268,2551,300530653,300530921
23472,5,24,149,5745,-82,-97,15,,300539540,28,8591,300539512,300539540
23473,5,24,149,5745,-82,-97,15,,300539584,28,16,300539556,300539584
23474,5,24,149,5745,-82,-97,15,,300539696,32,80,300539664,300539696
23475,5,24,149,5745,-82,-97,15,,300539835,28,111,300539807,300539835
23476,5,24,149,5745,-82,-97,15,,300539879,28,16,300539851,300539879
23477,5,24,149,5745,-83,-97,14,,300539991,32,80,300539959,300539991
23478,5,24,149,5745,-83,-97,14,,300542125,28,2106,300542097,300542125
23479,5,24,149,5745,-82,-97,15,,300542170,28,17,300542142,300542170
23480,5,24,149,5745,-82,-97,15,,300542285,32,83,300542253,300542285
23481,5,24,149,5745,-83,-97,14,,300544766,28,2453,300544738,300544766
23482,5,24,149,5745,-82,-97,15,,300544810,28,16,300544782,300544810
23483,5,24,149,5745,-82,-97,15,,300544918,32,76,300544886,300544918
23484,5,24,149,5745,-82,-97,15,,300550350,28,5404,300550322,300550350
23485,5,24,149,5745,-82,-97,15,,300550395,28,17,300550367,300550395
23486,5,24,149,5745,-82,-97,15,,300550503,32,76,300550471,300550503
23487,5,12,149,5745,-67,-97,30,f2:da:61:dd:98:c5,300553928,268,3157,300553660,300553928
23488,5,12,149,5745,-89,-97,8,de:be:a8:cd:79:57,300557451,284,3239,300557167,300557451
23489,5,24,149,5745,-82,-97,15,,300557823,28,344,300557795,300557823
23490,5,24,149,5745,-81,-97,16,,300557867,28,16,300557839,300557867
23491,5,24,149,5745,-83,-97,14,,300557975,32,76,300557943,300557975
23492,5,24,149,5745,-82,-97,15,,300559010,28,1007,300558982,300559010
23493,5,24,149,5745,-82,-97,15,,300559054,28,16,300559026,300559054
23494,5,24,149,5745,-82,-97,15,,300559162,32,76,300559130,300559162
23495,5,24,149,5745,-82,-97,15,,300565821,28,6631,300565793,300565821
23496,5,24,149,5745,-81,-97,16,,300565865,28,16,300565837,300565865
23497,5,24,149,5745,-82,-97,15,,300565974,32,77,300565942,300565974
23498,5,12,149,5745,-65,-97,32,2a:07:ef:54:b5:55,300570495,440,4081,300570055,300570495
23499,5,12,149,5745,-73,-97,24,d2:00:04:7e:2c:ab,300576617,440,5682,300576177,300576617
23500,5,12,149,5745,-69,-97,28,5e:29:73:5b:30:00,300578378,540,1221,300577838,300578378
23501,5,12,149,5745,-92,-97,5,42:d2:d9:2b:ac:61,300579039,288,373,300578751,300579039
23502,5,12,149,5745,-57,-97,40,3e:d1:9b:c7:a4:de,300580819,544,1236,300580275,300580819
23503,5,12,149,5745,-63,-97,34,a6:92:ad:b7:76:65,300584421,484,3118,300583937,300584421
23504,5,12,149,5745,-56,-97,41,b6:90:18:f6:b1:d4,300586725,268,2036,300586457,300586725
23505,5,12,149,5745,-67,-97,30,f2:da:61:dd:98:c5,300588026,268,1033,300587758,300588026
23506,5,12,149,5745,-65,-97,32,22:ec:75:a8:8a:31,300591244,516,2702,300590728,300591244
23507,5,12,149,5745,-51,-97,46,4a:86:35:36:74:b8,300592137,268,625,300591869,300592137
23508,5,12,149,5745,-61,-97,36,0a:b9:b7:b1:4d:fa,300594501,268,2096,300594233,300594501
23509,5,12,149,5745,-51,-97,46,4a:86:35:36:74:b8,300600168,268,5399,300599900,300600168
23510,5,12,149,5745,-56,-97,41,3e:d1:9b:c7:a4:de,300600471,272,31,300600199,300600471
23511,5,12,149,5745,-71,-97,26,5e:29:73:5b:30:00,300601902,272,1159,300601630,300601902
23512,5,12,149,5745,-65,-97,32,22:ec:75:a8:8a:31,300627267,244,25121,300627023,300627267
23513,5,12,149,5745,-67,-97,30,6a:1e:a4:f8:14:49,300627672,284,121,300627388,300627672
23514,5,6,149,5745,-89,-97,8,54:e4:3a:ec:fb:65,300630504,360,2472,300630144,300630504
23515,5,24,149,5745,-81,-97,16,,300630927,28,395,300630899,300630927
23516,5,24,149,5745,-81,-97,16,,300630971,28,16,300630943,300630971
23517,5,24,149,5745,-81,-97,16,,300631083,32,80,300631051,300631083
23518,5,24,149,5745,-82,-97,15,,300634077,28,2966,300634049,300634077
23519,5,24,149,5745,-82,-97,15,,300634121,28,16,300634093,300634121
23520,5,24,149,5745,-80,-97,17,,300634230,32,77,300634198,300634230
23521,5,24,149,5745,-81,-97,16,,300635047,28,789,300635019,300635047
23522,5,24,149,5745,-81,-97,16,,300635091,28,16,300635063,300635091
23523,5,24,149,5745,-82,-97,15,,300635199,32,76,300635167,300635199
23524,5,24,149,5745,-81,-97,16,,300635397,28,170,300635369,300635397
23525,5,24,149,5745,-82,-97,15,,300635441,28,16,300635413,300635441
23526,5,24,149,5745,-81,-97,16,,300635549,32,76,300635517,300635549
23527,5,24,149,5745,-82,-97,15,,300642800,28,7223,300642772,300642800
23528,5,24,149,5745,-81,-97,16,,300642844,28,16,300642816,300642844
23529,5,24,149,5745,-81,-97,16,,300642952,32,76,300642920,300642952
23530,5,24,149,5745,-82,-97,15,,300644006,28,1026,300643978,300644006
23531,5,24,149,5745,-81,-97,16,,300644050,28,16,300644022,300644050
23532,5,24,149,5745,-81,-97,16,,300644159,32,77,300644127,300644159
23533,5,12,149,5745,-57,-97,40,b6:90:18:f6:b1:d4,300646933,268,2506,300646665,300646933
23534,5,12,149,5745,-61,-97,36,f6:0a:5c:59:72:df,300648908,280,1695,300648628,300648908
23535,5,24,149,5745,-81,-97,16,,300652424,28,3488,300652396,300652424
23536,5,24,149,5745,-81,-97,16,,300652468,28,16,300652440,300652468
23537,5,24,149,5745,-81,-97,16,,300652576,32,76,300652544,300652576
23538,5,12,149,5745,-65,-97,32,72:d1:72:1d:22:a1,300654717,284,1857,300654433,300654717
23539,5,12,149,5745,-66,-97,31,56:68:e2:c2:8d:d5,300656609,280,1612,300656329,300656609
23540,5,12,149,5745,-86,-97,11,7e:05:42:11:d2:ec,300658183,412,1162,300657771,300658183
23541,5,24,149,5745,-81,-97,16,,300658665,28,454,300658637,300658665
23542,5,24,149,5745,-82,-97,15,,300658709,28,16,300658681,300658709
23543,5,24,149,5745,-82,-97,15,,300658817,32,76,300658785,300658817
23544,5,24,149,5745,-82,-97,15,,300666622,28,7777,300666594,300666622
23545,5,24,149,5745,-81,-97,16,,300666667,28,17,300666639,300666667
23546,5,24,149,5745,-81,-97,16,,300666775,32,76,300666743,300666775
23547,5,12,149,5745,-66,-97,31,f2:da:61:dd:98:c5,300671776,268,4733,300671508,300671776
23548,5,12,149,5745,-90,-97,7,de:be:a8:cd:79:57,300674532,284,2472,300674248,300674532
23549,5,12,149,5745,-86,-97,11,9a:24:38:da:96:bb,300682744,272,7940,300682472,300682744
23550,5,12,149,5745,-91,-97,6,46:28:71:6e:d2:2e,300699243,252,16247,300698991,300699243
23551,5,12,149,5745,-56,-97,41,3e:d1:9b:c7:a4:de,300699857,272,342,300699585,300699857
23552,5,12,149,5745,-70,-97,27,5e:29:73:5b:30:00,300706754,272,6625,300706482,300706754
23553,5,12,149,5745,-48,-97,49,4a:86:35:36:74:b8,300715149,268,8127,300714881,300715149
23554,5,24,149,5745,-81,-97,16,,300720479,28,5302,300720451,300720479
23555,5,24,149,5745,-81,-97,16,,300720523,28,16,300720495,300720523
23556,5,24,149,5745,-81,-97,16,,300720634,32,79,300720602,300720634
23557,5,24,149,5745,-81,-97,16,,300723497,28,2835,300723469,300723497
23558,5,24,149,5745,-80,-97,17,,300723540,28,15,300723512,300723540
23559,5,24,149,5745,-81,-97,16,,300723649,32,77,300723617,300723649
23560,5,24,149,5745,-81,-97,16,,300723769,28,92,300723741,300723769
23561,5,24,149,5745,-80,-97,17,,300723813,28,16,300723785,300723813
23562,5,24,149,5745,-81,-97,16,,300723922,32,77,300723890,300723922
23563,5,24,149,5745,-81,-97,16,,300724033,32,79,300724001,300724033
23564,5,24,149,5745,-80,-97,17,,300729524,28,5463,300729496,300729524
23565,5,24,149,5745,-81,-97,16,,300729568,28,16,300729540,300729568
23566,5,24,149,5745,-81,-97,16,,300729676,32,76,300729644,300729676
23567,5,12,149,5745,-70,-97,27,6a:1e:a4:f8:14:49,300730082,284,122,300729798,300730082
23568,5,6,149,5745,-89,-97,8,54:e4:3a:ec:fb:65,300732904,360,2462,300732544,300732904
23569,5,24,149,5745,-81,-97,16,,300741378,28,8446,300741350,300741378
23570,5,24,149,5745,-81,-97,16,,300741422,28,16,300741394,300741422
23571,5,24,149,5745,-81,-97,16,,300741530,32,76,300741498,300741530
23572,5,12,149,5745,-64,-97,33,22:ec:75:a8:8a:31,300742985,244,1211,300742741,300742985
23573,5,12,149,5745,-63,-97,34,f6:0a:5c:59:72:df,300764620,280,21355,300764340,300764620
23574,5,12,149,5745,-90,-97,7,42:d2:d9:2b:ac:61,300770795,288,5887,300770507,300770795
23575,5,12,149,5745,-90,-97,7,de:be:a8:cd:79:57,300786546,284,15467,300786262,300786546
23576,5,12,149,5745,-55,-97,42,3e:d1:9b:c7:a4:de,300817008,272,30190,300816736,300817008
23577,5,24,149,5745,-80,-97,17,,300817933,32,893,300817901,300817933
23578,5,12,149,5745,-70,-97,27,5e:29:73:5b:30:00,300823327,272,5122,300823055,300823327
23579,5,12,149,5745,-85,-97,12,9a:24:38:da:96:bb,300823635,272,36,300823363,300823635
23580,5,12,149,5745,-72,-97,25,6a:1e:a4:f8:14:49,300832413,284,8494,300832129,300832413
23581,5,24,149,5745,-81,-97,16,,300834450,28,2009,300834422,300834450
23582,5,6,149,5745,-93,-97,4,,300834609,68,91,300834541,300834609
23583,5,6,149,5745,-91,-97,6,54:e4:3a:ec:fb:65,300835305,360,336,300834945,300835305
23584,5,12,149,5745,-47,-97,50,4a:86:35:36:74:b8,300835989,268,416,300835721,300835989
23585,5,24,149,5745,-81,-97,16,,300836388,28,371,300836360,300836388
23586,5,6,149,5745,-93,-97,4,,300836547,68,91,300836479,300836547
23587,5,12,149,5745,-70,-97,27,f2:da:61:dd:98:c5,300838120,268,1305,300837852,300838120
23588,5,12,149,5745,-68,-97,29,72:d1:72:1d:22:a1,300859996,284,21592,300859712,300859996
23589,5,12,149,5745,-66,-97,31,22:ec:75:a8:8a:31,300860332,244,92,300860088,300860332
23590,5,12,149,5745,-66,-97,31,56:68:e2:c2:8d:d5,300861672,280,1060,300861392,300861672
23591,5,12,149,5745,-90,-97,7,42:d2:d9:2b:ac:61,300873175,288,11215,300872887,300873175
23592,5,12,149,5745,-56,-97,41,b6:90:18:f6:b1:d4,300875291,268,1848,300875023,300875291
23593,5,12,149,5745,-89,-97,8,7e:05:42:11:d2:ec,300877864,244,2329,300877620,300877864
23594,5,24,149,5745,-81,-97,16,,300889339,32,11443,300889307,300889339
23595,5,24,149,5745,-81,-97,16,,300889457,32,86,300889425,300889457
23596,5,12,149,5745,-86,-97,11,9a:24:38:da:96:bb,300907157,272,17428,300906885,300907157
23597,5,24,149,5745,-66,-97,31,,300913689,28,6504,300913661,300913689
23598,5,24,149,5745,-80,-97,17,,300913732,28,15,300913704,300913732
23599,5,24,149,5745,-81,-97,16,,300913841,28,81,300913813,300913841
23600,5,12,149,5745,-54,-97,43,3e:d1:9b:c7:a4:de,300930748,272,16635,300930476,300930748
23601,5,24,149,5745,-81,-97,16,,300932243,28,1467,300932215,300932243
23602,5,12,149,5745,-70,-97,27,6a:1e:a4:f8:14:49,300934832,284,2305,300934548,300934832
23603,5,6,149,5745,-90,-97,7,54:e4:3a:ec:fb:65,300937705,360,2513,300937345,300937705
23604,5,12,149,5745,-49,-97,48,4a:86:35:36:74:b8,300938538,268,565,300938270,300938538
23605,5,12,149,5745,-69,-97,28,f2:da:61:dd:98:c5,300939057,268,251,300938789,300939057
23606,5,12,149,5745,-68,-97,29,5e:29:73:5b:30:00,300941035,272,1706,300940763,300941035
23607,5,12,149,5745,-67,-97,30,72:d1:72:1d:22:a1,300962258,284,20939,300961974,300962258
23608,5,12,149,5745,-65,-97,32,56:68:e2:c2:8d:d5,300962804,280,266,300962524,300962804
23609,5,12,149,5745,-61,-97,36,22:ec:75:a8:8a:31,300971877,244,8829,300971633,300971877
23610,5,24,149,5745,-65,-97,32,,300974435,28,2530,300974407,300974435
23611,5,24,149,5745,-80,-97,17,,300974479,28,16,300974451,300974479
23612,5,24,149,5745,-80,-97,17,,300974587,28,80,300974559,300974587
23613,5,12,149,5745,-89,-97,8,42:d2:d9:2b:ac:61,300974892,288,17,300974604,300974892
23614,5,24,149,5745,-83,-97,14,,300977032,28,2112,300977004,300977032
23615,5,24,149,5745,-80,-97,17,,300977075,28,15,300977047,300977075
23616,5,24,149,5745,-80,-97,17,,300977184,32,77,300977152,300977184
23617,5,12,149,5745,-86,-97,11,7e:05:42:11:d2:ec,300979003,244,1575,300978759,300979003
23618,5,12,149,5745,-91,-97,6,de:be:a8:cd:79:57,300979331,284,44,300979047,300979331
23619,5,24,149,5745,-81,-97,16,,300991330,28,11971,300991302,300991330
23620,5,24,149,5745,-83,-97,14,,300991374,28,16,300991346,300991374
23621,5,24,149,5745,-83,-97,14,,300991482,32,76,300991450,300991482
23622,5,12,149,5745,-92,-97,5,ce:c3:e4:21:bb:52,300996089,284,4323,300995805,300996089
23623,5,24,149,5745,-83,-97,14,,300998983,28,2866,300998955,300998983
23624,5,24,149,5745,-81,-97,16,,300999028,28,17,300999000,300999028
23625,5,24,149,5745,-81,-97,16,,300999136,32,76,300999104,300999136
23626,5,24,149,5745,-81,-97,16,,300999250,32,82,300999218,300999250
23627,5,12,149,5745,-91,-97,6,de:be:a8:cd:79:57,301003726,284,4192,301003442,301003726
23628,5,12,149,5745,-70,-97,27,6a:1e:a4:f8:14:49,301014140,284,10130,301013856,301014140
23629,5,12,149,5745,-65,-97,32,f2:da:61:dd:98:c5,301015091,268,683,301014823,301015091
23630,5,12,149,5745,-56,-97,41,3e:d1:9b:c7:a4:de,301026072,544,10437,301025528,301026072
23631,5,12,149,5745,-69,-97,28,72:d1:72:1d:22:a1,301026651,284,295,301026367,301026651
23632,5,24,149,5745,-81,-97,16,,301026984,28,305,301026956,301026984
23633,5,24,149,5745,-81,-97,16,,301027028,28,16,301027000,301027028
23634,5,24,149,5745,-82,-97,15,,301027136,32,76,301027104,301027136
23635,5,12,149,5745,-69,-97,28,72:d1:72:1d:22:a1,301027760,480,144,301027280,301027760
23636,5,12,149,5745,-88,-97,9,42:d2:d9:2b:ac:61,301028792,288,744,301028504,301028792
23637,5,24,149,5745,-83,-97,14,,301030057,28,1237,301030029,301030057
23638,5,24,149,5745,-81,-97,16,,301030101,28,16,301030073,301030101
23639,5,24,149,5745,-81,-97,16,,301030209,32,76,301030177,301030209
23640,5,12,149,5745,-56,-97,41,b6:90:18:f6:b1:d4,301033678,268,3201,301033410,301033678
23641,5,12,149,5745,-70,-97,27,6a:1e:a4:f8:14:49,301034002,480,-156,301033522,301034002
23642,5,12,149,5745,-70,-97,27,5e:29:73:5b:30:00,301034525,540,-17,301033985,301034525
23643,5,6,149,5745,-91,-97,6,54:e4:3a:ec:fb:65,301040106,360,5221,301039746,301040106
23644,5,12,149,5745,-50,-97,47,4a:86:35:36:74:b8,301042502,268,2128,301042234,301042502
23645,5,12,149,5745,-66,-97,31,56:68:e2:c2:8d:d5,301045975,476,2997,301045499,301045975
23646,5,24,149,5745,-81,-97,16,,301046863,28,860,301046835,301046863
23647,5,24,149,5745,-82,-97,15,,301046907,28,16,301046879,301046907
23648,5,24,149,5745,-82,-97,15,,301047019,32,80,301046987,301047019
23649,5,12,149,5745,-60,-97,37,22:ec:75:a8:8a:31,301047121,516,-414,301046605,301047121
23650,5,12,149,5745,-84,-97,13,7e:05:42:11:d2:ec,301047698,440,137,301047258,301047698
23651,5,12,149,5745,-66,-97,31,f2:da:61:dd:98:c5,301049619,268,1653,301049351,301049619
23652,5,24,149,5745,-81,-97,16,,301049971,28,324,301049943,301049971
23653,5,24,149,5745,-82,-97,15,,301050015,28,16,301049987,301050015
23654,5,24,149,5745,-83,-97,14,,301050122,32,75,301050090,301050122
23655,5,24,149,5745,-82,-97,15,,301050279,28,129,301050251,301050279
23656,5,24,149,5745,-81,-97,16,,301050324,28,17,301050296,301050324
23657,5,24,149,5745,-81,-97,16,,301050432,32,76,301050400,301050432
23658,5,24,149,5745,-81,-97,16,,301050561,28,101,301050533,301050561
23659,5,24,149,5745,-82,-97,15,,301050606,28,17,301050578,301050606
23660,5,24,149,5745,-82,-97,15,,301050713,32,75,301050681,301050713
23661,5,12,149,5745,-62,-97,35,f6:0a:5c:59:72:df,301050779,476,-410,301050303,301050779
23662,5,12,149,5745,-49,-97,48,4a:86:35:36:74:b8,301052305,268,1258,301052037,301052305
23663,5,12,149,5745,-90,-97,7,de:be:a8:cd:79:57,301053552,480,767,301053072,301053552
23664,5,12,149,5745,-91,-97,6,3a:90:78:0e:4f:1f,301054266,452,262,301053814,301054266
23665,5,24,149,5745,-82,-97,15,,301056708,28,2414,301056680,301056708
23666,5,24,149,5745,-81,-97,16,,301056753,28,17,301056725,301056753
23667,5,24,149,5745,-81,-97,16,,301056861,32,76,301056829,301056861
23668,5,12,149,5745,-57,-97,40,3e:d1:9b:c7:a4:de,301059240,272,2107,301058968,301059240
23669,5,12,149,5745,-66,-97,31,56:68:e2:c2:8d:d5,301059609,280,89,301059329,301059609
23670,5,12,149,5745,-70,-97,27,5e:29:73:5b:30:00,301060628,272,747,301060356,301060628
23671,5,24,149,5745,-64,-97,33,,301066394,28,5738,301066366,301066394
23672,5,24,149,5745,-81,-97,16,,301066438,28,16,301066410,301066438
23673,5,24,149,5745,-81,-97,16,,301066547,28,81,301066519,301066547
23674,5,24,149,5745,-81,-97,16,,301068135,28,1560,301068107,301068135
23675,5,24,149,5745,-82,-97,15,,301068179,28,16,301068151,301068179
23676,5,24,149,5745,-82,-97,15,,301068287,32,76,301068255,301068287
23677,5,12,149,5745,-85,-97,12,7e:05:42:11:d2:ec,301079422,244,10891,301079178,301079422
23678,5,12,149,5745,-61,-97,36,f6:0a:5c:59:72:df,301085281,280,5579,301085001,301085281
23679,5,12,149,5745,-55,-97,42,b6:90:18:f6:b1:d4,301090794,268,5245,301090526,301090794
23680,5,12,149,5745,-57,-97,40,3e:d1:9b:c7:a4:de,301091096,544,-242,301090552,301091096
23681,5,12,149,5745,-63,-97,34,22:ec:75:a8:8a:31,301091711,244,371,301091467,301091711
23682,5,12,149,5745,-70,-97,27,72:d1:72:1d:22:a1,301092179,480,-12,301091699,301092179
23683,5,12,149,5745,-69,-97,28,f2:da:61:dd:98:c5,301095763,268,3316,301095495,301095763
23684,5,12,149,5745,-89,-97,8,42:d2:d9:2b:ac:61,301096317,484,70,301095833,301096317
23685,5,12,149,5745,-67,-97,30,56:68:e2:c2:8d:d5,301097557,476,764,301097081,301097557
23686,5,12,149,5745,-50,-97,47,4a:86:35:36:74:b8,301098140,268,315,301097872,301098140
23687,5,12,149,5745,-56,-97,41,b6:90:18:f6:b1:d4,301099137,268,729,301098869,301099137
23688,5,12,149,5745,-63,-97,34,0a:b9:b7:b1:4d:fa,301106992,268,7587,301106724,301106992
23689,5,12,149,5745,-66,-97,31,a6:92:ad:b7:76:65,301107294,484,-182,301106810,301107294
23690,5,12,149,5745,-73,-97,24,6a:1e:a4:f8:14:49,301109217,284,1639,301108933,301109217
23691,5,12,149,5745,-66,-97,31,2a:07:ef:54:b5:55,301109653,380,56,301109273,301109653
23692,5,12,149,5745,-87,-97,10,de:be:a8:cd:79:57,301110540,284,603,301110256,301110540
23693,5,12,149,5745,-72,-97,25,d2:00:04:7e:2c:ab,301110876,152,184,301110724,301110876
23694,5,12,149,5745,-66,-97,31,2a:07:ef:54:b5:55,301111063,440,-253,301110623,301111063
23695,5,12,149,5745,-70,-97,27,f2:da:61:dd:98:c5,301111583,268,252,301111315,301111583
23696,5,12,149,5745,-64,-97,33,22:ec:75:a8:8a:31,301112038,516,-61,301111522,301112038
23697,5,12,149,5745,-92,-97,5,3a:90:78:0e:4f:1f,301113180,452,690,301112728,301113180
23698,5,12,149,5745,-64,-97,33,f6:0a:5c:59:72:df,301113712,476,56,301113236,301113712
23699,5,12,149,5745,-85,-97,12,7e:05:42:11:d2:ec,301114441,440,289,301114001,301114441
23700,5,12,149,5745,-87,-97,10,de:be:a8:cd:79:57,301114915,480,-6,301114435,301114915
23701,5,12,149,5745,-89,-97,8,9a:24:38:da:96:bb,301116077,824,338,301115253,301116077
23702,5,12,149,5745,-88,-97,9,9a:24:38:da:96:bb,301132226,272,15877,301131954,301132226
23703,5,12,149,5745,-69,-97,28,72:d1:72:1d:22:a1,301141594,284,9084,301141310,301141594
23704,5,6,149,5745,-91,-97,6,54:e4:3a:ec:fb:65,301142506,360,552,301142146,301142506
23705,5,12,149,5745,-92,-97,5,42:d2:d9:2b:ac:61,301154771,288,11977,301154483,301154771
23706,5,12,149,5745,-56,-97,41,3e:d1:9b:c7:a4:de,301159945,272,4902,301159673,301159945
23707,5,12,149,5745,-68,-97,29,5e:29:73:5b:30:00,301170330,272,10113,301170058,301170330
23708,5,12,149,5745,-50,-97,47,4a:86:35:36:74:b8,301171711,268,1113,301171443,301171711
23709,5,12,149,5745,-63,-97,34,56:68:e2:c2:8d:d5,301180336,280,8345,301180056,301180336
23710,5,12,149,5745,-64,-97,33,22:ec:75:a8:8a:31,301196921,244,16341,301196677,301196921
23711,5,12,149,5745,-84,-97,13,7e:05:42:11:d2:ec,301199881,244,2716,301199637,301199881
23712,5,12,149,5745,-72,-97,25,f2:da:61:dd:98:c5,301235112,268,34963,301234844,301235112
23713,5,12,149,5745,-67,-97,30,6a:1e:a4:f8:14:49,301237113,284,1717,301236829,301237113
23714,5,12,149,5745,-86,-97,11,9a:24:38:da:96:bb,301244880,272,7495,301244608,301244880
23715,5,12,149,5745,-56,-97,41,b6:90:18:f6:b1:d4,301268860,268,23712,301268592,301268860
23716,5,12,149,5745,-68,-97,29,72:d1:72:1d:22:a1,301269227,284,83,301268943,301269227
23717,5,12,149,5745,-52,-97,45,3e:d1:9b:c7:a4:de,301275612,272,6113,301275340,301275612
23718,5,12,149,5745,-88,-97,9,42:d2:d9:2b:ac:61,301283329,288,7429,301283041,301283329
23719,5,12,149,5745,-71,-97,26,5e:29:73:5b:30:00,301287109,272,3508,301286837,301287109
23720,5,12,149,5745,-91,-97,6,4e:72:d0:f1:a2:44,301289845,272,2464,301289573,301289845
23721,5,12,149,5745,-62,-97,35,22:ec:75:a8:8a:31,301311289,244,21200,301311045,301311289
23722,5,6,149,5745,-89,-97,8,54:e4:3a:ec:fb:65,301347307,360,35658,301346947,301347307
23723,5,12,149,5745,-49,-97,48,4a:86:35:36:74:b8,301347976,268,401,301347708,301347976
23724,5,12,149,5745,-72,-97,25,f2:da:61:dd:98:c5,301348476,268,232,301348208,301348476
23725,5,12,149,5745,-68,-97,29,6a:1e:a4:f8:14:49,301349624,284,864,301349340,301349624
23726,5,12,149,5745,-84,-97,13,9a:24:38:da:96:bb,301361537,272,11641,301361265,301361537
23727,5,12,149,5745,-56,-97,41,b6:90:18:f6:b1:d4,301371261,268,9456,301370993,301371261
23728,5,12,149,5745,-67,-97,30,72:d1:72:1d:22:a1,301371583,284,38,301371299,301371583
23729,5,12,149,5745,-65,-97,32,56:68:e2:c2:8d:d5,301373377,280,1514,301373097,301373377
23730,5,12,149,5745,-89,-97,8,de:be:a8:cd:79:57,301384931,284,11270,301384647,301384931
23731,5,12,149,5745,-91,-97,6,42:d2:d9:2b:ac:61,301385375,288,156,301385087,301385375
23732,5,12,149,5745,-91,-97,6,7e:05:42:11:d2:ec,301389968,244,4349,301389724,301389968
23733,5,12,149,5745,-53,-97,44,3e:d1:9b:c7:a4:de,301392701,272,2461,301392429,301392701
23734,5,12,149,5745,-66,-97,31,5e:29:73:5b:30:00,301404353,272,11380,301404081,301404353
23735,5,12,149,5745,-65,-97,32,56:68:e2:c2:8d:d5,301404867,280,234,301404587,301404867
23736,5,12,149,5745,-91,-97,6,42:d2:d9:2b:ac:61,301427248,484,21897,301426764,301427248
23737,5,12,149,5745,-64,-97,33,22:ec:75:a8:8a:31,301427799,244,307,301427555,301427799
23738,5,12,149,5745,-64,-97,33,f6:0a:5c:59:72:df,301431732,280,3653,301431452,301431732
23739,5,12,149,5745,-56,-97,41,b6:90:18:f6:b1:d4,301435990,268,3990,301435722,301435990
23740,5,6,149,5745,-89,-97,8,54:e4:3a:ec:fb:65,301449707,360,13357,301449347,301449707
23741,5,12,149,5745,-48,-97,49,4a:86:35:36:74:b8,301450284,268,309,301450016,301450284
23742,5,12,149,5745,-72,-97,25,f2:da:61:dd:98:c5,301460830,268,10278,301460562,301460830
23743,5,12,149,5745,-72,-97,25,6a:1e:a4:f8:14:49,301462311,284,1197,301462027,301462311
23744,5,12,149,5745,-91,-97,6,de:be:a8:cd:79:57,301465094,284,2499,301464810,301465094
23745,5,12,149,5745,-88,-97,9,9a:24:38:da:96:bb,301468177,272,2811,301467905,301468177
23746,5,12,149,5745,-66,-97,31,72:d1:72:1d:22:a1,301484800,284,16339,301484516,301484800
23747,5,12,149,5745,-53,-97,44,3e:d1:9b:c7:a4:de,301487299,544,1955,301486755,301487299
23748,5,12,149,5745,-67,-97,30,f2:da:61:dd:98:c5,301489016,268,1449,301488748,301489016
23749,5,12,149,5745,-48,-97,49,4a:86:35:36:74:b8,301490863,268,1579,301490595,301490863
23750,5,12,149,5745,-55,-97,42,b6:90:18:f6:b1:d4,301492400,268,1269,301492132,301492400
23751,5,12,149,5745,-64,-97,33,56:68:e2:c2:8d:d5,301495069,476,2193,301494593,301495069
23752,5,12,149,5745,-64,-97,33,5e:29:73:5b:30:00,301496671,540,1062,301496131,301496671
23753,5,12,149,5745,-91,-97,6,de:be:a8:cd:79:57,301498044,480,893,301497564,301498044
23754,5,12,149,5745,-49,-97,48,4a:86:35:36:74:b8,301501248,268,2936,301500980,301501248
23755,5,12,149,5745,-66,-97,31,72:d1:72:1d:22:a1,301501552,480,-176,301501072,301501552
23756,5,12,149,5745,-90,-97,7,42:d2:d9:2b:ac:61,301502619,288,779,301502331,301502619
23757,5,12,149,5745,-90,-97,7,4e:72:d0:f1:a2:44,301502943,272,52,301502671,301502943
23758,5,12,149,5745,-61,-97,36,22:ec:75:a8:8a:31,301507362,516,3903,301506846,301507362
23759,5,12,149,5745,-61,-97,36,f6:0a:5c:59:72:df,301507912,476,74,301507436,301507912
23760,5,12,149,5745,-91,-97,6,3a:90:78:0e:4f:1f,301513717,452,5353,301513265,301513717
23761,5,12,149,5745,-54,-97,43,3e:d1:9b:c7:a4:de,301517897,272,3908,301517625,301517897
23762,5,12,149,5745,-65,-97,32,56:68:e2:c2:8d:d5,301518428,280,251,301518148,301518428
23763,5,12,149,5745,-61,-97,36,f6:0a:5c:59:72:df,301533221,280,14513,301532941,301533221
23764,5,12,149,5745,-67,-97,30,5e:29:73:5b:30:00,301536118,272,2625,301535846,301536118
23765,5,12,149,5745,-62,-97,35,22:ec:75:a8:8a:31,301542658,244,6296,301542414,301542658
23766,5,6,149,5745,-89,-97,8,54:e4:3a:ec:fb:65,301552108,360,9090,301551748,301552108
23767,5,12,149,5745,-59,-97,38,b6:90:18:f6:b1:d4,301561073,268,8697,301560805,301561073
23768,5,12,149,5745,-69,-97,28,f2:da:61:dd:98:c5,301562320,268,979,301562052,301562320
23769,5,12,149,5745,-69,-97,28,f2:da:61:dd:98:c5,301569363,268,6775,301569095,301569363
23770,5,12,149,5745,-67,-97,30,6a:1e:a4:f8:14:49,301574208,284,4561,301573924,301574208
23771,5,12,149,5745,-93,-97,4,4e:72:d0:f1:a2:44,301575420,468,744,301574952,301575420
23772,5,12,149,5745,-89,-97,8,de:be:a8:cd:79:57,301575968,284,264,301575684,301575968
23773,5,12,149,5745,-61,-97,36,a6:92:ad:b7:76:65,301601016,284,24764,301600732,301601016
23774,5,12,149,5745,-86,-97,11,9a:24:38:da:96:bb,301601566,272,278,301601294,301601566
23775,5,12,149,5745,-88,-97,9,42:d2:d9:2b:ac:61,301607165,288,5311,301606877,301607165
23776,5,24,149,5745,-80,-97,17,,301609932,28,2739,301609904,301609932
23777,5,24,149,5745,-78,-97,19,,301609976,28,16,301609948,301609976
23778,5,24,149,5745,-78,-97,19,,301610084,32,76,301610052,301610084
23779,5,12,149,5745,-51,-97,46,4a:86:35:36:74:b8,301615982,268,5630,301615714,301615982
23780,5,12,149,5745,-53,-97,44,3e:d1:9b:c7:a4:de,301618374,544,1848,301617830,301618374
23781,5,12,149,5745,-62,-97,35,b6:90:18:f6:b1:d4,301624026,268,5384,301623758,301624026
23782,5,12,149,5745,-52,-97,45,4a:86:35:36:74:b8,301624383,268,89,301624115,301624383
23783,5,24,149,5745,-80,-97,17,,301624712,28,301,301624684,301624712
23784,5,24,149,5745,-79,-97,18,,301624757,28,17,301624729,301624757
23785,5,24,149,5745,-79,-97,18,,301624864,32,75,301624832,301624864
23786,5,12,149,5745,-67,-97,30,5e:29:73:5b:30:00,301627739,540,2335,301627199,301627739
23787,5,12,149,5745,-68,-97,29,f2:da:61:dd:98:c5,301628332,268,325,301628064,301628332
23788,5,12,149,5745,-86,-97,11,7e:05:42:11:d2:ec,301629983,440,1211,301629543,301629983
23789,5,12,149,5745,-89,-97,8,de:be:a8:cd:79:57,301630512,480,49,301630032,301630512
23790,5,12,149,5745,-60,-97,37,a6:92:ad:b7:76:65,301631026,484,30,301630542,301631026
23791,5,12,149,5745,-63,-97,34,0a:b9:b7:b1:4d:fa,301632039,268,745,301631771,301632039
23792,5,24,149,5745,-79,-97,18,,301632405,28,338,301632377,301632405
23793,5,24,149,5745,-79,-97,18,,301632449,28,16,301632421,301632449
23794,5,24,149,5745,-79,-97,18,,301632557,32,76,301632525,301632557
23795,5,12,149,5745,-53,-97,44,3e:d1:9b:c7:a4:de,301632838,272,9,301632566,301632838
23796,5,12,149,5745,-70,-97,27,2a:07:ef:54:b5:55,301636844,440,3566,301636404,301636844
23797,5,12,149,5745,-64,-97,33,22:ec:75:a8:8a:31,301639433,516,2073,301638917,301639433
23798,5,12,149,5745,-86,-97,11,9a:24:38:da:96:bb,301641446,824,1189,301640622,301641446
23799,5,12,149,5745,-62,-97,35,b6:90:18:f6:b1:d4,301647839,268,6125,301647571,301647839
23800,5,12,149,5745,-67,-97,30,5e:29:73:5b:30:00,301650499,272,2388,301650227,301650499
23801,5,6,149,5745,-89,-97,8,54:e4:3a:ec:fb:65,301654509,360,3650,301654149,301654509
23802,5,12,149,5745,-64,-97,33,22:ec:75:a8:8a:31,301665174,244,10421,301664930,301665174
23803,5,24,149,5745,-79,-97,18,,301669020,28,3818,301668992,301669020
23804,5,24,149,5745,-79,-97,18,,301669064,28,16,301669036,301669064
23805,5,24,149,5745,-80,-97,17,,301669176,32,80,301669144,301669176
23806,5,24,149,5745,-80,-97,17,,301671377,28,2173,301671349,301671377
23807,5,24,149,5745,-79,-97,18,,301671421,28,16,301671393,301671421
23808,5,24,149,5745,-79,-97,18,,301671529,32,76,301671497,301671529
23809,5,24,149,5745,-79,-97,18,,301671641,32,80,301671609,301671641
23810,5,24,149,5745,-79,-97,18,,301671772,28,103,301671744,301671772
23811,5,24,149,5745,-78,-97,19,,301671816,28,16,301671788,301671816
23812,5,24,149,5745,-79,-97,18,,301671924,32,76,301671892,301671924
23813,5,24,149,5745,-79,-97,18,,301677876,28,5924,301677848,301677876
23814,5,24,149,5745,-79,-97,18,,301677920,28,16,301677892,301677920
23815,5,24,149,5745,-80,-97,17,,301678028,32,76,301677996,301678028
23816,5,12,149,5745,-62,-97,35,72:d1:72:1d:22:a1,301678854,284,542,301678570,301678854
23817,5,12,149,5745,-66,-97,31,56:68:e2:c2:8d:d5,301680864,280,1730,301680584,301680864
23818,5,12,149,5745,-89,-97,8,de:be:a8:cd:79:57,301687038,284,5890,301686754,301687038
23819,5,24,149,5745,-79,-97,18,,301689670,28,2604,301689642,301689670
23820,5,24,149,5745,-79,-97,18,,301689715,28,17,301689687,301689715
23821,5,24,149,5745,-79,-97,18,,301689823,32,76,301689791,301689823
23822,5,12,149,5745,-82,-97,15,9a:24:38:da:96:bb,301692711,272,2616,301692439,301692711
23823,5,12,149,5745,-71,-97,26,f2:da:61:dd:98:c5,301695546,268,2567,301695278,301695546
23824,5,12,149,5745,-60,-97,37,a6:92:ad:b7:76:65,301717135,284,21305,301716851,301717135
23825,5,12,149,5745,-62,-97,35,72:d1:72:1d:22:a1,301718946,284,1527,301718662,301718946
23826,5,12,149,5745,-92,-97,5,4e:72:d0:f1:a2:44,301723323,272,4105,301723051,301723323
23827,5,12,149,5745,-50,-97,47,3e:d1:9b:c7:a4:de,301732950,272,9355,301732678,301732950
23828,5,12,149,5745,-49,-97,48,4a:86:35:36:74:b8,301736824,268,3606,301736556,301736824
23829,5,12,149,5745,-64,-97,33,5e:29:73:5b:30:00,301745286,272,8190,301745014,301745286
23830,5,12,149,5745,-67,-97,30,6a:1e:a4:f8:14:49,301753984,284,8414,301753700,301753984
23831,5,6,149,5745,-90,-97,7,54:e4:3a:ec:fb:65,301756909,360,2565,301756549,301756909
23832,5,12,149,5745,-64,-97,33,22:ec:75:a8:8a:31,301770689,244,13536,301770445,301770689
23833,5,12,149,5745,-58,-97,39,b6:90:18:f6:b1:d4,301781659,268,10702,301781391,301781659
23834,5,12,149,5745,-65,-97,32,56:68:e2:c2:8d:d5,301785136,280,3197,301784856,301785136
23835,5,12,149,5745,-88,-97,9,42:d2:d9:2b:ac:61,301794807,288,9383,301794519,301794807
23836,5,24,149,5745,-78,-97,19,,301797332,32,2493,301797300,301797332
23837,5,12,149,5745,-89,-97,8,de:be:a8:cd:79:57,301801146,284,3530,301800862,301801146
23838,5,12,149,5745,-81,-97,16,9a:24:38:da:96:bb,301808410,272,6992,301808138,301808410
23839,5,24,149,5745,-77,-97,20,,301814920,32,6478,301814888,301814920
23840,5,24,149,5745,-77,-97,20,,301815894,28,946,301815866,301815894
23841,5,24,149,5745,-90,-97,7,,301815937,28,15,301815909,301815937
23842,5,6,149,5745,-90,-97,7,,301816054,68,49,301815986,301816054
23843,5,24,149,5745,-77,-97,20,,301826783,28,10701,301826755,301826783
23844,5,24,149,5745,-61,-97,36,,301826827,28,16,301826799,301826827
23845,5,12,149,5745,-88,-97,9,7e:05:42:11:d2:ec,301828589,440,1322,301828149,301828589
23846,5,24,149,5745,-63,-97,34,,301830328,28,1711,301830300,301830328
23847,5,24,149,5745,-77,-97,20,,301830373,28,17,301830345,301830373
23848,5,24,149,5745,-77,-97,20,,301830481,28,80,301830453,301830481
23849,5,24,149,5745,-63,-97,34,,301830574,28,65,301830546,301830574
23850,5,24,149,5745,-77,-97,20,,301830618,28,16,301830590,301830618
23851,5,24,149,5745,-77,-97,20,,301830726,28,80,301830698,301830726
23852,5,12,149,5745,-91,-97,6,4e:72:d0:f1:a2:44,301836930,272,5932,301836658,301836930
23853,5,24,149,5745,-77,-97,20,,301841154,28,4196,301841126,301841154
23854,5,24,149,5745,-61,-97,36,,301841198,28,16,301841170,301841198
23855,5,12,149,5745,-57,-97,40,3e:d1:9b:c7:a4:de,301848697,272,7227,301848425,301848697
23856,5,12,149,5745,-64,-97,33,6a:1e:a4:f8:14:49,301856443,284,7462,301856159,301856443
23857,5,12,149,5745,-49,-97,48,4a:86:35:36:74:b8,301859508,268,2797,301859240,301859508
23858,5,12,149,5745,-73,-97,24,f2:da:61:dd:98:c5,301860100,268,324,301859832,301860100
23859,5,24,149,5745,-77,-97,20,,301860640,32,508,301860608,301860640
23860,5,12,149,5745,-66,-97,31,5e:29:73:5b:30:00,301862862,272,1950,301862590,301862862
23861,5,12,149,5745,-63,-97,34,a6:92:ad:b7:76:65,301882869,284,19723,301882585,301882869
23862,5,12,149,5745,-59,-97,38,b6:90:18:f6:b1:d4,301883803,268,666,301883535,301883803
23863,5,12,149,5745,-66,-97,31,72:d1:72:1d:22:a1,301884275,284,188,301883991,301884275
23864,5,12,149,5745,-64,-97,33,56:68:e2:c2:8d:d5,301884629,280,74,301884349,301884629
23865,5,12,149,5745,-65,-97,32,22:ec:75:a8:8a:31,301887754,244,2881,301887510,301887754
23866,5,12,149,5745,-59,-97,38,f6:0a:5c:59:72:df,301891837,280,3803,301891557,301891837
23867,5,12,149,5745,-89,-97,8,42:d2:d9:2b:ac:61,301896223,288,4098,301895935,301896223
23868,5,24,149,5745,-64,-97,33,,301926197,28,29946,301926169,301926197
23869,5,24,149,5745,-77,-97,20,,301926241,28,16,301926213,301926241
23870,5,24,149,5745,-78,-97,19,,301926349,28,80,301926321,301926349
23871,5,24,149,5745,-64,-97,33,,301926461,28,84,301926433,301926461
23872,5,24,149,5745,-78,-97,19,,301926504,28,15,301926476,301926504
23873,5,24,149,5745,-78,-97,19,,301926613,28,81,301926585,301926613
23874,5,24,149,5745,-64,-97,33,,301926821,28,180,301926793,301926821
23875,5,24,149,5745,-77,-97,20,,301926865,28,16,301926837,301926865
23876,5,24,149,5745,-78,-97,19,,301926973,28,80,301926945,301926973
23877,5,24,149,5745,-78,-97,19,,301943318,32,16313,301943286,301943318
23878,5,24,149,5745,-78,-97,19,,301943853,32,503,301943821,301943853
23879,5,24,149,5745,-78,-97,19,,301944389,28,508,301944361,301944389
23880,5,24,149,5745,-78,-97,19,,301945885,28,1468,301945857,301945885
23881,5,12,149,5745,-92,-97,5,4e:72:d0:f1:a2:44,301949768,272,3611,301949496,301949768
23882,5,12,149,5745,-66,-97,31,6a:1e:a4:f8:14:49,301958738,284,8686,301958454,301958738
23883,5,6,149,5745,-87,-97,10,54:e4:3a:ec:fb:65,301961710,360,2612,301961350,301961710
23884,5,12,149,5745,-50,-97,47,4a:86:35:36:74:b8,301962363,268,385,301962095,301962363
23885,5,12,149,5745,-73,-97,24,f2:da:61:dd:98:c5,301962794,268,163,301962526,301962794
23886,5,12,149,5745,-55,-97,42,3e:d1:9b:c7:a4:de,301965641,272,2575,301965369,301965641
23887,5,24,149,5745,-66,-97,31,,301970838,28,5169,301970810,301970838
23888,5,24,149,5745,-77,-97,20,,301970882,28,16,301970854,301970882
23889,5,24,149,5745,-77,-97,20,,301970990,28,80,301970962,301970990
23890,5,12,149,5745,-65,-97,32,5e:29:73:5b:30:00,301980054,272,8792,301979782,301980054
23891,5,12,149,5745,-62,-97,35,a6:92:ad:b7:76:65,301981319,284,981,301981035,301981319
23892,5,12,149,5745,-64,-97,33,72:d1:72:1d:22:a1,301985556,284,3953,301985272,301985556
23893,5,24,149,5745,-66,-97,31,,301986290,28,706,301986262,301986290
23894,5,24,149,5745,-77,-97,20,,301986334,28,16,301986306,301986334
23895,5,24,149,5745,-77,-97,20,,301986443,28,81,301986415,301986443
23896,5,24,149,5745,-66,-97,31,,301986633,28,162,301986605,301986633
23897,5,24,149,5745,-77,-97,20,,301986677,28,16,301986649,301986677
23898,5,24,149,5745,-77,-97,20,,301986785,28,80,301986757,301986785
23899,5,12,149,5745,-64,-97,33,56:68:e2:c2:8d:d5,301987540,280,475,301987260,301987540
23900,5,12,149,5745,-62,-97,35,22:ec:75:a8:8a:31,301999597,244,11813,301999353,301999597
23901,5,12,149,5745,-89,-97,8,42:d2:d9:2b:ac:61,302001033,288,1148,302000745,302001033
23902,5,24,149,5745,-67,-97,30,,302001374,28,313,302001346,302001374
23903,5,24,149,5745,-77,-97,20,,302001418,28,16,302001390,302001418
23904,5,24,149,5745,-76,-97,21,,302001526,28,80,302001498,302001526
23905,5,12,149,5745,-58,-97,39,b6:90:18:f6:b1:d4,302002795,268,1001,302002527,302002795
23906,5,12,149,5745,-89,-97,8,42:d2:d9:2b:ac:61,302018403,484,15124,302017919,302018403
23907,5,12,149,5745,-76,-97,21,f2:da:61:dd:98:c5,302023822,268,5151,302023554,302023822
23908,5,12,149,5745,-87,-97,10,de:be:a8:cd:79:57,302038395,284,14289,302038111,302038395
23909,5,12,149,5745,-90,-97,7,42:d2:d9:2b:ac:61,302047239,288,8556,302046951,302047239
23910,5,12,149,5745,-62,-97,35,a6:92:ad:b7:76:65,302049134,284,1611,302048850,302049134
23911,5,12,149,5745,-65,-97,32,72:d1:72:1d:22:a1,302060878,284,11460,302060594,302060878
23912,5,12,149,5745,-66,-97,31,6a:1e:a4:f8:14:49,302062509,284,1347,302062225,302062509
23913,5,6,149,5745,-90,-97,7,54:e4:3a:ec:fb:65,302064111,360,1242,302063751,302064111
23914,5,12,149,5745,-53,-97,44,3e:d1:9b:c7:a4:de,302074714,544,10059,302074170,302074714
23915,5,12,149,5745,-47,-97,50,4a:86:35:36:74:b8,302075329,268,347,302075061,302075329
23916,5,12,149,5745,-63,-97,34,56:68:e2:c2:8d:d5,302075685,280,76,302075405,302075685
23917,5,12,149,5745,-91,-97,6,42:d2:d9:2b:ac:61,302081585,484,5416,302081101,302081585
23918,5,12,149,5745,-64,-97,33,56:68:e2:c2:8d:d5,302083578,476,1517,302083102,302083578
23919,5,12,149,5745,-57,-97,40,b6:90:18:f6:b1:d4,302084171,268,325,302083903,302084171
23920,5,12,149,5745,-66,-97,31,5e:29:73:5b:30:00,302085328,540,617,302084788,302085328
23921,5,12,149,5745,-67,-97,30,6a:1e:a4:f8:14:49,302086568,480,760,302086088,302086568
23922,5,12,149,5745,-86,-97,11,de:be:a8:cd:79:57,302087449,480,401,302086969,302087449
23923,5,12,149,5745,-71,-97,26,f2:da:61:dd:98:c5,302088262,268,545,302087994,302088262
23924,5,12,149,5745,-63,-97,34,a6:92:ad:b7:76:65,302090122,484,1376,302089638,302090122
23925,5,12,149,5745,-53,-97,44,3e:d1:9b:c7:a4:de,302091399,272,1005,302091127,302091399
23926,5,12,149,5745,-65,-97,32,72:d1:72:1d:22:a1,302091707,480,-172,302091227,302091707
23927,5,12,149,5745,-47,-97,50,4a:86:35:36:74:b8,302094608,268,2633,302094340,302094608
23928,5,12,149,5745,-59,-97,38,22:ec:75:a8:8a:31,302095747,516,623,302095231,302095747
23929,5,12,149,5745,-64,-97,33,f6:0a:5c:59:72:df,302096342,476,119,302095866,302096342
23930,5,12,149,5745,-92,-97,5,4e:72:d0:f1:a2:44,302100498,468,3688,302100030,302100498
23931,5,12,149,5745,-91,-97,6,3a:90:78:0e:4f:1f,302103664,452,2714,302103212,302103664
23932,5,12,149,5745,-64,-97,33,f6:0a:5c:59:72:df,302106259,280,2315,302105979,302106259
23933,5,12,149,5745,-57,-97,40,b6:90:18:f6:b1:d4,302106574,268,47,302106306,302106574
23934,5,12,149,5745,-65,-97,32,5e:29:73:5b:30:00,302109333,272,2487,302109061,302109333
23935,5,12,149,5745,-91,-97,6,3a:90:78:0e:4f:1f,302122944,256,13355,302122688,302122944
23936,5,12,149,5745,-59,-97,38,22:ec:75:a8:8a:31,302123432,244,244,302123188,302123432
23937,5,12,149,5745,-70,-97,27,6a:1e:a4:f8:14:49,302125492,284,1776,302125208,302125492
23938,5,12,149,5745,-68,-97,29,f2:da:61:dd:98:c5,302127441,268,1681,302127173,302127441
23939,5,12,149,5745,-86,-97,11,9a:24:38:da:96:bb,302140263,272,12550,302139991,302140263
23940,5,12,149,5745,-52,-97,45,3e:d1:9b:c7:a4:de,302141849,544,1042,302141305,302141849
23941,5,12,149,5745,-87,-97,10,de:be:a8:cd:79:57,302143368,284,1235,302143084,302143368
23942,5,12,149,5745,-66,-97,31,56:68:e2:c2:8d:d5,302146351,476,2507,302145875,302146351
23943,5,12,149,5745,-58,-97,39,b6:90:18:f6:b1:d4,302146916,268,297,302146648,302146916
23944,5,12,149,5745,-71,-97,26,6a:1e:a4:f8:14:49,302149531,480,2135,302149051,302149531
23945,5,12,149,5745,-65,-97,32,5e:29:73:5b:30:00,302150171,540,100,302149631,302150171
23946,5,12,149,5745,-85,-97,12,7e:05:42:11:d2:ec,302151660,104,1385,302151556,302151660
23947,5,12,149,5745,-85,-97,12,7e:05:42:11:d2:ec,302151843,360,-177,302151483,302151843
23948,5,12,149,5745,-85,-97,12,7e:05:42:11:d2:ec,302152273,360,70,302151913,302152273
23949,5,12,149,5745,-68,-97,29,f2:da:61:dd:98:c5,302153014,268,473,302152746,302153014
23950,5,12,149,5745,-62,-97,35,a6:92:ad:b7:76:65,302155182,484,1684,302154698,302155182
23951,5,12,149,5745,-66,-97,31,72:d1:72:1d:22:a1,302155711,480,49,302155231,302155711
23952,5,12,149,5745,-65,-97,32,72:d1:72:1d:22:a1,302156994,284,999,302156710,302156994
23953,5,12,149,5745,-63,-97,34,0a:b9:b7:b1:4d:fa,302157438,268,176,302157170,302157438
23954,5,12,149,5745,-62,-97,35,a6:92:ad:b7:76:65,302157915,284,193,302157631,302157915
23955,5,12,149,5745,-47,-97,50,4a:86:35:36:74:b8,302159288,268,1105,302159020,302159288
23956,5,12,149,5745,-67,-97,30,f6:0a:5c:59:72:df,302161592,476,1828,302161116,302161592
23957,5,12,149,5745,-89,-97,8,3a:90:78:0e:4f:1f,302162112,452,68,302161660,302162112
23958,5,12,149,5745,-86,-97,11,9a:24:38:da:96:bb,302164068,824,1132,302163244,302164068
23959,5,12,149,5745,-92,-97,5,4e:72:d0:f1:a2:44,302165446,468,910,302164978,302165446
23960,5,6,149,5745,-89,-97,8,54:e4:3a:ec:fb:65,302166511,360,705,302166151,302166511
23961,5,12,149,5745,-69,-97,28,d2:00:04:7e:2c:ab,302167001,440,50,302166561,302167001
23962,5,12,149,5745,-47,-97,50,4a:86:35:36:74:b8,302173010,268,5741,302172742,302173010
23963,5,12,149,5745,-90,-97,7,42:d2:d9:2b:ac:61,302174489,288,1191,302174201,302174489
23964,5,12,149,5745,-67,-97,30,56:68:e2:c2:8d:d5,302191160,280,16391,302190880,302191160
23965,5,12,149,5745,-54,-97,43,3e:d1:9b:c7:a4:de,302192940,272,1508,302192668,302192940
23966,5,12,149,5745,-65,-97,32,5e:29:73:5b:30:00,302204594,272,11382,302204322,302204594
23967,5,6,149,5745,-73,-97,24,0e:99:e9:e6:d6:ab,302205391,108,689,302205283,302205391
23968,5,6,149,5745,-88,-97,9,54:e4:3a:ec:fb:65,302205661,352,-82,302205309,302205661
23969,5,6,149,5745,-89,-97,8,54:e4:3a:ec:fb:65,302206272,352,259,302205920,302206272
23970,5,6,149,5745,-73,-97,24,,302206643,44,327,302206599,302206643
23971,5,6,149,5745,-73,-97,24,0e:99:e9:e6:d6:ab,302225498,108,18747,302225390,302225498
23972,5,6,149,5745,-90,-97,7,54:e4:3a:ec:fb:65,302225756,352,-94,302225404,302225756
23973,5,6,149,5745,-74,-97,23,,302226126,44,326,302226082,302226126
23974,5,12,149,5745,-58,-97,39,b6:90:18:f6:b1:d4,302226324,268,-70,302226056,302226324
23975,5,12,149,5745,-58,-97,39,22:ec:75:a8:8a:31,302228585,244,2017,302228341,302228585
23976,5,12,149,5745,-68,-97,29,6a:1e:a4:f8:14:49,302249704,284,20835,302249420,302249704
23977,5,12,149,5745,-67,-97,30,f2:da:61:dd:98:c5,302250222,268,250,302249954,302250222
23978,5,12,149,5745,-86,-97,11,9a:24:38:da:96:bb,302252887,272,2393,302252615,302252887
23979,5,12,149,5745,-89,-97,8,de:be:a8:cd:79:57,302254020,284,849,302253736,302254020
23980,5,6,149,5745,-88,-97,9,54:e4:3a:ec:fb:65,302268912,360,14532,302268552,302268912
23981,5,12,149,5745,-63,-97,34,a6:92:ad:b7:76:65,302275627,284,6431,302275343,302275627
23982,5,12,149,5745,-68,-97,29,72:d1:72:1d:22:a1,302283458,284,7547,302283174,302283458
23983,5,12,149,5745,-91,-97,6,42:d2:d9:2b:ac:61,302288988,288,5242,302288700,302288988
23984,5,12,149,5745,-89,-97,8,4e:72:d0:f1:a2:44,302289708,272,448,302289436,302289708
23985,5,24,149,5745,-79,-97,18,,302305194,28,15458,302305166,302305194
23986,5,6,149,5745,-90,-97,7,,302305353,68,91,302305285,302305353
23987,5,24,149,5745,-79,-97,18,,302306254,32,869,302306222,302306254
23988,5,12,149,5745,-56,-97,41,3e:d1:9b:c7:a4:de,302307202,272,676,302306930,302307202
23989,5,12,149,5745,-68,-97,29,56:68:e2:c2:8d:d5,302307554,280,72,302307274,302307554
23990,5,24,149,5745,-78,-97,19,,302308234,28,652,302308206,302308234
23991,5,24,149,5745,-79,-97,18,,302308278,28,16,302308250,302308278
23992,5,24,149,5745,-79,-97,18,,302308390,32,80,302308358,302308390
23993,5,12,149,5745,-64,-97,33,5e:29:73:5b:30:00,302318886,272,10224,302318614,302318886
23994,5,24,149,5745,-79,-97,18,,302323515,28,4601,302323487,302323515
23995,5,24,149,5745,-78,-97,19,,302323559,28,16,302323531,302323559
23996,5,24,149,5745,-78,-97,19,,302323667,32,76,302323635,302323667
23997,5,24,149,5745,-78,-97,19,,302335917,28,12222,302335889,302335917
23998,5,24,149,5745,-78,-97,19,,302335961,28,16,302335933,302335961
23999,5,24,149,5745,-79,-97,18,,302336077,32,84,302336045,302336077
24000,5,12,149,5745,-60,-97,37,22:ec:75:a8:8a:31,302345969,244,9648,302345725,302345969
24001,5,12,149,5745,-60,-97,37,f6:0a:5c:59:72:df,302347518,280,1269,302347238,302347518
24002,5,24,149,5745,-79,-97,18,,302351654,28,4108,302351626,302351654
24003,5,24,149,5745,-78,-97,19,,302351698,28,16,302351670,302351698
24004,5,24,149,5745,-78,-97,19,,302351806,32,76,302351774,302351806
24005,5,12,149,5745,-87,-97,10,7e:05:42:11:d2:ec,302352835,440,589,302352395,302352835
24006,5,24,149,5745,-78,-97,19,,302353427,28,564,302353399,302353427
24007,5,24,149,5745,-79,-97,18,,302353471,28,16,302353443,302353471
24008,5,24,149,5745,-79,-97,18,,302353579,32,76,302353547,302353579
24009,5,24,149,5745,-79,-97,18,,302359526,28,5919,302359498,302359526
24010,5,24,149,5745,-78,-97,19,,302359570,28,16,302359542,302359570
24011,5,24,149,5745,-79,-97,18,,302359678,32,76,302359646,302359678
24012,5,12,149,5745,-66,-97,31,6a:1e:a4:f8:14:49,302359799,284,-163,302359515,302359799
24013,5,6,149,5745,-87,-97,10,54:e4:3a:ec:fb:65,302371312,360,11153,302370952,302371312
24014,5,12,149,5745,-49,-97,48,4a:86:35:36:74:b8,302371882,268,302,302371614,302371882
24015,5,12,149,5745,-70,-97,27,f2:da:61:dd:98:c5,302372299,268,149,302372031,302372299
24016,5,24,149,5745,-78,-97,19,,302379402,28,7075,302379374,302379402
24017,5,24,149,5745,-78,-97,19,,302379446,28,16,302379418,302379446
24018,5,24,149,5745,-78,-97,19,,302379557,32,79,302379525,302379557
24019,5,24,149,5745,-78,-97,19,,302379770,28,185,302379742,302379770
24020,5,24,149,5745,-78,-97,19,,302379815,28,17,302379787,302379815
24021,5,24,149,5745,-78,-97,19,,302379922,32,75,302379890,302379922
24022,5,24,149,5745,-78,-97,19,,302382517,28,2567,302382489,302382517
24023,5,24,149,5745,-78,-97,19,,302382724,28,179,302382696,302382724
24024,5,24,149,5745,-78,-97,19,,302383048,28,296,302383020,302383048
24025,5,24,149,5745,-79,-97,18,,302383092,28,16,302383064,302383092
24026,5,24,149,5745,-78,-97,19,,302383200,32,76,302383168,302383200
24027,5,12,149,5745,-61,-97,36,a6:92:ad:b7:76:65,302393770,284,10286,302393486,302393770
24028,5,12,149,5745,-67,-97,30,72:d1:72:1d:22:a1,302395680,284,1626,302395396,302395680
24029,5,12,149,5745,-60,-97,37,b6:90:18:f6:b1:d4,302396429,268,481,302396161,302396429
24030,5,12,149,5745,-90,-97,7,42:d2:d9:2b:ac:61,302400939,288,4222,302400651,302400939
24031,5,12,149,5745,-89,-97,8,4e:72:d0:f1:a2:44,302404792,272,3581,302404520,302404792
24032,5,12,149,5745,-91,-97,6,46:28:71:6e:d2:2e,302405111,252,67,302404859,302405111
24033,5,24,149,5745,-78,-97,19,,302410103,28,4964,302410075,302410103
24034,5,24,149,5745,-78,-97,19,,302410147,28,16,302410119,302410147
24035,5,24,149,5745,-78,-97,19,,302410255,32,76,302410223,302410255
24036,5,12,149,5745,-91,-97,6,de:be:a8:cd:79:57,302412491,284,1952,302412207,302412491
24037,5,24,149,5745,-78,-97,19,,302421972,28,9453,302421944,302421972
24038,5,24,149,5745,-78,-97,19,,302422016,28,16,302421988,302422016
24039,5,24,149,5745,-78,-97,19,,302422124,32,76,302422092,302422124
24040,5,12,149,5745,-56,-97,41,3e:d1:9b:c7:a4:de,302424140,272,1744,302423868,302424140
24041,5,12,149,5745,-65,-97,32,5e:29:73:5b:30:00,302435825,272,11413,302435553,302435825
24042,5,24,149,5745,-78,-97,19,,302441537,28,5684,302441509,302441537
24043,5,24,149,5745,-78,-97,19,,302441581,28,16,302441553,302441581
24044,5,24,149,5745,-78,-97,19,,302441699,32,86,302441667,302441699
24045,5,24,149,5745,-78,-97,19,,302441818,32,87,302441786,302441818
24046,5,24,149,5745,-78,-97,19,,302441993,28,147,302441965,302441993
24047,5,24,149,5745,-77,-97,20,,302442038,28,17,302442010,302442038
24048,5,24,149,5745,-78,-97,19,,302442145,32,75,302442113,302442145
24049,5,24,149,5745,-77,-97,20,,302444543,28,2370,302444515,302444543
24050,5,24,149,5745,-78,-97,19,,302444586,28,15,302444558,302444586
24051,5,24,149,5745,-78,-97,19,,302444695,32,77,302444663,302444695
24052,5,24,149,5745,-77,-97,20,,302450852,28,6129,302450824,302450852
24053,5,24,149,5745,-77,-97,20,,302450896,28,16,302450868,302450896
24054,5,24,149,5745,-78,-97,19,,302451005,32,77,302450973,302451005
24055,5,24,149,5745,-77,-97,20,,302453361,28,2328,302453333,302453361
24056,5,24,149,5745,-78,-97,19,,302453406,28,17,302453378,302453406
24057,5,24,149,5745,-77,-97,20,,302453524,32,86,302453492,302453524
24058,5,24,149,5745,-78,-97,19,,302453803,28,251,302453775,302453803
24059,5,24,149,5745,-77,-97,20,,302453847,28,16,302453819,302453847
24060,5,24,149,5745,-78,-97,19,,302454078,32,199,302454046,302454078
24061,5,24,149,5745,-78,-97,19,,302455551,28,1445,302455523,302455551
24062,5,24,149,5745,-78,-97,19,,302455596,28,17,302455568,302455596
24063,5,24,149,5745,-77,-97,20,,302455725,32,97,302455693,302455725
24064,5,24,149,5745,-78,-97,19,,302455904,28,151,302455876,302455904
24065,5,24,149,5745,-77,-97,20,,302455949,28,17,302455921,302455949
24066,5,24,149,5745,-77,-97,20,,302456060,32,79,302456028,302456060
24067,5,24,149,5745,-77,-97,20,,302456219,32,127,302456187,302456219
24068,5,24,149,5745,-78,-97,19,,302456930,28,683,302456902,302456930
24069,5,24,149,5745,-77,-97,20,,302456975,28,17,302456947,302456975
24070,5,24,149,5745,-77,-97,20,,302457104,32,97,302457072,302457104
24071,5,24,149,5745,-77,-97,20,,302457250,28,118,302457222,302457250
24072,5,24,149,5745,-77,-97,20,,302457294,28,16,302457266,302457294
24073,5,24,149,5745,-77,-97,20,,302457413,32,87,302457381,302457413
24074,5,24,149,5745,-77,-97,20,,302457525,32,80,302457493,302457525
24075,5,24,149,5745,-77,-97,20,,302457611,28,58,302457583,302457611
24076,5,24,149,5745,-78,-97,19,,302457655,28,16,302457627,302457655
24077,5,24,149,5745,-78,-97,19,,302457764,32,77,302457732,302457764
24078,5,12,149,5745,-61,-97,36,22:ec:75:a8:8a:31,302458901,244,893,302458657,302458901
24079,5,24,149,5745,-77,-97,20,,302460213,28,1284,302460185,302460213
24080,5,24,149,5745,-77,-97,20,,302460257,28,16,302460229,302460257
24081,5,24,149,5745,-78,-97,19,,302460365,32,76,302460333,302460365
24082,5,24,149,5745,-78,-97,19,,302462542,28,2149,302462514,302462542
24083,5,24,149,5745,-77,-97,20,,302462586,28,16,302462558,302462586
24084,5,24,149,5745,-77,-97,20,,302462694,32,76,302462662,302462694
24085,5,24,149,5745,-77,-97,20,,302464432,28,1710,302464404,302464432
24086,5,24,149,5745,-78,-97,19,,302464476,28,16,302464448,302464476
24087,5,24,149,5745,-78,-97,19,,302464584,32,76,302464552,302464584
24088,5,12,149,5745,-66,-97,31,6a:1e:a4:f8:14:49,302473146,284,8278,302472862,302473146
24089,5,6,149,5745,-88,-97,9,54:e4:3a:ec:fb:65,302473713,360,207,302473353,302473713
24090,5,12,149,5745,-48,-97,49,4a:86:35:36:74:b8,302474434,268,453,302474166,302474434
24091,5,12,149,5745,-69,-97,28,f2:da:61:dd:98:c5,302474889,268,187,302474621,302474889
24092,5,12,149,5745,-91,-97,6,42:d2:d9:2b:ac:61,302477853,484,2480,302477369,302477853
24093,5,12,149,5745,-86,-97,11,9a:24:38:da:96:bb,302480329,272,2204,302480057,302480329
24094,5,12,149,5745,-60,-97,37,b6:90:18:f6:b1:d4,302498858,268,18261,302498590,302498858
24095,5,12,149,5745,-69,-97,28,56:68:e2:c2:8d:d5,302500457,280,1319,302500177,302500457
24096,5,12,149,5745,-91,-97,6,42:d2:d9:2b:ac:61,302505936,288,5191,302505648,302505936
24097,5,12,149,5745,-67,-97,30,72:d1:72:1d:22:a1,302508881,284,2661,302508597,302508881
24098,5,12,149,5745,-62,-97,35,a6:92:ad:b7:76:65,302512991,284,3826,302512707,302512991
24099,5,12,149,5745,-91,-97,6,de:be:a8:cd:79:57,302514926,284,1651,302514642,302514926
24100,5,12,149,5745,-47,-97,50,4a:86:35:36:74:b8,302518982,268,3788,302518714,302518982
24101,5,12,149,5745,-70,-97,27,56:68:e2:c2:8d:d5,302534206,280,14944,302533926,302534206
24102,5,12,149,5745,-56,-97,41,3e:d1:9b:c7:a4:de,302536587,544,1837,302536043,302536587
24103,5,12,149,5745,-59,-97,38,b6:90:18:f6:b1:d4,302540416,268,3561,302540148,302540416
24104,5,12,149,5745,-71,-97,26,56:68:e2:c2:8d:d5,302540718,476,-174,302540242,302540718
24105,5,12,149,5745,-67,-97,30,5e:29:73:5b:30:00,302543238,540,1980,302542698,302543238
24106,5,12,149,5745,-67,-97,30,6a:1e:a4:f8:14:49,302546895,480,3177,302546415,302546895
24107,5,12,149,5745,-68,-97,29,f2:da:61:dd:98:c5,302547483,268,320,302547215,302547483
24108,5,12,149,5745,-92,-97,5,de:be:a8:cd:79:57,302547838,480,-125,302547358,302547838
24109,5,12,149,5745,-66,-97,31,72:d1:72:1d:22:a1,302548604,480,286,302548124,302548604
24110,5,12,149,5745,-56,-97,41,3e:d1:9b:c7:a4:de,302550564,272,1688,302550292,302550564
24111,5,12,149,5745,-47,-97,50,4a:86:35:36:74:b8,302553489,268,2657,302553221,302553489
24112,5,12,149,5745,-64,-97,33,2a:07:ef:54:b5:55,302554054,440,125,302553614,302554054
24113,5,12,149,5745,-62,-97,35,f6:0a:5c:59:72:df,302555644,476,1114,302555168,302555644
24114,5,12,149,5745,-60,-97,37,22:ec:75:a8:8a:31,302557018,516,858,302556502,302557018
24115,5,12,149,5745,-63,-97,34,f6:0a:5c:59:72:df,302558027,280,729,302557747,302558027
24116,5,12,149,5745,-89,-97,8,9a:24:38:da:96:bb,302558429,824,-422,302557605,302558429
24117,5,12,149,5745,-90,-97,7,4e:72:d0:f1:a2:44,302559394,468,497,302558926,302559394
24118,5,12,149,5745,-89,-97,8,3a:90:78:0e:4f:1f,302562899,452,3053,302562447,302562899
24119,5,12,149,5745,-61,-97,36,a6:92:ad:b7:76:65,302564519,484,1136,302564035,302564519
24120,5,12,149,5745,-59,-97,38,b6:90:18:f6:b1:d4,302567801,268,3014,302567533,302567801
24121,5,12,149,5745,-67,-97,30,5e:29:73:5b:30:00,302568103,272,30,302567831,302568103
24122,5,12,149,5745,-89,-97,8,3a:90:78:0e:4f:1f,302574487,256,6128,302574231,302574487
24123,5,6,149,5745,-89,-97,8,54:e4:3a:ec:fb:65,302576113,360,1266,302575753,302576113
24124,5,12,149,5745,-60,-97,37,22:ec:75:a8:8a:31,302582728,244,6371,302582484,302582728
24125,5,12,149,5745,-67,-97,30,6a:1e:a4:f8:14:49,302584644,284,1632,302584360,302584644
24126,5,12,149,5745,-68,-97,29,f2:da:61:dd:98:c5,302585504,268,592,302585236,302585504
24127,5,12,149,5745,-88,-97,9,9a:24:38:da:96:bb,302588882,272,3106,302588610,302588882
24128,5,12,149,5745,-64,-97,33,2a:07:ef:54:b5:55,302601257,440,11935,302600817,302601257
24129,5,12,149,5745,-69,-97,28,f2:da:61:dd:98:c5,302611083,268,9558,302610815,302611083
24130,5,12,149,5745,-89,-97,8,7e:05:42:11:d2:ec,302616260,440,4737,302615820,302616260
24131,5,12,149,5745,-60,-97,37,a6:92:ad:b7:76:65,302617094,484,350,302616610,302617094
24132,5,12,149,5745,-60,-97,37,a6:92:ad:b7:76:65,302617622,284,244,302617338,302617622
24133,5,12,149,5745,-66,-97,31,72:d1:72:1d:22:a1,302621590,284,3684,302621306,302621590
24134,5,12,149,5745,-92,-97,5,42:d2:d9:2b:ac:61,302626596,288,4718,302626308,302626596
24135,5,12,149,5745,-91,-97,6,4e:72:d0:f1:a2:44,302632878,272,6010,302632606,302632878
24136,5,12,149,5745,-47,-97,50,4a:86:35:36:74:b8,302638612,268,5466,302638344,302638612
24137,5,12,149,5745,-65,-97,32,2a:07:ef:54:b5:55,302648471,244,9615,302648227,302648471
24138,5,12,149,5745,-89,-97,8,7e:05:42:11:d2:ec,302649312,244,597,302649068,302649312
24139,5,12,149,5745,-71,-97,26,56:68:e2:c2:8d:d5,302652589,280,2997,302652309,302652589
24140,5,12,149,5745,-75,-97,22,d2:00:04:7e:2c:ab,302653808,380,839,302653428,302653808
24141,5,12,149,5745,-75,-97,22,d2:00:04:7e:2c:ab,302654368,104,456,302654264,302654368
24142,5,12,149,5745,-55,-97,42,3e:d1:9b:c7:a4:de,302664901,272,10261,302664629,302664901
24143,5,12,149,5745,-65,-97,32,2a:07:ef:54:b5:55,302665244,440,-97,302664804,302665244
24144,5,12,149,5745,-67,-97,30,5e:29:73:5b:30:00,302666359,272,843,302666087,302666359
24145,5,12,149,5745,-74,-97,23,d2:00:04:7e:2c:ab,302666684,468,-143,302666216,302666684
24146,5,24,149,5745,-79,-97,18,,302669611,28,2899,302669583,302669611
24147,5,24,149,5745,-77,-97,20,,302669656,28,17,302669628,302669656
24148,5,24,149,5745,-77,-97,20,,302669764,32,76,302669732,302669764
24149,5,12,149,5745,-60,-97,37,b6:90:18:f6:b1:d4,302674832,268,4800,302674564,302674832
24150,5,12,149,5745,-88,-97,9,7e:05:42:11:d2:ec,302675359,440,87,302674919,302675359
24151,5,12,149,5745,-70,-97,27,f2:da:61:dd:98:c5,302676124,268,497,302675856,302676124
24152,5,12,149,5745,-66,-97,31,5e:29:73:5b:30:00,302677317,540,653,302676777,302677317
24153,5,6,149,5745,-88,-97,9,54:e4:3a:ec:fb:65,302678514,360,837,302678154,302678514
24154,5,12,149,5745,-90,-97,7,de:be:a8:cd:79:57,302678901,480,-93,302678421,302678901
24155,5,12,149,5745,-62,-97,35,0a:b9:b7:b1:4d:fa,302681681,268,2512,302681413,302681681
24156,5,12,149,5745,-60,-97,37,a6:92:ad:b7:76:65,302682928,484,763,302682444,302682928
24157,5,12,149,5745,-47,-97,50,4a:86:35:36:74:b8,302685481,268,2285,302685213,302685481
24158,5,24,149,5745,-80,-97,17,,302685847,28,338,302685819,302685847
24159,5,24,149,5745,-77,-97,20,,302685891,28,16,302685863,302685891
24160,5,24,149,5745,-78,-97,19,,302686000,32,77,302685968,302686000
24161,5,12,149,5745,-63,-97,34,f6:0a:5c:59:72:df,302686078,280,-202,302685798,302686078
24162,5,12,149,5745,-59,-97,38,22:ec:75:a8:8a:31,302687632,516,1038,302687116,302687632
24163,5,24,149,5745,-78,-97,19,,302688209,28,549,302688181,302688209
24164,5,24,149,5745,-80,-97,17,,302688253,28,16,302688225,302688253
24165,5,24,149,5745,-80,-97,17,,302688361,32,76,302688329,302688361
24166,5,12,149,5745,-86,-97,11,9a:24:38:da:96:bb,302691237,824,2052,302690413,302691237
24167,5,12,149,5745,-59,-97,38,22:ec:75:a8:8a:31,302696541,244,5060,302696297,302696541
24168,5,12,149,5745,-70,-97,27,f2:da:61:dd:98:c5,302699798,268,2989,302699530,302699798
24169,5,12,149,5745,-86,-97,11,9a:24:38:da:96:bb,302700101,272,31,302699829,302700101
24170,5,24,149,5745,-78,-97,19,,302713772,28,13643,302713744,302713772
24171,5,24,149,5745,-79,-97,18,,302713816,28,16,302713788,302713816
24172,5,24,149,5745,-79,-97,18,,302713924,32,76,302713892,302713924
24173,5,24,149,5745,-79,-97,18,,302716605,28,2653,302716577,302716605
24174,5,24,149,5745,-78,-97,19,,302716649,28,16,302716621,302716649
24175,5,24,149,5745,-79,-97,18,,302716757,32,76,302716725,302716757
24176,5,12,149,5745,-65,-97,32,72:d1:72:1d:22:a1,302735480,284,18439,302735196,302735480
24177,5,12,149,5745,-48,-97,49,4a:86:35:36:74:b8,302737896,268,2148,302737628,302737896
24178,5,12,149,5745,-59,-97,38,a6:92:ad:b7:76:65,302740765,284,2585,302740481,302740765
24179,5,12,149,5745,-89,-97,8,4e:72:d0:f1:a2:44,302748169,272,7132,302747897,302748169
24180,5,12,149,5745,-48,-97,49,4a:86:35:36:74:b8,302748662,268,225,302748394,302748662
24181,5,12,149,5745,-92,-97,5,42:43:08:e8:5d:e9,302752293,468,3163,302751825,302752293
24182,5,12,149,5745,-54,-97,43,3e:d1:9b:c7:a4:de,302765697,272,13132,302765425,302765697
24183,5,12,149,5745,-66,-97,31,2a:07:ef:54:b5:55,302767114,244,1173,302766870,302767114
24184,5,12,149,5745,-65,-97,32,5e:29:73:5b:30:00,302773002,272,5616,302772730,302773002
24185,5,12,149,5745,-67,-97,30,6a:1e:a4:f8:14:49,302776828,284,3542,302776544,302776828
24186,5,6,149,5745,-87,-97,10,54:e4:3a:ec:fb:65,302780915,360,3727,302780555,302780915
24187,5,12,149,5745,-60,-97,37,b6:90:18:f6:b1:d4,302792452,268,11269,302792184,302792452
24188,5,12,149,5745,-60,-97,37,22:ec:75:a8:8a:31,302800449,244,7753,302800205,302800449
24189,5,12,149,5745,-64,-97,33,f6:0a:5c:59:72:df,302802790,280,2061,302802510,302802790
24190,5,12,149,5745,-49,-97,48,4a:86:35:36:74:b8,302803182,268,124,302802914,302803182
24191,5,12,149,5745,-70,-97,27,56:68:e2:c2:8d:d5,302806503,280,3041,302806223,302806503
24192,5,12,149,5745,-85,-97,12,9a:24:38:da:96:bb,302813299,272,6524,302813027,302813299
24193,5,12,149,5745,-91,-97,6,42:43:08:e8:5d:e9,302817882,468,4115,302817414,302817882
24194,5,12,149,5745,-86,-97,11,7e:05:42:11:d2:ec,302822889,244,4763,302822645,302822889
24195,5,12,149,5745,-89,-97,8,de:be:a8:cd:79:57,302827749,284,4576,302827465,302827749
24196,5,12,149,5745,-93,-97,4,42:43:08:e8:5d:e9,302848666,272,20645,302848394,302848666
24197,5,12,149,5745,-90,-97,7,4e:72:d0:f1:a2:44,302863005,272,14067,302862733,302863005
24198,5,12,149,5745,-50,-97,47,4a:86:35:36:74:b8,302863429,268,156,302863161,302863429
24199,5,12,149,5745,-50,-97,47,4a:86:35:36:74:b8,302868834,268,5137,302868566,302868834
24200,5,12,149,5745,-68,-97,29,6a:1e:a4:f8:14:49,302878762,284,9644,302878478,302878762
24201,5,12,149,5745,-67,-97,30,2a:07:ef:54:b5:55,302879867,244,861,302879623,302879867
24202,5,12,149,5745,-52,-97,45,3e:d1:9b:c7:a4:de,302882646,272,2507,302882374,302882646
24203,5,6,149,5745,-88,-97,9,54:e4:3a:ec:fb:65,302883315,360,309,302882955,302883315
24204,5,12,149,5745,-73,-97,24,f2:da:61:dd:98:c5,302884126,268,543,302883858,302884126
24205,5,12,149,5745,-66,-97,31,5e:29:73:5b:30:00,302890015,272,5617,302889743,302890015
24206,5,24,149,5745,-79,-97,18,,302894657,28,4614,302894629,302894657
24207,5,24,149,5745,-79,-97,18,,302894990,28,305,302894962,302894990
24208,5,24,149,5745,-79,-97,18,,302895034,28,16,302895006,302895034
24209,5,24,149,5745,-79,-97,18,,302895143,32,77,302895111,302895143
24210,5,12,149,5745,-60,-97,37,b6:90:18:f6:b1:d4,302905617,268,10206,302905349,302905617
24211,5,12,149,5745,-62,-97,35,a6:92:ad:b7:76:65,302906516,284,615,302906232,302906516
24212,5,12,149,5745,-67,-97,30,72:d1:72:1d:22:a1,302907678,284,878,302907394,302907678
24213,5,12,149,5745,-68,-97,29,56:68:e2:c2:8d:d5,302909004,280,1046,302908724,302909004
24214,5,24,149,5745,-79,-97,18,,302913215,28,4183,302913187,302913215
24215,5,24,149,5745,-80,-97,17,,302913259,28,16,302913231,302913259
24216,5,24,149,5745,-80,-97,17,,302913367,32,76,302913335,302913367
24217,5,24,149,5745,-80,-97,17,,302913482,32,83,302913450,302913482
24218,5,24,149,5745,-79,-97,18,,302914127,28,617,302914099,302914127
24219,5,24,149,5745,-80,-97,17,,302914171,28,16,302914143,302914171
24220,5,24,149,5745,-80,-97,17,,302914286,32,83,302914254,302914286
24221,5,24,149,5745,-80,-97,17,,302914402,32,84,302914370,302914402
24222,5,24,149,5745,-79,-97,18,,302915948,28,1518,302915920,302915948
24223,5,24,149,5745,-80,-97,17,,302915993,28,17,302915965,302915993
24224,5,24,149,5745,-80,-97,17,,302916111,32,86,302916079,302916111
24225,5,24,149,5745,-80,-97,17,,302916227,32,84,302916195,302916227
24226,5,24,149,5745,-79,-97,18,,302916566,28,311,302916538,302916566
24227,5,24,149,5745,-80,-97,17,,302916610,28,16,302916582,302916610
24228,5,24,149,5745,-80,-97,17,,302916725,32,83,302916693,302916725
24229,5,12,149,5745,-61,-97,36,22:ec:75:a8:8a:31,302917519,244,550,302917275,302917519
24230,5,24,149,5745,-79,-97,18,,302920593,28,3046,302920565,302920593
24231,5,24,149,5745,-80,-97,17,,302920637,28,16,302920609,302920637
24232,5,24,149,5745,-80,-97,17,,302920752,32,83,302920720,302920752
24233,5,24,149,5745,-79,-97,18,,302920935,28,155,302920907,302920935
24234,5,24,149,5745,-80,-97,17,,302920979,28,16,302920951,302920979
24235,5,24,149,5745,-80,-97,17,,302921098,32,87,302921066,302921098
24236,5,24,149,5745,-79,-97,18,,302921210,32,80,302921178,302921210
24237,5,24,149,5745,-81,-97,16,,302921430,28,192,302921402,302921430
24238,5,24,149,5745,-79,-97,18,,302921474,28,16,302921446,302921474
24239,5,24,149,5745,-79,-97,18,,302921582,32,76,302921550,302921582
24240,5,24,149,5745,-79,-97,18,,302921712,28,102,302921684,302921712
24241,5,24,149,5745,-81,-97,16,,302921756,28,16,302921728,302921756
24242,5,24,149,5745,-80,-97,17,,302921885,32,97,302921853,302921885
24243,5,24,149,5745,-80,-97,17,,302922050,28,137,302922022,302922050
24244,5,24,149,5745,-80,-97,17,,302922095,28,17,302922067,302922095
24245,5,24,149,5745,-80,-97,17,,302922213,32,86,302922181,302922213
24246,5,24,149,5745,-79,-97,18,,302922332,32,87,302922300,302922332
24247,5,24,149,5745,-64,-97,33,,302923909,28,1549,302923881,302923909
24248,5,24,149,5745,-79,-97,18,,302923953,28,16,302923925,302923953
24249,5,24,149,5745,-79,-97,18,,302924061,28,80,302924033,302924061
24250,5,12,149,5745,-87,-97,10,7e:05:42:11:d2:ec,302926083,244,1778,302925839,302926083
24251,5,24,149,5745,-80,-97,17,,302927820,28,1709,302927792,302927820
24252,5,24,149,5745,-79,-97,18,,302927864,28,16,302927836,302927864
24253,5,24,149,5745,-79,-97,18,,302927972,32,76,302927940,302927972
24254,5,12,149,5745,-84,-97,13,9a:24:38:da:96:bb,302928132,272,-112,302927860,302928132
24255,5,24,149,5745,-79,-97,18,,302935384,28,7224,302935356,302935384
24256,5,24,149,5745,-80,-97,17,,302935429,28,17,302935401,302935429
24257,5,24,149,5745,-80,-97,17,,302935547,32,86,302935515,302935547
24258,5,24,149,5745,-80,-97,17,,302935670,32,91,302935638,302935670
24259,5,24,149,5745,-79,-97,18,,302935845,28,147,302935817,302935845
24260,5,24,149,5745,-80,-97,17,,302935889,28,16,302935861,302935889
24261,5,24,149,5745,-80,-97,17,,302936008,32,87,302935976,302936008
24262,5,24,149,5745,-80,-97,17,,302936124,32,84,302936092,302936124
24263,5,12,149,5745,-90,-97,7,de:be:a8:cd:79:57,302936190,284,-218,302935906,302936190
24264,5,24,149,5745,-79,-97,18,,302941967,28,5749,302941939,302941967
24265,5,24,149,5745,-79,-97,18,,302943103,28,1108,302943075,302943103
24266,5,24,149,5745,-81,-97,16,,302943148,28,17,302943120,302943148
24267,5,24,149,5745,-80,-97,17,,302943277,32,97,302943245,302943277
24268,5,24,149,5745,-79,-97,18,,302943435,28,130,302943407,302943435
24269,5,24,149,5745,-81,-97,16,,302943480,28,17,302943452,302943480
24270,5,24,149,5745,-81,-97,16,,302943609,32,97,302943577,302943609
24271,5,24,149,5745,-80,-97,17,,302943694,28,57,302943666,302943694
24272,5,24,149,5745,-79,-97,18,,302943738,28,16,302943710,302943738
24273,5,24,149,5745,-78,-97,19,,302943847,32,77,302943815,302943847
24274,5,24,149,5745,-79,-97,18,,302945314,28,1439,302945286,302945314
24275,5,24,149,5745,-81,-97,16,,302945358,28,16,302945330,302945358
24276,5,24,149,5745,-81,-97,16,,302945488,32,98,302945456,302945488
24277,5,24,149,5745,-79,-97,18,,302945670,28,154,302945642,302945670
24278,5,24,149,5745,-80,-97,17,,302945715,28,17,302945687,302945715
24279,5,24,149,5745,-80,-97,17,,302945869,32,122,302945837,302945869
24280,5,24,149,5745,-80,-97,17,,302945985,32,84,302945953,302945985
24281,5,24,149,5745,-80,-97,17,,302946288,28,275,302946260,302946288
24282,5,24,149,5745,-79,-97,18,,302946332,28,16,302946304,302946332
24283,5,24,149,5745,-79,-97,18,,302946445,32,81,302946413,302946445
24284,5,24,149,5745,-79,-97,18,,302947632,28,1159,302947604,302947632
24285,5,24,149,5745,-81,-97,16,,302947677,28,17,302947649,302947677
24286,5,24,149,5745,-80,-97,17,,302947784,32,75,302947752,302947784
24287,5,24,149,5745,-79,-97,18,,302947960,28,148,302947932,302947960
24288,5,24,149,5745,-81,-97,16,,302948004,28,16,302947976,302948004
24289,5,24,149,5745,-80,-97,17,,302948115,32,79,302948083,302948115
24290,5,24,149,5745,-80,-97,17,,302949925,28,1782,302949897,302949925
24291,5,24,149,5745,-79,-97,18,,302949969,28,16,302949941,302949969
24292,5,24,149,5745,-79,-97,18,,302950081,32,80,302950049,302950081
24293,5,24,149,5745,-80,-97,17,,302951055,28,946,302951027,302951055
24294,5,24,149,5745,-79,-97,18,,302951099,28,16,302951071,302951099
24295,5,24,149,5745,-79,-97,18,,302951207,32,76,302951175,302951207
24296,5,24,149,5745,-81,-97,16,,302954935,28,3700,302954907,302954935
24297,5,24,149,5745,-79,-97,18,,302954980,28,17,302954952,302954980
24298,5,24,149,5745,-79,-97,18,,302955088,32,76,302955056,302955088
24299,5,24,149,5745,-78,-97,19,,302963853,28,8737,302963825,302963853
24300,5,24,149,5745,-80,-97,17,,302963897,28,16,302963869,302963897
24301,5,24,149,5745,-80,-97,17,,302964005,32,76,302963973,302964005
24302,5,24,149,5745,-78,-97,19,,302964771,28,738,302964743,302964771
24303,5,24,149,5745,-80,-97,17,,302964815,28,16,302964787,302964815
24304,5,24,149,5745,-80,-97,17,,302964923,32,76,302964891,302964923
24305,5,24,149,5745,-80,-97,17,,302965089,28,138,302965061,302965089
24306,5,24,149,5745,-78,-97,19,,302965133,28,16,302965105,302965133
24307,5,24,149,5745,-78,-97,19,,302965245,32,80,302965213,302965245
24308,5,24,149,5745,-80,-97,17,,302966306,28,1033,302966278,302966306
24309,5,24,149,5745,-79,-97,18,,302966350,28,16,302966322,302966350
24310,5,24,149,5745,-79,-97,18,,302966479,32,97,302966447,302966479
24311,5,24,149,5745,-81,-97,16,,302976077,28,9570,302976049,302976077
24312,5,24,149,5745,-79,-97,18,,302976121,28,16,302976093,302976121
24313,5,24,149,5745,-79,-97,18,,302976230,32,77,302976198,302976230
24314,5,12,149,5745,-53,-97,44,4a:86:35:36:74:b8,302976713,268,215,302976445,302976713
24315,5,24,149,5745,-78,-97,19,,302980593,28,3852,302980565,302980593
24316,5,24,149,5745,-80,-97,17,,302980638,28,17,302980610,302980638
24317,5,24,149,5745,-80,-97,17,,302980745,32,75,302980713,302980745
24318,5,24,149,5745,-78,-97,19,,302980903,28,130,302980875,302980903
24319,5,24,149,5745,-80,-97,17,,302980947,28,16,302980919,302980947
24320,5,24,149,5745,-80,-97,17,,302981055,32,76,302981023,302981055
24321,5,24,149,5745,-80,-97,17,,302981167,32,80,302981135,302981167
24322,5,12,149,5745,-69,-97,28,6a:1e:a4:f8:14:49,302981806,284,355,302981522,302981806
24323,5,24,149,5745,-64,-97,33,,302983405,28,1571,302983377,302983405
24324,5,24,149,5745,-78,-97,19,,302983449,28,16,302983421,302983449
24325,5,24,149,5745,-79,-97,18,,302983557,28,80,302983529,302983557
24326,5,6,149,5745,-87,-97,10,54:e4:3a:ec:fb:65,302985716,360,1799,302985356,302985716
24327,5,24,149,5745,-78,-97,19,,302986501,28,757,302986473,302986501
24328,5,24,149,5745,-80,-97,17,,302986546,28,17,302986518,302986546
24329,5,24,149,5745,-79,-97,18,,302986728,28,154,302986700,302986728
24330,5,24,149,5745,-80,-97,17,,302986773,28,17,302986745,302986773
24331,5,24,149,5745,-80,-97,17,,302986905,32,100,302986873,302986905
24332,5,12,149,5745,-72,-97,25,f2:da:61:dd:98:c5,302987016,268,-157,302986748,302987016
24333,5,24,149,5745,-79,-97,18,,302987466,28,422,302987438,302987466
24334,5,24,149,5745,-80,-97,17,,302987510,28,16,302987482,302987510
24335,5,24,149,5745,-80,-97,17,,302987683,32,141,302987651,302987683
24336,5,24,149,5745,-80,-97,17,,302988603,28,892,302988575,302988603
24337,5,24,149,5745,-78,-97,19,,302988648,28,17,302988620,302988648
24338,5,24,149,5745,-78,-97,19,,302988756,32,76,302988724,302988756
24339,5,24,149,5745,-80,-97,17,,302989449,28,665,302989421,302989449
24340,5,24,149,5745,-78,-97,19,,302989493,28,16,302989465,302989493
24341,5,24,149,5745,-78,-97,19,,302989602,32,77,302989570,302989602
24342,5,24,149,5745,-80,-97,17,,302990716,28,1086,302990688,302990716
24343,5,24,149,5745,-78,-97,19,,302990759,28,15,302990731,302990759
24344,5,24,149,5745,-78,-97,19,,302990876,32,85,302990844,302990876
24345,5,12,149,5745,-69,-97,28,2a:07:ef:54:b5:55,302992364,244,1244,302992120,302992364
24346,5,24,149,5745,-78,-97,19,,302994303,28,1911,302994275,302994303
24347,5,24,149,5745,-80,-97,17,,302994348,28,17,302994320,302994348
24348,5,24,149,5745,-80,-97,17,,302994455,32,75,302994423,302994455
24349,5,24,149,5745,-80,-97,17,,302995980,28,1497,302995952,302995980
24350,5,24,149,5745,-78,-97,19,,302996025,28,17,302995997,302996025
24351,5,24,149,5745,-78,-97,19,,302996133,32,76,302996101,302996133
24352,5,12,149,5745,-51,-97,46,3e:d1:9b:c7:a4:de,302996473,272,68,302996201,302996473
24353,5,24,149,5745,-80,-97,17,,302997115,28,614,302997087,302997115
24354,5,24,149,5745,-80,-97,17,,302997286,28,143,302997258,302997286
24355,5,24,149,5745,-78,-97,19,,302997330,28,16,302997302,302997330
24356,5,24,149,5745,-78,-97,19,,302997458,32,96,302997426,302997458
24357,5,24,149,5745,-78,-97,19,,302998481,28,995,302998453,302998481
24358,5,24,149,5745,-80,-97,17,,302998525,28,16,302998497,302998525
24359,5,24,149,5745,-80,-97,17,,302998636,32,79,302998604,302998636
24360,5,24,149,5745,-78,-97,19,,302998809,28,145,302998781,302998809
24361,5,24,149,5745,-80,-97,17,,302998853,28,16,302998825,302998853
24362,5,24,149,5745,-80,-97,17,,302998961,32,76,302998929,302998961
24363,5,24,149,5745,-80,-97,17,,303000840,28,1851,303000812,303000840
24364,5,24,149,5745,-79,-97,18,,303000884,28,16,303000856,303000884
24365,5,24,149,5745,-78,-97,19,,303000992,32,76,303000960,303000992
24366,5,24,149,5745,-80,-97,17,,303006063,28,5043,303006035,303006063
24367,5,24,149,5745,-78,-97,19,,303006107,28,16,303006079,303006107
24368,5,24,149,5745,-78,-97,19,,303006215,32,76,303006183,303006215
24369,5,12,149,5745,-66,-97,31,5e:29:73:5b:30:00,303007070,272,583,303006798,303007070
24370,5,24,149,5745,-79,-97,18,,303009905,28,2807,303009877,303009905
24371,5,24,149,5745,-80,-97,17,,303009949,28,16,303009921,303009949
24372,5,24,149,5745,-81,-97,16,,303010064,32,83,303010032,303010064
24373,5,12,149,5745,-62,-97,35,a6:92:ad:b7:76:65,303010166,284,-182,303009882,303010166
24374,5,12,149,5745,-67,-97,30,72:d1:72:1d:22:a1,303010486,284,36,303010202,303010486
24375,5,24,149,5745,-78,-97,19,,303010974,28,460,303010946,303010974
24376,5,24,149,5745,-80,-97,17,,303011018,28,16,303010990,303011018
24377,5,24,149,5745,-81,-97,16,,303011126,32,76,303011094,303011126
24378,5,24,149,5745,-81,-97,16,,303011245,32,87,303011213,303011245
24379,5,24,149,5745,-78,-97,19,,303011403,28,130,303011375,303011403
24380,5,24,149,5745,-81,-97,16,,303011447,28,16,303011419,303011447
24381,5,24,149,5745,-81,-97,16,,303011555,32,76,303011523,303011555
24382,5,24,149,5745,-79,-97,18,,303011795,28,212,303011767,303011795
24383,5,24,149,5745,-81,-97,16,,303011839,28,16,303011811,303011839
24384,5,24,149,5745,-81,-97,16,,303011947,32,76,303011915,303011947
24385,5,24,149,5745,-81,-97,16,,303012349,28,374,303012321,303012349
24386,5,24,149,5745,-78,-97,19,,303012393,28,16,303012365,303012393
24387,5,24,149,5745,-79,-97,18,,303012501,32,76,303012469,303012501
24388,5,24,149,5745,-79,-97,18,,303012616,32,83,303012584,303012616
24389,5,12,149,5745,-70,-97,27,56:68:e2:c2:8d:d5,303012718,280,-178,303012438,303012718
24390,5,24,149,5745,-81,-97,16,,303013414,28,668,303013386,303013414
24391,5,24,149,5745,-78,-97,19,,303013459,28,17,303013431,303013459
24392,5,24,149,5745,-78,-97,19,,303013567,32,76,303013535,303013567
24393,5,24,149,5745,-79,-97,18,,303013685,32,86,303013653,303013685
24394,5,24,149,5745,-79,-97,18,,303013931,28,218,303013903,303013931
24395,5,24,149,5745,-81,-97,16,,303013975,28,16,303013947,303013975
24396,5,24,149,5745,-81,-97,16,,303014086,32,79,303014054,303014086
24397,5,24,149,5745,-81,-97,16,,303014202,32,84,303014170,303014202
24398,5,24,149,5745,-79,-97,18,,303014357,28,127,303014329,303014357
24399,5,24,149,5745,-80,-97,17,,303014401,28,16,303014373,303014401
24400,5,24,149,5745,-81,-97,16,,303014509,32,76,303014477,303014509
24401,5,24,149,5745,-81,-97,16,,303014624,32,83,303014592,303014624
24402,5,24,149,5745,-81,-97,16,,303016119,28,1467,303016091,303016119
24403,5,24,149,5745,-78,-97,19,,303016164,28,17,303016136,303016164
24404,5,24,149,5745,-78,-97,19,,303016272,32,76,303016240,303016272
24405,5,24,149,5745,-81,-97,16,,303017219,28,919,303017191,303017219
24406,5,24,149,5745,-78,-97,19,,303017263,28,16,303017235,303017263
24407,5,24,149,5745,-78,-97,19,,303017371,32,76,303017339,303017371
24408,5,24,149,5745,-80,-97,17,,303017691,28,292,303017663,303017691
24409,5,24,149,5745,-78,-97,19,,303017735,28,16,303017707,303017735
24410,5,24,149,5745,-78,-97,19,,303017843,32,76,303017811,303017843
24411,5,12,149,5745,-60,-97,37,b6:90:18:f6:b1:d4,303018107,268,-4,303017839,303018107
24412,5,24,149,5745,-78,-97,19,,303018536,28,401,303018508,303018536
24413,5,24,149,5745,-80,-97,17,,303018580,28,16,303018552,303018580
24414,5,24,149,5745,-81,-97,16,,303018688,32,76,303018656,303018688
24415,5,24,149,5745,-78,-97,19,,303023358,28,4642,303023330,303023358
24416,5,24,149,5745,-81,-97,16,,303023402,28,16,303023374,303023402
24417,5,24,149,5745,-80,-97,17,,303023520,32,86,303023488,303023520
24418,5,24,149,5745,-78,-97,19,,303023692,28,144,303023664,303023692
24419,5,24,149,5745,-81,-97,16,,303023736,28,16,303023708,303023736
24420,5,24,149,5745,-80,-97,17,,303023854,32,86,303023822,303023854
24421,5,24,149,5745,-80,-97,17,,303024103,32,217,303024071,303024103
24422,5,12,149,5745,-86,-97,11,7e:05:42:11:d2:ec,303027544,244,3197,303027300,303027544
24423,5,24,149,5745,-78,-97,19,,303028199,28,627,303028171,303028199
24424,5,24,149,5745,-81,-97,16,,303028244,28,17,303028216,303028244
24425,5,24,149,5745,-81,-97,16,,303028373,32,97,303028341,303028373
24426,5,24,149,5745,-78,-97,19,,303028793,28,392,303028765,303028793
24427,5,24,149,5745,-81,-97,16,,303028838,28,17,303028810,303028838
24428,5,24,149,5745,-81,-97,16,,303028967,32,97,303028935,303028967
24429,5,24,149,5745,-81,-97,16,,303029061,28,66,303029033,303029061
24430,5,24,149,5745,-78,-97,19,,303029105,28,16,303029077,303029105
24431,5,24,149,5745,-78,-97,19,,303029244,28,111,303029216,303029244
24432,5,24,149,5745,-81,-97,16,,303029288,28,16,303029260,303029288
24433,5,24,149,5745,-81,-97,16,,303029418,32,98,303029386,303029418
24434,5,24,149,5745,-78,-97,19,,303029602,28,156,303029574,303029602
24435,5,24,149,5745,-81,-97,16,,303029646,28,16,303029618,303029646
24436,5,24,149,5745,-81,-97,16,,303029826,32,148,303029794,303029826
24437,5,24,149,5745,-81,-97,16,,303029920,28,66,303029892,303029920
24438,5,24,149,5745,-78,-97,19,,303029964,28,16,303029936,303029964
24439,5,24,149,5745,-78,-97,19,,303030072,32,76,303030040,303030072
24440,5,24,149,5745,-78,-97,19,,303030823,28,723,303030795,303030823
24441,5,24,149,5745,-81,-97,16,,303030867,28,16,303030839,303030867
24442,5,24,149,5745,-81,-97,16,,303030975,32,76,303030943,303030975
24443,5,24,149,5745,-81,-97,16,,303031096,28,93,303031068,303031096
24444,5,24,149,5745,-78,-97,19,,303031140,28,16,303031112,303031140
24445,5,24,149,5745,-78,-97,19,,303031249,32,77,303031217,303031249
24446,5,24,149,5745,-78,-97,19,,303031574,28,297,303031546,303031574
24447,5,24,149,5745,-81,-97,16,,303031619,28,17,303031591,303031619
24448,5,24,149,5745,-81,-97,16,,303031737,32,86,303031705,303031737
24449,5,24,149,5745,-78,-97,19,,303031932,28,167,303031904,303031932
24450,5,24,149,5745,-81,-97,16,,303031977,28,17,303031949,303031977
24451,5,24,149,5745,-81,-97,16,,303032167,32,158,303032135,303032167
24452,5,24,149,5745,-78,-97,19,,303033628,28,1433,303033600,303033628
24453,5,24,149,5745,-81,-97,16,,303033673,28,17,303033645,303033673
24454,5,24,149,5745,-80,-97,17,,303033802,32,97,303033770,303033802
24455,5,24,149,5745,-78,-97,19,,303033973,28,143,303033945,303033973
24456,5,24,149,5745,-81,-97,16,,303034017,28,16,303033989,303034017
24457,5,24,149,5745,-81,-97,16,,303034171,32,122,303034139,303034171
24458,5,24,149,5745,-81,-97,16,,303034283,32,80,303034251,303034283
24459,5,12,149,5745,-62,-97,35,22:ec:75:a8:8a:31,303034625,244,98,303034381,303034625
24460,5,24,149,5745,-78,-97,19,,303035364,28,711,303035336,303035364
24461,5,24,149,5745,-81,-97,16,,303035408,28,16,303035380,303035408
24462,5,24,149,5745,-81,-97,16,,303035526,32,86,303035494,303035526
24463,5,24,149,5745,-81,-97,16,,303035666,28,112,303035638,303035666
24464,5,24,149,5745,-78,-97,19,,303035710,28,16,303035682,303035710
24465,5,24,149,5745,-78,-97,19,,303035818,32,76,303035786,303035818
24466,5,24,149,5745,-78,-97,19,,303035939,28,93,303035911,303035939
24467,5,24,149,5745,-82,-97,15,,303035983,28,16,303035955,303035983
24468,5,24,149,5745,-81,-97,16,,303036159,32,144,303036127,303036159
24469,5,24,149,5745,-78,-97,19,,303036367,28,180,303036339,303036367
24470,5,24,149,5745,-80,-97,17,,303036411,28,16,303036383,303036411
24471,5,24,149,5745,-81,-97,16,,303037537,28,1098,303037509,303037537
24472,5,24,149,5745,-78,-97,19,,303037581,28,16,303037553,303037581
24473,5,24,149,5745,-77,-97,20,,303037690,32,77,303037658,303037690
24474,5,24,149,5745,-81,-97,16,,303042361,28,4643,303042333,303042361
24475,5,24,149,5745,-78,-97,19,,303042405,28,16,303042377,303042405
24476,5,24,149,5745,-78,-97,19,,303042514,32,77,303042482,303042514
24477,5,12,149,5745,-89,-97,8,de:be:a8:cd:79:57,303058353,284,15555,303058069,303058353
24478,5,12,149,5745,-69,-97,28,72:d1:72:1d:22:a1,303072768,284,14131,303072484,303072768
24479,5,24,149,5745,-64,-97,33,,303074795,28,1999,303074767,303074795
24480,5,24,149,5745,-79,-97,18,,303074839,28,16,303074811,303074839
24481,5,24,149,5745,-78,-97,19,,303074947,28,80,303074919,303074947
24482,5,12,149,5745,-63,-97,34,a6:92:ad:b7:76:65,303076271,284,1040,303075987,303076271
24483,5,12,149,5745,-92,-97,5,42:d2:d9:2b:ac:61,303082505,288,5946,303082217,303082505
24484,5,12,149,5745,-69,-97,28,6a:1e:a4:f8:14:49,303083995,284,1206,303083711,303083995
24485,5,6,149,5745,-87,-97,10,54:e4:3a:ec:fb:65,303088259,360,3904,303087899,303088259
24486,5,12,149,5745,-72,-97,25,f2:da:61:dd:98:c5,303088692,268,165,303088424,303088692
24487,5,12,149,5745,-50,-97,47,4a:86:35:36:74:b8,303089887,268,927,303089619,303089887
24488,5,12,149,5745,-68,-97,29,56:68:e2:c2:8d:d5,303101936,280,11769,303101656,303101936
24489,5,12,149,5745,-70,-97,27,2a:07:ef:54:b5:55,303107643,244,5463,303107399,303107643
24490,5,12,149,5745,-86,-97,11,7e:05:42:11:d2:ec,303108486,244,599,303108242,303108486
24491,5,12,149,5745,-52,-97,45,3e:d1:9b:c7:a4:de,303123335,544,14305,303122791,303123335
24492,5,12,149,5745,-52,-97,45,3e:d1:9b:c7:a4:de,303123896,272,289,303123624,303123896
24493,5,12,149,5745,-70,-97,27,2a:07:ef:54:b5:55,303124240,440,-96,303123800,303124240
24494,5,24,149,5745,-78,-97,19,,303124759,32,487,303124727,303124759
24495,5,12,149,5745,-59,-97,38,b6:90:18:f6:b1:d4,303125203,268,176,303124935,303125203
24496,5,24,149,5745,-78,-97,19,,303125592,32,357,303125560,303125592
24497,5,24,149,5745,-78,-97,19,,303126038,28,418,303126010,303126038
24498,5,12,149,5745,-64,-97,33,f6:0a:5c:59:72:df,303127831,280,1513,303127551,303127831
24499,5,12,149,5745,-69,-97,28,56:68:e2:c2:8d:d5,303129567,476,1260,303129091,303129567
24500,5,12,149,5745,-51,-97,46,4a:86:35:36:74:b8,303130934,268,1099,303130666,303130934
24501,5,24,149,5745,-80,-97,17,,303131389,28,427,303131361,303131389
24502,5,24,149,5745,-79,-97,18,,303131433,28,16,303131405,303131433
24503,5,24,149,5745,-78,-97,19,,303131542,32,77,303131510,303131542
24504,5,12,149,5745,-69,-97,28,6a:1e:a4:f8:14:49,303132958,480,936,303132478,303132958
24505,5,12,149,5745,-67,-97,30,5e:29:73:5b:30:00,303133517,540,19,303132977,303133517
24506,5,12,149,5745,-60,-97,37,b6:90:18:f6:b1:d4,303134739,268,954,303134471,303134739
24507,5,24,149,5745,-80,-97,17,,303135077,28,310,303135049,303135077
24508,5,24,149,5745,-78,-97,19,,303135122,28,17,303135094,303135122
24509,5,24,149,5745,-80,-97,17,,303135336,28,186,303135308,303135336
24510,5,24,149,5745,-79,-97,18,,303135380,28,16,303135352,303135380
24511,5,24,149,5745,-80,-97,17,,303135658,28,250,303135630,303135658
24512,5,24,149,5745,-78,-97,19,,303135702,28,16,303135674,303135702
24513,5,24,149,5745,-79,-97,18,,303135823,32,89,303135791,303135823
24514,5,12,149,5745,-71,-97,26,f2:da:61:dd:98:c5,303136035,268,-56,303135767,303136035
24515,5,24,149,5745,-81,-97,16,,303136355,28,292,303136327,303136355
24516,5,24,149,5745,-79,-97,18,,303136400,28,17,303136372,303136400
24517,5,24,149,5745,-79,-97,18,,303136512,32,80,303136480,303136512
24518,5,12,149,5745,-89,-97,8,de:be:a8:cd:79:57,303136830,480,-162,303136350,303136830
24519,5,12,149,5745,-91,-97,6,3a:90:78:0e:4f:1f,303137996,256,910,303137740,303137996
24520,5,24,149,5745,-80,-97,17,,303139794,28,1770,303139766,303139794
24521,5,24,149,5745,-78,-97,19,,303139838,28,16,303139810,303139838
24522,5,24,149,5745,-79,-97,18,,303139946,32,76,303139914,303139946
24523,5,24,149,5745,-79,-97,18,,303140061,32,83,303140029,303140061
24524,5,12,149,5745,-71,-97,26,6a:1e:a4:f8:14:49,303140838,284,493,303140554,303140838
24525,5,12,149,5745,-62,-97,35,a6:92:ad:b7:76:65,303141246,484,-76,303140762,303141246
24526,5,12,149,5745,-67,-97,30,5e:29:73:5b:30:00,303141764,272,246,303141492,303141764
24527,5,12,149,5745,-69,-97,28,72:d1:72:1d:22:a1,303142114,480,-130,303141634,303142114
24528,5,12,149,5745,-72,-97,25,f2:da:61:dd:98:c5,303142781,268,399,303142513,303142781
24529,5,12,149,5745,-64,-97,33,22:ec:75:a8:8a:31,303143974,516,677,303143458,303143974
24530,5,12,149,5745,-87,-97,10,7e:05:42:11:d2:ec,303144596,440,182,303144156,303144596
24531,5,12,149,5745,-64,-97,33,f6:0a:5c:59:72:df,303145169,476,97,303144693,303145169
24532,5,24,149,5745,-79,-97,18,,303145831,28,634,303145803,303145831
24533,5,24,149,5745,-80,-97,17,,303145876,28,17,303145848,303145876
24534,5,24,149,5745,-81,-97,16,,303145984,32,76,303145952,303145984
24535,5,24,149,5745,-80,-97,17,,303147268,28,1256,303147240,303147268
24536,5,24,149,5745,-79,-97,18,,303147312,28,16,303147284,303147312
24537,5,24,149,5745,-79,-97,18,,303147449,32,105,303147417,303147449
24538,5,12,149,5745,-86,-97,11,9a:24:38:da:96:bb,303147981,272,260,303147709,303147981
24539,5,24,149,5745,-79,-97,18,,303149970,28,1961,303149942,303149970
24540,5,24,149,5745,-81,-97,16,,303150014,28,16,303149986,303150014
24541,5,24,149,5745,-81,-97,16,,303150122,32,76,303150090,303150122
24542,5,24,149,5745,-78,-97,19,,303150594,28,444,303150566,303150594
24543,5,24,149,5745,-80,-97,17,,303150638,28,16,303150610,303150638
24544,5,24,149,5745,-80,-97,17,,303150746,32,76,303150714,303150746
24545,5,12,149,5745,-92,-97,5,4e:72:d0:f1:a2:44,303151428,468,214,303150960,303151428
24546,5,12,149,5745,-90,-97,7,3a:90:78:0e:4f:1f,303151939,452,59,303151487,303151939
24547,5,24,149,5745,-80,-97,17,,303152516,28,549,303152488,303152516
24548,5,24,149,5745,-79,-97,18,,303152560,28,16,303152532,303152560
24549,5,24,149,5745,-79,-97,18,,303152668,32,76,303152636,303152668
24550,5,12,149,5745,-64,-97,33,22:ec:75:a8:8a:31,303155327,244,2415,303155083,303155327
24551,5,24,149,5745,-80,-97,17,,303157657,28,2302,303157629,303157657
24552,5,24,149,5745,-79,-97,18,,303157701,28,16,303157673,303157701
24553,5,24,149,5745,-78,-97,19,,303157810,32,77,303157778,303157810
24554,5,12,149,5745,-89,-97,8,de:be:a8:cd:79:57,303158785,284,691,303158501,303158785
24555,5,24,149,5745,-80,-97,17,,303160964,28,2151,303160936,303160964
24556,5,24,149,5745,-79,-97,18,,303161008,28,16,303160980,303161008
24557,5,24,149,5745,-79,-97,18,,303161116,32,76,303161084,303161116
24558,5,24,149,5745,-78,-97,19,,303161177,28,33,303161149,303161177
24559,5,24,149,5745,-80,-97,17,,303161221,28,16,303161193,303161221
24560,5,24,149,5745,-80,-97,17,,303161329,32,76,303161297,303161329
24561,5,24,149,5745,-78,-97,19,,303161899,28,542,303161871,303161899
24562,5,24,149,5745,-80,-97,17,,303161943,28,16,303161915,303161943
24563,5,24,149,5745,-79,-97,18,,303162051,32,76,303162019,303162051
24564,5,24,149,5745,-79,-97,18,,303166176,28,4097,303166148,303166176
24565,5,24,149,5745,-80,-97,17,,303166220,28,16,303166192,303166220
24566,5,24,149,5745,-79,-97,18,,303166349,32,97,303166317,303166349
24567,5,24,149,5745,-79,-97,18,,303166624,28,247,303166596,303166624
24568,5,24,149,5745,-79,-97,18,,303166668,28,16,303166640,303166668
24569,5,24,149,5745,-80,-97,17,,303166946,32,246,303166914,303166946
24570,5,24,149,5745,-79,-97,18,,303167369,28,395,303167341,303167369
24571,5,24,149,5745,-80,-97,17,,303167413,28,16,303167385,303167413
24572,5,24,149,5745,-80,-97,17,,303167542,32,97,303167510,303167542
24573,5,24,149,5745,-79,-97,18,,303167618,28,48,303167590,303167618
24574,5,24,149,5745,-80,-97,17,,303167662,28,16,303167634,303167662
24575,5,24,149,5745,-79,-97,18,,303167770,32,76,303167738,303167770
24576,5,24,149,5745,-79,-97,18,,303167863,28,65,303167835,303167863
24577,5,24,149,5745,-80,-97,17,,303167907,28,16,303167879,303167907
24578,5,24,149,5745,-80,-97,17,,303168062,32,123,303168030,303168062
24579,5,24,149,5745,-79,-97,18,,303168155,28,65,303168127,303168155
24580,5,24,149,5745,-80,-97,17,,303168199,28,16,303168171,303168199
24581,5,24,149,5745,-80,-97,17,,303168307,32,76,303168275,303168307
24582,5,24,149,5745,-79,-97,18,,303170027,28,1692,303169999,303170027
24583,5,24,149,5745,-80,-97,17,,303170071,28,16,303170043,303170071
24584,5,24,149,5745,-80,-97,17,,303170200,32,97,303170168,303170200
24585,5,24,149,5745,-79,-97,18,,303170422,28,194,303170394,303170422
24586,5,24,149,5745,-80,-97,17,,303170466,28,16,303170438,303170466
24587,5,24,149,5745,-79,-97,18,,303170697,32,199,303170665,303170697
24588,5,24,149,5745,-79,-97,18,,303171554,28,829,303171526,303171554
24589,5,24,149,5745,-79,-97,18,,303171598,28,16,303171570,303171598
24590,5,24,149,5745,-79,-97,18,,303171706,32,76,303171674,303171706
24591,5,24,149,5745,-79,-97,18,,303171765,28,31,303171737,303171765
24592,5,24,149,5745,-80,-97,17,,303171809,28,16,303171781,303171809
24593,5,24,149,5745,-80,-97,17,,303171938,32,97,303171906,303171938
24594,5,24,149,5745,-80,-97,17,,303172060,28,94,303172032,303172060
24595,5,24,149,5745,-79,-97,18,,303172104,28,16,303172076,303172104
24596,5,24,149,5745,-79,-97,18,,303172216,32,80,303172184,303172216
24597,5,24,149,5745,-79,-97,18,,303172309,28,65,303172281,303172309
24598,5,24,149,5745,-80,-97,17,,303172353,28,16,303172325,303172353
24599,5,24,149,5745,-80,-97,17,,303172508,32,123,303172476,303172508
24600,5,24,149,5745,-79,-97,18,,303173598,28,1062,303173570,303173598
24601,5,24,149,5745,-80,-97,17,,303173643,28,17,303173615,303173643
24602,5,24,149,5745,-80,-97,17,,303173772,32,97,303173740,303173772
24603,5,12,149,5745,-61,-97,36,a6:92:ad:b7:76:65,303173883,284,-173,303173599,303173883
24604,5,24,149,5745,-78,-97,19,,303174201,28,290,303174173,303174201
24605,5,24,149,5745,-79,-97,18,,303174246,28,17,303174218,303174246
24606,5,24,149,5745,-80,-97,17,,303174425,32,147,303174393,303174425
24607,5,24,149,5745,-80,-97,17,,303174548,32,91,303174516,303174548
24608,5,24,149,5745,-80,-97,17,,303174652,28,76,303174624,303174652
24609,5,24,149,5745,-79,-97,18,,303174696,28,16,303174668,303174696
24610,5,24,149,5745,-79,-97,18,,303174812,32,84,303174780,303174812
24611,5,24,149,5745,-79,-97,18,,303174927,32,83,303174895,303174927
24612,5,24,149,5745,-79,-97,18,,303175242,28,287,303175214,303175242
24613,5,24,149,5745,-80,-97,17,,303175286,28,16,303175258,303175286
24614,5,24,149,5745,-81,-97,16,,303175394,32,76,303175362,303175394
24615,5,12,149,5745,-68,-97,29,72:d1:72:1d:22:a1,303175478,284,-200,303175194,303175478
24616,5,24,149,5745,-79,-97,18,,303175805,28,299,303175777,303175805
24617,5,24,149,5745,-80,-97,17,,303175850,28,17,303175822,303175850
24618,5,24,149,5745,-80,-97,17,,303176029,32,147,303175997,303176029
24619,5,24,149,5745,-79,-97,18,,303176691,28,634,303176663,303176691
24620,5,24,149,5745,-80,-97,17,,303176735,28,16,303176707,303176735
24621,5,24,149,5745,-81,-97,16,,303176865,32,98,303176833,303176865
24622,5,24,149,5745,-79,-97,18,,303177032,28,139,303177004,303177032
24623,5,24,149,5745,-80,-97,17,,303177076,28,16,303177048,303177076
24624,5,24,149,5745,-80,-97,17,,303177231,32,123,303177199,303177231
24625,5,24,149,5745,-79,-97,18,,303178088,28,829,303178060,303178088
24626,5,24,149,5745,-80,-97,17,,303178133,28,17,303178105,303178133
24627,5,24,149,5745,-80,-97,17,,303178262,32,97,303178230,303178262
24628,5,24,149,5745,-80,-97,17,,303178401,28,111,303178373,303178401
24629,5,24,149,5745,-79,-97,18,,303178445,28,16,303178417,303178445
24630,5,24,149,5745,-79,-97,18,,303178558,32,81,303178526,303178558
24631,5,24,149,5745,-79,-97,18,,303178669,28,83,303178641,303178669
24632,5,24,149,5745,-80,-97,17,,303178713,28,16,303178685,303178713
24633,5,24,149,5745,-80,-97,17,,303178893,32,148,303178861,303178893
24634,5,24,149,5745,-79,-97,18,,303180842,28,1921,303180814,303180842
24635,5,24,149,5745,-79,-97,18,,303180886,28,16,303180858,303180886
24636,5,24,149,5745,-80,-97,17,,303181016,32,98,303180984,303181016
24637,5,24,149,5745,-79,-97,18,,303181187,28,143,303181159,303181187
24638,5,24,149,5745,-80,-97,17,,303181231,28,16,303181203,303181231
24639,5,24,149,5745,-80,-97,17,,303181386,32,123,303181354,303181386
24640,5,24,149,5745,-80,-97,17,,303181597,28,183,303181569,303181597
24641,5,24,149,5745,-79,-97,18,,303181641,28,16,303181613,303181641
24642,5,24,149,5745,-79,-97,18,,303181754,32,81,303181722,303181754
24643,5,24,149,5745,-80,-97,17,,303184041,28,2259,303184013,303184041
24644,5,24,149,5745,-79,-97,18,,303184086,28,17,303184058,303184086
24645,5,24,149,5745,-79,-97,18,,303184194,32,76,303184162,303184194
24646,5,24,149,5745,-79,-97,18,,303188608,28,4386,303188580,303188608
24647,5,24,149,5745,-80,-97,17,,303188652,28,16,303188624,303188652
24648,5,24,149,5745,-80,-97,17,,303188782,32,98,303188750,303188782
24649,5,12,149,5745,-54,-97,43,3e:d1:9b:c7:a4:de,303188848,544,-478,303188304,303188848
24650,5,12,149,5745,-70,-97,27,2a:07:ef:54:b5:55,303189463,440,175,303189023,303189463
24651,5,24,149,5745,-79,-97,18,,303190167,28,676,303190139,303190167
24652,5,24,149,5745,-80,-97,17,,303190211,28,16,303190183,303190211
24653,5,24,149,5745,-80,-97,17,,303190340,32,97,303190308,303190340
24654,5,24,149,5745,-79,-97,18,,303190508,28,140,303190480,303190508
24655,5,24,149,5745,-78,-97,19,,303190552,28,16,303190524,303190552
24656,5,24,149,5745,-79,-97,18,,303190706,32,122,303190674,303190706
24657,5,12,149,5745,-52,-97,45,4a:86:35:36:74:b8,303191034,268,60,303190766,303191034
24658,5,24,149,5745,-79,-97,18,,303191415,28,353,303191387,303191415
24659,5,24,149,5745,-78,-97,19,,303191459,28,16,303191431,303191459
24660,5,24,149,5745,-79,-97,18,,303191667,28,180,303191639,303191667
24661,5,24,149,5745,-80,-97,17,,303191712,28,17,303191684,303191712
24662,5,24,149,5745,-80,-97,17,,303191841,32,97,303191809,303191841
24663,5,24,149,5745,-79,-97,18,,303192016,28,147,303191988,303192016
24664,5,24,149,5745,-79,-97,18,,303192060,28,16,303192032,303192060
24665,5,24,149,5745,-79,-97,18,,303192169,32,77,303192137,303192169
24666,5,24,149,5745,-79,-97,18,,303192604,28,407,303192576,303192604
24667,5,24,149,5745,-80,-97,17,,303192649,28,17,303192621,303192649
24668,5,24,149,5745,-80,-97,17,,303192828,32,147,303192796,303192828
24669,5,24,149,5745,-80,-97,17,,303193016,28,160,303192988,303193016
24670,5,24,149,5745,-79,-97,18,,303193060,28,16,303193032,303193060
24671,5,24,149,5745,-80,-97,17,,303193190,32,98,303193158,303193190
24672,5,24,149,5745,-79,-97,18,,303194218,28,1000,303194190,303194218
24673,5,24,149,5745,-80,-97,17,,303194263,28,17,303194235,303194263
24674,5,24,149,5745,-80,-97,17,,303194392,32,97,303194360,303194392
24675,5,24,149,5745,-79,-97,18,,303194513,28,93,303194485,303194513
24676,5,24,149,5745,-79,-97,18,,303194557,28,16,303194529,303194557
24677,5,24,149,5745,-79,-97,18,,303194665,32,76,303194633,303194665
24678,5,24,149,5745,-79,-97,18,,303194731,28,38,303194703,303194731
24679,5,24,149,5745,-80,-97,17,,303194776,28,17,303194748,303194776
24680,5,24,149,5745,-80,-97,17,,303194959,32,151,303194927,303194959
24681,5,12,149,5745,-69,-97,28,56:68:e2:c2:8d:d5,303195079,476,-356,303194603,303195079
24682,5,24,149,5745,-79,-97,18,,303195616,28,509,303195588,303195616
24683,5,24,149,5745,-80,-97,17,,303195660,28,16,303195632,303195660
24684,5,24,149,5745,-80,-97,17,,303195866,32,174,303195834,303195866
24685,5,24,149,5745,-80,-97,17,,303195987,28,93,303195959,303195987
24686,5,24,149,5745,-79,-97,18,,303196031,28,16,303196003,303196031
24687,5,24,149,5745,-80,-97,17,,303196139,32,76,303196107,303196139
24688,5,24,149,5745,-79,-97,18,,303196200,28,33,303196172,303196200
24689,5,24,149,5745,-80,-97,17,,303196244,28,16,303196216,303196244
24690,5,24,149,5745,-80,-97,17,,303196373,32,97,303196341,303196373
24691,5,24,149,5745,-79,-97,18,,303196572,28,171,303196544,303196572
24692,5,24,149,5745,-81,-97,16,,303196617,28,17,303196589,303196617
24693,5,24,149,5745,-79,-97,18,,303196796,32,147,303196764,303196796
24694,5,12,149,5745,-52,-97,45,4a:86:35:36:74:b8,303196907,268,-157,303196639,303196907
24695,5,24,149,5745,-79,-97,18,,303197383,28,448,303197355,303197383
24696,5,24,149,5745,-80,-97,17,,303197427,28,16,303197399,303197427
24697,5,24,149,5745,-79,-97,18,,303197758,28,303,303197730,303197758
24698,5,24,149,5745,-80,-97,17,,303197802,28,16,303197774,303197802
24699,5,24,149,5745,-80,-97,17,,303197931,32,97,303197899,303197931
24700,5,12,149,5745,-59,-97,38,b6:90:18:f6:b1:d4,303197998,268,-201,303197730,303197998
24701,5,12,149,5745,-67,-97,30,5e:29:73:5b:30:00,303198671,540,133,303198131,303198671
24702,5,24,149,5745,-79,-97,18,,303199254,28,555,303199226,303199254
24703,5,24,149,5745,-80,-97,17,,303199298,28,16,303199270,303199298
24704,5,24,149,5745,-80,-97,17,,303199525,32,195,303199493,303199525
24705,5,24,149,5745,-80,-97,17,,303199673,28,120,303199645,303199673
24706,5,24,149,5745,-80,-97,17,,303199717,28,16,303199689,303199717
24707,5,24,149,5745,-80,-97,17,,303199825,32,76,303199793,303199825
24708,5,24,149,5745,-80,-97,17,,303200481,28,628,303200453,303200481
24709,5,24,149,5745,-79,-97,18,,303200525,28,16,303200497,303200525
24710,5,24,149,5745,-79,-97,18,,303200633,32,76,303200601,303200633
24711,5,24,149,5745,-79,-97,18,,303201098,28,437,303201070,303201098
24712,5,24,149,5745,-80,-97,17,,303201143,28,17,303201115,303201143
24713,5,12,149,5745,-72,-97,25,f2:da:61:dd:98:c5,303201258,268,-153,303200990,303201258
24714,5,24,149,5745,-79,-97,18,,303201636,28,350,303201608,303201636
24715,5,24,149,5745,-79,-97,18,,303201680,28,16,303201652,303201680
24716,5,24,149,5745,-80,-97,17,,303201806,32,94,303201774,303201806
24717,5,24,149,5745,-79,-97,18,,303201936,28,102,303201908,303201936
24718,5,24,149,5745,-79,-97,18,,303201980,28,16,303201952,303201980
24719,5,24,149,5745,-80,-97,17,,303202093,32,81,303202061,303202093
24720,5,12,149,5745,-88,-97,9,de:be:a8:cd:79:57,303202186,480,-387,303201706,303202186
24721,5,24,149,5745,-80,-97,17,,303202826,28,612,303202798,303202826
24722,5,24,149,5745,-79,-97,18,,303203141,28,287,303203113,303203141
24723,5,24,149,5745,-80,-97,17,,303203186,28,17,303203158,303203186
24724,5,24,149,5745,-80,-97,17,,303203294,32,76,303203262,303203294
24725,5,24,149,5745,-80,-97,17,,303203396,28,74,303203368,303203396
24726,5,24,149,5745,-80,-97,17,,303203440,28,16,303203412,303203440
24727,5,24,149,5745,-80,-97,17,,303203556,32,84,303203524,303203556
24728,5,24,149,5745,-80,-97,17,,303203735,28,151,303203707,303203735
24729,5,24,149,5745,-79,-97,18,,303203779,28,16,303203751,303203779
24730,5,24,149,5745,-79,-97,18,,303203888,32,77,303203856,303203888
24731,5,24,149,5745,-80,-97,17,,303205021,28,1105,303204993,303205021
24732,5,24,149,5745,-79,-97,18,,303205065,28,16,303205037,303205065
24733,5,24,149,5745,-79,-97,18,,303205174,32,77,303205142,303205174
24734,5,12,149,5745,-71,-97,26,2a:07:ef:54:b5:55,303205249,244,-169,303205005,303205249
24735,5,12,149,5745,-67,-97,30,72:d1:72:1d:22:a1,303205986,480,257,303205506,303205986
24736,5,12,149,5745,-61,-97,36,a6:92:ad:b7:76:65,303206500,484,30,303206016,303206500
24737,5,12,149,5745,-69,-97,28,56:68:e2:c2:8d:d5,303207054,280,274,303206774,303207054
24738,5,12,149,5745,-87,-97,10,7e:05:42:11:d2:ec,303208241,244,943,303207997,303208241
24739,5,12,149,5745,-90,-97,7,4e:72:d0:f1:a2:44,303208610,272,97,303208338,303208610
24740,5,12,149,5745,-65,-97,32,22:ec:75:a8:8a:31,303209049,516,-77,303208533,303209049
24741,5,12,149,5745,-66,-97,31,f6:0a:5c:59:72:df,303209608,476,83,303209132,303209608
24742,5,24,149,5745,-80,-97,17,,303210252,28,616,303210224,303210252
24743,5,24,149,5745,-80,-97,17,,303210297,28,17,303210269,303210297
24744,5,24,149,5745,-80,-97,17,,303210405,32,76,303210373,303210405
24745,5,24,149,5745,-80,-97,17,,303210724,28,291,303210696,303210724
24746,5,24,149,5745,-80,-97,17,,303210768,28,16,303210740,303210768
24747,5,24,149,5745,-80,-97,17,,303210876,32,76,303210844,303210876
24748,5,12,149,5745,-91,-97,6,3a:90:78:0e:4f:1f,303211294,452,-34,303210842,303211294
24749,5,12,149,5745,-74,-97,23,d2:00:04:7e:2c:ab,303211861,380,187,303211481,303211861
24750,5,12,149,5745,-87,-97,10,7e:05:42:11:d2:ec,303212835,440,534,303212395,303212835
24751,5,12,149,5745,-88,-97,9,9a:24:38:da:96:bb,303214346,824,687,303213522,303214346
24752,5,12,149,5745,-89,-97,8,4e:72:d0:f1:a2:44,303217020,468,2206,303216552,303217020
24753,5,24,149,5745,-80,-97,17,,303218620,28,1572,303218592,303218620
24754,5,24,149,5745,-79,-97,18,,303218664,28,16,303218636,303218664
24755,5,24,149,5745,-79,-97,18,,303218801,32,105,303218769,303218801
24756,5,24,149,5745,-79,-97,18,,303221127,28,2298,303221099,303221127
24757,5,24,149,5745,-80,-97,17,,303221172,28,17,303221144,303221172
24758,5,24,149,5745,-80,-97,17,,303221280,32,76,303221248,303221280
24759,5,24,149,5745,-80,-97,17,,303224140,28,2832,303224112,303224140
24760,5,24,149,5745,-80,-97,17,,303224184,28,16,303224156,303224184
24761,5,24,149,5745,-81,-97,16,,303224292,32,76,303224260,303224292
24762,5,24,149,5745,-80,-97,17,,303232389,28,8069,303232361,303232389
24763,5,24,149,5745,-80,-97,17,,303232433,28,16,303232405,303232433
24764,5,24,149,5745,-81,-97,16,,303232541,32,76,303232509,303232541
24765,5,24,149,5745,-79,-97,18,,303233052,28,483,303233024,303233052
24766,5,24,149,5745,-80,-97,17,,303233096,28,16,303233068,303233096
24767,5,24,149,5745,-80,-97,17,,303233203,32,75,303233171,303233203
24768,5,12,149,5745,-56,-97,41,3e:d1:9b:c7:a4:de,303239138,272,5663,303238866,303239138
24769,5,12,149,5745,-59,-97,38,b6:90:18:f6:b1:d4,303239679,268,273,303239411,303239679
24770,5,24,149,5745,-80,-97,17,,303240071,28,364,303240043,303240071
24771,5,24,149,5745,-80,-97,17,,303240116,28,17,303240088,303240116
24772,5,24,149,5745,-80,-97,17,,303240224,32,76,303240192,303240224
24773,5,12,149,5745,-65,-97,32,5e:29:73:5b:30:00,303240908,272,412,303240636,303240908
24774,5,12,149,5745,-64,-97,33,f6:0a:5c:59:72:df,303257647,280,16459,303257367,303257647
24775,5,12,149,5745,-87,-97,10,9a:24:38:da:96:bb,303260939,272,3020,303260667,303260939
24776,5,12,149,5745,-53,-97,44,4a:86:35:36:74:b8,303263145,268,1938,303262877,303263145
24777,5,12,149,5745,-64,-97,33,22:ec:75:a8:8a:31,303264126,244,737,303263882,303264126
24778,5,12,149,5745,-70,-97,27,6a:1e:a4:f8:14:49,303269115,284,4705,303268831,303269115
24779,5,12,149,5745,-72,-97,25,f2:da:61:dd:98:c5,303271693,268,2310,303271425,303271693
24780,5,12,149,5745,-89,-97,8,de:be:a8:cd:79:57,303279855,284,7878,303279571,303279855
24781,5,6,149,5745,-90,-97,7,54:e4:3a:ec:fb:65,303292917,360,12702,303292557,303292917
24782,5,24,149,5745,-80,-97,17,,303296022,28,3077,303295994,303296022
24783,5,24,149,5745,-80,-97,17,,303296066,28,16,303296038,303296066
24784,5,24,149,5745,-80,-97,17,,303296184,32,86,303296152,303296184
24785,5,24,149,5745,-80,-97,17,,303296303,32,87,303296271,303296303
24786,5,24,149,5745,-80,-97,17,,303296476,28,145,303296448,303296476
24787,5,24,149,5745,-80,-97,17,,303296520,28,16,303296492,303296520
24788,5,24,149,5745,-80,-97,17,,303296628,32,76,303296596,303296628
24789,5,24,149,5745,-81,-97,16,,303296758,32,98,303296726,303296758
24790,5,12,149,5745,-67,-97,30,72:d1:72:1d:22:a1,303298009,284,967,303297725,303298009
24791,5,24,149,5745,-81,-97,16,,303298390,28,353,303298362,303298390
24792,5,24,149,5745,-80,-97,17,,303298434,28,16,303298406,303298434
24793,5,24,149,5745,-80,-97,17,,303298564,32,98,303298532,303298564
24794,5,24,149,5745,-81,-97,16,,303298654,28,62,303298626,303298654
24795,5,24,149,5745,-80,-97,17,,303298698,28,16,303298670,303298698
24796,5,24,149,5745,-80,-97,17,,303298806,32,76,303298774,303298806
24797,5,24,149,5745,-80,-97,17,,303298872,28,38,303298844,303298872
24798,5,24,149,5745,-80,-97,17,,303298917,28,17,303298889,303298917
24799,5,24,149,5745,-80,-97,17,,303299230,32,281,303299198,303299230
24800,5,24,149,5745,-80,-97,17,,303300104,28,846,303300076,303300104
24801,5,24,149,5745,-80,-97,17,,303300148,28,16,303300120,303300148
24802,5,24,149,5745,-80,-97,17,,303300277,32,97,303300245,303300277
24803,5,24,149,5745,-81,-97,16,,303300463,28,158,303300435,303300463
24804,5,24,149,5745,-80,-97,17,,303300507,28,16,303300479,303300507
24805,5,24,149,5745,-80,-97,17,,303300677,32,138,303300645,303300677
24806,5,24,149,5745,-80,-97,17,,303300918,32,209,303300886,303300918
24807,5,24,149,5745,-81,-97,16,,303301012,28,66,303300984,303301012
24808,5,24,149,5745,-81,-97,16,,303301056,28,16,303301028,303301056
24809,5,24,149,5745,-81,-97,16,,303301165,32,77,303301133,303301165
24810,5,12,149,5745,-62,-97,35,a6:92:ad:b7:76:65,303301285,284,-164,303301001,303301285
24811,5,24,149,5745,-80,-97,17,,303302244,28,931,303302216,303302244
24812,5,24,149,5745,-80,-97,17,,303302288,28,16,303302260,303302288
24813,5,24,149,5745,-80,-97,17,,303302418,32,98,303302386,303302418
24814,5,24,149,5745,-81,-97,16,,303302574,28,128,303302546,303302574
24815,5,24,149,5745,-80,-97,17,,303302618,28,16,303302590,303302618
24816,5,24,149,5745,-80,-97,17,,303302737,32,87,303302705,303302737
24817,5,24,149,5745,-80,-97,17,,303302856,32,87,303302824,303302856
24818,5,24,149,5745,-81,-97,16,,303303450,28,566,303303422,303303450
24819,5,24,149,5745,-80,-97,17,,303303494,28,16,303303466,303303494
24820,5,24,149,5745,-81,-97,16,,303303607,32,81,303303575,303303607
24821,5,24,149,5745,-81,-97,16,,303305255,28,1620,303305227,303305255
24822,5,24,149,5745,-80,-97,17,,303305499,28,216,303305471,303305499
24823,5,24,149,5745,-80,-97,17,,303305993,28,466,303305965,303305993
24824,5,24,149,5745,-80,-97,17,,303306038,28,17,303306010,303306038
24825,5,24,149,5745,-80,-97,17,,303306150,32,80,303306118,303306150
24826,5,12,149,5745,-53,-97,44,4a:86:35:36:74:b8,303306225,268,-193,303305957,303306225
24827,5,12,149,5745,-92,-97,5,42:d2:d9:2b:ac:61,303307990,288,1477,303307702,303307990
24828,5,24,149,5745,-80,-97,17,,303311180,28,3162,303311152,303311180
24829,5,24,149,5745,-81,-97,16,,303311224,28,16,303311196,303311224
24830,5,24,149,5745,-81,-97,16,,303311343,32,87,303311311,303311343
24831,5,24,149,5745,-80,-97,17,,303311465,32,90,303311433,303311465
24832,5,24,149,5745,-81,-97,16,,303311667,28,174,303311639,303311667
24833,5,24,149,5745,-80,-97,17,,303311711,28,16,303311683,303311711
24834,5,24,149,5745,-81,-97,16,,303311916,32,173,303311884,303311916
24835,5,24,149,5745,-80,-97,17,,303312145,28,201,303312117,303312145
24836,5,24,149,5745,-80,-97,17,,303312189,28,16,303312161,303312189
24837,5,24,149,5745,-80,-97,17,,303312394,32,173,303312362,303312394
24838,5,24,149,5745,-80,-97,17,,303312560,28,138,303312532,303312560
24839,5,24,149,5745,-81,-97,16,,303312604,28,16,303312576,303312604
24840,5,24,149,5745,-80,-97,17,,303312734,32,98,303312702,303312734
24841,5,24,149,5745,-80,-97,17,,303313531,28,769,303313503,303313531
24842,5,24,149,5745,-81,-97,16,,303313575,28,16,303313547,303313575
24843,5,24,149,5745,-81,-97,16,,303313704,32,97,303313672,303313704
24844,5,24,149,5745,-80,-97,17,,303313923,28,191,303313895,303313923
24845,5,24,149,5745,-80,-97,17,,303313967,28,16,303313939,303313967
24846,5,24,149,5745,-81,-97,16,,303314122,32,123,303314090,303314122
24847,5,24,149,5745,-80,-97,17,,303314241,32,87,303314209,303314241
24848,5,12,149,5745,-90,-97,7,4e:72:d0:f1:a2:44,303314812,272,299,303314540,303314812
24849,5,24,149,5745,-81,-97,16,,303315416,28,576,303315388,303315416
24850,5,24,149,5745,-79,-97,18,,303315459,28,15,303315431,303315459
24851,5,24,149,5745,-80,-97,17,,303315572,32,81,303315540,303315572
24852,5,24,149,5745,-79,-97,18,,303319764,28,4164,303319736,303319764
24853,5,24,149,5745,-80,-97,17,,303319808,28,16,303319780,303319808
24854,5,24,149,5745,-80,-97,17,,303319916,32,76,303319884,303319916
24855,5,24,149,5745,-81,-97,16,,303320001,28,57,303319973,303320001
24856,5,24,149,5745,-80,-97,17,,303320045,28,16,303320017,303320045
24857,5,24,149,5745,-80,-97,17,,303320153,32,76,303320121,303320153
24858,5,24,149,5745,-80,-97,17,,303323983,28,3802,303323955,303323983
24859,5,24,149,5745,-80,-97,17,,303324028,28,17,303324000,303324028
24860,5,24,149,5745,-80,-97,17,,303324146,32,86,303324114,303324146
24861,5,24,149,5745,-81,-97,16,,303324269,32,91,303324237,303324269
24862,5,24,149,5745,-80,-97,17,,303324483,28,186,303324455,303324483
24863,5,24,149,5745,-81,-97,16,,303324528,28,17,303324500,303324528
24864,5,24,149,5745,-81,-97,16,,303324758,32,198,303324726,303324758
24865,5,24,149,5745,-80,-97,17,,303325284,28,498,303325256,303325284
24866,5,24,149,5745,-81,-97,16,,303325328,28,16,303325300,303325328
24867,5,24,149,5745,-81,-97,16,,303325458,32,98,303325426,303325458
24868,5,24,149,5745,-79,-97,18,,303325675,28,189,303325647,303325675
24869,5,24,149,5745,-80,-97,17,,303325719,28,16,303325691,303325719
24870,5,24,149,5745,-82,-97,15,,303325949,32,198,303325917,303325949
24871,5,24,149,5745,-79,-97,18,,303326393,28,416,303326365,303326393
24872,5,24,149,5745,-81,-97,16,,303326437,28,16,303326409,303326437
24873,5,24,149,5745,-81,-97,16,,303326567,32,98,303326535,303326567
24874,5,24,149,5745,-79,-97,18,,303326783,28,188,303326755,303326783
24875,5,24,149,5745,-81,-97,16,,303326828,28,17,303326800,303326828
24876,5,24,149,5745,-80,-97,17,,303327058,32,198,303327026,303327058
24877,5,12,149,5745,-54,-97,43,4a:86:35:36:74:b8,303327574,268,248,303327306,303327574
24878,5,24,149,5745,-80,-97,17,,303327903,28,301,303327875,303327903
24879,5,24,149,5745,-80,-97,17,,303327947,28,16,303327919,303327947
24880,5,24,149,5745,-81,-97,16,,303328077,32,98,303328045,303328077
24881,5,12,149,5745,-69,-97,28,56:68:e2:c2:8d:d5,303328170,280,-187,303327890,303328170
24882,5,24,149,5745,-80,-97,17,,303328484,28,286,303328456,303328484
24883,5,24,149,5745,-81,-97,16,,303328528,28,16,303328500,303328528
24884,5,24,149,5745,-81,-97,16,,303328759,32,199,303328727,303328759
24885,5,24,149,5745,-80,-97,17,,303328925,28,138,303328897,303328925
24886,5,24,149,5745,-79,-97,18,,303328969,28,16,303328941,303328969
24887,5,24,149,5745,-80,-97,17,,303329081,32,80,303329049,303329081
24888,5,24,149,5745,-79,-97,18,,303329175,28,66,303329147,303329175
24889,5,24,149,5745,-80,-97,17,,303329218,28,15,303329190,303329218
24890,5,24,149,5745,-81,-97,16,,303329348,32,98,303329316,303329348
24891,5,24,149,5745,-80,-97,17,,303329536,28,160,303329508,303329536
24892,5,24,149,5745,-81,-97,16,,303329580,28,16,303329552,303329580
24893,5,24,149,5745,-81,-97,16,,303329692,32,80,303329660,303329692
24894,5,12,149,5745,-87,-97,10,7e:05:42:11:d2:ec,303330080,244,144,303329836,303330080
24895,5,24,149,5745,-81,-97,16,,303331024,28,916,303330996,303331024
24896,5,24,149,5745,-80,-97,17,,303331068,28,16,303331040,303331068
24897,5,24,149,5745,-80,-97,17,,303331176,32,76,303331144,303331176
24898,5,24,149,5745,-81,-97,16,,303332663,28,1459,303332635,303332663
24899,5,24,149,5745,-80,-97,17,,303332707,28,16,303332679,303332707
24900,5,24,149,5745,-79,-97,18,,303332820,32,81,303332788,303332820
24901,5,24,149,5745,-81,-97,16,,303337679,28,4831,303337651,303337679
24902,5,24,149,5745,-80,-97,17,,303337723,28,16,303337695,303337723
24903,5,24,149,5745,-79,-97,18,,303337831,32,76,303337799,303337831
24904,5,12,149,5745,-53,-97,44,3e:d1:9b:c7:a4:de,303338541,272,438,303338269,303338541
24905,5,24,149,5745,-81,-97,16,,303338910,28,341,303338882,303338910
24906,5,24,149,5745,-79,-97,18,,303338954,28,16,303338926,303338954
24907,5,24,149,5745,-80,-97,17,,303339066,32,80,303339034,303339066
24908,5,24,149,5745,-79,-97,18,,303340258,28,1164,303340230,303340258
24909,5,24,149,5745,-81,-97,16,,303340302,28,16,303340274,303340302
24910,5,24,149,5745,-81,-97,16,,303340410,32,76,303340378,303340410
24911,5,24,149,5745,-81,-97,16,,303346319,28,5881,303346291,303346319
24912,5,24,149,5745,-79,-97,18,,303346363,28,16,303346335,303346363
24913,5,24,149,5745,-79,-97,18,,303346496,32,101,303346464,303346496
24914,5,24,149,5745,-80,-97,17,,303348309,28,1785,303348281,303348309
24915,5,24,149,5745,-79,-97,18,,303348353,28,16,303348325,303348353
24916,5,24,149,5745,-79,-97,18,,303348462,32,77,303348430,303348462
24917,5,12,149,5745,-65,-97,32,5e:29:73:5b:30:00,303348574,272,-160,303348302,303348574
24918,5,24,149,5745,-79,-97,18,,303353873,28,5271,303353845,303353873
24919,5,24,149,5745,-81,-97,16,,303353917,28,16,303353889,303353917
24920,5,24,149,5745,-81,-97,16,,303354029,32,80,303353997,303354029
24921,5,24,149,5745,-81,-97,16,,303357085,28,3028,303357057,303357085
24922,5,24,149,5745,-79,-97,18,,303357129,28,16,303357101,303357129
24923,5,24,149,5745,-79,-97,18,,303357237,32,76,303357205,303357237
24924,5,24,149,5745,-78,-97,19,,303360165,28,2900,303360137,303360165
24925,5,24,149,5745,-81,-97,16,,303360209,28,16,303360181,303360209
24926,5,24,149,5745,-81,-97,16,,303360317,32,76,303360285,303360317
24927,5,24,149,5745,-78,-97,19,,303360899,28,554,303360871,303360899
24928,5,24,149,5745,-81,-97,16,,303360943,28,16,303360915,303360943
24929,5,24,149,5745,-81,-97,16,,303361051,32,76,303361019,303361051
24930,5,24,149,5745,-79,-97,18,,303362909,28,1830,303362881,303362909
24931,5,24,149,5745,-81,-97,16,,303362954,28,17,303362926,303362954
24932,5,24,149,5745,-81,-97,16,,303363061,32,75,303363029,303363061
24933,5,24,149,5745,-79,-97,18,,303364106,28,1017,303364078,303364106
24934,5,24,149,5745,-81,-97,16,,303364151,28,17,303364123,303364151
24935,5,24,149,5745,-81,-97,16,,303364270,32,87,303364238,303364270
24936,5,24,149,5745,-81,-97,16,,303364392,32,90,303364360,303364392
24937,5,24,149,5745,-79,-97,18,,303364678,28,258,303364650,303364678
24938,5,24,149,5745,-81,-97,16,,303364722,28,16,303364694,303364722
24939,5,24,149,5745,-81,-97,16,,303365050,32,296,303365018,303365050
24940,5,24,149,5745,-78,-97,19,,303365308,28,230,303365280,303365308
24941,5,24,149,5745,-81,-97,16,,303365352,28,16,303365324,303365352
24942,5,24,149,5745,-81,-97,16,,303365482,32,98,303365450,303365482
24943,5,24,149,5745,-78,-97,19,,303365650,28,140,303365622,303365650
24944,5,24,149,5745,-81,-97,16,,303365694,28,16,303365666,303365694
24945,5,24,149,5745,-81,-97,16,,303365849,32,123,303365817,303365849
24946,5,24,149,5745,-81,-97,16,,303366033,32,152,303366001,303366033
24947,5,24,149,5745,-79,-97,18,,303366328,28,267,303366300,303366328
24948,5,24,149,5745,-80,-97,17,,303366372,28,16,303366344,303366372
24949,5,24,149,5745,-80,-97,17,,303366501,32,97,303366469,303366501
24950,5,24,149,5745,-78,-97,19,,303366718,28,189,303366690,303366718
24951,5,24,149,5745,-81,-97,16,,303366762,28,16,303366734,303366762
24952,5,24,149,5745,-81,-97,16,,303366993,32,199,303366961,303366993
24953,5,24,149,5745,-81,-97,16,,303367123,28,102,303367095,303367123
24954,5,24,149,5745,-78,-97,19,,303367167,28,16,303367139,303367167
24955,5,24,149,5745,-78,-97,19,,303367275,32,76,303367243,303367275
24956,5,24,149,5745,-79,-97,18,,303368064,28,761,303368036,303368064
24957,5,24,149,5745,-80,-97,17,,303368108,28,16,303368080,303368108
24958,5,24,149,5745,-81,-97,16,,303368227,32,87,303368195,303368227
24959,5,24,149,5745,-81,-97,16,,303368349,32,90,303368317,303368349
24960,5,24,149,5745,-78,-97,19,,303370434,28,2057,303370406,303370434
24961,5,24,149,5745,-81,-97,16,,303370479,28,17,303370451,303370479
24962,5,24,149,5745,-81,-97,16,,303370781,32,270,303370749,303370781
24963,5,24,149,5745,-81,-97,16,,303370884,28,75,303370856,303370884
24964,5,24,149,5745,-78,-97,19,,303370928,28,16,303370900,303370928
24965,5,24,149,5745,-78,-97,19,,303371049,32,89,303371017,303371049
24966,5,24,149,5745,-78,-97,19,,303371183,28,106,303371155,303371183
24967,5,24,149,5745,-81,-97,16,,303371227,28,16,303371199,303371227
24968,5,24,149,5745,-81,-97,16,,303371656,32,397,303371624,303371656
24969,5,24,149,5745,-78,-97,19,,303372234,28,550,303372206,303372234
24970,5,24,149,5745,-81,-97,16,,303372278,28,16,303372250,303372278
24971,5,24,149,5745,-80,-97,17,,303372408,32,98,303372376,303372408
24972,5,24,149,5745,-78,-97,19,,303372676,28,240,303372648,303372676
24973,5,24,149,5745,-81,-97,16,,303372720,28,16,303372692,303372720
24974,5,24,149,5745,-80,-97,17,,303373019,32,267,303372987,303373019
24975,5,24,149,5745,-79,-97,18,,303373148,28,101,303373120,303373148
24976,5,24,149,5745,-81,-97,16,,303373192,28,16,303373164,303373192
24977,5,24,149,5745,-81,-97,16,,303373300,32,76,303373268,303373300
24978,5,24,149,5745,-81,-97,16,,303374626,28,1298,303374598,303374626
24979,5,24,149,5745,-78,-97,19,,303374669,28,15,303374641,303374669
24980,5,24,149,5745,-78,-97,19,,303374790,32,89,303374758,303374790
24981,5,12,149,5745,-70,-97,27,6a:1e:a4:f8:14:49,303375693,284,619,303375409,303375693
24982,5,12,149,5745,-84,-97,13,9a:24:38:da:96:bb,303376327,272,362,303376055,303376327
24983,5,12,149,5745,-63,-97,34,22:ec:75:a8:8a:31,303377045,244,474,303376801,303377045
24984,5,24,149,5745,-81,-97,16,,303377912,28,839,303377884,303377912
24985,5,24,149,5745,-78,-97,19,,303377956,28,16,303377928,303377956
24986,5,24,149,5745,-78,-97,19,,303378064,32,76,303378032,303378064
24987,5,24,149,5745,-81,-97,16,,303379035,28,943,303379007,303379035
24988,5,24,149,5745,-78,-97,19,,303379079,28,16,303379051,303379079
24989,5,24,149,5745,-78,-97,19,,303379204,32,93,303379172,303379204
24990,5,24,149,5745,-80,-97,17,,303383401,28,4169,303383373,303383401
24991,5,24,149,5745,-78,-97,19,,303383445,28,16,303383417,303383445
24992,5,24,149,5745,-78,-97,19,,303383554,32,77,303383522,303383554
24993,5,24,149,5745,-78,-97,19,,303384654,28,1072,303384626,303384654
24994,5,24,149,5745,-81,-97,16,,303384698,28,16,303384670,303384698
24995,5,24,149,5745,-81,-97,16,,303384806,32,76,303384774,303384806
24996,5,12,149,5745,-54,-97,43,4a:86:35:36:74:b8,303392990,268,7916,303392722,303392990
24997,5,24,149,5745,-78,-97,19,,303395036,28,2018,303395008,303395036
24998,5,24,149,5745,-80,-97,17,,303395080,28,16,303395052,303395080
24999,5,24,149,5745,-80,-97,17,,303395188,32,76,303395156,303395188
25000,5,6,149,5745,-91,-97,6,54:e4:3a:ec:fb:65,303395318,360,-230,303394958,303395318
25001,5,24,149,5745,-78,-97,19,,303395832,28,486,303395804,303395832
25002,5,24,149,5745,-79,-97,18,,303395876,28,16,303395848,303395876
25003,5,24,149,5745,-80,-97,17,,303395984,32,76,303395952,303395984
25004,5,12,149,5745,-69,-97,28,f2:da:61:dd:98:c5,303396075,268,-177,303395807,303396075
25005,5,12,149,5745,-68,-97,29,2a:07:ef:54:b5:55,303396982,244,663,303396738,303396982
25006,5,24,149,5745,-80,-97,17,,303397816,28,806,303397788,303397816
25007,5,24,149,5745,-78,-97,19,,303397860,28,16,303397832,303397860
25008,5,24,149,5745,-78,-97,19,,303397968,32,76,303397936,303397968
25009,5,24,149,5745,-80,-97,17,,303398980,28,984,303398952,303398980
25010,5,24,149,5745,-78,-97,19,,303399024,28,16,303398996,303399024
25011,5,24,149,5745,-78,-97,19,,303399148,32,92,303399116,303399148
25012,5,24,149,5745,-80,-97,17,,303401116,28,1940,303401088,303401116
25013,5,24,149,5745,-77,-97,20,,303401160,28,16,303401132,303401160
25014,5,24,149,5745,-78,-97,19,,303401268,32,76,303401236,303401268
25015,5,24,149,5745,-78,-97,19,,303405976,28,4680,303405948,303405976
25016,5,24,149,5745,-79,-97,18,,303406020,28,16,303405992,303406020
25017,5,24,149,5745,-79,-97,18,,303406139,32,87,303406107,303406139
25018,5,24,149,5745,-80,-97,17,,303406764,32,593,303406732,303406764
25019,5,24,149,5745,-79,-97,18,,303408954,28,2162,303408926,303408954
25020,5,24,149,5745,-78,-97,19,,303408998,28,16,303408970,303408998
25021,5,24,149,5745,-78,-97,19,,303409106,32,76,303409074,303409106
25022,5,24,149,5745,-78,-97,19,,303414769,28,5635,303414741,303414769
25023,5,24,149,5745,-79,-97,18,,303414814,28,17,303414786,303414814
25024,5,24,149,5745,-79,-97,18,,303414922,32,76,303414890,303414922
25025,5,12,149,5745,-63,-97,34,a6:92:ad:b7:76:65,303415015,284,-191,303414731,303415015
25026,5,24,149,5745,-78,-97,19,,303415432,28,389,303415404,303415432
25027,5,24,149,5745,-79,-97,18,,303415476,28,16,303415448,303415476
25028,5,24,149,5745,-79,-97,18,,303415598,32,90,303415566,303415598
25029,5,24,149,5745,-79,-97,18,,303415701,28,75,303415673,303415701
25030,5,24,149,5745,-78,-97,19,,303415745,28,16,303415717,303415745
25031,5,24,149,5745,-78,-97,19,,303415854,32,77,303415822,303415854
25032,5,24,149,5745,-78,-97,19,,303415965,28,83,303415937,303415965
25033,5,24,149,5745,-79,-97,18,,303416009,28,16,303415981,303416009
25034,5,24,149,5745,-78,-97,19,,303416117,32,76,303416085,303416117
25035,5,24,149,5745,-78,-97,19,,303416408,28,263,303416380,303416408
25036,5,24,149,5745,-79,-97,18,,303416452,28,16,303416424,303416452
25037,5,24,149,5745,-79,-97,18,,303416564,32,80,303416532,303416564
25038,5,24,149,5745,-78,-97,19,,303416782,28,190,303416754,303416782
25039,5,24,149,5745,-79,-97,18,,303416827,28,17,303416799,303416827
25040,5,24,149,5745,-78,-97,19,,303416934,32,75,303416902,303416934
25041,5,24,149,5745,-78,-97,19,,303417029,28,67,303417001,303417029
25042,5,24,149,5745,-78,-97,19,,303417073,28,16,303417045,303417073
25043,5,24,149,5745,-78,-97,19,,303417189,32,84,303417157,303417189
25044,5,24,149,5745,-78,-97,19,,303417300,28,83,303417272,303417300
25045,5,24,149,5745,-79,-97,18,,303417345,28,17,303417317,303417345
25046,5,24,149,5745,-79,-97,18,,303417453,32,76,303417421,303417453
25047,5,24,149,5745,-79,-97,18,,303418642,28,1161,303418614,303418642
25048,5,24,149,5745,-78,-97,19,,303418686,28,16,303418658,303418686
25049,5,24,149,5745,-79,-97,18,,303418798,32,80,303418766,303418798
25050,5,24,149,5745,-78,-97,19,,303419781,28,955,303419753,303419781
25051,5,24,149,5745,-78,-97,19,,303419825,28,16,303419797,303419825
25052,5,24,149,5745,-78,-97,19,,303419933,32,76,303419901,303419933
25053,5,12,149,5745,-67,-97,30,72:d1:72:1d:22:a1,303419999,284,-218,303419715,303419999
25054,5,12,149,5745,-54,-97,43,4a:86:35:36:74:b8,303420364,268,97,303420096,303420364
25055,5,24,149,5745,-78,-97,19,,303421909,28,1517,303421881,303421909
25056,5,24,149,5745,-78,-97,19,,303421953,28,16,303421925,303421953
25057,5,24,149,5745,-78,-97,19,,303422061,32,76,303422029,303422061
25058,5,24,149,5745,-78,-97,19,,303426469,28,4380,303426441,303426469
25059,5,24,149,5745,-78,-97,19,,303426513,28,16,303426485,303426513
25060,5,24,149,5745,-78,-97,19,,303426621,32,76,303426589,303426621
25061,5,12,149,5745,-88,-97,9,4e:72:d0:f1:a2:44,303428686,272,1793,303428414,303428686
25062,5,24,149,5745,-79,-97,18,,303432809,28,4095,303432781,303432809
25063,5,24,149,5745,-78,-97,19,,303432853,28,16,303432825,303432853
25064,5,24,149,5745,-78,-97,19,,303432961,32,76,303432929,303432961
25065,5,12,149,5745,-90,-97,7,42:d2:d9:2b:ac:61,303433203,288,-46,303432915,303433203
25066,5,24,149,5745,-79,-97,18,,303434125,28,894,303434097,303434125
25067,5,24,149,5745,-78,-97,19,,303434169,28,16,303434141,303434169
25068,5,24,149,5745,-78,-97,19,,303434277,32,76,303434245,303434277
25069,5,24,149,5745,-78,-97,19,,303434389,32,80,303434357,303434389
25070,5,24,149,5745,-79,-97,18,,303434455,28,38,303434427,303434455
25071,5,24,149,5745,-78,-97,19,,303434500,28,17,303434472,303434500
25072,5,24,149,5745,-78,-97,19,,303434607,32,75,303434575,303434607
25073,5,24,149,5745,-78,-97,19,,303437031,28,2396,303437003,303437031
25074,5,24,149,5745,-79,-97,18,,303437075,28,16,303437047,303437075
25075,5,24,149,5745,-79,-97,18,,303437183,32,76,303437151,303437183
25076,5,12,149,5745,-67,-97,30,56:68:e2:c2:8d:d5,303438140,280,677,303437860,303438140
25077,5,12,149,5745,-88,-97,9,de:be:a8:cd:79:57,303439942,284,1518,303439658,303439942
25078,5,24,149,5745,-78,-97,19,,303442260,28,2290,303442232,303442260
25079,5,24,149,5745,-79,-97,18,,303442304,28,16,303442276,303442304
25080,5,24,149,5745,-79,-97,18,,303442412,32,76,303442380,303442412
25081,5,12,149,5745,-87,-97,10,7e:05:42:11:d2:ec,303443162,244,506,303442918,303443162
25082,5,24,149,5745,-77,-97,20,,303454242,28,11052,303454214,303454242
25083,5,24,149,5745,-80,-97,17,,303454286,28,16,303454258,303454286
25084,5,24,149,5745,-80,-97,17,,303454407,32,89,303454375,303454407
25085,5,24,149,5745,-79,-97,18,,303455015,28,580,303454987,303455015
25086,5,24,149,5745,-77,-97,20,,303455060,28,17,303455032,303455060
25087,5,24,149,5745,-77,-97,20,,303455168,32,76,303455136,303455168
25088,5,12,149,5745,-56,-97,41,3e:d1:9b:c7:a4:de,303455552,272,112,303455280,303455552
25089,5,12,149,5745,-71,-97,26,5e:29:73:5b:30:00,303465663,272,9839,303465391,303465663
25090,5,24,149,5745,-80,-97,17,,303468662,28,2971,303468634,303468662
25091,5,24,149,5745,-78,-97,19,,303468706,28,16,303468678,303468706
25092,5,24,149,5745,-78,-97,19,,303468814,32,76,303468782,303468814
25093,5,24,149,5745,-80,-97,17,,303469740,28,898,303469712,303469740
25094,5,24,149,5745,-78,-97,19,,303469784,28,16,303469756,303469784
25095,5,24,149,5745,-77,-97,20,,303469903,32,87,303469871,303469903
25096,5,24,149,5745,-78,-97,19,,303470025,32,90,303469993,303470025
25097,5,24,149,5745,-79,-97,18,,303470182,28,129,303470154,303470182
25098,5,24,149,5745,-78,-97,19,,303470226,28,16,303470198,303470226
25099,5,24,149,5745,-77,-97,20,,303470370,32,112,303470338,303470370
25100,5,24,149,5745,-77,-97,20,,303470489,32,87,303470457,303470489
25101,5,24,149,5745,-78,-97,19,,303472682,28,2165,303472654,303472682
25102,5,24,149,5745,-80,-97,17,,303472726,28,16,303472698,303472726
25103,5,24,149,5745,-79,-97,18,,303472835,32,77,303472803,303472835
25104,5,24,149,5745,-78,-97,19,,303476917,28,4054,303476889,303476917
25105,5,24,149,5745,-80,-97,17,,303476961,28,16,303476933,303476961
25106,5,24,149,5745,-80,-97,17,,303477070,32,77,303477038,303477070
25107,5,24,149,5745,-78,-97,19,,303478722,28,1624,303478694,303478722
25108,5,24,149,5745,-79,-97,18,,303478766,28,16,303478738,303478766
25109,5,24,149,5745,-79,-97,18,,303478882,32,84,303478850,303478882
25110,5,12,149,5745,-84,-97,13,9a:24:38:da:96:bb,303484898,272,5744,303484626,303484898
25111,5,12,149,5745,-71,-97,26,6a:1e:a4:f8:14:49,303485789,284,607,303485505,303485789
25112,5,24,149,5745,-80,-97,17,,303490506,28,4689,303490478,303490506
25113,5,24,149,5745,-78,-97,19,,303490551,28,17,303490523,303490551
25114,5,24,149,5745,-78,-97,19,,303490658,32,75,303490626,303490658
25115,5,24,149,5745,-78,-97,19,,303492922,28,2236,303492894,303492922
25116,5,24,149,5745,-80,-97,17,,303492966,28,16,303492938,303492966
25117,5,24,149,5745,-81,-97,16,,303493086,32,88,303493054,303493086
25118,5,24,149,5745,-80,-97,17,,303493161,28,47,303493133,303493161
25119,5,24,149,5745,-78,-97,19,,303493206,28,17,303493178,303493206
25120,5,24,149,5745,-78,-97,19,,303493313,32,75,303493281,303493313
25121,5,24,149,5745,-78,-97,19,,303493619,28,278,303493591,303493619
25122,5,24,149,5745,-80,-97,17,,303493663,28,16,303493635,303493663
25123,5,24,149,5745,-79,-97,18,,303493771,32,76,303493739,303493771
25124,5,24,149,5745,-80,-97,17,,303494715,28,916,303494687,303494715
25125,5,24,149,5745,-79,-97,18,,303494760,28,17,303494732,303494760
25126,5,24,149,5745,-78,-97,19,,303494867,32,75,303494835,303494867
25127,5,24,149,5745,-79,-97,18,,303495040,28,145,303495012,303495040
25128,5,24,149,5745,-78,-97,19,,303495084,28,16,303495056,303495084
25129,5,24,149,5745,-78,-97,19,,303495192,32,76,303495160,303495192
25130,5,12,149,5745,-63,-97,34,22:ec:75:a8:8a:31,303495303,244,-133,303495059,303495303
25131,5,24,149,5745,-79,-97,18,,303495617,28,286,303495589,303495617
25132,5,24,149,5745,-78,-97,19,,303495661,28,16,303495633,303495661
25133,5,24,149,5745,-78,-97,19,,303495769,32,76,303495737,303495769
25134,5,24,149,5745,-79,-97,18,,303496026,28,229,303495998,303496026
25135,5,24,149,5745,-78,-97,19,,303496070,28,16,303496042,303496070
25136,5,24,149,5745,-78,-97,19,,303496182,32,80,303496150,303496182
25137,5,24,149,5745,-78,-97,19,,303497635,28,1425,303497607,303497635
25138,5,24,149,5745,-79,-97,18,,303497679,28,16,303497651,303497679
25139,5,24,149,5745,-78,-97,19,,303497870,28,163,303497842,303497870
25140,5,24,149,5745,-79,-97,18,,303497915,28,17,303497887,303497915
25141,5,24,149,5745,-78,-97,19,,303498214,28,271,303498186,303498214
25142,5,24,149,5745,-78,-97,19,,303498258,28,16,303498230,303498258
25143,5,24,149,5745,-79,-97,18,,303498383,32,93,303498351,303498383
25144,5,24,149,5745,-78,-97,19,,303499728,28,1317,303499700,303499728
25145,5,24,149,5745,-79,-97,18,,303499772,28,16,303499744,303499772
25146,5,24,149,5745,-79,-97,18,,303499892,32,88,303499860,303499892
25147,5,12,149,5745,-69,-97,28,2a:07:ef:54:b5:55,303499967,244,-169,303499723,303499967
25148,5,24,149,5745,-78,-97,19,,303500854,28,859,303500826,303500854
25149,5,24,149,5745,-78,-97,19,,303500898,28,16,303500870,303500898
25150,5,24,149,5745,-80,-97,17,,303501007,32,77,303500975,303501007
25151,5,24,149,5745,-78,-97,19,,303501981,28,946,303501953,303501981
25152,5,24,149,5745,-79,-97,18,,303502026,28,17,303501998,303502026
25153,5,24,149,5745,-79,-97,18,,303502158,32,100,303502126,303502158
25154,5,24,149,5745,-79,-97,18,,303505363,28,3177,303505335,303505363
25155,5,24,149,5745,-78,-97,19,,303505407,28,16,303505379,303505407
25156,5,24,149,5745,-78,-97,19,,303505519,32,80,303505487,303505519
25157,5,24,149,5745,-79,-97,18,,303505724,28,177,303505696,303505724
25158,5,24,149,5745,-78,-97,19,,303505768,28,16,303505740,303505768
25159,5,24,149,5745,-78,-97,19,,303505876,32,76,303505844,303505876
25160,5,24,149,5745,-79,-97,18,,303507748,28,1844,303507720,303507748
25161,5,24,149,5745,-78,-97,19,,303507793,28,17,303507765,303507793
25162,5,24,149,5745,-78,-97,19,,303507900,32,75,303507868,303507900
25163,5,24,149,5745,-78,-97,19,,303508013,28,85,303507985,303508013
25164,5,24,149,5745,-79,-97,18,,303508057,28,16,303508029,303508057
25165,5,24,149,5745,-79,-97,18,,303508165,32,76,303508133,303508165
25166,5,24,149,5745,-78,-97,19,,303514710,28,6517,303514682,303514710
25167,5,24,149,5745,-79,-97,18,,303514754,28,16,303514726,303514754
25168,5,24,149,5745,-79,-97,18,,303514863,32,77,303514831,303514863
25169,5,24,149,5745,-79,-97,18,,303517610,28,2719,303517582,303517610
25170,5,24,149,5745,-78,-97,19,,303517654,28,16,303517626,303517654
25171,5,24,149,5745,-79,-97,18,,303517773,32,87,303517741,303517773
25172,5,24,149,5745,-79,-97,18,,303517966,28,165,303517938,303517966
25173,5,24,149,5745,-79,-97,18,,303518010,28,16,303517982,303518010
25174,5,24,149,5745,-78,-97,19,,303518125,32,83,303518093,303518125
25175,5,24,149,5745,-79,-97,18,,303518290,28,137,303518262,303518290
25176,5,24,149,5745,-79,-97,18,,303518335,28,17,303518307,303518335
25177,5,24,149,5745,-78,-97,19,,303518442,32,75,303518410,303518442
25178,5,24,149,5745,-79,-97,18,,303518601,28,131,303518573,303518601
25179,5,24,149,5745,-78,-97,19,,303518645,28,16,303518617,303518645
25180,5,24,149,5745,-78,-97,19,,303518753,32,76,303518721,303518753
25181,5,24,149,5745,-79,-97,18,,303518852,28,71,303518824,303518852
25182,5,24,149,5745,-78,-97,19,,303518896,28,16,303518868,303518896
25183,5,24,149,5745,-78,-97,19,,303519004,32,76,303518972,303519004
25184,5,24,149,5745,-78,-97,19,,303520706,28,1674,303520678,303520706
25185,5,24,149,5745,-79,-97,18,,303520750,28,16,303520722,303520750
25186,5,24,149,5745,-79,-97,18,,303520866,32,84,303520834,303520866
25187,5,24,149,5745,-79,-97,18,,303521786,28,892,303521758,303521786
25188,5,24,149,5745,-79,-97,18,,303521830,28,16,303521802,303521830
25189,5,24,149,5745,-78,-97,19,,303521948,32,86,303521916,303521948
25190,5,24,149,5745,-79,-97,18,,303522132,28,156,303522104,303522132
25191,5,24,149,5745,-79,-97,18,,303522176,28,16,303522148,303522176
25192,5,24,149,5745,-78,-97,19,,303522291,32,83,303522259,303522291
25193,5,12,149,5745,-66,-97,31,72:d1:72:1d:22:a1,303522402,284,-173,303522118,303522402
25194,5,12,149,5745,-57,-97,40,b6:90:18:f6:b1:d4,303522768,268,98,303522500,303522768
25195,5,24,149,5745,-79,-97,18,,303523043,28,247,303523015,303523043
25196,5,24,149,5745,-79,-97,18,,303523088,28,17,303523060,303523088
25197,5,24,149,5745,-78,-97,19,,303523196,32,76,303523164,303523196
25198,5,24,149,5745,-78,-97,19,,303523357,28,133,303523329,303523357
25199,5,24,149,5745,-78,-97,19,,303523401,28,16,303523373,303523401
25200,5,24,149,5745,-78,-97,19,,303523509,32,76,303523477,303523509
25201,5,24,149,5745,-78,-97,19,,303524839,28,1302,303524811,303524839
25202,5,24,149,5745,-79,-97,18,,303524883,28,16,303524855,303524883
25203,5,24,149,5745,-79,-97,18,,303524995,32,80,303524963,303524995
25204,5,24,149,5745,-79,-97,18,,303525912,28,889,303525884,303525912
25205,5,24,149,5745,-78,-97,19,,303525956,28,16,303525928,303525956
25206,5,24,149,5745,-78,-97,19,,303526067,32,79,303526035,303526067
25207,5,24,149,5745,-80,-97,17,,303526278,28,183,303526250,303526278
25208,5,24,149,5745,-79,-97,18,,303526322,28,16,303526294,303526322
25209,5,24,149,5745,-79,-97,18,,303526430,32,76,303526398,303526430
25210,5,24,149,5745,-79,-97,18,,303526554,28,96,303526526,303526554
25211,5,24,149,5745,-79,-97,18,,303526599,28,17,303526571,303526599
25212,5,24,149,5745,-79,-97,18,,303526707,32,76,303526675,303526707
25213,5,24,149,5745,-79,-97,18,,303527921,28,1186,303527893,303527921
25214,5,24,149,5745,-79,-97,18,,303527965,28,16,303527937,303527965
25215,5,24,149,5745,-79,-97,18,,303528073,32,76,303528041,303528073
25216,5,24,149,5745,-79,-97,18,,303528250,28,149,303528222,303528250
25217,5,24,149,5745,-79,-97,18,,303528294,28,16,303528266,303528294
25218,5,24,149,5745,-80,-97,17,,303528403,32,77,303528371,303528403
25219,5,24,149,5745,-79,-97,18,,303528838,28,407,303528810,303528838
25220,5,24,149,5745,-79,-97,18,,303528882,28,16,303528854,303528882
25221,5,24,149,5745,-79,-97,18,,303528990,32,76,303528958,303528990
25222,5,24,149,5745,-78,-97,19,,303529921,28,903,303529893,303529921
25223,5,24,149,5745,-79,-97,18,,303529965,28,16,303529937,303529965
25224,5,24,149,5745,-79,-97,18,,303530073,32,76,303530041,303530073
25225,5,24,149,5745,-79,-97,18,,303530424,28,323,303530396,303530424
25226,5,24,149,5745,-80,-97,17,,303530468,28,16,303530440,303530468
25227,5,24,149,5745,-80,-97,17,,303530577,32,77,303530545,303530577
25228,5,6,149,5745,-82,-97,15,24:f6:77:10:02:c8,303533784,176,3031,303533608,303533784
25229,5,12,149,5745,-91,-97,6,42:d2:d9:2b:ac:61,303534496,288,424,303534208,303534496
25230,5,24,149,5745,-78,-97,19,,303535269,28,745,303535241,303535269
25231,5,12,149,5745,-90,-97,7,de:be:a8:cd:79:57,303535316,284,-237,303535032,303535316
25232,5,24,149,5745,-79,-97,18,,303535602,28,258,303535574,303535602
25233,5,24,149,5745,-80,-97,17,,303535646,28,16,303535618,303535646
25234,5,24,149,5745,-80,-97,17,,303535755,32,77,303535723,303535755
25235,5,12,149,5745,-61,-97,36,a6:92:ad:b7:76:65,303536816,284,777,303536532,303536816
25236,5,24,149,5745,-81,-97,16,,303538923,28,2079,303538895,303538923
25237,5,24,149,5745,-79,-97,18,,303538968,28,17,303538940,303538968
25238,5,24,149,5745,-79,-97,18,,303539076,32,76,303539044,303539076
25239,5,24,149,5745,-80,-97,17,,303539532,28,428,303539504,303539532
25240,5,24,149,5745,-79,-97,18,,303539577,28,17,303539549,303539577
25241,5,24,149,5745,-79,-97,18,,303539684,32,75,303539652,303539684
25242,5,12,149,5745,-56,-97,41,4a:86:35:36:74:b8,303540888,268,936,303540620,303540888
25243,5,12,149,5745,-90,-97,7,46:28:71:6e:d2:2e,303543122,252,1982,303542870,303543122
25244,5,24,149,5745,-80,-97,17,,303547483,28,4333,303547455,303547483
25245,5,24,149,5745,-79,-97,18,,303547527,28,16,303547499,303547527
25246,5,24,149,5745,-80,-97,17,,303547635,32,76,303547603,303547635
25247,5,24,149,5745,-80,-97,17,,303549008,28,1345,303548980,303549008
25248,5,24,149,5745,-79,-97,18,,303549053,28,17,303549025,303549053
25249,5,24,149,5745,-80,-97,17,,303549161,32,76,303549129,303549161
25250,5,24,149,5745,-80,-97,17,,303549336,28,147,303549308,303549336
25251,5,24,149,5745,-79,-97,18,,303549381,28,17,303549353,303549381
25252,5,24,149,5745,-80,-97,17,,303549488,32,75,303549456,303549488
25253,5,12,149,5745,-87,-97,10,7e:05:42:11:d2:ec,303550478,244,746,303550234,303550478
25254,5,24,149,5745,-80,-97,17,,303551908,28,1402,303551880,303551908
25255,5,24,149,5745,-79,-97,18,,303551953,28,17,303551925,303551953
25256,5,24,149,5745,-80,-97,17,,303552061,32,76,303552029,303552061
25257,5,24,149,5745,-79,-97,18,,303552786,28,697,303552758,303552786
25258,5,24,149,5745,-80,-97,17,,303552830,28,16,303552802,303552830
25259,5,24,149,5745,-80,-97,17,,303552949,32,87,303552917,303552949
25260,5,24,149,5745,-80,-97,17,,303553118,28,141,303553090,303553118
25261,5,24,149,5745,-80,-97,17,,303553162,28,16,303553134,303553162
25262,5,24,149,5745,-79,-97,18,,303553277,32,83,303553245,303553277
25263,5,24,149,5745,-80,-97,17,,303553469,28,164,303553441,303553469
25264,5,24,149,5745,-80,-97,17,,303553514,28,17,303553486,303553514
25265,5,24,149,5745,-80,-97,17,,303553622,32,76,303553590,303553622
25266,5,24,149,5745,-79,-97,18,,303553779,28,129,303553751,303553779
25267,5,24,149,5745,-80,-97,17,,303553823,28,16,303553795,303553823
25268,5,24,149,5745,-80,-97,17,,303553931,32,76,303553899,303553931
25269,5,24,149,5745,-79,-97,18,,303555718,28,1759,303555690,303555718
25270,5,24,149,5745,-80,-97,17,,303555762,28,16,303555734,303555762
25271,5,24,149,5745,-81,-97,16,,303555879,32,85,303555847,303555879
25272,5,12,149,5745,-66,-97,31,56:68:e2:c2:8d:d5,303556431,280,272,303556151,303556431
25273,5,24,149,5745,-79,-97,18,,303566125,28,9666,303566097,303566125
25274,5,24,149,5745,-80,-97,17,,303566169,28,16,303566141,303566169
25275,5,24,149,5745,-80,-97,17,,303566277,32,76,303566245,303566277
25276,5,12,149,5745,-72,-97,25,2a:07:ef:54:b5:55,303567745,244,1224,303567501,303567745
25277,5,24,149,5745,-80,-97,17,,303575525,28,7752,303575497,303575525
25278,5,24,149,5745,-80,-97,17,,303575569,28,16,303575541,303575569
25279,5,24,149,5745,-80,-97,17,,303575677,32,76,303575645,303575677
25280,5,24,149,5745,-80,-97,17,,303575775,28,70,303575747,303575775
25281,5,24,149,5745,-80,-97,17,,303575820,28,17,303575792,303575820
25282,5,24,149,5745,-80,-97,17,,303575935,32,83,303575903,303575935
25283,5,24,149,5745,-80,-97,17,,303578015,28,2052,303577987,303578015
25284,5,24,149,5745,-80,-97,17,,303578059,28,16,303578031,303578059
25285,5,24,149,5745,-81,-97,16,,303578167,32,76,303578135,303578167
25286,5,24,149,5745,-81,-97,16,,303578387,28,192,303578359,303578387
25287,5,24,149,5745,-80,-97,17,,303578432,28,17,303578404,303578432
25288,5,24,149,5745,-80,-97,17,,303578544,32,80,303578512,303578544
25289,5,12,149,5745,-63,-97,34,f6:0a:5c:59:72:df,303581601,280,2777,303581321,303581601
25290,5,12,149,5745,-51,-97,46,3e:d1:9b:c7:a4:de,303582519,272,646,303582247,303582519
25291,5,12,149,5745,-71,-97,26,6a:1e:a4:f8:14:49,303583323,284,520,303583039,303583323
25292,5,12,149,5745,-58,-97,39,b6:90:18:f6:b1:d4,303583686,268,95,303583418,303583686
25293,5,12,149,5745,-64,-97,33,5e:29:73:5b:30:00,303584032,272,74,303583760,303584032
25294,5,24,149,5745,-80,-97,17,,303584454,28,394,303584426,303584454
25295,5,24,149,5745,-81,-97,16,,303584497,28,15,303584469,303584497
25296,5,24,149,5745,-80,-97,17,,303584606,32,77,303584574,303584606
25297,5,12,149,5745,-51,-97,46,3e:d1:9b:c7:a4:de,303584672,544,-478,303584128,303584672
25298,5,12,149,5745,-67,-97,30,2a:07:ef:54:b5:55,303585288,440,176,303584848,303585288
25299,5,12,149,5745,-66,-97,31,56:68:e2:c2:8d:d5,303588750,476,2986,303588274,303588750
25300,5,12,149,5745,-90,-97,7,3a:90:78:0e:4f:1f,303589366,256,360,303589110,303589366
25301,5,12,149,5745,-54,-97,43,4a:86:35:36:74:b8,303589831,268,197,303589563,303589831
25302,5,12,149,5745,-57,-97,40,b6:90:18:f6:b1:d4,303592592,268,2493,303592324,303592592
25303,5,12,149,5745,-65,-97,32,5e:29:73:5b:30:00,303595072,540,1940,303594532,303595072
25304,5,12,149,5745,-84,-97,13,9a:24:38:da:96:bb,303595674,272,330,303595402,303595674
25305,5,12,149,5745,-70,-97,27,f2:da:61:dd:98:c5,303595980,268,38,303595712,303595980
25306,5,12,149,5745,-70,-97,27,6a:1e:a4:f8:14:49,303596319,480,-141,303595839,303596319
25307,5,24,149,5745,-79,-97,18,,303597463,28,1116,303597435,303597463
25308,5,24,149,5745,-80,-97,17,,303597507,28,16,303597479,303597507
25309,5,24,149,5745,-80,-97,17,,303597615,32,76,303597583,303597615
25310,5,12,149,5745,-89,-97,8,46:28:71:6e:d2:2e,303597767,252,-100,303597515,303597767
25311,5,6,149,5745,-90,-97,7,54:e4:3a:ec:fb:65,303600119,360,1992,303599759,303600119
25312,5,12,149,5745,-63,-97,34,a6:92:ad:b7:76:65,303600709,484,106,303600225,303600709
25313,5,12,149,5745,-70,-97,27,f2:da:61:dd:98:c5,303601228,268,251,303600960,303601228
25314,5,12,149,5745,-67,-97,30,72:d1:72:1d:22:a1,303601540,480,-168,303601060,303601540
25315,5,12,149,5745,-62,-97,35,f6:0a:5c:59:72:df,303603138,476,1122,303602662,303603138
25316,5,12,149,5745,-59,-97,38,22:ec:75:a8:8a:31,303604593,516,939,303604077,303604593
25317,5,12,149,5745,-93,-97,4,4e:72:d0:f1:a2:44,303609289,468,4228,303608821,303609289
25318,5,12,149,5745,-88,-97,9,3a:90:78:0e:4f:1f,303610281,452,540,303609829,303610281
25319,5,12,149,5745,-59,-97,38,22:ec:75:a8:8a:31,303614076,244,3551,303613832,303614076
25320,5,12,149,5745,-60,-97,37,a6:92:ad:b7:76:65,303632632,284,18272,303632348,303632632
25321,5,12,149,5745,-67,-97,30,72:d1:72:1d:22:a1,303634193,284,1277,303633909,303634193
25322,5,24,149,5745,-80,-97,17,,303647528,28,13307,303647500,303647528
25323,5,24,149,5745,-78,-97,19,,303647571,28,15,303647543,303647571
25324,5,24,149,5745,-78,-97,19,,303647696,32,93,303647664,303647696
25325,5,12,149,5745,-70,-97,27,2a:07:ef:54:b5:55,303648126,440,-10,303647686,303648126
25326,5,12,149,5745,-52,-97,45,4a:86:35:36:74:b8,303650123,268,1729,303649855,303650123
25327,5,12,149,5745,-51,-97,46,4a:86:35:36:74:b8,303655497,268,5106,303655229,303655497
25328,5,12,149,5745,-87,-97,10,7e:05:42:11:d2:ec,303655826,440,-111,303655386,303655826
25329,5,12,149,5745,-91,-97,6,4e:72:d0:f1:a2:44,303657843,272,1745,303657571,303657843
25330,5,12,149,5745,-68,-97,29,f2:da:61:dd:98:c5,303659820,268,1709,303659552,303659820
25331,5,24,149,5745,-79,-97,18,,303662579,28,2731,303662551,303662579
25332,5,24,149,5745,-79,-97,18,,303662623,28,16,303662595,303662623
25333,5,24,149,5745,-79,-97,18,,303662731,32,76,303662699,303662731
25334,5,12,149,5745,-69,-97,28,2a:07:ef:54:b5:55,303663913,244,938,303663669,303663913
25335,5,12,149,5745,-58,-97,39,a6:92:ad:b7:76:65,303665388,484,991,303664904,303665388
25336,5,12,149,5745,-86,-97,11,7e:05:42:11:d2:ec,303666950,244,1318,303666706,303666950
25337,5,12,149,5745,-65,-97,32,56:68:e2:c2:8d:d5,303667324,280,94,303667044,303667324
25338,5,24,149,5745,-79,-97,18,,303670125,28,2773,303670097,303670125
25339,5,24,149,5745,-78,-97,19,,303670169,28,16,303670141,303670169
25340,5,24,149,5745,-79,-97,18,,303670277,32,76,303670245,303670277
25341,5,24,149,5745,-78,-97,19,,303679857,28,9552,303679829,303679857
25342,5,24,149,5745,-78,-97,19,,303679901,28,16,303679873,303679901
25343,5,24,149,5745,-78,-97,19,,303680009,32,76,303679977,303680009
25344,5,24,149,5745,-79,-97,18,,303680230,28,193,303680202,303680230
25345,5,24,149,5745,-78,-97,19,,303680274,28,16,303680246,303680274
25346,5,24,149,5745,-79,-97,18,,303680382,32,76,303680350,303680382
25347,5,24,149,5745,-78,-97,19,,303682721,28,2311,303682693,303682721
25348,5,24,149,5745,-78,-97,19,,303682765,28,16,303682737,303682765
25349,5,24,149,5745,-79,-97,18,,303682874,32,77,303682842,303682874
25350,5,12,149,5745,-53,-97,44,3e:d1:9b:c7:a4:de,303685242,272,2096,303684970,303685242
25351,5,24,149,5745,-78,-97,19,,303687722,28,2452,303687694,303687722
25352,5,24,149,5745,-79,-97,18,,303687766,28,16,303687738,303687766
25353,5,24,149,5745,-79,-97,18,,303687875,32,77,303687843,303687875
25354,5,12,149,5745,-66,-97,31,5e:29:73:5b:30:00,303691664,272,3517,303691392,303691664
25355,5,12,149,5745,-57,-97,40,b6:90:18:f6:b1:d4,303699870,268,7938,303699602,303699870
25356,5,24,149,5745,-79,-97,18,,303700964,28,1066,303700936,303700964
25357,5,24,149,5745,-77,-97,20,,303701008,28,16,303700980,303701008
25358,5,24,149,5745,-77,-97,20,,303701116,32,76,303701084,303701116
25359,5,6,149,5745,-87,-97,10,54:e4:3a:ec:fb:65,303702520,360,1044,303702160,303702520
25360,5,12,149,5745,-85,-97,12,9a:24:38:da:96:bb,303708473,272,5681,303708201,303708473
25361,5,12,149,5745,-71,-97,26,6a:1e:a4:f8:14:49,303712010,284,3253,303711726,303712010
25362,5,12,149,5745,-68,-97,29,2a:07:ef:54:b5:55,303713806,440,1356,303713366,303713806
25363,5,12,149,5745,-62,-97,35,f6:0a:5c:59:72:df,303714641,280,555,303714361,303714641
25364,5,12,149,5745,-51,-97,46,3e:d1:9b:c7:a4:de,303715127,544,-58,303714583,303715127
25365,5,12,149,5745,-69,-97,28,f2:da:61:dd:98:c5,303715706,268,311,303715438,303715706
25366,5,12,149,5745,-90,-97,7,46:16:4e:de:2f:e5,303720828,468,4654,303720360,303720828
25367,5,12,149,5745,-87,-97,10,7e:05:42:11:d2:ec,303721438,440,170,303720998,303721438
25368,5,12,149,5745,-57,-97,40,b6:90:18:f6:b1:d4,303722903,268,1197,303722635,303722903
25369,5,12,149,5745,-69,-97,28,5e:29:73:5b:30:00,303725077,540,1634,303724537,303725077
25370,5,12,149,5745,-70,-97,27,f2:da:61:dd:98:c5,303725698,268,353,303725430,303725698
25371,5,12,149,5745,-90,-97,7,de:be:a8:cd:79:57,303726630,480,452,303726150,303726630
25372,5,12,149,5745,-60,-97,37,22:ec:75:a8:8a:31,303728800,244,1926,303728556,303728800
25373,5,12,149,5745,-61,-97,36,0a:b9:b7:b1:4d:fa,303729097,268,29,303728829,303729097
25374,5,12,149,5745,-59,-97,38,a6:92:ad:b7:76:65,303730945,484,1364,303730461,303730945
25375,5,12,149,5745,-49,-97,48,4a:86:35:36:74:b8,303731690,268,477,303731422,303731690
25376,5,12,149,5745,-59,-97,38,22:ec:75:a8:8a:31,303733720,516,1514,303733204,303733720
25377,5,12,149,5745,-71,-97,26,d2:00:04:7e:2c:ab,303734425,440,265,303733985,303734425
25378,5,12,149,5745,-60,-97,37,a6:92:ad:b7:76:65,303746991,284,12282,303746707,303746991
25379,5,12,149,5745,-51,-97,46,4a:86:35:36:74:b8,303765068,268,17809,303764800,303765068
25380,5,12,149,5745,-86,-97,11,7e:05:42:11:d2:ec,303766280,244,968,303766036,303766280
25381,5,12,149,5745,-91,-97,6,4e:72:d0:f1:a2:44,303771391,272,4839,303771119,303771391
25382,5,12,149,5745,-65,-97,32,2a:07:ef:54:b5:55,303789888,244,18253,303789644,303789888
25383,5,12,149,5745,-54,-97,43,3e:d1:9b:c7:a4:de,303800024,272,9864,303799752,303800024
25384,5,24,149,5745,-82,-97,15,,303801399,32,1343,303801367,303801399
25385,5,24,149,5745,-81,-97,16,,303801890,32,459,303801858,303801890
25386,5,24,149,5745,-82,-97,15,,303802380,28,462,303802352,303802380
25387,5,6,149,5745,-89,-97,8,54:e4:3a:ec:fb:65,303804920,360,2180,303804560,303804920
25388,5,12,149,5745,-68,-97,29,5e:29:73:5b:30:00,303809542,272,4350,303809270,303809542
25389,5,12,149,5745,-89,-97,8,9a:24:38:da:96:bb,303820672,272,10858,303820400,303820672
25390,5,12,149,5745,-60,-97,37,b6:90:18:f6:b1:d4,303828884,268,7944,303828616,303828884
25391,5,12,149,5745,-65,-97,32,72:d1:72:1d:22:a1,303829503,284,335,303829219,303829503
25392,5,12,149,5745,-64,-97,33,56:68:e2:c2:8d:d5,303830055,280,272,303829775,303830055
25393,5,12,149,5745,-89,-97,8,de:be:a8:cd:79:57,303836444,284,6105,303836160,303836444
25394,5,12,149,5745,-57,-97,40,22:ec:75:a8:8a:31,303836759,244,71,303836515,303836759
25395,5,12,149,5745,-90,-97,7,42:d2:d9:2b:ac:61,303842942,288,5895,303842654,303842942
25396,5,24,149,5745,-67,-97,30,,303843246,28,276,303843218,303843246
25397,5,24,149,5745,-81,-97,16,,303843290,28,16,303843262,303843290
25398,5,24,149,5745,-80,-97,17,,303843398,28,80,303843370,303843398
25399,5,12,149,5745,-88,-97,9,4e:72:d0:f1:a2:44,303886457,272,42787,303886185,303886457
25400,5,12,149,5745,-68,-97,29,2a:07:ef:54:b5:55,303899175,244,12474,303898931,303899175
25401,5,12,149,5745,-69,-97,28,6a:1e:a4:f8:14:49,303903908,284,4449,303903624,303903908
25402,5,6,149,5745,-90,-97,7,54:e4:3a:ec:fb:65,303907320,360,3052,303906960,303907320
25403,5,12,149,5745,-71,-97,26,f2:da:61:dd:98:c5,303908032,268,444,303907764,303908032
25404,5,12,149,5745,-50,-97,47,4a:86:35:36:74:b8,303908424,268,124,303908156,303908424
25405,5,12,149,5745,-55,-97,42,3e:d1:9b:c7:a4:de,303916136,272,7440,303915864,303916136
25406,5,12,149,5745,-68,-97,29,5e:29:73:5b:30:00,303926617,272,10209,303926345,303926617
25407,5,12,149,5745,-60,-97,37,a6:92:ad:b7:76:65,303930943,284,4042,303930659,303930943
25408,5,12,149,5745,-66,-97,31,72:d1:72:1d:22:a1,303931461,284,234,303931177,303931461
25409,5,12,149,5745,-60,-97,37,b6:90:18:f6:b1:d4,303932204,268,475,303931936,303932204
25410,5,12,149,5745,-86,-97,11,9a:24:38:da:96:bb,303936338,272,3862,303936066,303936338
25411,5,12,149,5745,-64,-97,33,56:68:e2:c2:8d:d5,303937804,280,1186,303937524,303937804
25412,5,12,149,5745,-89,-97,8,42:d2:d9:2b:ac:61,303944077,288,5985,303943789,303944077
25413,5,12,149,5745,-88,-97,9,7e:05:42:11:d2:ec,303949980,244,5659,303949736,303949980
25414,5,12,149,5745,-91,-97,6,de:be:a8:cd:79:57,303950882,284,618,303950598,303950882
25415,5,12,149,5745,-57,-97,40,22:ec:75:a8:8a:31,303953771,244,2645,303953527,303953771
25416,5,12,149,5745,-90,-97,7,46:28:71:6e:d2:2e,304002237,252,48214,304001985,304002237
25417,5,12,149,5745,-70,-97,27,6a:1e:a4:f8:14:49,304006863,284,4342,304006579,304006863
25418,5,6,149,5745,-88,-97,9,54:e4:3a:ec:fb:65,304009721,360,2498,304009361,304009721
25419,5,12,149,5745,-49,-97,48,4a:86:35:36:74:b8,304010434,268,445,304010166,304010434
25420,5,12,149,5745,-72,-97,25,f2:da:61:dd:98:c5,304010781,268,79,304010513,304010781
25421,5,12,149,5745,-65,-97,32,2a:07:ef:54:b5:55,304016619,244,5594,304016375,304016619
25422,5,24,149,5745,-77,-97,20,,304026929,28,10282,304026901,304026929
25423,5,24,149,5745,-78,-97,19,,304026973,28,16,304026945,304026973
25424,5,24,149,5745,-78,-97,19,,304027089,32,84,304027057,304027089
25425,5,12,149,5745,-58,-97,39,3e:d1:9b:c7:a4:de,304029120,272,1759,304028848,304029120
25426,5,12,149,5745,-61,-97,36,a6:92:ad:b7:76:65,304032829,284,3425,304032545,304032829
25427,5,12,149,5745,-63,-97,34,72:d1:72:1d:22:a1,304034422,284,1309,304034138,304034422
25428,5,12,149,5745,-66,-97,31,56:68:e2:c2:8d:d5,304036460,280,1758,304036180,304036460
25429,5,24,149,5745,-77,-97,20,,304041443,28,4955,304041415,304041443
25430,5,24,149,5745,-78,-97,19,,304041487,28,16,304041459,304041487
25431,5,24,149,5745,-78,-97,19,,304041595,32,76,304041563,304041595
25432,5,24,149,5745,-78,-97,19,,304041715,28,92,304041687,304041715
25433,5,24,149,5745,-78,-97,19,,304041760,28,17,304041732,304041760
25434,5,24,149,5745,-77,-97,20,,304041868,32,76,304041836,304041868
25435,5,24,149,5745,-78,-97,19,,304042019,32,119,304041987,304042019
25436,5,24,149,5745,-77,-97,20,,304042295,32,244,304042263,304042295
25437,5,12,149,5745,-71,-97,26,5e:29:73:5b:30:00,304042471,272,-96,304042199,304042471
25438,5,24,149,5745,-78,-97,19,,304043376,32,873,304043344,304043376
25439,5,24,149,5745,-78,-97,19,,304043801,32,393,304043769,304043801
25440,5,12,149,5745,-86,-97,11,9a:24:38:da:96:bb,304045024,272,951,304044752,304045024
25441,5,12,149,5745,-90,-97,7,42:d2:d9:2b:ac:61,304047483,288,2171,304047195,304047483
25442,5,24,149,5745,-78,-97,19,,304049774,28,2263,304049746,304049774
25443,5,24,149,5745,-78,-97,19,,304049818,28,16,304049790,304049818
25444,5,24,149,5745,-77,-97,20,,304049931,32,81,304049899,304049931
25445,5,12,149,5745,-57,-97,40,b6:90:18:f6:b1:d4,304050078,268,-121,304049810,304050078
25446,5,12,149,5745,-87,-97,10,7e:05:42:11:d2:ec,304052383,244,2061,304052139,304052383
25447,5,24,149,5745,-77,-97,20,,304055860,28,3449,304055832,304055860
25448,5,24,149,5745,-78,-97,19,,304055905,28,17,304055877,304055905
25449,5,24,149,5745,-77,-97,20,,304056013,32,76,304055981,304056013
25450,5,24,149,5745,-78,-97,19,,304056198,28,157,304056170,304056198
25451,5,24,149,5745,-78,-97,19,,304056243,28,17,304056215,304056243
25452,5,24,149,5745,-77,-97,20,,304056351,32,76,304056319,304056351
25453,5,24,149,5745,-77,-97,20,,304056586,28,207,304056558,304056586
25454,5,24,149,5745,-78,-97,19,,304056630,28,16,304056602,304056630
25455,5,24,149,5745,-78,-97,19,,304056738,32,76,304056706,304056738
25456,5,24,149,5745,-76,-97,21,,304056903,28,137,304056875,304056903
25457,5,24,149,5745,-78,-97,19,,304056947,28,16,304056919,304056947
25458,5,24,149,5745,-77,-97,20,,304057055,32,76,304057023,304057055
25459,5,24,149,5745,-78,-97,19,,304059135,28,2052,304059107,304059135
25460,5,24,149,5745,-77,-97,20,,304059179,28,16,304059151,304059179
25461,5,24,149,5745,-78,-97,19,,304059292,32,81,304059260,304059292
25462,5,24,149,5745,-65,-97,32,,304059829,28,509,304059801,304059829
25463,5,24,149,5745,-77,-97,20,,304059873,28,16,304059845,304059873
25464,5,24,149,5745,-77,-97,20,,304059981,28,80,304059953,304059981
25465,5,24,149,5745,-65,-97,32,,304060074,28,65,304060046,304060074
25466,5,24,149,5745,-77,-97,20,,304060119,28,17,304060091,304060119
25467,5,24,149,5745,-77,-97,20,,304060226,28,79,304060198,304060226
25468,5,24,149,5745,-65,-97,32,,304060342,28,88,304060314,304060342
25469,5,24,149,5745,-78,-97,19,,304060386,28,16,304060358,304060386
25470,5,24,149,5745,-76,-97,21,,304060494,28,80,304060466,304060494
25471,5,12,149,5745,-91,-97,6,3a:90:78:0e:4f:1f,304062358,256,1608,304062102,304062358
25472,5,24,149,5745,-78,-97,19,,304063864,28,1478,304063836,304063864
25473,5,24,149,5745,-77,-97,20,,304063908,28,16,304063880,304063908
25474,5,24,149,5745,-76,-97,21,,304064021,32,81,304063989,304064021
25475,5,12,149,5745,-61,-97,36,f6:0a:5c:59:72:df,304068747,280,4446,304068467,304068747
25476,5,12,149,5745,-57,-97,40,22:ec:75:a8:8a:31,304070688,244,1697,304070444,304070688
25477,5,24,149,5745,-77,-97,20,,304077812,28,7096,304077784,304077812
25478,5,24,149,5745,-78,-97,19,,304077857,28,17,304077829,304077857
25479,5,24,149,5745,-78,-97,19,,304077964,32,75,304077932,304077964
25480,5,24,149,5745,-76,-97,21,,304098219,28,20227,304098191,304098219
25481,5,24,149,5745,-79,-97,18,,304098263,28,16,304098235,304098263
25482,5,24,149,5745,-79,-97,18,,304098371,32,76,304098339,304098371
25483,5,12,149,5745,-70,-97,27,6a:1e:a4:f8:14:49,304108003,284,9348,304107719,304108003
25484,5,24,149,5745,-76,-97,21,,304108447,32,412,304108415,304108447
25485,5,24,149,5745,-76,-97,21,,304108991,32,512,304108959,304108991
25486,5,24,149,5745,-76,-97,21,,304109536,28,517,304109508,304109536
25487,5,12,149,5745,-90,-97,7,4e:72:d0:f1:a2:44,304111703,272,1895,304111431,304111703
25488,5,6,149,5745,-91,-97,6,54:e4:3a:ec:fb:65,304112122,360,59,304111762,304112122
25489,5,12,149,5745,-71,-97,26,f2:da:61:dd:98:c5,304112590,268,200,304112322,304112590
25490,5,12,149,5745,-54,-97,43,4a:86:35:36:74:b8,304112919,268,61,304112651,304112919
25491,5,24,149,5745,-76,-97,21,,304117752,28,4805,304117724,304117752
25492,5,12,149,5745,-68,-97,29,2a:07:ef:54:b5:55,304124543,244,6547,304124299,304124543
25493,5,12,149,5745,-65,-97,32,a6:92:ad:b7:76:65,304134614,284,9787,304134330,304134614
25494,5,12,149,5745,-62,-97,35,72:d1:72:1d:22:a1,304137080,284,2182,304136796,304137080
25495,5,12,149,5745,-65,-97,32,56:68:e2:c2:8d:d5,304138143,280,783,304137863,304138143
25496,5,12,149,5745,-61,-97,36,3e:d1:9b:c7:a4:de,304141237,272,2822,304140965,304141237
25497,5,12,149,5745,-91,-97,6,42:d2:d9:2b:ac:61,304150005,288,8480,304149717,304150005
25498,5,12,149,5745,-57,-97,40,b6:90:18:f6:b1:d4,304153207,268,2934,304152939,304153207
25499,5,12,149,5745,-89,-97,8,7e:05:42:11:d2:ec,304153649,244,198,304153405,304153649
25500,5,12,149,5745,-90,-97,7,de:be:a8:cd:79:57,304154435,284,502,304154151,304154435
25501,5,12,149,5745,-86,-97,11,9a:24:38:da:96:bb,304156312,272,1605,304156040,304156312
25502,5,12,149,5745,-62,-97,35,f6:0a:5c:59:72:df,304157439,280,847,304157159,304157439
25503,5,12,149,5745,-71,-97,26,6a:1e:a4:f8:14:49,304160110,284,2387,304159826,304160110
25504,5,12,149,5745,-90,-97,7,de:be:a8:cd:79:57,304165490,284,5096,304165206,304165490
25505,5,12,149,5745,-71,-97,26,5e:29:73:5b:30:00,304173686,272,7924,304173414,304173686
25506,5,12,149,5745,-75,-97,22,f2:da:61:dd:98:c5,304174740,268,786,304174472,304174740
25507,5,12,149,5745,-72,-97,25,2a:07:ef:54:b5:55,304177706,440,2526,304177266,304177706
25508,5,12,149,5745,-64,-97,33,56:68:e2:c2:8d:d5,304178180,476,-2,304177704,304178180
25509,5,12,149,5745,-90,-97,7,7e:05:42:11:d2:ec,304180332,440,1712,304179892,304180332
25510,5,12,149,5745,-71,-97,26,5e:29:73:5b:30:00,304182636,540,1764,304182096,304182636
25511,5,12,149,5745,-89,-97,8,42:d2:d9:2b:ac:61,304183256,484,136,304182772,304183256
25512,5,12,149,5745,-62,-97,35,a6:92:ad:b7:76:65,304183783,484,43,304183299,304183783
25513,5,12,149,5745,-74,-97,23,f2:da:61:dd:98:c5,304186870,268,2819,304186602,304186870
25514,5,12,149,5745,-62,-97,35,a6:92:ad:b7:76:65,304189635,284,2481,304189351,304189635
25515,5,12,149,5745,-62,-97,35,72:d1:72:1d:22:a1,304189954,480,-161,304189474,304189954
25516,5,12,149,5745,-58,-97,39,22:ec:75:a8:8a:31,304190453,516,-17,304189937,304190453
25517,5,12,149,5745,-54,-97,43,4a:86:35:36:74:b8,304193409,268,2688,304193141,304193409
25518,5,12,149,5745,-64,-97,33,f6:0a:5c:59:72:df,304195052,476,1167,304194576,304195052
25519,5,12,149,5745,-91,-97,6,4e:72:d0:f1:a2:44,304199845,468,4325,304199377,304199845
25520,5,12,149,5745,-91,-97,6,3a:90:78:0e:4f:1f,304200357,452,60,304199905,304200357
25521,5,12,149,5745,-89,-97,8,de:be:a8:cd:79:57,304201923,480,1086,304201443,304201923
25522,5,12,149,5745,-59,-97,38,22:ec:75:a8:8a:31,304203868,244,1701,304203624,304203868
25523,5,12,149,5745,-56,-97,41,b6:90:18:f6:b1:d4,304206524,268,2388,304206256,304206524
25524,5,12,149,5745,-55,-97,42,4a:86:35:36:74:b8,304206828,268,36,304206560,304206828
25525,5,6,149,5745,-89,-97,8,54:e4:3a:ec:fb:65,304214523,360,7335,304214163,304214523
25526,5,12,149,5745,-64,-97,33,56:68:e2:c2:8d:d5,304222285,280,7482,304222005,304222285
25527,5,12,149,5745,-87,-97,10,7e:05:42:11:d2:ec,304224500,244,1971,304224256,304224500
25528,5,12,149,5745,-69,-97,28,2a:07:ef:54:b5:55,304237359,244,12615,304237115,304237359
25529,5,12,149,5745,-72,-97,25,f2:da:61:dd:98:c5,304240501,268,2874,304240233,304240501
25530,5,12,149,5745,-70,-97,27,2a:07:ef:54:b5:55,304242045,440,1104,304241605,304242045
25531,5,12,149,5745,-64,-97,33,0a:b9:b7:b1:4d:fa,304242627,268,314,304242359,304242627
25532,5,12,149,5745,-64,-97,33,56:68:e2:c2:8d:d5,304243325,476,222,304242849,304243325
25533,5,12,149,5745,-88,-97,9,7e:05:42:11:d2:ec,304246234,440,2469,304245794,304246234
25534,5,12,149,5745,-71,-97,26,6a:1e:a4:f8:14:49,304246697,480,-17,304246217,304246697
25535,5,12,149,5745,-89,-97,8,42:d2:d9:2b:ac:61,304248183,484,1002,304247699,304248183
25536,5,12,149,5745,-61,-97,36,a6:92:ad:b7:76:65,304248746,484,79,304248262,304248746
25537,5,12,149,5745,-88,-97,9,7e:05:42:11:d2:ec,304249773,360,667,304249413,304249773
25538,5,12,149,5745,-86,-97,11,de:be:a8:cd:79:57,304250232,480,-21,304249752,304250232
25539,5,12,149,5745,-67,-97,30,5e:29:73:5b:30:00,304252702,540,1930,304252162,304252702
25540,5,12,149,5745,-59,-97,38,22:ec:75:a8:8a:31,304254813,516,1595,304254297,304254813
25541,5,12,149,5745,-56,-97,41,b6:90:18:f6:b1:d4,304255364,268,283,304255096,304255364
25542,5,12,149,5745,-56,-97,41,b6:90:18:f6:b1:d4,304255650,268,18,304255382,304255650
25543,5,12,149,5745,-56,-97,41,3e:d1:9b:c7:a4:de,304256159,544,-35,304255615,304256159
25544,5,12,149,5745,-54,-97,43,4a:86:35:36:74:b8,304256991,268,564,304256723,304256991
25545,5,12,149,5745,-63,-97,34,f6:0a:5c:59:72:df,304258726,280,1455,304258446,304258726
25546,5,12,149,5745,-62,-97,35,72:d1:72:1d:22:a1,304259042,480,-164,304258562,304259042
25547,5,12,149,5745,-68,-97,29,d2:00:04:7e:2c:ab,304261680,440,2198,304261240,304261680
25548,5,12,149,5745,-85,-97,12,9a:24:38:da:96:bb,304263528,824,1024,304262704,304263528
25549,5,12,149,5745,-90,-97,7,4e:72:d0:f1:a2:44,304265105,468,1109,304264637,304265105
25550,5,12,149,5745,-86,-97,11,9a:24:38:da:96:bb,304268476,272,3099,304268204,304268476
25551,5,12,149,5745,-63,-97,34,f6:0a:5c:59:72:df,304269504,280,748,304269224,304269504
25552,5,12,149,5745,-56,-97,41,3e:d1:9b:c7:a4:de,304270664,272,888,304270392,304270664
25553,5,12,149,5745,-73,-97,24,6a:1e:a4:f8:14:49,304271619,284,671,304271335,304271619
25554,5,12,149,5745,-75,-97,22,f2:da:61:dd:98:c5,304272694,268,807,304272426,304272694
25555,5,24,149,5745,-77,-97,20,,304286058,28,13336,304286030,304286058
25556,5,24,149,5745,-78,-97,19,,304286102,28,16,304286074,304286102
25557,5,24,149,5745,-78,-97,19,,304286211,32,77,304286179,304286211
25558,5,12,149,5745,-68,-97,29,5e:29:73:5b:30:00,304289227,272,2744,304288955,304289227
25559,5,12,149,5745,-58,-97,39,22:ec:75:a8:8a:31,304296572,244,7101,304296328,304296572
25560,5,24,149,5745,-78,-97,19,,304304684,28,8084,304304656,304304684
25561,5,24,149,5745,-77,-97,20,,304304728,28,16,304304700,304304728
25562,5,24,149,5745,-77,-97,20,,304304836,32,76,304304804,304304836
25563,5,6,149,5745,-90,-97,7,54:e4:3a:ec:fb:65,304316923,360,11727,304316563,304316923
25564,5,12,149,5745,-61,-97,36,a6:92:ad:b7:76:65,304317346,284,139,304317062,304317346
25565,5,12,149,5745,-63,-97,34,72:d1:72:1d:22:a1,304320509,284,2879,304320225,304320509
25566,5,12,149,5745,-53,-97,44,4a:86:35:36:74:b8,304328879,268,8102,304328611,304328879
25567,5,12,149,5745,-90,-97,7,4e:72:d0:f1:a2:44,304338213,272,9062,304337941,304338213
25568,5,12,149,5745,-62,-97,35,56:68:e2:c2:8d:d5,304341283,280,2790,304341003,304341283
25569,5,12,149,5745,-86,-97,11,7e:05:42:11:d2:ec,304358733,244,17206,304358489,304358733
25570,5,12,149,5745,-54,-97,43,3e:d1:9b:c7:a4:de,304371033,272,12028,304370761,304371033
25571,5,12,149,5745,-89,-97,8,9a:24:38:da:96:bb,304380615,272,9310,304380343,304380615
25572,5,12,149,5745,-66,-97,31,5e:29:73:5b:30:00,304383824,272,2937,304383552,304383824
25573,5,12,149,5745,-58,-97,39,22:ec:75:a8:8a:31,304414334,244,30266,304414090,304414334
25574,5,12,149,5745,-71,-97,26,6a:1e:a4:f8:14:49,304416475,284,1857,304416191,304416475
25575,5,12,149,5745,-66,-97,31,2a:07:ef:54:b5:55,304419657,244,2938,304419413,304419657
25576,5,12,149,5745,-75,-97,22,f2:da:61:dd:98:c5,304420381,268,456,304420113,304420381
25577,5,12,149,5745,-60,-97,37,a6:92:ad:b7:76:65,304442372,284,21707,304442088,304442372
25578,5,12,149,5745,-59,-97,38,b6:90:18:f6:b1:d4,304443810,268,1170,304443542,304443810
25579,5,12,149,5745,-65,-97,32,72:d1:72:1d:22:a1,304444150,284,56,304443866,304444150
25580,5,12,149,5745,-63,-97,34,56:68:e2:c2:8d:d5,304452540,280,8110,304452260,304452540
25581,5,12,149,5745,-92,-97,5,4e:72:d0:f1:a2:44,304453319,272,507,304453047,304453319
25582,5,12,149,5745,-91,-97,6,42:d2:d9:2b:ac:61,304457233,288,3626,304456945,304457233
25583,5,12,149,5745,-88,-97,9,de:be:a8:cd:79:57,304460847,284,3330,304460563,304460847
25584,5,12,149,5745,-87,-97,10,7e:05:42:11:d2:ec,304461712,244,621,304461468,304461712
25585,5,12,149,5745,-52,-97,45,3e:d1:9b:c7:a4:de,304487911,272,25927,304487639,304487911
25586,5,12,149,5745,-83,-97,14,9a:24:38:da:96:bb,304496447,272,8264,304496175,304496447
25587,5,12,149,5745,-69,-97,28,5e:29:73:5b:30:00,304499763,272,3044,304499491,304499763
25588,5,24,149,5745,-81,-97,16,,304515026,28,15235,304514998,304515026
25589,5,24,149,5745,-80,-97,17,,304515070,28,16,304515042,304515070
25590,5,24,149,5745,-80,-97,17,,304515179,32,77,304515147,304515179
25591,5,12,149,5745,-71,-97,26,6a:1e:a4:f8:14:49,304518916,284,3453,304518632,304518916
25592,5,6,149,5745,-89,-97,8,54:e4:3a:ec:fb:65,304521724,360,2448,304521364,304521724
25593,5,12,149,5745,-48,-97,49,4a:86:35:36:74:b8,304522478,268,486,304522210,304522478
25594,5,12,149,5745,-70,-97,27,f2:da:61:dd:98:c5,304522969,268,223,304522701,304522969
25595,5,12,149,5745,-66,-97,31,2a:07:ef:54:b5:55,304524159,244,946,304523915,304524159
25596,5,12,149,5745,-58,-97,39,22:ec:75:a8:8a:31,304531406,244,7003,304531162,304531406
25597,5,12,149,5745,-63,-97,34,f6:0a:5c:59:72:df,304532834,280,1148,304532554,304532834
25598,5,24,149,5745,-80,-97,17,,304534289,28,1427,304534261,304534289
25599,5,24,149,5745,-82,-97,15,,304534333,28,16,304534305,304534333
25600,5,24,149,5745,-81,-97,16,,304534441,32,76,304534409,304534441
25601,5,12,149,5745,-60,-97,37,a6:92:ad:b7:76:65,304544936,284,10211,304544652,304544936
25602,5,12,149,5745,-59,-97,38,b6:90:18:f6:b1:d4,304545835,268,631,304545567,304545835
25603,5,12,149,5745,-67,-97,30,72:d1:72:1d:22:a1,304546444,284,325,304546160,304546444
25604,5,12,149,5745,-48,-97,49,4a:86:35:36:74:b8,304555822,268,9110,304555554,304555822
25605,5,12,149,5745,-90,-97,7,42:d2:d9:2b:ac:61,304559472,288,3362,304559184,304559472
25606,5,12,149,5745,-88,-97,9,de:be:a8:cd:79:57,304563093,284,3337,304562809,304563093
25607,5,12,149,5745,-86,-97,11,7e:05:42:11:d2:ec,304564097,244,760,304563853,304564097
25608,5,12,149,5745,-64,-97,33,56:68:e2:c2:8d:d5,304564439,280,62,304564159,304564439
25609,5,24,149,5745,-63,-97,34,,304568007,28,3540,304567979,304568007
25610,5,24,149,5745,-81,-97,16,,304568052,28,17,304568024,304568052
25611,5,24,149,5745,-81,-97,16,,304568159,28,79,304568131,304568159
25612,5,12,149,5745,-94,-97,3,4e:72:d0:f1:a2:44,304568231,272,-200,304567959,304568231
25613,5,12,149,5745,-66,-97,31,2a:07:ef:54:b5:55,304585179,244,16704,304584935,304585179
25614,5,12,149,5745,-83,-97,14,9a:24:38:da:96:bb,304603966,272,18515,304603694,304603966
25615,5,12,149,5745,-53,-97,44,3e:d1:9b:c7:a4:de,304604849,272,611,304604577,304604849
25616,5,12,149,5745,-59,-97,38,b6:90:18:f6:b1:d4,304608219,268,3102,304607951,304608219
25617,5,12,149,5745,-71,-97,26,6a:1e:a4:f8:14:49,304614315,284,5812,304614031,304614315
25618,5,12,149,5745,-69,-97,28,f2:da:61:dd:98:c5,304618823,268,4240,304618555,304618823
25619,5,12,149,5745,-91,-97,6,3a:90:78:0e:4f:1f,304622926,256,3847,304622670,304622926
25620,5,6,149,5745,-89,-97,8,54:e4:3a:ec:fb:65,304624125,360,839,304623765,304624125
25621,5,24,149,5745,-81,-97,16,,304629200,28,5047,304629172,304629200
25622,5,24,149,5745,-81,-97,16,,304629244,28,16,304629216,304629244
25623,5,24,149,5745,-82,-97,15,,304629352,32,76,304629320,304629352
25624,5,24,149,5745,-81,-97,16,,304629575,28,195,304629547,304629575
25625,5,24,149,5745,-81,-97,16,,304629619,28,16,304629591,304629619
25626,5,24,149,5745,-81,-97,16,,304629727,32,76,304629695,304629727
25627,5,12,149,5745,-63,-97,34,f6:0a:5c:59:72:df,304632181,280,2174,304631901,304632181
25628,5,12,149,5745,-68,-97,29,5e:29:73:5b:30:00,304632523,272,70,304632251,304632523
25629,5,12,149,5745,-88,-97,9,de:be:a8:cd:79:57,304633590,284,783,304633306,304633590
25630,5,12,149,5745,-66,-97,31,2a:07:ef:54:b5:55,304635053,440,1023,304634613,304635053
25631,5,12,149,5745,-69,-97,28,f2:da:61:dd:98:c5,304635529,268,208,304635261,304635529
25632,5,24,149,5745,-82,-97,15,,304637781,28,2224,304637753,304637781
25633,5,24,149,5745,-81,-97,16,,304637825,28,16,304637797,304637825
25634,5,24,149,5745,-82,-97,15,,304637933,32,76,304637901,304637933
25635,5,12,149,5745,-66,-97,31,56:68:e2:c2:8d:d5,304639745,476,1336,304639269,304639745
25636,5,12,149,5745,-63,-97,34,f6:0a:5c:59:72:df,304640354,132,477,304640222,304640354
25637,5,12,149,5745,-60,-97,37,a6:92:ad:b7:76:65,304643121,484,2283,304642637,304643121
25638,5,12,149,5745,-87,-97,10,de:be:a8:cd:79:57,304644172,480,571,304643692,304644172
25639,5,12,149,5745,-68,-97,29,5e:29:73:5b:30:00,304645918,540,1206,304645378,304645918
25640,5,12,149,5745,-71,-97,26,6a:1e:a4:f8:14:49,304646951,480,553,304646471,304646951
25641,5,12,149,5745,-59,-97,38,b6:90:18:f6:b1:d4,304648609,268,1390,304648341,304648609
25642,5,12,149,5745,-60,-97,37,a6:92:ad:b7:76:65,304648956,284,63,304648672,304648956
25643,5,12,149,5745,-67,-97,30,72:d1:72:1d:22:a1,304649275,284,35,304648991,304649275
25644,5,12,149,5745,-59,-97,38,22:ec:75:a8:8a:31,304649840,516,49,304649324,304649840
25645,5,12,149,5745,-48,-97,49,4a:86:35:36:74:b8,304650940,268,832,304650672,304650940
25646,5,12,149,5745,-54,-97,43,3e:d1:9b:c7:a4:de,304651810,544,326,304651266,304651810
25647,5,12,149,5745,-67,-97,30,72:d1:72:1d:22:a1,304653676,480,1386,304653196,304653676
25648,5,12,149,5745,-86,-97,11,9a:24:38:da:96:bb,304657370,824,2870,304656546,304657370
25649,5,12,149,5745,-91,-97,6,42:d2:d9:2b:ac:61,304658511,288,853,304658223,304658511
25650,5,12,149,5745,-59,-97,38,22:ec:75:a8:8a:31,304662604,244,3849,304662360,304662604
25651,5,12,149,5745,-64,-97,33,56:68:e2:c2:8d:d5,304664187,280,1303,304663907,304664187
25652,5,12,149,5745,-48,-97,49,4a:86:35:36:74:b8,304665475,268,1020,304665207,304665475
25653,5,12,149,5745,-67,-97,30,2a:07:ef:54:b5:55,304696127,244,30408,304695883,304696127
25654,5,12,149,5745,-68,-97,29,5e:29:73:5b:30:00,304697500,540,833,304696960,304697500
25655,5,12,149,5745,-70,-97,27,f2:da:61:dd:98:c5,304699300,268,1532,304699032,304699300
25656,5,12,149,5745,-60,-97,37,22:ec:75:a8:8a:31,304699647,516,-169,304699131,304699647
25657,5,24,149,5745,-81,-97,16,,304700192,28,517,304700164,304700192
25658,5,24,149,5745,-82,-97,15,,304700236,28,16,304700208,304700236
25659,5,24,149,5745,-81,-97,16,,304700345,32,77,304700313,304700345
25660,5,12,149,5745,-68,-97,29,2a:07:ef:54:b5:55,304701731,440,946,304701291,304701731
25661,5,12,149,5745,-59,-97,38,a6:92:ad:b7:76:65,304707937,484,5722,304707453,304707937
25662,5,24,149,5745,-81,-97,16,,304714933,28,6968,304714905,304714933
25663,5,24,149,5745,-82,-97,15,,304714977,28,16,304714949,304714977
25664,5,24,149,5745,-82,-97,15,,304715085,32,76,304715053,304715085
25665,5,12,149,5745,-59,-97,38,b6:90:18:f6:b1:d4,304719434,268,4081,304719166,304719434
25666,5,12,149,5745,-58,-97,39,3e:d1:9b:c7:a4:de,304722131,272,2425,304721859,304722131
25667,5,6,149,5745,-89,-97,8,54:e4:3a:ec:fb:65,304726525,360,4034,304726165,304726525
25668,5,12,149,5745,-72,-97,25,6a:1e:a4:f8:14:49,304727009,284,200,304726725,304727009
25669,5,24,149,5745,-80,-97,17,,304729183,28,2146,304729155,304729183
25670,5,24,149,5745,-81,-97,16,,304729227,28,16,304729199,304729227
25671,5,24,149,5745,-81,-97,16,,304729335,32,76,304729303,304729335
25672,5,24,149,5745,-81,-97,16,,304729580,28,217,304729552,304729580
25673,5,24,149,5745,-81,-97,16,,304729625,28,17,304729597,304729625
25674,5,24,149,5745,-81,-97,16,,304729732,32,75,304729700,304729732
25675,5,12,149,5745,-70,-97,27,f2:da:61:dd:98:c5,304731373,268,1373,304731105,304731373
25676,5,24,149,5745,-81,-97,16,,304732319,28,918,304732291,304732319
25677,5,24,149,5745,-80,-97,17,,304732363,28,16,304732335,304732363
25678,5,24,149,5745,-81,-97,16,,304732472,32,77,304732440,304732472
25679,5,24,149,5745,-82,-97,15,,304733409,28,909,304733381,304733409
25680,5,24,149,5745,-81,-97,16,,304733454,28,17,304733426,304733454
25681,5,24,149,5745,-81,-97,16,,304733566,32,80,304733534,304733566
25682,5,24,149,5745,-81,-97,16,,304737753,28,4159,304737725,304737753
25683,5,24,149,5745,-80,-97,17,,304738041,28,260,304738013,304738041
25684,5,12,149,5745,-90,-97,7,de:be:a8:cd:79:57,304738103,284,-222,304737819,304738103
25685,5,24,149,5745,-81,-97,16,,304738491,28,360,304738463,304738491
25686,5,24,149,5745,-81,-97,16,,304739229,28,710,304739201,304739229
25687,5,24,149,5745,-81,-97,16,,304739787,28,530,304739759,304739787
25688,5,24,149,5745,-81,-97,16,,304739831,28,16,304739803,304739831
25689,5,24,149,5745,-81,-97,16,,304739943,32,80,304739911,304739943
25690,5,12,149,5745,-68,-97,29,5e:29:73:5b:30:00,304747416,272,7201,304747144,304747416
25691,5,24,149,5745,-81,-97,16,,304747741,28,297,304747713,304747741
25692,5,24,149,5745,-81,-97,16,,304747785,28,16,304747757,304747785
25693,5,24,149,5745,-81,-97,16,,304747893,32,76,304747861,304747893
25694,5,12,149,5745,-88,-97,9,9a:24:38:da:96:bb,304750355,272,2190,304750083,304750355
25695,5,24,149,5745,-81,-97,16,,304755769,28,5386,304755741,304755769
25696,5,24,149,5745,-80,-97,17,,304755813,28,16,304755785,304755813
25697,5,24,149,5745,-81,-97,16,,304755922,32,77,304755890,304755922
25698,5,24,149,5745,-81,-97,16,,304757788,28,1838,304757760,304757788
25699,5,24,149,5745,-81,-97,16,,304757832,28,16,304757804,304757832
25700,5,24,149,5745,-81,-97,16,,304757941,32,77,304757909,304757941
25701,5,24,149,5745,-82,-97,15,,304758001,28,32,304757973,304758001
25702,5,24,149,5745,-81,-97,16,,304758046,28,17,304758018,304758046
25703,5,24,149,5745,-81,-97,16,,304758154,32,76,304758122,304758154
25704,5,24,149,5745,-80,-97,17,,304763235,28,5053,304763207,304763235
25705,5,24,149,5745,-81,-97,16,,304763279,28,16,304763251,304763279
25706,5,24,149,5745,-81,-97,16,,304763387,32,76,304763355,304763387
25707,5,12,149,5745,-71,-97,26,f2:da:61:dd:98:c5,304764513,268,858,304764245,304764513
25708,5,12,149,5745,-59,-97,38,22:ec:75:a8:8a:31,304764941,516,-88,304764425,304764941
25709,5,12,149,5745,-69,-97,28,2a:07:ef:54:b5:55,304766022,440,641,304765582,304766022
25710,5,12,149,5745,-63,-97,34,0a:b9:b7:b1:4d:fa,304766577,268,287,304766309,304766577
25711,5,24,149,5745,-81,-97,16,,304766874,28,269,304766846,304766874
25712,5,24,149,5745,-80,-97,17,,304766919,28,17,304766891,304766919
25713,5,24,149,5745,-81,-97,16,,304767027,32,76,304766995,304767027
25714,5,12,149,5745,-87,-97,10,9a:24:38:da:96:bb,304767584,824,-267,304766760,304767584
25715,5,24,149,5745,-80,-97,17,,304771753,28,4141,304771725,304771753
25716,5,24,149,5745,-80,-97,17,,304771798,28,17,304771770,304771798
25717,5,24,149,5745,-81,-97,16,,304771906,32,76,304771874,304771906
25718,5,12,149,5745,-59,-97,38,a6:92:ad:b7:76:65,304774035,484,1645,304773551,304774035
25719,5,12,149,5745,-89,-97,8,de:be:a8:cd:79:57,304774671,480,156,304774191,304774671
25720,5,24,149,5745,-81,-97,16,,304776128,28,1429,304776100,304776128
25721,5,24,149,5745,-80,-97,17,,304776172,28,16,304776144,304776172
25722,5,24,149,5745,-81,-97,16,,304776284,32,80,304776252,304776284
25723,5,12,149,5745,-90,-97,7,42:d2:d9:2b:ac:61,304776942,288,370,304776654,304776942
25724,5,12,149,5745,-59,-97,38,22:ec:75:a8:8a:31,304777284,244,98,304777040,304777284
25725,5,12,149,5745,-67,-97,30,d2:00:04:7e:2c:ab,304777582,412,-114,304777170,304777582
25726,5,12,149,5745,-59,-97,38,b6:90:18:f6:b1:d4,304781153,268,3303,304780885,304781153
25727,5,12,149,5745,-59,-97,38,3e:d1:9b:c7:a4:de,304783219,544,1522,304782675,304783219
25728,5,12,149,5745,-87,-97,10,7e:05:42:11:d2:ec,304783842,440,183,304783402,304783842
25729,5,24,149,5745,-79,-97,18,,304785374,28,1504,304785346,304785374
25730,5,24,149,5745,-81,-97,16,,304785418,28,16,304785390,304785418
25731,5,24,149,5745,-82,-97,15,,304785526,32,76,304785494,304785526
25732,5,12,149,5745,-70,-97,27,2a:07:ef:54:b5:55,304794379,244,8609,304794135,304794379
25733,5,24,149,5745,-80,-97,17,,304795169,28,762,304795141,304795169
25734,5,24,149,5745,-81,-97,16,,304795214,28,17,304795186,304795214
25735,5,24,149,5745,-81,-97,16,,304795321,32,75,304795289,304795321
25736,5,24,149,5745,-81,-97,16,,304797942,28,2593,304797914,304797942
25737,5,24,149,5745,-81,-97,16,,304797986,28,16,304797958,304797986
25738,5,24,149,5745,-81,-97,16,,304798095,32,77,304798063,304798095
25739,5,12,149,5745,-69,-97,28,5e:29:73:5b:30:00,304828548,540,29913,304828008,304828548
25740,5,12,149,5745,-85,-97,12,9a:24:38:da:96:bb,304829144,272,324,304828872,304829144
25741,5,12,149,5745,-58,-97,39,22:ec:75:a8:8a:31,304830978,516,1318,304830462,304830978
25742,5,12,149,5745,-69,-97,28,6a:1e:a4:f8:14:49,304837691,284,6429,304837407,304837691
25743,5,12,149,5745,-56,-97,41,3e:d1:9b:c7:a4:de,304838028,272,65,304837756,304838028
25744,5,24,149,5745,-80,-97,17,,304838361,28,305,304838333,304838361
25745,5,24,149,5745,-81,-97,16,,304838405,28,16,304838377,304838405
25746,5,24,149,5745,-81,-97,16,,304838513,32,76,304838481,304838513
25747,5,12,149,5745,-59,-97,38,b6:90:18:f6:b1:d4,304839900,268,1119,304839632,304839900
25748,5,12,149,5745,-69,-97,28,5e:29:73:5b:30:00,304845485,272,5313,304845213,304845485
25749,5,12,149,5745,-71,-97,26,f2:da:61:dd:98:c5,304852120,268,6367,304851852,304852120
25750,5,12,149,5745,-70,-97,27,72:d1:72:1d:22:a1,304853743,284,1339,304853459,304853743
25751,5,12,149,5745,-65,-97,32,56:68:e2:c2:8d:d5,304855634,280,1611,304855354,304855634
25752,5,24,149,5745,-80,-97,17,,304858132,28,2470,304858104,304858132
25753,5,24,149,5745,-81,-97,16,,304858177,28,17,304858149,304858177
25754,5,24,149,5745,-81,-97,16,,304858285,32,76,304858253,304858285
25755,5,24,149,5745,-81,-97,16,,304858460,28,147,304858432,304858460
25756,5,24,149,5745,-81,-97,16,,304858505,28,17,304858477,304858505
25757,5,24,149,5745,-81,-97,16,,304858613,32,76,304858581,304858613
25758,5,24,149,5745,-81,-97,16,,304861134,28,2493,304861106,304861134
25759,5,24,149,5745,-80,-97,17,,304861178,28,16,304861150,304861178
25760,5,24,149,5745,-80,-97,17,,304861291,32,81,304861259,304861291
25761,5,12,149,5745,-89,-97,8,de:be:a8:cd:79:57,304865952,284,4377,304865668,304865952
25762,5,12,149,5745,-59,-97,38,f6:0a:5c:59:72:df,304871555,280,5323,304871275,304871555
25763,5,12,149,5745,-59,-97,38,22:ec:75:a8:8a:31,304875964,244,4165,304875720,304875964
25764,5,12,149,5745,-69,-97,28,5e:29:73:5b:30:00,304894103,540,17599,304893563,304894103
25765,5,12,149,5745,-59,-97,38,22:ec:75:a8:8a:31,304896576,516,1957,304896060,304896576
25766,5,6,149,5745,-83,-97,14,70:bc:10:5f:b5:61,304908781,124,12081,304908657,304908781
25767,5,6,149,5745,-83,-97,14,70:bc:10:5f:b5:61,304908981,124,76,304908857,304908981
25768,5,6,149,5745,-90,-97,7,54:e4:3a:ec:fb:65,304909194,352,-139,304908842,304909194
25769,5,6,149,5745,-84,-97,13,,304909561,44,323,304909517,304909561
25770,5,6,149,5745,-91,-97,6,54:e4:3a:ec:fb:65,304910724,352,811,304910372,304910724
25771,5,6,149,5745,-83,-97,14,,304911092,44,324,304911048,304911092
25772,5,6,149,5745,-90,-97,7,54:e4:3a:ec:fb:65,304931326,360,19874,304930966,304931326
25773,5,12,149,5745,-71,-97,26,2a:07:ef:54:b5:55,304932965,244,1395,304932721,304932965
25774,5,12,149,5745,-57,-97,40,b6:90:18:f6:b1:d4,304945163,268,11930,304944895,304945163
25775,5,12,149,5745,-60,-97,37,a6:92:ad:b7:76:65,304954479,284,9032,304954195,304954479
25776,5,12,149,5745,-53,-97,44,3e:d1:9b:c7:a4:de,304954797,272,46,304954525,304954797
25777,5,12,149,5745,-69,-97,28,72:d1:72:1d:22:a1,304956036,284,955,304955752,304956036
25778,5,12,149,5745,-66,-97,31,56:68:e2:c2:8d:d5,304958064,280,1748,304957784,304958064
25779,5,12,149,5745,-70,-97,27,5e:29:73:5b:30:00,304959639,540,1035,304959099,304959639
25780,5,12,149,5745,-70,-97,27,5e:29:73:5b:30:00,304960196,272,285,304959924,304960196
25781,5,24,149,5745,-84,-97,13,,304960538,28,314,304960510,304960538
25782,5,24,149,5745,-79,-97,18,,304960582,28,16,304960554,304960582
25783,5,24,149,5745,-80,-97,17,,304960691,32,77,304960659,304960691
25784,5,12,149,5745,-60,-97,37,22:ec:75:a8:8a:31,304962017,516,810,304961501,304962017
25785,5,12,149,5745,-60,-97,37,f6:0a:5c:59:72:df,304962902,280,605,304962622,304962902
25786,5,24,149,5745,-79,-97,18,,304978467,28,15537,304978439,304978467
25787,5,24,149,5745,-83,-97,14,,304978511,28,16,304978483,304978511
25788,5,24,149,5745,-83,-97,14,,304978619,32,76,304978587,304978619
25789,5,12,149,5745,-86,-97,11,de:be:a8:cd:79:57,304978685,284,-218,304978401,304978685
25790,5,12,149,5745,-89,-97,8,7e:05:42:11:d2:ec,304981615,440,2490,304981175,304981615
25791,5,12,149,5745,-59,-97,38,22:ec:75:a8:8a:31,304990377,244,8518,304990133,304990377
25792,5,24,149,5745,-83,-97,14,,304993151,28,2746,304993123,304993151
25793,5,24,149,5745,-79,-97,18,,304993195,28,16,304993167,304993195
25794,5,24,149,5745,-79,-97,18,,304993304,32,77,304993272,304993304
25795,5,24,149,5745,-79,-97,18,,305010813,28,17481,305010785,305010813
25796,5,24,149,5745,-83,-97,14,,305010858,28,17,305010830,305010858
25797,5,24,149,5745,-83,-97,14,,305010965,32,75,305010933,305010965
25798,5,12,149,5745,-93,-97,4,4e:72:d0:f1:a2:44,305021670,268,10437,305021402,305021670
25799,5,12,149,5745,-93,-97,4,46:28:71:6e:d2:2e,305024745,252,2823,305024493,305024745
25800,5,12,149,5745,-69,-97,28,6a:1e:a4:f8:14:49,305030885,284,5856,305030601,305030885
25801,5,12,149,5745,-72,-97,25,2a:07:ef:54:b5:55,305033509,244,2380,305033265,305033509
25802,5,12,149,5745,-73,-97,24,f2:da:61:dd:98:c5,305034744,268,967,305034476,305034744
25803,5,12,149,5745,-85,-97,12,9a:24:38:da:96:bb,305055344,272,20328,305055072,305055344
25804,5,12,149,5745,-59,-97,38,a6:92:ad:b7:76:65,305057061,284,1433,305056777,305057061
25805,5,12,149,5745,-58,-97,39,b6:90:18:f6:b1:d4,305057542,268,213,305057274,305057542
25806,5,12,149,5745,-66,-97,31,72:d1:72:1d:22:a1,305057918,284,92,305057634,305057918
25807,5,12,149,5745,-67,-97,30,56:68:e2:c2:8d:d5,305060504,280,2306,305060224,305060504
25808,5,12,149,5745,-68,-97,29,5e:29:73:5b:30:00,305067896,272,7120,305067624,305067896
25809,5,12,149,5745,-54,-97,43,3e:d1:9b:c7:a4:de,305071634,272,3466,305071362,305071634
25810,5,24,149,5745,-63,-97,34,,305075093,28,3431,305075065,305075093
25811,5,24,149,5745,-81,-97,16,,305075137,28,16,305075109,305075137
25812,5,24,149,5745,-81,-97,16,,305075246,28,81,305075218,305075246
25813,5,12,149,5745,-86,-97,11,de:be:a8:cd:79:57,305086583,284,11053,305086299,305086583
25814,5,12,149,5745,-60,-97,37,22:ec:75:a8:8a:31,305095736,244,8909,305095492,305095736
25815,5,12,149,5745,-71,-97,26,6a:1e:a4:f8:14:49,305132714,284,36694,305132430,305132714
25816,5,6,149,5745,-89,-97,8,54:e4:3a:ec:fb:65,305136127,360,3053,305135767,305136127
25817,5,12,149,5745,-69,-97,28,f2:da:61:dd:98:c5,305136988,268,593,305136720,305136988
25818,5,12,149,5745,-71,-97,26,2a:07:ef:54:b5:55,305152665,244,15433,305152421,305152665
25819,5,12,149,5745,-62,-97,35,a6:92:ad:b7:76:65,305160268,284,7319,305159984,305160268
25820,5,12,149,5745,-64,-97,33,72:d1:72:1d:22:a1,305160947,284,395,305160663,305160947
25821,5,12,149,5745,-68,-97,29,56:68:e2:c2:8d:d5,305162048,280,821,305161768,305162048
25822,5,12,149,5745,-58,-97,39,b6:90:18:f6:b1:d4,305171095,268,8779,305170827,305171095
25823,5,12,149,5745,-91,-97,6,42:d2:d9:2b:ac:61,305173955,288,2572,305173667,305173955
25824,5,12,149,5745,-69,-97,28,6a:1e:a4:f8:14:49,305179320,284,5081,305179036,305179320
25825,5,12,149,5745,-67,-97,30,5e:29:73:5b:30:00,305179907,272,315,305179635,305179907
25826,5,24,149,5745,-81,-97,16,,305181929,28,1994,305181901,305181929
25827,5,24,149,5745,-81,-97,16,,305182253,28,296,305182225,305182253
25828,5,24,149,5745,-80,-97,17,,305182297,28,16,305182269,305182297
25829,5,24,149,5745,-81,-97,16,,305182405,32,76,305182373,305182405
25830,5,12,149,5745,-58,-97,39,3e:d1:9b:c7:a4:de,305183587,272,910,305183315,305183587
25831,5,12,149,5745,-69,-97,28,f2:da:61:dd:98:c5,305191212,268,7357,305190944,305191212
25832,5,12,149,5745,-88,-97,9,de:be:a8:cd:79:57,305194190,284,2694,305193906,305194190
25833,5,24,149,5745,-80,-97,17,,305201102,28,6884,305201074,305201102
25834,5,24,149,5745,-81,-97,16,,305201146,28,16,305201118,305201146
25835,5,24,149,5745,-81,-97,16,,305201254,32,76,305201222,305201254
25836,5,12,149,5745,-61,-97,36,a6:92:ad:b7:76:65,305205428,284,3890,305205144,305205428
25837,5,24,149,5745,-81,-97,16,,305216219,28,10763,305216191,305216219
25838,5,24,149,5745,-80,-97,17,,305216264,28,17,305216236,305216264
25839,5,24,149,5745,-80,-97,17,,305216372,32,76,305216340,305216372
25840,5,12,149,5745,-58,-97,39,22:ec:75:a8:8a:31,305219750,244,3134,305219506,305219750
25841,5,12,149,5745,-61,-97,36,f6:0a:5c:59:72:df,305221550,280,1520,305221270,305221550
25842,5,12,149,5745,-66,-97,31,5e:29:73:5b:30:00,305221916,540,-174,305221376,305221916
25843,5,12,149,5745,-64,-97,33,72:d1:72:1d:22:a1,305223113,284,913,305222829,305223113
25844,5,12,149,5745,-71,-97,26,f2:da:61:dd:98:c5,305223431,268,50,305223163,305223431
25845,5,12,149,5745,-58,-97,39,22:ec:75:a8:8a:31,305224322,516,375,305223806,305224322
25846,5,12,149,5745,-67,-97,30,2a:07:ef:54:b5:55,305225538,440,776,305225098,305225538
25847,5,12,149,5745,-66,-97,31,56:68:e2:c2:8d:d5,305228298,476,2284,305227822,305228298
25848,5,12,149,5745,-90,-97,7,3a:90:78:0e:4f:1f,305229311,284,729,305229027,305229311
25849,5,12,149,5745,-60,-97,37,a6:92:ad:b7:76:65,305232223,484,2428,305231739,305232223
25850,5,12,149,5745,-89,-97,8,42:d2:d9:2b:ac:61,305234043,288,1532,305233755,305234043
25851,5,24,149,5745,-80,-97,17,,305234390,28,319,305234362,305234390
25852,5,24,149,5745,-82,-97,15,,305234434,28,16,305234406,305234434
25853,5,24,149,5745,-82,-97,15,,305234542,32,76,305234510,305234542
25854,5,12,149,5745,-87,-97,10,de:be:a8:cd:79:57,305234645,284,-181,305234361,305234645
25855,5,12,149,5745,-69,-97,28,6a:1e:a4:f8:14:49,305237098,480,1973,305236618,305237098
25856,5,12,149,5745,-66,-97,31,56:68:e2:c2:8d:d5,305237613,280,235,305237333,305237613
25857,5,12,149,5745,-92,-97,5,46:28:71:6e:d2:2e,305238925,252,1060,305238673,305238925
25858,5,12,149,5745,-93,-97,4,4e:72:d0:f1:a2:44,305239213,268,20,305238945,305239213
25859,5,12,149,5745,-57,-97,40,b6:90:18:f6:b1:d4,305239533,268,52,305239265,305239533
25860,5,12,149,5745,-61,-97,36,3e:d1:9b:c7:a4:de,305239862,544,-215,305239318,305239862
25861,5,12,149,5745,-64,-97,33,72:d1:72:1d:22:a1,305243339,480,2997,305242859,305243339
25862,5,12,149,5745,-68,-97,29,2a:07:ef:54:b5:55,305253098,244,9515,305252854,305253098
25863,5,12,149,5745,-91,-97,6,4e:72:d0:f1:a2:44,305270606,268,17240,305270338,305270606
25864,5,12,149,5745,-56,-97,41,b6:90:18:f6:b1:d4,305271249,268,375,305270981,305271249
25865,5,12,149,5745,-86,-97,11,9a:24:38:da:96:bb,305276580,272,5059,305276308,305276580
25866,5,12,149,5745,-61,-97,36,f6:0a:5c:59:72:df,305286446,280,9586,305286166,305286446
25867,5,12,149,5745,-67,-97,30,5e:29:73:5b:30:00,305286860,540,-126,305286320,305286860
25868,5,12,149,5745,-72,-97,25,6a:1e:a4:f8:14:49,305287479,284,335,305287195,305287479
25869,5,12,149,5745,-75,-97,22,f2:da:61:dd:98:c5,305288499,268,752,305288231,305288499
25870,5,12,149,5745,-57,-97,40,22:ec:75:a8:8a:31,305289475,516,460,305288959,305289475
25871,5,12,149,5745,-90,-97,7,3a:90:78:0e:4f:1f,305290349,284,590,305290065,305290349
25872,5,12,149,5745,-71,-97,26,2a:07:ef:54:b5:55,305290988,440,199,305290548,305290988
25873,5,12,149,5745,-64,-97,33,56:68:e2:c2:8d:d5,305291489,476,25,305291013,305291489
25874,5,12,149,5745,-90,-97,7,3a:90:78:0e:4f:1f,305292090,132,469,305291958,305292090
25875,5,12,149,5745,-64,-97,33,0a:b9:b7:b1:4d:fa,305292360,268,2,305292092,305292360
25876,5,12,149,5745,-86,-97,11,9a:24:38:da:96:bb,305292782,824,-402,305291958,305292782
25877,5,12,149,5745,-90,-97,7,42:d2:d9:2b:ac:61,305294345,132,1431,305294213,305294345
25878,5,12,149,5745,-62,-97,35,f6:0a:5c:59:72:df,305294768,132,291,305294636,305294768
25879,5,12,149,5745,-89,-97,8,42:d2:d9:2b:ac:61,305296480,288,1424,305296192,305296480
25880,5,12,149,5745,-59,-97,38,a6:92:ad:b7:76:65,305298081,484,1117,305297597,305298081
25881,5,12,149,5745,-89,-97,8,3a:90:78:0e:4f:1f,305299330,284,965,305299046,305299330
25882,5,12,149,5745,-87,-97,10,de:be:a8:cd:79:57,305300747,284,1133,305300463,305300747
25883,5,12,149,5745,-71,-97,26,6a:1e:a4:f8:14:49,305302266,480,1039,305301786,305302266
25884,5,12,149,5745,-59,-97,38,3e:d1:9b:c7:a4:de,305302825,272,287,305302553,305302825
25885,5,12,149,5745,-55,-97,42,b6:90:18:f6:b1:d4,305304078,268,985,305303810,305304078
25886,5,12,149,5745,-68,-97,29,5e:29:73:5b:30:00,305304435,272,85,305304163,305304435
25887,5,12,149,5745,-59,-97,38,3e:d1:9b:c7:a4:de,305304741,544,-238,305304197,305304741
25888,5,12,149,5745,-63,-97,34,72:d1:72:1d:22:a1,305307140,480,1919,305306660,305307140
25889,5,12,149,5745,-87,-97,10,7e:05:42:11:d2:ec,305307751,440,171,305307311,305307751
25890,5,12,149,5745,-60,-97,37,a6:92:ad:b7:76:65,305319801,284,11766,305319517,305319801
25891,5,12,149,5745,-63,-97,34,72:d1:72:1d:22:a1,305321380,284,1295,305321096,305321380
25892,5,12,149,5745,-57,-97,40,22:ec:75:a8:8a:31,305334685,244,13061,305334441,305334685
25893,5,12,149,5745,-64,-97,33,56:68:e2:c2:8d:d5,305336889,280,1924,305336609,305336889
25894,5,12,149,5745,-90,-97,7,42:d2:d9:2b:ac:61,305338301,288,1124,305338013,305338301
25895,5,6,149,5745,-88,-97,9,54:e4:3a:ec:fb:65,305340928,360,2267,305340568,305340928
25896,5,12,149,5745,-68,-97,29,5e:29:73:5b:30:00,305352845,540,11377,305352305,305352845
25897,5,12,149,5745,-57,-97,40,22:ec:75:a8:8a:31,305355282,516,1921,305354766,305355282
25898,5,12,149,5745,-93,-97,4,46:28:71:6e:d2:2e,305363773,252,8239,305363521,305363773
25899,5,12,149,5745,-67,-97,30,2a:07:ef:54:b5:55,305373949,244,9932,305373705,305373949
25900,5,12,149,5745,-87,-97,10,9a:24:38:da:96:bb,305390236,272,16015,305389964,305390236
25901,5,12,149,5745,-69,-97,28,6a:1e:a4:f8:14:49,305404403,284,13883,305404119,305404403
25902,5,24,149,5745,-79,-97,18,,305407717,28,3286,305407689,305407717
25903,5,24,149,5745,-79,-97,18,,305407761,28,16,305407733,305407761
25904,5,24,149,5745,-79,-97,18,,305407870,32,77,305407838,305407870
25905,5,12,149,5745,-55,-97,42,3e:d1:9b:c7:a4:de,305412897,272,4755,305412625,305412897
25906,5,12,149,5745,-66,-97,31,f2:da:61:dd:98:c5,305414913,268,1748,305414645,305414913
25907,5,12,149,5745,-69,-97,28,5e:29:73:5b:30:00,305418722,540,3269,305418182,305418722
25908,5,12,149,5745,-69,-97,28,5e:29:73:5b:30:00,305419279,272,285,305419007,305419279
25909,5,12,149,5745,-56,-97,41,22:ec:75:a8:8a:31,305420863,516,1068,305420347,305420863
25910,5,12,149,5745,-63,-97,34,f6:0a:5c:59:72:df,305423178,280,2035,305422898,305423178
25911,5,24,149,5745,-79,-97,18,,305425778,28,2572,305425750,305425778
25912,5,24,149,5745,-80,-97,17,,305425822,28,16,305425794,305425822
25913,5,24,149,5745,-79,-97,18,,305425930,32,76,305425898,305425930
25914,5,24,149,5745,-80,-97,17,,305437698,28,11740,305437670,305437698
25915,5,24,149,5745,-79,-97,18,,305437742,28,16,305437714,305437742
25916,5,24,149,5745,-80,-97,17,,305437850,32,76,305437818,305437850
25917,5,6,149,5745,-90,-97,7,54:e4:3a:ec:fb:65,305443329,360,5119,305442969,305443329
25918,5,12,149,5745,-56,-97,41,22:ec:75:a8:8a:31,305449071,244,5498,305448827,305449071
25919,5,24,149,5745,-81,-97,16,,305455423,28,6324,305455395,305455423
25920,5,24,149,5745,-79,-97,18,,305455467,28,16,305455439,305455467
25921,5,24,149,5745,-80,-97,17,,305455575,32,76,305455543,305455575
25922,5,12,149,5745,-91,-97,6,42:d2:d9:2b:ac:61,305463309,288,7446,305463021,305463309
25923,5,12,149,5745,-62,-97,35,a6:92:ad:b7:76:65,305466712,284,3119,305466428,305466712
25924,5,24,149,5745,-70,-97,27,,305467140,28,400,305467112,305467140
25925,5,24,149,5745,-80,-97,17,,305467184,28,16,305467156,305467184
25926,5,24,149,5745,-80,-97,17,,305467292,32,76,305467260,305467292
25927,5,24,149,5745,-72,-97,25,,305467420,28,100,305467392,305467420
25928,5,24,149,5745,-80,-97,17,,305467464,28,16,305467436,305467464
25929,5,24,149,5745,-72,-97,25,,305467588,28,96,305467560,305467588
25930,5,24,149,5745,-80,-97,17,,305467632,28,16,305467604,305467632
25931,5,24,149,5745,-80,-97,17,,305467740,32,76,305467708,305467740
25932,5,12,149,5745,-68,-97,29,72:d1:72:1d:22:a1,305467891,284,-133,305467607,305467891
25933,5,12,149,5745,-59,-97,38,b6:90:18:f6:b1:d4,305468249,268,90,305467981,305468249
25934,5,12,149,5745,-68,-97,29,56:68:e2:c2:8d:d5,305470063,280,1534,305469783,305470063
25935,5,12,149,5745,-90,-97,7,4e:72:d0:f1:a2:44,305479809,268,9478,305479541,305479809
25936,5,12,149,5745,-70,-97,27,5e:29:73:5b:30:00,305483926,540,3577,305483386,305483926
25937,5,12,149,5745,-57,-97,40,22:ec:75:a8:8a:31,305485813,516,1371,305485297,305485813
25938,5,12,149,5745,-86,-97,11,7e:05:42:11:d2:ec,305503431,440,17178,305502991,305503431
25939,5,12,149,5745,-86,-97,11,9a:24:38:da:96:bb,305505041,272,1338,305504769,305505041
25940,5,24,149,5745,-79,-97,18,,305520814,28,15745,305520786,305520814
25941,5,24,149,5745,-73,-97,24,,305520858,28,16,305520830,305520858
25942,5,24,149,5745,-72,-97,25,,305520966,32,76,305520934,305520966
25943,5,12,149,5745,-58,-97,39,3e:d1:9b:c7:a4:de,305527263,272,6025,305526991,305527263
25944,5,12,149,5745,-67,-97,30,5e:29:73:5b:30:00,305533887,272,6352,305533615,305533887
25945,5,12,149,5745,-69,-97,28,6a:1e:a4:f8:14:49,305542859,284,8688,305542575,305542859
25946,5,12,149,5745,-59,-97,38,22:ec:75:a8:8a:31,305545777,244,2674,305545533,305545777
25947,5,12,149,5745,-69,-97,28,f2:da:61:dd:98:c5,305546702,268,657,305546434,305546702
25948,5,12,149,5745,-71,-97,26,2a:07:ef:54:b5:55,305547941,244,995,305547697,305547941
25949,5,24,149,5745,-63,-97,34,,305566131,28,18162,305566103,305566131
25950,5,24,149,5745,-78,-97,19,,305566176,28,17,305566148,305566176
25951,5,24,149,5745,-79,-97,18,,305566284,28,80,305566256,305566284
25952,5,12,149,5745,-64,-97,33,a6:92:ad:b7:76:65,305568378,284,1810,305568094,305568378
25953,5,12,149,5745,-57,-97,40,b6:90:18:f6:b1:d4,305570104,268,1458,305569836,305570104
25954,5,12,149,5745,-69,-97,28,72:d1:72:1d:22:a1,305570699,284,311,305570415,305570699
25955,5,12,149,5745,-67,-97,30,56:68:e2:c2:8d:d5,305571512,280,533,305571232,305571512
25956,5,12,149,5745,-91,-97,6,42:d2:d9:2b:ac:61,305576244,288,4444,305575956,305576244
25957,5,12,149,5745,-89,-97,8,de:be:a8:cd:79:57,305587020,284,10492,305586736,305587020
25958,5,12,149,5745,-90,-97,7,46:28:71:6e:d2:2e,305589742,252,2470,305589490,305589742
25959,5,12,149,5745,-89,-97,8,4e:72:d0:f1:a2:44,305593686,268,3676,305593418,305593686
25960,5,12,149,5745,-85,-97,12,9a:24:38:da:96:bb,305613561,272,19603,305613289,305613561
25961,5,12,149,5745,-57,-97,40,b6:90:18:f6:b1:d4,305621738,268,7909,305621470,305621738
25962,5,12,149,5745,-64,-97,33,5e:29:73:5b:30:00,305633347,272,11337,305633075,305633347
25963,5,12,149,5745,-56,-97,41,3e:d1:9b:c7:a4:de,305640115,272,6496,305639843,305640115
25964,5,12,149,5745,-72,-97,25,6a:1e:a4:f8:14:49,305645311,284,4912,305645027,305645311
25965,5,12,149,5745,-67,-97,30,2a:07:ef:54:b5:55,305647496,244,1941,305647252,305647496
25966,5,6,149,5745,-91,-97,6,54:e4:3a:ec:fb:65,305648130,360,274,305647770,305648130
25967,5,12,149,5745,-68,-97,29,f2:da:61:dd:98:c5,305648760,268,362,305648492,305648760
25968,5,12,149,5745,-90,-97,7,de:be:a8:cd:79:57,305656295,284,7251,305656011,305656295
25969,5,24,149,5745,-77,-97,20,,305663271,28,6948,305663243,305663271
25970,5,24,149,5745,-80,-97,17,,305663315,28,16,305663287,305663315
25971,5,24,149,5745,-80,-97,17,,305663423,32,76,305663391,305663423
25972,5,12,149,5745,-65,-97,32,a6:92:ad:b7:76:65,305664120,284,413,305663836,305664120
25973,5,12,149,5745,-64,-97,33,72:d1:72:1d:22:a1,305667132,284,2728,305666848,305667132
25974,5,12,149,5745,-60,-97,37,22:ec:75:a8:8a:31,305678678,244,11302,305678434,305678678
25975,5,12,149,5745,-62,-97,35,f6:0a:5c:59:72:df,305679073,280,115,305678793,305679073
25976,5,12,149,5745,-64,-97,33,56:68:e2:c2:8d:d5,305680035,280,682,305679755,305680035
25977,5,24,149,5745,-80,-97,17,,305681192,28,1129,305681164,305681192
25978,5,24,149,5745,-77,-97,20,,305681236,28,16,305681208,305681236
25979,5,24,149,5745,-76,-97,21,,305681345,32,77,305681313,305681345
25980,5,12,149,5745,-71,-97,26,f2:da:61:dd:98:c5,305682299,268,686,305682031,305682299
25981,5,12,149,5745,-65,-97,32,5e:29:73:5b:30:00,305682772,540,-67,305682232,305682772
25982,5,12,149,5745,-66,-97,31,2a:07:ef:54:b5:55,305684211,440,999,305683771,305684211
25983,5,12,149,5745,-60,-97,37,22:ec:75:a8:8a:31,305684704,516,-23,305684188,305684704
25984,5,12,149,5745,-89,-97,8,9a:24:38:da:96:bb,305686715,824,1187,305685891,305686715
25985,5,12,149,5745,-65,-97,32,56:68:e2:c2:8d:d5,305688359,476,1168,305687883,305688359
25986,5,12,149,5745,-92,-97,5,3a:90:78:0e:4f:1f,305689877,132,1386,305689745,305689877
25987,5,12,149,5745,-91,-97,6,3a:90:78:0e:4f:1f,305690132,284,-29,305689848,305690132
25988,5,12,149,5745,-92,-97,5,42:d2:d9:2b:ac:61,305690487,132,223,305690355,305690487
25989,5,12,149,5745,-91,-97,6,42:d2:d9:2b:ac:61,305691689,288,914,305691401,305691689
25990,5,12,149,5745,-90,-97,7,de:be:a8:cd:79:57,305693433,284,1460,305693149,305693433
25991,5,12,149,5745,-89,-97,8,4e:72:d0:f1:a2:44,305694832,268,1131,305694564,305694832
25992,5,12,149,5745,-90,-97,7,46:28:71:6e:d2:2e,305696098,252,1014,305695846,305696098
25993,5,12,149,5745,-90,-97,7,46:28:71:6e:d2:2e,305696437,252,87,305696185,305696437
25994,5,12,149,5745,-57,-97,40,b6:90:18:f6:b1:d4,305698242,268,1537,305697974,305698242
25995,5,12,149,5745,-70,-97,27,6a:1e:a4:f8:14:49,305698725,480,3,305698245,305698725
25996,5,12,149,5745,-54,-97,43,3e:d1:9b:c7:a4:de,305699401,544,132,305698857,305699401
25997,5,12,149,5745,-64,-97,33,72:d1:72:1d:22:a1,305701295,480,1414,305700815,305701295
25998,5,12,149,5745,-67,-97,30,2a:07:ef:54:b5:55,305711826,244,10287,305711582,305711826
25999,5,12,149,5745,-71,-97,26,d2:00:04:7e:2c:ab,305714039,104,2109,305713935,305714039
26000,5,12,149,5745,-88,-97,9,9a:24:38:da:96:bb,305724866,272,10555,305724594,305724866
26001,5,12,149,5745,-89,-97,8,4e:72:d0:f1:a2:44,305729378,268,4244,305729110,305729378
26002,5,12,149,5745,-60,-97,37,b6:90:18:f6:b1:d4,305729908,268,262,305729640,305729908
26003,5,12,149,5745,-64,-97,33,5e:29:73:5b:30:00,305746465,272,16285,305746193,305746465
26004,5,12,149,5745,-60,-97,37,b6:90:18:f6:b1:d4,305746781,268,48,305746513,305746781
26005,5,12,149,5745,-71,-97,26,f2:da:61:dd:98:c5,305747389,268,340,305747121,305747389
26006,5,12,149,5745,-71,-97,26,f2:da:61:dd:98:c5,305748368,268,711,305748100,305748368
26007,5,12,149,5745,-67,-97,30,2a:07:ef:54:b5:55,305749300,440,492,305748860,305749300
26008,5,6,149,5745,-90,-97,7,54:e4:3a:ec:fb:65,305750530,360,870,305750170,305750530
26009,5,12,149,5745,-56,-97,41,3e:d1:9b:c7:a4:de,305754566,544,3492,305754022,305754566
26010,5,12,149,5745,-57,-97,40,3e:d1:9b:c7:a4:de,305761535,272,6697,305761263,305761535
26011,5,12,149,5745,-88,-97,9,de:be:a8:cd:79:57,305769143,284,7324,305768859,305769143
26012,5,12,149,5745,-60,-97,37,f6:0a:5c:59:72:df,305774030,280,4607,305773750,305774030
26013,5,12,149,5745,-60,-97,37,22:ec:75:a8:8a:31,305778690,244,4416,305778446,305778690
26014,5,12,149,5745,-72,-97,25,d2:00:04:7e:2c:ab,305781357,272,2395,305781085,305781357
26015,5,12,149,5745,-65,-97,32,72:d1:72:1d:22:a1,305787961,284,6320,305787677,305787961
26016,5,12,149,5745,-91,-97,6,42:d2:d9:2b:ac:61,305802294,288,14045,305802006,305802294
26017,5,12,149,5745,-59,-97,38,b6:90:18:f6:b1:d4,305812012,268,9450,305811744,305812012
26018,5,12,149,5745,-68,-97,29,0a:b9:b7:b1:4d:fa,305814186,268,1906,305813918,305814186
26019,5,12,149,5745,-69,-97,28,2a:07:ef:54:b5:55,305814607,440,-19,305814167,305814607
26020,5,12,149,5745,-72,-97,25,f2:da:61:dd:98:c5,305815118,268,243,305814850,305815118
26021,5,12,149,5745,-58,-97,39,a6:92:ad:b7:76:65,305815474,484,-128,305814990,305815474
26022,5,12,149,5745,-92,-97,5,46:28:71:6e:d2:2e,305816504,252,778,305816252,305816504
26023,5,12,149,5745,-58,-97,39,3e:d1:9b:c7:a4:de,305820168,544,3120,305819624,305820168
26024,5,12,149,5745,-88,-97,9,de:be:a8:cd:79:57,305824341,284,3889,305824057,305824341
26025,5,12,149,5745,-69,-97,28,2a:07:ef:54:b5:55,305827023,244,2438,305826779,305827023
26026,5,12,149,5745,-90,-97,7,4e:72:d0:f1:a2:44,305827947,268,656,305827679,305827947
26027,5,12,149,5745,-91,-97,6,4e:72:d0:f1:a2:44,305828240,268,25,305827972,305828240
26028,5,12,149,5745,-63,-97,34,5e:29:73:5b:30:00,305830424,540,1644,305829884,305830424
26029,5,12,149,5745,-88,-97,9,9a:24:38:da:96:bb,305832599,824,1351,305831775,305832599
26030,5,12,149,5745,-59,-97,38,22:ec:75:a8:8a:31,305833706,516,591,305833190,305833706
26031,5,12,149,5745,-70,-97,27,d2:00:04:7e:2c:ab,305834276,412,158,305833864,305834276
26032,5,24,149,5745,-80,-97,17,,305834830,28,526,305834802,305834830
26033,5,24,149,5745,-80,-97,17,,305834874,28,16,305834846,305834874
26034,5,24,149,5745,-80,-97,17,,305834983,32,77,305834951,305834983
26035,5,12,149,5745,-83,-97,14,7e:05:42:11:d2:ec,305836331,440,908,305835891,305836331
26036,5,12,149,5745,-59,-97,38,b6:90:18:f6:b1:d4,305844213,268,7614,305843945,305844213
26037,5,6,149,5745,-88,-97,9,54:e4:3a:ec:fb:65,305852931,360,8358,305852571,305852931
26038,5,12,149,5745,-70,-97,27,6a:1e:a4:f8:14:49,305853319,284,104,305853035,305853319
26039,5,24,149,5745,-79,-97,18,,305853747,28,400,305853719,305853747
26040,5,24,149,5745,-81,-97,16,,305853791,28,16,305853763,305853791
26041,5,24,149,5745,-81,-97,16,,305853899,32,76,305853867,305853899
26042,5,12,149,5745,-88,-97,9,9a:24:38:da:96:bb,305854031,272,-140,305853759,305854031
26043,5,12,149,5745,-64,-97,33,5e:29:73:5b:30:00,305862079,272,7776,305861807,305862079
26044,5,12,149,5745,-71,-97,26,f2:da:61:dd:98:c5,305862398,268,51,305862130,305862398
26045,5,12,149,5745,-57,-97,40,3e:d1:9b:c7:a4:de,305876209,272,13539,305875937,305876209
26046,5,12,149,5745,-59,-97,38,b6:90:18:f6:b1:d4,305877723,268,1246,305877455,305877723
26047,5,12,149,5745,-66,-97,31,56:68:e2:c2:8d:d5,305879700,280,1697,305879420,305879700
26048,5,12,149,5745,-92,-97,5,3a:90:78:0e:4f:1f,305882625,284,2641,305882341,305882625
26049,5,12,149,5745,-56,-97,41,3e:d1:9b:c7:a4:de,305885667,544,2498,305885123,305885667
26050,5,24,149,5745,-81,-97,16,,305887821,28,2126,305887793,305887821
26051,5,24,149,5745,-79,-97,18,,305887864,28,15,305887836,305887864
26052,5,24,149,5745,-79,-97,18,,305887973,32,77,305887941,305887973
26053,5,12,149,5745,-87,-97,10,de:be:a8:cd:79:57,305888526,284,269,305888242,305888526
26054,5,12,149,5745,-69,-97,28,d2:00:04:7e:2c:ab,305892186,244,3416,305891942,305892186
26055,5,12,149,5745,-58,-97,39,22:ec:75:a8:8a:31,305895708,244,3278,305895464,305895708
26056,5,12,149,5745,-69,-97,28,d2:00:04:7e:2c:ab,305898256,440,2108,305897816,305898256
26057,5,24,149,5745,-79,-97,18,,305905480,28,7196,305905452,305905480
26058,5,24,149,5745,-81,-97,16,,305905524,28,16,305905496,305905524
26059,5,24,149,5745,-81,-97,16,,305905633,32,77,305905601,305905633
26060,5,12,149,5745,-88,-97,9,4e:72:d0:f1:a2:44,305934202,240,28329,305933962,305934202
26061,5,12,149,5745,-59,-97,38,b6:90:18:f6:b1:d4,305943108,268,8638,305942840,305943108
26062,5,12,149,5745,-69,-97,28,2a:07:ef:54:b5:55,305946124,244,2772,305945880,305946124
26063,5,12,149,5745,-57,-97,40,3e:d1:9b:c7:a4:de,305951226,544,4558,305950682,305951226
26064,5,6,149,5745,-91,-97,6,54:e4:3a:ec:fb:65,305955331,360,3745,305954971,305955331
26065,5,12,149,5745,-60,-97,37,b6:90:18:f6:b1:d4,305958871,268,3272,305958603,305958871
26066,5,12,149,5745,-71,-97,26,6a:1e:a4:f8:14:49,305964287,284,5132,305964003,305964287
26067,5,12,149,5745,-87,-97,10,9a:24:38:da:96:bb,305966066,272,1507,305965794,305966066
26068,5,12,149,5745,-66,-97,31,5e:29:73:5b:30:00,305975536,272,9198,305975264,305975536
26069,5,12,149,5745,-64,-97,33,72:d1:72:1d:22:a1,305980117,284,4297,305979833,305980117
26070,5,12,149,5745,-63,-97,34,56:68:e2:c2:8d:d5,305980471,280,74,305980191,305980471
26071,5,12,149,5745,-59,-97,38,3e:d1:9b:c7:a4:de,305991175,272,10432,305990903,305991175
26072,5,12,149,5745,-89,-97,8,42:d2:d9:2b:ac:61,305993820,288,2357,305993532,305993820
26073,5,12,149,5745,-87,-97,10,de:be:a8:cd:79:57,305995490,284,1386,305995206,305995490
26074,5,12,149,5745,-60,-97,37,b6:90:18:f6:b1:d4,306008624,268,12866,306008356,306008624
26075,5,12,149,5745,-56,-97,41,22:ec:75:a8:8a:31,306012346,244,3478,306012102,306012346
26076,5,12,149,5745,-60,-97,37,3e:d1:9b:c7:a4:de,306016807,544,3917,306016263,306016807
26077,5,12,149,5745,-88,-97,9,7e:05:42:11:d2:ec,306032465,468,15190,306031997,306032465
26078,5,12,149,5745,-89,-97,8,4e:72:d0:f1:a2:44,306047276,240,14571,306047036,306047276
26079,5,6,149,5745,-90,-97,7,54:e4:3a:ec:fb:65,306057732,360,10096,306057372,306057732
26080,5,12,149,5745,-69,-97,28,f2:da:61:dd:98:c5,306058477,268,477,306058209,306058477
26081,5,12,149,5745,-68,-97,29,2a:07:ef:54:b5:55,306060505,244,1784,306060261,306060505
26082,5,12,149,5745,-87,-97,10,9a:24:38:da:96:bb,306078664,272,17887,306078392,306078664
26083,5,12,149,5745,-62,-97,35,72:d1:72:1d:22:a1,306082518,284,3570,306082234,306082518
26084,5,12,149,5745,-70,-97,27,d2:00:04:7e:2c:ab,306082845,244,83,306082601,306082845
26085,5,12,149,5745,-63,-97,34,56:68:e2:c2:8d:d5,306084489,280,1364,306084209,306084489
26086,5,12,149,5745,-57,-97,40,b6:90:18:f6:b1:d4,306085075,268,318,306084807,306085075
26087,5,12,149,5745,-68,-97,29,5e:29:73:5b:30:00,306092590,272,7243,306092318,306092590
26088,5,12,149,5745,-60,-97,37,f6:0a:5c:59:72:df,306093222,280,352,306092942,306093222
26089,5,12,149,5745,-57,-97,40,3e:d1:9b:c7:a4:de,306094022,272,528,306093750,306094022
26090,5,12,149,5745,-89,-97,8,42:d2:d9:2b:ac:61,306094617,288,307,306094329,306094617
26091,5,12,149,5745,-89,-97,8,de:be:a8:cd:79:57,306108310,284,13409,306108026,306108310
26092,5,24,149,5745,-81,-97,16,,306113916,28,5578,306113888,306113916
26093,5,24,149,5745,-78,-97,19,,306113960,28,16,306113932,306113960
26094,5,24,149,5745,-78,-97,19,,306114069,32,77,306114037,306114069
26095,5,12,149,5745,-59,-97,38,22:ec:75:a8:8a:31,306129810,244,15497,306129566,306129810
26096,5,24,149,5745,-77,-97,20,,306131616,28,1778,306131588,306131616
26097,5,24,149,5745,-81,-97,16,,306131660,28,16,306131632,306131660
26098,5,24,149,5745,-82,-97,15,,306131768,32,76,306131736,306131768
26099,5,12,149,5745,-70,-97,27,6a:1e:a4:f8:14:49,306157289,284,25237,306157005,306157289
26100,5,6,149,5745,-89,-97,8,54:e4:3a:ec:fb:65,306160133,360,2484,306159773,306160133
26101,5,12,149,5745,-68,-97,29,f2:da:61:dd:98:c5,306161238,268,837,306160970,306161238
26102,5,12,149,5745,-90,-97,7,4e:72:d0:f1:a2:44,306164295,240,2817,306164055,306164295
26103,5,12,149,5745,-69,-97,28,2a:07:ef:54:b5:55,306172808,244,8269,306172564,306172808
26104,5,12,149,5745,-70,-97,27,d2:00:04:7e:2c:ab,306184477,244,11425,306184233,306184477
26105,5,12,149,5745,-68,-97,29,72:d1:72:1d:22:a1,306185016,284,255,306184732,306185016
26106,5,24,149,5745,-78,-97,19,,306185370,28,326,306185342,306185370
26107,5,24,149,5745,-81,-97,16,,306185414,28,16,306185386,306185414
26108,5,24,149,5745,-81,-97,16,,306185529,32,83,306185497,306185529
26109,5,12,149,5745,-65,-97,32,56:68:e2:c2:8d:d5,306185595,280,-214,306185315,306185595
26110,5,24,149,5745,-78,-97,19,,306185918,28,295,306185890,306185918
26111,5,24,149,5745,-81,-97,16,,306185962,28,16,306185934,306185962
26112,5,24,149,5745,-81,-97,16,,306186070,32,76,306186038,306186070
26113,5,12,149,5745,-57,-97,40,b6:90:18:f6:b1:d4,306186173,268,-165,306185905,306186173
26114,5,24,149,5745,-78,-97,19,,306187185,28,984,306187157,306187185
26115,5,24,149,5745,-82,-97,15,,306187230,28,17,306187202,306187230
26116,5,24,149,5745,-81,-97,16,,306187338,32,76,306187306,306187338
26117,5,24,149,5745,-78,-97,19,,306187504,28,138,306187476,306187504
26118,5,24,149,5745,-81,-97,16,,306187548,28,16,306187520,306187548
26119,5,24,149,5745,-82,-97,15,,306187656,32,76,306187624,306187656
26120,5,24,149,5745,-81,-97,16,,306187768,32,80,306187736,306187768
26121,5,24,149,5745,-81,-97,16,,306192841,28,5045,306192813,306192841
26122,5,24,149,5745,-78,-97,19,,306192886,28,17,306192858,306192886
26123,5,24,149,5745,-77,-97,20,,306192994,32,76,306192962,306192994
26124,5,12,149,5745,-90,-97,7,42:d2:d9:2b:ac:61,306197381,288,4099,306197093,306197381
26125,5,12,149,5745,-69,-97,28,6a:1e:a4:f8:14:49,306202506,284,4841,306202222,306202506
26126,5,12,149,5745,-65,-97,32,5e:29:73:5b:30:00,306204519,272,1741,306204247,306204519
26127,5,12,149,5745,-55,-97,42,3e:d1:9b:c7:a4:de,306205887,272,1096,306205615,306205887
26128,5,24,149,5745,-81,-97,16,,306206347,28,432,306206319,306206347
26129,5,24,149,5745,-79,-97,18,,306206391,28,16,306206363,306206391
26130,5,24,149,5745,-78,-97,19,,306206499,32,76,306206467,306206499
26131,5,12,149,5745,-68,-97,29,f2:da:61:dd:98:c5,306210063,268,3296,306209795,306210063
26132,5,12,149,5745,-89,-97,8,de:be:a8:cd:79:57,306216855,284,6508,306216571,306216855
26133,5,24,149,5745,-80,-97,17,,306217728,28,845,306217700,306217728
26134,5,24,149,5745,-78,-97,19,,306217772,28,16,306217744,306217772
26135,5,24,149,5745,-78,-97,19,,306217881,32,77,306217849,306217881
26136,5,24,149,5745,-78,-97,19,,306222508,28,4599,306222480,306222508
26137,5,24,149,5745,-81,-97,16,,306222553,28,17,306222525,306222553
26138,5,24,149,5745,-80,-97,17,,306222660,32,75,306222628,306222660
26139,5,24,149,5745,-80,-97,17,,306230433,28,7745,306230405,306230433
26140,5,24,149,5745,-79,-97,18,,306230477,28,16,306230449,306230477
26141,5,24,149,5745,-79,-97,18,,306230585,32,76,306230553,306230585
26142,5,24,149,5745,-78,-97,19,,306232115,28,1502,306232087,306232115
26143,5,24,149,5745,-80,-97,17,,306232159,28,16,306232131,306232159
26144,5,24,149,5745,-80,-97,17,,306232267,32,76,306232235,306232267
26145,5,12,149,5745,-69,-97,28,72:d1:72:1d:22:a1,306238599,284,6048,306238315,306238599
26146,5,24,149,5745,-79,-97,18,,306238954,28,327,306238926,306238954
26147,5,24,149,5745,-80,-97,17,,306238998,28,16,306238970,306238998
26148,5,24,149,5745,-79,-97,18,,306239106,32,76,306239074,306239106
26149,5,24,149,5745,-80,-97,17,,306239933,28,799,306239905,306239933
26150,5,24,149,5745,-78,-97,19,,306239977,28,16,306239949,306239977
26151,5,24,149,5745,-79,-97,18,,306240085,32,76,306240053,306240085
26152,5,24,149,5745,-79,-97,18,,306241354,28,1241,306241326,306241354
26153,5,24,149,5745,-79,-97,18,,306241398,28,16,306241370,306241398
26154,5,24,149,5745,-78,-97,19,,306241507,32,77,306241475,306241507
26155,5,12,149,5745,-60,-97,37,22:ec:75:a8:8a:31,306241591,244,-160,306241347,306241591
26156,5,12,149,5745,-70,-97,27,d2:00:04:7e:2c:ab,306243791,244,1956,306243547,306243791
26157,5,24,149,5745,-80,-97,17,,306247375,28,3556,306247347,306247375
26158,5,24,149,5745,-80,-97,17,,306247419,28,16,306247391,306247419
26159,5,24,149,5745,-80,-97,17,,306247527,32,76,306247495,306247527
26160,5,24,149,5745,-80,-97,17,,306249789,28,2234,306249761,306249789
26161,5,24,149,5745,-78,-97,19,,306249833,28,16,306249805,306249833
26162,5,24,149,5745,-78,-97,19,,306249942,32,77,306249910,306249942
26163,5,12,149,5745,-68,-97,29,56:68:e2:c2:8d:d5,306256419,280,6197,306256139,306256419
26164,5,12,149,5745,-89,-97,8,42:d2:d9:2b:ac:61,306258034,288,1327,306257746,306258034
26165,5,24,149,5745,-78,-97,19,,306259604,28,1542,306259576,306259604
26166,5,24,149,5745,-80,-97,17,,306259649,28,17,306259621,306259649
26167,5,24,149,5745,-80,-97,17,,306259757,32,76,306259725,306259757
26168,5,6,149,5745,-91,-97,6,54:e4:3a:ec:fb:65,306262533,360,2416,306262173,306262533
26169,5,24,149,5745,-78,-97,19,,306267783,28,5222,306267755,306267783
26170,5,24,149,5745,-79,-97,18,,306267828,28,17,306267800,306267828
26171,5,24,149,5745,-79,-97,18,,306267936,32,76,306267904,306267936
26172,5,12,149,5745,-92,-97,5,46:28:71:6e:d2:2e,306268249,284,29,306267965,306268249
26173,5,12,149,5745,-59,-97,38,f6:0a:5c:59:72:df,306270915,280,2386,306270635,306270915
26174,5,12,149,5745,-57,-97,40,b6:90:18:f6:b1:d4,306272392,268,1209,306272124,306272392
26175,5,12,149,5745,-68,-97,29,2a:07:ef:54:b5:55,306274836,440,2004,306274396,306274836
26176,5,12,149,5745,-67,-97,30,f2:da:61:dd:98:c5,306275482,268,378,306275214,306275482
26177,5,12,149,5745,-67,-97,30,56:68:e2:c2:8d:d5,306276540,476,582,306276064,306276540
26178,5,12,149,5745,-54,-97,43,3e:d1:9b:c7:a4:de,306279192,544,2108,306278648,306279192
26179,5,12,149,5745,-89,-97,8,42:d2:d9:2b:ac:61,306281130,284,1654,306280846,306281130
26180,5,12,149,5745,-67,-97,30,2a:07:ef:54:b5:55,306285226,244,3852,306284982,306285226
26181,5,12,149,5745,-87,-97,10,de:be:a8:cd:79:57,306285482,284,-28,306285198,306285482
26182,5,12,149,5745,-90,-97,7,4e:72:d0:f1:a2:44,306285973,240,251,306285733,306285973
26183,5,12,149,5745,-57,-97,40,b6:90:18:f6:b1:d4,306286817,268,576,306286549,306286817
26184,5,12,149,5745,-68,-97,29,6a:1e:a4:f8:14:49,306288398,480,1101,306287918,306288398
26185,5,12,149,5745,-65,-97,32,5e:29:73:5b:30:00,306289164,540,226,306288624,306289164
26186,5,12,149,5745,-69,-97,28,72:d1:72:1d:22:a1,306289857,480,213,306289377,306289857
26187,5,12,149,5745,-70,-97,27,d2:00:04:7e:2c:ab,306291019,440,722,306290579,306291019
26188,5,12,149,5745,-59,-97,38,22:ec:75:a8:8a:31,306291548,516,13,306291032,306291548
26189,5,12,149,5745,-89,-97,8,4e:72:d0:f1:a2:44,306294394,240,2606,306294154,306294394
26190,5,12,149,5745,-88,-97,9,9a:24:38:da:96:bb,306301502,272,6836,306301230,306301502
26191,5,12,149,5745,-68,-97,29,6a:1e:a4:f8:14:49,306302960,284,1174,306302676,306302960
26192,5,12,149,5745,-67,-97,30,f2:da:61:dd:98:c5,306304548,268,1320,306304280,306304548
26193,5,12,149,5745,-59,-97,38,f6:0a:5c:59:72:df,306305274,280,446,306304994,306305274
26194,5,12,149,5745,-89,-97,8,3a:90:78:0e:4f:1f,306315161,284,9603,306314877,306315161
26195,5,12,149,5745,-87,-97,10,de:be:a8:cd:79:57,306320894,284,5449,306320610,306320894
26196,5,12,149,5745,-61,-97,36,f6:0a:5c:59:72:df,306334514,280,13340,306334234,306334514
26197,5,12,149,5745,-57,-97,40,b6:90:18:f6:b1:d4,306336419,268,1637,306336151,306336419
26198,5,12,149,5745,-65,-97,32,5e:29:73:5b:30:00,306336721,272,30,306336449,306336721
26199,5,12,149,5745,-67,-97,30,72:d1:72:1d:22:a1,306337271,284,266,306336987,306337271
26200,5,12,149,5745,-54,-97,43,3e:d1:9b:c7:a4:de,306337735,272,192,306337463,306337735
26201,5,12,149,5745,-65,-97,32,56:68:e2:c2:8d:d5,306340648,476,2437,306340172,306340648
26202,5,12,149,5745,-93,-97,4,46:28:71:6e:d2:2e,306342540,284,1608,306342256,306342540
26203,5,12,149,5745,-60,-97,37,f6:0a:5c:59:72:df,306343451,132,779,306343319,306343451
26204,5,12,149,5745,-54,-97,43,3e:d1:9b:c7:a4:de,306344679,544,684,306344135,306344679
26205,5,12,149,5745,-92,-97,5,46:16:4e:de:2f:e5,306350477,268,5530,306350209,306350477
26206,5,12,149,5745,-88,-97,9,3a:90:78:0e:4f:1f,306351508,284,747,306351224,306351508
26207,5,12,149,5745,-65,-97,32,56:68:e2:c2:8d:d5,306351835,280,47,306351555,306351835
26208,5,12,149,5745,-89,-97,8,9a:24:38:da:96:bb,306352856,824,197,306352032,306352856
26209,5,12,149,5745,-70,-97,27,d2:00:04:7e:2c:ab,306354291,380,1055,306353911,306354291
26210,5,12,149,5745,-65,-97,32,5e:29:73:5b:30:00,306354705,540,-126,306354165,306354705
26211,5,12,149,5745,-67,-97,30,72:d1:72:1d:22:a1,306355317,480,132,306354837,306355317
26212,5,12,149,5745,-59,-97,38,22:ec:75:a8:8a:31,306355840,544,-21,306355296,306355840
26213,5,12,149,5745,-70,-97,27,d2:00:04:7e:2c:ab,306356537,440,257,306356097,306356537
26214,5,12,149,5745,-88,-97,9,4e:72:d0:f1:a2:44,306359630,240,2853,306359390,306359630
26215,5,12,149,5745,-85,-97,12,7e:05:42:11:d2:ec,306363387,468,3289,306362919,306363387
26216,5,6,149,5745,-91,-97,6,54:e4:3a:ec:fb:65,306364934,360,1187,306364574,306364934
26217,5,12,149,5745,-59,-97,38,22:ec:75:a8:8a:31,306369065,272,3859,306368793,306369065
26218,5,12,149,5745,-91,-97,6,42:d2:d9:2b:ac:61,306369517,284,168,306369233,306369517
26219,5,12,149,5745,-92,-97,5,46:28:71:6e:d2:2e,306380127,284,10326,306379843,306380127
26220,5,12,149,5745,-88,-97,9,4e:72:d0:f1:a2:44,306388977,240,8610,306388737,306388977
26221,5,12,149,5745,-58,-97,39,b6:90:18:f6:b1:d4,306401200,268,11955,306400932,306401200
26222,5,12,149,5745,-58,-97,39,b6:90:18:f6:b1:d4,306401916,268,448,306401648,306401916
26223,5,12,149,5745,-57,-97,40,3e:d1:9b:c7:a4:de,306404747,544,2287,306404203,306404747
26224,5,12,149,5745,-67,-97,30,2a:07:ef:54:b5:55,306410737,272,5718,306410465,306410737
26225,5,12,149,5745,-89,-97,8,9a:24:38:da:96:bb,306414595,272,3586,306414323,306414595
26226,5,12,149,5745,-66,-97,31,6a:1e:a4:f8:14:49,306421848,292,6961,306421556,306421848
26227,5,12,149,5745,-69,-97,28,d2:00:04:7e:2c:ab,306422201,440,-87,306421761,306422201
26228,5,12,149,5745,-67,-97,30,f2:da:61:dd:98:c5,306426156,268,3687,306425888,306426156
26229,5,12,149,5745,-64,-97,33,5e:29:73:5b:30:00,306433097,272,6669,306432825,306433097
26230,5,12,149,5745,-85,-97,12,de:be:a8:cd:79:57,306446332,284,12951,306446048,306446332
26231,5,12,149,5745,-59,-97,38,3e:d1:9b:c7:a4:de,306452775,272,6171,306452503,306452775
26232,5,12,149,5745,-65,-97,32,72:d1:72:1d:22:a1,306463729,284,10670,306463445,306463729
26233,5,6,149,5745,-90,-97,7,54:e4:3a:ec:fb:65,306467334,360,3245,306466974,306467334
26234,5,12,149,5745,-60,-97,37,3e:d1:9b:c7:a4:de,306469927,544,2049,306469383,306469927
26235,5,24,149,5745,-80,-97,17,,306471364,28,1409,306471336,306471364
26236,5,24,149,5745,-79,-97,18,,306471408,28,16,306471380,306471408
26237,5,24,149,5745,-79,-97,18,,306471517,32,77,306471485,306471517
26238,5,12,149,5745,-59,-97,38,22:ec:75:a8:8a:31,306471583,272,-206,306471311,306471583
26239,5,12,149,5745,-70,-97,27,d2:00:04:7e:2c:ab,306479772,244,7945,306479528,306479772
26240,5,12,149,5745,-64,-97,33,56:68:e2:c2:8d:d5,306480223,288,163,306479935,306480223
26241,5,12,149,5745,-59,-97,38,b6:90:18:f6:b1:d4,306486207,268,5716,306485939,306486207
26242,5,12,149,5745,-90,-97,7,42:d2:d9:2b:ac:61,306486806,284,315,306486522,306486806
26243,5,24,149,5745,-79,-97,18,,306489280,28,2446,306489252,306489280
26244,5,24,149,5745,-81,-97,16,,306489324,28,16,306489296,306489324
26245,5,24,149,5745,-81,-97,16,,306489432,32,76,306489400,306489432
26246,5,12,149,5745,-92,-97,5,46:28:71:6e:d2:2e,306501114,284,11398,306500830,306501114
26247,5,12,149,5745,-91,-97,6,4e:72:d0:f1:a2:44,306503979,240,2625,306503739,306503979
26248,5,12,149,5745,-60,-97,37,b6:90:18:f6:b1:d4,306516312,268,12065,306516044,306516312
26249,5,12,149,5745,-59,-97,38,3e:d1:9b:c7:a4:de,306535890,544,19034,306535346,306535890
26250,5,24,149,5745,-80,-97,17,,306539346,28,3428,306539318,306539346
26251,5,24,149,5745,-79,-97,18,,306539391,28,17,306539363,306539391
26252,5,24,149,5745,-80,-97,17,,306539499,32,76,306539467,306539499
26253,5,12,149,5745,-59,-97,38,f6:0a:5c:59:72:df,306542027,288,2240,306541739,306542027
26254,5,12,149,5745,-66,-97,31,5e:29:73:5b:30:00,306547291,272,4992,306547019,306547291
26255,5,12,149,5745,-59,-97,38,3e:d1:9b:c7:a4:de,306550811,272,3248,306550539,306550811
26256,5,12,149,5745,-60,-97,37,b6:90:18:f6:b1:d4,306552181,268,1102,306551913,306552181
26257,5,12,149,5745,-85,-97,12,7e:05:42:11:d2:ec,306556200,468,3551,306555732,306556200
26258,5,24,149,5745,-80,-97,17,,306557210,28,982,306557182,306557210
26259,5,24,149,5745,-79,-97,18,,306557254,28,16,306557226,306557254
26260,5,24,149,5745,-79,-97,18,,306557362,32,76,306557330,306557362
26261,5,24,149,5745,-60,-97,37,,306566527,28,9137,306566499,306566527
26262,5,24,149,5745,-79,-97,18,,306566571,28,16,306566543,306566571
26263,5,24,149,5745,-79,-97,18,,306566679,28,80,306566651,306566679
26264,5,12,149,5745,-67,-97,30,6a:1e:a4:f8:14:49,306566910,292,-61,306566618,306566910
26265,5,6,149,5745,-91,-97,6,54:e4:3a:ec:fb:65,306569735,360,2465,306569375,306569735
26266,5,12,149,5745,-71,-97,26,f2:da:61:dd:98:c5,306570534,268,531,306570266,306570534
26267,5,12,149,5745,-91,-97,6,3a:90:78:0e:4f:1f,306570889,284,71,306570605,306570889
26268,5,12,149,5745,-67,-97,30,2a:07:ef:54:b5:55,306571910,272,749,306571638,306571910
26269,5,12,149,5745,-87,-97,10,9a:24:38:da:96:bb,306573676,272,1494,306573404,306573676
26270,5,12,149,5745,-69,-97,28,d2:00:04:7e:2c:ab,306583421,244,9501,306583177,306583421
26271,5,12,149,5745,-58,-97,39,22:ec:75:a8:8a:31,306588557,272,4864,306588285,306588557
26272,5,12,149,5745,-62,-97,35,56:68:e2:c2:8d:d5,306592020,288,3175,306591732,306592020
26273,5,12,149,5745,-67,-97,30,72:d1:72:1d:22:a1,306594678,284,2374,306594394,306594678
26274,5,12,149,5745,-89,-97,8,42:d2:d9:2b:ac:61,306599626,284,4664,306599342,306599626
26275,5,12,149,5745,-85,-97,12,de:be:a8:cd:79:57,306611718,284,11808,306611434,306611718
26276,5,12,149,5745,-91,-97,6,46:28:71:6e:d2:2e,306615197,284,3195,306614913,306615197
26277,5,12,149,5745,-90,-97,7,4e:72:d0:f1:a2:44,306617645,240,2208,306617405,306617645
26278,5,12,149,5745,-58,-97,39,b6:90:18:f6:b1:d4,306637737,268,19824,306637469,306637737
26279,5,12,149,5745,-58,-97,39,3e:d1:9b:c7:a4:de,306656998,272,18989,306656726,306656998
26280,5,12,149,5745,-66,-97,31,5e:29:73:5b:30:00,306661263,272,3993,306660991,306661263
26281,5,12,149,5745,-65,-97,32,6a:1e:a4:f8:14:49,306669353,292,7798,306669061,306669353
26282,5,6,149,5745,-87,-97,10,54:e4:3a:ec:fb:65,306672135,360,2422,306671775,306672135
26283,5,12,149,5745,-66,-97,31,2a:07:ef:54:b5:55,306672970,272,563,306672698,306672970
26284,5,12,149,5745,-70,-97,27,f2:da:61:dd:98:c5,306673484,268,246,306673216,306673484
26285,5,12,149,5745,-85,-97,12,9a:24:38:da:96:bb,306687124,272,13368,306686852,306687124
26286,5,12,149,5745,-69,-97,28,d2:00:04:7e:2c:ab,306695490,244,8122,306695246,306695490
26287,5,12,149,5745,-70,-97,27,72:d1:72:1d:22:a1,306697069,284,1295,306696785,306697069
26288,5,24,149,5745,-77,-97,20,,306697495,28,398,306697467,306697495
26289,5,24,149,5745,-79,-97,18,,306697539,28,16,306697511,306697539
26290,5,24,149,5745,-79,-97,18,,306697648,32,77,306697616,306697648
26291,5,12,149,5745,-59,-97,38,22:ec:75:a8:8a:31,306704306,272,6386,306704034,306704306
26292,5,12,149,5745,-62,-97,35,56:68:e2:c2:8d:d5,306704792,288,198,306704504,306704792
26293,5,12,149,5745,-85,-97,12,de:be:a8:cd:79:57,306709778,284,4702,306709494,306709778
26294,5,24,149,5745,-79,-97,18,,306716299,28,6493,306716271,306716299
26295,5,24,149,5745,-77,-97,20,,306716343,28,16,306716315,306716343
26296,5,24,149,5745,-77,-97,20,,306716451,32,76,306716419,306716451
26297,5,12,149,5745,-89,-97,8,42:d2:d9:2b:ac:61,306716514,284,-221,306716230,306716514
26298,5,12,149,5745,-94,-97,3,46:28:71:6e:d2:2e,306722276,284,5478,306721992,306722276
26299,5,12,149,5745,-70,-97,27,72:d1:72:1d:22:a1,306729844,284,7284,306729560,306729844
26300,5,12,149,5745,-67,-97,30,2a:07:ef:54:b5:55,306730162,272,46,306729890,306730162
26301,5,12,149,5745,-72,-97,25,f2:da:61:dd:98:c5,306731271,268,841,306731003,306731271
26302,5,12,149,5745,-63,-97,34,56:68:e2:c2:8d:d5,306733796,484,2041,306733312,306733796
26303,5,12,149,5745,-68,-97,29,72:d1:72:1d:22:a1,306734460,132,532,306734328,306734460
26304,5,12,149,5745,-56,-97,41,3e:d1:9b:c7:a4:de,306734606,544,-398,306734062,306734606
26305,5,12,149,5745,-68,-97,29,6a:1e:a4:f8:14:49,306735238,488,144,306734750,306735238
26306,5,12,149,5745,-58,-97,39,f6:0a:5c:59:72:df,306736048,288,522,306735760,306736048
26307,5,12,149,5745,-92,-97,5,ce:c3:e4:21:bb:52,306737440,132,1260,306737308,306737440
26308,5,12,149,5745,-89,-97,8,42:d2:d9:2b:ac:61,306738172,132,600,306738040,306738172
26309,5,12,149,5745,-58,-97,39,f6:0a:5c:59:72:df,306740681,132,2377,306740549,306740681
26310,5,12,149,5745,-68,-97,29,5e:29:73:5b:30:00,306741371,540,150,306740831,306741371
26311,5,12,149,5745,-85,-97,12,9a:24:38:da:96:bb,306743537,824,1342,306742713,306743537
26312,5,12,149,5745,-58,-97,39,b6:90:18:f6:b1:d4,306745262,240,1485,306745022,306745262
26313,5,12,149,5745,-69,-97,28,d2:00:04:7e:2c:ab,306745537,440,-165,306745097,306745537
26314,5,12,149,5745,-58,-97,39,b6:90:18:f6:b1:d4,306746808,240,1031,306746568,306746808
26315,5,12,149,5745,-68,-97,29,6a:1e:a4:f8:14:49,306748237,292,1137,306747945,306748237
26316,5,12,149,5745,-89,-97,8,42:d2:d9:2b:ac:61,306749523,284,1002,306749239,306749523
26317,5,12,149,5745,-85,-97,12,de:be:a8:cd:79:57,306749994,284,187,306749710,306749994
26318,5,12,149,5745,-88,-97,9,3a:90:78:0e:4f:1f,306750322,284,44,306750038,306750322
26319,5,6,149,5745,-61,-97,36,,306753161,52,2787,306753109,306753161
26320,5,6,149,5745,-78,-97,19,,306753229,44,24,306753185,306753229
26321,5,24,149,5745,-79,-97,18,,306753347,28,90,306753319,306753347
26322,5,12,149,5745,-60,-97,37,f6:0a:5c:59:72:df,306754078,288,443,306753790,306754078
26323,5,12,149,5745,-58,-97,39,22:ec:75:a8:8a:31,306754401,544,-221,306753857,306754401
26324,5,12,149,5745,-67,-97,30,2a:07:ef:54:b5:55,306755483,468,614,306755015,306755483
26325,5,24,149,5745,-78,-97,19,,306758419,32,2904,306758387,306758419
26326,5,24,149,5745,-78,-97,19,,306758694,32,243,306758662,306758694
26327,5,24,149,5745,-78,-97,19,,306758970,28,248,306758942,306758970
26328,5,6,149,5745,-61,-97,36,,306759625,52,603,306759573,306759625
26329,5,6,149,5745,-78,-97,19,,306759693,44,24,306759649,306759693
26330,5,24,149,5745,-79,-97,18,,306759811,28,90,306759783,306759811
26331,5,6,149,5745,-62,-97,35,,306760231,52,368,306760179,306760231
26332,5,6,149,5745,-78,-97,19,,306760299,44,24,306760255,306760299
26333,5,24,149,5745,-78,-97,19,,306760417,28,90,306760389,306760417
26334,5,12,149,5745,-73,-97,24,f2:da:61:dd:98:c5,306763017,268,2332,306762749,306763017
26335,5,24,149,5745,-79,-97,18,,306764237,28,1192,306764209,306764237
26336,5,6,149,5745,-62,-97,35,,306764806,52,517,306764754,306764806
26337,5,6,149,5745,-78,-97,19,,306764874,44,24,306764830,306764874
26338,5,24,149,5745,-78,-97,19,,306764992,28,90,306764964,306764992
26339,5,6,149,5745,-62,-97,35,,306765127,52,83,306765075,306765127
26340,5,6,149,5745,-78,-97,19,,306765195,44,24,306765151,306765195
26341,5,24,149,5745,-78,-97,19,,306765313,28,90,306765285,306765313
26342,5,12,149,5745,-89,-97,8,3a:90:78:0e:4f:1f,306765832,284,235,306765548,306765832
26343,5,24,149,5745,-78,-97,19,,306770086,28,4226,306770058,306770086
26344,5,6,149,5745,-91,-97,6,54:e4:3a:ec:fb:65,306774536,360,4090,306774176,306774536
26345,5,12,149,5745,-83,-97,14,de:be:a8:cd:79:57,306779435,284,4615,306779151,306779435
26346,5,12,149,5745,-54,-97,43,3e:d1:9b:c7:a4:de,306780455,272,748,306780183,306780455
26347,5,12,149,5745,-67,-97,30,5e:29:73:5b:30:00,306782256,272,1529,306781984,306782256
26348,5,12,149,5745,-68,-97,29,d2:00:04:7e:2c:ab,306796268,244,13768,306796024,306796268
26349,5,12,149,5745,-86,-97,11,9a:24:38:da:96:bb,306798665,272,2125,306798393,306798665
26350,5,12,149,5745,-84,-97,13,de:be:a8:cd:79:57,306799255,284,306,306798971,306799255
26351,5,12,149,5745,-60,-97,37,a6:92:ad:b7:76:65,306804046,484,4307,306803562,306804046
26352,5,12,149,5745,-68,-97,29,72:d1:72:1d:22:a1,306806431,248,2137,306806183,306806431
26353,5,12,149,5745,-68,-97,29,d2:00:04:7e:2c:ab,306810889,440,4018,306810449,306810889
26354,5,12,149,5745,-64,-97,33,56:68:e2:c2:8d:d5,306814642,288,3465,306814354,306814642
26355,5,12,149,5745,-86,-97,11,7e:05:42:11:d2:ec,306816684,468,1574,306816216,306816684
26356,5,12,149,5745,-67,-97,30,2a:07:ef:54:b5:55,306818082,468,930,306817614,306818082
26357,5,12,149,5745,-57,-97,40,22:ec:75:a8:8a:31,306821352,272,2998,306821080,306821352
26358,5,12,149,5745,-90,-97,7,42:d2:d9:2b:ac:61,306827218,284,5582,306826934,306827218
26359,5,12,149,5745,-86,-97,11,7e:05:42:11:d2:ec,306843793,272,16303,306843521,306843793
26360,5,12,149,5745,-59,-97,38,a6:92:ad:b7:76:65,306844108,284,31,306843824,306844108
26361,5,12,149,5745,-67,-97,30,2a:07:ef:54:b5:55,306845532,272,1152,306845260,306845532
26362,5,12,149,5745,-71,-97,26,f2:da:61:dd:98:c5,306862468,268,16668,306862200,306862468
26363,5,12,149,5745,-56,-97,41,3e:d1:9b:c7:a4:de,306865046,544,2034,306864502,306865046
26364,5,12,149,5745,-85,-97,12,de:be:a8:cd:79:57,306865642,284,312,306865358,306865642
26365,5,12,149,5745,-85,-97,12,9a:24:38:da:96:bb,306870106,824,3640,306869282,306870106
26366,5,12,149,5745,-58,-97,39,a6:92:ad:b7:76:65,306871000,484,410,306870516,306871000
26367,5,12,149,5745,-67,-97,30,6a:1e:a4:f8:14:49,306871615,292,323,306871323,306871615
26368,5,12,149,5745,-68,-97,29,0a:b9:b7:b1:4d:fa,306875433,268,3550,306875165,306875433
26369,5,12,149,5745,-69,-97,28,d2:00:04:7e:2c:ab,306875753,440,-120,306875313,306875753
26370,5,12,149,5745,-88,-97,9,7e:05:42:11:d2:ec,306876246,468,25,306875778,306876246
26371,5,6,149,5745,-89,-97,8,54:e4:3a:ec:fb:65,306877102,360,496,306876742,306877102
26372,5,12,149,5745,-69,-97,28,5e:29:73:5b:30:00,306877535,540,-107,306876995,306877535
26373,5,12,149,5745,-72,-97,25,f2:da:61:dd:98:c5,306878111,268,308,306877843,306878111
26374,5,12,149,5745,-67,-97,30,2a:07:ef:54:b5:55,306884072,468,5493,306883604,306884072
26375,5,12,149,5745,-57,-97,40,22:ec:75:a8:8a:31,306885889,544,1273,306885345,306885889
26376,5,12,149,5745,-87,-97,10,de:be:a8:cd:79:57,306893976,284,7803,306893692,306893976
26377,5,12,149,5745,-56,-97,41,3e:d1:9b:c7:a4:de,306894942,272,694,306894670,306894942
26378,5,12,149,5745,-60,-97,37,f6:0a:5c:59:72:df,306895610,288,380,306895322,306895610
26379,5,12,149,5745,-70,-97,27,5e:29:73:5b:30:00,306896197,272,315,306895925,306896197
26380,5,12,149,5745,-86,-97,11,9a:24:38:da:96:bb,306910546,272,14077,306910274,306910546
26381,5,12,149,5745,-69,-97,28,d2:00:04:7e:2c:ab,306912014,244,1224,306911770,306912014
26382,5,12,149,5745,-65,-97,32,72:d1:72:1d:22:a1,306917673,248,5411,306917425,306917673
26383,5,24,149,5745,-76,-97,21,,306919861,28,2160,306919833,306919861
26384,5,24,149,5745,-81,-97,16,,306919906,28,17,306919878,306919906
26385,5,24,149,5745,-81,-97,16,,306920014,32,76,306919982,306920014
26386,5,12,149,5745,-92,-97,5,ce:c3:e4:21:bb:52,306920349,284,51,306920065,306920349
26387,5,12,149,5745,-87,-97,10,de:be:a8:cd:79:57,306929576,284,8943,306929292,306929576
26388,5,12,149,5745,-58,-97,39,22:ec:75:a8:8a:31,306938261,272,8413,306937989,306938261
26389,5,24,149,5745,-81,-97,16,,306938690,28,401,306938662,306938690
26390,5,24,149,5745,-76,-97,21,,306938734,28,16,306938706,306938734
26391,5,24,149,5745,-76,-97,21,,306938842,32,76,306938810,306938842
26392,5,12,149,5745,-91,-97,6,42:d2:d9:2b:ac:61,306940970,284,1844,306940686,306940970
26393,5,12,149,5745,-69,-97,28,d2:00:04:7e:2c:ab,306941513,440,103,306941073,306941513
26394,5,6,149,5745,-90,-97,7,54:e4:3a:ec:fb:65,306951451,352,9586,306951099,306951451
26395,5,12,149,5745,-88,-97,9,46:28:71:6e:d2:2e,306960948,284,9213,306960664,306960948
26396,5,12,149,5745,-59,-97,38,a6:92:ad:b7:76:65,306964986,284,3754,306964702,306964986
26397,5,12,149,5745,-67,-97,30,2a:07:ef:54:b5:55,306969614,272,4356,306969342,306969614
26398,5,6,149,5745,-89,-97,8,54:e4:3a:ec:fb:65,306972218,352,2252,306971866,306972218
26399,5,6,149,5745,-90,-97,7,54:e4:3a:ec:fb:65,306979337,360,6759,306978977,306979337
26400,5,12,149,5745,-67,-97,30,6a:1e:a4:f8:14:49,306983709,292,4080,306983417,306983709
26401,5,12,149,5745,-86,-97,11,de:be:a8:cd:79:57,306992292,284,8299,306992008,306992292
26402,5,12,149,5745,-71,-97,26,f2:da:61:dd:98:c5,306992757,268,197,306992489,306992757
26403,5,12,149,5745,-60,-97,37,f6:0a:5c:59:72:df,306993421,288,376,306993133,306993421
26404,5,12,149,5745,-87,-97,10,de:be:a8:cd:79:57,306996389,284,2684,306996105,306996389
26405,5,12,149,5745,-70,-97,27,5e:29:73:5b:30:00,307003680,272,7019,307003408,307003680
26406,5,12,149,5745,-64,-97,33,56:68:e2:c2:8d:d5,307006028,288,2060,307005740,307006028
26407,5,12,149,5745,-92,-97,5,ce:c3:e4:21:bb:52,307021847,284,15535,307021563,307021847
26408,5,12,149,5745,-86,-97,11,9a:24:38:da:96:bb,307024168,272,2049,307023896,307024168
26409,5,24,149,5745,-77,-97,20,,307036796,28,12600,307036768,307036796
26410,5,24,149,5745,-81,-97,16,,307036840,28,16,307036812,307036840
26411,5,24,149,5745,-81,-97,16,,307036952,32,80,307036920,307036952
26412,5,24,149,5745,-81,-97,16,,307038288,28,1308,307038260,307038288
26413,5,24,149,5745,-76,-97,21,,307038332,28,16,307038304,307038332
26414,5,24,149,5745,-76,-97,21,,307038440,32,76,307038408,307038440
26415,5,24,149,5745,-76,-97,21,,307038543,28,75,307038515,307038543
26416,5,24,149,5745,-81,-97,16,,307038587,28,16,307038559,307038587
26417,5,24,149,5745,-80,-97,17,,307038828,32,209,307038796,307038828
26418,5,24,149,5745,-80,-97,17,,307038957,28,101,307038929,307038957
26419,5,24,149,5745,-76,-97,21,,307039001,28,16,307038973,307039001
26420,5,24,149,5745,-76,-97,21,,307039109,32,76,307039077,307039109
26421,5,24,149,5745,-76,-97,21,,307040704,28,1567,307040676,307040704
26422,5,24,149,5745,-81,-97,16,,307040748,28,16,307040720,307040748
26423,5,24,149,5745,-80,-97,17,,307040861,32,81,307040829,307040861
26424,5,24,149,5745,-76,-97,21,,307041914,28,1025,307041886,307041914
26425,5,24,149,5745,-80,-97,17,,307041959,28,17,307041931,307041959
26426,5,24,149,5745,-81,-97,16,,307042079,32,88,307042047,307042079
26427,5,24,149,5745,-76,-97,21,,307043082,28,975,307043054,307043082
26428,5,24,149,5745,-80,-97,17,,307043126,28,16,307043098,307043126
26429,5,24,149,5745,-81,-97,16,,307043234,32,76,307043202,307043234
26430,5,24,149,5745,-81,-97,16,,307053240,28,9978,307053212,307053240
26431,5,24,149,5745,-76,-97,21,,307053284,28,16,307053256,307053284
26432,5,24,149,5745,-76,-97,21,,307053392,32,76,307053360,307053392
26433,5,24,149,5745,-81,-97,16,,307053584,28,164,307053556,307053584
26434,5,24,149,5745,-76,-97,21,,307053628,28,16,307053600,307053628
26435,5,24,149,5745,-76,-97,21,,307053736,32,76,307053704,307053736
26436,5,12,149,5745,-90,-97,7,42:d2:d9:2b:ac:61,307054659,284,639,307054375,307054659
26437,5,12,149,5745,-57,-97,40,22:ec:75:a8:8a:31,307055650,272,719,307055378,307055650
26438,5,24,149,5745,-81,-97,16,,307056807,28,1129,307056779,307056807
26439,5,24,149,5745,-76,-97,21,,307056851,28,16,307056823,307056851
26440,5,24,149,5745,-76,-97,21,,307056960,32,77,307056928,307056960
26441,5,24,149,5745,-76,-97,21,,307061070,28,4082,307061042,307061070
26442,5,24,149,5745,-81,-97,16,,307061114,28,16,307061086,307061114
26443,5,24,149,5745,-81,-97,16,,307061222,32,76,307061190,307061222
26444,5,12,149,5745,-88,-97,9,de:be:a8:cd:79:57,307061360,284,-146,307061076,307061360
26445,5,24,149,5745,-81,-97,16,,307063069,28,1681,307063041,307063069
26446,5,24,149,5745,-76,-97,21,,307063113,28,16,307063085,307063113
26447,5,24,149,5745,-76,-97,21,,307063232,32,87,307063200,307063232
26448,5,24,149,5745,-76,-97,21,,307063347,32,83,307063315,307063347
26449,5,24,149,5745,-76,-97,21,,307064239,28,864,307064211,307064239
26450,5,24,149,5745,-81,-97,16,,307064283,28,16,307064255,307064283
26451,5,24,149,5745,-81,-97,16,,307064391,32,76,307064359,307064391
26452,5,24,149,5745,-76,-97,21,,307066080,28,1661,307066052,307066080
26453,5,24,149,5745,-81,-97,16,,307066124,28,16,307066096,307066124
26454,5,24,149,5745,-81,-97,16,,307066328,32,172,307066296,307066328
26455,5,24,149,5745,-76,-97,21,,307066694,28,338,307066666,307066694
26456,5,24,149,5745,-81,-97,16,,307066738,28,16,307066710,307066738
26457,5,24,149,5745,-81,-97,16,,307066879,32,109,307066847,307066879
26458,5,24,149,5745,-81,-97,16,,307075005,28,8098,307074977,307075005
26459,5,24,149,5745,-76,-97,21,,307075049,28,16,307075021,307075049
26460,5,24,149,5745,-76,-97,21,,307075157,32,76,307075125,307075157
26461,5,24,149,5745,-76,-97,21,,307075269,32,80,307075237,307075269
26462,5,24,149,5745,-76,-97,21,,307077763,28,2466,307077735,307077763
26463,5,24,149,5745,-80,-97,17,,307077807,28,16,307077779,307077807
26464,5,24,149,5745,-80,-97,17,,307077915,32,76,307077883,307077915
26465,5,24,149,5745,-81,-97,16,,307079829,28,1886,307079801,307079829
26466,5,24,149,5745,-76,-97,21,,307079873,28,16,307079845,307079873
26467,5,24,149,5745,-76,-97,21,,307079981,32,76,307079949,307079981
26468,5,24,149,5745,-76,-97,21,,307080093,32,80,307080061,307080093
26469,5,24,149,5745,-81,-97,16,,307080259,28,138,307080231,307080259
26470,5,24,149,5745,-75,-97,22,,307080303,28,16,307080275,307080303
26471,5,24,149,5745,-75,-97,22,,307080411,32,76,307080379,307080411
26472,5,24,149,5745,-81,-97,16,,307080622,28,183,307080594,307080622
26473,5,24,149,5745,-76,-97,21,,307080666,28,16,307080638,307080666
26474,5,24,149,5745,-76,-97,21,,307080774,32,76,307080742,307080774
26475,5,24,149,5745,-81,-97,16,,307080937,28,135,307080909,307080937
26476,5,24,149,5745,-76,-97,21,,307080981,28,16,307080953,307080981
26477,5,24,149,5745,-75,-97,22,,307081103,32,90,307081071,307081103
26478,5,24,149,5745,-76,-97,21,,307081188,28,57,307081160,307081188
26479,5,24,149,5745,-81,-97,16,,307081232,28,16,307081204,307081232
26480,5,24,149,5745,-81,-97,16,,307081389,32,125,307081357,307081389
26481,5,6,149,5745,-90,-97,7,54:e4:3a:ec:fb:65,307081737,360,-12,307081377,307081737
26482,5,24,149,5745,-76,-97,21,,307082269,28,504,307082241,307082269
26483,5,24,149,5745,-81,-97,16,,307082313,28,16,307082285,307082313
26484,5,24,149,5745,-81,-97,16,,307082445,32,100,307082413,307082445
26485,5,24,149,5745,-76,-97,21,,307083375,28,902,307083347,307083375
26486,5,24,149,5745,-80,-97,17,,307083419,28,16,307083391,307083419
26487,5,24,149,5745,-81,-97,16,,307083547,32,96,307083515,307083547
26488,5,12,149,5745,-67,-97,30,2a:07:ef:54:b5:55,307083756,272,-63,307083484,307083756
26489,5,6,149,5745,-67,-97,30,,307087308,52,3500,307087256,307087308
26490,5,6,149,5745,-81,-97,16,,307087376,44,24,307087332,307087376
26491,5,24,149,5745,-81,-97,16,,307087494,28,90,307087466,307087494
26492,5,6,149,5745,-67,-97,30,,307087628,52,82,307087576,307087628
26493,5,6,149,5745,-81,-97,16,,307087696,44,24,307087652,307087696
26494,5,24,149,5745,-81,-97,16,,307087814,28,90,307087786,307087814
26495,5,24,149,5745,-76,-97,21,,307090841,28,2999,307090813,307090841
26496,5,24,149,5745,-81,-97,16,,307090885,28,16,307090857,307090885
26497,5,24,149,5745,-80,-97,17,,307091109,32,192,307091077,307091109
26498,5,12,149,5745,-67,-97,30,6a:1e:a4:f8:14:49,307094361,292,2960,307094069,307094361
26499,5,24,149,5745,-81,-97,16,,307095759,28,1370,307095731,307095759
26500,5,24,149,5745,-76,-97,21,,307095803,28,16,307095775,307095803
26501,5,24,149,5745,-76,-97,21,,307095911,32,76,307095879,307095911
26502,5,24,149,5745,-76,-97,21,,307096023,32,80,307095991,307096023
26503,5,24,149,5745,-81,-97,16,,307096193,28,142,307096165,307096193
26504,5,24,149,5745,-75,-97,22,,307096238,28,17,307096210,307096238
26505,5,24,149,5745,-76,-97,21,,307096346,32,76,307096314,307096346
26506,5,24,149,5745,-76,-97,21,,307096457,32,79,307096425,307096457
26507,5,24,149,5745,-81,-97,16,,307097050,28,565,307097022,307097050
26508,5,24,149,5745,-76,-97,21,,307097094,28,16,307097066,307097094
26509,5,24,149,5745,-76,-97,21,,307097202,32,76,307097170,307097202
26510,5,24,149,5745,-76,-97,21,,307098718,28,1488,307098690,307098718
26511,5,24,149,5745,-81,-97,16,,307098762,28,16,307098734,307098762
26512,5,24,149,5745,-81,-97,16,,307098870,32,76,307098838,307098870
26513,5,24,149,5745,-76,-97,21,,307099936,28,1038,307099908,307099936
26514,5,24,149,5745,-81,-97,16,,307099980,28,16,307099952,307099980
26515,5,24,149,5745,-81,-97,16,,307100112,32,100,307100080,307100112
26516,5,12,149,5745,-60,-97,37,a6:92:ad:b7:76:65,307104874,284,4478,307104590,307104874
26517,5,12,149,5745,-70,-97,27,d2:00:04:7e:2c:ab,307105473,244,355,307105229,307105473
26518,5,24,149,5745,-81,-97,16,,307105788,28,287,307105760,307105788
26519,5,24,149,5745,-76,-97,21,,307105831,28,15,307105803,307105831
26520,5,24,149,5745,-76,-97,21,,307105940,32,77,307105908,307105940
26521,5,12,149,5745,-64,-97,33,72:d1:72:1d:22:a1,307106426,248,238,307106178,307106426
26522,5,12,149,5745,-86,-97,11,de:be:a8:cd:79:57,307107216,284,506,307106932,307107216
26523,5,12,149,5745,-65,-97,32,56:68:e2:c2:8d:d5,307108432,288,928,307108144,307108432
26524,5,24,149,5745,-81,-97,16,,307109516,28,1056,307109488,307109516
26525,5,24,149,5745,-76,-97,21,,307109560,28,16,307109532,307109560
26526,5,24,149,5745,-76,-97,21,,307109668,32,76,307109636,307109668
26527,5,24,149,5745,-76,-97,21,,307113422,28,3726,307113394,307113422
26528,5,24,149,5745,-81,-97,16,,307113466,28,16,307113438,307113466
26529,5,24,149,5745,-81,-97,16,,307113574,32,76,307113542,307113574
26530,5,24,149,5745,-76,-97,21,,307114541,28,939,307114513,307114541
26531,5,24,149,5745,-80,-97,17,,307114585,28,16,307114557,307114585
26532,5,24,149,5745,-81,-97,16,,307114717,32,100,307114685,307114717
26533,5,24,149,5745,-81,-97,16,,307115010,28,265,307114982,307115010
26534,5,24,149,5745,-76,-97,21,,307115055,28,17,307115027,307115055
26535,5,24,149,5745,-76,-97,21,,307115163,32,76,307115131,307115163
26536,5,12,149,5745,-67,-97,30,5e:29:73:5b:30:00,307120670,272,5235,307120398,307120670
26537,5,12,149,5745,-90,-97,7,ce:c3:e4:21:bb:52,307124098,284,3144,307123814,307124098
26538,5,12,149,5745,-87,-97,10,7e:05:42:11:d2:ec,307128592,272,4222,307128320,307128592
26539,5,24,149,5745,-80,-97,17,,307129033,28,413,307129005,307129033
26540,5,24,149,5745,-76,-97,21,,307129078,28,17,307129050,307129078
26541,5,24,149,5745,-76,-97,21,,307129186,32,76,307129154,307129186
26542,5,24,149,5745,-76,-97,21,,307130839,28,1625,307130811,307130839
26543,5,24,149,5745,-80,-97,17,,307130883,28,16,307130855,307130883
26544,5,24,149,5745,-81,-97,16,,307131016,32,101,307130984,307131016
26545,5,12,149,5745,-83,-97,14,9a:24:38:da:96:bb,307139666,272,8378,307139394,307139666
26546,5,24,149,5745,-80,-97,17,,307145389,28,5695,307145361,307145389
26547,5,24,149,5745,-76,-97,21,,307145433,28,16,307145405,307145433
26548,5,24,149,5745,-76,-97,21,,307145541,32,76,307145509,307145541
26549,5,24,149,5745,-81,-97,16,,307147135,28,1566,307147107,307147135
26550,5,24,149,5745,-76,-97,21,,307147180,28,17,307147152,307147180
26551,5,24,149,5745,-76,-97,21,,307147298,32,86,307147266,307147298
26552,5,24,149,5745,-76,-97,21,,307148042,28,716,307148014,307148042
26553,5,24,149,5745,-80,-97,17,,307148086,28,16,307148058,307148086
26554,5,24,149,5745,-80,-97,17,,307148194,32,76,307148162,307148194
26555,5,24,149,5745,-76,-97,21,,307149399,28,1177,307149371,307149399
26556,5,24,149,5745,-80,-97,17,,307149443,28,16,307149415,307149443
26557,5,24,149,5745,-81,-97,16,,307149551,32,76,307149519,307149551
26558,5,24,149,5745,-81,-97,16,,307150869,28,1290,307150841,307150869
26559,5,24,149,5745,-76,-97,21,,307150913,28,16,307150885,307150913
26560,5,24,149,5745,-76,-97,21,,307151021,32,76,307150989,307151021
26561,5,24,149,5745,-76,-97,21,,307159723,28,8674,307159695,307159723
26562,5,24,149,5745,-80,-97,17,,307159767,28,16,307159739,307159767
26563,5,24,149,5745,-80,-97,17,,307159876,32,77,307159844,307159876
26564,5,24,149,5745,-80,-97,17,,307168993,28,9089,307168965,307168993
26565,5,24,149,5745,-77,-97,20,,307169037,28,16,307169009,307169037
26566,5,24,149,5745,-76,-97,21,,307169145,32,76,307169113,307169145
26567,5,24,149,5745,-77,-97,20,,307169264,32,87,307169232,307169264
26568,5,12,149,5745,-58,-97,39,22:ec:75:a8:8a:31,307169631,272,95,307169359,307169631
26569,5,24,149,5745,-81,-97,16,,307171253,28,1594,307171225,307171253
26570,5,24,149,5745,-77,-97,20,,307171297,28,16,307171269,307171297
26571,5,24,149,5745,-76,-97,21,,307171405,32,76,307171373,307171405
26572,5,24,149,5745,-77,-97,20,,307171492,28,59,307171464,307171492
26573,5,24,149,5745,-81,-97,16,,307171537,28,17,307171509,307171537
26574,5,24,149,5745,-80,-97,17,,307171645,32,76,307171613,307171645
26575,5,6,149,5745,-90,-97,7,54:e4:3a:ec:fb:65,307184138,360,12133,307183778,307184138
26576,5,12,149,5745,-70,-97,27,f2:da:61:dd:98:c5,307185799,268,1393,307185531,307185799
26577,5,24,149,5745,-80,-97,17,,307190263,28,4436,307190235,307190263
26578,5,24,149,5745,-77,-97,20,,307190307,28,16,307190279,307190307
26579,5,24,149,5745,-77,-97,20,,307190419,32,80,307190387,307190419
26580,5,24,149,5745,-81,-97,16,,307191911,28,1464,307191883,307191911
26581,5,24,149,5745,-76,-97,21,,307191955,28,16,307191927,307191955
26582,5,24,149,5745,-77,-97,20,,307192063,32,76,307192031,307192063
26583,5,24,149,5745,-77,-97,20,,307193229,28,1138,307193201,307193229
26584,5,24,149,5745,-81,-97,16,,307193274,28,17,307193246,307193274
26585,5,24,149,5745,-81,-97,16,,307193382,32,76,307193350,307193382
26586,5,12,149,5745,-68,-97,29,2a:07:ef:54:b5:55,307194738,272,1084,307194466,307194738
26587,5,24,149,5745,-80,-97,17,,307200494,28,5728,307200466,307200494
26588,5,24,149,5745,-77,-97,20,,307200538,28,16,307200510,307200538
26589,5,24,149,5745,-77,-97,20,,307200650,32,80,307200618,307200650
26590,5,24,149,5745,-76,-97,21,,307201784,28,1106,307201756,307201784
26591,5,24,149,5745,-81,-97,16,,307201828,28,16,307201800,307201828
26592,5,24,149,5745,-81,-97,16,,307201941,32,81,307201909,307201941
26593,5,24,149,5745,-81,-97,16,,307203918,28,1949,307203890,307203918
26594,5,24,149,5745,-77,-97,20,,307203962,28,16,307203934,307203962
26595,5,24,149,5745,-77,-97,20,,307204070,32,76,307204038,307204070
26596,5,24,149,5745,-76,-97,21,,307204193,32,91,307204161,307204193
26597,5,24,149,5745,-81,-97,16,,307204269,28,48,307204241,307204269
26598,5,24,149,5745,-76,-97,21,,307204312,28,15,307204284,307204312
26599,5,24,149,5745,-77,-97,20,,307204431,32,87,307204399,307204431
26600,5,24,149,5745,-76,-97,21,,307204615,28,156,307204587,307204615
26601,5,24,149,5745,-80,-97,17,,307204660,28,17,307204632,307204660
26602,5,24,149,5745,-80,-97,17,,307204768,32,76,307204736,307204768
26603,5,24,149,5745,-77,-97,20,,307206337,28,1541,307206309,307206337
26604,5,24,149,5745,-80,-97,17,,307206381,28,16,307206353,307206381
26605,5,24,149,5745,-80,-97,17,,307206490,32,77,307206458,307206490
26606,5,12,149,5745,-61,-97,36,a6:92:ad:b7:76:65,307207348,284,574,307207064,307207348
26607,5,24,149,5745,-77,-97,20,,307207711,28,335,307207683,307207711
26608,5,24,149,5745,-81,-97,16,,307207755,28,16,307207727,307207755
26609,5,24,149,5745,-80,-97,17,,307207900,32,113,307207868,307207900
26610,5,12,149,5745,-69,-97,28,d2:00:04:7e:2c:ab,307208372,244,228,307208128,307208372
26611,5,24,149,5745,-81,-97,16,,307208669,28,269,307208641,307208669
26612,5,24,149,5745,-77,-97,20,,307208713,28,16,307208685,307208713
26613,5,24,149,5745,-77,-97,20,,307208820,32,75,307208788,307208820
26614,5,12,149,5745,-64,-97,33,72:d1:72:1d:22:a1,307209571,248,503,307209323,307209571
26615,5,12,149,5745,-89,-97,8,46:28:71:6e:d2:2e,307210389,284,534,307210105,307210389
26616,5,12,149,5745,-64,-97,33,56:68:e2:c2:8d:d5,307210870,288,193,307210582,307210870
26617,5,24,149,5745,-80,-97,17,,307214991,28,4093,307214963,307214991
26618,5,24,149,5745,-77,-97,20,,307215036,28,17,307215008,307215036
26619,5,24,149,5745,-77,-97,20,,307215147,32,79,307215115,307215147
26620,5,24,149,5745,-77,-97,20,,307216386,28,1211,307216358,307216386
26621,5,24,149,5745,-80,-97,17,,307216430,28,16,307216402,307216430
26622,5,24,149,5745,-80,-97,17,,307216539,32,77,307216507,307216539
26623,5,24,149,5745,-80,-97,17,,307216814,28,247,307216786,307216814
26624,5,24,149,5745,-77,-97,20,,307216858,28,16,307216830,307216858
26625,5,24,149,5745,-77,-97,20,,307216966,32,76,307216934,307216966
26626,5,24,149,5745,-77,-97,20,,307217952,28,958,307217924,307217952
26627,5,24,149,5745,-80,-97,17,,307217996,28,16,307217968,307217996
26628,5,24,149,5745,-80,-97,17,,307218105,32,77,307218073,307218105
26629,5,24,149,5745,-81,-97,16,,307224733,28,6600,307224705,307224733
26630,5,24,149,5745,-77,-97,20,,307224777,28,16,307224749,307224777
26631,5,24,149,5745,-77,-97,20,,307224885,32,76,307224853,307224885
26632,5,12,149,5745,-93,-97,4,ce:c3:e4:21:bb:52,307226602,284,1433,307226318,307226602
26633,5,12,149,5745,-86,-97,11,de:be:a8:cd:79:57,307226926,284,40,307226642,307226926
26634,5,24,149,5745,-80,-97,17,,307230154,28,3200,307230126,307230154
26635,5,24,149,5745,-77,-97,20,,307230198,28,16,307230170,307230198
26636,5,24,149,5745,-77,-97,20,,307230324,32,94,307230292,307230324
26637,5,24,149,5745,-80,-97,17,,307230534,28,182,307230506,307230534
26638,5,24,149,5745,-77,-97,20,,307230579,28,17,307230551,307230579
26639,5,24,149,5745,-77,-97,20,,307230690,32,79,307230658,307230690
26640,5,24,149,5745,-77,-97,20,,307230809,32,87,307230777,307230809
26641,5,12,149,5745,-87,-97,10,7e:05:42:11:d2:ec,307231045,272,-36,307230773,307231045
26642,5,24,149,5745,-80,-97,17,,307231396,28,323,307231368,307231396
26643,5,24,149,5745,-77,-97,20,,307231440,28,16,307231412,307231440
26644,5,24,149,5745,-77,-97,20,,307231548,32,76,307231516,307231548
26645,5,24,149,5745,-77,-97,20,,307233298,28,1722,307233270,307233298
26646,5,24,149,5745,-81,-97,16,,307233343,28,17,307233315,307233343
26647,5,24,149,5745,-81,-97,16,,307233459,32,84,307233427,307233459
26648,5,12,149,5745,-65,-97,32,5e:29:73:5b:30:00,307238570,272,4839,307238298,307238570
26649,5,24,149,5745,-80,-97,17,,307247338,28,8740,307247310,307247338
26650,5,24,149,5745,-76,-97,21,,307247383,28,17,307247355,307247383
26651,5,24,149,5745,-77,-97,20,,307247491,32,76,307247459,307247491
26652,5,24,149,5745,-77,-97,20,,307250110,28,2591,307250082,307250110
26653,5,24,149,5745,-80,-97,17,,307250154,28,16,307250126,307250154
26654,5,24,149,5745,-81,-97,16,,307250263,32,77,307250231,307250263
26655,5,24,149,5745,-80,-97,17,,307252883,28,2592,307252855,307252883
26656,5,24,149,5745,-76,-97,21,,307252927,28,16,307252899,307252927
26657,5,24,149,5745,-77,-97,20,,307253035,32,76,307253003,307253035
26658,5,24,149,5745,-80,-97,17,,307253914,28,851,307253886,307253914
26659,5,24,149,5745,-77,-97,20,,307253958,28,16,307253930,307253958
26660,5,24,149,5745,-77,-97,20,,307254066,32,76,307254034,307254066
26661,5,12,149,5745,-68,-97,29,d2:00:04:7e:2c:ab,307258727,244,4417,307258483,307258727
26662,5,12,149,5745,-64,-97,33,72:d1:72:1d:22:a1,307259013,248,38,307258765,307259013
26663,5,24,149,5745,-77,-97,20,,307260251,28,1210,307260223,307260251
26664,5,24,149,5745,-80,-97,17,,307260295,28,16,307260267,307260295
26665,5,24,149,5745,-77,-97,20,,307261889,28,1566,307261861,307261889
26666,5,24,149,5745,-80,-97,17,,307261933,28,16,307261905,307261933
26667,5,24,149,5745,-80,-97,17,,307262042,32,77,307262010,307262042
26668,5,12,149,5745,-64,-97,33,56:68:e2:c2:8d:d5,307265222,288,2892,307264934,307265222
26669,5,12,149,5745,-59,-97,38,22:ec:75:a8:8a:31,307282481,272,16987,307282209,307282481
26670,5,24,149,5745,-76,-97,21,,307283287,28,778,307283259,307283287
26671,5,24,149,5745,-80,-97,17,,307283332,28,17,307283304,307283332
26672,5,24,149,5745,-80,-97,17,,307283440,32,76,307283408,307283440
26673,5,6,149,5745,-90,-97,7,54:e4:3a:ec:fb:65,307286538,360,2738,307286178,307286538
26674,5,12,149,5745,-71,-97,26,f2:da:61:dd:98:c5,307287728,268,922,307287460,307287728
26675,5,12,149,5745,-69,-97,28,6a:1e:a4:f8:14:49,307297510,292,9490,307297218,307297510
26676,5,24,149,5745,-77,-97,20,,307302226,28,4688,307302198,307302226
26677,5,24,149,5745,-80,-97,17,,307302270,28,16,307302242,307302270
26678,5,24,149,5745,-80,-97,17,,307302379,32,77,307302347,307302379
26679,5,12,149,5745,-90,-97,7,46:28:71:6e:d2:2e,307302461,284,-202,307302177,307302461
26680,5,12,149,5745,-87,-97,10,7e:05:42:11:d2:ec,307303435,272,702,307303163,307303435
26681,5,12,149,5745,-68,-97,29,2a:07:ef:54:b5:55,307304259,272,552,307303987,307304259
26682,5,12,149,5745,-59,-97,38,f6:0a:5c:59:72:df,307307591,288,3044,307307303,307307591
26683,5,12,149,5745,-59,-97,38,f6:0a:5c:59:72:df,307313854,288,5975,307313566,307313854
26684,5,12,149,5745,-92,-97,5,ce:c3:e4:21:bb:52,307319540,284,5402,307319256,307319540
26685,5,12,149,5745,-70,-97,27,6a:1e:a4:f8:14:49,307321413,488,1385,307320925,307321413
26686,5,24,149,5745,-80,-97,17,,307322049,28,608,307322021,307322049
26687,5,24,149,5745,-77,-97,20,,307322094,28,17,307322066,307322094
26688,5,24,149,5745,-77,-97,20,,307322202,32,76,307322170,307322202
26689,5,12,149,5745,-70,-97,27,f2:da:61:dd:98:c5,307322940,268,470,307322672,307322940
26690,5,12,149,5745,-71,-97,26,f2:da:61:dd:98:c5,307323296,268,88,307323028,307323296
26691,5,12,149,5745,-63,-97,34,56:68:e2:c2:8d:d5,307323679,484,-101,307323195,307323679
26692,5,12,149,5745,-87,-97,10,de:be:a8:cd:79:57,307324449,284,486,307324165,307324449
26693,5,12,149,5745,-59,-97,38,3e:d1:9b:c7:a4:de,307327053,544,2060,307326509,307327053
26694,5,12,149,5745,-61,-97,36,f6:0a:5c:59:72:df,307327712,288,371,307327424,307327712
26695,5,12,149,5745,-64,-97,33,72:d1:72:1d:22:a1,307328045,292,41,307327753,307328045
26696,5,12,149,5745,-61,-97,36,a6:92:ad:b7:76:65,307328587,484,58,307328103,307328587
26697,5,12,149,5745,-90,-97,7,3a:90:78:0e:4f:1f,307329710,284,839,307329426,307329710
26698,5,24,149,5745,-81,-97,16,,307330247,28,509,307330219,307330247
26699,5,24,149,5745,-77,-97,20,,307330291,28,16,307330263,307330291
26700,5,24,149,5745,-76,-97,21,,307330409,32,86,307330377,307330409
26701,5,24,149,5745,-80,-97,17,,307330587,28,150,307330559,307330587
26702,5,24,149,5745,-77,-97,20,,307330631,28,16,307330603,307330631
26703,5,24,149,5745,-77,-97,20,,307330750,32,87,307330718,307330750
26704,5,24,149,5745,-77,-97,20,,307330926,32,144,307330894,307330926
26705,5,24,149,5745,-81,-97,16,,307331247,28,293,307331219,307331247
26706,5,24,149,5745,-76,-97,21,,307331291,28,16,307331263,307331291
26707,5,24,149,5745,-76,-97,21,,307331421,32,98,307331389,307331421
26708,5,24,149,5745,-81,-97,16,,307331577,28,128,307331549,307331577
26709,5,24,149,5745,-77,-97,20,,307331621,28,16,307331593,307331621
26710,5,24,149,5745,-77,-97,20,,307331750,32,97,307331718,307331750
26711,5,12,149,5745,-67,-97,30,5e:29:73:5b:30:00,307333302,540,1012,307332762,307333302
26712,5,24,149,5745,-77,-97,20,,307333911,28,581,307333883,307333911
26713,5,24,149,5745,-80,-97,17,,307333955,28,16,307333927,307333955
26714,5,24,149,5745,-81,-97,16,,307334064,32,77,307334032,307334064
26715,5,24,149,5745,-77,-97,20,,307334432,28,340,307334404,307334432
26716,5,24,149,5745,-81,-97,16,,307334476,28,16,307334448,307334476
26717,5,24,149,5745,-80,-97,17,,307334601,32,93,307334569,307334601
26718,5,12,149,5745,-67,-97,30,d2:00:04:7e:2c:ab,307335990,440,949,307335550,307335990
26719,5,12,149,5745,-86,-97,11,de:be:a8:cd:79:57,307336715,284,441,307336431,307336715
26720,5,24,149,5745,-80,-97,17,,307338379,28,1636,307338351,307338379
26721,5,24,149,5745,-77,-97,20,,307338423,28,16,307338395,307338423
26722,5,24,149,5745,-77,-97,20,,307338542,32,87,307338510,307338542
26723,5,24,149,5745,-80,-97,17,,307338731,28,161,307338703,307338731
26724,5,24,149,5745,-77,-97,20,,307338775,28,16,307338747,307338775
26725,5,24,149,5745,-77,-97,20,,307338894,32,87,307338862,307338894
26726,5,12,149,5745,-92,-97,5,ce:c3:e4:21:bb:52,307339920,284,742,307339636,307339920
26727,5,24,149,5745,-80,-97,17,,307340283,28,335,307340255,307340283
26728,5,24,149,5745,-77,-97,20,,307340327,28,16,307340299,307340327
26729,5,24,149,5745,-77,-97,20,,307340445,32,86,307340413,307340445
26730,5,24,149,5745,-77,-97,20,,307340537,28,64,307340509,307340537
26731,5,24,149,5745,-80,-97,17,,307340582,28,17,307340554,307340582
26732,5,24,149,5745,-81,-97,16,,307340690,32,76,307340658,307340690
26733,5,24,149,5745,-80,-97,17,,307340765,28,47,307340737,307340765
26734,5,24,149,5745,-77,-97,20,,307340810,28,17,307340782,307340810
26735,5,24,149,5745,-79,-97,18,,307340976,28,138,307340948,307340976
26736,5,24,149,5745,-78,-97,19,,307341020,28,16,307340992,307341020
26737,5,24,149,5745,-77,-97,20,,307341139,32,87,307341107,307341139
26738,5,24,149,5745,-76,-97,21,,307342189,28,1022,307342161,307342189
26739,5,24,149,5745,-80,-97,17,,307342233,28,16,307342205,307342233
26740,5,24,149,5745,-80,-97,17,,307342341,32,76,307342309,307342341
26741,5,12,149,5745,-69,-97,28,2a:07:ef:54:b5:55,307342763,468,-46,307342295,307342763
26742,5,12,149,5745,-59,-97,38,22:ec:75:a8:8a:31,307343274,544,-33,307342730,307343274
26743,5,24,149,5745,-80,-97,17,,307349660,28,6358,307349632,307349660
26744,5,24,149,5745,-76,-97,21,,307349704,28,16,307349676,307349704
26745,5,24,149,5745,-77,-97,20,,307349812,32,76,307349780,307349812
26746,5,12,149,5745,-87,-97,10,7e:05:42:11:d2:ec,307352821,468,2541,307352353,307352821
26747,5,12,149,5745,-64,-97,33,72:d1:72:1d:22:a1,307355483,292,2370,307355191,307355483
26748,5,12,149,5745,-83,-97,14,9a:24:38:da:96:bb,307358860,272,3105,307358588,307358860
26749,5,24,149,5745,-77,-97,20,,307364909,28,6021,307364881,307364909
26750,5,24,149,5745,-81,-97,16,,307364953,28,16,307364925,307364953
26751,5,24,149,5745,-80,-97,17,,307365061,32,76,307365029,307365061
26752,5,24,149,5745,-76,-97,21,,307370059,28,4970,307370031,307370059
26753,5,24,149,5745,-80,-97,17,,307370103,28,16,307370075,307370103
26754,5,24,149,5745,-80,-97,17,,307370212,32,77,307370180,307370212
26755,5,12,149,5745,-64,-97,33,56:68:e2:c2:8d:d5,307370287,288,-213,307369999,307370287
26756,5,12,149,5745,-67,-97,30,d2:00:04:7e:2c:ab,307370746,244,215,307370502,307370746
26757,5,12,149,5745,-67,-97,30,5e:29:73:5b:30:00,307371798,272,780,307371526,307371798
26758,5,24,149,5745,-80,-97,17,,307382560,28,10734,307382532,307382560
26759,5,24,149,5745,-77,-97,20,,307382604,28,16,307382576,307382604
26760,5,24,149,5745,-77,-97,20,,307382712,32,76,307382680,307382712
26761,5,12,149,5745,-71,-97,26,6a:1e:a4:f8:14:49,307386297,488,3097,307385809,307386297
26762,5,12,149,5745,-64,-97,33,56:68:e2:c2:8d:d5,307386864,484,83,307386380,307386864
26763,5,12,149,5745,-59,-97,38,3e:d1:9b:c7:a4:de,307387378,544,-30,307386834,307387378
26764,5,12,149,5745,-71,-97,26,f2:da:61:dd:98:c5,307387993,268,347,307387725,307387993
26765,5,6,149,5745,-90,-97,7,54:e4:3a:ec:fb:65,307388939,360,586,307388579,307388939
26766,5,12,149,5745,-90,-97,7,3a:90:78:0e:4f:1f,307389961,132,890,307389829,307389961
26767,5,12,149,5745,-85,-97,12,de:be:a8:cd:79:57,307390144,284,-101,307389860,307390144
26768,5,12,149,5745,-91,-97,6,46:28:71:6e:d2:2e,307391215,284,787,307390931,307391215
26769,5,12,149,5745,-61,-97,36,f6:0a:5c:59:72:df,307391785,288,282,307391497,307391785
26770,5,12,149,5745,-63,-97,34,72:d1:72:1d:22:a1,307392136,132,219,307392004,307392136
26771,5,12,149,5745,-59,-97,38,a6:92:ad:b7:76:65,307394363,484,1743,307393879,307394363
26772,5,12,149,5745,-83,-97,14,9a:24:38:da:96:bb,307397062,824,1875,307396238,307397062
26773,5,12,149,5745,-66,-97,31,0a:b9:b7:b1:4d:fa,307397974,268,644,307397706,307397974
26774,5,12,149,5745,-67,-97,30,5e:29:73:5b:30:00,307399212,540,698,307398672,307399212
26775,5,12,149,5745,-88,-97,9,7e:05:42:11:d2:ec,307400248,468,568,307399780,307400248
26776,5,12,149,5745,-66,-97,31,d2:00:04:7e:2c:ab,307400805,440,117,307400365,307400805
26777,5,12,149,5745,-60,-97,37,22:ec:75:a8:8a:31,307401369,272,292,307401097,307401369
26778,5,12,149,5745,-59,-97,38,a6:92:ad:b7:76:65,307401720,284,67,307401436,307401720
26779,5,12,149,5745,-63,-97,34,72:d1:72:1d:22:a1,307402849,292,837,307402557,307402849
26780,5,12,149,5745,-66,-97,31,d2:00:04:7e:2c:ab,307405004,380,1775,307404624,307405004
26781,5,12,149,5745,-70,-97,27,2a:07:ef:54:b5:55,307407905,468,2433,307407437,307407905
26782,5,12,149,5745,-59,-97,38,22:ec:75:a8:8a:31,307408434,544,-15,307407890,307408434
26783,5,12,149,5745,-88,-97,9,7e:05:42:11:d2:ec,307416741,272,8035,307416469,307416741
26784,5,12,149,5745,-71,-97,26,2a:07:ef:54:b5:55,307418273,272,1260,307418001,307418273
26785,5,12,149,5745,-70,-97,27,6a:1e:a4:f8:14:49,307419884,292,1319,307419592,307419884
26786,5,12,149,5745,-62,-97,35,f6:0a:5c:59:72:df,307425682,288,5510,307425394,307425682
26787,5,24,149,5745,-81,-97,16,,307426253,32,539,307426221,307426253
26788,5,24,149,5745,-80,-97,17,,307426648,28,367,307426620,307426648
26789,5,6,149,5745,-89,-97,8,,307426808,68,92,307426740,307426808
26790,5,24,149,5745,-81,-97,16,,307427873,32,1033,307427841,307427873
26791,5,24,149,5745,-77,-97,20,,307429417,28,1516,307429389,307429417
26792,5,24,149,5745,-81,-97,16,,307429462,28,17,307429434,307429462
26793,5,24,149,5745,-80,-97,17,,307429570,32,76,307429538,307429570
26794,5,12,149,5745,-71,-97,26,f2:da:61:dd:98:c5,307438238,268,8400,307437970,307438238
26795,5,12,149,5745,-59,-97,38,3e:d1:9b:c7:a4:de,307446364,272,7854,307446092,307446364
26796,5,24,149,5745,-81,-97,16,,307446970,28,578,307446942,307446970
26797,5,24,149,5745,-76,-97,21,,307447014,28,16,307446986,307447014
26798,5,24,149,5745,-76,-97,21,,307447122,32,76,307447090,307447122
26799,5,12,149,5745,-86,-97,11,de:be:a8:cd:79:57,307451030,284,3624,307450746,307451030
26800,5,12,149,5745,-85,-97,12,de:be:a8:cd:79:57,307454494,284,3180,307454210,307454494
26801,5,12,149,5745,-66,-97,31,d2:00:04:7e:2c:ab,307466917,440,11983,307466477,307466917
26802,5,12,149,5745,-67,-97,30,5e:29:73:5b:30:00,307467400,272,211,307467128,307467400
26803,5,12,149,5745,-91,-97,6,3a:90:78:0e:4f:1f,307468910,284,1226,307468626,307468910
26804,5,12,149,5745,-84,-97,13,9a:24:38:da:96:bb,307471516,272,2334,307471244,307471516
26805,5,12,149,5745,-64,-97,33,72:d1:72:1d:22:a1,307478309,292,6501,307478017,307478309
26806,5,12,149,5745,-66,-97,31,d2:00:04:7e:2c:ab,307484341,244,5788,307484097,307484341
26807,5,12,149,5745,-64,-97,33,56:68:e2:c2:8d:d5,307491249,288,6620,307490961,307491249
26808,5,12,149,5745,-58,-97,39,22:ec:75:a8:8a:31,307511371,272,19850,307511099,307511371
26809,5,12,149,5745,-86,-97,11,de:be:a8:cd:79:57,307519458,284,7803,307519174,307519458
26810,5,12,149,5745,-59,-97,38,a6:92:ad:b7:76:65,307526887,284,7145,307526603,307526887
26811,5,24,149,5745,-76,-97,21,,307530182,28,3267,307530154,307530182
26812,5,24,149,5745,-80,-97,17,,307530227,28,17,307530199,307530227
26813,5,24,149,5745,-81,-97,16,,307530335,32,76,307530303,307530335
26814,5,12,149,5745,-87,-97,10,7e:05:42:11:d2:ec,307538583,272,7976,307538311,307538583
26815,5,12,149,5745,-92,-97,5,ce:c3:e4:21:bb:52,307544947,284,6080,307544663,307544947
26816,5,24,149,5745,-81,-97,16,,307548059,28,3084,307548031,307548059
26817,5,24,149,5745,-76,-97,21,,307548103,28,16,307548075,307548103
26818,5,24,149,5745,-76,-97,21,,307548211,32,76,307548179,307548211
26819,5,12,149,5745,-57,-97,40,3e:d1:9b:c7:a4:de,307563683,272,15200,307563411,307563683
26820,5,12,149,5745,-87,-97,10,de:be:a8:cd:79:57,307565929,284,1962,307565645,307565929
26821,5,12,149,5745,-68,-97,29,5e:29:73:5b:30:00,307581197,272,14996,307580925,307581197
26822,5,12,149,5745,-86,-97,11,de:be:a8:cd:79:57,307585739,284,4258,307585455,307585739
26823,5,12,149,5745,-83,-97,14,9a:24:38:da:96:bb,307587064,272,1053,307586792,307587064
26824,5,6,149,5745,-90,-97,7,54:e4:3a:ec:fb:65,307590160,352,2744,307589808,307590160
26825,5,12,149,5745,-72,-97,25,6a:1e:a4:f8:14:49,307590618,292,166,307590326,307590618
26826,5,12,149,5745,-68,-97,29,2a:07:ef:54:b5:55,307593531,272,2641,307593259,307593531
26827,5,6,149,5745,-92,-97,5,54:e4:3a:ec:fb:65,307593835,360,-56,307593475,307593835
26828,5,12,149,5745,-70,-97,27,f2:da:61:dd:98:c5,307596650,268,2547,307596382,307596650
26829,5,12,149,5745,-66,-97,31,d2:00:04:7e:2c:ab,307596980,244,86,307596736,307596980
26830,5,6,149,5745,-90,-97,7,54:e4:3a:ec:fb:65,307600439,352,3107,307600087,307600439
26831,5,12,149,5745,-67,-97,30,72:d1:72:1d:22:a1,307618340,292,17609,307618048,307618340
26832,5,12,149,5745,-64,-97,33,56:68:e2:c2:8d:d5,307620428,288,1800,307620140,307620428
26833,5,12,149,5745,-57,-97,40,22:ec:75:a8:8a:31,307628492,272,7792,307628220,307628492
26834,5,12,149,5745,-86,-97,11,7e:05:42:11:d2:ec,307648691,272,19927,307648419,307648691
26835,5,12,149,5745,-90,-97,7,ce:c3:e4:21:bb:52,307651634,284,2659,307651350,307651634
26836,5,24,149,5745,-75,-97,22,,307653624,28,1962,307653596,307653624
26837,5,24,149,5745,-81,-97,16,,307653668,28,16,307653640,307653668
26838,5,24,149,5745,-81,-97,16,,307653777,32,77,307653745,307653777
26839,5,12,149,5745,-58,-97,39,f6:0a:5c:59:72:df,307661037,288,6972,307660749,307661037
26840,5,24,149,5745,-81,-97,16,,307672102,28,11037,307672074,307672102
26841,5,24,149,5745,-75,-97,22,,307672146,28,16,307672118,307672146
26842,5,24,149,5745,-75,-97,22,,307672254,32,76,307672222,307672254
26843,5,12,149,5745,-88,-97,9,de:be:a8:cd:79:57,307672653,256,143,307672397,307672653
26844,5,12,149,5745,-58,-97,39,3e:d1:9b:c7:a4:de,307677466,272,4541,307677194,307677466
26845,5,12,149,5745,-69,-97,28,6a:1e:a4:f8:14:49,307692749,292,14991,307692457,307692749
26846,5,12,149,5745,-66,-97,31,2a:07:ef:54:b5:55,307695699,272,2678,307695427,307695699
26847,5,12,149,5745,-82,-97,15,9a:24:38:da:96:bb,307696043,272,72,307695771,307696043
26848,5,12,149,5745,-68,-97,29,5e:29:73:5b:30:00,307698784,272,2469,307698512,307698784
26849,5,12,149,5745,-72,-97,25,f2:da:61:dd:98:c5,307699161,268,109,307698893,307699161
26850,5,12,149,5745,-57,-97,40,a6:92:ad:b7:76:65,307719713,284,20268,307719429,307719713
26851,5,12,149,5745,-65,-97,32,d2:00:04:7e:2c:ab,307720457,244,500,307720213,307720457
26852,5,12,149,5745,-67,-97,30,72:d1:72:1d:22:a1,307720844,292,95,307720552,307720844
26853,5,12,149,5745,-63,-97,34,56:68:e2:c2:8d:d5,307722860,288,1728,307722572,307722860
26854,5,12,149,5745,-57,-97,40,a6:92:ad:b7:76:65,307745058,284,21914,307744774,307745058
26855,5,12,149,5745,-57,-97,40,22:ec:75:a8:8a:31,307745544,272,214,307745272,307745544
26856,5,24,149,5745,-74,-97,23,,307752035,28,6463,307752007,307752035
26857,5,24,149,5745,-81,-97,16,,307752079,28,16,307752051,307752079
26858,5,24,149,5745,-82,-97,15,,307752187,32,76,307752155,307752187
26859,5,12,149,5745,-87,-97,10,7e:05:42:11:d2:ec,307753683,272,1224,307753411,307753683
26860,5,12,149,5745,-91,-97,6,ce:c3:e4:21:bb:52,307754035,284,68,307753751,307754035
26861,5,12,149,5745,-66,-97,31,2a:07:ef:54:b5:55,307764021,272,9714,307763749,307764021
26862,5,12,149,5745,-58,-97,39,f6:0a:5c:59:72:df,307764327,288,18,307764039,307764327
26863,5,12,149,5745,-67,-97,30,6a:1e:a4:f8:14:49,307768431,292,3812,307768139,307768431
26864,5,24,149,5745,-81,-97,16,,307770579,28,2120,307770551,307770579
26865,5,24,149,5745,-74,-97,23,,307770624,28,17,307770596,307770624
26866,5,24,149,5745,-74,-97,23,,307770731,32,75,307770699,307770731
26867,5,12,149,5745,-67,-97,30,f2:da:61:dd:98:c5,307781722,268,10723,307781454,307781722
26868,5,12,149,5745,-63,-97,34,56:68:e2:c2:8d:d5,307782079,484,-127,307781595,307782079
26869,5,12,149,5745,-92,-97,5,ce:c3:e4:21:bb:52,307782813,132,602,307782681,307782813
26870,5,12,149,5745,-91,-97,6,3a:90:78:0e:4f:1f,307784020,284,923,307783736,307784020
26871,5,12,149,5745,-58,-97,39,3e:d1:9b:c7:a4:de,307784357,544,-207,307783813,307784357
26872,5,12,149,5745,-58,-97,39,f6:0a:5c:59:72:df,307784943,288,298,307784655,307784943
26873,5,12,149,5745,-92,-97,5,3a:90:78:0e:4f:1f,307785956,132,881,307785824,307785956
26874,5,12,149,5745,-67,-97,30,f2:da:61:dd:98:c5,307786328,268,104,307786060,307786328
26875,5,12,149,5745,-58,-97,39,a6:92:ad:b7:76:65,307787152,484,340,307786668,307787152
26876,5,12,149,5745,-66,-97,31,2a:07:ef:54:b5:55,307788839,468,1219,307788371,307788839
26877,5,12,149,5745,-84,-97,13,9a:24:38:da:96:bb,307791210,824,1547,307790386,307791210
26878,5,12,149,5745,-87,-97,10,7e:05:42:11:d2:ec,307793728,468,2050,307793260,307793728
26879,5,12,149,5745,-65,-97,32,5e:29:73:5b:30:00,307795183,540,915,307794643,307795183
26880,5,12,149,5745,-58,-97,39,3e:d1:9b:c7:a4:de,307795955,272,500,307795683,307795955
26881,5,12,149,5745,-91,-97,6,3a:90:78:0e:4f:1f,307796912,284,673,307796628,307796912
26882,5,12,149,5745,-69,-97,28,6a:1e:a4:f8:14:49,307797664,488,264,307797176,307797664
26883,5,12,149,5745,-66,-97,31,72:d1:72:1d:22:a1,307798231,292,275,307797939,307798231
26884,5,6,149,5745,-89,-97,8,54:e4:3a:ec:fb:65,307798541,360,-50,307798181,307798541
26885,5,24,149,5745,-81,-97,16,,307802519,32,3946,307802487,307802519
26886,5,24,149,5745,-81,-97,16,,307802953,32,402,307802921,307802953
26887,5,12,149,5745,-57,-97,40,22:ec:75:a8:8a:31,307803168,544,-329,307802624,307803168
26888,5,12,149,5745,-84,-97,13,9a:24:38:da:96:bb,307806903,272,3463,307806631,307806903
26889,5,12,149,5745,-63,-97,34,56:68:e2:c2:8d:d5,307812189,288,4998,307811901,307812189
26890,5,12,149,5745,-67,-97,30,72:d1:72:1d:22:a1,307813826,292,1345,307813534,307813826
26891,5,24,149,5745,-82,-97,15,,307820798,32,6940,307820766,307820798
26892,5,24,149,5745,-82,-97,15,,307821157,28,331,307821129,307821157
26893,5,6,149,5745,-89,-97,8,,307821317,68,92,307821249,307821317
26894,5,12,149,5745,-67,-97,30,5e:29:73:5b:30:00,307830892,272,9303,307830620,307830892
26895,5,12,149,5745,-61,-97,36,a6:92:ad:b7:76:65,307843609,484,12233,307843125,307843609
26896,5,12,149,5745,-85,-97,12,7e:05:42:11:d2:ec,307845867,468,1790,307845399,307845867
26897,5,12,149,5745,-61,-97,36,a6:92:ad:b7:76:65,307859483,284,13332,307859199,307859483
26898,5,24,149,5745,-81,-97,16,,307859919,32,404,307859887,307859919
26899,5,24,149,5745,-81,-97,16,,307860306,28,359,307860278,307860306
26900,5,6,149,5745,-91,-97,6,,307860466,68,92,307860398,307860466
26901,5,12,149,5745,-59,-97,38,22:ec:75:a8:8a:31,307860561,272,-177,307860289,307860561
26902,5,24,149,5745,-80,-97,17,,307861813,28,1224,307861785,307861813
26903,5,24,149,5745,-81,-97,16,,307862205,28,364,307862177,307862205
26904,5,6,149,5745,-92,-97,5,,307862365,68,92,307862297,307862365
26905,5,24,149,5745,-82,-97,15,,307863895,32,1498,307863863,307863895
26906,5,12,149,5745,-92,-97,5,46:28:71:6e:d2:2e,307867462,284,3283,307867178,307867462
26907,5,12,149,5745,-69,-97,28,2a:07:ef:54:b5:55,307871828,272,4094,307871556,307871828
26908,5,12,149,5745,-83,-97,14,7e:05:42:11:d2:ec,307875982,272,3882,307875710,307875982
26909,5,24,149,5745,-75,-97,22,,307879027,28,3017,307878999,307879027
26910,5,24,149,5745,-80,-97,17,,307879071,28,16,307879043,307879071
26911,5,24,149,5745,-82,-97,15,,307879179,32,76,307879147,307879179
26912,5,12,149,5745,-68,-97,29,6a:1e:a4:f8:14:49,307882400,292,2929,307882108,307882400
26913,5,12,149,5745,-92,-97,5,ce:c3:e4:21:bb:52,307883054,284,370,307882770,307883054
26914,5,24,149,5745,-81,-97,16,,307897283,28,14201,307897255,307897283
26915,5,24,149,5745,-75,-97,22,,307897328,28,17,307897300,307897328
26916,5,24,149,5745,-75,-97,22,,307897436,32,76,307897404,307897436
26917,5,12,149,5745,-69,-97,28,f2:da:61:dd:98:c5,307899422,268,1718,307899154,307899422
26918,5,6,149,5745,-89,-97,8,54:e4:3a:ec:fb:65,307900942,360,1160,307900582,307900942
26919,5,24,149,5745,-81,-97,16,,307910498,32,9524,307910466,307910498
26920,5,12,149,5745,-59,-97,38,3e:d1:9b:c7:a4:de,307910713,272,-57,307910441,307910713
26921,5,12,149,5745,-63,-97,34,a6:92:ad:b7:76:65,307911019,484,-178,307910535,307911019
26922,5,12,149,5745,-84,-97,13,7e:05:42:11:d2:ec,307911545,468,58,307911077,307911545
26923,5,12,149,5745,-59,-97,38,3e:d1:9b:c7:a4:de,307914834,544,2745,307914290,307914834
26924,5,12,149,5745,-69,-97,28,f2:da:61:dd:98:c5,307915432,268,330,307915164,307915432
26925,5,12,149,5745,-91,-97,6,3a:90:78:0e:4f:1f,307916278,284,562,307915994,307916278
26926,5,12,149,5745,-66,-97,31,2a:07:ef:54:b5:55,307918300,468,1554,307917832,307918300
26927,5,12,149,5745,-66,-97,31,0a:b9:b7:b1:4d:fa,307923419,268,4851,307923151,307923419
26928,5,12,149,5745,-65,-97,32,5e:29:73:5b:30:00,307924811,540,852,307924271,307924811
26929,5,12,149,5745,-67,-97,30,72:d1:72:1d:22:a1,307928980,292,3877,307928688,307928980
26930,5,12,149,5745,-59,-97,38,22:ec:75:a8:8a:31,307934427,544,4903,307933883,307934427
26931,5,12,149,5745,-66,-97,31,d2:00:04:7e:2c:ab,307935007,440,140,307934567,307935007
26932,5,12,149,5745,-64,-97,33,56:68:e2:c2:8d:d5,307938571,288,3276,307938283,307938571
26933,5,12,149,5745,-66,-97,31,5e:29:73:5b:30:00,307944764,272,5921,307944492,307944764
26934,5,12,149,5745,-85,-97,12,9a:24:38:da:96:bb,307953868,272,8832,307953596,307953868
26935,5,12,149,5745,-60,-97,37,22:ec:75:a8:8a:31,307974773,272,20633,307974501,307974773
26936,5,24,149,5745,-77,-97,20,,307978693,28,3892,307978665,307978693
26937,5,24,149,5745,-80,-97,17,,307978737,28,16,307978709,307978737
26938,5,24,149,5745,-80,-97,17,,307978845,32,76,307978813,307978845
26939,5,12,149,5745,-90,-97,7,46:28:71:6e:d2:2e,307983366,284,4237,307983082,307983366
26940,5,12,149,5745,-63,-97,34,a6:92:ad:b7:76:65,307986623,284,2973,307986339,307986623
26941,5,12,149,5745,-72,-97,25,2a:07:ef:54:b5:55,307987890,272,995,307987618,307987890
26942,5,12,149,5745,-85,-97,12,7e:05:42:11:d2:ec,307988333,272,171,307988061,307988333
26943,5,12,149,5745,-67,-97,30,6a:1e:a4:f8:14:49,307995372,292,6747,307995080,307995372
26944,5,24,149,5745,-80,-97,17,,307997106,28,1706,307997078,307997106
26945,5,24,149,5745,-76,-97,21,,307997151,28,17,307997123,307997151
26946,5,24,149,5745,-77,-97,20,,307997259,32,76,307997227,307997259
26947,5,6,149,5745,-89,-97,8,54:e4:3a:ec:fb:65,308003342,360,5723,308002982,308003342
26948,5,24,149,5745,-77,-97,20,,308009943,28,6573,308009915,308009943
26949,5,24,149,5745,-80,-97,17,,308009987,28,16,308009959,308009987
26950,5,24,149,5745,-80,-97,17,,308010099,32,80,308010067,308010099
26951,5,24,149,5745,-81,-97,16,,308011266,28,1139,308011238,308011266
26952,5,24,149,5745,-77,-97,20,,308011311,28,17,308011283,308011311
26953,5,24,149,5745,-77,-97,20,,308011419,32,76,308011387,308011419
26954,5,24,149,5745,-81,-97,16,,308011600,28,153,308011572,308011600
26955,5,24,149,5745,-77,-97,20,,308011644,28,16,308011616,308011644
26956,5,24,149,5745,-77,-97,20,,308011755,32,79,308011723,308011755
26957,5,12,149,5745,-67,-97,30,f2:da:61:dd:98:c5,308012658,268,635,308012390,308012658
26958,5,24,149,5745,-77,-97,20,,308015281,28,2595,308015253,308015281
26959,5,24,149,5745,-80,-97,17,,308015325,28,16,308015297,308015325
26960,5,24,149,5745,-80,-97,17,,308015445,32,88,308015413,308015445
26961,5,24,149,5745,-77,-97,20,,308017108,28,1635,308017080,308017108
26962,5,24,149,5745,-80,-97,17,,308017152,28,16,308017124,308017152
26963,5,24,149,5745,-80,-97,17,,308017260,32,76,308017228,308017260
26964,5,12,149,5745,-58,-97,39,3e:d1:9b:c7:a4:de,308017521,272,-11,308017249,308017521
26965,5,24,149,5745,-77,-97,20,,308017971,28,422,308017943,308017971
26966,5,24,149,5745,-80,-97,17,,308018015,28,16,308017987,308018015
26967,5,24,149,5745,-80,-97,17,,308018132,32,85,308018100,308018132
26968,5,24,149,5745,-80,-97,17,,308036386,28,18226,308036358,308036386
26969,5,24,149,5745,-77,-97,20,,308036430,28,16,308036402,308036430
26970,5,24,149,5745,-77,-97,20,,308036549,32,87,308036517,308036549
26971,5,24,149,5745,-80,-97,17,,308036740,28,163,308036712,308036740
26972,5,24,149,5745,-77,-97,20,,308036784,28,16,308036756,308036784
26973,5,24,149,5745,-77,-97,20,,308036900,32,84,308036868,308036900
26974,5,24,149,5745,-77,-97,20,,308037019,32,87,308036987,308037019
26975,5,24,149,5745,-80,-97,17,,308037171,28,124,308037143,308037171
26976,5,24,149,5745,-77,-97,20,,308037214,28,15,308037186,308037214
26977,5,24,149,5745,-77,-97,20,,308037323,32,77,308037291,308037323
26978,5,24,149,5745,-77,-97,20,,308039183,28,1832,308039155,308039183
26979,5,24,149,5745,-80,-97,17,,308039227,28,16,308039199,308039227
26980,5,24,149,5745,-79,-97,18,,308039344,32,85,308039312,308039344
26981,5,24,149,5745,-79,-97,18,,308050146,28,10774,308050118,308050146
26982,5,24,149,5745,-77,-97,20,,308050190,28,16,308050162,308050190
26983,5,24,149,5745,-78,-97,19,,308050302,32,80,308050270,308050302
26984,5,24,149,5745,-79,-97,18,,308050479,28,149,308050451,308050479
26985,5,24,149,5745,-77,-97,20,,308050524,28,17,308050496,308050524
26986,5,24,149,5745,-77,-97,20,,308050632,32,76,308050600,308050632
26987,5,24,149,5745,-77,-97,20,,308052767,28,2107,308052739,308052767
26988,5,24,149,5745,-79,-97,18,,308052811,28,16,308052783,308052811
26989,5,24,149,5745,-79,-97,18,,308052920,32,77,308052888,308052920
26990,5,24,149,5745,-79,-97,18,,308053215,28,267,308053187,308053215
26991,5,24,149,5745,-77,-97,20,,308053260,28,17,308053232,308053260
26992,5,24,149,5745,-77,-97,20,,308053367,32,75,308053335,308053367
26993,5,24,149,5745,-77,-97,20,,308055577,28,2182,308055549,308055577
26994,5,24,149,5745,-79,-97,18,,308055621,28,16,308055593,308055621
26995,5,24,149,5745,-79,-97,18,,308055729,32,76,308055697,308055729
26996,5,24,149,5745,-78,-97,19,,308060991,28,5234,308060963,308060991
26997,5,24,149,5745,-78,-97,19,,308061035,28,16,308061007,308061035
26998,5,24,149,5745,-78,-97,19,,308061171,32,104,308061139,308061171
26999,5,24,149,5745,-79,-97,18,,308069244,28,8045,308069216,308069244
27000,5,24,149,5745,-77,-97,20,,308069288,28,16,308069260,308069288
27001,5,24,149,5745,-78,-97,19,,308069396,32,76,308069364,308069396
27002,5,24,149,5745,-78,-97,19,,308075221,28,5797,308075193,308075221
27003,5,24,149,5745,-78,-97,19,,308075265,28,16,308075237,308075265
27004,5,24,149,5745,-78,-97,19,,308075373,32,76,308075341,308075373
27005,5,24,149,5745,-78,-97,19,,308075536,28,135,308075508,308075536
27006,5,24,149,5745,-78,-97,19,,308075580,28,16,308075552,308075580
27007,5,24,149,5745,-78,-97,19,,308075688,32,76,308075656,308075688
27008,5,24,149,5745,-78,-97,19,,308075800,32,80,308075768,308075800
27009,5,12,149,5745,-58,-97,39,22:ec:75:a8:8a:31,308088217,272,12145,308087945,308088217
27010,5,12,149,5745,-68,-97,29,2a:07:ef:54:b5:55,308100560,272,12071,308100288,308100560
27011,5,24,149,5745,-79,-97,18,,308105018,28,4430,308104990,308105018
27012,5,24,149,5745,-78,-97,19,,308105062,28,16,308105034,308105062
27013,5,24,149,5745,-78,-97,19,,308105174,32,80,308105142,308105174
27014,5,6,149,5745,-91,-97,6,54:e4:3a:ec:fb:65,308105743,360,209,308105383,308105743
27015,5,12,149,5745,-69,-97,28,6a:1e:a4:f8:14:49,308108075,292,2040,308107783,308108075
27016,5,12,149,5745,-58,-97,39,f6:0a:5c:59:72:df,308116248,288,7885,308115960,308116248
27017,5,12,149,5745,-70,-97,27,f2:da:61:dd:98:c5,308122514,268,5998,308122246,308122514
27018,5,24,149,5745,-78,-97,19,,308123144,28,602,308123116,308123144
27019,5,24,149,5745,-78,-97,19,,308123189,28,17,308123161,308123189
27020,5,24,149,5745,-78,-97,19,,308123296,32,75,308123264,308123296
27021,5,12,149,5745,-58,-97,39,a6:92:ad:b7:76:65,308128902,284,5322,308128618,308128902
27022,5,12,149,5745,-63,-97,34,56:68:e2:c2:8d:d5,308132451,288,3261,308132163,308132451
27023,5,12,149,5745,-57,-97,40,3e:d1:9b:c7:a4:de,308133449,272,726,308133177,308133449
27024,5,12,149,5745,-86,-97,11,7e:05:42:11:d2:ec,308146507,272,12786,308146235,308146507
27025,5,12,149,5745,-91,-97,6,ce:c3:e4:21:bb:52,308148273,284,1482,308147989,308148273
27026,5,12,149,5745,-66,-97,31,5e:29:73:5b:30:00,308153479,272,4934,308153207,308153479
27027,5,24,149,5745,-79,-97,18,,308158009,28,4502,308157981,308158009
27028,5,24,149,5745,-79,-97,18,,308158054,28,17,308158026,308158054
27029,5,24,149,5745,-79,-97,18,,308158165,32,79,308158133,308158165
27030,5,24,149,5745,-79,-97,18,,308159870,28,1677,308159842,308159870
27031,5,24,149,5745,-80,-97,17,,308159915,28,17,308159887,308159915
27032,5,24,149,5745,-79,-97,18,,308160023,32,76,308159991,308160023
27033,5,24,149,5745,-80,-97,17,,308161201,28,1150,308161173,308161201
27034,5,24,149,5745,-79,-97,18,,308161245,28,16,308161217,308161245
27035,5,24,149,5745,-79,-97,18,,308161354,32,77,308161322,308161354
27036,5,24,149,5745,-79,-97,18,,308171191,28,9809,308171163,308171191
27037,5,24,149,5745,-79,-97,18,,308171235,28,16,308171207,308171235
27038,5,24,149,5745,-79,-97,18,,308171343,32,76,308171311,308171343
27039,5,24,149,5745,-79,-97,18,,308175301,32,3926,308175269,308175301
27040,5,24,149,5745,-79,-97,18,,308179745,28,4416,308179717,308179745
27041,5,24,149,5745,-81,-97,16,,308179789,28,16,308179761,308179789
27042,5,24,149,5745,-80,-97,17,,308179897,32,76,308179865,308179897
27043,5,12,149,5745,-83,-97,14,9a:24:38:da:96:bb,308181966,272,1797,308181694,308181966
27044,5,24,149,5745,-81,-97,16,,308183678,28,1684,308183650,308183678
27045,5,24,149,5745,-80,-97,17,,308183722,28,16,308183694,308183722
27046,5,24,149,5745,-80,-97,17,,308183843,32,89,308183811,308183843
27047,5,24,149,5745,-80,-97,17,,308191517,28,7646,308191489,308191517
27048,5,24,149,5745,-81,-97,16,,308191562,28,17,308191534,308191562
27049,5,24,149,5745,-81,-97,16,,308191670,32,76,308191638,308191670
27050,5,24,149,5745,-81,-97,16,,308192421,28,723,308192393,308192421
27051,5,24,149,5745,-81,-97,16,,308192465,28,16,308192437,308192465
27052,5,24,149,5745,-81,-97,16,,308192573,32,76,308192541,308192573
27053,5,24,149,5745,-81,-97,16,,308192676,28,75,308192648,308192676
27054,5,24,149,5745,-79,-97,18,,308192720,28,16,308192692,308192720
27055,5,24,149,5745,-81,-97,16,,308192936,28,188,308192908,308192936
27056,5,24,149,5745,-81,-97,16,,308192980,28,16,308192952,308192980
27057,5,24,149,5745,-81,-97,16,,308193089,32,77,308193057,308193089
27058,5,24,149,5745,-81,-97,16,,308194349,28,1232,308194321,308194349
27059,5,24,149,5745,-81,-97,16,,308194393,28,16,308194365,308194393
27060,5,24,149,5745,-81,-97,16,,308194502,32,77,308194470,308194502
27061,5,24,149,5745,-81,-97,16,,308195491,28,961,308195463,308195491
27062,5,24,149,5745,-81,-97,16,,308195535,28,16,308195507,308195535
27063,5,24,149,5745,-81,-97,16,,308195660,32,93,308195628,308195660
27064,5,24,149,5745,-81,-97,16,,308200316,28,4628,308200288,308200316
27065,5,24,149,5745,-81,-97,16,,308200361,28,17,308200333,308200361
27066,5,24,149,5745,-81,-97,16,,308200469,32,76,308200437,308200469
27067,5,24,149,5745,-81,-97,16,,308202383,28,1886,308202355,308202383
27068,5,24,149,5745,-81,-97,16,,308202427,28,16,308202399,308202427
27069,5,24,149,5745,-81,-97,16,,308202535,32,76,308202503,308202535
27070,5,24,149,5745,-81,-97,16,,308203275,28,712,308203247,308203275
27071,5,24,149,5745,-81,-97,16,,308203319,28,16,308203291,308203319
27072,5,24,149,5745,-81,-97,16,,308203427,32,76,308203395,308203427
27073,5,24,149,5745,-81,-97,16,,308203655,28,200,308203627,308203655
27074,5,24,149,5745,-81,-97,16,,308203700,28,17,308203672,308203700
27075,5,24,149,5745,-81,-97,16,,308203808,32,76,308203776,308203808
27076,5,24,149,5745,-81,-97,16,,308203969,28,133,308203941,308203969
27077,5,24,149,5745,-81,-97,16,,308204013,28,16,308203985,308204013
27078,5,24,149,5745,-81,-97,16,,308204121,32,76,308204089,308204121
27079,5,24,149,5745,-81,-97,16,,308204331,28,182,308204303,308204331
27080,5,24,149,5745,-81,-97,16,,308204376,28,17,308204348,308204376
27081,5,24,149,5745,-81,-97,16,,308204487,32,79,308204455,308204487
27082,5,12,149,5745,-58,-97,39,22:ec:75:a8:8a:31,308205142,272,383,308204870,308205142
27083,5,24,149,5745,-81,-97,16,,308206188,28,1018,308206160,308206188
27084,5,24,149,5745,-80,-97,17,,308206232,28,16,308206204,308206232
27085,5,24,149,5745,-80,-97,17,,308206340,32,76,308206308,308206340
27086,5,6,149,5745,-89,-97,8,54:e4:3a:ec:fb:65,308208144,360,1444,308207784,308208144
27087,5,24,149,5745,-81,-97,16,,308209194,28,1022,308209166,308209194
27088,5,24,149,5745,-81,-97,16,,308209238,28,16,308209210,308209238
27089,5,24,149,5745,-81,-97,16,,308209351,32,81,308209319,308209351
27090,5,24,149,5745,-81,-97,16,,308211445,32,2062,308211413,308211445
27091,5,24,149,5745,-80,-97,17,,308211723,28,250,308211695,308211723
27092,5,24,149,5745,-80,-97,17,,308212109,28,358,308212081,308212109
27093,5,24,149,5745,-81,-97,16,,308212153,28,16,308212125,308212153
27094,5,24,149,5745,-81,-97,16,,308212265,32,80,308212233,308212265
27095,5,12,149,5745,-70,-97,27,2a:07:ef:54:b5:55,308213921,272,1384,308213649,308213921
27096,5,12,149,5745,-69,-97,28,6a:1e:a4:f8:14:49,308217152,292,2939,308216860,308217152
27097,5,24,149,5745,-80,-97,17,,308220857,28,3677,308220829,308220857
27098,5,24,149,5745,-80,-97,17,,308220901,28,16,308220873,308220901
27099,5,24,149,5745,-80,-97,17,,308221009,32,76,308220977,308221009
27100,5,24,149,5745,-81,-97,16,,308221165,28,128,308221137,308221165
27101,5,24,149,5745,-80,-97,17,,308221210,28,17,308221182,308221210
27102,5,24,149,5745,-79,-97,18,,308221318,32,76,308221286,308221318
27103,5,12,149,5745,-60,-97,37,a6:92:ad:b7:76:65,308231263,284,9661,308230979,308231263
27104,5,12,149,5745,-65,-97,32,72:d1:72:1d:22:a1,308233160,292,1605,308232868,308233160
27105,5,12,149,5745,-65,-97,32,56:68:e2:c2:8d:d5,308234837,288,1389,308234549,308234837
27106,5,12,149,5745,-57,-97,40,3e:d1:9b:c7:a4:de,308249261,272,14152,308248989,308249261
27107,5,12,149,5745,-86,-97,11,7e:05:42:11:d2:ec,308250494,272,961,308250222,308250494
27108,5,12,149,5745,-92,-97,5,ce:c3:e4:21:bb:52,308250795,284,17,308250511,308250795
27109,5,12,149,5745,-64,-97,33,5e:29:73:5b:30:00,308270479,272,19412,308270207,308270479
27110,5,6,149,5745,-91,-97,6,54:e4:3a:ec:fb:65,308310544,360,39705,308310184,308310544
27111,5,12,149,5745,-74,-97,23,f2:da:61:dd:98:c5,308311570,268,758,308311302,308311570
27112,5,12,149,5745,-59,-97,38,22:ec:75:a8:8a:31,308316997,272,5155,308316725,308316997
27113,5,12,149,5745,-69,-97,28,2a:07:ef:54:b5:55,308322157,272,4888,308321885,308322157
27114,5,12,149,5745,-84,-97,13,7e:05:42:11:d2:ec,308323650,272,1221,308323378,308323650
27115,5,24,149,5745,-79,-97,18,,308331289,28,7611,308331261,308331289
27116,5,24,149,5745,-79,-97,18,,308331524,28,207,308331496,308331524
27117,5,24,149,5745,-80,-97,17,,308331803,28,251,308331775,308331803
27118,5,24,149,5745,-79,-97,18,,308332298,28,467,308332270,308332298
27119,5,24,149,5745,-81,-97,16,,308332342,28,16,308332314,308332342
27120,5,24,149,5745,-80,-97,17,,308332455,32,81,308332423,308332455
27121,5,12,149,5745,-59,-97,38,a6:92:ad:b7:76:65,308333219,284,480,308332935,308333219
27122,5,12,149,5745,-65,-97,32,72:d1:72:1d:22:a1,308335435,292,1924,308335143,308335435
27123,5,12,149,5745,-64,-97,33,56:68:e2:c2:8d:d5,308336416,288,693,308336128,308336416
27124,5,12,149,5745,-73,-97,24,6a:1e:a4:f8:14:49,308337669,292,961,308337377,308337669
27125,5,24,149,5745,-80,-97,17,,308350497,28,12800,308350469,308350497
27126,5,24,149,5745,-80,-97,17,,308350541,28,16,308350513,308350541
27127,5,24,149,5745,-80,-97,17,,308350649,32,76,308350617,308350649
27128,5,12,149,5745,-73,-97,24,f2:da:61:dd:98:c5,308351328,268,411,308351060,308351328
27129,5,12,149,5745,-93,-97,4,ce:c3:e4:21:bb:52,308354283,284,2671,308353999,308354283
27130,5,12,149,5745,-64,-97,33,3e:d1:9b:c7:a4:de,308369474,272,14919,308369202,308369474
27131,5,12,149,5745,-72,-97,25,6a:1e:a4:f8:14:49,308369780,488,-182,308369292,308369780
27132,5,12,149,5745,-63,-97,34,56:68:e2:c2:8d:d5,308370356,484,92,308369872,308370356
27133,5,12,149,5745,-64,-97,33,3e:d1:9b:c7:a4:de,308370883,544,-17,308370339,308370883
27134,5,12,149,5745,-61,-97,36,a6:92:ad:b7:76:65,308371461,484,94,308370977,308371461
27135,5,12,149,5745,-62,-97,35,72:d1:72:1d:22:a1,308371999,292,246,308371707,308371999
27136,5,12,149,5745,-90,-97,7,46:28:71:6e:d2:2e,308373712,284,1429,308373428,308373712
27137,5,12,149,5745,-60,-97,37,f6:0a:5c:59:72:df,308375215,288,1215,308374927,308375215
27138,5,12,149,5745,-66,-97,31,2a:07:ef:54:b5:55,308377805,468,2122,308377337,308377805
27139,5,12,149,5745,-71,-97,26,5e:29:73:5b:30:00,308382574,540,4229,308382034,308382574
27140,5,12,149,5745,-64,-97,33,56:68:e2:c2:8d:d5,308385678,288,2816,308385390,308385678
27141,5,12,149,5745,-61,-97,36,72:d1:72:1d:22:a1,308386189,292,219,308385897,308386189
27142,5,12,149,5745,-72,-97,25,f2:da:61:dd:98:c5,308388336,268,1879,308388068,308388336
27143,5,12,149,5745,-60,-97,37,22:ec:75:a8:8a:31,308391669,544,2789,308391125,308391669
27144,5,24,149,5745,-79,-97,18,,308397097,32,5396,308397065,308397097
27145,5,24,149,5745,-78,-97,19,,308397542,32,413,308397510,308397542
27146,5,24,149,5745,-79,-97,18,,308397988,28,418,308397960,308397988
27147,5,12,149,5745,-85,-97,12,9a:24:38:da:96:bb,308402240,272,3980,308401968,308402240
27148,5,12,149,5745,-69,-97,28,5e:29:73:5b:30:00,308403465,272,953,308403193,308403465
27149,5,6,149,5745,-90,-97,7,54:e4:3a:ec:fb:65,308412945,360,9120,308412585,308412945
27150,5,12,149,5745,-59,-97,38,a6:92:ad:b7:76:65,308419044,284,5815,308418760,308419044
27151,5,24,149,5745,-81,-97,16,,308426999,28,7927,308426971,308426999
27152,5,24,149,5745,-79,-97,18,,308427043,28,16,308427015,308427043
27153,5,24,149,5745,-79,-97,18,,308427151,32,76,308427119,308427151
27154,5,12,149,5745,-86,-97,11,7e:05:42:11:d2:ec,308432503,272,5080,308432231,308432503
27155,5,12,149,5745,-70,-97,27,2a:07:ef:54:b5:55,308433976,272,1201,308433704,308433976
27156,5,12,149,5745,-74,-97,23,6a:1e:a4:f8:14:49,308434832,488,368,308434344,308434832
27157,5,12,149,5745,-65,-97,32,56:68:e2:c2:8d:d5,308435354,484,38,308434870,308435354
27158,5,12,149,5745,-74,-97,23,f2:da:61:dd:98:c5,308436904,268,1282,308436636,308436904
27159,5,12,149,5745,-62,-97,35,f6:0a:5c:59:72:df,308439035,288,1843,308438747,308439035
27160,5,12,149,5745,-86,-97,11,7e:05:42:11:d2:ec,308442025,360,2630,308441665,308442025
27161,5,12,149,5745,-71,-97,26,2a:07:ef:54:b5:55,308442597,468,104,308442129,308442597
27162,5,12,149,5745,-64,-97,33,f6:0a:5c:59:72:df,308443144,288,259,308442856,308443144
27163,5,12,149,5745,-64,-97,33,f6:0a:5c:59:72:df,308443700,132,424,308443568,308443700
27164,5,24,149,5745,-78,-97,19,,308445235,28,1507,308445207,308445235
27165,5,24,149,5745,-81,-97,16,,308445279,28,16,308445251,308445279
27166,5,24,149,5745,-81,-97,16,,308445387,32,76,308445355,308445387
27167,5,12,149,5745,-68,-97,29,5e:29:73:5b:30:00,308447817,540,1890,308447277,308447817
27168,5,12,149,5745,-63,-97,34,0a:b9:b7:b1:4d:fa,308448409,268,324,308448141,308448409
27169,5,12,149,5745,-61,-97,36,22:ec:75:a8:8a:31,308449852,272,1171,308449580,308449852
27170,5,12,149,5745,-64,-97,33,72:d1:72:1d:22:a1,308451356,292,1212,308451064,308451356
27171,5,12,149,5745,-75,-97,22,f2:da:61:dd:98:c5,308453374,268,1750,308453106,308453374
27172,5,6,149,5745,-63,-97,34,,308453649,52,223,308453597,308453649
27173,5,6,149,5745,-78,-97,19,,308453717,44,24,308453673,308453717
27174,5,24,149,5745,-78,-97,19,,308453835,28,90,308453807,308453835
27175,5,12,149,5745,-61,-97,36,22:ec:75:a8:8a:31,308456462,544,2083,308455918,308456462
27176,5,12,149,5745,-68,-97,29,d2:00:04:7e:2c:ab,308460993,440,4091,308460553,308460993
27177,5,12,149,5745,-58,-97,39,3e:d1:9b:c7:a4:de,308484966,272,23701,308484694,308484966
27178,5,12,149,5745,-64,-97,33,72:d1:72:1d:22:a1,308486516,292,1258,308486224,308486516
27179,5,12,149,5745,-70,-97,27,5e:29:73:5b:30:00,308496936,272,10148,308496664,308496936
27180,5,12,149,5745,-63,-97,34,56:68:e2:c2:8d:d5,308513584,288,16360,308513296,308513584
27181,5,12,149,5745,-86,-97,11,9a:24:38:da:96:bb,308515072,272,1216,308514800,308515072
27182,5,24,149,5745,-79,-97,18,,308533751,32,18647,308533719,308533751
27183,5,24,149,5745,-78,-97,19,,308534039,28,260,308534011,308534039
27184,5,6,149,5745,-91,-97,6,,308534198,68,91,308534130,308534198
27185,5,12,149,5745,-57,-97,40,a6:92:ad:b7:76:65,308544668,284,10186,308544384,308544668
27186,5,12,149,5745,-59,-97,38,22:ec:75:a8:8a:31,308546748,272,1808,308546476,308546748
27187,5,12,149,5745,-86,-97,11,7e:05:42:11:d2:ec,308548120,272,1100,308547848,308548120
27188,5,24,149,5745,-78,-97,19,,308558581,28,10433,308558553,308558581
27189,5,24,149,5745,-79,-97,18,,308558625,28,16,308558597,308558625
27190,5,24,149,5745,-79,-97,18,,308558734,32,77,308558702,308558734
27191,5,12,149,5745,-63,-97,34,f6:0a:5c:59:72:df,308570397,288,11375,308570109,308570397
27192,5,24,149,5745,-80,-97,17,,308576244,28,5819,308576216,308576244
27193,5,24,149,5745,-79,-97,18,,308576288,28,16,308576260,308576288
27194,5,24,149,5745,-79,-97,18,,308576396,32,76,308576364,308576396
27195,5,24,149,5745,-80,-97,17,,308584626,32,8198,308584594,308584626
27196,5,12,149,5745,-57,-97,40,3e:d1:9b:c7:a4:de,308590905,272,6007,308590633,308590905
27197,5,6,149,5745,-64,-97,33,,308593138,52,2181,308593086,308593138
27198,5,6,149,5745,-81,-97,16,,308593206,44,24,308593162,308593206
27199,5,24,149,5745,-80,-97,17,,308593324,28,90,308593296,308593324
27200,5,12,149,5745,-71,-97,26,5e:29:73:5b:30:00,308609228,272,15632,308608956,308609228
27201,5,24,149,5745,-80,-97,17,,308611956,28,2700,308611928,308611956
27202,5,12,149,5745,-74,-97,23,6a:1e:a4:f8:14:49,308614931,292,2683,308614639,308614931
27203,5,12,149,5745,-68,-97,29,2a:07:ef:54:b5:55,308617399,272,2196,308617127,308617399
27204,5,6,149,5745,-91,-97,6,54:e4:3a:ec:fb:65,308617746,360,-13,308617386,308617746
27205,5,12,149,5745,-72,-97,25,f2:da:61:dd:98:c5,308620550,268,2536,308620282,308620550
27206,5,24,149,5745,-81,-97,16,,308621727,28,1149,308621699,308621727
27207,5,12,149,5745,-84,-97,13,9a:24:38:da:96:bb,308639000,272,17001,308638728,308639000
27208,5,12,149,5745,-68,-97,29,72:d1:72:1d:22:a1,308642389,292,3097,308642097,308642389
27209,5,12,149,5745,-63,-97,34,56:68:e2:c2:8d:d5,308644449,288,1772,308644161,308644449
27210,5,12,149,5745,-59,-97,38,a6:92:ad:b7:76:65,308652608,284,7875,308652324,308652608
27211,5,12,149,5745,-86,-97,11,7e:05:42:11:d2:ec,308662143,272,9263,308661871,308662143
27212,5,12,149,5745,-59,-97,38,22:ec:75:a8:8a:31,308663755,272,1340,308663483,308663755
27213,5,6,149,5745,-62,-97,35,,308669787,52,5980,308669735,308669787
27214,5,6,149,5745,-80,-97,17,,308669855,44,24,308669811,308669855
27215,5,24,149,5745,-80,-97,17,,308669973,28,90,308669945,308669973
27216,5,12,149,5745,-57,-97,40,3e:d1:9b:c7:a4:de,308704974,272,34729,308704702,308704974
27217,5,12,149,5745,-73,-97,24,6a:1e:a4:f8:14:49,308716799,292,11533,308716507,308716799
27218,5,12,149,5745,-67,-97,30,2a:07:ef:54:b5:55,308719825,272,2754,308719553,308719825
27219,5,6,149,5745,-90,-97,7,54:e4:3a:ec:fb:65,308720146,360,-39,308719786,308720146
27220,5,12,149,5745,-75,-97,22,f2:da:61:dd:98:c5,308720935,268,521,308720667,308720935
27221,5,12,149,5745,-69,-97,28,5e:29:73:5b:30:00,308726156,272,4949,308725884,308726156
27222,5,12,149,5745,-85,-97,12,9a:24:38:da:96:bb,308738307,272,11879,308738035,308738307
27223,5,12,149,5745,-68,-97,29,72:d1:72:1d:22:a1,308745098,292,6499,308744806,308745098
27224,5,12,149,5745,-64,-97,33,56:68:e2:c2:8d:d5,308745532,288,146,308745244,308745532
27225,5,12,149,5745,-85,-97,12,7e:05:42:11:d2:ec,308774223,272,28419,308773951,308774223
27226,5,12,149,5745,-59,-97,38,a6:92:ad:b7:76:65,308775017,284,510,308774733,308775017
27227,5,12,149,5745,-71,-97,26,2a:07:ef:54:b5:55,308777839,272,2550,308777567,308777839
27228,5,12,149,5745,-60,-97,37,22:ec:75:a8:8a:31,308779291,272,1180,308779019,308779291
27229,5,12,149,5745,-74,-97,23,6a:1e:a4:f8:14:49,308781118,292,1535,308780826,308781118
27230,5,24,149,5745,-79,-97,18,,308803622,32,22472,308803590,308803622
27231,5,12,149,5745,-70,-97,27,f2:da:61:dd:98:c5,308809958,268,6068,308809690,308809958
27232,5,24,149,5745,-79,-97,18,,308820838,28,10852,308820810,308820838
27233,5,6,149,5745,-89,-97,8,,308820997,68,91,308820929,308820997
27234,5,6,149,5745,-89,-97,8,54:e4:3a:ec:fb:65,308822546,360,1189,308822186,308822546
27235,5,12,149,5745,-62,-97,35,a6:92:ad:b7:76:65,308829550,484,6520,308829066,308829550
27236,5,12,149,5745,-70,-97,27,72:d1:72:1d:22:a1,308830070,292,228,308829778,308830070
27237,5,12,149,5745,-71,-97,26,f2:da:61:dd:98:c5,308830405,268,67,308830137,308830405
27238,5,12,149,5745,-72,-97,25,6a:1e:a4:f8:14:49,308831319,488,426,308830831,308831319
27239,5,12,149,5745,-55,-97,42,3e:d1:9b:c7:a4:de,308831841,544,-22,308831297,308831841
27240,5,12,149,5745,-64,-97,33,56:68:e2:c2:8d:d5,308832447,484,122,308831963,308832447
27241,5,12,149,5745,-63,-97,34,f6:0a:5c:59:72:df,308834364,288,1629,308834076,308834364
27242,5,12,149,5745,-72,-97,25,2a:07:ef:54:b5:55,308835784,468,952,308835316,308835784
27243,5,12,149,5745,-70,-97,27,72:d1:72:1d:22:a1,308836520,132,604,308836388,308836520
27244,5,12,149,5745,-63,-97,34,f6:0a:5c:59:72:df,308838252,132,1600,308838120,308838252
27245,5,12,149,5745,-66,-97,31,5e:29:73:5b:30:00,308840520,540,1728,308839980,308840520
27246,5,12,149,5745,-66,-97,31,5e:29:73:5b:30:00,308845910,272,5118,308845638,308845910
27247,5,12,149,5745,-69,-97,28,72:d1:72:1d:22:a1,308846595,292,393,308846303,308846595
27248,5,12,149,5745,-87,-97,10,9a:24:38:da:96:bb,308849824,824,2405,308849000,308849824
27249,5,12,149,5745,-85,-97,12,9a:24:38:da:96:bb,308850665,272,569,308850393,308850665
27250,5,12,149,5745,-61,-97,36,22:ec:75:a8:8a:31,308852015,544,806,308851471,308852015
27251,5,24,149,5745,-78,-97,19,,308859302,28,7259,308859274,308859302
27252,5,24,149,5745,-80,-97,17,,308859346,28,16,308859318,308859346
27253,5,24,149,5745,-80,-97,17,,308859455,32,77,308859423,308859455
27254,5,24,149,5745,-80,-97,17,,308865103,32,5616,308865071,308865103
27255,5,12,149,5745,-70,-97,27,2a:07:ef:54:b5:55,308876838,272,11463,308876566,308876838
27256,5,24,149,5745,-80,-97,17,,308877665,28,799,308877637,308877665
27257,5,24,149,5745,-79,-97,18,,308877709,28,16,308877681,308877709
27258,5,24,149,5745,-79,-97,18,,308877817,32,76,308877785,308877817
27259,5,12,149,5745,-64,-97,33,a6:92:ad:b7:76:65,308877928,284,-173,308877644,308877928
27260,5,12,149,5745,-73,-97,24,6a:1e:a4:f8:14:49,308878372,292,152,308878080,308878372
27261,5,12,149,5745,-60,-97,37,22:ec:75:a8:8a:31,308894761,272,16117,308894489,308894761
27262,5,12,149,5745,-61,-97,36,a6:92:ad:b7:76:65,308895120,484,-125,308894636,308895120
27263,5,12,149,5745,-60,-97,37,f6:0a:5c:59:72:df,308909999,288,14591,308909711,308909999
27264,5,12,149,5745,-73,-97,24,f2:da:61:dd:98:c5,308921107,268,10840,308920839,308921107
27265,5,6,149,5745,-90,-97,7,54:e4:3a:ec:fb:65,308924947,360,3480,308924587,308924947
27266,5,12,149,5745,-59,-97,38,3e:d1:9b:c7:a4:de,308933461,272,8242,308933189,308933461
27267,5,12,149,5745,-66,-97,31,72:d1:72:1d:22:a1,308952898,292,19145,308952606,308952898
27268,5,12,149,5745,-62,-97,35,56:68:e2:c2:8d:d5,308955265,288,2079,308954977,308955265
27269,5,12,149,5745,-58,-97,39,a6:92:ad:b7:76:65,308959925,484,4176,308959441,308959925
27270,5,12,149,5745,-68,-97,29,5e:29:73:5b:30:00,308960628,272,431,308960356,308960628
27271,5,12,149,5745,-72,-97,25,f2:da:61:dd:98:c5,308960972,268,76,308960704,308960972
27272,5,12,149,5745,-90,-97,7,9a:24:38:da:96:bb,308961783,272,539,308961511,308961783
27273,5,12,149,5745,-58,-97,39,3e:d1:9b:c7:a4:de,308963577,544,1250,308963033,308963577
27274,5,12,149,5745,-70,-97,27,2a:07:ef:54:b5:55,308966830,468,2785,308966362,308966830
27275,5,12,149,5745,-68,-97,29,0a:b9:b7:b1:4d:fa,308972471,268,5373,308972203,308972471
27276,5,12,149,5745,-68,-97,29,5e:29:73:5b:30:00,308974807,540,1796,308974267,308974807
27277,5,12,149,5745,-59,-97,38,22:ec:75:a8:8a:31,308983987,544,8636,308983443,308983987
27278,5,24,149,5745,-79,-97,18,,308984638,28,623,308984610,308984638
27279,5,24,149,5745,-80,-97,17,,308984682,28,16,308984654,308984682
27280,5,24,149,5745,-80,-97,17,,308984790,32,76,308984758,308984790
27281,5,24,149,5745,-78,-97,19,,308985840,28,1022,308985812,308985840
27282,5,24,149,5745,-80,-97,17,,308985884,28,16,308985856,308985884
27283,5,24,149,5745,-80,-97,17,,308985992,32,76,308985960,308985992
27284,5,12,149,5745,-70,-97,27,2a:07:ef:54:b5:55,308991206,272,4942,308990934,308991206
27285,5,12,149,5745,-57,-97,40,a6:92:ad:b7:76:65,308992686,284,1196,308992402,308992686
27286,5,24,149,5745,-80,-97,17,,309003184,28,10470,309003156,309003184
27287,5,24,149,5745,-79,-97,18,,309003228,28,16,309003200,309003228
27288,5,24,149,5745,-79,-97,18,,309003336,32,76,309003304,309003336
27289,5,24,149,5745,-80,-97,17,,309003926,28,562,309003898,309003926
27290,5,24,149,5745,-79,-97,18,,309003971,28,17,309003943,309003971
27291,5,24,149,5745,-79,-97,18,,309004079,32,76,309004047,309004079
27292,5,12,149,5745,-59,-97,38,22:ec:75:a8:8a:31,309008410,272,4059,309008138,309008410
27293,5,12,149,5745,-86,-97,11,7e:05:42:11:d2:ec,309008752,244,98,309008508,309008752
27294,5,12,149,5745,-70,-97,27,6a:1e:a4:f8:14:49,309024496,292,15452,309024204,309024496
27295,5,6,149,5745,-90,-97,7,54:e4:3a:ec:fb:65,309027348,360,2492,309026988,309027348
27296,5,12,149,5745,-59,-97,38,f6:0a:5c:59:72:df,309035180,288,7544,309034892,309035180
27297,5,12,149,5745,-56,-97,41,3e:d1:9b:c7:a4:de,309051600,272,16148,309051328,309051600
27298,5,12,149,5745,-64,-97,33,72:d1:72:1d:22:a1,309064105,248,12257,309063857,309064105
27299,5,12,149,5745,-63,-97,34,56:68:e2:c2:8d:d5,309066322,288,1929,309066034,309066322
27300,5,12,149,5745,-68,-97,29,5e:29:73:5b:30:00,309067623,272,1029,309067351,309067623
27301,5,6,149,5745,-63,-97,34,,309068472,52,797,309068420,309068472
27302,5,6,149,5745,-81,-97,16,,309068540,44,24,309068496,309068540
27303,5,24,149,5745,-82,-97,15,,309068657,28,89,309068629,309068657
27304,5,6,149,5745,-63,-97,34,,309068757,52,48,309068705,309068757
27305,5,6,149,5745,-80,-97,17,,309068825,44,24,309068781,309068825
27306,5,24,149,5745,-82,-97,15,,309068951,32,94,309068919,309068951
27307,5,24,149,5745,-81,-97,16,,309072884,32,3901,309072852,309072884
27308,5,24,149,5745,-81,-97,16,,309073330,32,414,309073298,309073330
27309,5,24,149,5745,-82,-97,15,,309073776,28,418,309073748,309073776
27310,5,24,149,5745,-81,-97,16,,309074771,28,967,309074743,309074771
27311,5,24,149,5745,-80,-97,17,,309119786,32,44983,309119754,309119786
27312,5,24,149,5745,-81,-97,16,,309120231,32,413,309120199,309120231
27313,5,24,149,5745,-80,-97,17,,309120676,28,417,309120648,309120676
27314,5,24,149,5745,-77,-97,20,,309120722,28,18,309120694,309120722
27315,5,24,149,5745,-77,-97,20,,309120839,32,85,309120807,309120839
27316,5,12,149,5745,-91,-97,6,46:28:71:6e:d2:2e,309122064,284,941,309121780,309122064
27317,5,12,149,5745,-59,-97,38,22:ec:75:a8:8a:31,309124044,272,1708,309123772,309124044
27318,5,12,149,5745,-74,-97,23,6a:1e:a4:f8:14:49,309127094,292,2758,309126802,309127094
27319,5,6,149,5745,-90,-97,7,54:e4:3a:ec:fb:65,309129748,360,2294,309129388,309129748
27320,5,12,149,5745,-68,-97,29,2a:07:ef:54:b5:55,309130172,272,152,309129900,309130172
27321,5,12,149,5745,-86,-97,11,7e:05:42:11:d2:ec,309134597,244,4181,309134353,309134597
27322,5,24,149,5745,-81,-97,16,,309147786,28,13161,309147758,309147786
27323,5,24,149,5745,-79,-97,18,,309147830,28,16,309147802,309147830
27324,5,24,149,5745,-79,-97,18,,309147942,32,80,309147910,309147942
27325,5,24,149,5745,-80,-97,17,,309149100,28,1130,309149072,309149100
27326,5,24,149,5745,-80,-97,17,,309149144,28,16,309149116,309149144
27327,5,24,149,5745,-80,-97,17,,309149256,32,80,309149224,309149256
27328,5,24,149,5745,-79,-97,18,,309149394,28,110,309149366,309149394
27329,5,24,149,5745,-80,-97,17,,309149438,28,16,309149410,309149438
27330,5,24,149,5745,-80,-97,17,,309149546,32,76,309149514,309149546
27331,5,24,149,5745,-80,-97,17,,309152303,28,2729,309152275,309152303
27332,5,24,149,5745,-79,-97,18,,309152347,28,16,309152319,309152347
27333,5,24,149,5745,-79,-97,18,,309152456,32,77,309152424,309152456
27334,5,12,149,5745,-61,-97,36,a6:92:ad:b7:76:65,309152907,284,167,309152623,309152907
27335,5,24,149,5745,-81,-97,16,,309158221,32,5282,309158189,309158221
27336,5,24,149,5745,-79,-97,18,,309158730,32,477,309158698,309158730
27337,5,24,149,5745,-79,-97,18,,309159238,28,480,309159210,309159238
27338,5,24,149,5745,-76,-97,21,,309159284,28,18,309159256,309159284
27339,5,24,149,5745,-76,-97,21,,309159398,32,82,309159366,309159398
27340,5,24,149,5745,-80,-97,17,,309162969,32,3539,309162937,309162969
27341,5,24,149,5745,-79,-97,18,,309168490,28,5493,309168462,309168490
27342,5,24,149,5745,-79,-97,18,,309168534,28,16,309168506,309168534
27343,5,24,149,5745,-79,-97,18,,309168642,32,76,309168610,309168642
27344,5,12,149,5745,-59,-97,38,3e:d1:9b:c7:a4:de,309168708,272,-206,309168436,309168708
27345,5,24,149,5745,-79,-97,18,,309171401,28,2665,309171373,309171401
27346,5,24,149,5745,-79,-97,18,,309171445,28,16,309171417,309171445
27347,5,24,149,5745,-79,-97,18,,309171553,32,76,309171521,309171553
27348,5,24,149,5745,-79,-97,18,,309172468,28,887,309172440,309172468
27349,5,24,149,5745,-79,-97,18,,309172512,28,16,309172484,309172512
27350,5,24,149,5745,-79,-97,18,,309172628,32,84,309172596,309172628
27351,5,24,149,5745,-79,-97,18,,309183355,32,10695,309183323,309183355
27352,5,24,149,5745,-79,-97,18,,309183764,32,377,309183732,309183764
27353,5,24,149,5745,-79,-97,18,,309184174,28,382,309184146,309184174
27354,5,24,149,5745,-76,-97,21,,309184220,28,18,309184192,309184220
27355,5,24,149,5745,-76,-97,21,,309184333,32,81,309184301,309184333
27356,5,12,149,5745,-68,-97,29,5e:29:73:5b:30:00,309184729,272,124,309184457,309184729
27357,5,24,149,5745,-76,-97,21,,309185225,28,468,309185197,309185225
27358,5,24,149,5745,-79,-97,18,,309185268,28,15,309185240,309185268
27359,5,24,149,5745,-79,-97,18,,309185383,32,83,309185351,309185383
27360,5,24,149,5745,-79,-97,18,,309188609,28,3198,309188581,309188609
27361,5,24,149,5745,-80,-97,17,,309188653,28,16,309188625,309188653
27362,5,24,149,5745,-80,-97,17,,309188761,32,76,309188729,309188761
27363,5,24,149,5745,-79,-97,18,,309188959,28,170,309188931,309188959
27364,5,24,149,5745,-80,-97,17,,309189003,28,16,309188975,309189003
27365,5,24,149,5745,-81,-97,16,,309189136,32,101,309189104,309189136
27366,5,24,149,5745,-78,-97,19,,309189285,28,121,309189257,309189285
27367,5,24,149,5745,-80,-97,17,,309189329,28,16,309189301,309189329
27368,5,24,149,5745,-81,-97,16,,309189447,32,86,309189415,309189447
27369,5,24,149,5745,-78,-97,19,,309189532,28,57,309189504,309189532
27370,5,24,149,5745,-80,-97,17,,309189576,28,16,309189548,309189576
27371,5,24,149,5745,-81,-97,16,,309189695,32,87,309189663,309189695
27372,5,24,149,5745,-80,-97,17,,309191619,28,1896,309191591,309191619
27373,5,24,149,5745,-79,-97,18,,309191664,28,17,309191636,309191664
27374,5,24,149,5745,-79,-97,18,,309191776,32,80,309191744,309191776
27375,5,24,149,5745,-80,-97,17,,309192804,28,1000,309192776,309192804
27376,5,24,149,5745,-78,-97,19,,309192848,28,16,309192820,309192848
27377,5,24,149,5745,-79,-97,18,,309192981,32,101,309192949,309192981
27378,5,24,149,5745,-78,-97,19,,309195300,32,2287,309195268,309195300
27379,5,24,149,5745,-78,-97,19,,309195419,32,87,309195387,309195419
27380,5,12,149,5745,-82,-97,15,9a:24:38:da:96:bb,309201283,272,5592,309201011,309201283
27381,5,24,149,5745,-78,-97,19,,309209003,28,7692,309208975,309209003
27382,5,24,149,5745,-80,-97,17,,309209047,28,16,309209019,309209047
27383,5,24,149,5745,-81,-97,16,,309209155,32,76,309209123,309209155
27384,5,24,149,5745,-79,-97,18,,309209365,32,178,309209333,309209365
27385,5,24,149,5745,-78,-97,19,,309209873,32,476,309209841,309209873
27386,5,24,149,5745,-79,-97,18,,309210381,28,480,309210353,309210381
27387,5,24,149,5745,-76,-97,21,,309210428,28,19,309210400,309210428
27388,5,24,149,5745,-76,-97,21,,309210544,32,84,309210512,309210544
27389,5,24,149,5745,-78,-97,19,,309210764,28,192,309210736,309210764
27390,5,24,149,5745,-81,-97,16,,309210808,28,16,309210780,309210808
27391,5,24,149,5745,-80,-97,17,,309210916,32,76,309210884,309210916
27392,5,24,149,5745,-79,-97,18,,309211088,28,144,309211060,309211088
27393,5,24,149,5745,-81,-97,16,,309211132,28,16,309211104,309211132
27394,5,24,149,5745,-80,-97,17,,309211240,32,76,309211208,309211240
27395,5,24,149,5745,-81,-97,16,,309214158,28,2890,309214130,309214158
27396,5,24,149,5745,-79,-97,18,,309214202,28,16,309214174,309214202
27397,5,24,149,5745,-79,-97,18,,309214311,32,77,309214279,309214311
27398,5,24,149,5745,-80,-97,17,,309215275,28,936,309215247,309215275
27399,5,24,149,5745,-79,-97,18,,309215319,28,16,309215291,309215319
27400,5,24,149,5745,-79,-97,18,,309215427,32,76,309215395,309215427
27401,5,24,149,5745,-79,-97,18,,309223629,28,8174,309223601,309223629
27402,5,24,149,5745,-81,-97,16,,309223673,28,16,309223645,309223673
27403,5,24,149,5745,-81,-97,16,,309223785,32,80,309223753,309223785
27404,5,24,149,5745,-81,-97,16,,309226471,28,2658,309226443,309226471
27405,5,24,149,5745,-79,-97,18,,309226515,28,16,309226487,309226515
27406,5,24,149,5745,-79,-97,18,,309226624,32,77,309226592,309226624
27407,5,12,149,5745,-74,-97,23,6a:1e:a4:f8:14:49,309229282,292,2366,309228990,309229282
27408,5,12,149,5745,-68,-97,29,2a:07:ef:54:b5:55,309231311,272,1757,309231039,309231311
27409,5,6,149,5745,-90,-97,7,54:e4:3a:ec:fb:65,309232149,360,478,309231789,309232149
27410,5,12,149,5745,-74,-97,23,f2:da:61:dd:98:c5,309233003,268,586,309232735,309233003
27411,5,12,149,5745,-58,-97,39,22:ec:75:a8:8a:31,309235915,272,2640,309235643,309235915
27412,5,12,149,5745,-60,-97,37,a6:92:ad:b7:76:65,309255288,284,19089,309255004,309255288
27413,5,12,149,5745,-60,-97,37,56:68:e2:c2:8d:d5,309258771,288,3195,309258483,309258771
27414,5,24,149,5745,-79,-97,18,,309278805,28,20006,309278777,309278805
27415,5,24,149,5745,-81,-97,16,,309278849,28,16,309278821,309278849
27416,5,24,149,5745,-81,-97,16,,309278957,32,76,309278925,309278957
27417,5,12,149,5745,-60,-97,37,3e:d1:9b:c7:a4:de,309285612,272,6383,309285340,309285612
27418,5,12,149,5745,-86,-97,11,9a:24:38:da:96:bb,309298555,272,12671,309298283,309298555
27419,5,12,149,5745,-69,-97,28,5e:29:73:5b:30:00,309301791,272,2964,309301519,309301791
27420,5,6,149,5745,-90,-97,7,54:e4:3a:ec:fb:65,309334549,360,32398,309334189,309334549
27421,5,12,149,5745,-77,-97,20,f2:da:61:dd:98:c5,309335438,268,621,309335170,309335438
27422,5,12,149,5745,-72,-97,25,6a:1e:a4:f8:14:49,309345676,292,9946,309345384,309345676
27423,5,12,149,5745,-58,-97,39,22:ec:75:a8:8a:31,309348822,272,2874,309348550,309348822
27424,5,12,149,5745,-60,-97,37,a6:92:ad:b7:76:65,309358802,284,9696,309358518,309358802
27425,5,12,149,5745,-60,-97,37,56:68:e2:c2:8d:d5,309360477,288,1387,309360189,309360477
27426,5,12,149,5745,-76,-97,21,f2:da:61:dd:98:c5,309379309,268,18564,309379041,309379309
27427,5,12,149,5745,-60,-97,37,56:68:e2:c2:8d:d5,309404811,288,25214,309404523,309404811
27428,5,12,149,5745,-85,-97,12,9a:24:38:da:96:bb,309410288,272,5205,309410016,309410288
27429,5,12,149,5745,-60,-97,37,3e:d1:9b:c7:a4:de,309418050,272,7490,309417778,309418050
27430,5,12,149,5745,-74,-97,23,f2:da:61:dd:98:c5,309419508,268,1190,309419240,309419508
27431,5,12,149,5745,-60,-97,37,3e:d1:9b:c7:a4:de,309419910,544,-142,309419366,309419910
27432,5,12,149,5745,-60,-97,37,56:68:e2:c2:8d:d5,309420902,484,508,309420418,309420902
27433,5,12,149,5745,-57,-97,40,a6:92:ad:b7:76:65,309421465,484,79,309420981,309421465
27434,5,12,149,5745,-61,-97,36,f6:0a:5c:59:72:df,309423953,288,2200,309423665,309423953
27435,5,12,149,5745,-57,-97,40,a6:92:ad:b7:76:65,309434517,284,10280,309434233,309434517
27436,5,12,149,5745,-69,-97,28,5e:29:73:5b:30:00,309435750,272,961,309435478,309435750
27437,5,6,149,5745,-91,-97,6,54:e4:3a:ec:fb:65,309436950,360,840,309436590,309436950
27438,5,12,149,5745,-58,-97,39,22:ec:75:a8:8a:31,309439912,544,2418,309439368,309439912
27439,5,12,149,5745,-70,-97,27,6a:1e:a4:f8:14:49,309451484,292,11280,309451192,309451484
27440,5,12,149,5745,-62,-97,35,f6:0a:5c:59:72:df,309467563,288,15791,309467275,309467563
27441,5,12,149,5745,-58,-97,39,22:ec:75:a8:8a:31,309482060,272,14225,309481788,309482060
27442,5,12,149,5745,-73,-97,24,6a:1e:a4:f8:14:49,309483401,488,853,309482913,309483401
27443,5,12,149,5745,-57,-97,40,a6:92:ad:b7:76:65,309483923,484,38,309483439,309483923
27444,5,12,149,5745,-72,-97,25,f2:da:61:dd:98:c5,309485288,268,1097,309485020,309485288
27445,5,12,149,5745,-72,-97,25,f2:da:61:dd:98:c5,309485815,268,259,309485547,309485815
27446,5,12,149,5745,-64,-97,33,f6:0a:5c:59:72:df,309488753,288,2650,309488465,309488753
27447,5,12,149,5745,-67,-97,30,0a:b9:b7:b1:4d:fa,309495393,268,6372,309495125,309495393
27448,5,12,149,5745,-68,-97,29,5e:29:73:5b:30:00,309495947,540,14,309495407,309495947
27449,5,12,149,5745,-86,-97,11,7e:05:42:11:d2:ec,309499067,360,2760,309498707,309499067
27450,5,12,149,5745,-59,-97,38,22:ec:75:a8:8a:31,309505473,544,5862,309504929,309505473
27451,5,12,149,5745,-85,-97,12,7e:05:42:11:d2:ec,309507188,468,1247,309506720,309507188
27452,5,12,149,5745,-69,-97,28,d2:00:04:7e:2c:ab,309517657,412,10057,309517245,309517657
27453,5,12,149,5745,-86,-97,11,9a:24:38:da:96:bb,309522130,272,4201,309521858,309522130
27454,5,12,149,5745,-68,-97,29,5e:29:73:5b:30:00,309534891,272,12489,309534619,309534891
27455,5,6,149,5745,-91,-97,6,54:e4:3a:ec:fb:65,309539351,360,4100,309538991,309539351
27456,5,12,149,5745,-61,-97,36,a6:92:ad:b7:76:65,309562310,284,22675,309562026,309562310
27457,5,12,149,5745,-72,-97,25,6a:1e:a4:f8:14:49,309569654,292,7052,309569362,309569654
27458,5,12,149,5745,-85,-97,12,7e:05:42:11:d2:ec,309572180,468,2058,309571712,309572180
27459,5,12,149,5745,-59,-97,38,22:ec:75:a8:8a:31,309578507,272,6055,309578235,309578507
27460,5,12,149,5745,-72,-97,25,f2:da:61:dd:98:c5,309604716,268,25941,309604448,309604716
27461,5,24,149,5745,-82,-97,15,,309617821,28,13077,309617793,309617821
27462,5,12,149,5745,-56,-97,41,3e:d1:9b:c7:a4:de,309624403,272,6310,309624131,309624403
27463,5,12,149,5745,-88,-97,9,9a:24:38:da:96:bb,309635181,272,10506,309634909,309635181
27464,5,6,149,5745,-92,-97,5,54:e4:3a:ec:fb:65,309641751,360,6210,309641391,309641751
27465,5,12,149,5745,-72,-97,25,5e:29:73:5b:30:00,309643268,272,1245,309642996,309643268
27466,5,12,149,5745,-59,-97,38,56:68:e2:c2:8d:d5,309668474,288,24918,309668186,309668474
27467,5,6,149,5745,-66,-97,31,,309668805,52,279,309668753,309668805
27468,5,6,149,5745,-81,-97,16,,309668873,44,24,309668829,309668873
27469,5,24,149,5745,-81,-97,16,,309668991,28,90,309668963,309668991
27470,5,12,149,5745,-60,-97,37,a6:92:ad:b7:76:65,309675833,284,6558,309675549,309675833
27471,5,24,149,5745,-81,-97,16,,309694082,28,18221,309694054,309694082
27472,5,24,149,5745,-81,-97,16,,309694126,28,16,309694098,309694126
27473,5,24,149,5745,-81,-97,16,,309694234,32,76,309694202,309694234
27474,5,12,149,5745,-59,-97,38,22:ec:75:a8:8a:31,309694337,272,-169,309694065,309694337
27475,5,12,149,5745,-85,-97,12,7e:05:42:11:d2:ec,309698635,272,4026,309698363,309698635
27476,5,24,149,5745,-80,-97,17,,309712535,28,13872,309712507,309712535
27477,5,24,149,5745,-81,-97,16,,309712579,28,16,309712551,309712579
27478,5,24,149,5745,-81,-97,16,,309712687,32,76,309712655,309712687
27479,5,12,149,5745,-56,-97,41,3e:d1:9b:c7:a4:de,309740472,272,27513,309740200,309740472
27480,5,12,149,5745,-71,-97,26,6a:1e:a4:f8:14:49,309741336,292,572,309741044,309741336
27481,5,6,149,5745,-89,-97,8,54:e4:3a:ec:fb:65,309744152,360,2456,309743792,309744152
27482,5,12,149,5745,-72,-97,25,f2:da:61:dd:98:c5,309744989,268,569,309744721,309744989
27483,5,12,149,5745,-85,-97,12,9a:24:38:da:96:bb,309750609,272,5348,309750337,309750609
27484,5,12,149,5745,-58,-97,39,56:68:e2:c2:8d:d5,309770816,288,19919,309770528,309770816
27485,5,24,149,5745,-81,-97,16,,309781579,28,10735,309781551,309781579
27486,5,24,149,5745,-81,-97,16,,309781623,28,16,309781595,309781623
27487,5,24,149,5745,-81,-97,16,,309781731,32,76,309781699,309781731
27488,5,24,149,5745,-81,-97,16,,309781846,32,83,309781814,309781846
27489,5,12,149,5745,-59,-97,38,a6:92:ad:b7:76:65,309782691,284,561,309782407,309782691
27490,5,24,149,5745,-81,-97,16,,309789712,28,6993,309789684,309789712
27491,5,24,149,5745,-81,-97,16,,309789756,28,16,309789728,309789756
27492,5,24,149,5745,-81,-97,16,,309789864,32,76,309789832,309789864
27493,5,24,149,5745,-80,-97,17,,309792680,28,2788,309792652,309792680
27494,5,24,149,5745,-81,-97,16,,309792725,28,17,309792697,309792725
27495,5,24,149,5745,-80,-97,17,,309792833,32,76,309792801,309792833
27496,5,24,149,5745,-81,-97,16,,309797772,28,4911,309797744,309797772
27497,5,24,149,5745,-81,-97,16,,309797816,28,16,309797788,309797816
27498,5,24,149,5745,-81,-97,16,,309797924,32,76,309797892,309797924
27499,5,24,149,5745,-81,-97,16,,309800556,28,2604,309800528,309800556
27500,5,24,149,5745,-81,-97,16,,309800600,28,16,309800572,309800600
27501,5,24,149,5745,-80,-97,17,,309800709,32,77,309800677,309800709
27502,5,24,149,5745,-80,-97,17,,309802788,32,2047,309802756,309802788
27503,5,24,149,5745,-81,-97,16,,309807442,28,4626,309807414,309807442
27504,5,24,149,5745,-81,-97,16,,309807486,28,16,309807458,309807486
27505,5,24,149,5745,-81,-97,16,,309807594,32,76,309807562,309807594
27506,5,12,149,5745,-61,-97,36,22:ec:75:a8:8a:31,309808180,272,314,309807908,309808180
27507,5,12,149,5745,-86,-97,11,7e:05:42:11:d2:ec,309817421,272,8969,309817149,309817421
27508,5,24,149,5745,-81,-97,16,,309822205,28,4756,309822177,309822205
27509,5,6,149,5745,-91,-97,6,,309822365,68,92,309822297,309822365
27510,5,12,149,5745,-61,-97,36,f6:0a:5c:59:72:df,309822984,288,331,309822696,309822984
27511,5,24,149,5745,-81,-97,16,,309825222,28,2210,309825194,309825222
27512,5,24,149,5745,-81,-97,16,,309825266,28,16,309825238,309825266
27513,5,24,149,5745,-81,-97,16,,309825374,32,76,309825342,309825374
27514,5,12,149,5745,-71,-97,26,6a:1e:a4:f8:14:49,309843709,292,18043,309843417,309843709
27515,5,6,149,5745,-89,-97,8,54:e4:3a:ec:fb:65,309846552,360,2483,309846192,309846552
27516,5,12,149,5745,-71,-97,26,f2:da:61:dd:98:c5,309847618,268,798,309847350,309847618
27517,5,12,149,5745,-57,-97,40,56:68:e2:c2:8d:d5,309856339,288,8433,309856051,309856339
27518,5,12,149,5745,-89,-97,8,9a:24:38:da:96:bb,309860693,272,4082,309860421,309860693
27519,5,24,149,5745,-80,-97,17,,309864548,32,3823,309864516,309864548
27520,5,12,149,5745,-57,-97,40,3e:d1:9b:c7:a4:de,309876805,272,11985,309876533,309876805
27521,5,12,149,5745,-57,-97,40,56:68:e2:c2:8d:d5,309877129,484,-160,309876645,309877129
27522,5,12,149,5745,-61,-97,36,a6:92:ad:b7:76:65,309877692,484,79,309877208,309877692
27523,5,12,149,5745,-71,-97,26,f2:da:61:dd:98:c5,309878310,268,350,309878042,309878310
27524,5,12,149,5745,-70,-97,27,6a:1e:a4:f8:14:49,309878667,488,-131,309878179,309878667
27525,5,12,149,5745,-57,-97,40,3e:d1:9b:c7:a4:de,309880242,544,1031,309879698,309880242
27526,5,12,149,5745,-61,-97,36,f6:0a:5c:59:72:df,309882998,288,2468,309882710,309882998
27527,5,12,149,5745,-69,-97,28,5e:29:73:5b:30:00,309889099,540,5561,309888559,309889099
27528,5,12,149,5745,-61,-97,36,a6:92:ad:b7:76:65,309893291,284,3908,309893007,309893291
27529,5,12,149,5745,-71,-97,26,6a:1e:a4:f8:14:49,309893840,292,257,309893548,309893840
27530,5,12,149,5745,-90,-97,7,9a:24:38:da:96:bb,309898999,824,4335,309898175,309898999
27531,5,12,149,5745,-60,-97,37,22:ec:75:a8:8a:31,309901537,544,1994,309900993,309901537
27532,5,6,149,5745,-64,-97,33,,309914640,52,13051,309914588,309914640
27533,5,6,149,5745,-79,-97,18,,309914708,44,24,309914664,309914708
27534,5,24,149,5745,-79,-97,18,,309914826,28,90,309914798,309914826
27535,5,12,149,5745,-61,-97,36,f6:0a:5c:59:72:df,309924241,288,9127,309923953,309924241
27536,5,12,149,5745,-59,-97,38,22:ec:75:a8:8a:31,309925108,272,595,309924836,309925108
27537,5,12,149,5745,-72,-97,25,f2:da:61:dd:98:c5,309928475,268,3099,309928207,309928475
27538,5,24,149,5745,-80,-97,17,,309932265,32,3758,309932233,309932265
27539,5,24,149,5745,-80,-97,17,,309932765,32,468,309932733,309932765
27540,5,24,149,5745,-79,-97,18,,309933265,28,472,309933237,309933265
27541,5,12,149,5745,-60,-97,37,a6:92:ad:b7:76:65,309943100,484,9351,309942616,309943100
27542,5,6,149,5745,-91,-97,6,54:e4:3a:ec:fb:65,309948952,360,5492,309948592,309948952
27543,5,12,149,5745,-57,-97,40,56:68:e2:c2:8d:d5,309966848,288,17608,309966560,309966848
27544,5,12,149,5745,-57,-97,40,3e:d1:9b:c7:a4:de,309973368,272,6248,309973096,309973368
27545,5,6,149,5745,-65,-97,32,,309975473,52,2053,309975421,309975473
27546,5,6,149,5745,-79,-97,18,,309975540,44,23,309975496,309975540
27547,5,24,149,5745,-79,-97,18,,309975666,32,94,309975634,309975666
27548,5,12,149,5745,-69,-97,28,d2:00:04:7e:2c:ab,309995339,380,19293,309994959,309995339
27549,5,12,149,5745,-60,-97,37,a6:92:ad:b7:76:65,310008492,484,12669,310008008,310008492
27550,5,12,149,5745,-60,-97,37,a6:92:ad:b7:76:65,310008996,284,220,310008712,310008996
27551,5,12,149,5745,-73,-97,24,f2:da:61:dd:98:c5,310011331,268,2067,310011063,310011331
27552,5,12,149,5745,-58,-97,39,3e:d1:9b:c7:a4:de,310011688,544,-187,310011144,310011688
27553,5,12,149,5745,-58,-97,39,22:ec:75:a8:8a:31,310016622,516,4418,310016106,310016622
27554,5,12,149,5745,-86,-97,11,7e:05:42:11:d2:ec,310017181,468,91,310016713,310017181
27555,5,12,149,5745,-72,-97,25,6a:1e:a4:f8:14:49,310018630,292,1157,310018338,310018630
27556,5,12,149,5745,-65,-97,32,0a:b9:b7:b1:4d:fa,310019513,268,615,310019245,310019513
27557,5,12,149,5745,-69,-97,28,5e:29:73:5b:30:00,310021130,540,1077,310020590,310021130
27558,5,12,149,5745,-69,-97,28,d2:00:04:7e:2c:ab,310030515,468,8917,310030047,310030515
27559,5,12,149,5745,-58,-97,39,22:ec:75:a8:8a:31,310039121,244,8362,310038877,310039121
27560,5,12,149,5745,-74,-97,23,f2:da:61:dd:98:c5,310042594,268,3205,310042326,310042594
27561,5,6,149,5745,-90,-97,7,54:e4:3a:ec:fb:65,310051353,360,8399,310050993,310051353
27562,5,6,149,5745,-66,-97,31,,310067732,52,16327,310067680,310067732
27563,5,6,149,5745,-80,-97,17,,310067800,44,24,310067756,310067800
27564,5,24,149,5745,-82,-97,15,,310067918,28,90,310067890,310067918
27565,5,12,149,5745,-57,-97,40,56:68:e2:c2:8d:d5,310081391,288,13185,310081103,310081391
27566,5,12,149,5745,-87,-97,10,9a:24:38:da:96:bb,310085571,272,3908,310085299,310085571
27567,5,12,149,5745,-59,-97,38,3e:d1:9b:c7:a4:de,310090531,272,4688,310090259,310090531
27568,5,12,149,5745,-72,-97,25,6a:1e:a4:f8:14:49,310148831,292,58008,310148539,310148831
27569,5,12,149,5745,-60,-97,37,22:ec:75:a8:8a:31,310150051,244,976,310149807,310150051
27570,5,6,149,5745,-90,-97,7,54:e4:3a:ec:fb:65,310153753,360,3342,310153393,310153753
27571,5,12,149,5745,-57,-97,40,f6:0a:5c:59:72:df,310161507,288,7466,310161219,310161507
27572,5,12,149,5745,-68,-97,29,f2:da:61:dd:98:c5,310167388,268,5613,310167120,310167388
27573,5,24,149,5745,-80,-97,17,,310170485,32,3065,310170453,310170485
27574,5,24,149,5745,-81,-97,16,,310170781,28,268,310170753,310170781
27575,5,24,149,5745,-81,-97,16,,310171021,28,212,310170993,310171021
27576,5,24,149,5745,-80,-97,17,,310171242,28,193,310171214,310171242
27577,5,6,149,5745,-91,-97,6,,310171420,68,110,310171352,310171420
27578,5,12,149,5745,-59,-97,38,a6:92:ad:b7:76:65,310176868,284,5164,310176584,310176868
27579,5,12,149,5745,-58,-97,39,56:68:e2:c2:8d:d5,310192736,288,15580,310192448,310192736
27580,5,12,149,5745,-82,-97,15,9a:24:38:da:96:bb,310201201,272,8193,310200929,310201201
27581,5,12,149,5745,-61,-97,36,3e:d1:9b:c7:a4:de,310207420,272,5947,310207148,310207420
27582,5,12,149,5745,-86,-97,11,7e:05:42:11:d2:ec,310213372,468,5484,310212904,310213372
27583,5,12,149,5745,-70,-97,27,5e:29:73:5b:30:00,310214494,272,850,310214222,310214494
27584,5,24,149,5745,-80,-97,17,,310225356,32,10830,310225324,310225356
27585,5,12,149,5745,-69,-97,28,6a:1e:a4:f8:14:49,310251544,292,25896,310251252,310251544
27586,5,6,149,5745,-89,-97,8,54:e4:3a:ec:fb:65,310256154,360,4250,310255794,310256154
27587,5,12,149,5745,-60,-97,37,22:ec:75:a8:8a:31,310266994,244,10596,310266750,310266994
27588,5,12,149,5745,-57,-97,40,f6:0a:5c:59:72:df,310276666,288,9384,310276378,310276666
27589,5,12,149,5745,-58,-97,39,a6:92:ad:b7:76:65,310279239,284,2289,310278955,310279239
27590,5,12,149,5745,-86,-97,11,9a:24:38:da:96:bb,310309915,272,30404,310309643,310309915
27591,5,12,149,5745,-59,-97,38,3e:d1:9b:c7:a4:de,310324570,272,14383,310324298,310324570
27592,5,12,149,5745,-74,-97,23,5e:29:73:5b:30:00,310330437,272,5595,310330165,310330437
27593,5,12,149,5745,-70,-97,27,6a:1e:a4:f8:14:49,310356863,292,26134,310356571,310356863
27594,5,6,149,5745,-90,-97,7,54:e4:3a:ec:fb:65,310358555,360,1332,310358195,310358555
27595,5,12,149,5745,-71,-97,26,f2:da:61:dd:98:c5,310359440,268,617,310359172,310359440
27596,5,24,149,5745,-78,-97,19,,310373607,28,14139,310373579,310373607
27597,5,24,149,5745,-90,-97,7,,310373650,28,15,310373622,310373650
27598,5,24,149,5745,-78,-97,19,,310373828,28,150,310373800,310373828
27599,5,24,149,5745,-88,-97,9,,310373871,28,15,310373843,310373871
27600,5,24,149,5745,-79,-97,18,,310374042,28,143,310374014,310374042
27601,5,6,149,5745,-89,-97,8,,310374220,68,110,310374152,310374220
27602,5,12,149,5745,-56,-97,41,a6:92:ad:b7:76:65,310381616,284,7112,310381332,310381616
27603,5,12,149,5745,-62,-97,35,22:ec:75:a8:8a:31,310384658,244,2798,310384414,310384658
27604,5,12,149,5745,-62,-97,35,56:68:e2:c2:8d:d5,310385294,288,348,310385006,310385294
27605,5,12,149,5745,-69,-97,28,f2:da:61:dd:98:c5,310392818,268,7256,310392550,310392818
27606,5,12,149,5745,-63,-97,34,56:68:e2:c2:8d:d5,310420925,288,27819,310420637,310420925
27607,5,24,149,5745,-77,-97,20,,310429725,32,8768,310429693,310429725
27608,5,12,149,5745,-59,-97,38,3e:d1:9b:c7:a4:de,310436358,272,6361,310436086,310436358
27609,5,12,149,5745,-70,-97,27,5e:29:73:5b:30:00,310442183,272,5553,310441911,310442183
27610,5,6,149,5745,-92,-97,5,54:e4:3a:ec:fb:65,310460955,360,18412,310460595,310460955
27611,5,12,149,5745,-54,-97,43,a6:92:ad:b7:76:65,310467050,284,5811,310466766,310467050
27612,5,12,149,5745,-70,-97,27,6a:1e:a4:f8:14:49,310467395,292,53,310467103,310467395
27613,5,12,149,5745,-56,-97,41,3e:d1:9b:c7:a4:de,310468612,544,673,310468068,310468612
27614,5,12,149,5745,-63,-97,34,56:68:e2:c2:8d:d5,310469610,476,522,310469134,310469610
27615,5,12,149,5745,-70,-97,27,f2:da:61:dd:98:c5,310470165,268,287,310469897,310470165
27616,5,12,149,5745,-69,-97,28,6a:1e:a4:f8:14:49,310470494,488,-159,310470006,310470494
27617,5,12,149,5745,-64,-97,33,22:ec:75:a8:8a:31,310473807,516,2797,310473291,310473807
27618,5,12,149,5745,-59,-97,38,f6:0a:5c:59:72:df,310474375,280,288,310474095,310474375
27619,5,12,149,5745,-69,-97,28,96:a3:af:37:f7:5e,310474842,468,-1,310474374,310474842
27620,5,12,149,5745,-90,-97,7,46:28:71:6e:d2:2e,310479924,280,4802,310479644,310479924
27621,5,12,149,5745,-69,-97,28,5e:29:73:5b:30:00,310480286,540,-178,310479746,310480286
27622,5,12,149,5745,-59,-97,38,f6:0a:5c:59:72:df,310484721,280,4155,310484441,310484721
27623,5,12,149,5745,-54,-97,43,a6:92:ad:b7:76:65,310489508,484,4303,310489024,310489508
27624,5,12,149,5745,-71,-97,26,f2:da:61:dd:98:c5,310501274,268,11498,310501006,310501274
27625,5,12,149,5745,-61,-97,36,22:ec:75:a8:8a:31,310514581,244,13063,310514337,310514581
27626,5,12,149,5745,-61,-97,36,56:68:e2:c2:8d:d5,310532022,280,17161,310531742,310532022
27627,5,12,149,5745,-90,-97,7,9a:24:38:da:96:bb,310532964,272,670,310532692,310532964
27628,5,12,149,5745,-60,-97,37,3e:d1:9b:c7:a4:de,310533445,544,-63,310532901,310533445
27629,5,12,149,5745,-75,-97,22,f2:da:61:dd:98:c5,310534033,268,320,310533765,310534033
27630,5,12,149,5745,-63,-97,34,f6:0a:5c:59:72:df,310534335,280,22,310534055,310534335
27631,5,12,149,5745,-59,-97,38,22:ec:75:a8:8a:31,310538997,516,4146,310538481,310538997
27632,5,12,149,5745,-87,-97,10,7e:05:42:11:d2:ec,310539907,468,442,310539439,310539907
27633,5,12,149,5745,-87,-97,10,7e:05:42:11:d2:ec,310542306,360,2039,310541946,310542306
27634,5,12,149,5745,-66,-97,31,96:a3:af:37:f7:5e,310544083,468,1309,310543615,310544083
27635,5,12,149,5745,-68,-97,29,5e:29:73:5b:30:00,310544958,540,335,310544418,310544958
27636,5,12,149,5745,-61,-97,36,0a:b9:b7:b1:4d:fa,310545541,268,315,310545273,310545541
27637,5,12,149,5745,-66,-97,31,96:a3:af:37:f7:5e,310548994,356,3097,310548638,310548994
27638,5,12,149,5745,-66,-97,31,96:a3:af:37:f7:5e,310549493,132,367,310549361,310549493
27639,5,12,149,5745,-64,-97,33,56:68:e2:c2:8d:d5,310550223,476,254,310549747,310550223
27640,5,12,149,5745,-68,-97,29,d2:00:04:7e:2c:ab,310552320,104,1993,310552216,310552320
27641,5,12,149,5745,-68,-97,29,d2:00:04:7e:2c:ab,310552487,380,-213,310552107,310552487
27642,5,12,149,5745,-53,-97,44,a6:92:ad:b7:76:65,310553117,484,146,310552633,310553117
27643,5,12,149,5745,-67,-97,30,d2:00:04:7e:2c:ab,310554906,468,1321,310554438,310554906
27644,5,6,149,5745,-91,-97,6,54:e4:3a:ec:fb:65,310563356,360,8090,310562996,310563356
27645,5,12,149,5745,-61,-97,36,3e:d1:9b:c7:a4:de,310564914,272,1286,310564642,310564914
27646,5,12,149,5745,-53,-97,44,a6:92:ad:b7:76:65,310565274,284,76,310564990,310565274
27647,5,12,149,5745,-73,-97,24,6a:1e:a4:f8:14:49,310565862,292,296,310565570,310565862
27648,5,12,149,5745,-66,-97,31,5e:29:73:5b:30:00,310566849,272,715,310566577,310566849
27649,5,12,149,5745,-63,-97,34,f6:0a:5c:59:72:df,310607617,280,40488,310607337,310607617
27650,5,12,149,5745,-59,-97,38,22:ec:75:a8:8a:31,310613526,244,5665,310613282,310613526
27651,5,12,149,5745,-69,-97,28,f2:da:61:dd:98:c5,310621150,268,7356,310620882,310621150
27652,5,12,149,5745,-86,-97,11,9a:24:38:da:96:bb,310645700,272,24278,310645428,310645700
27653,5,12,149,5745,-63,-97,34,56:68:e2:c2:8d:d5,310646546,280,566,310646266,310646546
27654,5,6,149,5745,-88,-97,9,54:e4:3a:ec:fb:65,310665756,360,18850,310665396,310665756
27655,5,12,149,5745,-57,-97,40,3e:d1:9b:c7:a4:de,310669609,272,3581,310669337,310669609
27656,5,12,149,5745,-69,-97,28,5e:29:73:5b:30:00,310671850,272,1969,310671578,310671850
27657,5,12,149,5745,-63,-97,34,a6:92:ad:b7:76:65,310691470,284,19336,310691186,310691470
27658,5,12,149,5745,-57,-97,40,22:ec:75:a8:8a:31,310727749,244,36035,310727505,310727749
27659,5,12,149,5745,-63,-97,34,f6:0a:5c:59:72:df,310728362,280,333,310728082,310728362
27660,5,12,149,5745,-86,-97,11,7e:05:42:11:d2:ec,310741705,468,12875,310741237,310741705
27661,5,12,149,5745,-71,-97,26,6a:1e:a4:f8:14:49,310765354,292,23357,310765062,310765354
27662,5,6,149,5745,-90,-97,7,54:e4:3a:ec:fb:65,310768157,360,2443,310767797,310768157
27663,5,12,149,5745,-76,-97,21,f2:da:61:dd:98:c5,310768936,268,511,310768668,310768936
27664,5,24,149,5745,-73,-97,24,,310784798,28,15834,310784770,310784798
27665,5,24,149,5745,-82,-97,15,,310784842,28,16,310784814,310784842
27666,5,24,149,5745,-82,-97,15,,310784971,32,97,310784939,310784971
27667,5,12,149,5745,-57,-97,40,3e:d1:9b:c7:a4:de,310786899,272,1656,310786627,310786899
27668,5,12,149,5745,-67,-97,30,5e:29:73:5b:30:00,310788845,272,1674,310788573,310788845
27669,5,12,149,5745,-62,-97,35,56:68:e2:c2:8d:d5,310793725,280,4600,310793445,310793725
27670,5,24,149,5745,-82,-97,15,,310799257,28,5504,310799229,310799257
27671,5,24,149,5745,-73,-97,24,,310799301,28,16,310799273,310799301
27672,5,24,149,5745,-74,-97,23,,310799409,32,76,310799377,310799409
27673,5,12,149,5745,-60,-97,37,a6:92:ad:b7:76:65,310803721,284,4028,310803437,310803721
27674,5,24,149,5745,-83,-97,14,,310806286,32,2533,310806254,310806286
27675,5,24,149,5745,-73,-97,24,,310807252,28,938,310807224,310807252
27676,5,24,149,5745,-81,-97,16,,310807296,28,16,310807268,310807296
27677,5,24,149,5745,-82,-97,15,,310807405,32,77,310807373,310807405
27678,5,24,149,5745,-83,-97,14,,310819437,28,12004,310819409,310819437
27679,5,24,149,5745,-74,-97,23,,310819482,28,17,310819454,310819482
27680,5,24,149,5745,-74,-97,23,,310819590,32,76,310819558,310819590
27681,5,24,149,5745,-73,-97,24,,310819702,32,80,310819670,310819702
27682,5,6,149,5745,-64,-97,33,,310821542,52,1788,310821490,310821542
27683,5,6,149,5745,-83,-97,14,,310821610,44,24,310821566,310821610
27684,5,24,149,5745,-82,-97,15,,310821727,28,89,310821699,310821727
27685,5,24,149,5745,-74,-97,23,,310822697,28,942,310822669,310822697
27686,5,24,149,5745,-83,-97,14,,310822741,28,16,310822713,310822741
27687,5,24,149,5745,-82,-97,15,,310822850,32,77,310822818,310822850
27688,5,24,149,5745,-83,-97,14,,310822988,32,106,310822956,310822988
27689,5,24,149,5745,-82,-97,15,,310823248,28,232,310823220,310823248
27690,5,24,149,5745,-83,-97,14,,310823472,28,196,310823444,310823472
27691,5,24,149,5745,-82,-97,15,,310823722,28,222,310823694,310823722
27692,5,6,149,5745,-90,-97,7,,310823882,68,92,310823814,310823882
27693,5,24,149,5745,-83,-97,14,,310824692,28,782,310824664,310824692
27694,5,24,149,5745,-82,-97,15,,310824960,28,240,310824932,310824960
27695,5,24,149,5745,-82,-97,15,,310825158,28,170,310825130,310825158
27696,5,6,149,5745,-90,-97,7,,310825318,68,92,310825250,310825318
27697,5,24,149,5745,-74,-97,23,,310827697,28,2351,310827669,310827697
27698,5,24,149,5745,-82,-97,15,,310827741,28,16,310827713,310827741
27699,5,24,149,5745,-82,-97,15,,310827850,32,77,310827818,310827850
27700,5,24,149,5745,-82,-97,15,,310838514,32,10632,310838482,310838514
27701,5,24,149,5745,-82,-97,15,,310838986,32,440,310838954,310838986
27702,5,24,149,5745,-83,-97,14,,310839459,28,445,310839431,310839459
27703,5,24,149,5745,-82,-97,15,,310840569,28,1082,310840541,310840569
27704,5,24,149,5745,-74,-97,23,,310840613,28,16,310840585,310840613
27705,5,24,149,5745,-74,-97,23,,310840721,32,76,310840689,310840721
27706,5,12,149,5745,-57,-97,40,22:ec:75:a8:8a:31,310845421,244,4456,310845177,310845421
27707,5,24,149,5745,-82,-97,15,,310868374,32,22921,310868342,310868374
27708,5,6,149,5745,-90,-97,7,54:e4:3a:ec:fb:65,310870558,360,1824,310870198,310870558
27709,5,12,149,5745,-75,-97,22,f2:da:61:dd:98:c5,310871648,268,822,310871380,310871648
27710,5,12,149,5745,-86,-97,11,9a:24:38:da:96:bb,310873444,272,1524,310873172,310873444
27711,5,12,149,5745,-68,-97,29,56:68:e2:c2:8d:d5,310897317,280,23593,310897037,310897317
27712,5,12,149,5745,-71,-97,26,6a:1e:a4:f8:14:49,310902270,292,4661,310901978,310902270
27713,5,12,149,5745,-54,-97,43,a6:92:ad:b7:76:65,310909750,284,7196,310909466,310909750
27714,5,6,149,5745,-63,-97,34,,310914970,52,5168,310914918,310914970
27715,5,6,149,5745,-80,-97,17,,310915038,44,24,310914994,310915038
27716,5,24,149,5745,-80,-97,17,,310915155,28,89,310915127,310915155
27717,5,12,149,5745,-58,-97,39,3e:d1:9b:c7:a4:de,310925405,272,9978,310925133,310925405
27718,5,12,149,5745,-66,-97,31,5e:29:73:5b:30:00,310926701,272,1024,310926429,310926701
27719,5,12,149,5745,-70,-97,27,6a:1e:a4:f8:14:49,310927017,488,-172,310926529,310927017
27720,5,12,149,5745,-58,-97,39,f6:0a:5c:59:72:df,310928306,280,1009,310928026,310928306
27721,5,12,149,5745,-58,-97,39,3e:d1:9b:c7:a4:de,310928665,544,-185,310928121,310928665
27722,5,24,149,5745,-79,-97,18,,310932256,32,3559,310932224,310932256
27723,5,24,149,5745,-80,-97,17,,310932756,32,468,310932724,310932756
27724,5,24,149,5745,-80,-97,17,,310933255,28,471,310933227,310933255
27725,5,12,149,5745,-59,-97,38,22:ec:75:a8:8a:31,310934134,516,363,310933618,310934134
27726,5,12,149,5745,-58,-97,39,f6:0a:5c:59:72:df,310938687,280,4273,310938407,310938687
27727,5,12,149,5745,-66,-97,31,5e:29:73:5b:30:00,310939300,540,73,310938760,310939300
27728,5,12,149,5745,-70,-97,27,56:68:e2:c2:8d:d5,310944183,476,4407,310943707,310944183
27729,5,12,149,5745,-54,-97,43,a6:92:ad:b7:76:65,310945913,484,1246,310945429,310945913
27730,5,12,149,5745,-85,-97,12,9a:24:38:da:96:bb,310947448,824,711,310946624,310947448
27731,5,6,149,5745,-89,-97,8,54:e4:3a:ec:fb:65,310972958,360,25150,310972598,310972958
27732,5,12,149,5745,-59,-97,38,22:ec:75:a8:8a:31,310973893,244,691,310973649,310973893
27733,5,24,149,5745,-63,-97,34,,310975094,28,1173,310975066,310975094
27734,5,24,149,5745,-80,-97,17,,310975139,28,17,310975111,310975139
27735,5,24,149,5745,-80,-97,17,,310975246,28,79,310975218,310975246
27736,5,12,149,5745,-70,-97,27,56:68:e2:c2:8d:d5,310978531,280,3005,310978251,310978531
27737,5,12,149,5745,-84,-97,13,9a:24:38:da:96:bb,310981712,272,2909,310981440,310981712
27738,5,12,149,5745,-52,-97,45,a6:92:ad:b7:76:65,311011726,484,29530,311011242,311011726
27739,5,12,149,5745,-69,-97,28,5e:29:73:5b:30:00,311019713,272,7715,311019441,311019713
27740,5,12,149,5745,-57,-97,40,3e:d1:9b:c7:a4:de,311021199,272,1214,311020927,311021199
27741,5,12,149,5745,-52,-97,45,a6:92:ad:b7:76:65,311023827,284,2344,311023543,311023827
27742,5,12,149,5745,-73,-97,24,6a:1e:a4:f8:14:49,311029435,292,5316,311029143,311029435
27743,5,12,149,5745,-88,-97,9,7e:05:42:11:d2:ec,311040154,272,10447,311039882,311040154
27744,5,12,149,5745,-59,-97,38,f6:0a:5c:59:72:df,311064770,280,24336,311064490,311064770
27745,5,12,149,5745,-60,-97,37,22:ec:75:a8:8a:31,311065085,516,-201,311064569,311065085
27746,5,12,149,5745,-57,-97,40,3e:d1:9b:c7:a4:de,311065662,544,33,311065118,311065662
27747,5,24,149,5745,-64,-97,33,,311066278,28,588,311066250,311066278
27748,5,24,149,5745,-80,-97,17,,311066322,28,16,311066294,311066322
27749,5,24,149,5745,-80,-97,17,,311066430,28,80,311066402,311066430
27750,5,12,149,5745,-67,-97,30,0a:b9:b7:b1:4d:fa,311069657,268,2959,311069389,311069657
27751,5,12,149,5745,-69,-97,28,5e:29:73:5b:30:00,311071993,540,1796,311071453,311071993
27752,5,6,149,5745,-89,-97,8,54:e4:3a:ec:fb:65,311075359,360,3006,311074999,311075359
27753,5,12,149,5745,-77,-97,20,f2:da:61:dd:98:c5,311076583,268,956,311076315,311076583
27754,5,12,149,5745,-54,-97,43,a6:92:ad:b7:76:65,311077155,484,88,311076671,311077155
27755,5,12,149,5745,-68,-97,29,d2:00:04:7e:2c:ab,311077720,468,97,311077252,311077720
27756,5,12,149,5745,-85,-97,12,9a:24:38:da:96:bb,311078332,824,-212,311077508,311078332
27757,5,12,149,5745,-88,-97,9,7e:05:42:11:d2:ec,311080257,468,1457,311079789,311080257
27758,5,12,149,5745,-60,-97,37,22:ec:75:a8:8a:31,311087696,244,7195,311087452,311087696
27759,5,12,149,5745,-84,-97,13,9a:24:38:da:96:bb,311092834,272,4866,311092562,311092834
27760,5,12,149,5745,-66,-97,31,56:68:e2:c2:8d:d5,311096073,280,2959,311095793,311096073
27761,5,24,149,5745,-65,-97,32,,311097562,28,1461,311097534,311097562
27762,5,24,149,5745,-80,-97,17,,311097606,28,16,311097578,311097606
27763,5,24,149,5745,-80,-97,17,,311097714,28,80,311097686,311097714
27764,5,12,149,5745,-65,-97,32,5e:29:73:5b:30:00,311133906,272,35920,311133634,311133906
27765,5,12,149,5745,-56,-97,41,3e:d1:9b:c7:a4:de,311138164,272,3986,311137892,311138164
27766,5,12,149,5745,-70,-97,27,96:a3:af:37:f7:5e,311138481,272,45,311138209,311138481
27767,5,12,149,5745,-70,-97,27,96:a3:af:37:f7:5e,311140830,468,1881,311140362,311140830
27768,5,12,149,5745,-59,-97,38,a6:92:ad:b7:76:65,311143477,284,2363,311143193,311143477
27769,5,12,149,5745,-86,-97,11,7e:05:42:11:d2:ec,311159546,272,15797,311159274,311159546
27770,5,12,149,5745,-69,-97,28,6a:1e:a4:f8:14:49,311174899,292,15061,311174607,311174899
27771,5,6,149,5745,-90,-97,7,54:e4:3a:ec:fb:65,311177759,360,2500,311177399,311177759
27772,5,12,149,5745,-63,-97,34,22:ec:75:a8:8a:31,311185440,244,7437,311185196,311185440
27773,5,12,149,5745,-65,-97,32,56:68:e2:c2:8d:d5,311207460,280,21740,311207180,311207460
27774,5,12,149,5745,-85,-97,12,9a:24:38:da:96:bb,311228397,272,20665,311228125,311228397
27775,5,12,149,5745,-68,-97,29,5e:29:73:5b:30:00,311249743,272,21074,311249471,311249743
27776,5,12,149,5745,-59,-97,38,3e:d1:9b:c7:a4:de,311253896,272,3881,311253624,311253896
27777,5,12,149,5745,-67,-97,30,96:a3:af:37:f7:5e,311259201,272,5033,311258929,311259201
27778,5,12,149,5745,-67,-97,30,6a:1e:a4:f8:14:49,311277677,292,18184,311277385,311277677
27779,5,6,149,5745,-87,-97,10,54:e4:3a:ec:fb:65,311280159,360,2122,311279799,311280159
27780,5,12,149,5745,-90,-97,7,46:28:71:6e:d2:2e,311282412,280,1973,311282132,311282412
27781,5,12,149,5745,-63,-97,34,22:ec:75:a8:8a:31,311302451,244,19795,311302207,311302451
27782,5,12,149,5745,-63,-97,34,a6:92:ad:b7:76:65,311303695,284,960,311303411,311303695
27783,5,12,149,5745,-65,-97,32,56:68:e2:c2:8d:d5,311319139,280,15164,311318859,311319139
27784,5,12,149,5745,-86,-97,11,7e:05:42:11:d2:ec,311322557,272,3146,311322285,311322557
27785,5,24,149,5745,-78,-97,19,,311328278,28,5693,311328250,311328278
27786,5,24,149,5745,-79,-97,18,,311328322,28,16,311328294,311328322
27787,5,24,149,5745,-80,-97,17,,311328431,32,77,311328399,311328431
27788,5,12,149,5745,-82,-97,15,9a:24:38:da:96:bb,311344709,272,16006,311344437,311344709
27789,5,24,149,5745,-81,-97,16,,311346382,28,1645,311346354,311346382
27790,5,24,149,5745,-79,-97,18,,311346426,28,16,311346398,311346426
27791,5,24,149,5745,-79,-97,18,,311346534,32,76,311346502,311346534
27792,5,12,149,5745,-65,-97,32,5e:29:73:5b:30:00,311366610,272,19804,311366338,311366610
27793,5,12,149,5745,-59,-97,38,3e:d1:9b:c7:a4:de,311367418,272,536,311367146,311367418
27794,5,6,149,5745,-58,-97,39,f8:89:d2:65:d2:3b,311378669,160,11091,311378509,311378669
27795,5,12,149,5745,-67,-97,30,6a:1e:a4:f8:14:49,311379719,292,758,311379427,311379719
27796,5,12,149,5745,-68,-97,29,96:a3:af:37:f7:5e,311382359,272,2368,311382087,311382359
27797,5,6,149,5745,-88,-97,9,54:e4:3a:ec:fb:65,311382741,360,22,311382381,311382741
27798,5,12,149,5745,-90,-97,7,46:28:71:6e:d2:2e,311395567,280,12546,311395287,311395567
27799,5,12,149,5745,-62,-97,35,a6:92:ad:b7:76:65,311402125,284,6274,311401841,311402125
27800,5,12,149,5745,-61,-97,36,22:ec:75:a8:8a:31,311417856,244,15487,311417612,311417856
27801,5,12,149,5745,-85,-97,12,7e:05:42:11:d2:ec,311424938,272,6810,311424666,311424938
27802,5,6,149,5745,-59,-97,38,f8:89:d2:65:d2:3b,311428846,160,3748,311428686,311428846
27803,5,24,149,5745,-78,-97,19,,311433480,28,4606,311433452,311433480
27804,5,24,149,5745,-81,-97,16,,311433525,28,17,311433497,311433525
27805,5,24,149,5745,-81,-97,16,,311433633,32,76,311433601,311433633
27806,5,12,149,5745,-63,-97,34,56:68:e2:c2:8d:d5,311439479,280,5566,311439199,311439479
27807,5,24,149,5745,-81,-97,16,,311451169,28,11662,311451141,311451169
27808,5,24,149,5745,-77,-97,20,,311451213,28,16,311451185,311451213
27809,5,24,149,5745,-78,-97,19,,311451321,32,76,311451289,311451321
27810,5,12,149,5745,-65,-97,32,5e:29:73:5b:30:00,311478563,272,26970,311478291,311478563
27811,5,12,149,5745,-60,-97,37,3e:d1:9b:c7:a4:de,311479172,272,337,311478900,311479172
27812,5,6,149,5745,-88,-97,9,54:e4:3a:ec:fb:65,311484960,360,5428,311484600,311484960
27813,5,12,149,5745,-67,-97,30,96:a3:af:37:f7:5e,311485367,272,135,311485095,311485367
27814,5,12,149,5745,-86,-97,11,7e:05:42:11:d2:ec,311499282,272,13643,311499010,311499282
27815,5,12,149,5745,-90,-97,7,46:28:71:6e:d2:2e,311502062,280,2500,311501782,311502062
27816,5,12,149,5745,-60,-97,37,f6:0a:5c:59:72:df,311511011,280,8669,311510731,311511011
27817,5,12,149,5745,-66,-97,31,6a:1e:a4:f8:14:49,311515358,444,3903,311514914,311515358
27818,5,12,149,5745,-60,-97,37,f6:0a:5c:59:72:df,311521138,280,5500,311520858,311521138
27819,5,12,149,5745,-60,-97,37,3e:d1:9b:c7:a4:de,311522313,544,631,311521769,311522313
27820,5,12,149,5745,-60,-97,37,22:ec:75:a8:8a:31,311522918,516,89,311522402,311522918
27821,5,12,149,5745,-65,-97,32,5e:29:73:5b:30:00,311526365,540,2907,311525825,311526365
27822,5,12,149,5745,-64,-97,33,56:68:e2:c2:8d:d5,311531406,280,4761,311531126,311531406
27823,5,12,149,5745,-88,-97,9,46:28:71:6e:d2:2e,311532003,280,317,311531723,311532003
27824,5,12,149,5745,-60,-97,37,a6:92:ad:b7:76:65,311536142,484,3655,311535658,311536142
27825,5,12,149,5745,-64,-97,33,56:68:e2:c2:8d:d5,311536705,476,87,311536229,311536705
27826,5,12,149,5745,-67,-97,30,96:a3:af:37:f7:5e,311539024,468,1851,311538556,311539024
27827,5,12,149,5745,-60,-97,37,22:ec:75:a8:8a:31,311546585,244,7317,311546341,311546585
27828,5,12,149,5745,-85,-97,12,9a:24:38:da:96:bb,311563853,272,16996,311563581,311563853
27829,5,12,149,5745,-59,-97,38,a6:92:ad:b7:76:65,311580941,284,16804,311580657,311580941
27830,5,12,149,5745,-69,-97,28,6a:1e:a4:f8:14:49,311581448,248,259,311581200,311581448
27831,5,12,149,5745,-61,-97,36,f6:0a:5c:59:72:df,311581990,280,262,311581710,311581990
27832,5,12,149,5745,-69,-97,28,0a:b9:b7:b1:4d:fa,311585230,268,2972,311584962,311585230
27833,5,12,149,5745,-71,-97,26,f2:da:61:dd:98:c5,311586514,268,1016,311586246,311586514
27834,5,12,149,5745,-59,-97,38,3e:d1:9b:c7:a4:de,311586816,544,-242,311586272,311586816
27835,5,12,149,5745,-60,-97,37,22:ec:75:a8:8a:31,311587394,516,62,311586878,311587394
27836,5,12,149,5745,-64,-97,33,5e:29:73:5b:30:00,311591670,540,3736,311591130,311591670
27837,5,12,149,5745,-69,-97,28,d2:00:04:7e:2c:ab,311592479,468,341,311592011,311592479
27838,5,12,149,5745,-88,-97,9,46:28:71:6e:d2:2e,311597229,280,4470,311596949,311597229
27839,5,12,149,5745,-64,-97,33,5e:29:73:5b:30:00,311598438,272,937,311598166,311598438
27840,5,12,149,5745,-65,-97,32,56:68:e2:c2:8d:d5,311598789,476,-125,311598313,311598789
27841,5,12,149,5745,-58,-97,39,a6:92:ad:b7:76:65,311601576,484,2303,311601092,311601576
27842,5,12,149,5745,-69,-97,28,d2:00:04:7e:2c:ab,311602150,104,470,311602046,311602150
27843,5,12,149,5745,-67,-97,30,96:a3:af:37:f7:5e,311602333,156,27,311602177,311602333
27844,5,12,149,5745,-67,-97,30,96:a3:af:37:f7:5e,311602559,356,-130,311602203,311602559
27845,5,12,149,5745,-86,-97,11,9a:24:38:da:96:bb,311603028,824,-355,311602204,311603028
27846,5,12,149,5745,-70,-97,27,6a:1e:a4:f8:14:49,311603940,444,468,311603496,311603940
27847,5,12,149,5745,-67,-97,30,96:a3:af:37:f7:5e,311604420,468,12,311603952,311604420
27848,5,12,149,5745,-58,-97,39,3e:d1:9b:c7:a4:de,311613851,272,9159,311613579,311613851
27849,5,12,149,5745,-89,-97,8,46:28:71:6e:d2:2e,311614185,280,54,311613905,311614185
27850,5,12,149,5745,-62,-97,35,f6:0a:5c:59:72:df,311622761,280,8296,311622481,311622761
27851,5,12,149,5745,-60,-97,37,22:ec:75:a8:8a:31,311642714,244,19709,311642470,311642714
27852,5,6,149,5745,-89,-97,8,10:f6:0a:d6:ae:16,311646651,236,3701,311646415,311646651
27853,5,12,149,5745,-66,-97,31,56:68:e2:c2:8d:d5,311664030,280,17099,311663750,311664030
27854,5,12,149,5745,-68,-97,29,96:a3:af:37:f7:5e,311669542,468,5044,311669074,311669542
27855,5,12,149,5745,-84,-97,13,9a:24:38:da:96:bb,311676934,272,7120,311676662,311676934
27856,5,6,149,5745,-89,-97,8,54:e4:3a:ec:fb:65,311689761,360,12467,311689401,311689761
27857,5,12,149,5745,-71,-97,26,6a:1e:a4:f8:14:49,311698547,248,8538,311698299,311698547
27858,5,12,149,5745,-63,-97,34,5e:29:73:5b:30:00,311707000,272,8181,311706728,311707000
27859,5,12,149,5745,-59,-97,38,a6:92:ad:b7:76:65,311707646,284,362,311707362,311707646
27860,5,12,149,5745,-56,-97,41,3e:d1:9b:c7:a4:de,311708924,272,1006,311708652,311708924
27861,5,12,149,5745,-85,-97,12,7e:05:42:11:d2:ec,311720935,272,11739,311720663,311720935
27862,5,12,149,5745,-69,-97,28,96:a3:af:37:f7:5e,311721898,272,691,311721626,311721898
27863,5,12,149,5745,-89,-97,8,46:28:71:6e:d2:2e,311735440,280,13262,311735160,311735440
27864,5,12,149,5745,-60,-97,37,22:ec:75:a8:8a:31,311759126,244,23442,311758882,311759126
27865,5,12,149,5745,-85,-97,12,9a:24:38:da:96:bb,311791733,272,32335,311791461,311791733
27866,5,6,149,5745,-88,-97,9,54:e4:3a:ec:fb:65,311792162,360,69,311791802,311792162
27867,5,24,149,5745,-80,-97,17,,311806826,32,14632,311806794,311806826
27868,5,12,149,5745,-66,-97,31,56:68:e2:c2:8d:d5,311818849,280,11743,311818569,311818849
27869,5,12,149,5745,-59,-97,38,a6:92:ad:b7:76:65,311820206,284,1073,311819922,311820206
27870,5,12,149,5745,-62,-97,35,5e:29:73:5b:30:00,311822817,272,2339,311822545,311822817
27871,5,24,149,5745,-80,-97,17,,311824851,32,2002,311824819,311824851
27872,5,24,149,5745,-79,-97,18,,311825395,32,512,311825363,311825395
27873,5,12,149,5745,-56,-97,41,3e:d1:9b:c7:a4:de,311825889,272,222,311825617,311825889
27874,5,24,149,5745,-80,-97,17,,311826294,28,377,311826266,311826294
27875,5,24,149,5745,-80,-97,17,,311826709,28,387,311826681,311826709
27876,5,6,149,5745,-93,-97,4,,311826869,68,92,311826801,311826869
27877,5,24,149,5745,-65,-97,32,,311828864,28,1967,311828836,311828864
27878,5,24,149,5745,-79,-97,18,,311828908,28,16,311828880,311828908
27879,5,24,149,5745,-80,-97,17,,311829017,28,81,311828989,311829017
27880,5,24,149,5745,-65,-97,32,,311829109,28,64,311829081,311829109
27881,5,24,149,5745,-80,-97,17,,311829153,28,16,311829125,311829153
27882,5,24,149,5745,-80,-97,17,,311829262,28,81,311829234,311829262
27883,5,12,149,5745,-84,-97,13,7e:05:42:11:d2:ec,311833254,272,3720,311832982,311833254
27884,5,24,149,5745,-79,-97,18,,311839765,28,6483,311839737,311839765
27885,5,12,149,5745,-90,-97,7,46:28:71:6e:d2:2e,311851017,280,10972,311850737,311851017
27886,5,12,149,5745,-60,-97,37,f6:0a:5c:59:72:df,311865896,280,14599,311865616,311865896
27887,5,24,149,5745,-79,-97,18,,311870425,32,4497,311870393,311870425
27888,5,12,149,5745,-60,-97,37,22:ec:75:a8:8a:31,311875701,244,5032,311875457,311875701
27889,5,12,149,5745,-67,-97,30,6a:1e:a4:f8:14:49,311891693,248,15744,311891445,311891693
27890,5,12,149,5745,-70,-97,27,96:a3:af:37:f7:5e,311894382,272,2417,311894110,311894382
27891,5,6,149,5745,-89,-97,8,54:e4:3a:ec:fb:65,311894764,360,22,311894404,311894764
27892,5,12,149,5745,-84,-97,13,9a:24:38:da:96:bb,311900310,272,5274,311900038,311900310
27893,5,24,149,5745,-64,-97,33,,311912811,28,12473,311912783,311912811
27894,5,24,149,5745,-79,-97,18,,311912855,28,16,311912827,311912855
27895,5,24,149,5745,-78,-97,19,,311912963,28,80,311912935,311912963
27896,5,24,149,5745,-64,-97,33,,311913127,28,136,311913099,311913127
27897,5,24,149,5745,-79,-97,18,,311913171,28,16,311913143,311913171
27898,5,24,149,5745,-79,-97,18,,311913279,28,80,311913251,311913279
27899,5,24,149,5745,-64,-97,33,,311913488,28,181,311913460,311913488
27900,5,24,149,5745,-78,-97,19,,311913532,28,16,311913504,311913532
27901,5,24,149,5745,-79,-97,18,,311913640,28,80,311913612,311913640
27902,5,12,149,5745,-67,-97,30,56:68:e2:c2:8d:d5,311920423,280,6503,311920143,311920423
27903,5,24,149,5745,-78,-97,19,,311930007,32,9552,311929975,311930007
27904,5,12,149,5745,-60,-97,37,a6:92:ad:b7:76:65,311930424,284,133,311930140,311930424
27905,5,24,149,5745,-78,-97,19,,311930832,32,376,311930800,311930832
27906,5,24,149,5745,-78,-97,19,,311931341,28,481,311931313,311931341
27907,5,24,149,5745,-79,-97,18,,311931543,28,174,311931515,311931543
27908,5,24,149,5745,-78,-97,19,,311931789,28,218,311931761,311931789
27909,5,24,149,5745,-78,-97,19,,311932251,28,434,311932223,311932251
27910,5,12,149,5745,-71,-97,26,96:a3:af:37:f7:5e,311935434,272,2911,311935162,311935434
27911,5,12,149,5745,-62,-97,35,5e:29:73:5b:30:00,311939552,272,3846,311939280,311939552
27912,5,12,149,5745,-57,-97,40,3e:d1:9b:c7:a4:de,311942842,272,3018,311942570,311942842
27913,5,12,149,5745,-84,-97,13,7e:05:42:11:d2:ec,311945600,272,2486,311945328,311945600
27914,5,12,149,5745,-88,-97,9,46:28:71:6e:d2:2e,311958958,280,13078,311958678,311958958
27915,5,12,149,5745,-59,-97,38,f6:0a:5c:59:72:df,311965725,280,6487,311965445,311965725
27916,5,24,149,5745,-63,-97,34,,311973018,28,7265,311972990,311973018
27917,5,24,149,5745,-78,-97,19,,311973062,28,16,311973034,311973062
27918,5,24,149,5745,-77,-97,20,,311973170,28,80,311973142,311973170
27919,5,24,149,5745,-78,-97,19,,311973502,28,304,311973474,311973502
27920,5,24,149,5745,-77,-97,20,,311973547,28,17,311973519,311973547
27921,5,24,149,5745,-77,-97,20,,311973655,32,76,311973623,311973655
27922,5,24,149,5745,-63,-97,34,,311973995,28,312,311973967,311973995
27923,5,24,149,5745,-78,-97,19,,311974039,28,16,311974011,311974039
27924,5,24,149,5745,-78,-97,19,,311974147,28,80,311974119,311974147
27925,5,12,149,5745,-59,-97,38,f6:0a:5c:59:72:df,311976255,280,1828,311975975,311976255
27926,5,12,149,5745,-59,-97,38,22:ec:75:a8:8a:31,311981258,516,4487,311980742,311981258
27927,5,12,149,5745,-57,-97,40,3e:d1:9b:c7:a4:de,311981853,544,51,311981309,311981853
27928,5,24,149,5745,-77,-97,20,,311982477,28,596,311982449,311982477
27929,5,24,149,5745,-78,-97,19,,311982521,28,16,311982493,311982521
27930,5,24,149,5745,-78,-97,19,,311982629,32,76,311982597,311982629
27931,5,12,149,5745,-62,-97,35,5e:29:73:5b:30:00,311987571,540,4402,311987031,311987571
27932,5,24,149,5745,-63,-97,34,,311988327,28,728,311988299,311988327
27933,5,24,149,5745,-78,-97,19,,311988371,28,16,311988343,311988371
27934,5,24,149,5745,-78,-97,19,,311988479,28,80,311988451,311988479
27935,5,12,149,5745,-88,-97,9,46:28:71:6e:d2:2e,311991638,280,2879,311991358,311991638
27936,5,24,149,5745,-78,-97,19,,311994372,28,2706,311994344,311994372
27937,5,24,149,5745,-77,-97,20,,311994416,28,16,311994388,311994416
27938,5,24,149,5745,-77,-97,20,,311994524,32,76,311994492,311994524
27939,5,12,149,5745,-61,-97,36,a6:92:ad:b7:76:65,311994707,484,-301,311994223,311994707
27940,5,12,149,5745,-67,-97,30,56:68:e2:c2:8d:d5,311995225,476,42,311994749,311995225
27941,5,12,149,5745,-87,-97,10,9a:24:38:da:96:bb,311995774,824,-275,311994950,311995774
27942,5,24,149,5745,-77,-97,20,,311997410,28,1608,311997382,311997410
27943,5,24,149,5745,-78,-97,19,,311997454,28,16,311997426,311997454
27944,5,24,149,5745,-78,-97,19,,311997562,32,76,311997530,311997562
27945,5,12,149,5745,-70,-97,27,96:a3:af:37:f7:5e,311997637,468,-393,311997169,311997637
27946,5,12,149,5745,-85,-97,12,7e:05:42:11:d2:ec,311999161,468,1056,311998693,311999161
27947,5,12,149,5745,-65,-97,32,6a:1e:a4:f8:14:49,312001038,444,1433,312000594,312001038
27948,5,12,149,5745,-59,-97,38,22:ec:75:a8:8a:31,312005179,244,3897,312004935,312005179
27949,5,12,149,5745,-67,-97,30,56:68:e2:c2:8d:d5,312006591,280,1132,312006311,312006591
27950,5,12,149,5745,-86,-97,11,9a:24:38:da:96:bb,312011985,272,5122,312011713,312011985
27951,5,24,149,5745,-77,-97,20,,312017074,28,5061,312017046,312017074
27952,5,24,149,5745,-78,-97,19,,312017118,28,16,312017090,312017118
27953,5,24,149,5745,-78,-97,19,,312017234,32,84,312017202,312017234
27954,5,24,149,5745,-78,-97,19,,312031599,28,14337,312031571,312031599
27955,5,24,149,5745,-77,-97,20,,312031643,28,16,312031615,312031643
27956,5,24,149,5745,-77,-97,20,,312031751,32,76,312031719,312031751
27957,5,24,149,5745,-78,-97,19,,312032431,28,652,312032403,312032431
27958,5,24,149,5745,-77,-97,20,,312032475,28,16,312032447,312032475
27959,5,24,149,5745,-77,-97,20,,312032583,32,76,312032551,312032583
27960,5,24,149,5745,-77,-97,20,,312038572,28,5961,312038544,312038572
27961,5,24,149,5745,-78,-97,19,,312038617,28,17,312038589,312038617
27962,5,24,149,5745,-78,-97,19,,312038725,32,76,312038693,312038725
27963,5,12,149,5745,-70,-97,27,96:a3:af:37:f7:5e,312039283,272,286,312039011,312039283
27964,5,12,149,5745,-60,-97,37,a6:92:ad:b7:76:65,312039607,284,40,312039323,312039607
27965,5,12,149,5745,-86,-97,11,7e:05:42:11:d2:ec,312047215,468,7140,312046747,312047215
27966,5,12,149,5745,-62,-97,35,5e:29:73:5b:30:00,312052072,272,4585,312051800,312052072
27967,5,12,149,5745,-65,-97,32,6a:1e:a4:f8:14:49,312052414,248,94,312052166,312052414
27968,5,12,149,5745,-86,-97,11,7e:05:42:11:d2:ec,312055451,272,2765,312055179,312055451
27969,5,12,149,5745,-58,-97,39,3e:d1:9b:c7:a4:de,312059815,272,4092,312059543,312059815
27970,5,12,149,5745,-60,-97,37,a6:92:ad:b7:76:65,312060193,484,-106,312059709,312060193
27971,5,12,149,5745,-70,-97,27,96:a3:af:37:f7:5e,312062844,468,2183,312062376,312062844
27972,5,24,149,5745,-77,-97,20,,312075147,28,12275,312075119,312075147
27973,5,24,149,5745,-77,-97,20,,312075191,28,16,312075163,312075191
27974,5,24,149,5745,-77,-97,20,,312075309,32,86,312075277,312075309
27975,5,24,149,5745,-78,-97,19,,312075504,28,167,312075476,312075504
27976,5,24,149,5745,-77,-97,20,,312075548,28,16,312075520,312075548
27977,5,24,149,5745,-77,-97,20,,312075656,32,76,312075624,312075656
27978,5,24,149,5745,-77,-97,20,,312075768,32,80,312075736,312075768
27979,5,12,149,5745,-89,-97,8,46:28:71:6e:d2:2e,312076205,280,157,312075925,312076205
27980,5,24,149,5745,-76,-97,21,,312078182,28,1949,312078154,312078182
27981,5,24,149,5745,-78,-97,19,,312078226,28,16,312078198,312078226
27982,5,24,149,5745,-77,-97,20,,312078334,32,76,312078302,312078334
27983,5,24,149,5745,-77,-97,20,,312079380,28,1018,312079352,312079380
27984,5,24,149,5745,-76,-97,21,,312079425,28,17,312079397,312079425
27985,5,24,149,5745,-76,-97,21,,312079540,32,83,312079508,312079540
27986,5,24,149,5745,-77,-97,20,,312079652,32,80,312079620,312079652
27987,5,24,149,5745,-78,-97,19,,312079855,28,175,312079827,312079855
27988,5,24,149,5745,-77,-97,20,,312079899,28,16,312079871,312079899
27989,5,24,149,5745,-77,-97,20,,312080007,32,76,312079975,312080007
27990,5,24,149,5745,-76,-97,21,,312081992,28,1957,312081964,312081992
27991,5,24,149,5745,-77,-97,20,,312082036,28,16,312082008,312082036
27992,5,24,149,5745,-78,-97,19,,312082145,32,77,312082113,312082145
27993,5,24,149,5745,-76,-97,21,,312086248,28,4075,312086220,312086248
27994,5,24,149,5745,-77,-97,20,,312086292,28,16,312086264,312086292
27995,5,24,149,5745,-78,-97,19,,312086400,32,76,312086368,312086400
27996,5,24,149,5745,-77,-97,20,,312096222,28,9794,312096194,312096222
27997,5,24,149,5745,-77,-97,20,,312096266,28,16,312096238,312096266
27998,5,24,149,5745,-77,-97,20,,312096374,32,76,312096342,312096374
27999,5,6,149,5745,-88,-97,9,54:e4:3a:ec:fb:65,312099364,360,2630,312099004,312099364
28000,5,12,149,5745,-86,-97,11,7e:05:42:11:d2:ec,312104087,468,4255,312103619,312104087
28001,5,12,149,5745,-74,-97,23,f2:da:61:dd:98:c5,312112567,268,8212,312112299,312112567
28002,5,12,149,5745,-59,-97,38,22:ec:75:a8:8a:31,312113727,516,644,312113211,312113727
28003,5,12,149,5745,-58,-97,39,3e:d1:9b:c7:a4:de,312114322,544,51,312113778,312114322
28004,5,12,149,5745,-66,-97,31,0a:b9:b7:b1:4d:fa,312117303,268,2713,312117035,312117303
28005,5,12,149,5745,-58,-97,39,22:ec:75:a8:8a:31,312119918,244,2371,312119674,312119918
28006,5,12,149,5745,-62,-97,35,5e:29:73:5b:30:00,312120382,540,-76,312119842,312120382
28007,5,12,149,5745,-71,-97,26,d2:00:04:7e:2c:ab,312121001,468,151,312120533,312121001
28008,5,12,149,5745,-87,-97,10,9a:24:38:da:96:bb,312123582,272,2309,312123310,312123582
28009,5,12,149,5745,-60,-97,37,a6:92:ad:b7:76:65,312125706,484,1640,312125222,312125706
28010,5,12,149,5745,-71,-97,26,96:a3:af:37:f7:5e,312128258,468,2084,312127790,312128258
28011,5,12,149,5745,-88,-97,9,9a:24:38:da:96:bb,312128795,824,-287,312127971,312128795
28012,5,12,149,5745,-71,-97,26,96:a3:af:37:f7:5e,312154365,272,25298,312154093,312154365
28013,5,12,149,5745,-61,-97,36,a6:92:ad:b7:76:65,312154638,284,-11,312154354,312154638
28014,5,12,149,5745,-62,-97,35,5e:29:73:5b:30:00,312166482,272,11572,312166210,312166482
28015,5,12,149,5745,-59,-97,38,3e:d1:9b:c7:a4:de,312175509,272,8755,312175237,312175509
28016,5,12,149,5745,-87,-97,10,7e:05:42:11:d2:ec,312182054,272,6273,312181782,312182054
28017,5,24,149,5745,-78,-97,19,,312183372,28,1290,312183344,312183372
28018,5,24,149,5745,-76,-97,21,,312183416,28,16,312183388,312183416
28019,5,24,149,5745,-77,-97,20,,312183524,32,76,312183492,312183524
28020,5,12,149,5745,-90,-97,7,46:28:71:6e:d2:2e,312188503,280,4699,312188223,312188503
28021,5,12,149,5745,-70,-97,27,96:a3:af:37:f7:5e,312193942,468,4971,312193474,312193942
28022,5,12,149,5745,-70,-97,27,6a:1e:a4:f8:14:49,312198989,248,4799,312198741,312198989
28023,5,24,149,5745,-76,-97,21,,312201407,28,2390,312201379,312201407
28024,5,24,149,5745,-78,-97,19,,312201452,28,17,312201424,312201452
28025,5,24,149,5745,-78,-97,19,,312201560,32,76,312201528,312201560
28026,5,6,149,5745,-88,-97,9,54:e4:3a:ec:fb:65,312201765,360,-155,312201405,312201765
28027,5,12,149,5745,-60,-97,37,22:ec:75:a8:8a:31,312217990,244,15981,312217746,312217990
28028,5,12,149,5745,-67,-97,30,56:68:e2:c2:8d:d5,312231406,280,13136,312231126,312231406
28029,5,12,149,5745,-88,-97,9,9a:24:38:da:96:bb,312236483,272,4805,312236211,312236483
28030,5,12,149,5745,-73,-97,24,96:a3:af:37:f7:5e,312273146,272,36391,312272874,312273146
28031,5,12,149,5745,-62,-97,35,5e:29:73:5b:30:00,312283353,272,9935,312283081,312283353
28032,5,12,149,5745,-58,-97,39,3e:d1:9b:c7:a4:de,312289232,272,5607,312288960,312289232
28033,5,12,149,5745,-90,-97,7,46:28:71:6e:d2:2e,312300865,280,11353,312300585,312300865
28034,5,12,149,5745,-72,-97,25,6a:1e:a4:f8:14:49,312301368,248,255,312301120,312301368
28035,5,24,149,5745,-78,-97,19,,312303156,28,1760,312303128,312303156
28036,5,24,149,5745,-77,-97,20,,312303200,28,16,312303172,312303200
28037,5,24,149,5745,-77,-97,20,,312303308,32,76,312303276,312303308
28038,5,6,149,5745,-90,-97,7,54:e4:3a:ec:fb:65,312304165,360,497,312303805,312304165
28039,5,6,149,5745,-81,-97,16,24:f6:77:10:02:c8,312315065,176,10724,312314889,312315065
28040,5,24,149,5745,-77,-97,20,,312321609,28,6516,312321581,312321609
28041,5,24,149,5745,-78,-97,19,,312321653,28,16,312321625,312321653
28042,5,24,149,5745,-78,-97,19,,312321761,32,76,312321729,312321761
28043,5,6,149,5745,-80,-97,17,24:f6:77:10:02:c8,312326376,176,4439,312326200,312326376
28044,5,12,149,5745,-60,-97,37,f6:0a:5c:59:72:df,312327688,280,1032,312327408,312327688
28045,5,12,149,5745,-57,-97,40,a6:92:ad:b7:76:65,312328011,284,39,312327727,312328011
28046,5,12,149,5745,-60,-97,37,22:ec:75:a8:8a:31,312335145,244,6890,312334901,312335145
28047,5,12,149,5745,-67,-97,30,56:68:e2:c2:8d:d5,312343063,280,7638,312342783,312343063
28048,5,12,149,5745,-86,-97,11,7e:05:42:11:d2:ec,312346511,272,3176,312346239,312346511
28049,5,12,149,5745,-63,-97,34,5e:29:73:5b:30:00,312397153,272,50370,312396881,312397153
28050,5,12,149,5745,-71,-97,26,6a:1e:a4:f8:14:49,312402301,248,4900,312402053,312402301
28051,5,24,149,5745,-79,-97,18,,312404487,28,2158,312404459,312404487
28052,5,24,149,5745,-75,-97,22,,312404531,28,16,312404503,312404531
28053,5,24,149,5745,-75,-97,22,,312404640,32,77,312404608,312404640
28054,5,12,149,5745,-58,-97,39,3e:d1:9b:c7:a4:de,312406112,272,1200,312405840,312406112
28055,5,12,149,5745,-76,-97,21,96:a3:af:37:f7:5e,312406482,272,98,312406210,312406482
28056,5,24,149,5745,-75,-97,22,,312423543,28,17033,312423515,312423543
28057,5,24,149,5745,-79,-97,18,,312423588,28,17,312423560,312423588
28058,5,24,149,5745,-79,-97,18,,312423695,32,75,312423663,312423695
28059,5,12,149,5745,-58,-97,39,a6:92:ad:b7:76:65,312426123,284,2144,312425839,312426123
28060,5,12,149,5745,-60,-97,37,f6:0a:5c:59:72:df,312436778,280,10375,312436498,312436778
28061,5,12,149,5745,-87,-97,10,7e:05:42:11:d2:ec,312448901,272,11851,312448629,312448901
28062,5,12,149,5745,-60,-97,37,22:ec:75:a8:8a:31,312452327,244,3182,312452083,312452327
28063,5,12,149,5745,-71,-97,26,6a:1e:a4:f8:14:49,312504843,248,52268,312504595,312504843
28064,5,12,149,5745,-85,-97,12,7e:05:42:11:d2:ec,312505165,272,50,312504893,312505165
28065,5,12,149,5745,-74,-97,23,96:a3:af:37:f7:5e,312508413,272,2976,312508141,312508413
28066,5,12,149,5745,-62,-97,35,5e:29:73:5b:30:00,312509304,272,619,312509032,312509304
28067,5,12,149,5745,-56,-97,41,3e:d1:9b:c7:a4:de,312518066,272,8490,312517794,312518066
28068,5,12,149,5745,-58,-97,39,a6:92:ad:b7:76:65,312527734,284,9384,312527450,312527734
28069,5,24,149,5745,-79,-97,18,,312528061,28,299,312528033,312528061
28070,5,24,149,5745,-75,-97,22,,312528106,28,17,312528078,312528106
28071,5,24,149,5745,-76,-97,21,,312528214,32,76,312528182,312528214
28072,5,12,149,5745,-67,-97,30,56:68:e2:c2:8d:d5,312534915,280,6421,312534635,312534915
28073,5,24,149,5745,-76,-97,21,,312545453,32,10506,312545421,312545453
28074,5,24,149,5745,-76,-97,21,,312545741,28,260,312545713,312545741
28075,5,24,149,5745,-88,-97,9,,312545784,28,15,312545756,312545784
28076,5,6,149,5745,-89,-97,8,,312545901,68,49,312545833,312545901
28077,5,24,149,5745,-75,-97,22,,312546314,28,385,312546286,312546314
28078,5,24,149,5745,-79,-97,18,,312546358,28,16,312546330,312546358
28079,5,24,149,5745,-78,-97,19,,312546466,32,76,312546434,312546466
28080,5,24,149,5745,-76,-97,21,,312546645,32,147,312546613,312546645
28081,5,12,149,5745,-83,-97,14,7e:05:42:11:d2:ec,312563149,468,16036,312562681,312563149
28082,5,12,149,5745,-67,-97,30,56:68:e2:c2:8d:d5,312563687,280,258,312563407,312563687
28083,5,12,149,5745,-61,-97,36,f6:0a:5c:59:72:df,312567751,280,3784,312567471,312567751
28084,5,12,149,5745,-55,-97,42,3e:d1:9b:c7:a4:de,312570495,544,2200,312569951,312570495
28085,5,12,149,5745,-61,-97,36,22:ec:75:a8:8a:31,312571100,516,89,312570584,312571100
28086,5,12,149,5745,-84,-97,13,9a:24:38:da:96:bb,312573362,272,1990,312573090,312573362
28087,5,12,149,5745,-61,-97,36,22:ec:75:a8:8a:31,312578652,244,5046,312578408,312578652
28088,5,12,149,5745,-63,-97,34,5e:29:73:5b:30:00,312579353,540,161,312578813,312579353
28089,5,12,149,5745,-90,-97,7,46:28:71:6e:d2:2e,312581099,280,1466,312580819,312581099
28090,5,12,149,5745,-67,-97,30,56:68:e2:c2:8d:d5,312582690,476,1115,312582214,312582690
28091,5,12,149,5745,-57,-97,40,a6:92:ad:b7:76:65,312586134,484,2960,312585650,312586134
28092,5,12,149,5745,-72,-97,25,96:a3:af:37:f7:5e,312588985,440,2411,312588545,312588985
28093,5,12,149,5745,-70,-97,27,6a:1e:a4:f8:14:49,312589674,444,245,312589230,312589674
28094,5,12,149,5745,-57,-97,40,a6:92:ad:b7:76:65,312596509,284,6551,312596225,312596509
28095,5,12,149,5745,-70,-97,27,6a:1e:a4:f8:14:49,312597218,248,461,312596970,312597218
28096,5,6,149,5745,-90,-97,7,54:e4:3a:ec:fb:65,312611367,360,13789,312611007,312611367
28097,5,24,149,5745,-77,-97,20,,312628029,28,16634,312628001,312628029
28098,5,24,149,5745,-76,-97,21,,312628074,28,17,312628046,312628074
28099,5,24,149,5745,-76,-97,21,,312628182,32,76,312628150,312628182
28100,5,12,149,5745,-83,-97,14,7e:05:42:11:d2:ec,312628302,468,-348,312627834,312628302
28101,5,12,149,5745,-63,-97,34,5e:29:73:5b:30:00,312630745,272,2171,312630473,312630745
28102,5,12,149,5745,-61,-97,36,f6:0a:5c:59:72:df,312631177,280,152,312630897,312631177
28103,5,12,149,5745,-90,-97,7,46:28:71:6e:d2:2e,312634319,280,2862,312634039,312634319
28104,5,12,149,5745,-55,-97,42,3e:d1:9b:c7:a4:de,312635830,544,967,312635286,312635830
28105,5,12,149,5745,-61,-97,36,22:ec:75:a8:8a:31,312636444,516,98,312635928,312636444
28106,5,12,149,5745,-69,-97,28,f2:da:61:dd:98:c5,312637039,268,327,312636771,312637039
28107,5,12,149,5745,-84,-97,13,7e:05:42:11:d2:ec,312638733,360,1334,312638373,312638733
28108,5,12,149,5745,-70,-97,27,0a:b9:b7:b1:4d:fa,312642453,268,3452,312642185,312642453
28109,5,12,149,5745,-70,-97,27,96:a3:af:37:f7:5e,312642757,440,-136,312642317,312642757
28110,5,12,149,5745,-71,-97,26,96:a3:af:37:f7:5e,312644504,156,1591,312644348,312644504
28111,5,12,149,5745,-71,-97,26,96:a3:af:37:f7:5e,312644830,104,222,312644726,312644830
28112,5,12,149,5745,-63,-97,34,5e:29:73:5b:30:00,312645140,540,-230,312644600,312645140
28113,5,12,149,5745,-56,-97,41,3e:d1:9b:c7:a4:de,312645814,272,402,312645542,312645814
28114,5,24,149,5745,-77,-97,20,,312646116,28,274,312646088,312646116
28115,5,24,149,5745,-76,-97,21,,312646332,28,188,312646304,312646332
28116,5,24,149,5745,-77,-97,20,,312646376,28,16,312646348,312646376
28117,5,24,149,5745,-77,-97,20,,312646487,32,79,312646455,312646487
28118,5,12,149,5745,-66,-97,31,56:68:e2:c2:8d:d5,312647292,476,329,312646816,312647292
28119,5,12,149,5745,-63,-97,34,f6:0a:5c:59:72:df,312647810,280,238,312647530,312647810
28120,5,12,149,5745,-57,-97,40,a6:92:ad:b7:76:65,312649392,484,1098,312648908,312649392
28121,5,12,149,5745,-85,-97,12,9a:24:38:da:96:bb,312650592,824,376,312649768,312650592
28122,5,12,149,5745,-71,-97,26,6a:1e:a4:f8:14:49,312652502,444,1466,312652058,312652502
28123,5,12,149,5745,-65,-97,32,56:68:e2:c2:8d:d5,312679233,280,26451,312678953,312679233
28124,5,12,149,5745,-62,-97,35,22:ec:75:a8:8a:31,312679952,244,475,312679708,312679952
28125,5,12,149,5745,-85,-97,12,9a:24:38:da:96:bb,312687046,272,6822,312686774,312687046
28126,5,12,149,5745,-70,-97,27,96:a3:af:37:f7:5e,312708021,440,20535,312707581,312708021
28127,5,12,149,5745,-70,-97,27,96:a3:af:37:f7:5e,312711015,244,2750,312710771,312711015
28128,5,6,149,5745,-90,-97,7,54:e4:3a:ec:fb:65,312714208,360,2833,312713848,312714208
28129,5,12,149,5745,-69,-97,28,6a:1e:a4:f8:14:49,312716710,248,2254,312716462,312716710
28130,5,12,149,5745,-60,-97,37,a6:92:ad:b7:76:65,312724757,284,7763,312724473,312724757
28131,5,12,149,5745,-85,-97,12,7e:05:42:11:d2:ec,312730874,272,5845,312730602,312730874
28132,5,12,149,5745,-64,-97,33,5e:29:73:5b:30:00,312738845,272,7699,312738573,312738845
28133,5,12,149,5745,-58,-97,39,3e:d1:9b:c7:a4:de,312746366,272,7249,312746094,312746366
28134,5,12,149,5745,-90,-97,7,46:28:71:6e:d2:2e,312751319,280,4673,312751039,312751319
28135,5,24,149,5745,-79,-97,18,,312753434,28,2087,312753406,312753434
28136,5,24,149,5745,-77,-97,20,,312753478,28,16,312753450,312753478
28137,5,24,149,5745,-77,-97,20,,312753586,32,76,312753554,312753586
28138,5,24,149,5745,-77,-97,20,,312771469,28,17855,312771441,312771469
28139,5,24,149,5745,-79,-97,18,,312771513,28,16,312771485,312771513
28140,5,24,149,5745,-79,-97,18,,312771621,32,76,312771589,312771621
28141,5,12,149,5745,-62,-97,35,f6:0a:5c:59:72:df,312776887,280,4986,312776607,312776887
28142,5,12,149,5745,-61,-97,36,22:ec:75:a8:8a:31,312792721,244,15590,312792477,312792721
28143,5,6,149,5745,-91,-97,6,54:e4:3a:ec:fb:65,312816168,360,23087,312815808,312816168
28144,5,12,149,5745,-69,-97,28,6a:1e:a4:f8:14:49,312824964,248,8548,312824716,312824964
28145,5,12,149,5745,-61,-97,36,a6:92:ad:b7:76:65,312837611,284,12363,312837327,312837611
28146,5,12,149,5745,-63,-97,34,56:68:e2:c2:8d:d5,312841108,280,3217,312840828,312841108
28147,5,24,149,5745,-81,-97,16,,312853010,28,11874,312852982,312853010
28148,5,24,149,5745,-76,-97,21,,312853054,28,16,312853026,312853054
28149,5,24,149,5745,-77,-97,20,,312853163,32,77,312853131,312853163
28150,5,12,149,5745,-62,-97,35,5e:29:73:5b:30:00,312855860,272,2425,312855588,312855860
28151,5,12,149,5745,-84,-97,13,7e:05:42:11:d2:ec,312857479,272,1347,312857207,312857479
28152,5,12,149,5745,-55,-97,42,3e:d1:9b:c7:a4:de,312860749,272,2998,312860477,312860749
28153,5,24,149,5745,-77,-97,20,,312871087,28,10310,312871059,312871087
28154,5,24,149,5745,-81,-97,16,,312871131,28,16,312871103,312871131
28155,5,24,149,5745,-81,-97,16,,312871239,32,76,312871207,312871239
28156,5,12,149,5745,-62,-97,35,f6:0a:5c:59:72:df,312889234,280,17715,312888954,312889234
28157,5,12,149,5745,-61,-97,36,22:ec:75:a8:8a:31,312909167,244,19689,312908923,312909167
28158,5,24,149,5745,-66,-97,31,,312911107,28,1912,312911079,312911107
28159,5,24,149,5745,-79,-97,18,,312911151,28,16,312911123,312911151
28160,5,24,149,5745,-78,-97,19,,312911259,28,80,312911231,312911259
28161,5,12,149,5745,-84,-97,13,9a:24:38:da:96:bb,312914285,272,2754,312914013,312914285
28162,5,12,149,5745,-73,-97,24,96:a3:af:37:f7:5e,312920250,244,5721,312920006,312920250
28163,5,24,149,5745,-80,-97,17,,312934182,28,13904,312934154,312934182
28164,5,12,149,5745,-62,-97,35,56:68:e2:c2:8d:d5,312944167,280,9705,312943887,312944167
28165,5,12,149,5745,-69,-97,28,6a:1e:a4:f8:14:49,312947127,248,2712,312946879,312947127
28166,5,12,149,5745,-60,-97,37,a6:92:ad:b7:76:65,312950177,284,2766,312949893,312950177
28167,5,12,149,5745,-74,-97,23,96:a3:af:37:f7:5e,312953095,244,2674,312952851,312953095
28168,5,12,149,5745,-85,-97,12,7e:05:42:11:d2:ec,312961437,272,8070,312961165,312961437
28169,5,12,149,5745,-62,-97,35,5e:29:73:5b:30:00,312971734,272,10025,312971462,312971734
28170,5,12,149,5745,-60,-97,37,3e:d1:9b:c7:a4:de,312977876,272,5870,312977604,312977876
28171,5,24,149,5745,-79,-97,18,,312978281,28,377,312978253,312978281
28172,5,24,149,5745,-81,-97,16,,312978325,28,16,312978297,312978325
28173,5,24,149,5745,-80,-97,17,,312978433,32,76,312978401,312978433
28174,5,24,149,5745,-64,-97,33,,312987408,28,8947,312987380,312987408
28175,5,24,149,5745,-80,-97,17,,312987452,28,16,312987424,312987452
28176,5,24,149,5745,-81,-97,16,,312987560,28,80,312987532,312987560
28177,5,24,149,5745,-80,-97,17,,312996977,28,9389,312996949,312996977
28178,5,24,149,5745,-78,-97,19,,312997021,28,16,312996993,312997021
28179,5,24,149,5745,-79,-97,18,,312997128,32,75,312997096,312997128
28180,5,6,149,5745,-91,-97,6,54:e4:3a:ec:fb:65,313020969,360,23481,313020609,313020969
28181,5,12,149,5745,-84,-97,13,9a:24:38:da:96:bb,313022013,272,772,313021741,313022013
28182,5,12,149,5745,-63,-97,34,56:68:e2:c2:8d:d5,313022376,280,83,313022096,313022376
28183,5,12,149,5745,-61,-97,36,f6:0a:5c:59:72:df,313024931,280,2275,313024651,313024931
28184,5,12,149,5745,-57,-97,40,22:ec:75:a8:8a:31,313029794,516,4347,313029278,313029794
28185,5,12,149,5745,-58,-97,39,3e:d1:9b:c7:a4:de,313030345,544,7,313029801,313030345
28186,5,12,149,5745,-58,-97,39,a6:92:ad:b7:76:65,313034064,484,3235,313033580,313034064
28187,5,12,149,5745,-57,-97,40,22:ec:75:a8:8a:31,313037444,244,3136,313037200,313037444
28188,5,12,149,5745,-70,-97,27,6a:1e:a4:f8:14:49,313039603,248,1911,313039355,313039603
28189,5,12,149,5745,-65,-97,32,5e:29:73:5b:30:00,313039930,540,-213,313039390,313039930
28190,5,12,149,5745,-62,-97,35,56:68:e2:c2:8d:d5,313043809,476,3403,313043333,313043809
28191,5,12,149,5745,-70,-97,27,6a:1e:a4:f8:14:49,313047938,444,3685,313047494,313047938
28192,5,12,149,5745,-59,-97,38,a6:92:ad:b7:76:65,313055315,284,7093,313055031,313055315
28193,5,24,149,5745,-78,-97,19,,313077209,28,21866,313077181,313077209
28194,5,24,149,5745,-81,-97,16,,313077253,28,16,313077225,313077253
28195,5,24,149,5745,-81,-97,16,,313077361,32,76,313077329,313077361
28196,5,12,149,5745,-65,-97,32,5e:29:73:5b:30:00,313086118,272,8485,313085846,313086118
28197,5,12,149,5745,-57,-97,40,3e:d1:9b:c7:a4:de,313093649,272,7259,313093377,313093649
28198,5,12,149,5745,-72,-97,25,f2:da:61:dd:98:c5,313094177,268,260,313093909,313094177
28199,5,24,149,5745,-80,-97,17,,313095635,28,1430,313095607,313095635
28200,5,24,149,5745,-78,-97,19,,313095679,28,16,313095651,313095679
28201,5,24,149,5745,-78,-97,19,,313095787,32,76,313095755,313095787
28202,5,6,149,5745,-89,-97,8,54:e4:3a:ec:fb:65,313123370,360,27223,313123010,313123370
28203,5,12,149,5745,-61,-97,36,56:68:e2:c2:8d:d5,313130492,280,6842,313130212,313130492
28204,5,12,149,5745,-87,-97,10,9a:24:38:da:96:bb,313133591,272,2827,313133319,313133591
28205,5,12,149,5745,-71,-97,26,f2:da:61:dd:98:c5,313139440,268,5581,313139172,313139440
28206,5,12,149,5745,-55,-97,42,22:ec:75:a8:8a:31,313152096,244,12412,313151852,313152096
28207,5,12,149,5745,-83,-97,14,7e:05:42:11:d2:ec,313154498,468,1934,313154030,313154498
28208,5,24,149,5745,-80,-97,17,,313155903,32,1373,313155871,313155903
28209,5,24,149,5745,-80,-97,17,,313156252,32,317,313156220,313156252
28210,5,24,149,5745,-79,-97,18,,313157504,32,1220,313157472,313157504
28211,5,24,149,5745,-80,-97,17,,313157630,32,94,313157598,313157630
28212,5,12,149,5745,-72,-97,25,f2:da:61:dd:98:c5,313157954,268,56,313157686,313157954
28213,5,12,149,5745,-60,-97,37,3e:d1:9b:c7:a4:de,313161901,544,3403,313161357,313161901
28214,5,12,149,5745,-55,-97,42,22:ec:75:a8:8a:31,313162506,516,89,313161990,313162506
28215,5,12,149,5745,-57,-97,40,a6:92:ad:b7:76:65,313163794,484,804,313163310,313163794
28216,5,12,149,5745,-67,-97,30,0a:b9:b7:b1:4d:fa,313165878,268,1816,313165610,313165878
28217,5,12,149,5745,-57,-97,40,a6:92:ad:b7:76:65,313170023,284,3861,313169739,313170023
28218,5,24,149,5745,-79,-97,18,,313170477,32,422,313170445,313170477
28219,5,24,149,5745,-80,-97,17,,313170755,28,250,313170727,313170755
28220,5,24,149,5745,-87,-97,10,,313170798,28,15,313170770,313170798
28221,5,6,149,5745,-87,-97,10,,313170915,68,49,313170847,313170915
28222,5,24,149,5745,-79,-97,18,,313171424,28,481,313171396,313171424
28223,5,24,149,5745,-87,-97,10,,313171467,28,15,313171439,313171467
28224,5,12,149,5745,-71,-97,26,96:a3:af:37:f7:5e,313171495,440,-412,313171055,313171495
28225,5,12,149,5745,-67,-97,30,5e:29:73:5b:30:00,313172089,540,54,313171549,313172089
28226,5,24,149,5745,-80,-97,17,,313172745,28,628,313172717,313172745
28227,5,24,149,5745,-88,-97,9,,313172788,28,15,313172760,313172788
28228,5,6,149,5745,-87,-97,10,,313172905,68,49,313172837,313172905
28229,5,24,149,5745,-80,-97,17,,313173434,32,497,313173402,313173434
28230,5,12,149,5745,-83,-97,14,9a:24:38:da:96:bb,313175199,824,941,313174375,313175199
28231,5,24,149,5745,-77,-97,20,,313202962,28,27735,313202934,313202962
28232,5,24,149,5745,-79,-97,18,,313203006,28,16,313202978,313203006
28233,5,24,149,5745,-80,-97,17,,313203115,32,77,313203083,313203115
28234,5,12,149,5745,-65,-97,32,5e:29:73:5b:30:00,313204992,272,1605,313204720,313204992
28235,5,12,149,5745,-56,-97,41,3e:d1:9b:c7:a4:de,313206707,272,1443,313206435,313206707
28236,5,24,149,5745,-78,-97,19,,313220832,28,14097,313220804,313220832
28237,5,24,149,5745,-77,-97,20,,313220876,28,16,313220848,313220876
28238,5,24,149,5745,-77,-97,20,,313220984,32,76,313220952,313220984
28239,5,12,149,5745,-69,-97,28,6a:1e:a4:f8:14:49,313224043,248,2811,313223795,313224043
28240,5,6,149,5745,-92,-97,5,54:e4:3a:ec:fb:65,313225770,360,1367,313225410,313225770
28241,5,12,149,5745,-63,-97,34,56:68:e2:c2:8d:d5,313244208,280,18158,313243928,313244208
28242,5,12,149,5745,-84,-97,13,9a:24:38:da:96:bb,313249354,272,4874,313249082,313249354
28243,5,12,149,5745,-55,-97,42,22:ec:75:a8:8a:31,313251750,244,2152,313251506,313251750
28244,5,12,149,5745,-61,-97,36,f6:0a:5c:59:72:df,313252363,280,333,313252083,313252363
28245,5,24,149,5745,-77,-97,20,,313303621,28,51230,313303593,313303621
28246,5,24,149,5745,-78,-97,19,,313303665,28,16,313303637,313303665
28247,5,24,149,5745,-77,-97,20,,313303881,28,188,313303853,313303881
28248,5,24,149,5745,-78,-97,19,,313303925,28,16,313303897,313303925
28249,5,24,149,5745,-77,-97,20,,313304132,28,179,313304104,313304132
28250,5,24,149,5745,-79,-97,18,,313304177,28,17,313304149,313304177
28251,5,24,149,5745,-78,-97,19,,313304289,32,80,313304257,313304289
28252,5,12,149,5745,-66,-97,31,5e:29:73:5b:30:00,313314707,272,10146,313314435,313314707
28253,5,24,149,5745,-80,-97,17,,313322386,28,7651,313322358,313322386
28254,5,24,149,5745,-77,-97,20,,313322431,28,17,313322403,313322431
28255,5,24,149,5745,-77,-97,20,,313322538,32,75,313322506,313322538
28256,5,12,149,5745,-58,-97,39,3e:d1:9b:c7:a4:de,313324154,272,1344,313323882,313324154
28257,5,12,149,5745,-69,-97,28,6a:1e:a4:f8:14:49,313325352,248,950,313325104,313325352
28258,5,6,149,5745,-90,-97,7,54:e4:3a:ec:fb:65,313328170,360,2458,313327810,313328170
28259,5,12,149,5745,-69,-97,28,f2:da:61:dd:98:c5,313329031,268,593,313328763,313329031
28260,5,12,149,5745,-72,-97,25,d2:00:04:7e:2c:ab,313337900,244,8625,313337656,313337900
28261,5,12,149,5745,-63,-97,34,f6:0a:5c:59:72:df,313350654,280,12474,313350374,313350654
28262,5,12,149,5745,-85,-97,12,7e:05:42:11:d2:ec,313351058,468,-64,313350590,313351058
28263,5,12,149,5745,-57,-97,40,a6:92:ad:b7:76:65,313351749,284,407,313351465,313351749
28264,5,12,149,5745,-64,-97,33,56:68:e2:c2:8d:d5,313355651,280,3622,313355371,313355651
28265,5,12,149,5745,-84,-97,13,9a:24:38:da:96:bb,313358686,272,2763,313358414,313358686
28266,5,12,149,5745,-55,-97,42,22:ec:75:a8:8a:31,313368696,244,9766,313368452,313368696
28267,5,12,149,5745,-70,-97,27,6a:1e:a4:f8:14:49,313427746,248,58802,313427498,313427746
28268,5,24,149,5745,-81,-97,16,,313428163,28,389,313428135,313428163
28269,5,24,149,5745,-77,-97,20,,313428208,28,17,313428180,313428208
28270,5,24,149,5745,-77,-97,20,,313428316,32,76,313428284,313428316
28271,5,6,149,5745,-90,-97,7,54:e4:3a:ec:fb:65,313430571,360,1895,313430211,313430571
28272,5,12,149,5745,-70,-97,27,f2:da:61:dd:98:c5,313431713,268,874,313431445,313431713
28273,5,12,149,5745,-69,-97,28,5e:29:73:5b:30:00,313432282,272,297,313432010,313432282
28274,5,12,149,5745,-60,-97,37,3e:d1:9b:c7:a4:de,313439425,272,6871,313439153,313439425
28275,5,24,149,5745,-77,-97,20,,313446668,28,7215,313446640,313446668
28276,5,24,149,5745,-81,-97,16,,313446712,28,16,313446684,313446712
28277,5,24,149,5745,-81,-97,16,,313446820,32,76,313446788,313446820
28278,5,12,149,5745,-70,-97,27,d2:00:04:7e:2c:ab,313447630,244,566,313447386,313447630
28279,5,12,149,5745,-56,-97,41,a6:92:ad:b7:76:65,313450167,284,2253,313449883,313450167
28280,5,12,149,5745,-66,-97,31,56:68:e2:c2:8d:d5,313467743,280,17296,313467463,313467743
28281,5,12,149,5745,-83,-97,14,9a:24:38:da:96:bb,313474178,272,6163,313473906,313474178
28282,5,24,149,5745,-80,-97,17,,313476557,28,2351,313476529,313476557
28283,5,24,149,5745,-76,-97,21,,313476601,28,16,313476573,313476601
28284,5,24,149,5745,-76,-97,21,,313476713,32,80,313476681,313476713
28285,5,24,149,5745,-76,-97,21,,313477863,28,1122,313477835,313477863
28286,5,24,149,5745,-80,-97,17,,313477907,28,16,313477879,313477907
28287,5,24,149,5745,-81,-97,16,,313478015,32,76,313477983,313478015
28288,5,24,149,5745,-76,-97,21,,313478099,28,56,313478071,313478099
28289,5,24,149,5745,-80,-97,17,,313478144,28,17,313478116,313478144
28290,5,24,149,5745,-80,-97,17,,313478255,32,79,313478223,313478255
28291,5,24,149,5745,-80,-97,17,,313482121,28,3838,313482093,313482121
28292,5,24,149,5745,-76,-97,21,,313482165,28,16,313482137,313482165
28293,5,24,149,5745,-76,-97,21,,313482285,32,88,313482253,313482285
28294,5,24,149,5745,-80,-97,17,,313483251,28,938,313483223,313483251
28295,5,24,149,5745,-76,-97,21,,313483295,28,16,313483267,313483295
28296,5,24,149,5745,-76,-97,21,,313483404,32,77,313483372,313483404
28297,5,12,149,5745,-55,-97,42,22:ec:75:a8:8a:31,313485819,244,2171,313485575,313485819
28298,5,24,149,5745,-76,-97,21,,313503494,28,17647,313503466,313503494
28299,5,24,149,5745,-81,-97,16,,313503538,28,16,313503510,313503538
28300,5,24,149,5745,-81,-97,16,,313503657,32,87,313503625,313503657
28301,5,24,149,5745,-81,-97,16,,313503777,32,88,313503745,313503777
28302,5,24,149,5745,-76,-97,21,,313504002,28,197,313503974,313504002
28303,5,24,149,5745,-81,-97,16,,313504046,28,16,313504018,313504046
28304,5,24,149,5745,-81,-97,16,,313504154,32,76,313504122,313504154
28305,5,24,149,5745,-82,-97,15,,313507917,28,3735,313507889,313507917
28306,5,24,149,5745,-81,-97,16,,313508120,28,175,313508092,313508120
28307,5,24,149,5745,-82,-97,15,,313508601,28,453,313508573,313508601
28308,5,24,149,5745,-76,-97,21,,313508645,28,16,313508617,313508645
28309,5,24,149,5745,-76,-97,21,,313508790,32,113,313508758,313508790
28310,5,24,149,5745,-76,-97,21,,313522419,28,13601,313522391,313522419
28311,5,24,149,5745,-82,-97,15,,313522464,28,17,313522436,313522464
28312,5,24,149,5745,-82,-97,15,,313522572,32,76,313522540,313522572
28313,5,24,149,5745,-82,-97,15,,313522859,28,259,313522831,313522859
28314,5,24,149,5745,-83,-97,14,,313523383,28,496,313523355,313523383
28315,5,24,149,5745,-82,-97,15,,313523582,28,171,313523554,313523582
28316,5,24,149,5745,-82,-97,15,,313525707,28,2097,313525679,313525707
28317,5,24,149,5745,-77,-97,20,,313525751,28,16,313525723,313525751
28318,5,24,149,5745,-77,-97,20,,313525859,32,76,313525827,313525859
28319,5,12,149,5745,-72,-97,25,6a:1e:a4:f8:14:49,313530303,248,4196,313530055,313530303
28320,5,24,149,5745,-77,-97,20,,313532052,32,1717,313532020,313532052
28321,5,24,149,5745,-77,-97,20,,313532312,28,232,313532284,313532312
28322,5,24,149,5745,-87,-97,10,,313532355,28,15,313532327,313532355
28323,5,6,149,5745,-87,-97,10,,313532473,68,50,313532405,313532473
28324,5,6,149,5745,-91,-97,6,54:e4:3a:ec:fb:65,313532972,360,139,313532612,313532972
28325,5,12,149,5745,-72,-97,25,f2:da:61:dd:98:c5,313533431,268,191,313533163,313533431
28326,5,24,149,5745,-77,-97,20,,313533820,32,357,313533788,313533820
28327,5,12,149,5745,-67,-97,30,5e:29:73:5b:30:00,313544167,272,10075,313543895,313544167
28328,5,12,149,5745,-57,-97,40,3e:d1:9b:c7:a4:de,313552318,272,7879,313552046,313552318
28329,5,12,149,5745,-54,-97,43,a6:92:ad:b7:76:65,313557076,284,4474,313556792,313557076
28330,5,12,149,5745,-70,-97,27,d2:00:04:7e:2c:ab,313559841,244,2521,313559597,313559841
28331,5,24,149,5745,-80,-97,17,,313584674,28,24805,313584646,313584674
28332,5,24,149,5745,-79,-97,18,,313584718,28,16,313584690,313584718
28333,5,24,149,5745,-78,-97,19,,313584838,32,88,313584806,313584838
28334,5,12,149,5745,-61,-97,36,56:68:e2:c2:8d:d5,313590041,280,4923,313589761,313590041
28335,5,24,149,5745,-79,-97,18,,313595441,28,5372,313595413,313595441
28336,5,24,149,5745,-80,-97,17,,313595485,28,16,313595457,313595485
28337,5,24,149,5745,-81,-97,16,,313595600,32,83,313595568,313595600
28338,5,24,149,5745,-78,-97,19,,313595711,28,83,313595683,313595711
28339,5,24,149,5745,-80,-97,17,,313595756,28,17,313595728,313595756
28340,5,24,149,5745,-81,-97,16,,313595863,32,75,313595831,313595863
28341,5,24,149,5745,-78,-97,19,,313595993,28,102,313595965,313595993
28342,5,24,149,5745,-80,-97,17,,313596037,28,16,313596009,313596037
28343,5,24,149,5745,-81,-97,16,,313596144,32,75,313596112,313596144
28344,5,24,149,5745,-78,-97,19,,313598517,28,2345,313598489,313598517
28345,5,24,149,5745,-80,-97,17,,313598561,28,16,313598533,313598561
28346,5,24,149,5745,-81,-97,16,,313598669,32,76,313598637,313598669
28347,5,24,149,5745,-80,-97,17,,313598835,28,138,313598807,313598835
28348,5,24,149,5745,-78,-97,19,,313598879,28,16,313598851,313598879
28349,5,24,149,5745,-78,-97,19,,313598995,32,84,313598963,313598995
28350,5,12,149,5745,-73,-97,24,f2:da:61:dd:98:c5,313599752,268,489,313599484,313599752
28351,5,12,149,5745,-55,-97,42,22:ec:75:a8:8a:31,313610906,244,10910,313610662,313610906
28352,5,12,149,5745,-55,-97,42,a6:92:ad:b7:76:65,313612489,284,1299,313612205,313612489
28353,5,12,149,5745,-74,-97,23,6a:1e:a4:f8:14:49,313613032,284,259,313612748,313613032
28354,5,12,149,5745,-59,-97,38,f6:0a:5c:59:72:df,313614070,280,758,313613790,313614070
28355,5,24,149,5745,-78,-97,19,,313616361,28,2263,313616333,313616361
28356,5,24,149,5745,-81,-97,16,,313616405,28,16,313616377,313616405
28357,5,24,149,5745,-81,-97,16,,313616513,32,76,313616481,313616513
28358,5,12,149,5745,-71,-97,26,d2:00:04:7e:2c:ab,313617749,440,796,313617309,313617749
28359,5,12,149,5745,-72,-97,25,f2:da:61:dd:98:c5,313618277,268,260,313618009,313618277
28360,5,12,149,5745,-56,-97,41,22:ec:75:a8:8a:31,313620568,516,1775,313620052,313620568
28361,5,12,149,5745,-60,-97,37,3e:d1:9b:c7:a4:de,313625141,544,4029,313624597,313625141
28362,5,12,149,5745,-68,-97,29,5e:29:73:5b:30:00,313628474,540,2793,313627934,313628474
28363,5,12,149,5745,-61,-97,36,56:68:e2:c2:8d:d5,313630582,476,1632,313630106,313630582
28364,5,12,149,5745,-55,-97,42,a6:92:ad:b7:76:65,313631218,484,152,313630734,313631218
28365,5,6,149,5745,-91,-97,6,54:e4:3a:ec:fb:65,313635372,360,3794,313635012,313635372
28366,5,12,149,5745,-72,-97,25,6a:1e:a4:f8:14:49,313638172,480,2320,313637692,313638172
28367,5,12,149,5745,-70,-97,27,d2:00:04:7e:2c:ab,313662713,244,24297,313662469,313662713
28368,5,12,149,5745,-67,-97,30,5e:29:73:5b:30:00,313663700,272,715,313663428,313663700
28369,5,12,149,5745,-61,-97,36,f6:0a:5c:59:72:df,313670795,280,6815,313670515,313670795
28370,5,12,149,5745,-63,-97,34,f6:0a:5c:59:72:df,313676961,280,5886,313676681,313676961
28371,5,12,149,5745,-73,-97,24,6a:1e:a4:f8:14:49,313677707,480,266,313677227,313677707
28372,5,12,149,5745,-61,-97,36,56:68:e2:c2:8d:d5,313678221,280,234,313677941,313678221
28373,5,12,149,5745,-61,-97,36,3e:d1:9b:c7:a4:de,313678536,272,43,313678264,313678536
28374,5,12,149,5745,-86,-97,11,7e:05:42:11:d2:ec,313678923,468,-81,313678455,313678923
28375,5,12,149,5745,-68,-97,29,d2:00:04:7e:2c:ab,313681207,440,1844,313680767,313681207
28376,5,12,149,5745,-58,-97,39,22:ec:75:a8:8a:31,313685435,516,3712,313684919,313685435
28377,5,12,149,5745,-61,-97,36,56:68:e2:c2:8d:d5,313688073,476,2162,313687597,313688073
28378,5,12,149,5745,-72,-97,25,96:a3:af:37:f7:5e,313688592,440,79,313688152,313688592
28379,5,12,149,5745,-67,-97,30,0a:b9:b7:b1:4d:fa,313689156,268,296,313688888,313689156
28380,5,12,149,5745,-63,-97,34,3e:d1:9b:c7:a4:de,313690431,544,731,313689887,313690431
28381,5,12,149,5745,-72,-97,25,96:a3:af:37:f7:5e,313692709,380,1898,313692329,313692709
28382,5,12,149,5745,-72,-97,25,96:a3:af:37:f7:5e,313693250,132,409,313693118,313693250
28383,5,12,149,5745,-56,-97,41,a6:92:ad:b7:76:65,313694108,484,374,313693624,313694108
28384,5,12,149,5745,-72,-97,25,f2:da:61:dd:98:c5,313695976,268,1600,313695708,313695976
28385,5,12,149,5745,-69,-97,28,5e:29:73:5b:30:00,313704216,540,7700,313703676,313704216
28386,5,12,149,5745,-74,-97,23,6a:1e:a4:f8:14:49,313711389,284,6889,313711105,313711389
28387,5,12,149,5745,-85,-97,12,9a:24:38:da:96:bb,313718180,272,6519,313717908,313718180
28388,5,12,149,5745,-60,-97,37,22:ec:75:a8:8a:31,313725897,244,7473,313725653,313725897
28389,5,12,149,5745,-56,-97,41,a6:92:ad:b7:76:65,313727903,284,1722,313727619,313727903
28390,5,24,149,5745,-80,-97,17,,313728240,28,309,313728212,313728240
28391,5,24,149,5745,-80,-97,17,,313728284,28,16,313728256,313728284
28392,5,24,149,5745,-81,-97,16,,313728392,32,76,313728360,313728392
28393,5,6,149,5745,-92,-97,5,54:e4:3a:ec:fb:65,313737773,360,9021,313737413,313737773
28394,5,24,149,5745,-81,-97,16,,313746394,28,8593,313746366,313746394
28395,5,24,149,5745,-80,-97,17,,313746438,28,16,313746410,313746438
28396,5,24,149,5745,-80,-97,17,,313746546,32,76,313746514,313746546
28397,5,12,149,5745,-68,-97,29,d2:00:04:7e:2c:ab,313746756,440,-230,313746316,313746756
28398,5,12,149,5745,-60,-97,37,22:ec:75:a8:8a:31,313761441,516,14169,313760925,313761441
28399,5,12,149,5745,-70,-97,27,5e:29:73:5b:30:00,313768838,540,6857,313768298,313768838
28400,5,24,149,5745,-81,-97,16,,313774064,28,5198,313774036,313774064
28401,5,24,149,5745,-62,-97,35,,313776062,28,1970,313776034,313776062
28402,5,24,149,5745,-82,-97,15,,313776106,28,16,313776078,313776106
28403,5,24,149,5745,-82,-97,15,,313776214,28,80,313776186,313776214
28404,5,12,149,5745,-69,-97,28,d2:00:04:7e:2c:ab,313776330,244,-128,313776086,313776330
28405,5,12,149,5745,-70,-97,27,5e:29:73:5b:30:00,313777570,272,968,313777298,313777570
28406,5,12,149,5745,-57,-97,40,3e:d1:9b:c7:a4:de,313782194,272,4352,313781922,313782194
28407,5,24,149,5745,-82,-97,15,,313791648,32,9422,313791616,313791648
28408,5,24,149,5745,-82,-97,15,,313792093,32,413,313792061,313792093
28409,5,24,149,5745,-82,-97,15,,313792539,28,418,313792511,313792539
28410,5,12,149,5745,-68,-97,29,f2:da:61:dd:98:c5,313822631,268,29824,313822363,313822631
28411,5,12,149,5745,-65,-97,32,22:ec:75:a8:8a:31,313826992,516,3845,313826476,313826992
28412,5,12,149,5745,-87,-97,10,9a:24:38:da:96:bb,313831020,272,3756,313830748,313831020
28413,5,12,149,5745,-69,-97,28,5e:29:73:5b:30:00,313834840,540,3280,313834300,313834840
28414,5,12,149,5745,-71,-97,26,6a:1e:a4:f8:14:49,313838023,284,2899,313837739,313838023
28415,5,12,149,5745,-64,-97,33,22:ec:75:a8:8a:31,313840223,244,1956,313839979,313840223
28416,5,24,149,5745,-78,-97,19,,313853525,28,13274,313853497,313853525
28417,5,24,149,5745,-80,-97,17,,313853569,28,16,313853541,313853569
28418,5,24,149,5745,-81,-97,16,,313853678,32,77,313853646,313853678
28419,5,12,149,5745,-58,-97,39,a6:92:ad:b7:76:65,313863276,284,9314,313862992,313863276
28420,5,12,149,5745,-62,-97,35,56:68:e2:c2:8d:d5,313866827,280,3271,313866547,313866827
28421,5,24,149,5745,-80,-97,17,,313871659,28,4804,313871631,313871659
28422,5,24,149,5745,-80,-97,17,,313871703,28,16,313871675,313871703
28423,5,24,149,5745,-79,-97,18,,313871811,32,76,313871779,313871811
28424,5,12,149,5745,-86,-97,11,7e:05:42:11:d2:ec,313878627,468,6348,313878159,313878627
28425,5,12,149,5745,-60,-97,37,3e:d1:9b:c7:a4:de,313899169,272,20270,313898897,313899169
28426,5,12,149,5745,-68,-97,29,5e:29:73:5b:30:00,313900366,540,657,313899826,313900366
28427,5,24,149,5745,-81,-97,16,,313935345,28,34951,313935317,313935345
28428,5,24,149,5745,-73,-97,24,,313935392,28,19,313935364,313935392
28429,5,24,149,5745,-73,-97,24,,313935505,32,81,313935473,313935505
28430,5,12,149,5745,-58,-97,39,22:ec:75:a8:8a:31,313939583,244,3834,313939339,313939583
28431,5,6,149,5745,-90,-97,7,54:e4:3a:ec:fb:65,313942574,360,2631,313942214,313942574
28432,5,12,149,5745,-74,-97,23,f2:da:61:dd:98:c5,313943121,268,279,313942853,313943121
28433,5,12,149,5745,-84,-97,13,9a:24:38:da:96:bb,313945884,272,2491,313945612,313945884
28434,5,12,149,5745,-72,-97,25,6a:1e:a4:f8:14:49,313950100,284,3932,313949816,313950100
28435,5,12,149,5745,-59,-97,38,a6:92:ad:b7:76:65,313965617,284,15233,313965333,313965617
28436,5,12,149,5745,-70,-97,27,d2:00:04:7e:2c:ab,313966823,244,962,313966579,313966823
28437,5,12,149,5745,-65,-97,32,56:68:e2:c2:8d:d5,313967630,280,527,313967350,313967630
28438,5,12,149,5745,-68,-97,29,5e:29:73:5b:30:00,313998270,272,30368,313997998,313998270
28439,5,12,149,5745,-69,-97,28,d2:00:04:7e:2c:ab,314012002,244,13488,314011758,314012002
28440,5,12,149,5745,-58,-97,39,3e:d1:9b:c7:a4:de,314012580,272,306,314012308,314012580
28441,5,24,149,5745,-82,-97,15,,314015438,32,2826,314015406,314015438
28442,5,12,149,5745,-58,-97,39,f6:0a:5c:59:72:df,314024420,280,8702,314024140,314024420
28443,5,12,149,5745,-64,-97,33,56:68:e2:c2:8d:d5,314029150,280,4450,314028870,314029150
28444,5,24,149,5745,-82,-97,15,,314031907,32,2725,314031875,314031907
28445,5,24,149,5745,-82,-97,15,,314032388,32,449,314032356,314032388
28446,5,24,149,5745,-82,-97,15,,314032870,28,454,314032842,314032870
28447,5,24,149,5745,-77,-97,20,,314032916,28,18,314032888,314032916
28448,5,24,149,5745,-77,-97,20,,314033025,32,77,314032993,314033025
28449,5,6,149,5745,-90,-97,7,54:e4:3a:ec:fb:65,314044974,360,11589,314044614,314044974
28450,5,12,149,5745,-72,-97,25,f2:da:61:dd:98:c5,314045795,268,553,314045527,314045795
28451,5,12,149,5745,-86,-97,11,9a:24:38:da:96:bb,314053874,272,7807,314053602,314053874
28452,5,12,149,5745,-71,-97,26,6a:1e:a4:f8:14:49,314058619,284,4461,314058335,314058619
28453,5,12,149,5745,-60,-97,37,22:ec:75:a8:8a:31,314069623,244,10760,314069379,314069623
28454,5,12,149,5745,-60,-97,37,f6:0a:5c:59:72:df,314070018,280,115,314069738,314070018
28455,5,12,149,5745,-71,-97,26,6a:1e:a4:f8:14:49,314073734,480,3236,314073254,314073734
28456,5,12,149,5745,-69,-97,28,d2:00:04:7e:2c:ab,314075643,440,1469,314075203,314075643
28457,5,12,149,5745,-62,-97,35,56:68:e2:c2:8d:d5,314083010,476,6891,314082534,314083010
28458,5,12,149,5745,-58,-97,39,3e:d1:9b:c7:a4:de,314083556,544,2,314083012,314083556
28459,5,12,149,5745,-75,-97,22,f2:da:61:dd:98:c5,314087511,268,3687,314087243,314087511
28460,5,12,149,5745,-60,-97,37,22:ec:75:a8:8a:31,314089988,516,1961,314089472,314089988
28461,5,12,149,5745,-70,-97,27,5e:29:73:5b:30:00,314099711,540,9183,314099171,314099711
28462,5,12,149,5745,-70,-97,27,d2:00:04:7e:2c:ab,314121687,244,21732,314121443,314121687
28463,5,12,149,5745,-59,-97,38,3e:d1:9b:c7:a4:de,314126423,272,4464,314126151,314126423
28464,5,12,149,5745,-69,-97,28,d2:00:04:7e:2c:ab,314140010,440,13147,314139570,314140010
28465,5,12,149,5745,-60,-97,37,f6:0a:5c:59:72:df,314140629,280,339,314140349,314140629
28466,5,12,149,5745,-76,-97,21,f2:da:61:dd:98:c5,314147835,268,6938,314147567,314147835
28467,5,12,149,5745,-63,-97,34,56:68:e2:c2:8d:d5,314149397,280,1282,314149117,314149397
28468,5,12,149,5745,-59,-97,38,22:ec:75:a8:8a:31,314154598,516,4685,314154082,314154598
28469,5,12,149,5745,-76,-97,21,f2:da:61:dd:98:c5,314155148,268,282,314154880,314155148
28470,5,12,149,5745,-68,-97,29,5e:29:73:5b:30:00,314162578,540,6890,314162038,314162578
28471,5,12,149,5745,-84,-97,13,9a:24:38:da:96:bb,314170354,272,7504,314170082,314170354
28472,5,12,149,5745,-58,-97,39,22:ec:75:a8:8a:31,314184612,244,14014,314184368,314184612
28473,5,24,149,5745,-80,-97,17,,314187177,32,2533,314187145,314187177
28474,5,24,149,5745,-81,-97,16,,314188368,28,1163,314188340,314188368
28475,5,24,149,5745,-75,-97,22,,314188414,28,18,314188386,314188414
28476,5,24,149,5745,-75,-97,22,,314188531,32,85,314188499,314188531
28477,5,24,149,5745,-81,-97,16,,314192468,32,3905,314192436,314192468
28478,5,12,149,5745,-69,-97,28,d2:00:04:7e:2c:ab,314204874,440,11966,314204434,314204874
28479,5,24,149,5745,-80,-97,17,,314206320,28,1418,314206292,314206320
28480,5,24,149,5745,-75,-97,22,,314206367,28,19,314206339,314206367
28481,5,24,149,5745,-75,-97,22,,314206476,32,77,314206444,314206476
28482,5,12,149,5745,-87,-97,10,7e:05:42:11:d2:ec,314206587,468,-357,314206119,314206587
28483,5,24,149,5745,-81,-97,16,,314209094,32,2475,314209062,314209094
28484,5,12,149,5745,-71,-97,26,96:a3:af:37:f7:5e,314212274,440,2740,314211834,314212274
28485,5,12,149,5745,-77,-97,20,f2:da:61:dd:98:c5,314213396,268,854,314213128,314213396
28486,5,12,149,5745,-58,-97,39,3e:d1:9b:c7:a4:de,314217370,544,3430,314216826,314217370
28487,5,12,149,5745,-67,-97,30,0a:b9:b7:b1:4d:fa,314219469,268,1831,314219201,314219469
28488,5,12,149,5745,-58,-97,39,22:ec:75:a8:8a:31,314219816,516,-169,314219300,314219816
28489,5,12,149,5745,-59,-97,38,a6:92:ad:b7:76:65,314220713,484,413,314220229,314220713
28490,5,12,149,5745,-69,-97,28,5e:29:73:5b:30:00,314222248,540,995,314221708,314222248
28491,5,24,149,5745,-75,-97,22,,314225989,28,3713,314225961,314225989
28492,5,24,149,5745,-75,-97,22,,314226253,28,236,314226225,314226253
28493,5,24,149,5745,-75,-97,22,,314226740,28,459,314226712,314226740
28494,5,24,149,5745,-80,-97,17,,314226784,28,16,314226756,314226784
28495,5,24,149,5745,-81,-97,16,,314226906,32,90,314226874,314226906
28496,5,12,149,5745,-68,-97,29,d2:00:04:7e:2c:ab,314235024,244,7874,314234780,314235024
28497,5,12,149,5745,-69,-97,28,5e:29:73:5b:30:00,314236292,272,996,314236020,314236292
28498,5,24,149,5745,-80,-97,17,,314240725,28,4405,314240697,314240725
28499,5,24,149,5745,-75,-97,22,,314240771,28,18,314240743,314240771
28500,5,24,149,5745,-75,-97,22,,314240881,32,78,314240849,314240881
28501,5,24,149,5745,-80,-97,17,,314241860,28,951,314241832,314241860
28502,5,24,149,5745,-75,-97,22,,314241906,28,18,314241878,314241906
28503,5,24,149,5745,-75,-97,22,,314242019,32,81,314241987,314242019
28504,5,24,149,5745,-80,-97,17,,314242636,32,585,314242604,314242636
28505,5,24,149,5745,-80,-97,17,,314245568,32,2900,314245536,314245568
28506,5,12,149,5745,-71,-97,26,6a:1e:a4:f8:14:49,314247018,284,1166,314246734,314247018
28507,5,12,149,5745,-57,-97,40,3e:d1:9b:c7:a4:de,314252260,272,4970,314251988,314252260
28508,5,24,149,5745,-80,-97,17,,314262402,28,10114,314262374,314262402
28509,5,24,149,5745,-74,-97,23,,314262448,28,18,314262420,314262448
28510,5,24,149,5745,-74,-97,23,,314262561,32,81,314262529,314262561
28511,5,24,149,5745,-80,-97,17,,314263589,32,996,314263557,314263589
28512,5,12,149,5745,-68,-97,29,d2:00:04:7e:2c:ab,314270999,440,6970,314270559,314270999
28513,5,12,149,5745,-61,-97,36,56:68:e2:c2:8d:d5,314276530,280,5251,314276250,314276530
28514,5,12,149,5745,-87,-97,10,9a:24:38:da:96:bb,314278997,272,2195,314278725,314278997
28515,5,12,149,5745,-74,-97,23,f2:da:61:dd:98:c5,314280963,268,1698,314280695,314280963
28516,5,12,149,5745,-60,-97,37,22:ec:75:a8:8a:31,314285711,516,4232,314285195,314285711
28517,5,12,149,5745,-70,-97,27,5e:29:73:5b:30:00,314287109,540,858,314286569,314287109
28518,5,24,149,5745,-80,-97,17,,314298817,28,11680,314298789,314298817
28519,5,24,149,5745,-74,-97,23,,314298864,28,19,314298836,314298864
28520,5,24,149,5745,-74,-97,23,,314298992,32,96,314298960,314298992
28521,5,12,149,5745,-59,-97,38,22:ec:75:a8:8a:31,314299058,244,-178,314298814,314299058
28522,5,24,149,5745,-79,-97,18,,314301359,32,2269,314301327,314301359
28523,5,12,149,5745,-93,-97,4,46:28:71:6e:d2:2e,314347856,280,46217,314347576,314347856
28524,5,12,149,5745,-72,-97,25,6a:1e:a4:f8:14:49,314349385,284,1245,314349101,314349385
28525,5,12,149,5745,-70,-97,27,d2:00:04:7e:2c:ab,314349746,244,117,314349502,314349746
28526,5,12,149,5745,-61,-97,36,22:ec:75:a8:8a:31,314350933,516,671,314350417,314350933
28527,5,12,149,5745,-70,-97,27,5e:29:73:5b:30:00,314351501,272,296,314351229,314351501
28528,5,6,149,5745,-91,-97,6,54:e4:3a:ec:fb:65,314352176,360,315,314351816,314352176
28529,5,12,149,5745,-70,-97,27,5e:29:73:5b:30:00,314353140,540,424,314352600,314353140
28530,5,12,149,5745,-57,-97,40,3e:d1:9b:c7:a4:de,314355984,272,2572,314355712,314355984
28531,5,12,149,5745,-61,-97,36,56:68:e2:c2:8d:d5,314377062,280,20798,314376782,314377062
28532,5,12,149,5745,-84,-97,13,9a:24:38:da:96:bb,314394252,272,16918,314393980,314394252
28533,5,12,149,5745,-62,-97,35,22:ec:75:a8:8a:31,314397265,244,2769,314397021,314397265
28534,5,12,149,5745,-86,-97,11,7e:05:42:11:d2:ec,314404624,468,6891,314404156,314404624
28535,5,12,149,5745,-62,-97,35,22:ec:75:a8:8a:31,314416763,516,11623,314416247,314416763
28536,5,12,149,5745,-70,-97,27,5e:29:73:5b:30:00,314418610,540,1307,314418070,314418610
28537,5,12,149,5745,-70,-97,27,5e:29:73:5b:30:00,314450158,272,31276,314449886,314450158
28538,5,12,149,5745,-73,-97,24,6a:1e:a4:f8:14:49,314451787,284,1345,314451503,314451787
28539,5,6,149,5745,-91,-97,6,54:e4:3a:ec:fb:65,314454576,360,2429,314454216,314454576
28540,5,12,149,5745,-77,-97,20,f2:da:61:dd:98:c5,314455422,268,578,314455154,314455422
28541,5,12,149,5745,-58,-97,39,3e:d1:9b:c7:a4:de,314471690,272,15996,314471418,314471690
28542,5,12,149,5745,-71,-97,26,d2:00:04:7e:2c:ab,314478624,244,6690,314478380,314478624
28543,5,12,149,5745,-61,-97,36,56:68:e2:c2:8d:d5,314481312,280,2408,314481032,314481312
28544,5,12,149,5745,-61,-97,36,f6:0a:5c:59:72:df,314494991,280,13399,314494711,314494991
28545,5,12,149,5745,-84,-97,13,9a:24:38:da:96:bb,314502403,272,7140,314502131,314502403
28546,5,12,149,5745,-62,-97,35,22:ec:75:a8:8a:31,314508270,244,5623,314508026,314508270
28547,5,12,149,5745,-73,-97,24,6a:1e:a4:f8:14:49,314552611,284,44057,314552327,314552611
28548,5,6,149,5745,-92,-97,5,54:e4:3a:ec:fb:65,314556977,360,4006,314556617,314556977
28549,5,12,149,5745,-74,-97,23,f2:da:61:dd:98:c5,314558064,268,819,314557796,314558064
28550,5,24,149,5745,-80,-97,17,,314559639,28,1547,314559611,314559639
28551,5,24,149,5745,-79,-97,18,,314559683,28,16,314559655,314559683
28552,5,24,149,5745,-80,-97,17,,314559791,32,76,314559759,314559791
28553,5,24,149,5745,-80,-97,17,,314559906,32,83,314559874,314559906
28554,5,12,149,5745,-69,-97,28,5e:29:73:5b:30:00,314563400,272,3222,314563128,314563400
28555,5,24,149,5745,-79,-97,18,,314577328,28,13900,314577300,314577328
28556,5,24,149,5745,-79,-97,18,,314577372,28,16,314577344,314577372
28557,5,24,149,5745,-79,-97,18,,314577481,32,77,314577449,314577481
28558,5,12,149,5745,-72,-97,25,d2:00:04:7e:2c:ab,314581122,244,3397,314580878,314581122
28559,5,12,149,5745,-56,-97,41,3e:d1:9b:c7:a4:de,314583788,272,2394,314583516,314583788
28560,5,24,149,5745,-79,-97,18,,314587422,28,3606,314587394,314587422
28561,5,24,149,5745,-79,-97,18,,314587466,28,16,314587438,314587466
28562,5,24,149,5745,-79,-97,18,,314587574,32,76,314587542,314587574
28563,5,24,149,5745,-79,-97,18,,314590471,28,2869,314590443,314590471
28564,5,24,149,5745,-79,-97,18,,314590515,28,16,314590487,314590515
28565,5,24,149,5745,-79,-97,18,,314590624,32,77,314590592,314590624
28566,5,12,149,5745,-62,-97,35,56:68:e2:c2:8d:d5,314598045,280,7141,314597765,314598045
28567,5,12,149,5745,-73,-97,24,f2:da:61:dd:98:c5,314612699,268,14386,314612431,314612699
28568,5,12,149,5745,-62,-97,35,22:ec:75:a8:8a:31,314620067,244,7124,314619823,314620067
28569,5,12,149,5745,-71,-97,26,6a:1e:a4:f8:14:49,314624272,284,3921,314623988,314624272
28570,5,24,149,5745,-79,-97,18,,314634653,32,10349,314634621,314634653
28571,5,24,149,5745,-79,-97,18,,314635117,32,432,314635085,314635117
28572,5,24,149,5745,-79,-97,18,,314635580,28,435,314635552,314635580
28573,5,24,149,5745,-79,-97,18,,314635626,28,18,314635598,314635626
28574,5,24,149,5745,-80,-97,17,,314635740,32,82,314635708,314635740
28575,5,12,149,5745,-71,-97,26,6a:1e:a4:f8:14:49,314661169,480,24949,314660689,314661169
28576,5,12,149,5745,-59,-97,38,f6:0a:5c:59:72:df,314661773,280,324,314661493,314661773
28577,5,12,149,5745,-71,-97,26,d2:00:04:7e:2c:ab,314665392,440,3179,314664952,314665392
28578,5,24,149,5745,-79,-97,18,,314671440,32,6016,314671408,314671440
28579,5,24,149,5745,-79,-97,18,,314672246,32,774,314672214,314672246
28580,5,24,149,5745,-79,-97,18,,314672364,32,86,314672332,314672364
28581,5,12,149,5745,-57,-97,40,3e:d1:9b:c7:a4:de,314673772,544,864,314673228,314673772
28582,5,12,149,5745,-73,-97,24,f2:da:61:dd:98:c5,314674369,268,329,314674101,314674369
28583,5,12,149,5745,-65,-97,32,56:68:e2:c2:8d:d5,314674750,476,-95,314674274,314674750
28584,5,24,149,5745,-79,-97,18,,314675296,32,514,314675264,314675296
28585,5,24,149,5745,-78,-97,19,,314675696,28,372,314675668,314675696
28586,5,24,149,5745,-80,-97,17,,314675742,28,18,314675714,314675742
28587,5,24,149,5745,-81,-97,16,,314675852,32,78,314675820,314675852
28588,5,12,149,5745,-71,-97,26,d2:00:04:7e:2c:ab,314677368,244,1272,314677124,314677368
28589,5,24,149,5745,-78,-97,19,,314677727,28,331,314677699,314677727
28590,5,24,149,5745,-79,-97,18,,314677771,28,16,314677743,314677771
28591,5,24,149,5745,-79,-97,18,,314677879,32,76,314677847,314677879
28592,5,24,149,5745,-79,-97,18,,314677945,28,38,314677917,314677945
28593,5,24,149,5745,-79,-97,18,,314677990,28,17,314677962,314677990
28594,5,24,149,5745,-79,-97,18,,314678098,32,76,314678066,314678098
28595,5,12,149,5745,-63,-97,34,22:ec:75:a8:8a:31,314679281,516,667,314678765,314679281
28596,5,12,149,5745,-72,-97,25,5e:29:73:5b:30:00,314681253,540,1432,314680713,314681253
28597,5,12,149,5745,-64,-97,33,56:68:e2:c2:8d:d5,314693572,280,12039,314693292,314693572
28598,5,12,149,5745,-59,-97,38,f6:0a:5c:59:72:df,314694168,280,316,314693888,314694168
28599,5,12,149,5745,-73,-97,24,5e:29:73:5b:30:00,314695103,272,663,314694831,314695103
28600,5,24,149,5745,-79,-97,18,,314695598,28,467,314695570,314695598
28601,5,24,149,5745,-78,-97,19,,314695643,28,17,314695615,314695643
28602,5,24,149,5745,-79,-97,18,,314695751,32,76,314695719,314695751
28603,5,24,149,5745,-79,-97,18,,314704732,32,8949,314704700,314704732
28604,5,24,149,5745,-79,-97,18,,314709156,32,4392,314709124,314709156
28605,5,24,149,5745,-79,-97,18,,314709655,32,467,314709623,314709655
28606,5,24,149,5745,-79,-97,18,,314710154,28,471,314710126,314710154
28607,5,24,149,5745,-80,-97,17,,314710200,28,18,314710172,314710200
28608,5,24,149,5745,-80,-97,17,,314710310,32,78,314710278,314710310
28609,5,12,149,5745,-57,-97,40,3e:d1:9b:c7:a4:de,314710493,272,-89,314710221,314710493
28610,5,12,149,5745,-75,-97,22,f2:da:61:dd:98:c5,314712403,268,1642,314712135,314712403
28611,5,24,149,5745,-80,-97,17,,314714389,32,1954,314714357,314714389
28612,5,24,149,5745,-80,-97,17,,314715639,28,1222,314715611,314715639
28613,5,24,149,5745,-79,-97,18,,314715683,28,16,314715655,314715683
28614,5,24,149,5745,-79,-97,18,,314715805,32,90,314715773,314715805
28615,5,24,149,5745,-80,-97,17,,314715923,32,86,314715891,314715923
28616,5,12,149,5745,-75,-97,22,6a:1e:a4:f8:14:49,314726339,480,9936,314725859,314726339
28617,5,12,149,5745,-60,-97,37,f6:0a:5c:59:72:df,314726898,280,279,314726618,314726898
28618,5,24,149,5745,-79,-97,18,,314729082,28,2156,314729054,314729082
28619,5,24,149,5745,-80,-97,17,,314729128,28,18,314729100,314729128
28620,5,24,149,5745,-79,-97,18,,314729238,32,78,314729206,314729238
28621,5,24,149,5745,-79,-97,18,,314729439,28,173,314729411,314729439
28622,5,24,149,5745,-80,-97,17,,314729485,28,18,314729457,314729485
28623,5,24,149,5745,-80,-97,17,,314729599,32,82,314729567,314729599
28624,5,12,149,5745,-70,-97,27,d2:00:04:7e:2c:ab,314729800,440,-239,314729360,314729800
28625,5,24,149,5745,-79,-97,18,,314730382,28,554,314730354,314730382
28626,5,24,149,5745,-80,-97,17,,314730428,28,18,314730400,314730428
28627,5,24,149,5745,-80,-97,17,,314730538,32,78,314730506,314730538
28628,5,12,149,5745,-89,-97,8,7e:05:42:11:d2:ec,314732352,468,1346,314731884,314732352
28629,5,12,149,5745,-72,-97,25,96:a3:af:37:f7:5e,314736697,440,3905,314736257,314736697
28630,5,12,149,5745,-66,-97,31,56:68:e2:c2:8d:d5,314737144,476,-29,314736668,314737144
28631,5,12,149,5745,-63,-97,34,22:ec:75:a8:8a:31,314737672,516,12,314737156,314737672
28632,5,12,149,5745,-76,-97,21,f2:da:61:dd:98:c5,314738258,268,318,314737990,314738258
28633,5,12,149,5745,-57,-97,40,3e:d1:9b:c7:a4:de,314739298,544,496,314738754,314739298
28634,5,12,149,5745,-64,-97,33,22:ec:75:a8:8a:31,314741387,244,1845,314741143,314741387
28635,5,12,149,5745,-72,-97,25,5e:29:73:5b:30:00,314742334,540,407,314741794,314742334
28636,5,12,149,5745,-70,-97,27,0a:b9:b7:b1:4d:fa,314742953,268,351,314742685,314742953
28637,5,12,149,5745,-70,-97,27,d2:00:04:7e:2c:ab,314744311,380,978,314743931,314744311
28638,5,12,149,5745,-60,-97,37,a6:92:ad:b7:76:65,314744725,484,-70,314744241,314744725
28639,5,6,149,5745,-92,-97,5,54:e4:3a:ec:fb:65,314761778,360,16693,314761418,314761778
28640,5,12,149,5745,-73,-97,24,5e:29:73:5b:30:00,314789631,272,27581,314789359,314789631
28641,5,12,149,5745,-70,-97,27,d2:00:04:7e:2c:ab,314792802,244,2927,314792558,314792802
28642,5,12,149,5745,-70,-97,27,d2:00:04:7e:2c:ab,314795359,440,2117,314794919,314795359
28643,5,24,149,5745,-79,-97,18,,314805367,32,9976,314805335,314805367
28644,5,24,149,5745,-79,-97,18,,314806601,32,1202,314806569,314806601
28645,5,24,149,5745,-79,-97,18,,314807073,32,440,314807041,314807073
28646,5,24,149,5745,-79,-97,18,,314807546,28,445,314807518,314807546
28647,5,24,149,5745,-80,-97,17,,314807592,28,18,314807564,314807592
28648,5,24,149,5745,-81,-97,16,,314807709,32,85,314807677,314807709
28649,5,24,149,5745,-78,-97,19,,314811347,32,3606,314811315,314811347
28650,5,12,149,5745,-59,-97,38,3e:d1:9b:c7:a4:de,314813501,272,1882,314813229,314813501
28651,5,12,149,5745,-63,-97,34,56:68:e2:c2:8d:d5,314815913,280,2132,314815633,314815913
28652,5,24,149,5745,-79,-97,18,,314827190,28,11249,314827162,314827190
28653,5,24,149,5745,-79,-97,18,,314827236,28,18,314827208,314827236
28654,5,24,149,5745,-80,-97,17,,314827371,32,103,314827339,314827371
28655,5,24,149,5745,-78,-97,19,,314827590,28,191,314827562,314827590
28656,5,24,149,5745,-80,-97,17,,314827636,28,18,314827608,314827636
28657,5,24,149,5745,-80,-97,17,,314827750,32,82,314827718,314827750
28658,5,24,149,5745,-78,-97,19,,314827921,28,143,314827893,314827921
28659,5,24,149,5745,-80,-97,17,,314827968,28,19,314827940,314827968
28660,5,24,149,5745,-80,-97,17,,314828077,32,77,314828045,314828077
28661,5,12,149,5745,-75,-97,22,f2:da:61:dd:98:c5,314837509,268,9164,314837241,314837509
28662,5,24,149,5745,-79,-97,18,,314840113,28,2576,314840085,314840113
28663,5,24,149,5745,-78,-97,19,,314840157,28,16,314840129,314840157
28664,5,24,149,5745,-79,-97,18,,314840287,32,98,314840255,314840287
28665,5,24,149,5745,-78,-97,19,,314840405,32,86,314840373,314840405
28666,5,24,149,5745,-78,-97,19,,314840523,32,86,314840491,314840523
28667,5,12,149,5745,-63,-97,34,22:ec:75:a8:8a:31,314846659,244,5892,314846415,314846659
28668,5,12,149,5745,-72,-97,25,6a:1e:a4:f8:14:49,314848620,284,1677,314848336,314848620
28669,5,24,149,5745,-78,-97,19,,314854615,32,5963,314854583,314854615
28670,5,24,149,5745,-78,-97,19,,314855078,32,431,314855046,314855078
28671,5,24,149,5745,-78,-97,19,,314855542,28,436,314855514,314855542
28672,5,24,149,5745,-79,-97,18,,314855588,28,18,314855560,314855588
28673,5,24,149,5745,-78,-97,19,,314855697,32,77,314855665,314855697
28674,5,24,149,5745,-78,-97,19,,314855896,28,171,314855868,314855896
28675,5,24,149,5745,-79,-97,18,,314855942,28,18,314855914,314855942
28676,5,24,149,5745,-79,-97,18,,314856055,32,81,314856023,314856055
28677,5,24,149,5745,-77,-97,20,,314856221,28,138,314856193,314856221
28678,5,24,149,5745,-79,-97,18,,314856267,28,18,314856239,314856267
28679,5,24,149,5745,-79,-97,18,,314856377,32,78,314856345,314856377
28680,5,24,149,5745,-78,-97,19,,314856543,28,138,314856515,314856543
28681,5,24,149,5745,-78,-97,19,,314856589,28,18,314856561,314856589
28682,5,24,149,5745,-79,-97,18,,314856706,32,85,314856674,314856706
28683,5,24,149,5745,-78,-97,19,,314859791,32,3053,314859759,314859791
28684,5,24,149,5745,-77,-97,20,,314874938,28,15119,314874910,314874938
28685,5,24,149,5745,-79,-97,18,,314874984,28,18,314874956,314874984
28686,5,24,149,5745,-78,-97,19,,314875105,32,89,314875073,314875105
28687,5,24,149,5745,-77,-97,20,,314880836,32,5699,314880804,314880836
28688,5,12,149,5745,-69,-97,28,5e:29:73:5b:30:00,314905256,272,24148,314904984,314905256
28689,5,24,149,5745,-77,-97,20,,314915317,32,10029,314915285,314915317
28690,5,24,149,5745,-76,-97,21,,314915717,32,368,314915685,314915717
28691,5,24,149,5745,-77,-97,20,,314916117,28,372,314916089,314916117
28692,5,24,149,5745,-78,-97,19,,314916164,28,19,314916136,314916164
28693,5,24,149,5745,-78,-97,19,,314916273,32,77,314916241,314916273
28694,5,24,149,5745,-65,-97,32,,314928136,28,11835,314928108,314928136
28695,5,24,149,5745,-77,-97,20,,314928180,28,16,314928152,314928180
28696,5,24,149,5745,-77,-97,20,,314928288,28,80,314928260,314928288
28697,5,24,149,5745,-65,-97,32,,314928747,28,431,314928719,314928747
28698,5,24,149,5745,-77,-97,20,,314928791,28,16,314928763,314928791
28699,5,24,149,5745,-77,-97,20,,314928900,28,81,314928872,314928900
28700,5,24,149,5745,-65,-97,32,,314929027,28,99,314928999,314929027
28701,5,24,149,5745,-77,-97,20,,314929071,28,16,314929043,314929071
28702,5,24,149,5745,-77,-97,20,,314929203,32,100,314929171,314929203
28703,5,12,149,5745,-58,-97,39,3e:d1:9b:c7:a4:de,314929324,272,-151,314929052,314929324
28704,5,24,149,5745,-64,-97,33,,314929704,28,352,314929676,314929704
28705,5,24,149,5745,-76,-97,21,,314929748,28,16,314929720,314929748
28706,5,24,149,5745,-77,-97,20,,314929864,32,84,314929832,314929864
28707,5,24,149,5745,-64,-97,33,,314930007,28,115,314929979,314930007
28708,5,24,149,5745,-77,-97,20,,314930051,28,16,314930023,314930051
28709,5,24,149,5745,-77,-97,20,,314930159,28,80,314930131,314930159
28710,5,24,149,5745,-77,-97,20,,314930344,32,153,314930312,314930344
28711,5,24,149,5745,-77,-97,20,,314930852,32,476,314930820,314930852
28712,5,24,149,5745,-77,-97,20,,314931360,28,480,314931332,314931360
28713,5,24,149,5745,-76,-97,21,,314931747,28,359,314931719,314931747
28714,5,24,149,5745,-63,-97,34,,314931791,28,16,314931763,314931791
28715,5,24,149,5745,-77,-97,20,,314932010,28,191,314931982,314932010
28716,5,24,149,5745,-63,-97,34,,314932054,28,16,314932026,314932054
28717,5,24,149,5745,-77,-97,20,,314932347,28,265,314932319,314932347
28718,5,24,149,5745,-77,-97,20,,314932550,28,175,314932522,314932550
28719,5,24,149,5745,-77,-97,20,,314932753,28,175,314932725,314932753
28720,5,24,149,5745,-64,-97,33,,314933338,28,557,314933310,314933338
28721,5,24,149,5745,-77,-97,20,,314933382,28,16,314933354,314933382
28722,5,24,149,5745,-77,-97,20,,314933490,28,80,314933462,314933490
28723,5,24,149,5745,-64,-97,33,,314933645,28,127,314933617,314933645
28724,5,24,149,5745,-77,-97,20,,314933689,28,16,314933661,314933689
28725,5,24,149,5745,-77,-97,20,,314933797,28,80,314933769,314933797
28726,5,12,149,5745,-83,-97,14,7e:05:42:11:d2:ec,314937918,468,3653,314937450,314937918
28727,5,12,149,5745,-59,-97,38,f6:0a:5c:59:72:df,314938737,280,539,314938457,314938737
28728,5,24,149,5745,-77,-97,20,,314942536,28,3771,314942508,314942536
28729,5,24,149,5745,-77,-97,20,,314942765,28,201,314942737,314942765
28730,5,24,149,5745,-77,-97,20,,314943066,28,273,314943038,314943066
28731,5,24,149,5745,-77,-97,20,,314943318,28,224,314943290,314943318
28732,5,24,149,5745,-79,-97,18,,314943362,28,16,314943334,314943362
28733,5,24,149,5745,-79,-97,18,,314943470,32,76,314943438,314943470
28734,5,24,149,5745,-64,-97,33,,314943568,28,70,314943540,314943568
28735,5,24,149,5745,-77,-97,20,,314943612,28,16,314943584,314943612
28736,5,24,149,5745,-77,-97,20,,314943728,32,84,314943696,314943728
28737,5,24,149,5745,-77,-97,20,,314943848,28,92,314943820,314943848
28738,5,24,149,5745,-77,-97,20,,314944169,28,293,314944141,314944169
28739,5,24,149,5745,-78,-97,19,,314945103,28,906,314945075,314945103
28740,5,24,149,5745,-65,-97,32,,314945468,28,337,314945440,314945468
28741,5,24,149,5745,-77,-97,20,,314945512,28,16,314945484,314945512
28742,5,24,149,5745,-77,-97,20,,314945628,32,84,314945596,314945628
28743,5,24,149,5745,-64,-97,33,,314945825,28,169,314945797,314945825
28744,5,24,149,5745,-77,-97,20,,314945869,28,16,314945841,314945869
28745,5,24,149,5745,-77,-97,20,,314945993,32,92,314945961,314945993
28746,5,24,149,5745,-79,-97,18,,314948243,28,2222,314948215,314948243
28747,5,24,149,5745,-77,-97,20,,314948287,28,16,314948259,314948287
28748,5,24,149,5745,-77,-97,20,,314948396,32,77,314948364,314948396
28749,5,24,149,5745,-79,-97,18,,314949386,28,962,314949358,314949386
28750,5,24,149,5745,-78,-97,19,,314949431,28,17,314949403,314949431
28751,5,24,149,5745,-77,-97,20,,314949539,32,76,314949507,314949539
28752,5,12,149,5745,-88,-97,9,9a:24:38:da:96:bb,314951320,272,1509,314951048,314951320
28753,5,24,149,5745,-77,-97,20,,314957656,32,6304,314957624,314957656
28754,5,24,149,5745,-77,-97,20,,314958146,32,458,314958114,314958146
28755,5,24,149,5745,-77,-97,20,,314958637,28,463,314958609,314958637
28756,5,24,149,5745,-77,-97,20,,314959094,28,429,314959066,314959094
28757,5,24,149,5745,-78,-97,19,,314959438,28,316,314959410,314959438
28758,5,24,149,5745,-77,-97,20,,314959640,28,174,314959612,314959640
28759,5,24,149,5745,-65,-97,32,,314959887,28,219,314959859,314959887
28760,5,24,149,5745,-77,-97,20,,314959931,28,16,314959903,314959931
28761,5,24,149,5745,-77,-97,20,,314960051,32,88,314960019,314960051
28762,5,24,149,5745,-65,-97,32,,314960230,28,151,314960202,314960230
28763,5,24,149,5745,-77,-97,20,,314960274,28,16,314960246,314960274
28764,5,24,149,5745,-77,-97,20,,314960394,32,88,314960362,314960394
28765,5,12,149,5745,-74,-97,23,6a:1e:a4:f8:14:49,314963061,284,2383,314962777,314963061
28766,5,24,149,5745,-77,-97,20,,314964680,28,1591,314964652,314964680
28767,5,24,149,5745,-79,-97,18,,314964725,28,17,314964697,314964725
28768,5,24,149,5745,-80,-97,17,,314964832,32,75,314964800,314964832
28769,5,12,149,5745,-63,-97,34,22:ec:75:a8:8a:31,314964899,244,-177,314964655,314964899
28770,5,24,149,5745,-77,-97,20,,314965633,28,706,314965605,314965633
28771,5,24,149,5745,-77,-97,20,,314965844,28,183,314965816,314965844
28772,5,24,149,5745,-77,-97,20,,314966098,28,226,314966070,314966098
28773,5,24,149,5745,-65,-97,32,,314966418,28,292,314966390,314966418
28774,5,24,149,5745,-78,-97,19,,314966462,28,16,314966434,314966462
28775,5,24,149,5745,-78,-97,19,,314966571,28,81,314966543,314966571
28776,5,24,149,5745,-65,-97,32,,314966692,28,93,314966664,314966692
28777,5,24,149,5745,-77,-97,20,,314966736,28,16,314966708,314966736
28778,5,24,149,5745,-65,-97,32,,314967133,28,369,314967105,314967133
28779,5,24,149,5745,-77,-97,20,,314967177,28,16,314967149,314967177
28780,5,24,149,5745,-77,-97,20,,314967285,28,80,314967257,314967285
28781,5,24,149,5745,-77,-97,20,,314967443,28,130,314967415,314967443
28782,5,24,149,5745,-65,-97,32,,314967752,28,281,314967724,314967752
28783,5,24,149,5745,-77,-97,20,,314967796,28,16,314967768,314967796
28784,5,24,149,5745,-77,-97,20,,314967904,28,80,314967876,314967904
28785,5,12,149,5745,-73,-97,24,f2:da:61:dd:98:c5,314967949,268,-223,314967681,314967949
28786,5,24,149,5745,-77,-97,20,,314971372,28,3395,314971344,314971372
28787,5,24,149,5745,-77,-97,20,,314971685,28,285,314971657,314971685
28788,5,24,149,5745,-77,-97,20,,314971967,28,254,314971939,314971967
28789,5,24,149,5745,-77,-97,20,,314979136,28,7141,314979108,314979136
28790,5,12,149,5745,-66,-97,31,d2:00:04:7e:2c:ab,314991355,244,11975,314991111,314991355
28791,5,12,149,5745,-65,-97,32,56:68:e2:c2:8d:d5,314993271,280,1636,314992991,314993271
28792,5,24,149,5745,-78,-97,19,,315005466,32,12163,315005434,315005466
28793,5,24,149,5745,-77,-97,20,,315006010,32,512,315005978,315006010
28794,5,24,149,5745,-78,-97,19,,315006555,28,517,315006527,315006555
28795,5,24,149,5745,-61,-97,36,,315006599,28,16,315006571,315006599
28796,5,24,149,5745,-77,-97,20,,315006804,28,177,315006776,315006804
28797,5,24,149,5745,-64,-97,33,,315007618,28,786,315007590,315007618
28798,5,24,149,5745,-77,-97,20,,315007662,28,16,315007634,315007662
28799,5,24,149,5745,-77,-97,20,,315007770,28,80,315007742,315007770
28800,5,24,149,5745,-64,-97,33,,315007871,28,73,315007843,315007871
28801,5,24,149,5745,-78,-97,19,,315007915,28,16,315007887,315007915
28802,5,24,149,5745,-77,-97,20,,315008023,28,80,315007995,315008023
28803,5,12,149,5745,-71,-97,26,5e:29:73:5b:30:00,315022443,272,14148,315022171,315022443
28804,5,12,149,5745,-94,-97,3,46:28:71:6e:d2:2e,315026794,280,4071,315026514,315026794
28805,5,12,149,5745,-58,-97,39,3e:d1:9b:c7:a4:de,315046318,272,19252,315046046,315046318
28806,5,12,149,5745,-60,-97,37,f6:0a:5c:59:72:df,315050637,280,4039,315050357,315050637
28807,5,12,149,5745,-90,-97,7,9a:24:38:da:96:bb,315064671,272,13762,315064399,315064671
28808,5,6,149,5745,-92,-97,5,54:e4:3a:ec:fb:65,315068980,360,3949,315068620,315068980
28809,5,12,149,5745,-71,-97,26,f2:da:61:dd:98:c5,315069826,268,578,315069558,315069826
28810,5,24,149,5745,-76,-97,21,,315071760,32,1902,315071728,315071760
28811,5,24,149,5745,-76,-97,21,,315072322,32,530,315072290,315072322
28812,5,24,149,5745,-77,-97,20,,315072884,28,534,315072856,315072884
28813,5,24,149,5745,-60,-97,37,,315072929,28,17,315072901,315072929
28814,5,24,149,5745,-76,-97,21,,315073158,28,201,315073130,315073158
28815,5,24,149,5745,-61,-97,36,,315073689,28,503,315073661,315073689
28816,5,24,149,5745,-76,-97,21,,315073733,28,16,315073705,315073733
28817,5,24,149,5745,-76,-97,21,,315073841,28,80,315073813,315073841
28818,5,12,149,5745,-61,-97,36,22:ec:75:a8:8a:31,315081767,244,7682,315081523,315081767
28819,5,24,149,5745,-61,-97,36,,315090526,28,8731,315090498,315090526
28820,5,24,149,5745,-76,-97,21,,315090570,28,16,315090542,315090570
28821,5,24,149,5745,-76,-97,21,,315090678,28,80,315090650,315090678
28822,5,12,149,5745,-68,-97,29,d2:00:04:7e:2c:ab,315093852,244,2930,315093608,315093852
28823,5,12,149,5745,-65,-97,32,56:68:e2:c2:8d:d5,315095679,280,1547,315095399,315095679
28824,5,12,149,5745,-61,-97,36,f6:0a:5c:59:72:df,315119777,280,23818,315119497,315119777
28825,5,12,149,5745,-69,-97,28,d2:00:04:7e:2c:ab,315122523,440,2306,315122083,315122523
28826,5,12,149,5745,-74,-97,23,6a:1e:a4:f8:14:49,315123620,480,617,315123140,315123620
28827,5,24,149,5745,-76,-97,21,,315126141,32,2489,315126109,315126141
28828,5,24,149,5745,-76,-97,21,,315126972,28,803,315126944,315126972
28829,5,24,149,5745,-61,-97,36,,315127363,28,363,315127335,315127363
28830,5,24,149,5745,-76,-97,21,,315127407,28,16,315127379,315127407
28831,5,24,149,5745,-76,-97,21,,315127515,28,80,315127487,315127515
28832,5,12,149,5745,-60,-97,37,22:ec:75:a8:8a:31,315130500,516,2469,315129984,315130500
28833,5,12,149,5745,-67,-97,30,56:68:e2:c2:8d:d5,315131626,476,650,315131150,315131626
28834,5,12,149,5745,-70,-97,27,f2:da:61:dd:98:c5,315132191,268,297,315131923,315132191
28835,5,12,149,5745,-58,-97,39,3e:d1:9b:c7:a4:de,315134968,544,2233,315134424,315134968
28836,5,12,149,5745,-67,-97,30,56:68:e2:c2:8d:d5,315136059,280,811,315135779,315136059
28837,5,12,149,5745,-68,-97,29,d2:00:04:7e:2c:ab,315136654,244,351,315136410,315136654
28838,5,12,149,5745,-56,-97,41,a6:92:ad:b7:76:65,315137658,484,520,315137174,315137658
28839,5,12,149,5745,-71,-97,26,5e:29:73:5b:30:00,315138282,540,84,315137742,315138282
28840,5,12,149,5745,-61,-97,36,f6:0a:5c:59:72:df,315149145,280,10583,315148865,315149145
28841,5,12,149,5745,-70,-97,27,5e:29:73:5b:30:00,315153824,272,4407,315153552,315153824
28842,5,12,149,5745,-57,-97,40,3e:d1:9b:c7:a4:de,315169818,272,15722,315169546,315169818
28843,5,12,149,5745,-72,-97,25,6a:1e:a4:f8:14:49,315170438,284,336,315170154,315170438
28844,5,12,149,5745,-74,-97,23,f2:da:61:dd:98:c5,315171327,268,621,315171059,315171327
28845,5,12,149,5745,-91,-97,6,9a:24:38:da:96:bb,315176338,272,4739,315176066,315176338
28846,5,12,149,5745,-68,-97,29,d2:00:04:7e:2c:ab,315188438,440,11660,315187998,315188438
28847,5,12,149,5745,-86,-97,11,7e:05:42:11:d2:ec,315189220,468,314,315188752,315189220
28848,5,12,149,5745,-56,-97,41,a6:92:ad:b7:76:65,315192989,484,3285,315192505,315192989
28849,5,12,149,5745,-79,-97,18,f2:da:61:dd:98:c5,315196838,268,3581,315196570,315196838
28850,5,12,149,5745,-59,-97,38,22:ec:75:a8:8a:31,315198794,244,1712,315198550,315198794
28851,5,12,149,5745,-72,-97,25,96:a3:af:37:f7:5e,315201223,244,2185,315200979,315201223
28852,5,12,149,5745,-72,-97,25,96:a3:af:37:f7:5e,315206268,440,4605,315205828,315206268
28853,5,12,149,5745,-57,-97,40,a6:92:ad:b7:76:65,315234549,284,27997,315234265,315234549
28854,5,12,149,5745,-68,-97,29,d2:00:04:7e:2c:ab,315250828,244,16035,315250584,315250828
28855,5,12,149,5745,-86,-97,11,7e:05:42:11:d2:ec,315253617,468,2321,315253149,315253617
28856,5,12,149,5745,-68,-97,29,d2:00:04:7e:2c:ab,315254128,440,71,315253688,315254128
28857,5,12,149,5745,-86,-97,11,9a:24:38:da:96:bb,315255767,824,815,315254943,315255767
28858,5,12,149,5745,-57,-97,40,a6:92:ad:b7:76:65,315258333,484,2082,315257849,315258333
28859,5,12,149,5745,-59,-97,38,22:ec:75:a8:8a:31,315258860,516,11,315258344,315258860
28860,5,12,149,5745,-70,-97,27,f2:da:61:dd:98:c5,315261957,268,2829,315261689,315261957
28861,5,12,149,5745,-58,-97,39,3e:d1:9b:c7:a4:de,315265148,544,2647,315264604,315265148
28862,5,12,149,5745,-69,-97,28,0a:b9:b7:b1:4d:fa,315268021,268,2605,315267753,315268021
28863,5,12,149,5745,-70,-97,27,5e:29:73:5b:30:00,315268549,272,256,315268277,315268549
28864,5,12,149,5745,-70,-97,27,5e:29:73:5b:30:00,315268999,540,-90,315268459,315268999
28865,5,12,149,5745,-69,-97,28,96:a3:af:37:f7:5e,315271888,440,2449,315271448,315271888
28866,5,12,149,5745,-59,-97,38,3e:d1:9b:c7:a4:de,315283685,272,11525,315283413,315283685
28867,5,12,149,5745,-73,-97,24,f2:da:61:dd:98:c5,315285225,268,1272,315284957,315285225
28868,5,12,149,5745,-87,-97,10,9a:24:38:da:96:bb,315289036,272,3539,315288764,315289036
28869,5,12,149,5745,-63,-97,34,56:68:e2:c2:8d:d5,315299401,280,10085,315299121,315299401
28870,5,12,149,5745,-57,-97,40,22:ec:75:a8:8a:31,315312620,244,12975,315312376,315312620
28871,5,12,149,5745,-68,-97,29,96:a3:af:37:f7:5e,315328697,244,15833,315328453,315328697
28872,5,12,149,5745,-57,-97,40,a6:92:ad:b7:76:65,315354653,284,25672,315354369,315354653
28873,5,12,149,5745,-71,-97,26,5e:29:73:5b:30:00,315363500,272,8575,315363228,315363500
28874,5,12,149,5745,-68,-97,29,d2:00:04:7e:2c:ab,315365202,244,1458,315364958,315365202
28875,5,12,149,5745,-87,-97,10,7e:05:42:11:d2:ec,315368454,272,2980,315368182,315368454
28876,5,12,149,5745,-71,-97,26,6a:1e:a4:f8:14:49,315373356,284,4618,315373072,315373356
28877,5,12,149,5745,-59,-97,38,3e:d1:9b:c7:a4:de,315385046,272,11418,315384774,315385046
28878,5,12,149,5745,-61,-97,36,f6:0a:5c:59:72:df,315394711,280,9385,315394431,315394711
28879,5,12,149,5745,-86,-97,11,9a:24:38:da:96:bb,315401000,272,6017,315400728,315401000
28880,5,12,149,5745,-62,-97,35,56:68:e2:c2:8d:d5,315402912,280,1632,315402632,315402912
28881,5,12,149,5745,-59,-97,38,22:ec:75:a8:8a:31,315429766,244,26610,315429522,315429766
28882,5,12,149,5745,-72,-97,25,6a:1e:a4:f8:14:49,315475767,284,45717,315475483,315475767
28883,5,12,149,5745,-72,-97,25,96:a3:af:37:f7:5e,315478406,244,2395,315478162,315478406
28884,5,12,149,5745,-69,-97,28,5e:29:73:5b:30:00,315479047,272,369,315478775,315479047
28885,5,12,149,5745,-73,-97,24,f2:da:61:dd:98:c5,315479577,268,262,315479309,315479577
28886,5,12,149,5745,-86,-97,11,7e:05:42:11:d2:ec,315484163,272,4314,315483891,315484163
28887,5,12,149,5745,-52,-97,45,a6:92:ad:b7:76:65,315501643,284,17196,315501359,315501643
28888,5,12,149,5745,-71,-97,26,d2:00:04:7e:2c:ab,315502851,244,964,315502607,315502851
28889,5,12,149,5745,-55,-97,42,3e:d1:9b:c7:a4:de,315503138,272,15,315502866,315503138
28890,5,12,149,5745,-65,-97,32,56:68:e2:c2:8d:d5,315505305,280,1887,315505025,315505305
28891,5,12,149,5745,-86,-97,11,9a:24:38:da:96:bb,315513869,272,8292,315513597,315513869
28892,5,12,149,5745,-60,-97,37,22:ec:75:a8:8a:31,315542593,244,28480,315542349,315542593
28893,5,12,149,5745,-71,-97,26,6a:1e:a4:f8:14:49,315578168,284,35291,315577884,315578168
28894,5,12,149,5745,-69,-97,28,96:a3:af:37:f7:5e,315580612,244,2200,315580368,315580612
28895,5,6,149,5745,-92,-97,5,54:e4:3a:ec:fb:65,315581213,360,241,315580853,315581213
28896,5,12,149,5745,-72,-97,25,f2:da:61:dd:98:c5,315581736,268,255,315581468,315581736
28897,5,12,149,5745,-71,-97,26,5e:29:73:5b:30:00,315592912,272,10904,315592640,315592912
28898,5,12,149,5745,-51,-97,46,a6:92:ad:b7:76:65,315603476,284,10280,315603192,315603476
28899,5,12,149,5745,-68,-97,29,d2:00:04:7e:2c:ab,315605154,244,1434,315604910,315605154
28900,5,12,149,5745,-66,-97,31,56:68:e2:c2:8d:d5,315605900,280,466,315605620,315605900
28901,5,12,149,5745,-60,-97,37,3e:d1:9b:c7:a4:de,315620007,272,13835,315619735,315620007
28902,5,12,149,5745,-83,-97,14,7e:05:42:11:d2:ec,315623269,272,2990,315622997,315623269
28903,5,12,149,5745,-61,-97,36,22:ec:75:a8:8a:31,315654441,244,30928,315654197,315654441
28904,5,12,149,5745,-71,-97,26,6a:1e:a4:f8:14:49,315679255,284,24530,315678971,315679255
28905,5,12,149,5745,-72,-97,25,96:a3:af:37:f7:5e,315682657,244,3158,315682413,315682657
28906,5,6,149,5745,-92,-97,5,54:e4:3a:ec:fb:65,315683383,360,366,315683023,315683383
28907,5,12,149,5745,-74,-97,23,f2:da:61:dd:98:c5,315684899,268,1248,315684631,315684899
28908,5,12,149,5745,-89,-97,8,46:28:71:6e:d2:2e,315688712,280,3533,315688432,315688712
28909,5,12,149,5745,-53,-97,44,a6:92:ad:b7:76:65,315694207,284,5211,315693923,315694207
28910,5,12,149,5745,-70,-97,27,d2:00:04:7e:2c:ab,315695733,244,1282,315695489,315695733
28911,5,12,149,5745,-85,-97,12,9a:24:38:da:96:bb,315696028,272,23,315695756,315696028
28912,5,12,149,5745,-83,-97,14,7e:05:42:11:d2:ec,315709163,272,12863,315708891,315709163
28913,5,12,149,5745,-61,-97,36,56:68:e2:c2:8d:d5,315709478,280,35,315709198,315709478
28914,5,12,149,5745,-71,-97,26,6a:1e:a4:f8:14:49,315709838,480,-120,315709358,315709838
28915,5,12,149,5745,-60,-97,37,f6:0a:5c:59:72:df,315710745,280,627,315710465,315710745
28916,5,12,149,5745,-83,-97,14,7e:05:42:11:d2:ec,315713034,468,1821,315712566,315713034
28917,5,12,149,5745,-57,-97,40,3e:d1:9b:c7:a4:de,315713545,544,-33,315713001,315713545
28918,5,12,149,5745,-61,-97,36,22:ec:75:a8:8a:31,315717705,516,3644,315717189,315717705
28919,5,12,149,5745,-54,-97,43,a6:92:ad:b7:76:65,315718282,484,93,315717798,315718282
28920,5,12,149,5745,-61,-97,36,f6:0a:5c:59:72:df,315718881,280,319,315718601,315718881
28921,5,12,149,5745,-70,-97,27,d2:00:04:7e:2c:ab,315720583,440,1262,315720143,315720583
28922,5,12,149,5745,-74,-97,23,f2:da:61:dd:98:c5,315721066,268,215,315720798,315721066
28923,5,12,149,5745,-90,-97,7,46:28:71:6e:d2:2e,315722509,280,1163,315722229,315722509
28924,5,12,149,5745,-61,-97,36,56:68:e2:c2:8d:d5,315723381,476,396,315722905,315723381
28925,5,12,149,5745,-68,-97,29,5e:29:73:5b:30:00,315725656,540,1735,315725116,315725656
28926,5,12,149,5745,-68,-97,29,5e:29:73:5b:30:00,315727256,272,1328,315726984,315727256
28927,5,12,149,5745,-74,-97,23,f2:da:61:dd:98:c5,315727618,268,94,315727350,315727618
28928,5,12,149,5745,-72,-97,25,96:a3:af:37:f7:5e,315730853,440,2795,315730413,315730853
28929,5,12,149,5745,-86,-97,11,9a:24:38:da:96:bb,315736331,272,5206,315736059,315736331
28930,5,12,149,5745,-58,-97,39,3e:d1:9b:c7:a4:de,315742388,272,5785,315742116,315742388
28931,5,12,149,5745,-73,-97,24,6a:1e:a4:f8:14:49,315743243,284,571,315742959,315743243
28932,5,12,149,5745,-59,-97,38,22:ec:75:a8:8a:31,315773568,244,30081,315773324,315773568
28933,5,12,149,5745,-65,-97,32,f6:0a:5c:59:72:df,315773922,280,74,315773642,315773922
28934,5,12,149,5745,-71,-97,26,6a:1e:a4:f8:14:49,315774959,480,557,315774479,315774959
28935,5,12,149,5745,-72,-97,25,96:a3:af:37:f7:5e,315775493,244,290,315775249,315775493
28936,5,12,149,5745,-84,-97,13,7e:05:42:11:d2:ec,315777812,468,1851,315777344,315777812
28937,5,12,149,5745,-61,-97,36,3e:d1:9b:c7:a4:de,315778314,544,-42,315777770,315778314
28938,5,12,149,5745,-58,-97,39,22:ec:75:a8:8a:31,315782618,516,3788,315782102,315782618
28939,5,12,149,5745,-55,-97,42,a6:92:ad:b7:76:65,315783186,484,84,315782702,315783186
28940,5,12,149,5745,-71,-97,26,d2:00:04:7e:2c:ab,315784858,440,1232,315784418,315784858
28941,5,12,149,5745,-63,-97,34,56:68:e2:c2:8d:d5,315785377,476,43,315784901,315785377
28942,5,12,149,5745,-76,-97,21,f2:da:61:dd:98:c5,315786194,268,549,315785926,315786194
28943,5,12,149,5745,-92,-97,5,46:28:71:6e:d2:2e,315788423,280,1949,315788143,315788423
28944,5,12,149,5745,-68,-97,29,5e:29:73:5b:30:00,315790996,540,2033,315790456,315790996
28945,5,12,149,5745,-55,-97,42,a6:92:ad:b7:76:65,315791570,284,290,315791286,315791570
28946,5,12,149,5745,-69,-97,28,0a:b9:b7:b1:4d:fa,315795794,268,3956,315795526,315795794
28947,5,12,149,5745,-73,-97,24,96:a3:af:37:f7:5e,315796521,440,287,315796081,315796521
28948,5,12,149,5745,-91,-97,6,46:28:71:6e:d2:2e,315800081,280,3280,315799801,315800081
28949,5,12,149,5745,-85,-97,12,7e:05:42:11:d2:ec,315807433,272,7080,315807161,315807433
28950,5,12,149,5745,-72,-97,25,d2:00:04:7e:2c:ab,315807892,244,215,315807648,315807892
28951,5,12,149,5745,-65,-97,32,56:68:e2:c2:8d:d5,315825009,280,16837,315824729,315825009
28952,5,12,149,5745,-67,-97,30,5e:29:73:5b:30:00,315826593,272,1312,315826321,315826593
28953,5,12,149,5745,-61,-97,36,f6:0a:5c:59:72:df,315843755,280,16882,315843475,315843755
28954,5,12,149,5745,-62,-97,35,3e:d1:9b:c7:a4:de,315844645,544,346,315844101,315844645
28955,5,12,149,5745,-88,-97,9,9a:24:38:da:96:bb,315849518,272,4601,315849246,315849518
28956,5,12,149,5745,-61,-97,36,3e:d1:9b:c7:a4:de,315857080,272,7290,315856808,315857080
28957,5,12,149,5745,-76,-97,21,f2:da:61:dd:98:c5,315857396,268,48,315857128,315857396
28958,5,12,149,5745,-69,-97,28,6a:1e:a4:f8:14:49,315861136,284,3456,315860852,315861136
28959,5,12,149,5745,-56,-97,41,22:ec:75:a8:8a:31,315884213,244,22833,315883969,315884213
28960,5,12,149,5745,-69,-97,28,96:a3:af:37:f7:5e,315891493,244,7036,315891249,315891493
28961,5,12,149,5745,-60,-97,37,3e:d1:9b:c7:a4:de,315909683,544,17646,315909139,315909683
28962,5,12,149,5745,-93,-97,4,46:28:71:6e:d2:2e,315917172,280,7209,315916892,315917172
28963,5,12,149,5745,-61,-97,36,a6:92:ad:b7:76:65,315918344,284,888,315918060,315918344
28964,5,12,149,5745,-74,-97,23,d2:00:04:7e:2c:ab,315928317,244,9729,315928073,315928317
28965,5,12,149,5745,-86,-97,11,7e:05:42:11:d2:ec,315928640,272,51,315928368,315928640
28966,5,12,149,5745,-67,-97,30,5e:29:73:5b:30:00,315933621,272,4709,315933349,315933621
28967,5,12,149,5745,-67,-97,30,56:68:e2:c2:8d:d5,315946158,280,12257,315945878,315946158
28968,5,12,149,5745,-84,-97,13,9a:24:38:da:96:bb,315965777,272,19347,315965505,315965777
28969,5,12,149,5745,-72,-97,25,f2:da:61:dd:98:c5,315970105,268,4060,315969837,315970105
28970,5,12,149,5745,-60,-97,37,3e:d1:9b:c7:a4:de,315971784,272,1407,315971512,315971784
28971,5,12,149,5745,-60,-97,37,3e:d1:9b:c7:a4:de,315974997,544,2669,315974453,315974997
28972,5,12,149,5745,-70,-97,27,6a:1e:a4:f8:14:49,315987753,284,12472,315987469,315987753
28973,5,6,149,5745,-93,-97,4,54:e4:3a:ec:fb:65,315990585,360,2472,315990225,315990585
28974,5,12,149,5745,-55,-97,42,22:ec:75:a8:8a:31,316001272,244,10443,316001028,316001272
28975,5,12,149,5745,-71,-97,26,96:a3:af:37:f7:5e,316002639,244,1123,316002395,316002639
28976,5,12,149,5745,-59,-97,38,a6:92:ad:b7:76:65,316025249,284,22326,316024965,316025249
28977,5,12,149,5745,-93,-97,4,46:28:71:6e:d2:2e,316029070,280,3541,316028790,316029070
28978,5,12,149,5745,-88,-97,9,7e:05:42:11:d2:ec,316039836,272,10494,316039564,316039836
28979,5,24,149,5745,-80,-97,17,,316043946,28,4082,316043918,316043946
28980,5,24,149,5745,-78,-97,19,,316043990,28,16,316043962,316043990
28981,5,24,149,5745,-78,-97,19,,316044099,32,77,316044067,316044099
28982,5,12,149,5745,-71,-97,26,5e:29:73:5b:30:00,316049747,272,5376,316049475,316049747
28983,5,12,149,5745,-58,-97,39,3e:d1:9b:c7:a4:de,316072172,272,22153,316071900,316072172
28984,5,24,149,5745,-78,-97,19,,316073111,28,911,316073083,316073111
28985,5,24,149,5745,-81,-97,16,,316073155,28,16,316073127,316073155
28986,5,24,149,5745,-82,-97,15,,316073263,32,76,316073231,316073263
28987,5,12,149,5745,-85,-97,12,9a:24:38:da:96:bb,316073861,272,326,316073589,316073861
28988,5,24,149,5745,-81,-97,16,,316075899,28,2010,316075871,316075899
28989,5,24,149,5745,-78,-97,19,,316075942,28,15,316075914,316075942
28990,5,24,149,5745,-78,-97,19,,316076051,32,77,316076019,316076051
28991,5,12,149,5745,-68,-97,29,6a:1e:a4:f8:14:49,316090151,284,13816,316089867,316090151
28992,5,12,149,5745,-67,-97,30,f2:da:61:dd:98:c5,316093845,268,3426,316093577,316093845
28993,5,12,149,5745,-71,-97,26,d2:00:04:7e:2c:ab,316117098,244,23009,316116854,316117098
28994,5,12,149,5745,-57,-97,40,22:ec:75:a8:8a:31,316118322,244,980,316118078,316118322
28995,5,12,149,5745,-67,-97,30,56:68:e2:c2:8d:d5,316119724,280,1122,316119444,316119724
28996,5,12,149,5745,-76,-97,21,96:a3:af:37:f7:5e,316124812,244,4844,316124568,316124812
28997,5,12,149,5745,-62,-97,35,a6:92:ad:b7:76:65,316147507,284,22411,316147223,316147507
28998,5,12,149,5745,-91,-97,6,46:28:71:6e:d2:2e,316153610,280,5823,316153330,316153610
28999,5,12,149,5745,-70,-97,27,d2:00:04:7e:2c:ab,316153961,244,107,316153717,316153961
29000,5,12,149,5745,-86,-97,11,7e:05:42:11:d2:ec,316154239,272,6,316153967,316154239
29001,5,12,149,5745,-60,-97,37,f6:0a:5c:59:72:df,316168526,280,14007,316168246,316168526
29002,5,12,149,5745,-60,-97,37,f6:0a:5c:59:72:df,316168824,280,18,316168544,316168824
29003,5,12,149,5745,-69,-97,28,5e:29:73:5b:30:00,316169732,272,636,316169460,316169732
29004,5,12,149,5745,-64,-97,33,56:68:e2:c2:8d:d5,316170038,280,26,316169758,316170038
29005,5,12,149,5745,-67,-97,30,6a:1e:a4:f8:14:49,316172396,480,1878,316171916,316172396
29006,5,12,149,5745,-85,-97,12,7e:05:42:11:d2:ec,316173199,468,335,316172731,316173199
29007,5,12,149,5745,-62,-97,35,3e:d1:9b:c7:a4:de,316174738,544,995,316174194,316174738
29008,5,12,149,5745,-62,-97,35,a6:92:ad:b7:76:65,316176450,484,1228,316175966,316176450
29009,5,12,149,5745,-58,-97,39,22:ec:75:a8:8a:31,316176986,516,20,316176470,316176986
29010,5,12,149,5745,-86,-97,11,9a:24:38:da:96:bb,316177670,824,-140,316176846,316177670
29011,5,12,149,5745,-62,-97,35,56:68:e2:c2:8d:d5,316181029,476,2883,316180553,316181029
29012,5,12,149,5745,-67,-97,30,f2:da:61:dd:98:c5,316181539,268,242,316181271,316181539
29013,5,12,149,5745,-86,-97,11,9a:24:38:da:96:bb,316185302,272,3491,316185030,316185302
29014,5,12,149,5745,-67,-97,30,6a:1e:a4:f8:14:49,316185662,284,76,316185378,316185662
29015,5,24,149,5745,-83,-97,14,,316186007,28,317,316185979,316186007
29016,5,24,149,5745,-80,-97,17,,316186051,28,16,316186023,316186051
29017,5,24,149,5745,-80,-97,17,,316186160,32,77,316186128,316186160
29018,5,12,149,5745,-69,-97,28,5e:29:73:5b:30:00,316186763,540,63,316186223,316186763
29019,5,12,149,5745,-67,-97,30,f2:da:61:dd:98:c5,316187348,268,317,316187080,316187348
29020,5,12,149,5745,-73,-97,24,96:a3:af:37:f7:5e,316189207,440,1419,316188767,316189207
29021,5,6,149,5745,-92,-97,5,54:e4:3a:ec:fb:65,316195386,360,5819,316195026,316195386
29022,5,12,149,5745,-62,-97,35,3e:d1:9b:c7:a4:de,316201165,272,5507,316200893,316201165
29023,5,24,149,5745,-79,-97,18,,316203967,28,2774,316203939,316203967
29024,5,24,149,5745,-83,-97,14,,316204011,28,16,316203983,316204011
29025,5,24,149,5745,-82,-97,15,,316204119,32,76,316204087,316204119
29026,5,12,149,5745,-73,-97,24,96:a3:af:37:f7:5e,316217376,244,13013,316217132,316217376
29027,5,12,149,5745,-59,-97,38,22:ec:75:a8:8a:31,316232227,244,14607,316231983,316232227
29028,5,12,149,5745,-61,-97,36,a6:92:ad:b7:76:65,316233648,484,937,316233164,316233648
29029,5,12,149,5745,-62,-97,35,3e:d1:9b:c7:a4:de,316237402,544,3210,316236858,316237402
29030,5,12,149,5745,-71,-97,26,f2:da:61:dd:98:c5,316244885,268,7215,316244617,316244885
29031,5,12,149,5745,-85,-97,12,7e:05:42:11:d2:ec,316249596,468,4243,316249128,316249596
29032,5,12,149,5745,-85,-97,12,7e:05:42:11:d2:ec,316250080,272,212,316249808,316250080
29033,5,12,149,5745,-61,-97,36,a6:92:ad:b7:76:65,316250395,284,31,316250111,316250395
29034,5,12,149,5745,-73,-97,24,96:a3:af:37:f7:5e,316254952,440,4117,316254512,316254952
29035,5,12,149,5745,-93,-97,4,46:28:71:6e:d2:2e,316256891,280,1659,316256611,316256891
29036,5,12,149,5745,-60,-97,37,56:68:e2:c2:8d:d5,316284272,280,27101,316283992,316284272
29037,5,12,149,5745,-85,-97,12,9a:24:38:da:96:bb,316298275,272,13731,316298003,316298275
29038,5,12,149,5745,-60,-97,37,a6:92:ad:b7:76:65,316299521,484,762,316299037,316299521
29039,5,12,149,5745,-69,-97,28,5e:29:73:5b:30:00,316300723,272,930,316300451,316300723
29040,5,12,149,5745,-72,-97,25,f2:da:61:dd:98:c5,316301058,268,67,316300790,316301058
29041,5,12,149,5745,-61,-97,36,3e:d1:9b:c7:a4:de,316302953,544,1351,316302409,316302953
29042,5,12,149,5745,-58,-97,39,f6:0a:5c:59:72:df,316303588,280,355,316303308,316303588
29043,5,24,149,5745,-81,-97,16,,316303948,28,332,316303920,316303948
29044,5,24,149,5745,-81,-97,16,,316303992,28,16,316303964,316303992
29045,5,24,149,5745,-79,-97,18,,316304100,32,76,316304068,316304100
29046,5,12,149,5745,-68,-97,29,6a:1e:a4:f8:14:49,316306624,284,2240,316306340,316306624
29047,5,12,149,5745,-72,-97,25,f2:da:61:dd:98:c5,316310450,268,3558,316310182,316310450
29048,5,12,149,5745,-85,-97,12,9a:24:38:da:96:bb,316313218,824,1944,316312394,316313218
29049,5,12,149,5745,-84,-97,13,7e:05:42:11:d2:ec,316315158,468,1472,316314690,316315158
29050,5,12,149,5745,-61,-97,36,3e:d1:9b:c7:a4:de,316315882,272,452,316315610,316315882
29051,5,12,149,5745,-67,-97,30,0a:b9:b7:b1:4d:fa,316316801,268,651,316316533,316316801
29052,5,12,149,5745,-69,-97,28,5e:29:73:5b:30:00,316317121,540,-220,316316581,316317121
29053,5,12,149,5745,-74,-97,23,96:a3:af:37:f7:5e,316320432,440,2871,316319992,316320432
29054,5,12,149,5745,-62,-97,35,22:ec:75:a8:8a:31,316321053,516,105,316320537,316321053
29055,5,24,149,5745,-79,-97,18,,316322105,28,1024,316322077,316322105
29056,5,24,149,5745,-81,-97,16,,316322149,28,16,316322121,316322149
29057,5,24,149,5745,-81,-97,16,,316322258,32,77,316322226,316322258
29058,5,12,149,5745,-74,-97,23,96:a3:af:37:f7:5e,316331731,244,9229,316331487,316331731
29059,5,12,149,5745,-63,-97,34,22:ec:75:a8:8a:31,316347859,244,15884,316347615,316347859
29060,5,12,149,5745,-63,-97,34,a6:92:ad:b7:76:65,316374799,284,26656,316374515,316374799
29061,5,12,149,5745,-61,-97,36,3e:d1:9b:c7:a4:de,316380081,544,4738,316379537,316380081
29062,5,12,149,5745,-84,-97,13,7e:05:42:11:d2:ec,316381002,272,649,316380730,316381002
29063,5,24,149,5745,-79,-97,18,,316392179,28,11149,316392151,316392179
29064,5,24,149,5745,-80,-97,17,,316392223,28,16,316392195,316392223
29065,5,24,149,5745,-80,-97,17,,316400632,28,8381,316400604,316400632
29066,5,24,149,5745,-79,-97,18,,316400676,28,16,316400648,316400676
29067,5,24,149,5745,-80,-97,17,,316400784,32,76,316400752,316400784
29068,5,12,149,5745,-85,-97,12,9a:24:38:da:96:bb,316410407,272,9351,316410135,316410407
29069,5,12,149,5745,-62,-97,35,56:68:e2:c2:8d:d5,316426906,280,16219,316426626,316426906
29070,5,12,149,5745,-61,-97,36,3e:d1:9b:c7:a4:de,316430603,272,3425,316430331,316430603
29071,5,12,149,5745,-62,-97,35,3e:d1:9b:c7:a4:de,316445516,544,14369,316444972,316445516
29072,5,12,149,5745,-64,-97,33,22:ec:75:a8:8a:31,316461391,244,15631,316461147,316461391
29073,5,12,149,5745,-69,-97,28,6a:1e:a4:f8:14:49,316499834,284,38159,316499550,316499834
29074,5,6,149,5745,-92,-97,5,54:e4:3a:ec:fb:65,316502587,360,2393,316502227,316502587
29075,5,12,149,5745,-70,-97,27,f2:da:61:dd:98:c5,316503450,268,595,316503182,316503450
29076,5,12,149,5745,-73,-97,24,96:a3:af:37:f7:5e,316504374,244,680,316504130,316504374
29077,5,12,149,5745,-69,-97,28,5e:29:73:5b:30:00,316509336,272,4690,316509064,316509336
29078,5,12,149,5745,-62,-97,35,3e:d1:9b:c7:a4:de,316511073,544,1193,316510529,316511073
29079,5,12,149,5745,-60,-97,37,a6:92:ad:b7:76:65,316526158,284,14801,316525874,316526158
29080,5,12,149,5745,-63,-97,34,3e:d1:9b:c7:a4:de,316528889,272,2459,316528617,316528889
29081,5,12,149,5745,-63,-97,34,56:68:e2:c2:8d:d5,316529981,280,812,316529701,316529981
29082,5,12,149,5745,-85,-97,12,7e:05:42:11:d2:ec,316544918,272,14665,316544646,316544918
29083,5,12,149,5745,-61,-97,36,22:ec:75:a8:8a:31,316578997,244,33835,316578753,316578997
29084,5,24,149,5745,-77,-97,20,,316597281,28,18256,316597253,316597281
29085,5,24,149,5745,-79,-97,18,,316597325,28,16,316597297,316597325
29086,5,24,149,5745,-79,-97,18,,316597433,32,76,316597401,316597433
29087,5,12,149,5745,-71,-97,26,6a:1e:a4:f8:14:49,316602170,284,4453,316601886,316602170
29088,5,6,149,5745,-92,-97,5,54:e4:3a:ec:fb:65,316604988,360,2458,316604628,316604988
29089,5,12,149,5745,-72,-97,25,96:a3:af:37:f7:5e,316605430,244,198,316605186,316605430
29090,5,12,149,5745,-69,-97,28,f2:da:61:dd:98:c5,316605808,268,110,316605540,316605808
29091,5,24,149,5745,-79,-97,18,,316617777,28,11941,316617749,316617777
29092,5,24,149,5745,-77,-97,20,,316617821,28,16,316617793,316617821
29093,5,24,149,5745,-78,-97,19,,316617929,32,76,316617897,316617929
29094,5,12,149,5745,-58,-97,39,a6:92:ad:b7:76:65,316624858,284,6645,316624574,316624858
29095,5,12,149,5745,-69,-97,28,5e:29:73:5b:30:00,316626389,272,1259,316626117,316626389
29096,5,12,149,5745,-64,-97,33,56:68:e2:c2:8d:d5,316631567,280,4898,316631287,316631567
29097,5,12,149,5745,-87,-97,10,9a:24:38:da:96:bb,316638580,272,6741,316638308,316638580
29098,5,12,149,5745,-61,-97,36,3e:d1:9b:c7:a4:de,316638905,272,53,316638633,316638905
29099,5,12,149,5745,-60,-97,37,f6:0a:5c:59:72:df,316639408,280,223,316639128,316639408
29100,5,12,149,5745,-85,-97,12,7e:05:42:11:d2:ec,316647718,272,8038,316647446,316647718
29101,5,12,149,5745,-61,-97,36,22:ec:75:a8:8a:31,316690607,244,42645,316690363,316690607
29102,5,6,149,5745,-82,-97,15,6e:9d:b4:09:66:28,316699413,164,8642,316699249,316699413
29103,5,6,149,5745,-91,-97,6,54:e4:3a:ec:fb:65,316699723,352,-42,316699371,316699723
29104,5,6,149,5745,-83,-97,14,,316700094,44,327,316700050,316700094
29105,5,12,149,5745,-71,-97,26,6a:1e:a4:f8:14:49,316703347,284,2969,316703063,316703347
29106,5,12,149,5745,-74,-97,23,96:a3:af:37:f7:5e,316707728,244,4137,316707484,316707728
29107,5,12,149,5745,-70,-97,27,f2:da:61:dd:98:c5,316708065,268,69,316707797,316708065
29108,5,12,149,5745,-85,-97,12,7e:05:42:11:d2:ec,316715659,272,7322,316715387,316715659
29109,5,6,149,5745,-83,-97,14,6e:9d:b4:09:66:28,316721686,164,5863,316721522,316721686
29110,5,6,149,5745,-92,-97,5,54:e4:3a:ec:fb:65,316722036,352,-2,316721684,316722036
29111,5,6,149,5745,-83,-97,14,,316722406,44,326,316722362,316722406
29112,5,12,149,5745,-56,-97,41,a6:92:ad:b7:76:65,316726935,284,4245,316726651,316726935
29113,5,12,149,5745,-66,-97,31,56:68:e2:c2:8d:d5,316733195,280,5980,316732915,316733195
29114,5,12,149,5745,-59,-97,38,f6:0a:5c:59:72:df,316742918,280,9443,316742638,316742918
29115,5,12,149,5745,-87,-97,10,9a:24:38:da:96:bb,316745474,272,2284,316745202,316745474
29116,5,12,149,5745,-61,-97,36,3e:d1:9b:c7:a4:de,316758208,272,12462,316757936,316758208
29117,5,12,149,5745,-59,-97,38,f6:0a:5c:59:72:df,316758955,280,467,316758675,316758955
29118,5,12,149,5745,-67,-97,30,5e:29:73:5b:30:00,316759525,272,298,316759253,316759525
29119,5,12,149,5745,-72,-97,25,96:a3:af:37:f7:5e,316759878,440,-87,316759438,316759878
29120,5,12,149,5745,-70,-97,27,f2:da:61:dd:98:c5,316760379,268,233,316760111,316760379
29121,5,12,149,5745,-71,-97,26,6a:1e:a4:f8:14:49,316761267,480,408,316760787,316761267
29122,5,12,149,5745,-61,-97,36,3e:d1:9b:c7:a4:de,316765894,544,4083,316765350,316765894
29123,5,12,149,5745,-67,-97,30,56:68:e2:c2:8d:d5,316768480,476,2110,316768004,316768480
29124,5,12,149,5745,-67,-97,30,5e:29:73:5b:30:00,316774868,540,5848,316774328,316774868
29125,5,12,149,5745,-56,-97,41,a6:92:ad:b7:76:65,316776027,484,675,316775543,316776027
29126,5,12,149,5745,-70,-97,27,f2:da:61:dd:98:c5,316780291,268,3996,316780023,316780291
29127,5,12,149,5745,-62,-97,35,22:ec:75:a8:8a:31,316780621,516,-186,316780105,316780621
29128,5,12,149,5745,-72,-97,25,96:a3:af:37:f7:5e,316790496,244,9631,316790252,316790496
29129,5,12,149,5745,-55,-97,42,a6:92:ad:b7:76:65,316807489,284,16709,316807205,316807489
29130,5,6,149,5745,-91,-97,6,54:e4:3a:ec:fb:65,316809789,360,1940,316809429,316809789
29131,5,12,149,5745,-82,-97,15,7e:05:42:11:d2:ec,316814530,360,4381,316814170,316814530
29132,5,24,149,5745,-78,-97,19,,316822099,28,7541,316822071,316822099
29133,5,24,149,5745,-78,-97,19,,316822143,28,16,316822115,316822143
29134,5,24,149,5745,-77,-97,20,,316822251,32,76,316822219,316822251
29135,5,12,149,5745,-62,-97,35,22:ec:75:a8:8a:31,316822317,244,-178,316822073,316822317
29136,5,12,149,5745,-82,-97,15,7e:05:42:11:d2:ec,316823276,272,687,316823004,316823276
29137,5,12,149,5745,-72,-97,25,96:a3:af:37:f7:5e,316824107,440,391,316823667,316824107
29138,5,12,149,5745,-73,-97,24,6a:1e:a4:f8:14:49,316828490,480,3903,316828010,316828490
29139,5,12,149,5745,-67,-97,30,5e:29:73:5b:30:00,316829022,540,-8,316828482,316829022
29140,5,12,149,5745,-85,-97,12,9a:24:38:da:96:bb,316829625,824,-221,316828801,316829625
29141,5,12,149,5745,-59,-97,38,3e:d1:9b:c7:a4:de,316831410,544,1241,316830866,316831410
29142,5,12,149,5745,-82,-97,15,7e:05:42:11:d2:ec,316831997,468,119,316831529,316831997
29143,5,12,149,5745,-61,-97,36,f6:0a:5c:59:72:df,316832499,280,222,316832219,316832499
29144,5,12,149,5745,-68,-97,29,56:68:e2:c2:8d:d5,316835819,476,2844,316835343,316835819
29145,5,12,149,5745,-67,-97,30,56:68:e2:c2:8d:d5,316839885,280,3786,316839605,316839885
29146,5,24,149,5745,-78,-97,19,,316840226,28,313,316840198,316840226
29147,5,24,149,5745,-77,-97,20,,316840270,28,16,316840242,316840270
29148,5,24,149,5745,-77,-97,20,,316840378,32,76,316840346,316840378
29149,5,12,149,5745,-55,-97,42,a6:92:ad:b7:76:65,316841398,484,536,316840914,316841398
29150,5,12,149,5745,-69,-97,28,f2:da:61:dd:98:c5,316842895,268,1229,316842627,316842895
29151,5,12,149,5745,-67,-97,30,0a:b9:b7:b1:4d:fa,316845007,268,1844,316844739,316845007
29152,5,12,149,5745,-62,-97,35,22:ec:75:a8:8a:31,316845336,516,-187,316844820,316845336
29153,5,12,149,5745,-60,-97,37,f6:0a:5c:59:72:df,316854147,280,8531,316853867,316854147
29154,5,12,149,5745,-73,-97,24,6a:1e:a4:f8:14:49,316857073,284,2642,316856789,316857073
29155,5,12,149,5745,-67,-97,30,5e:29:73:5b:30:00,316857976,272,631,316857704,316857976
29156,5,12,149,5745,-69,-97,28,f2:da:61:dd:98:c5,316858914,268,670,316858646,316858914
29157,5,12,149,5745,-86,-97,11,9a:24:38:da:96:bb,316863920,272,4734,316863648,316863920
29158,5,12,149,5745,-57,-97,40,3e:d1:9b:c7:a4:de,316873781,272,9589,316873509,316873781
29159,5,12,149,5745,-82,-97,15,7e:05:42:11:d2:ec,316898282,468,24033,316897814,316898282
29160,5,6,149,5745,-93,-97,4,54:e4:3a:ec:fb:65,316912190,360,13548,316911830,316912190
29161,5,12,149,5745,-72,-97,25,96:a3:af:37:f7:5e,316915670,244,3236,316915426,316915670
29162,5,12,149,5745,-61,-97,36,22:ec:75:a8:8a:31,316920342,244,4428,316920098,316920342
29163,5,12,149,5745,-56,-97,41,a6:92:ad:b7:76:65,316925316,284,4690,316925032,316925316
29164,5,12,149,5745,-82,-97,15,7e:05:42:11:d2:ec,316941566,272,15978,316941294,316941566
29165,5,12,149,5745,-67,-97,30,5e:29:73:5b:30:00,316966828,272,24990,316966556,316966828
29166,5,12,149,5745,-86,-97,11,9a:24:38:da:96:bb,316976638,272,9538,316976366,316976638
29167,5,12,149,5745,-56,-97,41,3e:d1:9b:c7:a4:de,316978220,272,1310,316977948,316978220
29168,5,12,149,5745,-72,-97,25,6a:1e:a4:f8:14:49,317011852,284,33348,317011568,317011852
29169,5,6,149,5745,-92,-97,5,54:e4:3a:ec:fb:65,317014590,360,2378,317014230,317014590
29170,5,12,149,5745,-69,-97,28,f2:da:61:dd:98:c5,317015531,268,673,317015263,317015531
29171,5,12,149,5745,-72,-97,25,d2:00:04:7e:2c:ab,317020743,244,4968,317020499,317020743
29172,5,12,149,5745,-71,-97,26,96:a3:af:37:f7:5e,317028596,244,7609,317028352,317028596
29173,5,12,149,5745,-63,-97,34,22:ec:75:a8:8a:31,317037462,244,8622,317037218,317037462
29174,5,12,149,5745,-68,-97,29,56:68:e2:c2:8d:d5,317041366,280,3624,317041086,317041366
29175,5,24,149,5745,-77,-97,20,,317048136,28,6742,317048108,317048136
29176,5,24,149,5745,-77,-97,20,,317048180,28,16,317048152,317048180
29177,5,24,149,5745,-77,-97,20,,317048289,32,77,317048257,317048289
29178,5,12,149,5745,-55,-97,42,a6:92:ad:b7:76:65,317048664,284,91,317048380,317048664
29179,5,12,149,5745,-82,-97,15,7e:05:42:11:d2:ec,317053133,272,4197,317052861,317053133
29180,5,24,149,5745,-78,-97,19,,317065874,28,12713,317065846,317065874
29181,5,24,149,5745,-77,-97,20,,317065919,28,17,317065891,317065919
29182,5,24,149,5745,-76,-97,21,,317066027,32,76,317065995,317066027
29183,5,12,149,5745,-69,-97,28,5e:29:73:5b:30:00,317083695,272,17396,317083423,317083695
29184,5,12,149,5745,-82,-97,15,9a:24:38:da:96:bb,317092175,272,8208,317091903,317092175
29185,5,12,149,5745,-57,-97,40,3e:d1:9b:c7:a4:de,317094098,272,1651,317093826,317094098
29186,5,12,149,5745,-60,-97,37,f6:0a:5c:59:72:df,317096256,280,1878,317095976,317096256
29187,5,12,149,5745,-72,-97,25,6a:1e:a4:f8:14:49,317114206,284,17666,317113922,317114206
29188,5,6,149,5745,-93,-97,4,54:e4:3a:ec:fb:65,317116991,360,2425,317116631,317116991
29189,5,12,149,5745,-70,-97,27,f2:da:61:dd:98:c5,317117822,268,563,317117554,317117822
29190,5,12,149,5745,-72,-97,25,d2:00:04:7e:2c:ab,317141526,244,23460,317141282,317141526
29191,5,12,149,5745,-70,-97,27,56:68:e2:c2:8d:d5,317143593,280,1787,317143313,317143593
29192,5,12,149,5745,-71,-97,26,96:a3:af:37:f7:5e,317149280,244,5443,317149036,317149280
29193,5,12,149,5745,-63,-97,34,22:ec:75:a8:8a:31,317154518,244,4994,317154274,317154518
29194,5,12,149,5745,-58,-97,39,a6:92:ad:b7:76:65,317155586,284,784,317155302,317155586
29195,5,12,149,5745,-83,-97,14,7e:05:42:11:d2:ec,317164428,272,8570,317164156,317164428
29196,5,12,149,5745,-68,-97,29,56:68:e2:c2:8d:d5,317186192,280,21484,317185912,317186192
29197,5,12,149,5745,-89,-97,8,9a:24:38:da:96:bb,317201148,272,14684,317200876,317201148
29198,5,12,149,5745,-71,-97,26,f2:da:61:dd:98:c5,317204280,268,2864,317204012,317204280
29199,5,12,149,5745,-68,-97,29,6a:1e:a4:f8:14:49,317205608,284,1044,317205324,317205608
29200,5,12,149,5745,-58,-97,39,3e:d1:9b:c7:a4:de,317216996,272,11116,317216724,317216996
29201,5,12,149,5745,-74,-97,23,96:a3:af:37:f7:5e,317217871,440,435,317217431,317217871
29202,5,12,149,5745,-71,-97,26,5e:29:73:5b:30:00,317221192,540,2781,317220652,317221192
29203,5,12,149,5745,-88,-97,9,9a:24:38:da:96:bb,317222544,824,528,317221720,317222544
29204,5,12,149,5745,-58,-97,39,3e:d1:9b:c7:a4:de,317225168,544,2080,317224624,317225168
29205,5,12,149,5745,-67,-97,30,6a:1e:a4:f8:14:49,317225792,480,144,317225312,317225792
29206,5,12,149,5745,-60,-97,37,f6:0a:5c:59:72:df,317226746,280,674,317226466,317226746
29207,5,12,149,5745,-66,-97,31,56:68:e2:c2:8d:d5,317229490,476,2268,317229014,317229490
29208,5,12,149,5745,-73,-97,24,d2:00:04:7e:2c:ab,317234076,244,4342,317233832,317234076
29209,5,12,149,5745,-60,-97,37,a6:92:ad:b7:76:65,317234471,484,-89,317233987,317234471
29210,5,12,149,5745,-71,-97,26,f2:da:61:dd:98:c5,317237859,268,3120,317237591,317237859
29211,5,12,149,5745,-72,-97,25,d2:00:04:7e:2c:ab,317238983,380,744,317238603,317238983
29212,5,12,149,5745,-62,-97,35,22:ec:75:a8:8a:31,317240681,516,1182,317240165,317240681
29213,5,12,149,5745,-72,-97,25,d2:00:04:7e:2c:ab,317241260,440,139,317240820,317241260
29214,5,12,149,5745,-74,-97,23,96:a3:af:37:f7:5e,317249213,244,7709,317248969,317249213
29215,5,12,149,5745,-62,-97,35,22:ec:75:a8:8a:31,317265754,244,16297,317265510,317265754
29216,5,12,149,5745,-60,-97,37,a6:92:ad:b7:76:65,317266257,284,219,317265973,317266257
29217,5,24,149,5745,-77,-97,20,,317270201,28,3916,317270173,317270201
29218,5,24,149,5745,-77,-97,20,,317270245,28,16,317270217,317270245
29219,5,24,149,5745,-77,-97,20,,317270354,32,77,317270322,317270354
29220,5,12,149,5745,-91,-97,6,46:28:71:6e:d2:2e,317279346,280,8712,317279066,317279346
29221,5,12,149,5745,-75,-97,22,96:a3:af:37:f7:5e,317282546,440,2760,317282106,317282546
29222,5,12,149,5745,-84,-97,13,7e:05:42:11:d2:ec,317284224,272,1406,317283952,317284224
29223,5,24,149,5745,-77,-97,20,,317287915,28,3663,317287887,317287915
29224,5,24,149,5745,-77,-97,20,,317287960,28,17,317287932,317287960
29225,5,24,149,5745,-77,-97,20,,317288068,32,76,317288036,317288068
29226,5,12,149,5745,-84,-97,13,7e:05:42:11:d2:ec,317291756,468,3220,317291288,317291756
29227,5,12,149,5745,-61,-97,36,a6:92:ad:b7:76:65,317300045,484,7805,317299561,317300045
29228,5,12,149,5745,-66,-97,31,56:68:e2:c2:8d:d5,317301256,280,931,317300976,317301256
29229,5,12,149,5745,-72,-97,25,f2:da:61:dd:98:c5,317301624,268,100,317301356,317301624
29230,5,12,149,5745,-72,-97,25,d2:00:04:7e:2c:ab,317304911,440,2847,317304471,317304911
29231,5,12,149,5745,-69,-97,28,5e:29:73:5b:30:00,317313795,272,8612,317313523,317313795
29232,5,12,149,5745,-71,-97,26,f2:da:61:dd:98:c5,317316748,268,2685,317316480,317316748
29233,5,12,149,5745,-71,-97,26,6a:1e:a4:f8:14:49,317320854,284,3822,317320570,317320854
29234,5,6,149,5745,-92,-97,5,54:e4:3a:ec:fb:65,317321791,360,577,317321431,317321791
29235,5,12,149,5745,-58,-97,39,3e:d1:9b:c7:a4:de,317323681,272,1618,317323409,317323681
29236,5,12,149,5745,-87,-97,10,9a:24:38:da:96:bb,317336186,272,12233,317335914,317336186
29237,5,12,149,5745,-74,-97,23,d2:00:04:7e:2c:ab,317348773,244,12343,317348529,317348773
29238,5,12,149,5745,-87,-97,10,9a:24:38:da:96:bb,317353305,824,3708,317352481,317353305
29239,5,12,149,5745,-70,-97,27,5e:29:73:5b:30:00,317355097,540,1252,317354557,317355097
29240,5,12,149,5745,-74,-97,23,96:a3:af:37:f7:5e,317355736,440,199,317355296,317355736
29241,5,12,149,5745,-58,-97,39,3e:d1:9b:c7:a4:de,317356255,544,-25,317355711,317356255
29242,5,12,149,5745,-84,-97,13,7e:05:42:11:d2:ec,317357260,468,537,317356792,317357260
29243,5,12,149,5745,-73,-97,24,96:a3:af:37:f7:5e,317363954,244,6450,317363710,317363954
29244,5,12,149,5745,-58,-97,39,a6:92:ad:b7:76:65,317365402,484,964,317364918,317365402
29245,5,12,149,5745,-70,-97,27,f2:da:61:dd:98:c5,317366894,268,1224,317366626,317366894
29246,5,12,149,5745,-70,-97,27,0a:b9:b7:b1:4d:fa,317369194,268,2032,317368926,317369194
29247,5,12,149,5745,-74,-97,23,d2:00:04:7e:2c:ab,317370369,440,735,317369929,317370369
29248,5,12,149,5745,-63,-97,34,22:ec:75:a8:8a:31,317372157,516,1272,317371641,317372157
29249,5,12,149,5745,-57,-97,40,a6:92:ad:b7:76:65,317380706,284,8265,317380422,317380706
29250,5,12,149,5745,-85,-97,12,7e:05:42:11:d2:ec,317382912,272,1934,317382640,317382912
29251,5,12,149,5745,-64,-97,33,22:ec:75:a8:8a:31,317398204,244,15048,317397960,317398204
29252,5,12,149,5745,-85,-97,12,9a:24:38:da:96:bb,317425317,272,26841,317425045,317425317
29253,5,12,149,5745,-69,-97,28,5e:29:73:5b:30:00,317430838,272,5249,317430566,317430838
29254,5,12,149,5745,-67,-97,30,6a:1e:a4:f8:14:49,317433034,284,1912,317432750,317433034
29255,5,12,149,5745,-75,-97,22,d2:00:04:7e:2c:ab,317436664,440,3190,317436224,317436664
29256,5,12,149,5745,-73,-97,24,f2:da:61:dd:98:c5,317437148,268,216,317436880,317437148
29257,5,12,149,5745,-59,-97,38,3e:d1:9b:c7:a4:de,317439286,272,1866,317439014,317439286
29258,5,12,149,5745,-65,-97,32,56:68:e2:c2:8d:d5,317450917,280,11351,317450637,317450917
29259,5,12,149,5745,-57,-97,40,f6:0a:5c:59:72:df,317452769,280,1572,317452489,317452769
29260,5,12,149,5745,-75,-97,22,d2:00:04:7e:2c:ab,317462231,244,9218,317461987,317462231
29261,5,24,149,5745,-76,-97,21,,317489033,28,26774,317489005,317489033
29262,5,24,149,5745,-75,-97,22,,317489077,28,16,317489049,317489077
29263,5,24,149,5745,-75,-97,22,,317489185,32,76,317489153,317489185
29264,5,24,149,5745,-75,-97,22,,317492869,28,3656,317492841,317492869
29265,5,24,149,5745,-77,-97,20,,317492913,28,16,317492885,317492913
29266,5,24,149,5745,-76,-97,21,,317493021,32,76,317492989,317493021
29267,5,12,149,5745,-63,-97,34,22:ec:75:a8:8a:31,317496043,244,2778,317495799,317496043
29268,5,24,149,5745,-76,-97,21,,317497002,28,931,317496974,317497002
29269,5,24,149,5745,-76,-97,21,,317497046,28,16,317497018,317497046
29270,5,24,149,5745,-77,-97,20,,317497155,32,77,317497123,317497155
29271,5,24,149,5745,-77,-97,20,,317510757,28,13574,317510729,317510757
29272,5,24,149,5745,-75,-97,22,,317510802,28,17,317510774,317510802
29273,5,24,149,5745,-75,-97,22,,317510910,32,76,317510878,317510910
29274,5,12,149,5745,-92,-97,5,46:28:71:6e:d2:2e,317513308,280,2118,317513028,317513308
29275,5,12,149,5745,-75,-97,22,96:a3:af:37:f7:5e,317526474,244,12922,317526230,317526474
29276,5,6,149,5745,-91,-97,6,54:e4:3a:ec:fb:65,317526750,360,-84,317526390,317526750
29277,5,12,149,5745,-86,-97,11,9a:24:38:da:96:bb,317540971,272,13949,317540699,317540971
29278,5,12,149,5745,-71,-97,26,5e:29:73:5b:30:00,317548081,272,6838,317547809,317548081
29279,5,12,149,5745,-58,-97,39,a6:92:ad:b7:76:65,317550233,284,1868,317549949,317550233
29280,5,12,149,5745,-63,-97,34,56:68:e2:c2:8d:d5,317551820,280,1307,317551540,317551820
29281,5,12,149,5745,-55,-97,42,f6:0a:5c:59:72:df,317552460,280,360,317552180,317552460
29282,5,12,149,5745,-62,-97,35,3e:d1:9b:c7:a4:de,317556681,272,3949,317556409,317556681
29283,5,12,149,5745,-85,-97,12,7e:05:42:11:d2:ec,317567892,272,10939,317567620,317567892
29284,5,12,149,5745,-60,-97,37,22:ec:75:a8:8a:31,317611482,244,43346,317611238,317611482
29285,5,12,149,5745,-72,-97,25,6a:1e:a4:f8:14:49,317626289,284,14523,317626005,317626289
29286,5,12,149,5745,-75,-97,22,96:a3:af:37:f7:5e,317628815,244,2282,317628571,317628815
29287,5,6,149,5745,-91,-97,6,54:e4:3a:ec:fb:65,317629091,360,-84,317628731,317629091
29288,5,12,149,5745,-71,-97,26,f2:da:61:dd:98:c5,317631914,268,2555,317631646,317631914
29289,5,12,149,5745,-56,-97,41,a6:92:ad:b7:76:65,317648718,284,16520,317648434,317648718
29290,5,12,149,5745,-86,-97,11,9a:24:38:da:96:bb,317649426,272,436,317649154,317649426
29291,5,12,149,5745,-74,-97,23,d2:00:04:7e:2c:ab,317652722,244,3052,317652478,317652722
29292,5,12,149,5745,-64,-97,33,56:68:e2:c2:8d:d5,317654646,280,1644,317654366,317654646
29293,5,12,149,5745,-70,-97,27,5e:29:73:5b:30:00,317664914,272,9996,317664642,317664914
29294,5,24,149,5745,-80,-97,17,,317666961,28,2019,317666933,317666961
29295,5,6,149,5745,-87,-97,10,,317667121,68,92,317667053,317667121
29296,5,24,149,5745,-80,-97,17,,317667976,32,823,317667944,317667976
29297,5,12,149,5745,-87,-97,10,7e:05:42:11:d2:ec,317671302,272,3054,317671030,317671302
29298,5,12,149,5745,-60,-97,37,3e:d1:9b:c7:a4:de,317673849,272,2275,317673577,317673849
29299,5,24,149,5745,-75,-97,22,,317697420,28,23543,317697392,317697420
29300,5,24,149,5745,-81,-97,16,,317697464,28,16,317697436,317697464
29301,5,24,149,5745,-81,-97,16,,317697573,32,77,317697541,317697573
29302,5,24,149,5745,-81,-97,16,,317714954,28,17353,317714926,317714954
29303,5,24,149,5745,-75,-97,22,,317714998,28,16,317714970,317714998
29304,5,24,149,5745,-75,-97,22,,317715106,32,76,317715074,317715106
29305,5,24,149,5745,-75,-97,22,,317717838,28,2704,317717810,317717838
29306,5,24,149,5745,-81,-97,16,,317717881,28,15,317717853,317717881
29307,5,24,149,5745,-81,-97,16,,317717990,32,77,317717958,317717990
29308,5,24,149,5745,-75,-97,22,,317722580,28,4562,317722552,317722580
29309,5,24,149,5745,-80,-97,17,,317722624,28,16,317722596,317722624
29310,5,24,149,5745,-81,-97,16,,317722732,32,76,317722700,317722732
29311,5,12,149,5745,-59,-97,38,22:ec:75:a8:8a:31,317727161,244,4185,317726917,317727161
29312,5,12,149,5745,-72,-97,25,6a:1e:a4:f8:14:49,317727516,284,71,317727232,317727516
29313,5,6,149,5745,-92,-97,5,54:e4:3a:ec:fb:65,317731394,360,3518,317731034,317731394
29314,5,12,149,5745,-73,-97,24,f2:da:61:dd:98:c5,317731870,268,208,317731602,317731870
29315,5,12,149,5745,-70,-97,27,96:a3:af:37:f7:5e,317732317,244,203,317732073,317732317
29316,5,24,149,5745,-81,-97,16,,317736323,28,3978,317736295,317736323
29317,5,24,149,5745,-75,-97,22,,317736367,28,16,317736339,317736367
29318,5,24,149,5745,-75,-97,22,,317736475,32,76,317736443,317736475
29319,5,12,149,5745,-57,-97,40,a6:92:ad:b7:76:65,317750489,284,13730,317750205,317750489
29320,5,24,149,5745,-75,-97,22,,317750872,32,351,317750840,317750872
29321,5,24,149,5745,-76,-97,21,,317753180,28,2280,317753152,317753180
29322,5,24,149,5745,-79,-97,18,,317753224,28,16,317753196,317753224
29323,5,24,149,5745,-79,-97,18,,317753332,32,76,317753300,317753332
29324,5,12,149,5745,-73,-97,24,d2:00:04:7e:2c:ab,317755594,244,2018,317755350,317755594
29325,5,12,149,5745,-63,-97,34,56:68:e2:c2:8d:d5,317756734,280,860,317756454,317756734
29326,5,12,149,5745,-86,-97,11,7e:05:42:11:d2:ec,317773078,272,16072,317772806,317773078
29327,5,12,149,5745,-71,-97,26,6a:1e:a4:f8:14:49,317773692,284,330,317773408,317773692
29328,5,12,149,5745,-72,-97,25,f2:da:61:dd:98:c5,317776739,268,2779,317776471,317776739
29329,5,12,149,5745,-68,-97,29,5e:29:73:5b:30:00,317777060,272,49,317776788,317777060
29330,5,24,149,5745,-81,-97,16,,317802203,32,25111,317802171,317802203
29331,5,24,149,5745,-79,-97,18,,317802505,32,270,317802473,317802505
29332,5,12,149,5745,-73,-97,24,d2:00:04:7e:2c:ab,317805429,244,2680,317805185,317805429
29333,5,12,149,5745,-60,-97,37,3e:d1:9b:c7:a4:de,317806878,272,1177,317806606,317806878
29334,5,12,149,5745,-69,-97,28,96:a3:af:37:f7:5e,317807212,244,90,317806968,317807212
29335,5,12,149,5745,-69,-97,28,96:a3:af:37:f7:5e,317808292,440,640,317807852,317808292
29336,5,12,149,5745,-74,-97,23,6a:1e:a4:f8:14:49,317811827,480,3055,317811347,317811827
29337,5,12,149,5745,-71,-97,26,5e:29:73:5b:30:00,317812386,540,19,317811846,317812386
29338,5,12,149,5745,-60,-97,37,3e:d1:9b:c7:a4:de,317814220,544,1290,317813676,317814220
29339,5,12,149,5745,-61,-97,36,f6:0a:5c:59:72:df,317816986,280,2486,317816706,317816986
29340,5,24,149,5745,-80,-97,17,,317818886,32,1868,317818854,317818886
29341,5,24,149,5745,-81,-97,16,,317819191,28,277,317819163,317819191
29342,5,24,149,5745,-88,-97,9,,317819235,28,16,317819207,317819235
29343,5,6,149,5745,-89,-97,8,,317819352,68,49,317819284,317819352
29344,5,24,149,5745,-80,-97,17,,317819967,28,587,317819939,317819967
29345,5,6,149,5745,-88,-97,9,,317820127,68,92,317820059,317820127
29346,5,12,149,5745,-63,-97,34,56:68:e2:c2:8d:d5,317822211,476,1608,317821735,317822211
29347,5,12,149,5745,-59,-97,38,a6:92:ad:b7:76:65,317823179,284,684,317822895,317823179
29348,5,12,149,5745,-59,-97,38,a6:92:ad:b7:76:65,317824516,484,853,317824032,317824516
29349,5,12,149,5745,-74,-97,23,f2:da:61:dd:98:c5,317826034,268,1250,317825766,317826034
29350,5,12,149,5745,-73,-97,24,d2:00:04:7e:2c:ab,317827488,440,1014,317827048,317827488
29351,5,12,149,5745,-58,-97,39,22:ec:75:a8:8a:31,317828844,516,840,317828328,317828844
29352,5,24,149,5745,-80,-97,17,,317832601,32,3725,317832569,317832601
29353,5,24,149,5745,-80,-97,17,,317852096,32,19463,317852064,317852096
29354,5,24,149,5745,-81,-97,16,,317852356,28,232,317852328,317852356
29355,5,24,149,5745,-87,-97,10,,317852399,28,15,317852371,317852399
29356,5,6,149,5745,-88,-97,9,,317852516,68,49,317852448,317852516
29357,5,12,149,5745,-59,-97,38,22:ec:75:a8:8a:31,317854673,244,1913,317854429,317854673
29358,5,12,149,5745,-64,-97,33,56:68:e2:c2:8d:d5,317856256,280,1303,317855976,317856256
29359,5,24,149,5745,-80,-97,17,,317863502,32,7214,317863470,317863502
29360,5,24,149,5745,-80,-97,17,,317863628,32,94,317863596,317863628
29361,5,12,149,5745,-72,-97,25,96:a3:af:37:f7:5e,317872208,440,8140,317871768,317872208
29362,5,12,149,5745,-72,-97,25,6a:1e:a4:f8:14:49,317872934,284,442,317872650,317872934
29363,5,12,149,5745,-86,-97,11,9a:24:38:da:96:bb,317873685,272,479,317873413,317873685
29364,5,12,149,5745,-77,-97,20,f2:da:61:dd:98:c5,317874009,268,56,317873741,317874009
29365,5,12,149,5745,-73,-97,24,6a:1e:a4:f8:14:49,317877092,480,2603,317876612,317877092
29366,5,12,149,5745,-73,-97,24,5e:29:73:5b:30:00,317877615,540,-17,317877075,317877615
29367,5,12,149,5745,-58,-97,39,f6:0a:5c:59:72:df,317878216,280,321,317877936,317878216
29368,5,12,149,5745,-63,-97,34,3e:d1:9b:c7:a4:de,317879288,544,528,317878744,317879288
29369,5,12,149,5745,-60,-97,37,f6:0a:5c:59:72:df,317881182,280,1614,317880902,317881182
29370,5,12,149,5745,-65,-97,32,56:68:e2:c2:8d:d5,317884349,476,2691,317883873,317884349
29371,5,12,149,5745,-56,-97,41,a6:92:ad:b7:76:65,317890196,484,5363,317889712,317890196
29372,5,12,149,5745,-75,-97,22,f2:da:61:dd:98:c5,317891714,268,1250,317891446,317891714
29373,5,12,149,5745,-72,-97,25,d2:00:04:7e:2c:ab,317892062,440,-92,317891622,317892062
29374,5,12,149,5745,-72,-97,25,0a:b9:b7:b1:4d:fa,317893499,268,1169,317893231,317893499
29375,5,12,149,5745,-62,-97,35,22:ec:75:a8:8a:31,317893837,516,-178,317893321,317893837
29376,5,12,149,5745,-71,-97,26,96:a3:af:37:f7:5e,317895607,380,1390,317895227,317895607
29377,5,12,149,5745,-60,-97,37,3e:d1:9b:c7:a4:de,317905147,272,9268,317904875,317905147
29378,5,12,149,5745,-70,-97,27,5e:29:73:5b:30:00,317906443,272,1024,317906171,317906443
29379,5,12,149,5745,-72,-97,25,d2:00:04:7e:2c:ab,317921147,244,14460,317920903,317921147
29380,5,12,149,5745,-68,-97,29,96:a3:af:37:f7:5e,317921424,244,33,317921180,317921424
29381,5,24,149,5745,-78,-97,19,,317923307,28,1855,317923279,317923307
29382,5,24,149,5745,-80,-97,17,,317923351,28,16,317923323,317923351
29383,5,24,149,5745,-80,-97,17,,317923459,32,76,317923427,317923459
29384,5,24,149,5745,-80,-97,17,,317928567,32,5076,317928535,317928567
29385,5,24,149,5745,-80,-97,17,,317928949,32,350,317928917,317928949
29386,5,24,149,5745,-80,-97,17,,317929332,28,355,317929304,317929332
29387,5,24,149,5745,-74,-97,23,,317929378,28,18,317929350,317929378
29388,5,24,149,5745,-75,-97,22,,317929488,32,78,317929456,317929488
29389,5,6,149,5745,-91,-97,6,54:e4:3a:ec:fb:65,317936195,360,6347,317935835,317936195
29390,5,24,149,5745,-80,-97,17,,317941159,28,4936,317941131,317941159
29391,5,24,149,5745,-79,-97,18,,317941203,28,16,317941175,317941203
29392,5,24,149,5745,-78,-97,19,,317941311,32,76,317941279,317941311
29393,5,12,149,5745,-54,-97,43,a6:92:ad:b7:76:65,317952624,284,11029,317952340,317952624
29394,5,12,149,5745,-59,-97,38,22:ec:75:a8:8a:31,317956715,244,3847,317956471,317956715
29395,5,12,149,5745,-72,-97,25,d2:00:04:7e:2c:ab,317958101,440,946,317957661,317958101
29396,5,12,149,5745,-62,-97,35,56:68:e2:c2:8d:d5,317975262,280,16881,317974982,317975262
29397,5,12,149,5745,-88,-97,9,9a:24:38:da:96:bb,317987092,272,11558,317986820,317987092
29398,5,12,149,5745,-86,-97,11,7e:05:42:11:d2:ec,317996346,244,9010,317996102,317996346
29399,5,24,149,5745,-80,-97,17,,317998195,32,1817,317998163,317998195
29400,5,12,149,5745,-72,-97,25,6a:1e:a4:f8:14:49,317998936,284,457,317998652,317998936
29401,5,12,149,5745,-72,-97,25,f2:da:61:dd:98:c5,318002246,268,3042,318001978,318002246
29402,5,12,149,5745,-72,-97,25,5e:29:73:5b:30:00,318006449,272,3931,318006177,318006449
29403,5,12,149,5745,-56,-97,41,f6:0a:5c:59:72:df,318007549,280,820,318007269,318007549
29404,5,12,149,5745,-59,-97,38,3e:d1:9b:c7:a4:de,318010401,272,2580,318010129,318010401
29405,5,24,149,5745,-81,-97,16,,318013980,32,3547,318013948,318013980
29406,5,24,149,5745,-81,-97,16,,318014407,32,395,318014375,318014407
29407,5,24,149,5745,-81,-97,16,,318014835,28,400,318014807,318014835
29408,5,24,149,5745,-74,-97,23,,318014881,28,18,318014853,318014881
29409,5,24,149,5745,-73,-97,24,,318014991,32,78,318014959,318014991
29410,5,6,149,5745,-90,-97,7,54:e4:3a:ec:fb:65,318038596,360,23245,318038236,318038596
29411,5,12,149,5745,-73,-97,24,d2:00:04:7e:2c:ab,318039742,244,902,318039498,318039742
29412,5,12,149,5745,-70,-97,27,96:a3:af:37:f7:5e,318044449,244,4463,318044205,318044449
29413,5,12,149,5745,-57,-97,40,a6:92:ad:b7:76:65,318066217,284,21484,318065933,318066217
29414,5,12,149,5745,-91,-97,6,46:28:71:6e:d2:2e,318073448,280,6951,318073168,318073448
29415,5,12,149,5745,-61,-97,36,22:ec:75:a8:8a:31,318073812,244,120,318073568,318073812
29416,5,12,149,5745,-70,-97,27,5e:29:73:5b:30:00,318123454,272,49370,318123182,318123454
29417,5,12,149,5745,-60,-97,37,3e:d1:9b:c7:a4:de,318124336,272,610,318124064,318124336
29418,5,12,149,5745,-72,-97,25,6a:1e:a4:f8:14:49,318139345,284,14725,318139061,318139345
29419,5,24,149,5745,-83,-97,14,,318140363,28,990,318140335,318140363
29420,5,24,149,5745,-82,-97,15,,318140407,28,16,318140379,318140407
29421,5,24,149,5745,-82,-97,15,,318140515,32,76,318140483,318140515
29422,5,6,149,5745,-90,-97,7,54:e4:3a:ec:fb:65,318140996,360,121,318140636,318140996
29423,5,12,149,5745,-75,-97,22,f2:da:61:dd:98:c5,318142265,268,1001,318141997,318142265
29424,5,24,149,5745,-82,-97,15,,318145212,28,2919,318145184,318145212
29425,5,24,149,5745,-83,-97,14,,318145256,28,16,318145228,318145256
29426,5,24,149,5745,-82,-97,15,,318145365,32,77,318145333,318145365
29427,5,12,149,5745,-71,-97,26,96:a3:af:37:f7:5e,318152955,244,7346,318152711,318152955
29428,5,12,149,5745,-72,-97,25,d2:00:04:7e:2c:ab,318153303,244,104,318153059,318153303
29429,5,24,149,5745,-82,-97,15,,318158512,28,5181,318158484,318158512
29430,5,24,149,5745,-83,-97,14,,318158557,28,17,318158529,318158557
29431,5,24,149,5745,-83,-97,14,,318158665,32,76,318158633,318158665
29432,5,24,149,5745,-81,-97,16,,318162682,28,3989,318162654,318162682
29433,5,24,149,5745,-82,-97,15,,318162726,28,16,318162698,318162726
29434,5,24,149,5745,-82,-97,15,,318162834,32,76,318162802,318162834
29435,5,12,149,5745,-63,-97,34,56:68:e2:c2:8d:d5,318167525,280,4411,318167245,318167525
29436,5,12,149,5745,-53,-97,44,a6:92:ad:b7:76:65,318176508,284,8699,318176224,318176508
29437,5,24,149,5745,-82,-97,15,,318178180,28,1644,318178152,318178180
29438,5,24,149,5745,-81,-97,16,,318178224,28,16,318178196,318178224
29439,5,24,149,5745,-81,-97,16,,318178337,32,81,318178305,318178337
29440,5,12,149,5745,-85,-97,12,7e:05:42:11:d2:ec,318182970,272,4361,318182698,318182970
29441,5,12,149,5745,-59,-97,38,22:ec:75:a8:8a:31,318189565,244,6351,318189321,318189565
29442,5,12,149,5745,-64,-97,33,56:68:e2:c2:8d:d5,318203926,280,14081,318203646,318203926
29443,5,24,149,5745,-82,-97,15,,318206310,28,2356,318206282,318206310
29444,5,24,149,5745,-82,-97,15,,318206354,28,16,318206326,318206354
29445,5,24,149,5745,-82,-97,15,,318206462,32,76,318206430,318206462
29446,5,24,149,5745,-81,-97,16,,318206888,28,398,318206860,318206888
29447,5,24,149,5745,-83,-97,14,,318206933,28,17,318206905,318206933
29448,5,24,149,5745,-82,-97,15,,318207040,32,75,318207008,318207040
29449,5,24,149,5745,-82,-97,15,,318209341,28,2273,318209313,318209341
29450,5,24,149,5745,-81,-97,16,,318209385,28,16,318209357,318209385
29451,5,24,149,5745,-80,-97,17,,318209497,32,80,318209465,318209497
29452,5,12,149,5745,-86,-97,11,9a:24:38:da:96:bb,318215188,272,5419,318214916,318215188
29453,5,12,149,5745,-69,-97,28,5e:29:73:5b:30:00,318237995,272,22535,318237723,318237995
29454,5,12,149,5745,-70,-97,27,6a:1e:a4:f8:14:49,318240605,284,2326,318240321,318240605
29455,5,12,149,5745,-58,-97,39,3e:d1:9b:c7:a4:de,318241678,272,801,318241406,318241678
29456,5,12,149,5745,-73,-97,24,f2:da:61:dd:98:c5,318244605,268,2659,318244337,318244605
29457,5,12,149,5745,-71,-97,26,d2:00:04:7e:2c:ab,318264125,244,19276,318263881,318264125
29458,5,12,149,5745,-71,-97,26,96:a3:af:37:f7:5e,318265510,244,1141,318265266,318265510
29459,5,12,149,5745,-70,-97,27,96:a3:af:37:f7:5e,318265772,440,-178,318265332,318265772
29460,5,12,149,5745,-93,-97,4,46:28:71:6e:d2:2e,318269089,280,3037,318268809,318269089
29461,5,12,149,5745,-89,-97,8,9a:24:38:da:96:bb,318270563,824,650,318269739,318270563
29462,5,12,149,5745,-71,-97,26,6a:1e:a4:f8:14:49,318272070,480,1027,318271590,318272070
29463,5,12,149,5745,-69,-97,28,5e:29:73:5b:30:00,318272638,540,28,318272098,318272638
29464,5,12,149,5745,-64,-97,33,3e:d1:9b:c7:a4:de,318274463,544,1281,318273919,318274463
29465,5,12,149,5745,-59,-97,38,f6:0a:5c:59:72:df,318275086,280,343,318274806,318275086
29466,5,12,149,5745,-54,-97,43,a6:92:ad:b7:76:65,318281763,284,6393,318281479,318281763
29467,5,12,149,5745,-61,-97,36,56:68:e2:c2:8d:d5,318282162,476,-77,318281686,318282162
29468,5,12,149,5745,-54,-97,43,a6:92:ad:b7:76:65,318284238,484,1592,318283754,318284238
29469,5,12,149,5745,-72,-97,25,f2:da:61:dd:98:c5,318284803,268,297,318284535,318284803
29470,5,12,149,5745,-72,-97,25,d2:00:04:7e:2c:ab,318286590,104,1683,318286486,318286590
29471,5,12,149,5745,-70,-97,27,d2:00:04:7e:2c:ab,318286748,380,-222,318286368,318286748
29472,5,12,149,5745,-70,-97,27,d2:00:04:7e:2c:ab,318287416,440,228,318286976,318287416
29473,5,12,149,5745,-58,-97,39,22:ec:75:a8:8a:31,318290158,516,2226,318289642,318290158
29474,5,12,149,5745,-60,-97,37,56:68:e2:c2:8d:d5,318298087,280,7649,318297807,318298087
29475,5,12,149,5745,-58,-97,39,22:ec:75:a8:8a:31,318313953,244,15622,318313709,318313953
29476,5,12,149,5745,-89,-97,8,9a:24:38:da:96:bb,318323069,272,8844,318322797,318323069
29477,5,12,149,5745,-70,-97,27,96:a3:af:37:f7:5e,318331095,440,7586,318330655,318331095
29478,5,12,149,5745,-71,-97,26,f2:da:61:dd:98:c5,318332649,268,1286,318332381,318332649
29479,5,12,149,5745,-59,-97,38,f6:0a:5c:59:72:df,318342878,280,9949,318342598,318342878
29480,5,12,149,5745,-70,-97,27,6a:1e:a4:f8:14:49,318343811,284,649,318343527,318343811
29481,5,6,149,5745,-91,-97,6,54:e4:3a:ec:fb:65,318345797,360,1626,318345437,318345797
29482,5,12,149,5745,-53,-97,44,a6:92:ad:b7:76:65,318349367,484,3086,318348883,318349367
29483,5,12,149,5745,-71,-97,26,f2:da:61:dd:98:c5,318350031,268,396,318349763,318350031
29484,5,12,149,5745,-72,-97,25,d2:00:04:7e:2c:ab,318351116,440,645,318350676,318351116
29485,5,12,149,5745,-68,-97,29,5e:29:73:5b:30:00,318354972,272,3584,318354700,318354972
29486,5,12,149,5745,-61,-97,36,3e:d1:9b:c7:a4:de,318355397,272,153,318355125,318355397
29487,5,24,149,5745,-80,-97,17,,318369789,28,14364,318369761,318369789
29488,5,24,149,5745,-81,-97,16,,318369833,28,16,318369805,318369833
29489,5,24,149,5745,-81,-97,16,,318369942,32,77,318369910,318369942
29490,5,12,149,5745,-71,-97,26,d2:00:04:7e:2c:ab,318379909,244,9723,318379665,318379909
29491,5,12,149,5745,-68,-97,29,96:a3:af:37:f7:5e,318380214,244,61,318379970,318380214
29492,5,24,149,5745,-82,-97,15,,318387421,28,7179,318387393,318387421
29493,5,24,149,5745,-80,-97,17,,318387465,28,16,318387437,318387465
29494,5,24,149,5745,-80,-97,17,,318387573,32,76,318387541,318387573
29495,5,12,149,5745,-54,-97,43,a6:92:ad:b7:76:65,318396629,284,8772,318396345,318396629
29496,5,12,149,5745,-69,-97,28,96:a3:af:37:f7:5e,318396947,440,-122,318396507,318396947
29497,5,12,149,5745,-90,-97,7,9a:24:38:da:96:bb,318401448,824,3677,318400624,318401448
29498,5,12,149,5745,-70,-97,27,5e:29:73:5b:30:00,318404180,540,2192,318403640,318404180
29499,5,12,149,5745,-61,-97,36,3e:d1:9b:c7:a4:de,318405876,544,1152,318405332,318405876
29500,5,12,149,5745,-53,-97,44,a6:92:ad:b7:76:65,318414133,484,7773,318413649,318414133
29501,5,12,149,5745,-73,-97,24,f2:da:61:dd:98:c5,318415634,268,1233,318415366,318415634
29502,5,12,149,5745,-71,-97,26,d2:00:04:7e:2c:ab,318416009,440,-65,318415569,318416009
29503,5,12,149,5745,-69,-97,28,0a:b9:b7:b1:4d:fa,318417807,268,1530,318417539,318417807
29504,5,12,149,5745,-58,-97,39,22:ec:75:a8:8a:31,318421138,516,2815,318420622,318421138
29505,5,12,149,5745,-58,-97,39,22:ec:75:a8:8a:31,318427798,244,6416,318427554,318427798
29506,5,12,149,5745,-88,-97,9,9a:24:38:da:96:bb,318434655,272,6585,318434383,318434655
29507,5,12,149,5745,-69,-97,28,6a:1e:a4:f8:14:49,318444840,284,9901,318444556,318444840
29508,5,12,149,5745,-73,-97,24,f2:da:61:dd:98:c5,318447724,268,2616,318447456,318447724
29509,5,12,149,5745,-70,-97,27,5e:29:73:5b:30:00,318470861,272,22865,318470589,318470861
29510,5,12,149,5745,-61,-97,36,3e:d1:9b:c7:a4:de,318471365,272,232,318471093,318471365
29511,5,12,149,5745,-61,-97,36,56:68:e2:c2:8d:d5,318475566,280,3921,318475286,318475566
29512,5,12,149,5745,-70,-97,27,d2:00:04:7e:2c:ab,318477268,244,1458,318477024,318477268
29513,5,12,149,5745,-70,-97,27,d2:00:04:7e:2c:ab,318482021,440,4313,318481581,318482021
29514,5,12,149,5745,-69,-97,28,96:a3:af:37:f7:5e,318497396,244,15131,318497152,318497396
29515,5,12,149,5745,-59,-97,38,22:ec:75:a8:8a:31,318530457,244,32817,318530213,318530457
29516,5,24,149,5745,-82,-97,15,,318537056,32,6567,318537024,318537056
29517,5,24,149,5745,-82,-97,15,,318537249,32,161,318537217,318537249
29518,5,12,149,5745,-90,-97,7,9a:24:38:da:96:bb,318547340,272,9819,318547068,318547340
29519,5,12,149,5745,-70,-97,27,6a:1e:a4:f8:14:49,318563254,284,15630,318562970,318563254
29520,5,12,149,5745,-71,-97,26,f2:da:61:dd:98:c5,318564114,268,592,318563846,318564114
29521,5,12,149,5745,-53,-97,44,a6:92:ad:b7:76:65,318573670,284,9272,318573386,318573670
29522,5,12,149,5745,-63,-97,34,56:68:e2:c2:8d:d5,318575995,280,2045,318575715,318575995
29523,5,12,149,5745,-73,-97,24,5e:29:73:5b:30:00,318587793,272,11526,318587521,318587793
29524,5,12,149,5745,-60,-97,37,3e:d1:9b:c7:a4:de,318588445,272,380,318588173,318588445
29525,5,24,149,5745,-82,-97,15,,318596024,28,7551,318595996,318596024
29526,5,24,149,5745,-82,-97,15,,318596069,28,17,318596041,318596069
29527,5,24,149,5745,-82,-97,15,,318596177,32,76,318596145,318596177
29528,5,12,149,5745,-71,-97,26,d2:00:04:7e:2c:ab,318603487,244,7066,318603243,318603487
29529,5,12,149,5745,-86,-97,11,7e:05:42:11:d2:ec,318603737,440,-190,318603297,318603737
29530,5,24,149,5745,-82,-97,15,,318613826,28,10061,318613798,318613826
29531,5,24,149,5745,-82,-97,15,,318613870,28,16,318613842,318613870
29532,5,24,149,5745,-82,-97,15,,318613978,32,76,318613946,318613978
29533,5,24,149,5745,-65,-97,32,,318642209,28,28203,318642181,318642209
29534,5,24,149,5745,-81,-97,16,,318642253,28,16,318642225,318642253
29535,5,24,149,5745,-81,-97,16,,318642361,28,80,318642333,318642361
29536,5,12,149,5745,-62,-97,35,22:ec:75:a8:8a:31,318646945,244,4340,318646701,318646945
29537,5,6,149,5745,-91,-97,6,54:e4:3a:ec:fb:65,318652999,360,5694,318652639,318652999
29538,5,12,149,5745,-72,-97,25,96:a3:af:37:f7:5e,318654745,244,1502,318654501,318654745
29539,5,12,149,5745,-88,-97,9,9a:24:38:da:96:bb,318662769,272,7752,318662497,318662769
29540,5,24,149,5745,-80,-97,17,,318671189,32,8388,318671157,318671189
29541,5,24,149,5745,-80,-97,17,,318671670,32,449,318671638,318671670
29542,5,24,149,5745,-80,-97,17,,318672152,28,454,318672124,318672152
29543,5,12,149,5745,-55,-97,42,a6:92:ad:b7:76:65,318675439,284,3003,318675155,318675439
29544,5,12,149,5745,-67,-97,30,56:68:e2:c2:8d:d5,318678268,280,2549,318677988,318678268
29545,5,12,149,5745,-74,-97,23,5e:29:73:5b:30:00,318700613,272,22073,318700341,318700613
29546,5,12,149,5745,-62,-97,35,3e:d1:9b:c7:a4:de,318706971,272,6086,318706699,318706971
29547,5,24,149,5745,-80,-97,17,,318715407,32,8404,318715375,318715407
29548,5,24,149,5745,-80,-97,17,,318715793,28,358,318715765,318715793
29549,5,6,149,5745,-89,-97,8,,318715952,68,91,318715884,318715952
29550,5,24,149,5745,-66,-97,31,,318718615,28,2635,318718587,318718615
29551,5,24,149,5745,-80,-97,17,,318718659,28,16,318718631,318718659
29552,5,24,149,5745,-80,-97,17,,318718767,28,80,318718739,318718767
29553,5,12,149,5745,-71,-97,26,6a:1e:a4:f8:14:49,318750142,284,31091,318749858,318750142
29554,5,12,149,5745,-73,-97,24,f2:da:61:dd:98:c5,318756500,268,6090,318756232,318756500
29555,5,12,149,5745,-71,-97,26,96:a3:af:37:f7:5e,318757385,244,641,318757141,318757385
29556,5,12,149,5745,-61,-97,36,22:ec:75:a8:8a:31,318762700,244,5071,318762456,318762700
29557,5,12,149,5745,-59,-97,38,a6:92:ad:b7:76:65,318777903,284,14919,318777619,318777903
29558,5,12,149,5745,-67,-97,30,56:68:e2:c2:8d:d5,318780325,280,2142,318780045,318780325
29559,5,12,149,5745,-71,-97,26,6a:1e:a4:f8:14:49,318786178,284,5569,318785894,318786178
29560,5,12,149,5745,-74,-97,23,f2:da:61:dd:98:c5,318792707,268,6261,318792439,318792707
29561,5,24,149,5745,-80,-97,17,,318804054,32,11315,318804022,318804054
29562,5,12,149,5745,-73,-97,24,5e:29:73:5b:30:00,318812677,272,8351,318812405,318812677
29563,5,24,149,5745,-81,-97,16,,318819829,28,7124,318819801,318819829
29564,5,24,149,5745,-80,-97,17,,318819873,28,16,318819845,318819873
29565,5,24,149,5745,-80,-97,17,,318819981,32,76,318819949,318819981
29566,5,12,149,5745,-61,-97,36,3e:d1:9b:c7:a4:de,318820083,272,-170,318819811,318820083
29567,5,24,149,5745,-80,-97,17,,318820872,32,757,318820840,318820872
29568,5,24,149,5745,-80,-97,17,,318821159,28,259,318821131,318821159
29569,5,24,149,5745,-88,-97,9,,318821202,28,15,318821174,318821202
29570,5,6,149,5745,-89,-97,8,,318821319,68,49,318821251,318821319
29571,5,12,149,5745,-74,-97,23,d2:00:04:7e:2c:ab,318833316,244,11753,318833072,318833316
29572,5,24,149,5745,-80,-97,17,,318837361,28,4017,318837333,318837361
29573,5,24,149,5745,-81,-97,16,,318837406,28,17,318837378,318837406
29574,5,24,149,5745,-82,-97,15,,318837513,32,75,318837481,318837513
29575,5,12,149,5745,-72,-97,25,96:a3:af:37:f7:5e,318839104,244,1347,318838860,318839104
29576,5,12,149,5745,-89,-97,8,9a:24:38:da:96:bb,318842257,272,2881,318841985,318842257
29577,5,12,149,5745,-59,-97,38,a6:92:ad:b7:76:65,318855383,284,12842,318855099,318855383
29578,5,12,149,5745,-73,-97,24,96:a3:af:37:f7:5e,318855710,440,-113,318855270,318855710
29579,5,6,149,5745,-90,-97,7,54:e4:3a:ec:fb:65,318857799,360,1729,318857439,318857799
29580,5,12,149,5745,-72,-97,25,5e:29:73:5b:30:00,318860429,540,2090,318859889,318860429
29581,5,12,149,5745,-76,-97,21,f2:da:61:dd:98:c5,318861202,268,505,318860934,318861202
29582,5,12,149,5745,-71,-97,26,6a:1e:a4:f8:14:49,318863125,480,1443,318862645,318863125
29583,5,12,149,5745,-60,-97,37,3e:d1:9b:c7:a4:de,318863657,544,-12,318863113,318863657
29584,5,24,149,5745,-81,-97,16,,318864677,32,988,318864645,318864677
29585,5,12,149,5745,-92,-97,5,46:28:71:6e:d2:2e,318866695,280,1738,318866415,318866695
29586,5,12,149,5745,-62,-97,35,f6:0a:5c:59:72:df,318869274,280,2299,318868994,318869274
29587,5,12,149,5745,-64,-97,33,56:68:e2:c2:8d:d5,318870632,476,882,318870156,318870632
29588,5,12,149,5745,-65,-97,32,56:68:e2:c2:8d:d5,318871557,280,645,318871277,318871557
29589,5,12,149,5745,-59,-97,38,a6:92:ad:b7:76:65,318872690,484,649,318872206,318872690
29590,5,12,149,5745,-74,-97,23,d2:00:04:7e:2c:ab,318874515,440,1385,318874075,318874515
29591,5,12,149,5745,-61,-97,36,22:ec:75:a8:8a:31,318877240,516,2209,318876724,318877240
29592,5,12,149,5745,-88,-97,9,9a:24:38:da:96:bb,318884590,272,7078,318884318,318884590
29593,5,12,149,5745,-61,-97,36,22:ec:75:a8:8a:31,318886592,244,1758,318886348,318886592
29594,5,12,149,5745,-70,-97,27,6a:1e:a4:f8:14:49,318888697,284,1821,318888413,318888697
29595,5,12,149,5745,-76,-97,21,f2:da:61:dd:98:c5,318890259,268,1294,318889991,318890259
29596,5,12,149,5745,-62,-97,35,f6:0a:5c:59:72:df,318897509,280,6970,318897229,318897509
29597,5,12,149,5745,-74,-97,23,96:a3:af:37:f7:5e,318920854,440,22905,318920414,318920854
29598,5,12,149,5745,-92,-97,5,46:28:71:6e:d2:2e,318923060,280,1926,318922780,318923060
29599,5,12,149,5745,-76,-97,21,f2:da:61:dd:98:c5,318923776,268,448,318923508,318923776
29600,5,12,149,5745,-89,-97,8,9a:24:38:da:96:bb,318924468,824,-132,318923644,318924468
29601,5,12,149,5745,-69,-97,28,5e:29:73:5b:30:00,318925734,540,726,318925194,318925734
29602,5,12,149,5745,-73,-97,24,6a:1e:a4:f8:14:49,318926335,480,121,318925855,318926335
29603,5,12,149,5745,-60,-97,37,3e:d1:9b:c7:a4:de,318928245,544,1366,318927701,318928245
29604,5,12,149,5745,-62,-97,35,f6:0a:5c:59:72:df,318928904,280,379,318928624,318928904
29605,5,12,149,5745,-87,-97,10,7e:05:42:11:d2:ec,318929677,468,305,318929209,318929677
29606,5,12,149,5745,-66,-97,31,56:68:e2:c2:8d:d5,318932901,476,2748,318932425,318932901
29607,5,12,149,5745,-87,-97,10,7e:05:42:11:d2:ec,318935613,104,2608,318935509,318935613
29608,5,12,149,5745,-73,-97,24,d2:00:04:7e:2c:ab,318935841,244,-16,318935597,318935841
29609,5,12,149,5745,-75,-97,22,96:a3:af:37:f7:5e,318937326,244,1241,318937082,318937326
29610,5,12,149,5745,-69,-97,28,5e:29:73:5b:30:00,318938783,272,1185,318938511,318938783
29611,5,12,149,5745,-57,-97,40,a6:92:ad:b7:76:65,318939089,484,-178,318938605,318939089
29612,5,12,149,5745,-73,-97,24,d2:00:04:7e:2c:ab,318940545,440,1016,318940105,318940545
29613,5,12,149,5745,-67,-97,30,0a:b9:b7:b1:4d:fa,318942180,268,1367,318941912,318942180
29614,5,12,149,5745,-60,-97,37,22:ec:75:a8:8a:31,318942482,516,-214,318941966,318942482
29615,5,12,149,5745,-60,-97,37,3e:d1:9b:c7:a4:de,318953709,272,10955,318953437,318953709
29616,5,6,149,5745,-90,-97,7,54:e4:3a:ec:fb:65,318960201,360,6132,318959841,318960201
29617,5,24,149,5745,-83,-97,14,,318966709,28,6480,318966681,318966709
29618,5,24,149,5745,-80,-97,17,,318966753,28,16,318966725,318966753
29619,5,24,149,5745,-81,-97,16,,318966861,32,76,318966829,318966861
29620,5,12,149,5745,-56,-97,41,a6:92:ad:b7:76:65,318970239,284,3094,318969955,318970239
29621,5,12,149,5745,-91,-97,6,46:28:71:6e:d2:2e,318982512,280,11993,318982232,318982512
29622,5,24,149,5745,-80,-97,17,,318985272,28,2732,318985244,318985272
29623,5,24,149,5745,-84,-97,13,,318985316,28,16,318985288,318985316
29624,5,24,149,5745,-83,-97,14,,318985424,32,76,318985392,318985424
29625,5,12,149,5745,-59,-97,38,22:ec:75:a8:8a:31,318992183,244,6515,318991939,318992183
29626,5,12,149,5745,-89,-97,8,9a:24:38:da:96:bb,318997428,272,4973,318997156,318997428
29627,5,12,149,5745,-66,-97,31,56:68:e2:c2:8d:d5,318999359,280,1651,318999079,318999359
29628,5,12,149,5745,-74,-97,23,6a:1e:a4:f8:14:49,319010786,284,11143,319010502,319010786
29629,5,12,149,5745,-76,-97,21,f2:da:61:dd:98:c5,319017655,268,6601,319017387,319017655
29630,5,24,149,5745,-83,-97,14,,319020186,28,2503,319020158,319020186
29631,5,24,149,5745,-81,-97,16,,319020230,28,16,319020202,319020230
29632,5,24,149,5745,-81,-97,16,,319020391,32,129,319020359,319020391
29633,5,24,149,5745,-85,-97,12,,319025244,28,4825,319025216,319025244
29634,5,24,149,5745,-81,-97,16,,319025287,28,15,319025259,319025287
29635,5,24,149,5745,-80,-97,17,,319025400,32,81,319025368,319025400
29636,5,24,149,5745,-81,-97,16,,319038376,28,12948,319038348,319038376
29637,5,24,149,5745,-85,-97,12,,319038421,28,17,319038393,319038421
29638,5,24,149,5745,-85,-97,12,,319038536,32,83,319038504,319038536
29639,5,24,149,5745,-81,-97,16,,319039800,28,1236,319039772,319039800
29640,5,24,149,5745,-84,-97,13,,319039844,28,16,319039816,319039844
29641,5,24,149,5745,-84,-97,13,,319039952,32,76,319039920,319039952
29642,5,12,149,5745,-69,-97,28,5e:29:73:5b:30:00,319042216,272,1992,319041944,319042216
29643,5,24,149,5745,-84,-97,13,,319042632,28,388,319042604,319042632
29644,5,24,149,5745,-80,-97,17,,319042676,28,16,319042648,319042676
29645,5,24,149,5745,-81,-97,16,,319042784,32,76,319042752,319042784
29646,5,12,149,5745,-60,-97,37,3e:d1:9b:c7:a4:de,319046277,272,3221,319046005,319046277
29647,5,12,149,5745,-77,-97,20,d2:00:04:7e:2c:ab,319054579,244,8058,319054335,319054579
29648,5,6,149,5745,-93,-97,4,54:e4:3a:ec:fb:65,319062601,360,7662,319062241,319062601
29649,5,12,149,5745,-72,-97,25,96:a3:af:37:f7:5e,319068820,244,5975,319068576,319068820
29650,5,12,149,5745,-57,-97,40,a6:92:ad:b7:76:65,319087082,284,17978,319086798,319087082
29651,5,12,149,5745,-90,-97,7,46:28:71:6e:d2:2e,319097734,280,10372,319097454,319097734
29652,5,12,149,5745,-67,-97,30,56:68:e2:c2:8d:d5,319100296,280,2282,319100016,319100296
29653,5,24,149,5745,-64,-97,33,,319103168,28,2844,319103140,319103168
29654,5,24,149,5745,-82,-97,15,,319103212,28,16,319103184,319103212
29655,5,24,149,5745,-81,-97,16,,319103320,28,80,319103292,319103320
29656,5,12,149,5745,-60,-97,37,22:ec:75:a8:8a:31,319109287,244,5723,319109043,319109287
29657,5,12,149,5745,-87,-97,10,9a:24:38:da:96:bb,319113186,272,3627,319112914,319113186
29658,5,24,149,5745,-81,-97,16,,319118662,28,5448,319118634,319118662
29659,5,24,149,5745,-83,-97,14,,319118706,28,16,319118678,319118706
29660,5,24,149,5745,-84,-97,13,,319118818,32,80,319118786,319118818
29661,5,24,149,5745,-81,-97,16,,319120885,28,2039,319120857,319120885
29662,5,24,149,5745,-83,-97,14,,319120929,28,16,319120901,319120929
29663,5,24,149,5745,-84,-97,13,,319121037,32,76,319121005,319121037
29664,5,24,149,5745,-83,-97,14,,319121978,28,913,319121950,319121978
29665,5,24,149,5745,-82,-97,15,,319122022,28,16,319121994,319122022
29666,5,24,149,5745,-81,-97,16,,319122130,32,76,319122098,319122130
29667,5,24,149,5745,-81,-97,16,,319124017,28,1859,319123989,319124017
29668,5,24,149,5745,-83,-97,14,,319124061,28,16,319124033,319124061
29669,5,24,149,5745,-84,-97,13,,319124172,32,79,319124140,319124172
29670,5,24,149,5745,-82,-97,15,,319125739,28,1539,319125711,319125739
29671,5,24,149,5745,-85,-97,12,,319125783,28,16,319125755,319125783
29672,5,24,149,5745,-84,-97,13,,319125891,32,76,319125859,319125891
29673,5,12,149,5745,-85,-97,12,7e:05:42:11:d2:ec,319126419,468,60,319125951,319126419
29674,5,24,149,5745,-84,-97,13,,319127074,28,627,319127046,319127074
29675,5,24,149,5745,-81,-97,16,,319127118,28,16,319127090,319127118
29676,5,24,149,5745,-81,-97,16,,319127227,32,77,319127195,319127227
29677,5,24,149,5745,-80,-97,17,,319140735,28,13480,319140707,319140735
29678,5,24,149,5745,-83,-97,14,,319140779,28,16,319140751,319140779
29679,5,24,149,5745,-83,-97,14,,319140887,32,76,319140855,319140887
29680,5,12,149,5745,-62,-97,35,f6:0a:5c:59:72:df,319141657,280,490,319141377,319141657
29681,5,24,149,5745,-83,-97,14,,319154475,28,12790,319154447,319154475
29682,5,24,149,5745,-80,-97,17,,319154519,28,16,319154491,319154519
29683,5,24,149,5745,-80,-97,17,,319154628,32,77,319154596,319154628
29684,5,12,149,5745,-71,-97,26,5e:29:73:5b:30:00,319156069,272,1169,319155797,319156069
29685,5,12,149,5745,-70,-97,27,6a:1e:a4:f8:14:49,319161655,284,5302,319161371,319161655
29686,5,12,149,5745,-62,-97,35,3e:d1:9b:c7:a4:de,319163487,272,1560,319163215,319163487
29687,5,6,149,5745,-90,-97,7,54:e4:3a:ec:fb:65,319165001,360,1154,319164641,319165001
29688,5,12,149,5745,-74,-97,23,f2:da:61:dd:98:c5,319165898,268,629,319165630,319165898
29689,5,12,149,5745,-74,-97,23,96:a3:af:37:f7:5e,319178773,244,12631,319178529,319178773
29690,5,12,149,5745,-75,-97,22,d2:00:04:7e:2c:ab,319189289,244,10272,319189045,319189289
29691,5,12,149,5745,-58,-97,39,a6:92:ad:b7:76:65,319200198,284,10625,319199914,319200198
29692,5,12,149,5745,-91,-97,6,46:28:71:6e:d2:2e,319211501,280,11023,319211221,319211501
29693,5,12,149,5745,-85,-97,12,9a:24:38:da:96:bb,319221963,272,10190,319221691,319221963
29694,5,12,149,5745,-58,-97,39,22:ec:75:a8:8a:31,319226504,244,4297,319226260,319226504
29695,5,24,149,5745,-81,-97,16,,319245444,28,18912,319245416,319245444
29696,5,24,149,5745,-80,-97,17,,319245488,28,16,319245460,319245488
29697,5,24,149,5745,-80,-97,17,,319245597,32,77,319245565,319245597
29698,5,12,149,5745,-74,-97,23,6a:1e:a4:f8:14:49,319262365,284,16484,319262081,319262365
29699,5,24,149,5745,-81,-97,16,,319262979,28,586,319262951,319262979
29700,5,24,149,5745,-81,-97,16,,319263024,28,17,319262996,319263024
29701,5,24,149,5745,-81,-97,16,,319263132,32,76,319263100,319263132
29702,5,6,149,5745,-93,-97,4,54:e4:3a:ec:fb:65,319267402,360,3910,319267042,319267402
29703,5,6,149,5745,-61,-97,36,48:74:12:82:d8:d5,319267870,248,220,319267622,319267870
29704,5,12,149,5745,-75,-97,22,f2:da:61:dd:98:c5,319268146,268,8,319267878,319268146
29705,5,12,149,5745,-71,-97,26,5e:29:73:5b:30:00,319273194,272,4776,319272922,319273194
29706,5,6,149,5745,-61,-97,36,48:74:12:82:d8:d5,319273732,264,274,319273468,319273732
29707,5,12,149,5745,-62,-97,35,f6:0a:5c:59:72:df,319274790,280,778,319274510,319274790
29708,5,6,149,5745,-61,-97,36,48:74:12:82:d8:d5,319275111,256,65,319274855,319275111
29709,5,12,149,5745,-62,-97,35,3e:d1:9b:c7:a4:de,319276537,272,1154,319276265,319276537
29710,5,12,149,5745,-72,-97,25,96:a3:af:37:f7:5e,319284229,244,7448,319283985,319284229
29711,5,12,149,5745,-75,-97,22,d2:00:04:7e:2c:ab,319291513,244,7040,319291269,319291513
29712,5,12,149,5745,-67,-97,30,56:68:e2:c2:8d:d5,319294243,280,2450,319293963,319294243
29713,5,12,149,5745,-67,-97,30,56:68:e2:c2:8d:d5,319314015,280,19492,319313735,319314015
29714,5,12,149,5745,-73,-97,24,96:a3:af:37:f7:5e,319314356,440,-99,319313916,319314356
29715,5,12,149,5745,-57,-97,40,a6:92:ad:b7:76:65,319314839,284,199,319314555,319314839
29716,5,12,149,5745,-89,-97,8,46:28:71:6e:d2:2e,319316084,280,965,319315804,319316084
29717,5,12,149,5745,-87,-97,10,9a:24:38:da:96:bb,319318707,824,1799,319317883,319318707
29718,5,12,149,5745,-75,-97,22,f2:da:61:dd:98:c5,319319601,268,626,319319333,319319601
29719,5,12,149,5745,-72,-97,25,5e:29:73:5b:30:00,319321658,540,1517,319321118,319321658
29720,5,12,149,5745,-73,-97,24,6a:1e:a4:f8:14:49,319323006,480,868,319322526,319323006
29721,5,12,149,5745,-62,-97,35,f6:0a:5c:59:72:df,319323628,280,342,319323348,319323628
29722,5,12,149,5745,-60,-97,37,3e:d1:9b:c7:a4:de,319324114,544,-58,319323570,319324114
29723,5,12,149,5745,-67,-97,30,56:68:e2:c2:8d:d5,319328031,476,3441,319327555,319328031
29724,5,12,149,5745,-72,-97,25,6a:1e:a4:f8:14:49,319331124,284,2809,319330840,319331124
29725,5,12,149,5745,-57,-97,40,a6:92:ad:b7:76:65,319331487,484,-121,319331003,319331487
29726,5,12,149,5745,-87,-97,10,9a:24:38:da:96:bb,319333095,272,1336,319332823,319333095
29727,5,12,149,5745,-58,-97,39,22:ec:75:a8:8a:31,319341383,516,7772,319340867,319341383
29728,5,12,149,5745,-58,-97,39,22:ec:75:a8:8a:31,319345284,244,3657,319345040,319345284
29729,5,12,149,5745,-74,-97,23,f2:da:61:dd:98:c5,319348262,268,2710,319347994,319348262
29730,5,12,149,5745,-62,-97,35,f6:0a:5c:59:72:df,319348816,280,274,319348536,319348816
29731,5,6,149,5745,-91,-97,6,54:e4:3a:ec:fb:65,319369803,360,20627,319369443,319369803
29732,5,12,149,5745,-76,-97,21,96:a3:af:37:f7:5e,319379648,440,9405,319379208,319379648
29733,5,12,149,5745,-70,-97,27,5e:29:73:5b:30:00,319389160,272,9240,319388888,319389160
29734,5,12,149,5745,-58,-97,39,3e:d1:9b:c7:a4:de,319393276,272,3844,319393004,319393276
29735,5,12,149,5745,-76,-97,21,96:a3:af:37:f7:5e,319395410,244,1890,319395166,319395410
29736,5,12,149,5745,-56,-97,41,a6:92:ad:b7:76:65,319396845,484,951,319396361,319396845
29737,5,24,149,5745,-65,-97,32,,319409407,28,12534,319409379,319409407
29738,5,24,149,5745,-81,-97,16,,319409451,28,16,319409423,319409451
29739,5,24,149,5745,-65,-97,32,,319409641,28,162,319409613,319409641
29740,5,24,149,5745,-65,-97,32,,319410213,28,544,319410185,319410213
29741,5,6,149,5745,-65,-97,32,,319411054,52,789,319411002,319411054
29742,5,6,149,5745,-80,-97,17,,319411122,44,24,319411078,319411122
29743,5,24,149,5745,-80,-97,17,,319411239,28,89,319411211,319411239
29744,5,12,149,5745,-55,-97,42,a6:92:ad:b7:76:65,319412841,284,1318,319412557,319412841
29745,5,24,149,5745,-80,-97,17,,319430335,28,17466,319430307,319430335
29746,5,24,149,5745,-81,-97,16,,319430538,28,175,319430510,319430538
29747,5,24,149,5745,-81,-97,16,,319430896,28,330,319430868,319430896
29748,5,12,149,5745,-89,-97,8,9a:24:38:da:96:bb,319445233,272,14065,319444961,319445233
29749,5,12,149,5745,-76,-97,21,96:a3:af:37:f7:5e,319447062,440,1389,319446622,319447062
29750,5,12,149,5745,-73,-97,24,d2:00:04:7e:2c:ab,319449579,440,2077,319449139,319449579
29751,5,12,149,5745,-72,-97,25,f2:da:61:dd:98:c5,319450114,268,267,319449846,319450114
29752,5,12,149,5745,-89,-97,8,9a:24:38:da:96:bb,319451880,824,942,319451056,319451880
29753,5,12,149,5745,-70,-97,27,5e:29:73:5b:30:00,319452720,540,300,319452180,319452720
29754,5,12,149,5745,-85,-97,12,7e:05:42:11:d2:ec,319454705,468,1517,319454237,319454705
29755,5,12,149,5745,-60,-97,37,3e:d1:9b:c7:a4:de,319455581,544,332,319455037,319455581
29756,5,12,149,5745,-59,-97,38,22:ec:75:a8:8a:31,319457059,516,962,319456543,319457059
29757,5,12,149,5745,-59,-97,38,22:ec:75:a8:8a:31,319460021,244,2718,319459777,319460021
29758,5,12,149,5745,-69,-97,28,6a:1e:a4:f8:14:49,319460812,284,507,319460528,319460812
29759,5,12,149,5745,-72,-97,25,f2:da:61:dd:98:c5,319462905,268,1825,319462637,319462905
29760,5,12,149,5745,-55,-97,42,a6:92:ad:b7:76:65,319463216,484,-173,319462732,319463216
29761,5,12,149,5745,-67,-97,30,0a:b9:b7:b1:4d:fa,319466407,268,2923,319466139,319466407
29762,5,24,149,5745,-64,-97,33,,319485013,28,18578,319484985,319485013
29763,5,24,149,5745,-64,-97,33,,319485206,28,165,319485178,319485206
29764,5,6,149,5745,-64,-97,33,,319485388,52,130,319485336,319485388
29765,5,6,149,5745,-80,-97,17,,319485457,44,25,319485413,319485457
29766,5,24,149,5745,-80,-97,17,,319485574,28,89,319485546,319485574
29767,5,12,149,5745,-64,-97,33,56:68:e2:c2:8d:d5,319499458,280,13604,319499178,319499458
29768,5,12,149,5745,-70,-97,27,5e:29:73:5b:30:00,319503270,272,3540,319502998,319503270
29769,5,12,149,5745,-61,-97,36,3e:d1:9b:c7:a4:de,319506297,272,2755,319506025,319506297
29770,5,12,149,5745,-75,-97,22,96:a3:af:37:f7:5e,319523046,244,16505,319522802,319523046
29771,5,24,149,5745,-80,-97,17,,319533400,28,10326,319533372,319533400
29772,5,24,149,5745,-79,-97,18,,319533444,28,16,319533416,319533444
29773,5,24,149,5745,-79,-97,18,,319533553,32,77,319533521,319533553
29774,5,24,149,5745,-79,-97,18,,319539165,32,5580,319539133,319539165
29775,5,24,149,5745,-79,-97,18,,319539459,32,262,319539427,319539459
29776,5,12,149,5745,-56,-97,41,a6:92:ad:b7:76:65,319548430,284,8687,319548146,319548430
29777,5,24,149,5745,-79,-97,18,,319551957,28,3499,319551929,319551957
29778,5,24,149,5745,-80,-97,17,,319552001,28,16,319551973,319552001
29779,5,24,149,5745,-81,-97,16,,319552109,32,76,319552077,319552109
29780,5,12,149,5745,-90,-97,7,46:28:71:6e:d2:2e,319553016,280,627,319552736,319553016
29781,5,12,149,5745,-87,-97,10,9a:24:38:da:96:bb,319558589,272,5301,319558317,319558589
29782,5,12,149,5745,-59,-97,38,22:ec:75:a8:8a:31,319568039,244,9206,319567795,319568039
29783,5,12,149,5745,-71,-97,26,6a:1e:a4:f8:14:49,319572740,284,4417,319572456,319572740
29784,5,12,149,5745,-74,-97,23,f2:da:61:dd:98:c5,319581250,268,8242,319580982,319581250
29785,5,12,149,5745,-63,-97,34,f6:0a:5c:59:72:df,319595508,280,13978,319595228,319595508
29786,5,12,149,5745,-64,-97,33,56:68:e2:c2:8d:d5,319601342,280,5554,319601062,319601342
29787,5,12,149,5745,-75,-97,22,5e:29:73:5b:30:00,319622510,272,20896,319622238,319622510
29788,5,12,149,5745,-64,-97,33,3e:d1:9b:c7:a4:de,319623502,272,720,319623230,319623502
29789,5,12,149,5745,-84,-97,13,7e:05:42:11:d2:ec,319650994,468,27024,319650526,319650994
29790,5,6,149,5745,-93,-97,4,54:e4:3a:ec:fb:65,319677004,360,25650,319676644,319677004
29791,5,12,149,5745,-71,-97,26,96:a3:af:37:f7:5e,319678750,244,1502,319678506,319678750
29792,5,12,149,5745,-61,-97,36,22:ec:75:a8:8a:31,319683852,244,4858,319683608,319683852
29793,5,12,149,5745,-72,-97,25,6a:1e:a4:f8:14:49,319685697,284,1561,319685413,319685697
29794,5,12,149,5745,-70,-97,27,f2:da:61:dd:98:c5,319689772,268,3807,319689504,319689772
29795,5,12,149,5745,-57,-97,40,a6:92:ad:b7:76:65,319700588,284,10532,319700304,319700588
29796,5,12,149,5745,-67,-97,30,56:68:e2:c2:8d:d5,319702274,280,1406,319701994,319702274
29797,5,12,149,5745,-63,-97,34,f6:0a:5c:59:72:df,319710272,280,7718,319709992,319710272
29798,5,12,149,5745,-71,-97,26,5e:29:73:5b:30:00,319740459,272,29915,319740187,319740459
29799,5,12,149,5745,-58,-97,39,3e:d1:9b:c7:a4:de,319740820,272,89,319740548,319740820
29800,5,12,149,5745,-70,-97,27,96:a3:af:37:f7:5e,319779087,244,38023,319778843,319779087
29801,5,6,149,5745,-92,-97,5,54:e4:3a:ec:fb:65,319779405,360,-42,319779045,319779405
29802,5,12,149,5745,-89,-97,8,46:28:71:6e:d2:2e,319783662,280,3977,319783382,319783662
29803,5,12,149,5745,-87,-97,10,9a:24:38:da:96:bb,319787401,272,3467,319787129,319787401
29804,5,12,149,5745,-58,-97,39,a6:92:ad:b7:76:65,319799275,284,11590,319798991,319799275
29805,5,12,149,5745,-62,-97,35,22:ec:75:a8:8a:31,319800858,244,1339,319800614,319800858
29806,5,12,149,5745,-66,-97,31,56:68:e2:c2:8d:d5,319804976,280,3838,319804696,319804976
29807,5,24,149,5745,-80,-97,17,,319806543,32,1535,319806511,319806543
29808,5,24,149,5745,-79,-97,18,,319824734,28,18163,319824706,319824734
29809,5,6,149,5745,-90,-97,7,,319824894,68,92,319824826,319824894
29810,5,12,149,5745,-60,-97,37,3e:d1:9b:c7:a4:de,319852308,272,27142,319852036,319852308
29811,5,12,149,5745,-70,-97,27,5e:29:73:5b:30:00,319852669,272,89,319852397,319852669
29812,5,12,149,5745,-59,-97,38,a6:92:ad:b7:76:65,319867675,284,14722,319867391,319867675
29813,5,24,149,5745,-79,-97,18,,319868399,32,692,319868367,319868399
29814,5,12,149,5745,-72,-97,25,6a:1e:a4:f8:14:49,319877730,284,9047,319877446,319877730
29815,5,12,149,5745,-71,-97,26,96:a3:af:37:f7:5e,319881182,244,3208,319880938,319881182
29816,5,6,149,5745,-92,-97,5,54:e4:3a:ec:fb:65,319881806,360,264,319881446,319881806
29817,5,12,149,5745,-74,-97,23,f2:da:61:dd:98:c5,319882412,268,338,319882144,319882412
29818,5,12,149,5745,-90,-97,7,46:28:71:6e:d2:2e,319890222,280,7530,319889942,319890222
29819,5,12,149,5745,-65,-97,32,56:68:e2:c2:8d:d5,319890642,280,140,319890362,319890642
29820,5,6,149,5745,-85,-97,12,6e:9d:b4:09:66:28,319902117,164,11311,319901953,319902117
29821,5,6,149,5745,-92,-97,5,54:e4:3a:ec:fb:65,319902430,352,-39,319902078,319902430
29822,5,6,149,5745,-83,-97,14,,319902799,44,325,319902755,319902799
29823,5,12,149,5745,-72,-97,25,6a:1e:a4:f8:14:49,319904563,284,1480,319904279,319904563
29824,5,12,149,5745,-75,-97,22,f2:da:61:dd:98:c5,319906179,268,1348,319905911,319906179
29825,5,12,149,5745,-75,-97,22,f2:da:61:dd:98:c5,319906832,268,385,319906564,319906832
29826,5,12,149,5745,-71,-97,26,96:a3:af:37:f7:5e,319908250,440,978,319907810,319908250
29827,5,12,149,5745,-72,-97,25,5e:29:73:5b:30:00,319908778,540,-12,319908238,319908778
29828,5,12,149,5745,-73,-97,24,6a:1e:a4:f8:14:49,319909910,480,652,319909430,319909910
29829,5,12,149,5745,-66,-97,31,f6:0a:5c:59:72:df,319912694,280,2504,319912414,319912694
29830,5,12,149,5745,-61,-97,36,22:ec:75:a8:8a:31,319915052,516,1842,319914536,319915052
29831,5,12,149,5745,-59,-97,38,a6:92:ad:b7:76:65,319915719,484,183,319915235,319915719
29832,5,24,149,5745,-63,-97,34,,319917637,28,1890,319917609,319917637
29833,5,24,149,5745,-79,-97,18,,319917681,28,16,319917653,319917681
29834,5,24,149,5745,-80,-97,17,,319917789,28,80,319917761,319917789
29835,5,12,149,5745,-65,-97,32,56:68:e2:c2:8d:d5,319918521,476,256,319918045,319918521
29836,5,12,149,5745,-66,-97,31,f6:0a:5c:59:72:df,319921514,280,2713,319921234,319921514
29837,5,12,149,5745,-60,-97,37,3e:d1:9b:c7:a4:de,319921883,544,-175,319921339,319921883
29838,5,6,149,5745,-84,-97,13,6e:9d:b4:09:66:28,319924398,164,2351,319924234,319924398
29839,5,6,149,5745,-84,-97,13,,319925084,44,642,319925040,319925084
29840,5,12,149,5745,-61,-97,36,22:ec:75:a8:8a:31,319935110,244,9782,319934866,319935110
29841,5,24,149,5745,-79,-97,18,,319936191,28,1053,319936163,319936191
29842,5,12,149,5745,-71,-97,26,96:a3:af:37:f7:5e,319968803,244,32368,319968559,319968803
29843,5,12,149,5745,-64,-97,33,56:68:e2:c2:8d:d5,319969540,476,261,319969064,319969540
29844,5,12,149,5745,-73,-97,24,5e:29:73:5b:30:00,319970840,272,1028,319970568,319970840
29845,5,12,149,5745,-72,-97,25,96:a3:af:37:f7:5e,319973875,440,2595,319973435,319973875
29846,5,24,149,5745,-62,-97,35,,319977947,28,4044,319977919,319977947
29847,5,24,149,5745,-78,-97,19,,319977991,28,16,319977963,319977991
29848,5,24,149,5745,-78,-97,19,,319978099,28,80,319978071,319978099
29849,5,12,149,5745,-86,-97,11,7e:05:42:11:d2:ec,319978197,468,-370,319977729,319978197
29850,5,12,149,5745,-63,-97,34,22:ec:75:a8:8a:31,319979934,516,1221,319979418,319979934
29851,5,12,149,5745,-66,-97,31,f6:0a:5c:59:72:df,319980907,280,693,319980627,319980907
29852,5,12,149,5745,-75,-97,22,6a:1e:a4:f8:14:49,319981258,480,-129,319980778,319981258
29853,5,12,149,5745,-59,-97,38,a6:92:ad:b7:76:65,319981772,484,30,319981288,319981772
29854,5,12,149,5745,-73,-97,24,5e:29:73:5b:30:00,319983253,540,941,319982713,319983253
29855,5,12,149,5745,-76,-97,21,d2:00:04:7e:2c:ab,319984304,440,611,319983864,319984304
29856,5,12,149,5745,-65,-97,32,56:68:e2:c2:8d:d5,319985624,280,1040,319985344,319985624
29857,5,12,149,5745,-62,-97,35,3e:d1:9b:c7:a4:de,319985939,272,43,319985667,319985939
29858,5,12,149,5745,-59,-97,38,a6:92:ad:b7:76:65,319986263,284,40,319985979,319986263
29859,5,12,149,5745,-62,-97,35,3e:d1:9b:c7:a4:de,319986626,544,-181,319986082,319986626
29860,5,12,149,5745,-76,-97,21,f2:da:61:dd:98:c5,319987359,268,465,319987091,319987359
29861,5,12,149,5745,-76,-97,21,d2:00:04:7e:2c:ab,319988649,104,1186,319988545,319988649
29862,5,12,149,5745,-67,-97,30,0a:b9:b7:b1:4d:fa,319989750,268,833,319989482,319989750
29863,5,12,149,5745,-88,-97,9,9a:24:38:da:96:bb,320008927,272,18905,320008655,320008927
29864,5,12,149,5745,-76,-97,21,6a:1e:a4:f8:14:49,320020142,284,10931,320019858,320020142
29865,5,12,149,5745,-76,-97,21,f2:da:61:dd:98:c5,320020482,268,72,320020214,320020482
29866,5,12,149,5745,-61,-97,36,22:ec:75:a8:8a:31,320027910,244,7184,320027666,320027910
29867,5,24,149,5745,-82,-97,15,,320029103,28,1165,320029075,320029103
29868,5,24,149,5745,-78,-97,19,,320029148,28,17,320029120,320029148
29869,5,24,149,5745,-78,-97,19,,320029260,32,80,320029228,320029260
29870,5,24,149,5745,-77,-97,20,,320043537,28,14249,320043509,320043537
29871,5,24,149,5745,-82,-97,15,,320043581,28,16,320043553,320043581
29872,5,24,149,5745,-83,-97,14,,320043689,32,76,320043657,320043689
29873,5,12,149,5745,-63,-97,34,f6:0a:5c:59:72:df,320045919,280,1950,320045639,320045919
29874,5,24,149,5745,-82,-97,15,,320050997,28,5050,320050969,320050997
29875,5,24,149,5745,-78,-97,19,,320051041,28,16,320051013,320051041
29876,5,24,149,5745,-78,-97,19,,320051149,32,76,320051117,320051149
29877,5,24,149,5745,-78,-97,19,,320065991,28,14814,320065963,320065991
29878,5,24,149,5745,-82,-97,15,,320066034,28,15,320066006,320066034
29879,5,24,149,5745,-82,-97,15,,320066143,32,77,320066111,320066143
29880,5,24,149,5745,-78,-97,19,,320066336,28,165,320066308,320066336
29881,5,24,149,5745,-82,-97,15,,320066380,28,16,320066352,320066380
29882,5,24,149,5745,-82,-97,15,,320066488,32,76,320066456,320066488
29883,5,24,149,5745,-82,-97,15,,320069033,28,2517,320069005,320069033
29884,5,24,149,5745,-77,-97,20,,320069077,28,16,320069049,320069077
29885,5,24,149,5745,-78,-97,19,,320069190,32,81,320069158,320069190
29886,5,24,149,5745,-63,-97,34,,320069331,28,113,320069303,320069331
29887,5,24,149,5745,-78,-97,19,,320069375,28,16,320069347,320069375
29888,5,24,149,5745,-77,-97,20,,320069483,28,80,320069455,320069483
29889,5,24,149,5745,-82,-97,15,,320073596,28,4085,320073568,320073596
29890,5,24,149,5745,-77,-97,20,,320073640,28,16,320073612,320073640
29891,5,24,149,5745,-78,-97,19,,320073748,32,76,320073716,320073748
29892,5,12,149,5745,-72,-97,25,5e:29:73:5b:30:00,320078756,272,4736,320078484,320078756
29893,5,12,149,5745,-62,-97,35,3e:d1:9b:c7:a4:de,320082142,272,3114,320081870,320082142
29894,5,12,149,5745,-71,-97,26,96:a3:af:37:f7:5e,320086320,244,3934,320086076,320086320
29895,5,24,149,5745,-82,-97,15,,320086588,28,240,320086560,320086588
29896,5,24,149,5745,-81,-97,16,,320086696,32,76,320086664,320086696
29897,5,24,149,5745,-77,-97,20,,320086888,28,164,320086860,320086888
29898,5,24,149,5745,-82,-97,15,,320086932,28,16,320086904,320086932
29899,5,24,149,5745,-82,-97,15,,320087040,32,76,320087008,320087040
29900,5,12,149,5745,-58,-97,39,a6:92:ad:b7:76:65,320094135,284,6811,320093851,320094135
29901,5,12,149,5745,-65,-97,32,56:68:e2:c2:8d:d5,320110810,280,16395,320110530,320110810
29902,5,24,149,5745,-77,-97,20,,320122221,32,11379,320122189,320122221
29903,5,24,149,5745,-78,-97,19,,320122685,28,436,320122657,320122685
29904,5,24,149,5745,-63,-97,34,,320123327,28,614,320123299,320123327
29905,5,24,149,5745,-77,-97,20,,320123371,28,16,320123343,320123371
29906,5,24,149,5745,-77,-97,20,,320123479,28,80,320123451,320123479
29907,5,12,149,5745,-60,-97,37,22:ec:75:a8:8a:31,320143941,244,20218,320143697,320143941
29908,5,12,149,5745,-87,-97,10,7e:05:42:11:d2:ec,320181725,468,37316,320181257,320181725
29909,5,12,149,5745,-71,-97,26,6a:1e:a4:f8:14:49,320185596,284,3587,320185312,320185596
29910,5,12,149,5745,-63,-97,34,f6:0a:5c:59:72:df,320185944,280,68,320185664,320185944
29911,5,6,149,5745,-91,-97,6,54:e4:3a:ec:fb:65,320189007,360,2703,320188647,320189007
29912,5,12,149,5745,-73,-97,24,f2:da:61:dd:98:c5,320189990,268,715,320189722,320189990
29913,5,12,149,5745,-71,-97,26,5e:29:73:5b:30:00,320195681,272,5419,320195409,320195681
29914,5,12,149,5745,-62,-97,35,3e:d1:9b:c7:a4:de,320197882,272,1929,320197610,320197882
29915,5,12,149,5745,-73,-97,24,96:a3:af:37:f7:5e,320199374,244,1248,320199130,320199374
29916,5,12,149,5745,-55,-97,42,a6:92:ad:b7:76:65,320212620,284,12962,320212336,320212620
29917,5,12,149,5745,-66,-97,31,56:68:e2:c2:8d:d5,320222836,280,9936,320222556,320222836
29918,5,12,149,5745,-84,-97,13,9a:24:38:da:96:bb,320236944,272,13836,320236672,320236944
29919,5,12,149,5745,-59,-97,38,22:ec:75:a8:8a:31,320260256,244,23068,320260012,320260256
29920,5,12,149,5745,-69,-97,28,6a:1e:a4:f8:14:49,320287577,284,27037,320287293,320287577
29921,5,24,149,5745,-77,-97,20,,320290772,28,3167,320290744,320290772
29922,5,24,149,5745,-80,-97,17,,320290816,28,16,320290788,320290816
29923,5,24,149,5745,-79,-97,18,,320290925,32,77,320290893,320290925
29924,5,6,149,5745,-91,-97,6,54:e4:3a:ec:fb:65,320291408,360,123,320291048,320291408
29925,5,12,149,5745,-69,-97,28,f2:da:61:dd:98:c5,320292285,268,609,320292017,320292285
29926,5,24,149,5745,-81,-97,16,,320309943,28,17630,320309915,320309943
29927,5,24,149,5745,-78,-97,19,,320309987,28,16,320309959,320309987
29928,5,24,149,5745,-77,-97,20,,320310095,32,76,320310063,320310095
29929,5,12,149,5745,-70,-97,27,5e:29:73:5b:30:00,320312120,272,1753,320311848,320312120
29930,5,12,149,5745,-61,-97,36,3e:d1:9b:c7:a4:de,320315900,272,3508,320315628,320315900
29931,5,12,149,5745,-53,-97,44,a6:92:ad:b7:76:65,320331041,284,14857,320330757,320331041
29932,5,12,149,5745,-66,-97,31,56:68:e2:c2:8d:d5,320334138,280,2817,320333858,320334138
29933,5,12,149,5745,-88,-97,9,9a:24:38:da:96:bb,320346132,272,11722,320345860,320346132
29934,5,12,149,5745,-93,-97,4,46:28:71:6e:d2:2e,320361795,280,15383,320361515,320361795
29935,5,12,149,5745,-74,-97,23,6a:1e:a4:f8:14:49,320363313,284,1234,320363029,320363313
29936,5,12,149,5745,-66,-97,31,56:68:e2:c2:8d:d5,320364531,476,742,320364055,320364531
29937,5,12,149,5745,-63,-97,34,f6:0a:5c:59:72:df,320372701,280,7890,320372421,320372701
29938,5,12,149,5745,-55,-97,42,a6:92:ad:b7:76:65,320374212,484,1027,320373728,320374212
29939,5,12,149,5745,-63,-97,34,f6:0a:5c:59:72:df,320374846,280,354,320374566,320374846
29940,5,12,149,5745,-62,-97,35,22:ec:75:a8:8a:31,320376466,516,1104,320375950,320376466
29941,5,12,149,5745,-75,-97,22,6a:1e:a4:f8:14:49,320377025,480,79,320376545,320377025
29942,5,12,149,5745,-69,-97,28,5e:29:73:5b:30:00,320379240,540,1675,320378700,320379240
29943,5,12,149,5745,-62,-97,35,3e:d1:9b:c7:a4:de,320382189,544,2405,320381645,320382189
29944,5,12,149,5745,-72,-97,25,f2:da:61:dd:98:c5,320382823,268,366,320382555,320382823
29945,5,12,149,5745,-62,-97,35,22:ec:75:a8:8a:31,320393898,244,10831,320393654,320393898
29946,5,12,149,5745,-67,-97,30,5e:29:73:5b:30:00,320426697,272,32527,320426425,320426697
29947,5,12,149,5745,-60,-97,37,a6:92:ad:b7:76:65,320428209,284,1228,320427925,320428209
29948,5,12,149,5745,-59,-97,38,3e:d1:9b:c7:a4:de,320428781,272,300,320428509,320428781
29949,5,12,149,5745,-60,-97,37,a6:92:ad:b7:76:65,320439716,484,10451,320439232,320439716
29950,5,12,149,5745,-88,-97,9,7e:05:42:11:d2:ec,320440923,468,739,320440455,320440923
29951,5,12,149,5745,-63,-97,34,56:68:e2:c2:8d:d5,320449382,280,8179,320449102,320449382
29952,5,12,149,5745,-71,-97,26,6a:1e:a4:f8:14:49,320473179,284,23513,320472895,320473179
29953,5,12,149,5745,-86,-97,11,7e:05:42:11:d2:ec,320477997,272,4546,320477725,320477997
29954,5,12,149,5745,-73,-97,24,f2:da:61:dd:98:c5,320480507,268,2242,320480239,320480507
29955,5,12,149,5745,-89,-97,8,9a:24:38:da:96:bb,320480819,272,40,320480547,320480819
29956,5,12,149,5745,-60,-97,37,22:ec:75:a8:8a:31,320492230,244,11167,320491986,320492230
29957,5,12,149,5745,-88,-97,9,9a:24:38:da:96:bb,320494061,824,1007,320493237,320494061
29958,5,6,149,5745,-92,-97,5,54:e4:3a:ec:fb:65,320496209,360,1788,320495849,320496209
29959,5,12,149,5745,-60,-97,37,f6:0a:5c:59:72:df,320500627,280,4138,320500347,320500627
29960,5,12,149,5745,-85,-97,12,7e:05:42:11:d2:ec,320504042,468,2947,320503574,320504042
29961,5,12,149,5745,-60,-97,37,a6:92:ad:b7:76:65,320504571,484,45,320504087,320504571
29962,5,12,149,5745,-60,-97,37,22:ec:75:a8:8a:31,320506466,516,1379,320505950,320506466
29963,5,12,149,5745,-71,-97,26,5e:29:73:5b:30:00,320510309,540,3303,320509769,320510309
29964,5,12,149,5745,-58,-97,39,3e:d1:9b:c7:a4:de,320511883,544,1030,320511339,320511883
29965,5,12,149,5745,-68,-97,29,0a:b9:b7:b1:4d:fa,320512506,268,355,320512238,320512506
29966,5,12,149,5745,-72,-97,25,f2:da:61:dd:98:c5,320512977,268,203,320512709,320512977
29967,5,24,149,5745,-76,-97,21,,320518497,28,5492,320518469,320518497
29968,5,24,149,5745,-77,-97,20,,320518541,28,16,320518513,320518541
29969,5,24,149,5745,-77,-97,20,,320518650,32,77,320518618,320518650
29970,5,24,149,5745,-78,-97,19,,320536899,28,18221,320536871,320536899
29971,5,24,149,5745,-77,-97,20,,320536943,28,16,320536915,320536943
29972,5,24,149,5745,-76,-97,21,,320537051,32,76,320537019,320537051
29973,5,12,149,5745,-60,-97,37,a6:92:ad:b7:76:65,320543063,284,5728,320542779,320543063
29974,5,12,149,5745,-58,-97,39,3e:d1:9b:c7:a4:de,320543805,272,470,320543533,320543805
29975,5,12,149,5745,-68,-97,29,5e:29:73:5b:30:00,320545128,272,1051,320544856,320545128
29976,5,12,149,5745,-87,-97,10,9a:24:38:da:96:bb,320570479,272,25079,320570207,320570479
29977,5,12,149,5745,-71,-97,26,6a:1e:a4:f8:14:49,320585454,284,14691,320585170,320585454
29978,5,24,149,5745,-77,-97,20,,320589502,28,4020,320589474,320589502
29979,5,24,149,5745,-79,-97,18,,320589546,28,16,320589518,320589546
29980,5,24,149,5745,-78,-97,19,,320589654,32,76,320589622,320589654
29981,5,12,149,5745,-87,-97,10,7e:05:42:11:d2:ec,320597207,272,7281,320596935,320597207
29982,5,6,149,5745,-92,-97,5,54:e4:3a:ec:fb:65,320598609,360,1042,320598249,320598609
29983,5,12,149,5745,-73,-97,24,f2:da:61:dd:98:c5,320599757,268,880,320599489,320599757
29984,5,12,149,5745,-59,-97,38,22:ec:75:a8:8a:31,320601822,244,1821,320601578,320601822
29985,5,24,149,5745,-78,-97,19,,320607649,28,5799,320607621,320607649
29986,5,24,149,5745,-77,-97,20,,320607694,28,17,320607666,320607694
29987,5,24,149,5745,-78,-97,19,,320607802,32,76,320607770,320607802
29988,5,12,149,5745,-62,-97,35,56:68:e2:c2:8d:d5,320627539,280,19457,320627259,320627539
29989,5,12,149,5745,-70,-97,27,5e:29:73:5b:30:00,320651865,272,24054,320651593,320651865
29990,5,12,149,5745,-61,-97,36,3e:d1:9b:c7:a4:de,320656938,272,4801,320656666,320656938
29991,5,12,149,5745,-86,-97,11,9a:24:38:da:96:bb,320685602,272,28392,320685330,320685602
29992,5,12,149,5745,-73,-97,24,6a:1e:a4:f8:14:49,320698324,284,12438,320698040,320698324
29993,5,12,149,5745,-76,-97,21,f2:da:61:dd:98:c5,320711918,268,13326,320711650,320711918
29994,5,12,149,5745,-60,-97,37,22:ec:75:a8:8a:31,320718914,244,6752,320718670,320718914
29995,5,12,149,5745,-60,-97,37,a6:92:ad:b7:76:65,320723440,284,4242,320723156,320723440
29996,5,24,149,5745,-77,-97,20,,320741738,28,18270,320741710,320741738
29997,5,24,149,5745,-79,-97,18,,320741782,28,16,320741754,320741782
29998,5,24,149,5745,-79,-97,18,,320741891,32,77,320741859,320741891
29999,5,12,149,5745,-86,-97,11,7e:05:42:11:d2:ec,320743336,272,1173,320743064,320743336
30000,5,24,149,5745,-79,-97,18,,320760340,28,16976,320760312,320760340
30001,5,24,149,5745,-77,-97,20,,320760384,28,16,320760356,320760384
30002,5,24,149,5745,-77,-97,20,,320760492,32,76,320760460,320760492
30003,5,12,149,5745,-68,-97,29,5e:29:73:5b:30:00,320769828,272,9064,320769556,320769828
30004,5,12,149,5745,-61,-97,36,3e:d1:9b:c7:a4:de,320774151,272,4051,320773879,320774151
30005,5,12,149,5745,-84,-97,13,9a:24:38:da:96:bb,320794282,272,19859,320794010,320794282
30006,5,24,149,5745,-81,-97,16,,320804216,32,9902,320804184,320804216
30007,5,24,149,5745,-81,-97,16,,320804843,32,595,320804811,320804843
30008,5,12,149,5745,-70,-97,27,6a:1e:a4:f8:14:49,320809744,284,4617,320809460,320809744
30009,5,12,149,5745,-73,-97,24,f2:da:61:dd:98:c5,320819814,268,9802,320819546,320819814
30010,5,24,149,5745,-82,-97,15,,320821315,28,1473,320821287,320821315
30011,5,24,149,5745,-88,-97,9,,320821358,28,15,320821330,320821358
30012,5,6,149,5745,-89,-97,8,,320821475,68,49,320821407,320821475
30013,5,12,149,5745,-56,-97,41,a6:92:ad:b7:76:65,320822941,284,1182,320822657,320822941
30014,5,12,149,5745,-57,-97,40,22:ec:75:a8:8a:31,320835977,244,12792,320835733,320835977
30015,5,12,149,5745,-85,-97,12,7e:05:42:11:d2:ec,320846503,272,10254,320846231,320846503
30016,5,24,149,5745,-82,-97,15,,320865676,32,19141,320865644,320865676
30017,5,24,149,5745,-84,-97,13,,320865801,32,93,320865769,320865801
30018,5,12,149,5745,-67,-97,30,5e:29:73:5b:30:00,320881839,272,15766,320881567,320881839
30019,5,12,149,5745,-61,-97,36,3e:d1:9b:c7:a4:de,320885930,272,3819,320885658,320885930
30020,5,24,149,5745,-63,-97,34,,320916761,28,30803,320916733,320916761
30021,5,6,149,5745,-63,-97,34,,320917254,52,441,320917202,320917254
30022,5,6,149,5745,-84,-97,13,,320917323,44,25,320917279,320917323
30023,5,24,149,5745,-84,-97,13,,320917440,28,89,320917412,320917440
30024,5,12,149,5745,-57,-97,40,a6:92:ad:b7:76:65,320924611,284,6887,320924327,320924611
30025,5,24,149,5745,-82,-97,15,,320936194,32,11551,320936162,320936194
30026,5,24,149,5745,-82,-97,15,,320936712,32,486,320936680,320936712
30027,5,12,149,5745,-85,-97,12,7e:05:42:11:d2:ec,320937147,272,163,320936875,320937147
30028,5,24,149,5745,-82,-97,15,,320937543,28,368,320937515,320937543
30029,5,12,149,5745,-71,-97,26,f2:da:61:dd:98:c5,320940039,268,2228,320939771,320940039
30030,5,12,149,5745,-62,-97,35,f6:0a:5c:59:72:df,320945919,280,5600,320945639,320945919
30031,5,12,149,5745,-66,-97,31,56:68:e2:c2:8d:d5,320957339,476,10944,320956863,320957339
30032,5,12,149,5745,-60,-97,37,a6:92:ad:b7:76:65,320959100,484,1277,320958616,320959100
30033,5,12,149,5745,-56,-97,41,22:ec:75:a8:8a:31,320963691,516,4075,320963175,320963691
30034,5,12,149,5745,-67,-97,30,5e:29:73:5b:30:00,320966434,540,2203,320965894,320966434
30035,5,12,149,5745,-56,-97,41,22:ec:75:a8:8a:31,320967417,244,739,320967173,320967417
30036,5,24,149,5745,-83,-97,14,,320968582,28,1137,320968554,320968582
30037,5,24,149,5745,-78,-97,19,,320968626,28,16,320968598,320968626
30038,5,24,149,5745,-78,-97,19,,320968735,32,77,320968703,320968735
30039,5,12,149,5745,-60,-97,37,3e:d1:9b:c7:a4:de,320969863,544,584,320969319,320969863
30040,5,12,149,5745,-71,-97,26,f2:da:61:dd:98:c5,320972728,268,2597,320972460,320972728
30041,5,24,149,5745,-77,-97,20,,320986856,28,14100,320986828,320986856
30042,5,24,149,5745,-84,-97,13,,320986901,28,17,320986873,320986901
30043,5,24,149,5745,-83,-97,14,,320987008,32,75,320986976,320987008
30044,5,24,149,5745,-62,-97,35,,320992154,28,5118,320992126,320992154
30045,5,24,149,5745,-62,-97,35,,320992511,28,329,320992483,320992511
30046,5,6,149,5745,-61,-97,36,,320992891,52,328,320992839,320992891
30047,5,6,149,5745,-77,-97,20,,320992959,44,24,320992915,320992959
30048,5,24,149,5745,-77,-97,20,,320993077,28,90,320993049,320993077
30049,5,6,149,5745,-91,-97,6,54:e4:3a:ec:fb:65,320993378,352,-51,320993026,320993378
30050,5,12,149,5745,-62,-97,35,a6:92:ad:b7:76:65,321001876,284,8214,321001592,321001876
30051,5,12,149,5745,-70,-97,27,5e:29:73:5b:30:00,321003351,272,1203,321003079,321003351
30052,5,12,149,5745,-91,-97,6,46:28:71:6e:d2:2e,321016987,280,13356,321016707,321016987
30053,5,12,149,5745,-58,-97,39,3e:d1:9b:c7:a4:de,321018139,272,880,321017867,321018139
30054,5,12,149,5745,-75,-97,22,6a:1e:a4:f8:14:49,321019012,284,589,321018728,321019012
30055,5,12,149,5745,-67,-97,30,56:68:e2:c2:8d:d5,321020194,476,706,321019718,321020194
30056,5,12,149,5745,-60,-97,37,a6:92:ad:b7:76:65,321024664,484,3986,321024180,321024664
30057,5,12,149,5745,-89,-97,8,46:28:71:6e:d2:2e,321025233,280,289,321024953,321025233
30058,5,12,149,5745,-84,-97,13,7e:05:42:11:d2:ec,321028662,104,3325,321028558,321028662
30059,5,12,149,5745,-66,-97,31,f6:0a:5c:59:72:df,321028917,280,-25,321028637,321028917
30060,5,12,149,5745,-59,-97,38,22:ec:75:a8:8a:31,321029240,516,-193,321028724,321029240
30061,5,12,149,5745,-74,-97,23,6a:1e:a4:f8:14:49,321029862,284,338,321029578,321029862
30062,5,12,149,5745,-84,-97,13,7e:05:42:11:d2:ec,321030433,468,103,321029965,321030433
30063,5,12,149,5745,-69,-97,28,5e:29:73:5b:30:00,321031981,540,1008,321031441,321031981
30064,5,12,149,5745,-84,-97,13,7e:05:42:11:d2:ec,321034517,272,2264,321034245,321034517
30065,5,12,149,5745,-59,-97,38,3e:d1:9b:c7:a4:de,321035723,544,662,321035179,321035723
30066,5,12,149,5745,-73,-97,24,f2:da:61:dd:98:c5,321036302,268,311,321036034,321036302
30067,5,12,149,5745,-73,-97,24,f2:da:61:dd:98:c5,321036588,268,18,321036320,321036588
30068,5,12,149,5745,-67,-97,30,0a:b9:b7:b1:4d:fa,321037700,268,844,321037432,321037700
30069,5,12,149,5745,-65,-97,32,f6:0a:5c:59:72:df,321058015,280,20035,321057735,321058015
30070,5,12,149,5745,-62,-97,35,22:ec:75:a8:8a:31,321066493,244,8234,321066249,321066493
30071,5,12,149,5745,-68,-97,29,5e:29:73:5b:30:00,321111416,272,44651,321111144,321111416
30072,5,12,149,5745,-59,-97,38,3e:d1:9b:c7:a4:de,321115075,272,3387,321114803,321115075
30073,5,12,149,5745,-57,-97,40,a6:92:ad:b7:76:65,321126165,284,10806,321125881,321126165
30074,5,12,149,5745,-88,-97,9,9a:24:38:da:96:bb,321130940,272,4503,321130668,321130940
30075,5,12,149,5745,-83,-97,14,7e:05:42:11:d2:ec,321158576,272,27364,321158304,321158576
30076,5,12,149,5745,-61,-97,36,22:ec:75:a8:8a:31,321174210,244,15390,321173966,321174210
30077,5,24,149,5745,-80,-97,17,,321191394,28,17156,321191366,321191394
30078,5,24,149,5745,-82,-97,15,,321191438,28,16,321191410,321191438
30079,5,24,149,5745,-82,-97,15,,321191547,32,77,321191515,321191547
30080,5,24,149,5745,-82,-97,15,,321209422,28,17847,321209394,321209422
30081,5,24,149,5745,-80,-97,17,,321209466,28,16,321209438,321209466
30082,5,24,149,5745,-81,-97,16,,321209574,32,76,321209542,321209574
30083,5,12,149,5745,-70,-97,27,6a:1e:a4:f8:14:49,321209628,284,-230,321209344,321209628
30084,5,6,149,5745,-93,-97,4,54:e4:3a:ec:fb:65,321213012,360,3024,321212652,321213012
30085,5,12,149,5745,-75,-97,22,f2:da:61:dd:98:c5,321213921,268,641,321213653,321213921
30086,5,12,149,5745,-77,-97,20,d2:00:04:7e:2c:ab,321217488,412,3155,321217076,321217488
30087,5,12,149,5745,-70,-97,27,5e:29:73:5b:30:00,321228434,272,10674,321228162,321228434
30088,5,12,149,5745,-62,-97,35,3e:d1:9b:c7:a4:de,321232912,272,4206,321232640,321232912
30089,5,12,149,5745,-59,-97,38,a6:92:ad:b7:76:65,321234330,284,1134,321234046,321234330
30090,5,12,149,5745,-83,-97,14,7e:05:42:11:d2:ec,321266245,272,31643,321265973,321266245
30091,5,12,149,5745,-90,-97,7,46:28:71:6e:d2:2e,321268865,280,2340,321268585,321268865
30092,5,6,149,5745,-67,-97,30,0e:58:61:ad:22:7a,321277890,188,8837,321277702,321277890
30093,5,12,149,5745,-62,-97,35,22:ec:75:a8:8a:31,321288120,244,9986,321287876,321288120
30094,5,6,149,5745,-68,-97,29,0e:58:61:ad:22:7a,321290442,188,2134,321290254,321290442
30095,5,12,149,5745,-73,-97,24,6a:1e:a4:f8:14:49,321312596,284,21870,321312312,321312596
30096,5,12,149,5745,-73,-97,24,f2:da:61:dd:98:c5,321315365,268,2501,321315097,321315365
30097,5,12,149,5745,-71,-97,26,5e:29:73:5b:30:00,321345473,272,29836,321345201,321345473
30098,5,12,149,5745,-60,-97,37,a6:92:ad:b7:76:65,321346833,284,1076,321346549,321346833
30099,5,12,149,5745,-61,-97,36,3e:d1:9b:c7:a4:de,321350021,272,2916,321349749,321350021
30100,5,12,149,5745,-66,-97,31,56:68:e2:c2:8d:d5,321352073,280,1772,321351793,321352073
30101,5,12,149,5745,-86,-97,11,9a:24:38:da:96:bb,321357888,272,5543,321357616,321357888
30102,5,12,149,5745,-74,-97,23,6a:1e:a4:f8:14:49,321369962,284,11790,321369678,321369962
30103,5,12,149,5745,-92,-97,5,46:28:71:6e:d2:2e,321372004,280,1762,321371724,321372004
30104,5,12,149,5745,-70,-97,27,f2:da:61:dd:98:c5,321389063,268,16791,321388795,321389063
30105,5,12,149,5745,-85,-97,12,7e:05:42:11:d2:ec,321389780,272,445,321389508,321389780
30106,5,12,149,5745,-60,-97,37,f6:0a:5c:59:72:df,321398520,280,8460,321398240,321398520
30107,5,12,149,5745,-64,-97,33,22:ec:75:a8:8a:31,321409733,244,10969,321409489,321409733
30108,5,12,149,5745,-87,-97,10,9a:24:38:da:96:bb,321412002,824,1445,321411178,321412002
30109,5,12,149,5745,-67,-97,30,56:68:e2:c2:8d:d5,321413360,476,882,321412884,321413360
30110,5,12,149,5745,-58,-97,39,a6:92:ad:b7:76:65,321417960,484,4116,321417476,321417960
30111,5,24,149,5745,-80,-97,17,,321418551,28,563,321418523,321418551
30112,5,24,149,5745,-77,-97,20,,321418595,28,16,321418567,321418595
30113,5,24,149,5745,-77,-97,20,,321418703,32,76,321418671,321418703
30114,5,12,149,5745,-60,-97,37,f6:0a:5c:59:72:df,321423584,280,4601,321423304,321423584
30115,5,12,149,5745,-73,-97,24,6a:1e:a4:f8:14:49,321423952,132,236,321423820,321423952
30116,5,12,149,5745,-63,-97,34,22:ec:75:a8:8a:31,321424856,516,388,321424340,321424856
30117,5,12,149,5745,-85,-97,12,7e:05:42:11:d2:ec,321425451,468,127,321424983,321425451
30118,5,12,149,5745,-69,-97,28,5e:29:73:5b:30:00,321427835,540,1844,321427295,321427835
30119,5,12,149,5745,-70,-97,27,f2:da:61:dd:98:c5,321429013,268,910,321428745,321429013
30120,5,12,149,5745,-63,-97,34,3e:d1:9b:c7:a4:de,321429478,544,-79,321428934,321429478
30121,5,12,149,5745,-73,-97,24,6a:1e:a4:f8:14:49,321433899,284,4137,321433615,321433899
30122,5,24,149,5745,-78,-97,19,,321436438,28,2511,321436410,321436438
30123,5,24,149,5745,-80,-97,17,,321436482,28,16,321436454,321436482
30124,5,24,149,5745,-79,-97,18,,321436590,32,76,321436558,321436590
30125,5,12,149,5745,-59,-97,38,a6:92:ad:b7:76:65,321443823,284,6949,321443539,321443823
30126,5,12,149,5745,-62,-97,35,3e:d1:9b:c7:a4:de,321462256,272,18161,321461984,321462256
30127,5,12,149,5745,-69,-97,28,5e:29:73:5b:30:00,321462672,272,144,321462400,321462672
30128,5,12,149,5745,-87,-97,10,9a:24:38:da:96:bb,321467080,272,4136,321466808,321467080
30129,5,12,149,5745,-86,-97,11,7e:05:42:11:d2:ec,321488031,468,20483,321487563,321488031
30130,5,12,149,5745,-69,-97,28,6a:1e:a4:f8:14:49,321491163,284,2848,321490879,321491163
30131,5,12,149,5745,-87,-97,10,7e:05:42:11:d2:ec,321493222,272,1787,321492950,321493222
30132,5,12,149,5745,-72,-97,25,f2:da:61:dd:98:c5,321501598,268,8108,321501330,321501598
30133,5,12,149,5745,-62,-97,35,22:ec:75:a8:8a:31,321517962,244,16120,321517718,321517962
30134,5,12,149,5745,-87,-97,10,9a:24:38:da:96:bb,321542155,824,23369,321541331,321542155
30135,5,12,149,5745,-60,-97,37,a6:92:ad:b7:76:65,321548615,484,5976,321548131,321548615
30136,5,12,149,5745,-87,-97,10,7e:05:42:11:d2:ec,321553607,468,4524,321553139,321553607
30137,5,12,149,5745,-61,-97,36,22:ec:75:a8:8a:31,321554711,516,588,321554195,321554711
30138,5,12,149,5745,-60,-97,37,a6:92:ad:b7:76:65,321558645,284,3650,321558361,321558645
30139,5,12,149,5745,-70,-97,27,5e:29:73:5b:30:00,321558990,540,-195,321558450,321558990
30140,5,12,149,5745,-72,-97,25,f2:da:61:dd:98:c5,321559917,268,659,321559649,321559917
30141,5,12,149,5745,-59,-97,38,3e:d1:9b:c7:a4:de,321561446,544,985,321560902,321561446
30142,5,12,149,5745,-73,-97,24,0a:b9:b7:b1:4d:fa,321562942,268,1228,321562674,321562942
30143,5,12,149,5745,-76,-97,21,d2:00:04:7e:2c:ab,321563847,468,437,321563379,321563847
30144,5,12,149,5745,-71,-97,26,5e:29:73:5b:30:00,321576537,272,12418,321576265,321576537
30145,5,12,149,5745,-88,-97,9,9a:24:38:da:96:bb,321579236,272,2427,321578964,321579236
30146,5,12,149,5745,-59,-97,38,3e:d1:9b:c7:a4:de,321592414,272,12906,321592142,321592414
30147,5,12,149,5745,-88,-97,9,7e:05:42:11:d2:ec,321592720,272,34,321592448,321592720
30148,5,12,149,5745,-72,-97,25,6a:1e:a4:f8:14:49,321619231,284,26227,321618947,321619231
30149,5,12,149,5745,-71,-97,26,f2:da:61:dd:98:c5,321620881,268,1382,321620613,321620881
30150,5,6,149,5745,-93,-97,4,54:e4:3a:ec:fb:65,321622614,360,1373,321622254,321622614
30151,5,12,149,5745,-63,-97,34,22:ec:75:a8:8a:31,321635140,244,12282,321634896,321635140
30152,5,12,149,5745,-69,-97,28,5e:29:73:5b:30:00,321683001,272,47589,321682729,321683001
30153,5,12,149,5745,-58,-97,39,3e:d1:9b:c7:a4:de,321691685,272,8412,321691413,321691685
30154,5,12,149,5745,-87,-97,10,9a:24:38:da:96:bb,321692226,272,269,321691954,321692226
30155,5,24,149,5745,-76,-97,21,,321696977,28,4723,321696949,321696977
30156,5,24,149,5745,-80,-97,17,,321697022,28,17,321696994,321697022
30157,5,24,149,5745,-80,-97,17,,321697130,32,76,321697098,321697130
30158,5,24,149,5745,-80,-97,17,,321715025,28,17867,321714997,321715025
30159,5,24,149,5745,-76,-97,21,,321715069,28,16,321715041,321715069
30160,5,24,149,5745,-76,-97,21,,321715177,32,76,321715145,321715177
30161,5,12,149,5745,-71,-97,26,6a:1e:a4:f8:14:49,321726197,284,10736,321725913,321726197
30162,5,12,149,5745,-72,-97,25,f2:da:61:dd:98:c5,321727378,268,913,321727110,321727378
30163,5,12,149,5745,-63,-97,34,22:ec:75:a8:8a:31,321752194,244,24572,321751950,321752194
30164,5,12,149,5745,-60,-97,37,f6:0a:5c:59:72:df,321754607,280,2133,321754327,321754607
30165,5,12,149,5745,-86,-97,11,7e:05:42:11:d2:ec,321767382,272,12503,321767110,321767382
30166,5,24,149,5745,-67,-97,30,,321779763,28,12353,321779735,321779763
30167,5,24,149,5745,-82,-97,15,,321779807,28,16,321779779,321779807
30168,5,24,149,5745,-81,-97,16,,321779915,28,80,321779887,321779915
30169,5,24,149,5745,-67,-97,30,,321780314,28,371,321780286,321780314
30170,5,24,149,5745,-81,-97,16,,321780358,28,16,321780330,321780358
30171,5,24,149,5745,-81,-97,16,,321780466,28,80,321780438,321780466
30172,5,24,149,5745,-81,-97,16,,321781602,32,1104,321781570,321781602
30173,5,24,149,5745,-81,-97,16,,321782165,32,531,321782133,321782165
30174,5,24,149,5745,-81,-97,16,,321782728,28,535,321782700,321782728
30175,5,24,149,5745,-67,-97,30,,321785082,28,2326,321785054,321785082
30176,5,24,149,5745,-82,-97,15,,321785126,28,16,321785098,321785126
30177,5,24,149,5745,-81,-97,16,,321785246,28,92,321785218,321785246
30178,5,24,149,5745,-67,-97,30,,321788035,28,2761,321788007,321788035
30179,5,24,149,5745,-81,-97,16,,321788079,28,16,321788051,321788079
30180,5,24,149,5745,-82,-97,15,,321788187,28,80,321788159,321788187
30181,5,24,149,5745,-82,-97,15,,321793607,32,5388,321793575,321793607
30182,5,12,149,5745,-70,-97,27,5e:29:73:5b:30:00,321801660,272,7781,321801388,321801660
30183,5,24,149,5745,-82,-97,15,,321805899,28,4211,321805871,321805899
30184,5,24,149,5745,-82,-97,15,,321806267,28,340,321806239,321806267
30185,5,24,149,5745,-68,-97,29,,321807888,28,1593,321807860,321807888
30186,5,24,149,5745,-82,-97,15,,321807932,28,16,321807904,321807932
30187,5,24,149,5745,-83,-97,14,,321808052,28,92,321808024,321808052
30188,5,24,149,5745,-68,-97,29,,321808196,28,116,321808168,321808196
30189,5,24,149,5745,-83,-97,14,,321808240,28,16,321808212,321808240
30190,5,24,149,5745,-83,-97,14,,321808348,28,80,321808320,321808348
30191,5,12,149,5745,-61,-97,36,3e:d1:9b:c7:a4:de,321808469,272,-151,321808197,321808469
30192,5,6,149,5745,-67,-97,30,,321808802,52,281,321808750,321808802
30193,5,6,149,5745,-80,-97,17,,321808870,44,24,321808826,321808870
30194,5,24,149,5745,-81,-97,16,,321808991,28,93,321808963,321808991
30195,5,24,149,5745,-82,-97,15,,321811073,32,2050,321811041,321811073
30196,5,24,149,5745,-83,-97,14,,321811387,28,286,321811359,321811387
30197,5,6,149,5745,-89,-97,8,,321811547,68,92,321811479,321811547
30198,5,12,149,5745,-73,-97,24,6a:1e:a4:f8:14:49,321822730,284,10899,321822446,321822730
30199,5,24,149,5745,-83,-97,14,,321823094,32,332,321823062,321823094
30200,5,24,149,5745,-82,-97,15,,321823369,32,243,321823337,321823369
30201,5,24,149,5745,-82,-97,15,,321823645,28,248,321823617,321823645
30202,5,6,149,5745,-67,-97,30,,321824654,52,957,321824602,321824654
30203,5,6,149,5745,-82,-97,15,,321824722,44,24,321824678,321824722
30204,5,24,149,5745,-83,-97,14,,321824840,28,90,321824812,321824840
30205,5,24,149,5745,-82,-97,15,,321824983,28,115,321824955,321824983
30206,5,6,149,5745,-67,-97,30,,321827860,52,2825,321827808,321827860
30207,5,6,149,5745,-82,-97,15,,321827928,44,24,321827884,321827928
30208,5,24,149,5745,-82,-97,15,,321828045,28,89,321828017,321828045
30209,5,6,149,5745,-67,-97,30,,321828215,52,118,321828163,321828215
30210,5,6,149,5745,-82,-97,15,,321828283,44,24,321828239,321828283
30211,5,24,149,5745,-82,-97,15,,321828401,28,90,321828373,321828401
30212,5,24,149,5745,-82,-97,15,,321838944,28,10515,321838916,321838944
30213,5,24,149,5745,-82,-97,15,,321839278,28,306,321839250,321839278
30214,5,12,149,5745,-69,-97,28,f2:da:61:dd:98:c5,321840247,268,701,321839979,321840247
30215,5,24,149,5745,-77,-97,20,,321844608,28,4333,321844580,321844608
30216,5,24,149,5745,-82,-97,15,,321844652,28,16,321844624,321844652
30217,5,24,149,5745,-82,-97,15,,321844760,32,76,321844728,321844760
30218,5,12,149,5745,-63,-97,34,a6:92:ad:b7:76:65,321846989,284,1945,321846705,321846989
30219,5,24,149,5745,-81,-97,16,,321855725,32,8704,321855693,321855725
30220,5,24,149,5745,-81,-97,16,,321855851,32,94,321855819,321855851
30221,5,24,149,5745,-81,-97,16,,321857343,32,1460,321857311,321857343
30222,5,24,149,5745,-82,-97,15,,321857789,32,414,321857757,321857789
30223,5,24,149,5745,-81,-97,16,,321858234,28,417,321858206,321858234
30224,5,24,149,5745,-81,-97,16,,321858616,28,354,321858588,321858616
30225,5,6,149,5745,-66,-97,31,,321859495,52,827,321859443,321859495
30226,5,6,149,5745,-81,-97,16,,321859563,44,24,321859519,321859563
30227,5,24,149,5745,-81,-97,16,,321859680,28,89,321859652,321859680
30228,5,6,149,5745,-66,-97,31,,321859832,52,100,321859780,321859832
30229,5,6,149,5745,-81,-97,16,,321859900,44,24,321859856,321859900
30230,5,24,149,5745,-80,-97,17,,321860017,28,89,321859989,321860017
30231,5,6,149,5745,-66,-97,31,,321860151,52,82,321860099,321860151
30232,5,6,149,5745,-81,-97,16,,321860219,44,24,321860175,321860219
30233,5,24,149,5745,-81,-97,16,,321860345,32,94,321860313,321860345
30234,5,24,149,5745,-81,-97,16,,321862761,28,2388,321862733,321862761
30235,5,24,149,5745,-77,-97,20,,321862805,28,16,321862777,321862805
30236,5,24,149,5745,-77,-97,20,,321862913,32,76,321862881,321862913
30237,5,12,149,5745,-59,-97,38,22:ec:75:a8:8a:31,321869272,244,6115,321869028,321869272
30238,5,12,149,5745,-61,-97,36,f6:0a:5c:59:72:df,321871314,280,1762,321871034,321871314
30239,5,24,149,5745,-80,-97,17,,321873593,32,2247,321873561,321873593
30240,5,24,149,5745,-80,-97,17,,321873871,28,250,321873843,321873871
30241,5,12,149,5745,-85,-97,12,7e:05:42:11:d2:ec,321874278,272,135,321874006,321874278
30242,5,24,149,5745,-79,-97,18,,321899127,32,24817,321899095,321899127
30243,5,24,149,5745,-79,-97,18,,321899554,32,395,321899522,321899554
30244,5,24,149,5745,-79,-97,18,,321899982,28,400,321899954,321899982
30245,5,6,149,5745,-65,-97,32,,321913580,52,13546,321913528,321913580
30246,5,6,149,5745,-79,-97,18,,321913648,44,24,321913604,321913648
30247,5,24,149,5745,-79,-97,18,,321913765,28,89,321913737,321913765
30248,5,6,149,5745,-65,-97,32,,321914173,52,356,321914121,321914173
30249,5,6,149,5745,-79,-97,18,,321914241,44,24,321914197,321914241
30250,5,24,149,5745,-79,-97,18,,321914359,28,90,321914331,321914359
30251,5,6,149,5745,-65,-97,32,,321914521,52,110,321914469,321914521
30252,5,6,149,5745,-80,-97,17,,321914589,44,24,321914545,321914589
30253,5,24,149,5745,-79,-97,18,,321914707,28,90,321914679,321914707
30254,5,12,149,5745,-73,-97,24,5e:29:73:5b:30:00,321918155,272,3176,321917883,321918155
30255,5,12,149,5745,-59,-97,38,3e:d1:9b:c7:a4:de,321922734,272,4307,321922462,321922734
30256,5,24,149,5745,-79,-97,18,,321931095,32,8329,321931063,321931095
30257,5,24,149,5745,-79,-97,18,,321931658,32,531,321931626,321931658
30258,5,24,149,5745,-79,-97,18,,321932220,28,534,321932192,321932220
30259,5,24,149,5745,-79,-97,18,,321932440,28,192,321932412,321932440
30260,5,24,149,5745,-79,-97,18,,321932677,28,209,321932649,321932677
30261,5,24,149,5745,-79,-97,18,,321933033,28,328,321933005,321933033
30262,5,24,149,5745,-79,-97,18,,321933235,28,174,321933207,321933235
30263,5,12,149,5745,-74,-97,23,6a:1e:a4:f8:14:49,321940973,284,7454,321940689,321940973
30264,5,12,149,5745,-62,-97,35,a6:92:ad:b7:76:65,321954137,284,12880,321953853,321954137
30265,5,12,149,5745,-72,-97,25,f2:da:61:dd:98:c5,321962623,268,8218,321962355,321962623
30266,5,12,149,5745,-87,-97,10,7e:05:42:11:d2:ec,321971542,272,8647,321971270,321971542
30267,5,6,149,5745,-65,-97,32,,321973853,52,2259,321973801,321973853
30268,5,6,149,5745,-79,-97,18,,321973921,44,24,321973877,321973921
30269,5,24,149,5745,-79,-97,18,,321974047,32,94,321974015,321974047
30270,5,6,149,5745,-65,-97,32,,321989084,52,14985,321989032,321989084
30271,5,6,149,5745,-79,-97,18,,321989153,44,25,321989109,321989153
30272,5,24,149,5745,-79,-97,18,,321989270,28,89,321989242,321989270
30273,5,12,149,5745,-90,-97,7,46:28:71:6e:d2:2e,321998953,280,9403,321998673,321998953
30274,5,12,149,5745,-62,-97,35,22:ec:75:a8:8a:31,321999510,244,313,321999266,321999510
30275,5,12,149,5745,-66,-97,31,56:68:e2:c2:8d:d5,322006267,476,6281,322005791,322006267
30276,5,12,149,5745,-59,-97,38,a6:92:ad:b7:76:65,322008026,484,1275,322007542,322008026
30277,5,12,149,5745,-62,-97,35,22:ec:75:a8:8a:31,322012909,516,4367,322012393,322012909
30278,5,12,149,5745,-63,-97,34,f6:0a:5c:59:72:df,322013574,280,385,322013294,322013574
30279,5,12,149,5745,-66,-97,31,5e:29:73:5b:30:00,322015211,540,1097,322014671,322015211
30280,5,12,149,5745,-59,-97,38,a6:92:ad:b7:76:65,322017351,284,1856,322017067,322017351
30281,5,12,149,5745,-71,-97,26,f2:da:61:dd:98:c5,322018849,268,1230,322018581,322018849
30282,5,12,149,5745,-60,-97,37,3e:d1:9b:c7:a4:de,322019151,544,-242,322018607,322019151
30283,5,12,149,5745,-72,-97,25,6a:1e:a4:f8:14:49,322024824,284,5389,322024540,322024824
30284,5,12,149,5745,-87,-97,10,9a:24:38:da:96:bb,322029504,272,4408,322029232,322029504
30285,5,12,149,5745,-72,-97,25,6a:1e:a4:f8:14:49,322034476,284,4688,322034192,322034476
30286,5,12,149,5745,-93,-97,4,46:28:71:6e:d2:2e,322047775,280,13019,322047495,322047775
30287,5,12,149,5745,-60,-97,37,3e:d1:9b:c7:a4:de,322050662,272,2615,322050390,322050662
30288,5,12,149,5745,-72,-97,25,f2:da:61:dd:98:c5,322052094,268,1164,322051826,322052094
30289,5,12,149,5745,-65,-97,32,5e:29:73:5b:30:00,322052432,272,66,322052160,322052432
30290,5,12,149,5745,-92,-97,5,46:28:71:6e:d2:2e,322064866,280,12154,322064586,322064866
30291,5,12,149,5745,-66,-97,31,56:68:e2:c2:8d:d5,322066724,476,1382,322066248,322066724
30292,5,12,149,5745,-88,-97,9,9a:24:38:da:96:bb,322068719,824,1171,322067895,322068719
30293,5,12,149,5745,-85,-97,12,7e:05:42:11:d2:ec,322072654,360,3575,322072294,322072654
30294,5,12,149,5745,-58,-97,39,a6:92:ad:b7:76:65,322073156,484,18,322072672,322073156
30295,5,12,149,5745,-74,-97,23,d2:00:04:7e:2c:ab,322073676,440,80,322073236,322073676
30296,5,12,149,5745,-62,-97,35,22:ec:75:a8:8a:31,322077058,516,2866,322076542,322077058
30297,5,12,149,5745,-74,-97,23,6a:1e:a4:f8:14:49,322077653,132,463,322077521,322077653
30298,5,12,149,5745,-63,-97,34,f6:0a:5c:59:72:df,322077819,280,-114,322077539,322077819
30299,5,12,149,5745,-65,-97,32,5e:29:73:5b:30:00,322080680,540,2321,322080140,322080680
30300,5,12,149,5745,-65,-97,32,f6:0a:5c:59:72:df,322081983,280,1023,322081703,322081983
30301,5,12,149,5745,-60,-97,37,3e:d1:9b:c7:a4:de,322084254,544,1727,322083710,322084254
30302,5,12,149,5745,-72,-97,25,f2:da:61:dd:98:c5,322084888,268,366,322084620,322084888
30303,5,12,149,5745,-69,-97,28,0a:b9:b7:b1:4d:fa,322085325,268,169,322085057,322085325
30304,5,12,149,5745,-74,-97,23,6a:1e:a4:f8:14:49,322087418,284,1809,322087134,322087418
30305,5,12,149,5745,-62,-97,35,22:ec:75:a8:8a:31,322114486,244,26824,322114242,322114486
30306,5,12,149,5745,-58,-97,39,a6:92:ad:b7:76:65,322142112,284,27342,322141828,322142112
30307,5,12,149,5745,-88,-97,9,9a:24:38:da:96:bb,322142739,272,355,322142467,322142739
30308,5,12,149,5745,-67,-97,30,5e:29:73:5b:30:00,322147290,272,4279,322147018,322147290
30309,5,12,149,5745,-60,-97,37,3e:d1:9b:c7:a4:de,322151118,272,3556,322150846,322151118
30310,5,12,149,5745,-73,-97,24,6a:1e:a4:f8:14:49,322159189,284,7787,322158905,322159189
30311,5,12,149,5745,-86,-97,11,7e:05:42:11:d2:ec,322168776,272,9315,322168504,322168776
30312,5,12,149,5745,-72,-97,25,f2:da:61:dd:98:c5,322177928,268,8884,322177660,322177928
30313,5,12,149,5745,-64,-97,33,22:ec:75:a8:8a:31,322210832,244,32660,322210588,322210832
30314,5,12,149,5745,-65,-97,32,f6:0a:5c:59:72:df,322214356,280,3244,322214076,322214356
30315,5,12,149,5745,-86,-97,11,9a:24:38:da:96:bb,322258322,272,43694,322258050,322258322
30316,5,12,149,5745,-61,-97,36,a6:92:ad:b7:76:65,322260118,284,1512,322259834,322260118
30317,5,12,149,5745,-67,-97,30,5e:29:73:5b:30:00,322264311,272,3921,322264039,322264311
30318,5,12,149,5745,-59,-97,38,3e:d1:9b:c7:a4:de,322268195,272,3612,322267923,322268195
30319,5,12,149,5745,-92,-97,5,46:28:71:6e:d2:2e,322279543,280,11068,322279263,322279543
30320,5,12,149,5745,-87,-97,10,7e:05:42:11:d2:ec,322282935,272,3120,322282663,322282935
30321,5,12,149,5745,-64,-97,33,22:ec:75:a8:8a:31,322323432,244,40253,322323188,322323432
30322,5,12,149,5745,-71,-97,26,6a:1e:a4:f8:14:49,322336097,284,12381,322335813,322336097
30323,5,12,149,5745,-72,-97,25,f2:da:61:dd:98:c5,322342342,268,5977,322342074,322342342
30324,5,12,149,5745,-58,-97,39,a6:92:ad:b7:76:65,322362544,284,19918,322362260,322362544
30325,5,12,149,5745,-87,-97,10,9a:24:38:da:96:bb,322366816,272,4000,322366544,322366816
30326,5,12,149,5745,-66,-97,31,5e:29:73:5b:30:00,322379542,272,12454,322379270,322379542
30327,5,12,149,5745,-60,-97,37,3e:d1:9b:c7:a4:de,322385142,272,5328,322384870,322385142
30328,5,12,149,5745,-86,-97,11,7e:05:42:11:d2:ec,322392000,272,6586,322391728,322392000
30329,5,12,149,5745,-91,-97,6,46:28:71:6e:d2:2e,322394306,280,2026,322394026,322394306
30330,5,12,149,5745,-68,-97,29,6a:1e:a4:f8:14:49,322440090,284,45500,322439806,322440090
30331,5,12,149,5745,-71,-97,26,f2:da:61:dd:98:c5,322446496,268,6138,322446228,322446496
30332,5,6,149,5745,-64,-97,33,,322455838,52,9290,322455786,322455838
30333,5,6,149,5745,-80,-97,17,,322455906,44,24,322455862,322455906
30334,5,24,149,5745,-81,-97,16,,322456031,32,93,322455999,322456031
30335,5,12,149,5745,-66,-97,31,22:ec:75:a8:8a:31,322458362,244,2087,322458118,322458362
30336,5,12,149,5745,-87,-97,10,9a:24:38:da:96:bb,322462679,824,3493,322461855,322462679
30337,5,12,149,5745,-64,-97,33,56:68:e2:c2:8d:d5,322466236,476,3081,322465760,322466236
30338,5,12,149,5745,-66,-97,31,22:ec:75:a8:8a:31,322470814,516,4062,322470298,322470814
30339,5,12,149,5745,-63,-97,34,f6:0a:5c:59:72:df,322471364,280,270,322471084,322471364
30340,5,12,149,5745,-67,-97,30,5e:29:73:5b:30:00,322476484,540,4580,322475944,322476484
30341,5,12,149,5745,-68,-97,29,6a:1e:a4:f8:14:49,322477086,284,318,322476802,322477086
30342,5,12,149,5745,-85,-97,12,9a:24:38:da:96:bb,322477422,272,64,322477150,322477422
30343,5,12,149,5745,-62,-97,35,3e:d1:9b:c7:a4:de,322479600,544,1634,322479056,322479600
30344,5,12,149,5745,-69,-97,28,6a:1e:a4:f8:14:49,322482374,284,2490,322482090,322482374
30345,5,12,149,5745,-62,-97,35,3e:d1:9b:c7:a4:de,322509953,272,27307,322509681,322509953
30346,5,12,149,5745,-69,-97,28,5e:29:73:5b:30:00,322511205,272,980,322510933,322511205
30347,5,24,149,5745,-79,-97,18,,322549472,32,38235,322549440,322549472
30348,5,24,149,5745,-80,-97,17,,322549927,32,423,322549895,322549927
30349,5,24,149,5745,-79,-97,18,,322550381,28,426,322550353,322550381
30350,5,12,149,5745,-60,-97,37,f6:0a:5c:59:72:df,322557864,280,7203,322557584,322557864
30351,5,12,149,5745,-60,-97,37,22:ec:75:a8:8a:31,322558567,244,459,322558323,322558567
30352,5,12,149,5745,-87,-97,10,9a:24:38:da:96:bb,322590213,272,31374,322589941,322590213
30353,5,12,149,5745,-87,-97,10,9a:24:38:da:96:bb,322595598,824,4561,322594774,322595598
30354,5,12,149,5745,-74,-97,23,d2:00:04:7e:2c:ab,322600157,440,4119,322599717,322600157
30355,5,6,149,5745,-61,-97,36,,322602038,52,1829,322601986,322602038
30356,5,6,149,5745,-80,-97,17,,322602106,44,24,322602062,322602106
30357,5,24,149,5745,-81,-97,16,,322602224,28,90,322602196,322602224
30358,5,12,149,5745,-71,-97,26,5e:29:73:5b:30:00,322607255,540,4491,322606715,322607255
30359,5,12,149,5745,-71,-97,26,0a:b9:b7:b1:4d:fa,322609297,268,1774,322609029,322609297
30360,5,12,149,5745,-61,-97,36,22:ec:75:a8:8a:31,322610634,516,821,322610118,322610634
30361,5,12,149,5745,-59,-97,38,3e:d1:9b:c7:a4:de,322611193,544,15,322610649,322611193
30362,5,12,149,5745,-83,-97,14,7e:05:42:11:d2:ec,322611798,468,137,322611330,322611798
30363,5,12,149,5745,-60,-97,37,a6:92:ad:b7:76:65,322613021,484,739,322612537,322613021
30364,5,12,149,5745,-70,-97,27,f2:da:61:dd:98:c5,322617484,268,4195,322617216,322617484
30365,5,12,149,5745,-59,-97,38,3e:d1:9b:c7:a4:de,322623772,272,6016,322623500,322623772
30366,5,12,149,5745,-71,-97,26,5e:29:73:5b:30:00,322625024,272,980,322624752,322625024
30367,5,12,149,5745,-68,-97,29,6a:1e:a4:f8:14:49,322642349,284,17041,322642065,322642349
30368,5,12,149,5745,-89,-97,8,46:28:71:6e:d2:2e,322644860,280,2231,322644580,322644860
30369,5,12,149,5745,-61,-97,36,f6:0a:5c:59:72:df,322664907,280,19767,322664627,322664907
30370,5,12,149,5745,-61,-97,36,22:ec:75:a8:8a:31,322675453,244,10302,322675209,322675453
30371,5,24,149,5745,-82,-97,15,,322676568,28,1087,322676540,322676568
30372,5,24,149,5745,-79,-97,18,,322676612,28,16,322676584,322676612
30373,5,24,149,5745,-79,-97,18,,322676720,32,76,322676688,322676720
30374,5,24,149,5745,-79,-97,18,,322694481,28,17733,322694453,322694481
30375,5,24,149,5745,-82,-97,15,,322694525,28,16,322694497,322694525
30376,5,24,149,5745,-81,-97,16,,322694633,32,76,322694601,322694633
30377,5,12,149,5745,-70,-97,27,5e:29:73:5b:30:00,322701587,540,6414,322701047,322701587
30378,5,12,149,5745,-88,-97,9,9a:24:38:da:96:bb,322703742,272,1883,322703470,322703742
30379,5,12,149,5745,-72,-97,25,5e:29:73:5b:30:00,322723504,272,19490,322723232,322723504
30380,5,12,149,5745,-59,-97,38,22:ec:75:a8:8a:31,322728918,516,4898,322728402,322728918
30381,5,12,149,5745,-62,-97,35,3e:d1:9b:c7:a4:de,322731330,272,2140,322731058,322731330
30382,5,12,149,5745,-72,-97,25,5e:29:73:5b:30:00,322733868,540,1998,322733328,322733868
30383,5,12,149,5745,-70,-97,27,6a:1e:a4:f8:14:49,322745004,284,10852,322744720,322745004
30384,5,24,149,5745,-78,-97,19,,322783796,32,38760,322783764,322783796
30385,5,24,149,5745,-79,-97,18,,322784128,28,304,322784100,322784128
30386,5,6,149,5745,-92,-97,5,,322784288,68,92,322784220,322784288
30387,5,24,149,5745,-78,-97,19,,322785143,32,823,322785111,322785143
30388,5,12,149,5745,-59,-97,38,22:ec:75:a8:8a:31,322794412,516,8753,322793896,322794412
30389,5,12,149,5745,-68,-97,29,5e:29:73:5b:30:00,322799387,540,4435,322798847,322799387
30390,5,12,149,5745,-59,-97,38,22:ec:75:a8:8a:31,322802310,244,2679,322802066,322802310
30391,5,12,149,5745,-85,-97,12,7e:05:42:11:d2:ec,322806098,468,3320,322805630,322806098
30392,5,12,149,5745,-71,-97,26,5e:29:73:5b:30:00,322838364,272,31994,322838092,322838364
30393,5,12,149,5745,-58,-97,39,3e:d1:9b:c7:a4:de,322847901,272,9265,322847629,322847901
30394,5,12,149,5745,-72,-97,25,6a:1e:a4:f8:14:49,322848592,284,407,322848308,322848592
30395,5,6,149,5745,-92,-97,5,54:e4:3a:ec:fb:65,322851421,360,2469,322851061,322851421
30396,5,12,149,5745,-92,-97,5,46:28:71:6e:d2:2e,322852919,280,1218,322852639,322852919
30397,5,12,149,5745,-59,-97,38,22:ec:75:a8:8a:31,322904761,244,51598,322904517,322904761
30398,5,6,149,5745,-62,-97,35,,322925202,52,20389,322925150,322925202
30399,5,6,149,5745,-78,-97,19,,322925270,44,24,322925226,322925270
30400,5,24,149,5745,-78,-97,19,,322925387,28,89,322925359,322925387
30401,5,12,149,5745,-86,-97,11,9a:24:38:da:96:bb,322931490,272,5831,322931218,322931490
30402,5,6,149,5745,-62,-97,35,,322936148,52,4606,322936096,322936148
30403,5,6,149,5745,-78,-97,19,,322936216,44,24,322936172,322936216
30404,5,24,149,5745,-79,-97,18,,322936334,28,90,322936306,322936334
30405,5,6,149,5745,-62,-97,35,,322936539,52,153,322936487,322936539
30406,5,6,149,5745,-79,-97,18,,322936607,44,24,322936563,322936607
30407,5,24,149,5745,-78,-97,19,,322936725,28,90,322936697,322936725
30408,5,24,149,5745,-78,-97,19,,322937803,32,1046,322937771,322937803
30409,5,24,149,5745,-78,-97,19,,322938267,32,432,322938235,322938267
30410,5,24,149,5745,-78,-97,19,,322938730,28,435,322938702,322938730
30411,5,24,149,5745,-62,-97,35,,322939568,28,810,322939540,322939568
30412,5,24,149,5745,-78,-97,19,,322939612,28,16,322939584,322939612
30413,5,24,149,5745,-78,-97,19,,322939720,28,80,322939692,322939720
30414,5,12,149,5745,-69,-97,28,5e:29:73:5b:30:00,322942987,272,2995,322942715,322942987
30415,5,24,149,5745,-78,-97,19,,322943999,28,984,322943971,322943999
30416,5,12,149,5745,-75,-97,22,6a:1e:a4:f8:14:49,322950421,284,6138,322950137,322950421
30417,5,6,149,5745,-93,-97,4,54:e4:3a:ec:fb:65,322953821,360,3040,322953461,322953821
30418,5,12,149,5745,-60,-97,37,3e:d1:9b:c7:a4:de,322962707,272,8614,322962435,322962707
30419,5,24,149,5745,-79,-97,18,,322966676,32,3937,322966644,322966676
30420,5,24,149,5745,-79,-97,18,,322967176,32,468,322967144,322967176
30421,5,24,149,5745,-80,-97,17,,322967675,28,471,322967647,322967675
30422,5,24,149,5745,-63,-97,34,,322968142,28,439,322968114,322968142
30423,5,24,149,5745,-80,-97,17,,322968186,28,16,322968158,322968186
30424,5,24,149,5745,-80,-97,17,,322968294,28,80,322968266,322968294
30425,5,24,149,5745,-63,-97,34,,322968639,28,317,322968611,322968639
30426,5,24,149,5745,-79,-97,18,,322968683,28,16,322968655,322968683
30427,5,24,149,5745,-79,-97,18,,322968799,28,88,322968771,322968799
30428,5,24,149,5745,-63,-97,34,,322985642,28,16815,322985614,322985642
30429,5,24,149,5745,-80,-97,17,,322985685,28,15,322985657,322985685
30430,5,24,149,5745,-80,-97,17,,322985794,28,81,322985766,322985794
30431,5,24,149,5745,-80,-97,17,,322993801,32,7975,322993769,322993801
30432,5,24,149,5745,-80,-97,17,,322994345,32,512,322994313,322994345
30433,5,24,149,5745,-80,-97,17,,322994890,28,517,322994862,322994890
30434,5,24,149,5745,-63,-97,34,,322996445,28,1527,322996417,322996445
30435,5,24,149,5745,-80,-97,17,,322996489,28,16,322996461,322996489
30436,5,24,149,5745,-80,-97,17,,322996597,28,80,322996569,322996597
30437,5,24,149,5745,-63,-97,34,,322996872,28,247,322996844,322996872
30438,5,24,149,5745,-63,-97,34,,322997002,28,102,322996974,322997002
30439,5,24,149,5745,-80,-97,17,,322997046,28,16,322997018,322997046
30440,5,24,149,5745,-80,-97,17,,322997155,28,81,322997127,322997155
30441,5,24,149,5745,-63,-97,34,,322997368,28,185,322997340,322997368
30442,5,24,149,5745,-80,-97,17,,322997412,28,16,322997384,322997412
30443,5,24,149,5745,-80,-97,17,,322997528,28,88,322997500,322997528
30444,5,12,149,5745,-61,-97,36,22:ec:75:a8:8a:31,323016677,244,18905,323016433,323016677
30445,5,24,149,5745,-81,-97,16,,323022522,32,5813,323022490,323022522
30446,5,24,149,5745,-81,-97,16,,323023012,32,458,323022980,323023012
30447,5,24,149,5745,-81,-97,16,,323023503,28,463,323023475,323023503
30448,5,24,149,5745,-81,-97,16,,323023713,28,182,323023685,323023713
30449,5,24,149,5745,-63,-97,34,,323024877,28,1136,323024849,323024877
30450,5,24,149,5745,-81,-97,16,,323024921,28,16,323024893,323024921
30451,5,24,149,5745,-81,-97,16,,323025029,28,80,323025001,323025029
30452,5,12,149,5745,-88,-97,9,9a:24:38:da:96:bb,323039584,272,14283,323039312,323039584
30453,5,24,149,5745,-82,-97,15,,323045574,28,5962,323045546,323045574
30454,5,24,149,5745,-62,-97,35,,323046163,28,561,323046135,323046163
30455,5,24,149,5745,-82,-97,15,,323046207,28,16,323046179,323046207
30456,5,24,149,5745,-82,-97,15,,323046315,28,80,323046287,323046315
30457,5,12,149,5745,-77,-97,20,6a:1e:a4:f8:14:49,323050319,284,3720,323050035,323050319
30458,5,12,149,5745,-67,-97,30,56:68:e2:c2:8d:d5,323054399,476,3604,323053923,323054399
30459,5,6,149,5745,-91,-97,6,54:e4:3a:ec:fb:65,323056223,360,1464,323055863,323056223
30460,5,12,149,5745,-63,-97,34,22:ec:75:a8:8a:31,323057519,516,780,323057003,323057519
30461,5,12,149,5745,-65,-97,32,3e:d1:9b:c7:a4:de,323058123,544,60,323057579,323058123
30462,5,12,149,5745,-68,-97,29,5e:29:73:5b:30:00,323061915,540,3252,323061375,323061915
30463,5,12,149,5745,-59,-97,38,f6:0a:5c:59:72:df,323065874,280,3679,323065594,323065874
30464,5,12,149,5745,-68,-97,29,5e:29:73:5b:30:00,323067422,272,1276,323067150,323067422
30465,5,12,149,5745,-77,-97,20,6a:1e:a4:f8:14:49,323073524,284,5818,323073240,323073524
30466,5,12,149,5745,-63,-97,34,3e:d1:9b:c7:a4:de,323082590,272,8794,323082318,323082590
30467,5,24,149,5745,-82,-97,15,,323092443,32,9821,323092411,323092443
30468,5,24,149,5745,-82,-97,15,,323092880,32,405,323092848,323092880
30469,5,24,149,5745,-81,-97,16,,323093316,28,408,323093288,323093316
30470,5,12,149,5745,-60,-97,37,f6:0a:5c:59:72:df,323106861,280,13265,323106581,323106861
30471,5,12,149,5745,-92,-97,5,46:28:71:6e:d2:2e,323113449,280,6308,323113169,323113449
30472,5,12,149,5745,-68,-97,29,56:68:e2:c2:8d:d5,323115285,476,1360,323114809,323115285
30473,5,12,149,5745,-74,-97,23,d2:00:04:7e:2c:ab,323116499,440,774,323116059,323116499
30474,5,12,149,5745,-65,-97,32,22:ec:75:a8:8a:31,323122157,516,5142,323121641,323122157
30475,5,12,149,5745,-62,-97,35,3e:d1:9b:c7:a4:de,323123625,544,924,323123081,323123625
30476,5,12,149,5745,-87,-97,10,9a:24:38:da:96:bb,323124212,824,-237,323123388,323124212
30477,5,12,149,5745,-78,-97,19,6a:1e:a4:f8:14:49,323125755,132,1411,323125623,323125755
30478,5,12,149,5745,-70,-97,27,5e:29:73:5b:30:00,323127062,540,767,323126522,323127062
30479,5,12,149,5745,-63,-97,34,f6:0a:5c:59:72:df,323127645,280,303,323127365,323127645
30480,5,12,149,5745,-77,-97,20,6a:1e:a4:f8:14:49,323132036,284,4107,323131752,323132036
30481,5,12,149,5745,-61,-97,36,a6:92:ad:b7:76:65,323132697,484,177,323132213,323132697
30482,5,12,149,5745,-86,-97,11,7e:05:42:11:d2:ec,323135234,468,2069,323134766,323135234
30483,5,12,149,5745,-72,-97,25,0a:b9:b7:b1:4d:fa,323136462,268,960,323136194,323136462
30484,5,12,149,5745,-75,-97,22,f2:da:61:dd:98:c5,323143055,268,6325,323142787,323143055
30485,5,12,149,5745,-64,-97,33,22:ec:75:a8:8a:31,323146426,244,3127,323146182,323146426
30486,5,12,149,5745,-89,-97,8,9a:24:38:da:96:bb,323157020,272,10322,323156748,323157020
30487,5,12,149,5745,-78,-97,19,6a:1e:a4:f8:14:49,323165895,284,8591,323165611,323165895
30488,5,12,149,5745,-67,-97,30,5e:29:73:5b:30:00,323182188,272,16021,323181916,323182188
30489,5,24,149,5745,-79,-97,18,,323187813,28,5597,323187785,323187813
30490,5,24,149,5745,-80,-97,17,,323187857,28,16,323187829,323187857
30491,5,24,149,5745,-80,-97,17,,323187965,32,76,323187933,323187965
30492,5,12,149,5745,-61,-97,36,22:ec:75:a8:8a:31,323188049,516,-432,323187533,323188049
30493,5,12,149,5745,-67,-97,30,5e:29:73:5b:30:00,323192630,540,4041,323192090,323192630
30494,5,12,149,5745,-66,-97,31,3e:d1:9b:c7:a4:de,323193196,272,294,323192924,323193196
30495,5,12,149,5745,-61,-97,36,22:ec:75:a8:8a:31,323253245,516,59533,323252729,323253245
30496,5,12,149,5745,-72,-97,25,5e:29:73:5b:30:00,323257641,540,3856,323257101,323257641
30497,5,12,149,5745,-61,-97,36,22:ec:75:a8:8a:31,323261077,244,3192,323260833,323261077
30498,5,12,149,5745,-89,-97,8,9a:24:38:da:96:bb,323269513,272,8164,323269241,323269513
30499,5,12,149,5745,-69,-97,28,5e:29:73:5b:30:00,323297133,272,27348,323296861,323297133
30500,5,12,149,5745,-61,-97,36,3e:d1:9b:c7:a4:de,323309978,272,12573,323309706,323309978
30501,5,12,149,5745,-61,-97,36,22:ec:75:a8:8a:31,323318789,516,8295,323318273,323318789
30502,5,12,149,5745,-69,-97,28,5e:29:73:5b:30:00,323323759,540,4430,323323219,323323759
30503,5,12,149,5745,-84,-97,13,7e:05:42:11:d2:ec,323331282,468,7055,323330814,323331282
30504,5,12,149,5745,-71,-97,26,6a:1e:a4:f8:14:49,323359705,284,28139,323359421,323359705
30505,5,12,149,5745,-61,-97,36,22:ec:75:a8:8a:31,323360231,244,282,323359987,323360231
30506,5,12,149,5745,-87,-97,10,9a:24:38:da:96:bb,323385191,272,24688,323384919,323385191
30507,5,12,149,5745,-70,-97,27,5e:29:73:5b:30:00,323397660,272,12197,323397388,323397660
30508,5,12,149,5745,-65,-97,32,3e:d1:9b:c7:a4:de,323426970,272,29038,323426698,323426970
30509,5,12,149,5745,-66,-97,31,f6:0a:5c:59:72:df,323458840,280,31590,323458560,323458840
30510,5,12,149,5745,-74,-97,23,6a:1e:a4:f8:14:49,323462131,284,3007,323461847,323462131
30511,5,12,149,5745,-60,-97,37,22:ec:75:a8:8a:31,323470893,244,8518,323470649,323470893
30512,5,12,149,5745,-87,-97,10,9a:24:38:da:96:bb,323493154,272,21989,323492882,323493154
30513,5,12,149,5745,-74,-97,23,6a:1e:a4:f8:14:49,323509031,284,15593,323508747,323509031
30514,5,12,149,5745,-65,-97,32,56:68:e2:c2:8d:d5,323515488,476,5981,323515012,323515488
30515,5,12,149,5745,-60,-97,37,22:ec:75:a8:8a:31,323518077,516,2073,323517561,323518077
30516,5,12,149,5745,-63,-97,34,3e:d1:9b:c7:a4:de,323518636,544,15,323518092,323518636
30517,5,12,149,5745,-74,-97,23,6a:1e:a4:f8:14:49,323522978,132,4210,323522846,323522978
30518,5,12,149,5745,-70,-97,27,5e:29:73:5b:30:00,323523153,540,-365,323522613,323523153
30519,5,12,149,5745,-70,-97,27,5e:29:73:5b:30:00,323526220,272,2795,323525948,323526220
30520,5,12,149,5745,-64,-97,33,f6:0a:5c:59:72:df,323527885,280,1385,323527605,323527885
30521,5,12,149,5745,-71,-97,26,f2:da:61:dd:98:c5,323536062,268,7909,323535794,323536062
30522,5,12,149,5745,-63,-97,34,3e:d1:9b:c7:a4:de,323558865,272,22531,323558593,323558865
30523,5,12,149,5745,-62,-97,35,f6:0a:5c:59:72:df,323573008,280,13863,323572728,323573008
30524,5,12,149,5745,-58,-97,39,22:ec:75:a8:8a:31,323580899,516,7375,323580383,323580899
30525,5,12,149,5745,-61,-97,36,3e:54:6a:dc:ab:9c,323584106,116,3091,323583990,323584106
30526,5,12,149,5745,-61,-97,36,3e:54:6a:dc:ab:9c,323584392,104,182,323584288,323584392
30527,5,12,149,5745,-62,-97,35,3e:54:6a:dc:ab:9c,323584656,116,148,323584540,323584656
30528,5,12,149,5745,-61,-97,36,3e:54:6a:dc:ab:9c,323584851,104,91,323584747,323584851
30529,5,12,149,5745,-62,-97,35,3e:54:6a:dc:ab:9c,323585017,104,62,323584913,323585017
30530,5,12,149,5745,-62,-97,35,3e:54:6a:dc:ab:9c,323585236,380,-161,323584856,323585236
30531,5,12,149,5745,-70,-97,27,5e:29:73:5b:30:00,323585677,540,-99,323585137,323585677
30532,5,12,149,5745,-61,-97,36,3e:54:6a:dc:ab:9c,323586289,440,172,323585849,323586289
30533,5,12,149,5745,-72,-97,25,f2:da:61:dd:98:c5,323589733,268,3176,323589465,323589733
30534,5,12,149,5745,-58,-97,39,22:ec:75:a8:8a:31,323605187,244,15210,323604943,323605187
30535,5,12,149,5745,-74,-97,23,f2:da:61:dd:98:c5,323624723,268,19268,323624455,323624723
30536,5,12,149,5745,-87,-97,10,9a:24:38:da:96:bb,323627729,272,2734,323627457,323627729
30537,5,12,149,5745,-62,-97,35,3e:54:6a:dc:ab:9c,323632842,440,4673,323632402,323632842
30538,5,12,149,5745,-74,-97,23,6a:1e:a4:f8:14:49,323633377,284,251,323633093,323633377
30539,5,12,149,5745,-70,-97,27,5e:29:73:5b:30:00,323640922,272,7273,323640650,323640922
30540,5,12,149,5745,-58,-97,39,22:ec:75:a8:8a:31,323646449,516,5011,323645933,323646449
30541,5,12,149,5745,-56,-97,41,1e:e0:ac:6c:74:90,323647012,440,123,323646572,323647012
30542,5,12,149,5745,-89,-97,8,9a:24:38:da:96:bb,323648235,824,399,323647411,323648235
30543,5,12,149,5745,-60,-97,37,3e:d1:9b:c7:a4:de,323650587,544,1808,323650043,323650587
30544,5,12,149,5745,-75,-97,22,d2:00:04:7e:2c:ab,323651193,440,166,323650753,323651193
30545,5,12,149,5745,-75,-97,22,f2:da:61:dd:98:c5,323655163,268,3702,323654895,323655163
30546,5,12,149,5745,-61,-97,36,a6:92:ad:b7:76:65,323656005,484,358,323655521,323656005
30547,5,12,149,5745,-61,-97,36,3e:54:6a:dc:ab:9c,323658487,244,2238,323658243,323658487
30548,5,12,149,5745,-88,-97,9,7e:05:42:11:d2:ec,323660228,468,1273,323659760,323660228
30549,5,12,149,5745,-72,-97,25,0a:b9:b7:b1:4d:fa,323661772,268,1276,323661504,323661772
30550,5,12,149,5745,-60,-97,37,3e:d1:9b:c7:a4:de,323672408,272,10364,323672136,323672408
30551,5,24,149,5745,-62,-97,35,,323677609,28,5173,323677581,323677609
30552,5,24,149,5745,-76,-97,21,,323677653,28,16,323677625,323677653
30553,5,24,149,5745,-76,-97,21,,323677761,28,80,323677733,323677761
30554,5,12,149,5745,-59,-97,38,22:ec:75:a8:8a:31,323696911,244,18906,323696667,323696911
30555,5,12,149,5745,-57,-97,40,1e:e0:ac:6c:74:90,323704402,244,7247,323704158,323704402
30556,5,12,149,5745,-61,-97,36,3e:54:6a:dc:ab:9c,323716365,468,11495,323715897,323716365
30557,5,12,149,5745,-87,-97,10,9a:24:38:da:96:bb,323718968,272,2331,323718696,323718968
30558,5,12,149,5745,-57,-97,40,1e:e0:ac:6c:74:90,323721611,440,2203,323721171,323721611
30559,5,12,149,5745,-69,-97,28,5e:29:73:5b:30:00,323739151,272,17268,323738879,323739151
30560,5,24,149,5745,-76,-97,21,,323749237,32,10054,323749205,323749237
30561,5,24,149,5745,-76,-97,21,,323749737,28,472,323749709,323749737
30562,5,12,149,5745,-60,-97,37,3e:d1:9b:c7:a4:de,323768380,272,18371,323768108,323768380
30563,5,12,149,5745,-62,-97,35,3e:54:6a:dc:ab:9c,323784284,272,15632,323784012,323784284
30564,5,12,149,5745,-60,-97,37,22:ec:75:a8:8a:31,323814093,244,29565,323813849,323814093
30565,5,24,149,5745,-83,-97,14,,323819656,28,5535,323819628,323819656
30566,5,24,149,5745,-76,-97,21,,323819700,28,16,323819672,323819700
30567,5,24,149,5745,-75,-97,22,,323819809,32,77,323819777,323819809
30568,5,12,149,5745,-89,-97,8,9a:24:38:da:96:bb,323829904,272,9823,323829632,323829904
30569,5,24,149,5745,-76,-97,21,,323838217,28,8285,323838189,323838217
30570,5,24,149,5745,-82,-97,15,,323838261,28,16,323838233,323838261
30571,5,24,149,5745,-82,-97,15,,323838369,32,76,323838337,323838369
30572,5,12,149,5745,-69,-97,28,5e:29:73:5b:30:00,323855046,272,16405,323854774,323855046
30573,5,12,149,5745,-87,-97,10,7e:05:42:11:d2:ec,323855556,468,42,323855088,323855556
30574,5,12,149,5745,-91,-97,6,46:28:71:6e:d2:2e,323876108,280,20272,323875828,323876108
30575,5,12,149,5745,-72,-97,25,f2:da:61:dd:98:c5,323878359,268,1983,323878091,323878359
30576,5,12,149,5745,-62,-97,35,3e:d1:9b:c7:a4:de,323884478,272,5847,323884206,323884478
30577,5,12,149,5745,-60,-97,37,3e:54:6a:dc:ab:9c,323892892,272,8142,323892620,323892892
30578,5,12,149,5745,-57,-97,40,1e:e0:ac:6c:74:90,323899719,244,6583,323899475,323899719
30579,5,12,149,5745,-65,-97,32,f6:0a:5c:59:72:df,323918891,280,18892,323918611,323918891
30580,5,12,149,5745,-62,-97,35,22:ec:75:a8:8a:31,323931257,244,12122,323931013,323931257
