,phy,data_rate,channel,frequency,signal_dbm,noise_dbm,snr,tx_addr,timestamp,duration,ifs,start_tsf,end_tsf
0,6,6,1,2412,-49,-89,40,e6:aa:ea:c9:ea:33,23595,408,,23187,23595
1,6,6,1,2412,-49,-89,40,e6:aa:ea:c9:ea:33,35716,408,11713,35308,35716
2,6,12,1,2412,-56,-89,33,40:e3:d6:da:ba:20,59064,160,23188,58904,59064
3,6,6,1,2412,-56,-89,33,40:e3:d6:da:ba:21,59653,368,221,59285,59653
4,6,12,1,2412,-55,-89,34,40:e3:d6:da:ba:22,60040,180,207,59860,60040
5,6,12,1,2412,-56,-89,33,40:e3:d6:da:ba:23,60273,184,49,60089,60273
6,6,12,1,2412,-55,-89,34,40:e3:d6:da:ba:24,60491,176,42,60315,60491
7,6,12,1,2412,-55,-89,34,40:e3:d6:da:ba:25,60710,160,59,60550,60710
8,6,12,1,2412,-56,-89,33,40:e3:d6:da:ba:20,161464,160,100594,161304,161464
9,6,6,1,2412,-56,-89,33,40:e3:d6:da:ba:21,161683,368,-149,161315,161683
10,6,12,1,2412,-55,-89,34,40:e3:d6:da:ba:23,162400,184,533,162216,162400
11,6,12,1,2412,-55,-89,34,40:e3:d6:da:ba:24,162628,176,52,162452,162628
12,6,12,1,2412,-56,-89,33,40:e3:d6:da:ba:25,162875,160,87,162715,162875
13,6,6,1,2412,-53,-89,36,40:e3:d6:da:ba:26,163077,380,-178,162697,163077
14,6,6,1,2412,-84,-89,5,e6:aa:ea:c9:ea:1b,168680,408,5195,168272,168680
15,4,1,1,2412,-72,-89,17,54:e4:3a:ec:fb:64,172876,2160,2036,170716,172876
16,4,1,1,2412,-61,-89,28,b8:3a:5a:88:e6:e0,175059,2360,-177,172699,175059
17,4,5.5,1,2412,-84,-89,5,f0:b6:1e:30:eb:66,187132,389,11684,186743,187132
18,4,5.5,1,2412,-82,-89,7,,187538,213,193,187325,187538
19,6,12,1,2412,-56,-89,33,40:e3:d6:da:ba:20,187610,136,-64,187474,187610
20,6,12,1,2412,-80,-89,9,,187766,32,124,187734,187766
21,6,6,1,2412,-63,-89,26,40:e3:d6:da:ba:21,187805,348,-309,187457,187805
22,6,12,1,2412,-56,-89,33,40:e3:d6:da:ba:22,188190,156,229,188034,188190
23,4,1,1,2412,-81,-89,8,a6:e5:7c:28:b1:d3,188464,944,-670,187520,188464
24,4,1,1,2412,-82,-89,7,,189419,304,651,189115,189419
25,6,12,1,2412,-56,-89,33,40:e3:d6:da:ba:23,189601,156,26,189445,189601
26,6,12,1,2412,-56,-89,33,40:e3:d6:da:ba:25,189800,136,63,189664,189800
27,6,12,1,2412,-81,-89,8,,191753,32,1921,191721,191753
28,6,6,1,2412,-83,-89,6,e6:aa:ea:c9:ea:1b,192906,408,745,192498,192906
29,6,6,1,2412,-85,-89,4,e6:aa:ea:c9:ea:1b,205022,408,11708,204614,205022
30,6,6,1,2412,-77,-89,12,f0:b6:1e:30:eb:66,251859,204,46633,251655,251859
31,4,1,1,2412,-82,-89,7,,254787,304,2624,254483,254787
32,6,12,1,2412,-56,-89,33,40:e3:d6:da:ba:20,263878,160,8931,263718,263878
33,6,6,1,2412,-56,-89,33,40:e3:d6:da:ba:21,264079,368,-167,263711,264079
34,6,12,1,2412,-56,-89,33,40:e3:d6:da:ba:22,264475,180,216,264295,264475
35,6,12,1,2412,-56,-89,33,40:e3:d6:da:ba:23,264699,184,40,264515,264699
36,6,12,1,2412,-56,-89,33,40:e3:d6:da:ba:24,264908,176,33,264732,264908
37,6,12,1,2412,-56,-89,33,40:e3:d6:da:ba:25,265128,160,60,264968,265128
38,6,6,1,2412,-56,-89,33,40:e3:d6:da:ba:26,265347,380,-161,264967,265347
39,4,1,1,2412,-72,-89,17,54:e4:3a:ec:fb:64,275276,2160,7769,273116,275276
40,4,1,1,2412,-87,-89,2,b8:3a:5a:88:e6:e0,277459,2360,-177,275099,277459
41,4,1,1,2412,-85,-89,4,b8:3a:5a:88:e6:e1,279866,2376,31,277490,279866
42,6,12,1,2412,-56,-89,33,40:e3:d6:da:ba:20,366253,160,86227,366093,366253
43,6,6,1,2412,-56,-89,33,40:e3:d6:da:ba:21,366445,368,-176,366077,366445
44,6,12,1,2412,-56,-89,33,40:e3:d6:da:ba:25,367520,160,915,367360,367520
45,4,1,1,2412,-85,-89,4,c0:c9:e3:4d:6e:bf,418321,872,49929,417449,418321
46,6,6,1,2412,-72,-89,17,e6:aa:ea:b7:4a:dd,464933,408,46204,464525,464933
47,6,12,1,2412,-55,-89,34,40:e3:d6:da:ba:20,469047,160,3954,468887,469047
48,6,6,1,2412,-56,-89,33,40:e3:d6:da:ba:21,469267,368,-148,468899,469267
49,6,12,1,2412,-56,-89,33,40:e3:d6:da:ba:22,469681,180,234,469501,469681
50,6,12,1,2412,-56,-89,33,40:e3:d6:da:ba:23,469895,184,30,469711,469895
51,6,12,1,2412,-56,-89,33,40:e3:d6:da:ba:24,470114,176,43,469938,470114
52,6,12,1,2412,-56,-89,33,40:e3:d6:da:ba:25,470324,160,50,470164,470324
53,6,6,1,2412,-56,-89,33,40:e3:d6:da:ba:26,470516,380,-188,470136,470516
54,6,6,1,2412,-49,-89,40,e6:aa:ea:c9:ea:33,519727,408,48803,519319,519727
55,6,6,1,2412,-48,-89,41,e6:aa:ea:c9:ea:33,531846,408,11711,531438,531846
56,6,6,1,2412,-48,-89,41,e6:aa:ea:c9:ea:33,543953,408,11699,543545,543953
57,6,6,1,2412,-49,-89,40,e6:aa:ea:c9:ea:33,556085,408,11724,555677,556085
58,6,6,1,2412,-49,-89,40,e6:aa:ea:c9:ea:33,568188,408,11695,567780,568188
59,6,12,1,2412,-56,-89,33,40:e3:d6:da:ba:20,571054,160,2706,570894,571054
60,6,6,1,2412,-56,-89,33,40:e3:d6:da:ba:21,571273,368,-149,570905,571273
61,6,12,1,2412,-56,-89,33,40:e3:d6:da:ba:22,571660,180,207,571480,571660
62,6,12,1,2412,-56,-89,33,40:e3:d6:da:ba:23,571893,184,49,571709,571893
63,6,12,1,2412,-56,-89,33,40:e3:d6:da:ba:24,572102,176,33,571926,572102
64,6,12,1,2412,-55,-89,34,40:e3:d6:da:ba:25,572312,160,50,572152,572312
65,6,6,1,2412,-56,-89,33,40:e3:d6:da:ba:26,572513,380,-179,572133,572513
66,4,1,1,2412,-73,-89,16,54:e4:3a:ec:fb:64,582473,2160,7800,580313,582473
67,4,1,1,2412,-87,-89,2,b8:3a:5a:88:e6:e0,584657,2360,-176,582297,584657
68,4,1,1,2412,-82,-89,7,a6:e5:7c:28:b1:d3,667649,944,82048,666705,667649
69,4,1,1,2412,-82,-89,7,a6:e5:7c:28:b1:d3,668700,944,107,667756,668700
70,4,1,1,2412,-84,-89,5,a6:e5:7c:28:b1:d3,669751,944,107,668807,669751
71,4,1,1,2412,-77,-89,12,a6:e5:7c:28:b1:d3,670802,944,107,669858,670802
72,4,1,1,2412,-83,-89,6,a6:e5:7c:28:b1:d3,672068,944,322,671124,672068
73,4,1,1,2412,-69,-89,20,a6:e5:7c:28:b1:d3,674223,944,1211,673279,674223
74,4,1,1,2412,-80,-89,9,a6:e5:7c:28:b1:d3,675319,944,152,674375,675319
75,4,1,1,2412,-82,-89,7,a6:e5:7c:28:b1:d3,676379,944,116,675435,676379
76,4,1,1,2412,-83,-89,6,a6:e5:7c:28:b1:d3,677466,944,143,676522,677466
77,4,1,1,2412,-65,-89,24,a6:e5:7c:28:b1:d3,678535,944,125,677591,678535
78,6,12,1,2412,-56,-89,33,40:e3:d6:da:ba:20,679662,160,967,679502,679662
79,6,6,1,2412,-56,-89,33,40:e3:d6:da:ba:21,679881,368,-149,679513,679881
80,6,12,1,2412,-56,-89,33,40:e3:d6:da:ba:22,680295,180,234,680115,680295
81,6,12,1,2412,-56,-89,33,40:e3:d6:da:ba:23,680519,184,40,680335,680519
82,6,12,1,2412,-56,-89,33,40:e3:d6:da:ba:24,680737,176,42,680561,680737
83,6,12,1,2412,-56,-89,33,40:e3:d6:da:ba:25,680939,160,42,680779,680939
84,6,6,1,2412,-56,-89,33,40:e3:d6:da:ba:26,681158,380,-161,680778,681158
85,4,1,1,2412,-73,-89,16,54:e4:3a:ec:fb:64,684872,2160,1554,682712,684872
86,6,6,1,2412,-83,-89,6,e6:aa:ea:c9:ea:1b,727384,408,42104,726976,727384
87,6,6,1,2412,-84,-89,5,e6:aa:ea:c9:ea:1b,739471,408,11679,739063,739471
88,6,12,1,2412,-56,-89,33,40:e3:d6:da:ba:20,775877,160,36246,775717,775877
89,6,6,1,2412,-55,-89,34,40:e3:d6:da:ba:21,776103,368,-142,775735,776103
90,6,12,1,2412,-54,-89,35,40:e3:d6:da:ba:22,776505,180,222,776325,776505
91,6,12,1,2412,-56,-89,33,40:e3:d6:da:ba:23,776720,184,31,776536,776720
92,6,12,1,2412,-56,-89,33,40:e3:d6:da:ba:24,776957,176,61,776781,776957
93,6,12,1,2412,-56,-89,33,40:e3:d6:da:ba:25,777167,160,50,777007,777167
94,6,6,1,2412,-56,-89,33,40:e3:d6:da:ba:26,777377,380,-170,776997,777377
95,4,1,1,2412,-60,-89,29,54:e4:3a:ec:fb:64,787562,2160,8025,785402,787562
96,4,1,1,2412,-72,-89,17,de:58:69:86:8b:78,831776,992,43222,830784,831776
97,6,12,1,2412,-56,-89,33,40:e3:d6:da:ba:20,835257,136,3345,835121,835257
98,6,12,1,2412,-70,-89,19,,835410,32,121,835378,835410
99,6,6,1,2412,-56,-89,33,40:e3:d6:da:ba:21,835511,348,-247,835163,835511
100,6,12,1,2412,-56,-89,33,40:e3:d6:da:ba:22,837528,156,1861,837372,837528
101,6,12,1,2412,-56,-89,33,40:e3:d6:da:ba:23,837909,156,225,837753,837909
102,6,12,1,2412,-70,-89,19,,838083,32,142,838051,838083
103,6,12,1,2412,-56,-89,33,40:e3:d6:da:ba:25,838168,136,-51,838032,838168
104,6,12,1,2412,-70,-89,19,,838322,32,122,838290,838322
105,6,6,1,2412,-49,-89,40,e6:aa:ea:c9:ea:33,846856,408,8126,846448,846856
106,4,1,1,2412,-72,-89,17,,856301,304,9141,855997,856301
107,6,12,1,2412,-56,-89,33,40:e3:d6:da:ba:20,856465,136,28,856329,856465
108,6,12,1,2412,-71,-89,18,,857574,32,1077,857542,857574
109,6,12,1,2412,-70,-89,19,,858241,32,635,858209,858241
110,6,12,1,2412,-57,-89,32,40:e3:d6:da:ba:25,858907,136,530,858771,858907
111,6,6,1,2412,-49,-89,40,e6:aa:ea:c9:ea:33,859161,408,-154,858753,859161
112,6,12,1,2412,-69,-89,20,,860034,32,841,860002,860034
113,6,6,1,2412,-49,-89,40,e6:aa:ea:c9:ea:33,871098,408,10656,870690,871098
114,6,12,1,2412,-56,-89,33,40:e3:d6:da:ba:20,878274,160,7016,878114,878274
115,6,6,1,2412,-56,-89,33,40:e3:d6:da:ba:21,878475,368,-167,878107,878475
116,6,12,1,2412,-56,-89,33,40:e3:d6:da:ba:22,878862,180,207,878682,878862
117,6,12,1,2412,-56,-89,33,40:e3:d6:da:ba:23,879076,184,30,878892,879076
118,6,12,1,2412,-56,-89,33,40:e3:d6:da:ba:24,879295,176,43,879119,879295
119,6,12,1,2412,-56,-89,33,40:e3:d6:da:ba:25,879523,160,68,879363,879523
120,6,6,1,2412,-56,-89,33,40:e3:d6:da:ba:26,879742,380,-161,879362,879742
121,6,6,1,2412,-49,-89,40,e6:aa:ea:c9:ea:33,883214,408,3064,882806,883214
122,6,12,1,2412,-56,-89,33,40:e3:d6:da:ba:20,886208,136,2858,886072,886208
123,6,6,1,2412,-56,-89,33,40:e3:d6:da:ba:21,886412,348,-144,886064,886412
124,6,12,1,2412,-56,-89,33,40:e3:d6:da:ba:22,886788,156,220,886632,886788
125,6,12,1,2412,-56,-89,33,40:e3:d6:da:ba:23,886987,156,43,886831,886987
126,6,12,1,2412,-56,-89,33,40:e3:d6:da:ba:25,887177,136,54,887041,887177
127,4,1,1,2412,-85,-89,4,b8:3a:5a:88:e6:e0,891872,2360,2335,889512,891872
128,4,1,1,2412,-86,-89,3,b8:3a:5a:88:e6:e1,894279,2376,31,891903,894279
129,4,1,1,2412,-85,-89,4,c0:c9:e3:4d:6e:bf,909503,872,14352,908631,909503
130,6,12,1,2412,-57,-89,32,40:e3:d6:da:ba:20,980676,160,71013,980516,980676
131,6,12,1,2412,-56,-89,33,40:e3:d6:da:ba:22,981308,180,452,981128,981308
132,6,12,1,2412,-56,-89,33,40:e3:d6:da:ba:23,981540,184,48,981356,981540
133,6,12,1,2412,-56,-89,33,40:e3:d6:da:ba:24,981768,176,52,981592,981768
134,6,12,1,2412,-55,-89,34,40:e3:d6:da:ba:25,981978,160,50,981818,981978
135,6,6,1,2412,-56,-89,33,40:e3:d6:da:ba:26,982188,380,-170,981808,982188
136,6,6,1,2412,-72,-89,17,e6:aa:ea:b7:4a:dd,984541,408,1945,984133,984541
137,6,6,1,2412,-74,-89,15,e6:aa:ea:b7:4a:dd,1008773,408,23824,1008365,1008773
138,6,12,1,2412,-56,-89,33,40:e3:d6:da:ba:20,1083066,160,74133,1082906,1083066
139,6,6,1,2412,-56,-89,33,40:e3:d6:da:ba:21,1083276,368,-158,1082908,1083276
140,6,12,1,2412,-56,-89,33,40:e3:d6:da:ba:22,1083663,180,207,1083483,1083663
141,6,12,1,2412,-56,-89,33,40:e3:d6:da:ba:23,1083877,184,30,1083693,1083877
142,6,12,1,2412,-56,-89,33,40:e3:d6:da:ba:24,1084114,176,61,1083938,1084114
143,6,12,1,2412,-56,-89,33,40:e3:d6:da:ba:25,1084315,160,41,1084155,1084315
144,6,6,1,2412,-56,-89,33,40:e3:d6:da:ba:26,1084525,380,-170,1084145,1084525
145,4,1,1,2412,-85,-89,4,b8:3a:5a:88:e6:e0,1096678,2360,9793,1094318,1096678
146,4,1,1,2412,-86,-89,3,b8:3a:5a:88:e6:e1,1099067,2376,13,1096691,1099067
147,6,6,1,2412,-85,-89,4,e6:aa:ea:c9:ea:1b,1122208,408,22733,1121800,1122208
148,6,6,1,2412,-85,-89,4,e6:aa:ea:c9:ea:1b,1158555,408,35939,1158147,1158555
149,6,12,1,2412,-56,-89,33,40:e3:d6:da:ba:20,1185463,160,26748,1185303,1185463
150,6,6,1,2412,-56,-89,33,40:e3:d6:da:ba:21,1185681,368,-150,1185313,1185681
151,6,12,1,2412,-56,-89,33,40:e3:d6:da:ba:22,1186086,180,225,1185906,1186086
152,6,12,1,2412,-56,-89,33,40:e3:d6:da:ba:23,1186310,184,40,1186126,1186310
153,6,12,1,2412,-56,-89,33,40:e3:d6:da:ba:24,1186546,176,60,1186370,1186546
154,6,12,1,2412,-56,-89,33,40:e3:d6:da:ba:25,1186766,160,60,1186606,1186766
155,6,6,1,2412,-56,-89,33,40:e3:d6:da:ba:26,1186985,380,-161,1186605,1186985
156,4,1,1,2412,-74,-89,15,54:e4:3a:ec:fb:64,1196867,2160,7722,1194707,1196867
157,6,6,1,2412,-49,-89,40,e6:aa:ea:c9:ea:33,1264182,408,66907,1263774,1264182
158,6,6,1,2412,-49,-89,40,e6:aa:ea:c9:ea:33,1276314,408,11724,1275906,1276314
159,6,12,1,2412,-56,-89,33,40:e3:d6:da:ba:22,1289865,180,13371,1289685,1289865
160,6,12,1,2412,-55,-89,34,40:e3:d6:da:ba:24,1290345,176,304,1290169,1290345
161,6,12,1,2412,-56,-89,33,40:e3:d6:da:ba:25,1290565,160,60,1290405,1290565
162,6,6,1,2412,-56,-89,33,40:e3:d6:da:ba:26,1290783,380,-162,1290403,1290783
163,4,1,1,2412,-86,-89,3,b8:3a:5a:88:e6:e0,1301460,2360,8317,1299100,1301460
164,4,1,1,2412,-60,-89,29,b8:3a:5a:88:e6:e1,1303858,2376,22,1301482,1303858
165,6,12,1,2412,-55,-89,34,40:e3:d6:da:ba:20,1390277,160,86259,1390117,1390277
166,6,6,1,2412,-55,-89,34,40:e3:d6:da:ba:21,1390496,368,-149,1390128,1390496
167,6,12,1,2412,-56,-89,33,40:e3:d6:da:ba:22,1390891,180,215,1390711,1390891
168,6,12,1,2412,-55,-89,34,40:e3:d6:da:ba:23,1391106,184,31,1390922,1391106
169,6,12,1,2412,-56,-89,33,40:e3:d6:da:ba:24,1391333,176,51,1391157,1391333
170,6,12,1,2412,-54,-89,35,40:e3:d6:da:ba:25,1391535,160,42,1391375,1391535
171,6,6,1,2412,-56,-89,33,40:e3:d6:da:ba:26,1391735,380,-180,1391355,1391735
172,4,1,1,2412,-82,-89,7,c0:c9:e3:4d:6e:bf,1398902,872,6295,1398030,1398902
173,6,12,1,2412,-56,-89,33,40:e3:d6:da:ba:20,1492880,160,93818,1492720,1492880
174,6,6,1,2412,-56,-89,33,40:e3:d6:da:ba:21,1493090,368,-158,1492722,1493090
175,6,12,1,2412,-55,-89,34,40:e3:d6:da:ba:22,1493504,180,234,1493324,1493504
176,6,12,1,2412,-56,-89,33,40:e3:d6:da:ba:23,1493719,184,31,1493535,1493719
177,6,12,1,2412,-56,-89,33,40:e3:d6:da:ba:24,1493955,176,60,1493779,1493955
178,6,12,1,2412,-56,-89,33,40:e3:d6:da:ba:25,1494183,160,68,1494023,1494183
179,6,6,1,2412,-56,-89,33,40:e3:d6:da:ba:26,1494393,380,-170,1494013,1494393
180,4,1,1,2412,-85,-89,4,b8:3a:5a:88:e6:e0,1506266,2360,9513,1503906,1506266
181,6,6,1,2412,-72,-89,17,e6:aa:ea:b7:4a:dd,1516695,408,10021,1516287,1516695
182,6,6,1,2412,-48,-89,41,e6:aa:ea:c9:ea:33,1568767,408,51664,1568359,1568767
183,6,6,1,2412,-48,-89,41,e6:aa:ea:c9:ea:33,1580865,408,11690,1580457,1580865
184,4,1,1,2412,-80,-89,9,a4:e5:7c:28:b1:d3,1582773,688,1220,1582085,1582773
185,6,6,1,2412,-48,-89,41,e6:aa:ea:c9:ea:33,1593048,408,9867,1592640,1593048
186,6,12,1,2412,-56,-89,33,40:e3:d6:da:ba:20,1595078,160,1870,1594918,1595078
187,6,6,1,2412,-56,-89,33,40:e3:d6:da:ba:21,1595270,368,-176,1594902,1595270
188,6,12,1,2412,-56,-89,33,40:e3:d6:da:ba:22,1595657,180,207,1595477,1595657
189,6,12,1,2412,-56,-89,33,40:e3:d6:da:ba:23,1595889,184,48,1595705,1595889
190,6,12,1,2412,-56,-89,33,40:e3:d6:da:ba:24,1596141,176,76,1595965,1596141
191,6,12,1,2412,-56,-89,33,40:e3:d6:da:ba:25,1596343,160,42,1596183,1596343
192,6,6,1,2412,-56,-89,33,40:e3:d6:da:ba:26,1596534,380,-189,1596154,1596534
193,6,6,1,2412,-48,-89,41,e6:aa:ea:c9:ea:33,1605104,408,8162,1604696,1605104
194,6,6,1,2412,-49,-89,40,e6:aa:ea:c9:ea:33,1617224,408,11712,1616816,1617224
195,6,12,1,2412,-55,-89,34,40:e3:d6:da:ba:20,1697476,160,80092,1697316,1697476
196,6,6,1,2412,-56,-89,33,40:e3:d6:da:ba:21,1697695,368,-149,1697327,1697695
197,6,12,1,2412,-56,-89,33,40:e3:d6:da:ba:22,1698100,180,225,1697920,1698100
198,6,12,1,2412,-56,-89,33,40:e3:d6:da:ba:23,1698333,184,49,1698149,1698333
199,6,12,1,2412,-55,-89,34,40:e3:d6:da:ba:24,1698569,176,60,1698393,1698569
200,6,12,1,2412,-56,-89,33,40:e3:d6:da:ba:25,1698789,160,60,1698629,1698789
201,6,12,1,2412,-55,-89,34,40:e3:d6:da:ba:23,1802323,184,103350,1802139,1802323
202,6,12,1,2412,-56,-89,33,40:e3:d6:da:ba:24,1802532,176,33,1802356,1802532
203,6,6,1,2412,-55,-89,34,40:e3:d6:da:ba:26,1803017,380,105,1802637,1803017
204,4,1,1,2412,-73,-89,16,54:e4:3a:ec:fb:64,1811262,2160,6085,1809102,1811262
205,4,1,1,2412,-81,-89,8,b8:3a:5a:88:e6:e1,1815843,2376,2205,1813467,1815843
206,6,6,1,2412,-71,-89,18,e6:aa:ea:b7:4a:dd,1819485,408,3234,1819077,1819485
207,6,6,1,2412,-71,-89,18,e6:aa:ea:b7:4a:dd,1843730,408,23837,1843322,1843730
208,6,6,1,2412,-71,-89,18,e6:aa:ea:b7:4a:dd,1855842,408,11704,1855434,1855842
209,6,6,1,2412,-47,-89,42,e6:aa:ea:c9:ea:33,1884764,408,28514,1884356,1884764
210,4,1,1,2412,-64,-89,25,c0:c9:e3:4d:6e:bf,1893711,872,8075,1892839,1893711
211,6,6,1,2412,-47,-89,42,e6:aa:ea:c9:ea:33,1896886,408,2767,1896478,1896886
212,6,12,1,2412,-55,-89,34,40:e3:d6:da:ba:20,1902275,160,5229,1902115,1902275
213,6,6,1,2412,-55,-89,34,40:e3:d6:da:ba:21,1903664,368,1021,1903296,1903664
214,6,12,1,2412,-55,-89,34,40:e3:d6:da:ba:22,1904061,180,217,1903881,1904061
215,6,12,1,2412,-55,-89,34,40:e3:d6:da:ba:23,1904308,184,63,1904124,1904308
216,6,12,1,2412,-55,-89,34,40:e3:d6:da:ba:24,1904517,176,33,1904341,1904517
217,6,12,1,2412,-55,-89,34,40:e3:d6:da:ba:25,1904746,160,69,1904586,1904746
218,6,6,1,2412,-55,-89,34,40:e3:d6:da:ba:26,1904938,380,-188,1904558,1904938
219,6,6,1,2412,-46,-89,43,e6:aa:ea:c9:ea:33,1911161,408,5815,1910753,1911161
220,4,1,1,2412,-71,-89,18,54:e4:3a:ec:fb:64,1913662,2160,341,1911502,1913662
221,4,1,1,2412,-82,-89,7,b8:3a:5a:88:e6:e0,1915855,2360,-167,1913495,1915855
222,6,6,1,2412,-46,-89,43,e6:aa:ea:c9:ea:33,1921110,408,4847,1920702,1921110
223,6,6,1,2412,-46,-89,43,e6:aa:ea:c9:ea:33,1933220,408,11702,1932812,1933220
224,4,1,1,2412,-82,-89,7,,1940162,304,6638,1939858,1940162
225,6,6,1,2412,-84,-89,5,e6:aa:ea:c9:ea:1b,1974484,408,33914,1974076,1974484
226,6,6,1,2412,-82,-89,7,e6:aa:ea:c9:ea:1b,1998900,408,24008,1998492,1998900
227,6,12,1,2412,-55,-89,34,40:e3:d6:da:ba:20,2004661,160,5601,2004501,2004661
228,6,6,1,2412,-55,-89,34,40:e3:d6:da:ba:21,2004871,368,-158,2004503,2004871
229,6,12,1,2412,-55,-89,34,40:e3:d6:da:ba:22,2005285,180,234,2005105,2005285
230,6,12,1,2412,-55,-89,34,40:e3:d6:da:ba:23,2005508,184,39,2005324,2005508
231,6,12,1,2412,-55,-89,34,40:e3:d6:da:ba:24,2005745,176,61,2005569,2005745
232,6,12,1,2412,-55,-89,34,40:e3:d6:da:ba:25,2005946,160,41,2005786,2005946
233,6,6,1,2412,-55,-89,34,40:e3:d6:da:ba:26,2006147,380,-179,2005767,2006147
234,4,1,1,2412,-70,-89,19,54:e4:3a:ec:fb:64,2016061,2160,7754,2013901,2016061
235,6,6,1,2412,-47,-89,42,,2035209,44,19104,2035165,2035209
236,6,6,1,2412,-48,-89,41,,2045964,44,10711,2045920,2045964
237,6,6,1,2412,-46,-89,43,,2060214,44,14206,2060170,2060214
238,6,6,1,2412,-47,-89,42,,2085210,44,24952,2085166,2085210
239,6,12,1,2412,-56,-89,33,40:e3:d6:da:ba:20,2107061,160,21691,2106901,2107061
240,6,6,1,2412,-56,-89,33,40:e3:d6:da:ba:21,2107280,368,-149,2106912,2107280
241,6,12,1,2412,-55,-89,34,40:e3:d6:da:ba:22,2107676,180,216,2107496,2107676
242,6,12,1,2412,-56,-89,33,40:e3:d6:da:ba:23,2107890,184,30,2107706,2107890
243,6,12,1,2412,-56,-89,33,40:e3:d6:da:ba:24,2108109,176,43,2107933,2108109
244,6,12,1,2412,-56,-89,33,40:e3:d6:da:ba:25,2108320,160,51,2108160,2108320
245,6,6,1,2412,-53,-89,36,40:e3:d6:da:ba:26,2108538,380,-162,2108158,2108538
246,6,6,1,2412,-46,-89,43,,2110209,44,1627,2110165,2110209
247,4,1,1,2412,-69,-89,20,54:e4:3a:ec:fb:64,2118459,2160,6090,2116299,2118459
248,6,12,1,2412,-57,-89,32,40:e3:d6:da:ba:20,2209472,160,90853,2209312,2209472
249,6,6,1,2412,-56,-89,33,40:e3:d6:da:ba:21,2209682,368,-158,2209314,2209682
250,6,12,1,2412,-56,-89,33,40:e3:d6:da:ba:22,2210096,180,234,2209916,2210096
251,6,12,1,2412,-56,-89,33,40:e3:d6:da:ba:23,2210311,184,31,2210127,2210311
252,6,12,1,2412,-56,-89,33,40:e3:d6:da:ba:24,2210520,176,33,2210344,2210520
253,6,12,1,2412,-56,-89,33,40:e3:d6:da:ba:25,2210721,160,41,2210561,2210721
254,6,6,1,2412,-56,-89,33,40:e3:d6:da:ba:26,2210913,380,-188,2210533,2210913
255,6,6,1,2412,-48,-89,41,e6:aa:ea:c9:ea:33,2211994,408,673,2211586,2211994
256,6,6,1,2412,-47,-89,42,e6:aa:ea:c9:ea:33,2236366,408,23964,2235958,2236366
257,6,6,1,2412,-75,-89,14,e6:aa:ea:b7:4a:dd,2272877,408,36103,2272469,2272877
258,6,12,1,2412,-56,-89,33,40:e3:d6:da:ba:20,2311878,160,38841,2311718,2311878
259,6,6,1,2412,-56,-89,33,40:e3:d6:da:ba:21,2312088,368,-158,2311720,2312088
260,6,12,1,2412,-56,-89,33,40:e3:d6:da:ba:22,2312502,180,234,2312322,2312502
261,6,12,1,2412,-56,-89,33,40:e3:d6:da:ba:23,2312716,184,30,2312532,2312716
262,6,12,1,2412,-56,-89,33,40:e3:d6:da:ba:24,2312953,176,61,2312777,2312953
263,6,12,1,2412,-56,-89,33,40:e3:d6:da:ba:25,2313181,160,68,2313021,2313181
264,6,6,1,2412,-56,-89,33,40:e3:d6:da:ba:26,2313400,380,-161,2313020,2313400
265,4,1,1,2412,-83,-89,6,b8:3a:5a:88:e6:e1,2327114,2376,11338,2324738,2327114
266,6,6,1,2412,-82,-89,7,e6:aa:ea:c9:ea:1b,2394928,408,67406,2394520,2394928
267,6,12,1,2412,-56,-89,33,40:e3:d6:da:ba:20,2414282,160,19194,2414122,2414282
268,6,6,1,2412,-56,-89,33,40:e3:d6:da:ba:21,2414500,368,-150,2414132,2414500
269,6,12,1,2412,-56,-89,33,40:e3:d6:da:ba:22,2414887,180,207,2414707,2414887
270,6,12,1,2412,-56,-89,33,40:e3:d6:da:ba:23,2415102,184,31,2414918,2415102
271,6,12,1,2412,-55,-89,34,40:e3:d6:da:ba:24,2415338,176,60,2415162,2415338
272,6,12,1,2412,-56,-89,33,40:e3:d6:da:ba:25,2415540,160,42,2415380,2415540
273,6,6,1,2412,-56,-89,33,40:e3:d6:da:ba:26,2415740,380,-180,2415360,2415740
274,6,6,1,2412,-83,-89,6,e6:aa:ea:c9:ea:1b,2419151,408,3003,2418743,2419151
275,4,1,1,2412,-79,-89,10,a6:e5:7c:28:b1:d3,2490388,992,70245,2489396,2490388
276,6,12,1,2412,-57,-89,32,40:e3:d6:da:ba:20,2516673,160,26125,2516513,2516673
277,6,6,1,2412,-57,-89,32,40:e3:d6:da:ba:21,2516883,368,-158,2516515,2516883
278,6,12,1,2412,-57,-89,32,40:e3:d6:da:ba:22,2517270,180,207,2517090,2517270
279,6,12,1,2412,-57,-89,32,40:e3:d6:da:ba:23,2517502,184,48,2517318,2517502
280,6,12,1,2412,-57,-89,32,40:e3:d6:da:ba:24,2517721,176,43,2517545,2517721
281,6,12,1,2412,-57,-89,32,40:e3:d6:da:ba:25,2517922,160,41,2517762,2517922
282,6,6,1,2412,-57,-89,32,40:e3:d6:da:ba:26,2518141,380,-161,2517761,2518141
283,6,6,1,2412,-57,-89,32,40:e3:d6:da:ba:21,2619285,368,100776,2618917,2619285
284,6,12,1,2412,-57,-89,32,40:e3:d6:da:ba:22,2619681,180,216,2619501,2619681
285,6,12,1,2412,-58,-89,31,40:e3:d6:da:ba:23,2619895,184,30,2619711,2619895
286,6,12,1,2412,-58,-89,31,40:e3:d6:da:ba:24,2620105,176,34,2619929,2620105
287,6,12,1,2412,-58,-89,31,40:e3:d6:da:ba:25,2620306,160,41,2620146,2620306
288,6,6,1,2412,-57,-89,32,40:e3:d6:da:ba:26,2620507,380,-179,2620127,2620507
289,4,1,1,2412,-83,-89,6,b8:3a:5a:88:e6:e0,2632955,2360,10088,2630595,2632955
290,6,12,1,2412,-57,-89,32,40:e3:d6:da:ba:20,2721490,160,88375,2721330,2721490
291,6,6,1,2412,-57,-89,32,40:e3:d6:da:ba:21,2721709,368,-149,2721341,2721709
292,6,12,1,2412,-57,-89,32,40:e3:d6:da:ba:22,2722114,180,225,2721934,2722114
293,6,12,1,2412,-57,-89,32,40:e3:d6:da:ba:23,2722319,184,21,2722135,2722319
294,6,12,1,2412,-57,-89,32,40:e3:d6:da:ba:24,2722547,176,52,2722371,2722547
295,6,12,1,2412,-57,-89,32,40:e3:d6:da:ba:25,2722775,160,68,2722615,2722775
296,6,6,1,2412,-57,-89,32,40:e3:d6:da:ba:26,2722967,380,-188,2722587,2722967
297,4,1,1,2412,-73,-89,16,54:e4:3a:ec:fb:64,2732998,2160,7871,2730838,2732998
298,6,6,1,2412,-46,-89,43,e6:aa:ea:c9:ea:33,2743860,408,10454,2743452,2743860
299,6,6,1,2412,-47,-89,42,e6:aa:ea:c9:ea:33,2768102,408,23834,2767694,2768102
300,6,6,1,2412,-73,-89,16,e6:aa:ea:b7:4a:dd,2781344,408,12834,2780936,2781344
301,6,12,1,2412,-55,-89,34,40:e3:d6:da:ba:20,2823866,160,42362,2823706,2823866
302,6,6,1,2412,-55,-89,34,40:e3:d6:da:ba:21,2824066,368,-168,2823698,2824066
303,6,12,1,2412,-55,-89,34,40:e3:d6:da:ba:22,2824462,180,216,2824282,2824462
304,6,12,1,2412,-55,-89,34,40:e3:d6:da:ba:23,2824668,184,22,2824484,2824668
305,6,12,1,2412,-55,-89,34,40:e3:d6:da:ba:24,2825801,176,957,2825625,2825801
306,6,12,1,2412,-55,-89,34,40:e3:d6:da:ba:25,2826011,160,50,2825851,2826011
307,6,6,1,2412,-55,-89,34,40:e3:d6:da:ba:26,2826221,380,-170,2825841,2826221
308,4,1,1,2412,-83,-89,6,b8:3a:5a:88:e6:e0,2838094,2360,9513,2835734,2838094
309,4,1,1,2412,-73,-89,16,c0:c9:e3:4d:6e:bf,2874434,872,35468,2873562,2874434
310,4,1,1,2412,-87,-89,2,,2875323,304,585,2875019,2875323
311,4,1,1,2412,-87,-89,2,,2921177,304,45550,2920873,2921177
312,6,12,1,2412,-58,-89,31,40:e3:d6:da:ba:20,2926266,160,4929,2926106,2926266
313,6,6,1,2412,-57,-89,32,40:e3:d6:da:ba:21,2926846,368,212,2926478,2926846
314,6,12,1,2412,-57,-89,32,40:e3:d6:da:ba:23,2927474,184,444,2927290,2927474
315,6,12,1,2412,-57,-89,32,40:e3:d6:da:ba:24,2927711,176,61,2927535,2927711
316,6,12,1,2412,-57,-89,32,40:e3:d6:da:ba:25,2927921,160,50,2927761,2927921
317,6,6,1,2412,-58,-89,31,40:e3:d6:da:ba:26,2928140,380,-161,2927760,2928140
318,4,1,1,2412,-87,-89,2,,3023515,304,95071,3023211,3023515
319,4,1,1,2412,-87,-89,2,,3027418,304,3599,3027114,3027418
320,6,6,1,2412,-60,-89,29,40:e3:d6:da:ba:21,3030120,368,2334,3029752,3030120
321,6,12,1,2412,-60,-89,29,40:e3:d6:da:ba:23,3030817,184,513,3030633,3030817
322,6,12,1,2412,-59,-89,30,40:e3:d6:da:ba:24,3031053,176,60,3030877,3031053
323,6,12,1,2412,-61,-89,28,40:e3:d6:da:ba:25,3031272,160,59,3031112,3031272
324,6,6,1,2412,-61,-89,28,40:e3:d6:da:ba:26,3031483,380,-169,3031103,3031483
325,6,6,1,2412,-49,-89,40,e6:aa:ea:c9:ea:33,3034837,408,2946,3034429,3034837
326,4,1,1,2412,-69,-89,20,54:e4:3a:ec:fb:64,3040052,2160,3055,3037892,3040052
327,6,6,1,2412,-50,-89,39,e6:aa:ea:c9:ea:33,3059048,408,18588,3058640,3059048
328,6,6,1,2412,-51,-89,38,e6:aa:ea:c9:ea:33,3071162,408,11706,3070754,3071162
329,6,6,1,2412,-77,-89,12,78:8a:20:fa:27:f9,3078725,88,7475,3078637,3078725
330,6,12,1,2412,-78,-89,11,,3079089,32,332,3079057,3079089
331,6,12,1,2412,-78,-89,11,,3079312,32,191,3079280,3079312
332,6,6,1,2412,-77,-89,12,,3079759,44,403,3079715,3079759
333,6,12,1,2412,-77,-89,12,,3080411,32,620,3080379,3080411
334,6,12,1,2412,-78,-89,11,,3080741,32,298,3080709,3080741
335,4,1,1,2412,-78,-89,11,,3082902,304,1857,3082598,3082902
336,6,6,1,2412,-50,-89,39,e6:aa:ea:c9:ea:33,3083275,408,-35,3082867,3083275
337,4,1,1,2412,-84,-89,5,b8:3a:5a:88:e6:e0,3129301,2240,43786,3127061,3129301
338,6,12,1,2412,-57,-89,32,40:e3:d6:da:ba:20,3131419,160,1958,3131259,3131419
339,6,6,1,2412,-57,-89,32,40:e3:d6:da:ba:21,3131815,368,28,3131447,3131815
340,6,12,1,2412,-56,-89,33,40:e3:d6:da:ba:22,3133744,180,1749,3133564,3133744
341,6,12,1,2412,-57,-89,32,40:e3:d6:da:ba:23,3134063,184,135,3133879,3134063
342,6,12,1,2412,-57,-89,32,40:e3:d6:da:ba:24,3134290,176,51,3134114,3134290
343,6,12,1,2412,-56,-89,33,40:e3:d6:da:ba:25,3134492,160,42,3134332,3134492
344,6,6,1,2412,-56,-89,33,40:e3:d6:da:ba:26,3134701,380,-171,3134321,3134701
345,4,1,1,2412,-80,-89,9,,3135675,304,670,3135371,3135675
346,6,12,1,2412,-79,-89,10,,3136328,32,621,3136296,3136328
347,6,12,1,2412,-80,-89,9,,3136973,32,613,3136941,3136973
348,4,1,1,2412,-73,-89,16,54:e4:3a:ec:fb:64,3144945,2160,5812,3142785,3144945
349,6,6,1,2412,-71,-89,18,e6:aa:ea:b7:4a:dd,3175189,408,29836,3174781,3175189
350,6,6,1,2412,-72,-89,17,e6:aa:ea:b7:4a:dd,3187307,408,11710,3186899,3187307
351,6,6,1,2412,-72,-89,17,e6:aa:ea:b7:4a:dd,3199418,408,11703,3199010,3199418
352,6,6,1,2412,-82,-89,7,e6:aa:ea:c9:ea:1b,3210864,408,11038,3210456,3210864
353,6,6,1,2412,-72,-89,17,e6:aa:ea:b7:4a:dd,3211534,408,262,3211126,3211534
354,6,12,1,2412,-57,-89,32,40:e3:d6:da:ba:20,3233467,160,21773,3233307,3233467
355,6,6,1,2412,-56,-89,33,40:e3:d6:da:ba:21,3233668,368,-167,3233300,3233668
356,6,12,1,2412,-56,-89,33,40:e3:d6:da:ba:22,3234082,180,234,3233902,3234082
357,6,12,1,2412,-56,-89,33,40:e3:d6:da:ba:23,3234297,184,31,3234113,3234297
358,6,12,1,2412,-56,-89,33,40:e3:d6:da:ba:24,3234515,176,42,3234339,3234515
359,6,12,1,2412,-56,-89,33,40:e3:d6:da:ba:25,3234726,160,51,3234566,3234726
360,6,6,1,2412,-56,-89,33,40:e3:d6:da:ba:26,3234945,380,-161,3234565,3234945
361,6,12,1,2412,-54,-89,35,40:e3:d6:da:ba:20,3335867,160,100762,3335707,3335867
362,6,6,1,2412,-54,-89,35,40:e3:d6:da:ba:21,3336086,368,-149,3335718,3336086
363,6,12,1,2412,-54,-89,35,40:e3:d6:da:ba:22,3336473,180,207,3336293,3336473
364,6,12,1,2412,-54,-89,35,40:e3:d6:da:ba:23,3336705,184,48,3336521,3336705
365,6,12,1,2412,-54,-89,35,40:e3:d6:da:ba:24,3336915,176,34,3336739,3336915
366,6,12,1,2412,-54,-89,35,40:e3:d6:da:ba:25,3337116,160,41,3336956,3337116
367,6,6,1,2412,-54,-89,35,40:e3:d6:da:ba:26,3337335,380,-161,3336955,3337335
368,6,6,1,2412,-46,-89,43,e6:aa:ea:c9:ea:33,3361707,408,23964,3361299,3361707
369,4,1,1,2412,-82,-89,7,,3369227,304,7216,3368923,3369227
370,6,6,1,2412,-46,-89,43,e6:aa:ea:c9:ea:33,3373882,408,4247,3373474,3373882
371,6,6,1,2412,-45,-89,44,e6:aa:ea:c9:ea:33,3387168,408,12878,3386760,3387168
372,6,6,1,2412,-45,-89,44,e6:aa:ea:c9:ea:33,3398071,408,10495,3397663,3398071
373,4,1,1,2412,-82,-89,7,c0:c9:e3:4d:6e:bf,3413506,872,14563,3412634,3413506
374,6,12,1,2412,-54,-89,35,40:e3:d6:da:ba:20,3438293,160,24627,3438133,3438293
375,6,6,1,2412,-53,-89,36,40:e3:d6:da:ba:21,3438503,368,-158,3438135,3438503
376,6,12,1,2412,-53,-89,36,40:e3:d6:da:ba:22,3438917,180,234,3438737,3438917
377,6,12,1,2412,-53,-89,36,40:e3:d6:da:ba:23,3439141,184,40,3438957,3439141
378,6,12,1,2412,-53,-89,36,40:e3:d6:da:ba:24,3439377,176,60,3439201,3439377
379,6,12,1,2412,-53,-89,36,40:e3:d6:da:ba:25,3439579,160,42,3439419,3439579
380,6,6,1,2412,-53,-89,36,40:e3:d6:da:ba:26,3439897,380,-62,3439517,3439897
381,6,6,1,2412,-73,-89,16,e6:aa:ea:b7:4a:dd,3477897,408,37592,3477489,3477897
382,6,12,1,2412,-55,-89,34,40:e3:d6:da:ba:24,3542203,176,64130,3542027,3542203
383,6,12,1,2412,-55,-89,34,40:e3:d6:da:ba:25,3542432,160,69,3542272,3542432
384,6,6,1,2412,-55,-89,34,40:e3:d6:da:ba:26,3542662,380,-150,3542282,3542662
385,4,1,1,2412,-76,-89,13,54:e4:3a:ec:fb:64,3552048,2160,7226,3549888,3552048
386,4,1,1,2412,-82,-89,7,b8:3a:5a:88:e6:e0,3554232,2360,-176,3551872,3554232
387,6,12,1,2412,-59,-89,30,40:e3:d6:da:ba:20,3643095,160,88703,3642935,3643095
388,6,6,1,2412,-59,-89,30,40:e3:d6:da:ba:21,3643305,368,-158,3642937,3643305
389,6,12,1,2412,-59,-89,30,40:e3:d6:da:ba:22,3643710,180,225,3643530,3643710
390,6,12,1,2412,-59,-89,30,40:e3:d6:da:ba:23,3643916,184,22,3643732,3643916
391,6,12,1,2412,-59,-89,30,40:e3:d6:da:ba:24,3644125,176,33,3643949,3644125
392,6,12,1,2412,-59,-89,30,40:e3:d6:da:ba:25,3644354,160,69,3644194,3644354
393,6,6,1,2412,-59,-89,30,40:e3:d6:da:ba:26,3644564,380,-170,3644184,3644564
394,4,1,1,2412,-74,-89,15,54:e4:3a:ec:fb:64,3654448,2160,7724,3652288,3654448
395,6,6,1,2412,-82,-89,7,e6:aa:ea:c9:ea:1b,3744034,408,89178,3743626,3744034
396,6,12,1,2412,-56,-89,33,40:e3:d6:da:ba:20,3745484,160,1290,3745324,3745484
397,6,6,1,2412,-56,-89,33,40:e3:d6:da:ba:21,3745685,368,-167,3745317,3745685
398,6,12,1,2412,-56,-89,33,40:e3:d6:da:ba:22,3746099,180,234,3745919,3746099
399,6,12,1,2412,-55,-89,34,40:e3:d6:da:ba:23,3746323,184,40,3746139,3746323
400,6,6,1,2412,-85,-89,4,e6:aa:ea:c9:ea:1b,3756174,408,9443,3755766,3756174
401,6,6,1,2412,-47,-89,42,e6:aa:ea:c9:ea:33,3767867,408,11285,3767459,3767867
402,6,6,1,2412,-48,-89,41,e6:aa:ea:c9:ea:33,3780001,408,11726,3779593,3780001
403,6,6,1,2412,-48,-89,41,e6:aa:ea:c9:ea:33,3792111,408,11702,3791703,3792111
404,6,6,1,2412,-48,-89,41,e6:aa:ea:c9:ea:33,3804224,408,11705,3803816,3804224
405,6,6,1,2412,-49,-89,40,e6:aa:ea:c9:ea:33,3816349,408,11717,3815941,3816349
406,6,6,1,2412,-72,-89,17,e6:aa:ea:b7:4a:dd,3840883,408,24126,3840475,3840883
407,6,12,1,2412,-59,-89,30,40:e3:d6:da:ba:20,3847870,160,6827,3847710,3847870
408,6,12,1,2412,-58,-89,31,40:e3:d6:da:ba:23,3848724,184,670,3848540,3848724
409,6,12,1,2412,-59,-89,30,40:e3:d6:da:ba:24,3848975,176,75,3848799,3848975
410,6,12,1,2412,-59,-89,30,40:e3:d6:da:ba:25,3849195,160,60,3849035,3849195
411,4,1,1,2412,-82,-89,7,,3862655,304,13156,3862351,3862655
412,4,1,1,2412,-64,-89,25,,3905502,304,42543,3905198,3905502
413,6,6,1,2412,-53,-89,36,40:e3:d6:da:ba:21,3950463,368,44593,3950095,3950463
414,6,12,1,2412,-53,-89,36,40:e3:d6:da:ba:22,3950859,180,216,3950679,3950859
415,6,12,1,2412,-53,-89,36,40:e3:d6:da:ba:23,3951156,184,113,3950972,3951156
416,6,12,1,2412,-53,-89,36,40:e3:d6:da:ba:24,3951366,176,34,3951190,3951366
417,6,12,1,2412,-53,-89,36,40:e3:d6:da:ba:25,3951585,160,59,3951425,3951585
418,6,6,1,2412,-53,-89,36,40:e3:d6:da:ba:26,3951786,380,-179,3951406,3951786
419,6,12,1,2412,-60,-89,29,40:e3:d6:da:ba:20,4053346,160,101400,4053186,4053346
420,6,6,1,2412,-59,-89,30,40:e3:d6:da:ba:21,4053537,368,-177,4053169,4053537
421,6,12,1,2412,-60,-89,29,40:e3:d6:da:ba:23,4054227,184,506,4054043,4054227
422,6,12,1,2412,-60,-89,29,40:e3:d6:da:ba:24,4054446,176,43,4054270,4054446
423,6,12,1,2412,-60,-89,29,40:e3:d6:da:ba:25,4054647,160,41,4054487,4054647
424,6,6,1,2412,-60,-89,29,40:e3:d6:da:ba:26,4054866,380,-161,4054486,4054866
425,6,12,1,2412,-59,-89,30,40:e3:d6:da:ba:20,4155091,160,100065,4154931,4155091
426,6,6,1,2412,-59,-89,30,40:e3:d6:da:ba:21,4155301,368,-158,4154933,4155301
427,6,12,1,2412,-59,-89,30,40:e3:d6:da:ba:22,4155706,180,225,4155526,4155706
428,6,12,1,2412,-59,-89,30,40:e3:d6:da:ba:23,4155939,184,49,4155755,4155939
429,6,12,1,2412,-59,-89,30,40:e3:d6:da:ba:24,4156157,176,42,4155981,4156157
430,6,12,1,2412,-58,-89,31,40:e3:d6:da:ba:25,4156367,160,50,4156207,4156367
431,6,6,1,2412,-58,-89,31,40:e3:d6:da:ba:26,4156560,380,-187,4156180,4156560
432,6,6,1,2412,-45,-89,44,e6:aa:ea:c9:ea:33,4185552,408,28584,4185144,4185552
433,6,6,1,2412,-46,-89,43,e6:aa:ea:c9:ea:33,4216986,408,31026,4216578,4216986
434,6,6,1,2412,-70,-89,19,e6:aa:ea:b7:4a:dd,4221765,408,4371,4221357,4221765
435,6,6,1,2412,-46,-89,43,e6:aa:ea:c9:ea:33,4222793,408,620,4222385,4222793
436,6,6,1,2412,-46,-89,43,e6:aa:ea:c9:ea:33,4234354,408,11153,4233946,4234354
437,6,12,1,2412,-56,-89,33,40:e3:d6:da:ba:20,4257493,160,22979,4257333,4257493
438,6,6,1,2412,-56,-89,33,40:e3:d6:da:ba:21,4257711,368,-150,4257343,4257711
439,6,12,1,2412,-56,-89,33,40:e3:d6:da:ba:22,4258126,180,235,4257946,4258126
440,6,12,1,2412,-56,-89,33,40:e3:d6:da:ba:23,4258340,184,30,4258156,4258340
441,6,12,1,2412,-57,-89,32,40:e3:d6:da:ba:24,4258559,176,43,4258383,4258559
442,6,12,1,2412,-56,-89,33,40:e3:d6:da:ba:25,4258769,160,50,4258609,4258769
443,6,6,1,2412,-56,-89,33,40:e3:d6:da:ba:26,4258970,380,-179,4258590,4258970
444,4,1,1,2412,-68,-89,21,b8:3a:5a:88:e6:e0,4271071,2360,9741,4268711,4271071
445,4,1,1,2412,-82,-89,7,f0:51:ea:e5:56:1b,4335014,1032,62911,4333982,4335014
446,6,12,1,2412,-58,-89,31,40:e3:d6:da:ba:20,4359884,160,24710,4359724,4359884
447,6,6,1,2412,-58,-89,31,40:e3:d6:da:ba:21,4360085,368,-167,4359717,4360085
448,6,12,1,2412,-58,-89,31,40:e3:d6:da:ba:22,4360472,180,207,4360292,4360472
449,6,12,1,2412,-58,-89,31,40:e3:d6:da:ba:24,4360904,176,256,4360728,4360904
450,6,12,1,2412,-58,-89,31,40:e3:d6:da:ba:25,4361124,160,60,4360964,4361124
451,6,6,1,2412,-58,-89,31,40:e3:d6:da:ba:26,4361316,380,-188,4360936,4361316
452,4,1,1,2412,-84,-89,5,b8:3a:5a:88:e6:e0,4373424,2360,9748,4371064,4373424
453,4,1,1,2412,-85,-89,4,b8:3a:5a:88:e6:e1,4375878,2376,78,4373502,4375878
454,6,12,1,2412,-85,-89,4,,4429136,32,53226,4429104,4429136
455,6,12,1,2412,-57,-89,32,40:e3:d6:da:ba:20,4462437,160,33141,4462277,4462437
456,6,6,1,2412,-57,-89,32,40:e3:d6:da:ba:21,4462638,368,-167,4462270,4462638
457,6,12,1,2412,-57,-89,32,40:e3:d6:da:ba:22,4463052,180,234,4462872,4463052
458,6,12,1,2412,-57,-89,32,40:e3:d6:da:ba:24,4463467,176,239,4463291,4463467
459,6,12,1,2412,-56,-89,33,40:e3:d6:da:ba:25,4463668,160,41,4463508,4463668
460,6,6,1,2412,-57,-89,32,40:e3:d6:da:ba:26,4463887,380,-161,4463507,4463887
461,4,1,1,2412,-70,-89,19,b8:3a:5a:88:e6:e1,4476426,2376,10163,4474050,4476426
462,6,6,1,2412,-86,-89,3,a0:59:50:b4:3a:a2,4488207,188,11593,4488019,4488207
463,6,6,1,2412,-84,-89,5,,4489345,44,1094,4489301,4489345
464,4,1,1,2412,-86,-89,3,,4491263,304,1614,4490959,4491263
465,6,6,1,2412,-49,-89,40,e6:aa:ea:c9:ea:33,4500827,408,9156,4500419,4500827
466,6,6,1,2412,-51,-89,38,e6:aa:ea:c9:ea:33,4512960,408,11725,4512552,4512960
467,6,6,1,2412,-52,-89,37,e6:aa:ea:c9:ea:33,4525073,408,11705,4524665,4525073
468,6,6,1,2412,-69,-89,20,e6:aa:ea:b7:4a:dd,4525897,408,416,4525489,4525897
469,6,6,1,2412,-54,-89,35,e6:aa:ea:c9:ea:33,4537188,408,10883,4536780,4537188
470,6,6,1,2412,-70,-89,19,e6:aa:ea:b7:4a:dd,4549717,408,12121,4549309,4549717
471,6,12,1,2412,-56,-89,33,40:e3:d6:da:ba:20,4564684,160,14807,4564524,4564684
472,6,6,1,2412,-56,-89,33,40:e3:d6:da:ba:21,4564876,368,-176,4564508,4564876
473,6,12,1,2412,-56,-89,33,40:e3:d6:da:ba:22,4565272,180,216,4565092,4565272
474,6,12,1,2412,-56,-89,33,40:e3:d6:da:ba:23,4565504,184,48,4565320,4565504
475,6,12,1,2412,-56,-89,33,40:e3:d6:da:ba:24,4565732,176,52,4565556,4565732
476,6,12,1,2412,-56,-89,33,40:e3:d6:da:ba:25,4565933,160,41,4565773,4565933
477,6,6,1,2412,-56,-89,33,40:e3:d6:da:ba:26,4566152,380,-161,4565772,4566152
478,6,6,1,2412,-72,-89,17,e6:aa:ea:b7:4a:dd,4573682,408,7122,4573274,4573682
479,4,1,1,2412,-65,-89,24,54:e4:3a:ec:fb:64,4576040,2160,198,4573880,4576040
480,6,12,1,2412,-58,-89,31,40:e3:d6:da:ba:20,4667074,160,90874,4666914,4667074
481,6,6,1,2412,-58,-89,31,40:e3:d6:da:ba:21,4667348,368,-94,4666980,4667348
482,6,12,1,2412,-58,-89,31,40:e3:d6:da:ba:22,4667762,180,234,4667582,4667762
483,6,12,1,2412,-58,-89,31,40:e3:d6:da:ba:23,4667977,184,31,4667793,4667977
484,6,12,1,2412,-58,-89,31,40:e3:d6:da:ba:24,4668204,176,51,4668028,4668204
485,6,12,1,2412,-58,-89,31,40:e3:d6:da:ba:25,4668415,160,51,4668255,4668415
486,6,6,1,2412,-58,-89,31,40:e3:d6:da:ba:26,4668606,380,-189,4668226,4668606
487,4,1,1,2412,-70,-89,19,b8:3a:5a:88:e6:e0,4697468,2240,26622,4695228,4697468
488,6,12,1,2412,-57,-89,32,40:e3:d6:da:ba:20,4769495,160,71867,4769335,4769495
489,6,6,1,2412,-57,-89,32,40:e3:d6:da:ba:21,4771841,368,1978,4771473,4771841
490,6,12,1,2412,-57,-89,32,40:e3:d6:da:ba:22,4772246,180,225,4772066,4772246
491,6,12,1,2412,-57,-89,32,40:e3:d6:da:ba:23,4772478,184,48,4772294,4772478
492,6,12,1,2412,-57,-89,32,40:e3:d6:da:ba:25,4772951,160,313,4772791,4772951
493,6,6,1,2412,-57,-89,32,40:e3:d6:da:ba:26,4773152,380,-179,4772772,4773152
494,4,1,1,2412,-66,-89,23,a6:e5:7c:28:b1:d3,4774120,944,24,4773176,4774120
495,4,1,1,2412,-73,-89,16,a6:e5:7c:28:b1:d3,4777977,944,2913,4777033,4777977
496,4,1,1,2412,-63,-89,26,54:e4:3a:ec:fb:64,4780837,2160,700,4778677,4780837
497,4,1,1,2412,-82,-89,7,a6:e5:7c:28:b1:d3,4783472,944,1691,4782528,4783472
498,4,1,1,2412,-83,-89,6,a6:e5:7c:28:b1:d3,4785655,944,1239,4784711,4785655
499,6,6,1,2412,-73,-89,16,e6:aa:ea:b7:4a:dd,4839988,408,53925,4839580,4839988
500,6,6,1,2412,-73,-89,16,e6:aa:ea:b7:4a:dd,4852109,408,11713,4851701,4852109
501,6,6,1,2412,-72,-89,17,e6:aa:ea:b7:4a:dd,4864230,408,11713,4863822,4864230
502,4,1,1,2412,-82,-89,7,a6:e5:7c:28:b1:d3,4869963,944,4789,4869019,4869963
503,4,1,1,2412,-84,-89,5,a6:e5:7c:28:b1:d3,4874467,944,3560,4873523,4874467
504,4,1,1,2412,-82,-89,7,a6:e5:7c:28:b1:d3,4875554,944,143,4874610,4875554
505,6,6,1,2412,-72,-89,17,e6:aa:ea:b7:4a:dd,4876347,408,385,4875939,4876347
506,6,12,1,2412,-56,-89,33,40:e3:d6:da:ba:20,4877558,160,1051,4877398,4877558
507,6,6,1,2412,-57,-89,32,40:e3:d6:da:ba:21,4877750,368,-176,4877382,4877750
508,6,12,1,2412,-56,-89,33,40:e3:d6:da:ba:22,4878155,180,225,4877975,4878155
509,6,12,1,2412,-56,-89,33,40:e3:d6:da:ba:23,4878370,184,31,4878186,4878370
510,6,12,1,2412,-56,-89,33,40:e3:d6:da:ba:24,4878579,176,33,4878403,4878579
511,6,12,1,2412,-57,-89,32,40:e3:d6:da:ba:25,4878799,160,60,4878639,4878799
512,6,6,1,2412,-56,-89,33,40:e3:d6:da:ba:26,4879009,380,-170,4878629,4879009
513,4,1,1,2412,-76,-89,13,54:e4:3a:ec:fb:64,4883237,2160,2068,4881077,4883237
514,4,1,1,2412,-75,-89,14,,4955441,304,71900,4955137,4955441
515,6,12,1,2412,-59,-89,30,40:e3:d6:da:ba:20,4974291,160,18690,4974131,4974291
516,6,6,1,2412,-59,-89,30,40:e3:d6:da:ba:21,4974510,368,-149,4974142,4974510
517,6,12,1,2412,-59,-89,30,40:e3:d6:da:ba:22,4974915,180,225,4974735,4974915
518,6,12,1,2412,-58,-89,31,40:e3:d6:da:ba:23,4975129,184,30,4974945,4975129
519,6,12,1,2412,-59,-89,30,40:e3:d6:da:ba:24,4975357,176,52,4975181,4975357
520,6,12,1,2412,-58,-89,31,40:e3:d6:da:ba:25,4975567,160,50,4975407,4975567
521,6,6,1,2412,-58,-89,31,40:e3:d6:da:ba:26,4975759,380,-188,4975379,4975759
522,6,6,1,2412,-45,-89,44,e6:aa:ea:c9:ea:33,5020647,408,44480,5020239,5020647
523,6,6,1,2412,-44,-89,45,e6:aa:ea:c9:ea:33,5032770,408,11715,5032362,5032770
524,6,6,1,2412,-44,-89,45,e6:aa:ea:c9:ea:33,5044871,408,11693,5044463,5044871
525,6,6,1,2412,-44,-89,45,e6:aa:ea:c9:ea:33,5057024,408,11745,5056616,5057024
526,6,6,1,2412,-44,-89,45,e6:aa:ea:c9:ea:33,5069100,408,11668,5068692,5069100
527,6,12,1,2412,-54,-89,35,40:e3:d6:da:ba:20,5076693,160,7433,5076533,5076693
528,6,6,1,2412,-54,-89,35,40:e3:d6:da:ba:21,5076945,368,-116,5076577,5076945
529,6,12,1,2412,-54,-89,35,40:e3:d6:da:ba:22,5077436,180,311,5077256,5077436
530,6,12,1,2412,-54,-89,35,40:e3:d6:da:ba:23,5077642,184,22,5077458,5077642
531,6,12,1,2412,-54,-89,35,40:e3:d6:da:ba:24,5077869,176,51,5077693,5077869
532,6,12,1,2412,-54,-89,35,40:e3:d6:da:ba:25,5078080,160,51,5077920,5078080
533,6,6,1,2412,-54,-89,35,40:e3:d6:da:ba:26,5078299,380,-161,5077919,5078299
534,4,1,1,2412,-73,-89,16,54:e4:3a:ec:fb:64,5088035,2160,7576,5085875,5088035
535,6,12,1,2412,-58,-89,31,40:e3:d6:da:ba:20,5179088,160,90893,5178928,5179088
536,6,6,1,2412,-58,-89,31,40:e3:d6:da:ba:21,5179280,368,-176,5178912,5179280
537,6,12,1,2412,-57,-89,32,40:e3:d6:da:ba:22,5179667,180,207,5179487,5179667
538,6,12,1,2412,-58,-89,31,40:e3:d6:da:ba:23,5179872,184,21,5179688,5179872
539,6,12,1,2412,-57,-89,32,40:e3:d6:da:ba:24,5180081,176,33,5179905,5180081
540,6,12,1,2412,-58,-89,31,40:e3:d6:da:ba:25,5180310,160,69,5180150,5180310
541,6,6,1,2412,-58,-89,31,40:e3:d6:da:ba:26,5180502,380,-188,5180122,5180502
542,4,1,1,2412,-66,-89,23,a6:e5:7c:28:b1:d3,5259179,944,77733,5258235,5259179
543,4,1,1,2412,-87,-89,2,a6:e5:7c:28:b1:d3,5260248,944,125,5259304,5260248
544,4,1,1,2412,-85,-89,4,a6:e5:7c:28:b1:d3,5261317,944,125,5260373,5261317
545,4,1,1,2412,-89,-89,0,a6:e5:7c:28:b1:d3,5262368,944,107,5261424,5262368
546,4,1,1,2412,-87,-89,2,a6:e5:7c:28:b1:d3,5265566,944,2254,5264622,5265566
547,4,1,1,2412,-77,-89,12,a6:e5:7c:28:b1:d3,5267713,944,1203,5266769,5267713
548,4,1,1,2412,-61,-89,28,a6:e5:7c:28:b1:d3,5270299,944,1642,5269355,5270299
549,4,1,1,2412,-87,-89,2,a6:e5:7c:28:b1:d3,5273479,944,2236,5272535,5273479
550,4,1,1,2412,-87,-89,2,a6:e5:7c:28:b1:d3,5278788,944,4365,5277844,5278788
551,4,1,1,2412,-75,-89,14,a6:e5:7c:28:b1:d3,5280141,944,409,5279197,5280141
552,6,12,1,2412,-59,-89,30,40:e3:d6:da:ba:20,5282433,160,2132,5282273,5282433
553,6,6,1,2412,-59,-89,30,40:e3:d6:da:ba:21,5282634,368,-167,5282266,5282634
554,6,12,1,2412,-58,-89,31,40:e3:d6:da:ba:22,5283048,180,234,5282868,5283048
555,6,12,1,2412,-59,-89,30,40:e3:d6:da:ba:23,5283262,184,30,5283078,5283262
556,6,12,1,2412,-58,-89,31,40:e3:d6:da:ba:24,5283499,176,61,5283323,5283499
557,6,12,1,2412,-59,-89,30,40:e3:d6:da:ba:25,5283709,160,50,5283549,5283709
558,6,6,1,2412,-58,-89,31,40:e3:d6:da:ba:26,5283910,380,-179,5283530,5283910
559,4,1,1,2412,-77,-89,12,54:e4:3a:ec:fb:64,5292834,2160,6764,5290674,5292834
560,6,6,1,2412,-45,-89,44,e6:aa:ea:c9:ea:33,5336630,408,43388,5336222,5336630
561,6,6,1,2412,-44,-89,45,e6:aa:ea:c9:ea:33,5348707,408,11669,5348299,5348707
562,6,6,1,2412,-44,-89,45,e6:aa:ea:c9:ea:33,5360824,408,11709,5360416,5360824
563,6,6,1,2412,-45,-89,44,e6:aa:ea:c9:ea:33,5372938,408,11706,5372530,5372938
564,4,1,1,2412,-62,-89,27,,5380818,304,7576,5380514,5380818
565,6,12,1,2412,-55,-89,34,40:e3:d6:da:ba:20,5383888,160,2910,5383728,5383888
566,6,6,1,2412,-54,-89,35,40:e3:d6:da:ba:21,5384109,368,-147,5383741,5384109
567,6,12,1,2412,-60,-89,29,40:e3:d6:da:ba:22,5384523,180,234,5384343,5384523
568,6,12,1,2412,-55,-89,34,40:e3:d6:da:ba:23,5385038,184,331,5384854,5385038
569,6,12,1,2412,-55,-89,34,40:e3:d6:da:ba:25,5385476,160,278,5385316,5385476
570,6,6,1,2412,-55,-89,34,40:e3:d6:da:ba:26,5385668,380,-188,5385288,5385668
571,6,6,1,2412,-45,-89,44,e6:aa:ea:c9:ea:33,5386109,408,33,5385701,5386109
572,4,1,1,2412,-63,-89,26,54:e4:3a:ec:fb:64,5395237,2160,6968,5393077,5395237
573,6,12,1,2412,-53,-89,36,40:e3:d6:da:ba:20,5486407,160,91010,5486247,5486407
574,6,6,1,2412,-53,-89,36,40:e3:d6:da:ba:21,5486617,368,-158,5486249,5486617
575,6,12,1,2412,-53,-89,36,40:e3:d6:da:ba:22,5487022,180,225,5486842,5487022
576,6,12,1,2412,-53,-89,36,40:e3:d6:da:ba:23,5487245,184,39,5487061,5487245
577,6,12,1,2412,-53,-89,36,40:e3:d6:da:ba:24,5487482,176,61,5487306,5487482
578,6,12,1,2412,-53,-89,36,40:e3:d6:da:ba:25,5490140,160,2498,5489980,5490140
579,6,6,1,2412,-53,-89,36,40:e3:d6:da:ba:26,5491115,380,595,5490735,5491115
580,4,1,1,2412,-58,-89,31,54:e4:3a:ec:fb:64,5497632,2160,4357,5495472,5497632
581,4,1,1,2412,-87,-89,2,b8:3a:5a:88:e6:e1,5502213,2376,2205,5499837,5502213
582,6,6,1,2412,-72,-89,17,e6:aa:ea:b7:4a:dd,5584348,408,81727,5583940,5584348
583,6,12,1,2412,-55,-89,34,40:e3:d6:da:ba:20,5588700,160,4192,5588540,5588700
584,6,6,1,2412,-54,-89,35,40:e3:d6:da:ba:21,5588892,368,-176,5588524,5588892
585,6,12,1,2412,-54,-89,35,40:e3:d6:da:ba:22,5589297,180,225,5589117,5589297
586,6,12,1,2412,-54,-89,35,40:e3:d6:da:ba:23,5589502,184,21,5589318,5589502
587,6,12,1,2412,-54,-89,35,40:e3:d6:da:ba:24,5589739,176,61,5589563,5589739
588,6,12,1,2412,-54,-89,35,40:e3:d6:da:ba:25,5589940,160,41,5589780,5589940
589,6,6,1,2412,-54,-89,35,40:e3:d6:da:ba:26,5590159,380,-161,5589779,5590159
590,6,6,1,2412,-73,-89,16,e6:aa:ea:b7:4a:dd,5596465,408,5898,5596057,5596465
591,4,1,1,2412,-65,-89,24,b8:3a:5a:88:e6:e1,5604595,2376,5754,5602219,5604595
592,6,6,1,2412,-73,-89,16,e6:aa:ea:b7:4a:dd,5620825,408,15822,5620417,5620825
593,6,6,1,2412,-51,-89,38,e6:aa:ea:c9:ea:33,5651307,408,30074,5650899,5651307
594,6,6,1,2412,-51,-89,38,e6:aa:ea:c9:ea:33,5663682,408,11967,5663274,5663682
595,4,1,1,2412,-81,-89,8,a6:e5:7c:28:b1:d3,5664235,992,-439,5663243,5664235
596,6,6,1,2412,-51,-89,38,e6:aa:ea:c9:ea:33,5675553,408,10910,5675145,5675553
597,6,6,1,2412,-51,-89,38,e6:aa:ea:c9:ea:33,5687666,408,11705,5687258,5687666
598,6,12,1,2412,-55,-89,34,40:e3:d6:da:ba:20,5692912,160,5086,5692752,5692912
599,6,12,1,2412,-54,-89,35,40:e3:d6:da:ba:22,5693527,180,435,5693347,5693527
600,6,12,1,2412,-54,-89,35,40:e3:d6:da:ba:23,5693732,184,21,5693548,5693732
601,6,12,1,2412,-54,-89,35,40:e3:d6:da:ba:24,5693959,176,51,5693783,5693959
602,6,12,1,2412,-54,-89,35,40:e3:d6:da:ba:25,5694188,160,69,5694028,5694188
603,6,6,1,2412,-54,-89,35,40:e3:d6:da:ba:26,5694380,380,-188,5694000,5694380
604,4,1,1,2412,-85,-89,4,f0:51:ea:e5:56:1b,5735960,1032,40548,5734928,5735960
605,4,1,1,2412,-59,-89,30,f0:51:ea:e5:56:1b,5780027,1032,43035,5778995,5780027
606,6,12,1,2412,-57,-89,32,40:e3:d6:da:ba:20,5793486,160,13299,5793326,5793486
607,6,6,1,2412,-57,-89,32,40:e3:d6:da:ba:21,5793705,368,-149,5793337,5793705
608,6,12,1,2412,-57,-89,32,40:e3:d6:da:ba:22,5794110,180,225,5793930,5794110
609,6,12,1,2412,-57,-89,32,40:e3:d6:da:ba:23,5794315,184,21,5794131,5794315
610,6,12,1,2412,-57,-89,32,40:e3:d6:da:ba:24,5794534,176,43,5794358,5794534
611,4,1,1,2412,-85,-89,4,f0:51:ea:e5:56:1b,5802816,1032,7250,5801784,5802816
612,4,1,1,2412,-84,-89,5,f0:51:ea:e5:56:1b,5825141,1032,21293,5824109,5825141
613,4,1,1,2412,-86,-89,3,c0:c9:e3:4d:6e:bf,5829929,872,3916,5829057,5829929
614,4,1,1,2412,-78,-89,11,f0:51:ea:e5:56:1b,5872385,1032,41424,5871353,5872385
615,6,12,1,2412,-54,-89,35,40:e3:d6:da:ba:20,5895902,160,23357,5895742,5895902
616,6,6,1,2412,-54,-89,35,40:e3:d6:da:ba:21,5896121,368,-149,5895753,5896121
617,6,12,1,2412,-54,-89,35,40:e3:d6:da:ba:22,5896508,180,207,5896328,5896508
618,6,12,1,2412,-54,-89,35,40:e3:d6:da:ba:23,5896740,184,48,5896556,5896740
619,6,12,1,2412,-54,-89,35,40:e3:d6:da:ba:24,5896950,176,34,5896774,5896950
620,6,12,1,2412,-54,-89,35,40:e3:d6:da:ba:25,5897169,160,59,5897009,5897169
621,6,6,1,2412,-54,-89,35,40:e3:d6:da:ba:26,5897361,380,-188,5896981,5897361
622,6,6,1,2412,-85,-89,4,e6:aa:ea:c9:ea:1b,5932741,408,34972,5932333,5932741
623,6,6,1,2412,-86,-89,3,e6:aa:ea:c9:ea:1b,5944859,408,11710,5944451,5944859
624,6,12,1,2412,-54,-89,35,40:e3:d6:da:ba:20,5998300,160,53281,5998140,5998300
625,6,6,1,2412,-54,-89,35,40:e3:d6:da:ba:21,5998510,368,-158,5998142,5998510
626,6,12,1,2412,-54,-89,35,40:e3:d6:da:ba:22,5998906,180,216,5998726,5998906
627,6,12,1,2412,-54,-89,35,40:e3:d6:da:ba:23,5999111,184,21,5998927,5999111
628,6,12,1,2412,-54,-89,35,40:e3:d6:da:ba:24,5999348,176,61,5999172,5999348
629,6,12,1,2412,-54,-89,35,40:e3:d6:da:ba:25,5999558,160,50,5999398,5999558
630,6,6,1,2412,-54,-89,35,40:e3:d6:da:ba:26,5999750,380,-188,5999370,5999750
631,4,1,1,2412,-83,-87,4,a6:e5:7c:28:b1:d3,6074603,992,73861,6073611,6074603
632,6,12,1,2412,-52,-87,35,40:e3:d6:da:ba:20,6100683,160,25920,6100523,6100683
633,6,12,1,2412,-52,-87,35,40:e3:d6:da:ba:22,6101304,180,441,6101124,6101304
634,6,12,1,2412,-52,-87,35,40:e3:d6:da:ba:23,6101536,184,48,6101352,6101536
635,6,12,1,2412,-52,-87,35,40:e3:d6:da:ba:24,6101764,176,52,6101588,6101764
636,6,12,1,2412,-52,-87,35,40:e3:d6:da:ba:25,6101983,160,59,6101823,6101983
637,6,6,1,2412,-52,-87,35,40:e3:d6:da:ba:26,6102175,380,-188,6101795,6102175
638,6,6,1,2412,-71,-87,16,e6:aa:ea:b7:4a:dd,6104412,408,1829,6104004,6104412
639,4,1,1,2412,-76,-87,11,54:e4:3a:ec:fb:64,6112026,2160,5454,6109866,6112026
640,6,6,1,2412,-52,-87,35,e6:aa:ea:c9:ea:33,6171828,408,59394,6171420,6171828
641,4,1,1,2412,-86,-87,1,a4:e5:7c:28:b1:d3,6173031,688,515,6172343,6173031
642,4,1,1,2412,-91,-87,-4,,6173736,304,401,6173432,6173736
643,4,1,1,2412,-86,-87,1,a6:e5:7c:28:b1:d3,6176751,992,2023,6175759,6176751
644,6,6,1,2412,-54,-87,33,e6:aa:ea:c9:ea:33,6196247,408,19088,6195839,6196247
645,6,12,1,2412,-50,-87,37,40:e3:d6:da:ba:20,6203083,160,6676,6202923,6203083
646,6,6,1,2412,-50,-87,37,40:e3:d6:da:ba:21,6203302,368,-149,6202934,6203302
647,6,12,1,2412,-50,-87,37,40:e3:d6:da:ba:22,6203689,180,207,6203509,6203689
648,6,12,1,2412,-50,-87,37,40:e3:d6:da:ba:23,6203922,184,49,6203738,6203922
649,6,12,1,2412,-50,-87,37,40:e3:d6:da:ba:24,6204131,176,33,6203955,6204131
650,6,12,1,2412,-50,-87,37,40:e3:d6:da:ba:25,6204341,160,50,6204181,6204341
651,6,6,1,2412,-50,-87,37,40:e3:d6:da:ba:26,6204542,380,-179,6204162,6204542
652,6,6,1,2412,-52,-87,35,e6:aa:ea:c9:ea:33,6208175,408,3225,6207767,6208175
653,6,6,1,2412,-56,-87,31,e6:aa:ea:c9:ea:33,6221459,408,12876,6221051,6221459
654,6,12,1,2412,-51,-87,36,40:e3:d6:da:ba:20,6305482,160,83863,6305322,6305482
655,6,12,1,2412,-51,-87,36,40:e3:d6:da:ba:23,6306327,184,661,6306143,6306327
656,6,12,1,2412,-50,-87,37,40:e3:d6:da:ba:25,6306933,160,446,6306773,6306933
657,6,6,1,2412,-51,-87,36,40:e3:d6:da:ba:26,6307419,380,106,6307039,6307419
658,4,1,1,2412,-89,-87,-2,c0:c9:e3:4d:6e:bf,6322927,872,14636,6322055,6322927
659,4,1,1,2412,-81,-87,6,34:f6:4b:95:fe:d4,6354687,784,30976,6353903,6354687
660,6,12,1,2412,-52,-87,35,40:e3:d6:da:ba:20,6409179,160,54332,6409019,6409179
661,6,6,1,2412,-52,-87,35,40:e3:d6:da:ba:21,6409371,368,-176,6409003,6409371
662,6,12,1,2412,-52,-87,35,40:e3:d6:da:ba:22,6409785,180,234,6409605,6409785
663,6,12,1,2412,-52,-87,35,40:e3:d6:da:ba:23,6410017,184,48,6409833,6410017
664,6,12,1,2412,-52,-87,35,40:e3:d6:da:ba:24,6410254,176,61,6410078,6410254
665,6,12,1,2412,-52,-87,35,40:e3:d6:da:ba:25,6410464,160,50,6410304,6410464
666,6,6,1,2412,-52,-87,35,40:e3:d6:da:ba:26,6410683,380,-161,6410303,6410683
667,6,6,1,2412,-73,-87,14,e6:aa:ea:b7:4a:dd,6431385,408,20294,6430977,6431385
668,6,6,1,2412,-73,-87,14,e6:aa:ea:b7:4a:dd,6455622,408,23829,6455214,6455622
669,6,12,1,2412,-51,-87,36,40:e3:d6:da:ba:20,6510292,160,54510,6510132,6510292
670,6,6,1,2412,-52,-87,35,40:e3:d6:da:ba:21,6510544,368,-116,6510176,6510544
671,6,12,1,2412,-52,-87,35,40:e3:d6:da:ba:22,6510949,180,225,6510769,6510949
672,6,12,1,2412,-52,-87,35,40:e3:d6:da:ba:23,6511163,184,30,6510979,6511163
673,6,12,1,2412,-52,-87,35,40:e3:d6:da:ba:24,6511381,176,42,6511205,6511381
674,6,12,1,2412,-52,-87,35,40:e3:d6:da:ba:25,6511592,160,51,6511432,6511592
675,6,6,1,2412,-51,-87,36,40:e3:d6:da:ba:26,6511826,380,-146,6511446,6511826
676,4,1,1,2412,-63,-87,24,54:e4:3a:ec:fb:64,6521624,2160,7638,6519464,6521624
677,6,12,1,2412,-52,-87,35,40:e3:d6:da:ba:20,6612686,160,90902,6612526,6612686
678,6,6,1,2412,-52,-87,35,40:e3:d6:da:ba:21,6612896,368,-158,6612528,6612896
679,6,12,1,2412,-51,-87,36,40:e3:d6:da:ba:22,6613292,180,216,6613112,6613292
680,6,12,1,2412,-51,-87,36,40:e3:d6:da:ba:23,6613524,184,48,6613340,6613524
681,6,12,1,2412,-51,-87,36,40:e3:d6:da:ba:24,6613743,176,43,6613567,6613743
682,6,12,1,2412,-51,-87,36,40:e3:d6:da:ba:25,6613953,160,50,6613793,6613953
683,6,6,1,2412,-52,-87,35,40:e3:d6:da:ba:26,6614154,380,-179,6613774,6614154
684,4,1,1,2412,-61,-87,26,54:e4:3a:ec:fb:64,6624023,2160,7709,6621863,6624023
685,6,6,1,2412,-50,-87,37,e6:aa:ea:c9:ea:33,6692747,408,68316,6692339,6692747
686,6,6,1,2412,-50,-87,37,e6:aa:ea:c9:ea:33,6704868,408,11713,6704460,6704868
687,6,12,1,2412,-50,-87,37,40:e3:d6:da:ba:20,6715085,160,10057,6714925,6715085
688,6,6,1,2412,-50,-87,37,40:e3:d6:da:ba:21,6715304,368,-149,6714936,6715304
689,6,12,1,2412,-50,-87,37,40:e3:d6:da:ba:22,6715708,180,224,6715528,6715708
690,6,12,1,2412,-50,-87,37,40:e3:d6:da:ba:23,6715941,184,49,6715757,6715941
691,6,12,1,2412,-50,-87,37,40:e3:d6:da:ba:24,6716159,176,42,6715983,6716159
692,6,12,1,2412,-50,-87,37,40:e3:d6:da:ba:25,6716370,160,51,6716210,6716370
693,6,6,1,2412,-50,-87,37,40:e3:d6:da:ba:26,6716577,380,-173,6716197,6716577
694,6,6,1,2412,-50,-87,37,e6:aa:ea:c9:ea:33,6717000,408,15,6716592,6717000
695,4,1,1,2412,-65,-87,22,54:e4:3a:ec:fb:64,6726421,2160,7261,6724261,6726421
696,6,6,1,2412,-49,-87,38,e6:aa:ea:c9:ea:33,6729102,408,2273,6728694,6729102
697,6,6,1,2412,-49,-87,38,e6:aa:ea:c9:ea:33,6741233,408,11723,6740825,6741233
698,4,1,1,2412,-89,-87,-2,a6:e5:7c:28:b1:d3,6791297,992,49072,6790305,6791297
699,6,12,1,2412,-49,-87,38,40:e3:d6:da:ba:20,6817598,160,26141,6817438,6817598
700,6,6,1,2412,-49,-87,38,40:e3:d6:da:ba:21,6817808,368,-158,6817440,6817808
701,6,12,1,2412,-49,-87,38,40:e3:d6:da:ba:22,6818323,180,335,6818143,6818323
702,6,12,1,2412,-49,-87,38,40:e3:d6:da:ba:23,6818569,184,62,6818385,6818569
703,6,12,1,2412,-49,-87,38,40:e3:d6:da:ba:24,6818806,176,61,6818630,6818806
704,6,12,1,2412,-49,-87,38,40:e3:d6:da:ba:25,6819007,160,41,6818847,6819007
705,6,6,1,2412,-49,-87,38,40:e3:d6:da:ba:26,6819226,380,-161,6818846,6819226
706,6,6,1,2412,-68,-87,19,e6:aa:ea:b7:4a:dd,6836867,408,17233,6836459,6836867
707,6,6,1,2412,-69,-87,18,e6:aa:ea:b7:4a:dd,6873219,408,35944,6872811,6873219
708,4,1,1,2412,-63,-87,24,a6:e5:7c:28:b1:d3,6893512,992,19301,6892520,6893512
709,6,12,1,2412,-49,-87,38,40:e3:d6:da:ba:20,6919910,160,26238,6919750,6919910
710,6,6,1,2412,-49,-87,38,40:e3:d6:da:ba:21,6920129,368,-149,6919761,6920129
711,6,12,1,2412,-48,-87,39,40:e3:d6:da:ba:22,6920533,180,224,6920353,6920533
712,6,12,1,2412,-49,-87,38,40:e3:d6:da:ba:23,6920757,184,40,6920573,6920757
713,6,12,1,2412,-48,-87,39,40:e3:d6:da:ba:24,6920984,176,51,6920808,6920984
714,6,12,1,2412,-49,-87,38,40:e3:d6:da:ba:25,6921195,160,51,6921035,6921195
715,6,6,1,2412,-49,-87,38,40:e3:d6:da:ba:26,6921396,380,-179,6921016,6921396
716,4,1,1,2412,-72,-87,15,54:e4:3a:ec:fb:64,6931220,2160,7664,6929060,6931220
717,6,6,1,2412,-47,-87,40,e6:aa:ea:c9:ea:33,7010567,408,78939,7010159,7010567
718,6,6,1,2412,-47,-87,40,e6:aa:ea:c9:ea:33,7020030,408,9055,7019622,7020030
719,6,12,1,2412,-50,-87,37,40:e3:d6:da:ba:20,7022286,160,2096,7022126,7022286
720,6,6,1,2412,-50,-87,37,40:e3:d6:da:ba:21,7022478,368,-176,7022110,7022478
721,6,12,1,2412,-50,-87,37,40:e3:d6:da:ba:22,7022865,180,207,7022685,7022865
722,6,12,1,2412,-50,-87,37,40:e3:d6:da:ba:23,7023088,184,39,7022904,7023088
723,6,12,1,2412,-50,-87,37,40:e3:d6:da:ba:24,7023298,176,34,7023122,7023298
724,6,12,1,2412,-50,-87,37,40:e3:d6:da:ba:25,7023517,160,59,7023357,7023517
725,6,6,1,2412,-50,-87,37,40:e3:d6:da:ba:26,7023727,380,-170,7023347,7023727
726,6,6,1,2412,-47,-87,40,e6:aa:ea:c9:ea:33,7032209,408,8074,7031801,7032209
727,4,1,1,2412,-71,-87,16,54:e4:3a:ec:fb:64,7033618,2160,-751,7031458,7033618
728,4,1,1,2412,-85,-87,2,b8:3a:5a:88:e6:e0,7036135,2360,157,7033775,7036135
729,6,6,1,2412,-47,-87,40,e6:aa:ea:c9:ea:33,7044245,408,7702,7043837,7044245
730,6,6,1,2412,-48,-87,39,e6:aa:ea:c9:ea:33,7056365,408,11712,7055957,7056365
731,6,12,1,2412,-48,-87,39,40:e3:d6:da:ba:20,7124686,160,68161,7124526,7124686
732,6,6,1,2412,-48,-87,39,40:e3:d6:da:ba:21,7124887,368,-167,7124519,7124887
733,6,12,1,2412,-48,-87,39,40:e3:d6:da:ba:22,7125301,180,234,7125121,7125301
734,6,12,1,2412,-48,-87,39,40:e3:d6:da:ba:23,7125524,184,39,7125340,7125524
735,6,12,1,2412,-48,-87,39,40:e3:d6:da:ba:24,7125743,176,43,7125567,7125743
736,6,12,1,2412,-48,-87,39,40:e3:d6:da:ba:25,7125971,160,68,7125811,7125971
737,6,6,1,2412,-48,-87,39,40:e3:d6:da:ba:26,7126163,380,-188,7125783,7126163
738,6,6,1,2412,-72,-87,15,e6:aa:ea:b7:4a:dd,7176612,408,50041,7176204,7176612
739,6,12,1,2412,-50,-87,37,40:e3:d6:da:ba:20,7229057,160,52285,7228897,7229057
740,6,6,1,2412,-50,-87,37,40:e3:d6:da:ba:21,7229249,368,-176,7228881,7229249
741,6,12,1,2412,-50,-87,37,40:e3:d6:da:ba:23,7229868,184,435,7229684,7229868
742,6,12,1,2412,-50,-87,37,40:e3:d6:da:ba:24,7230104,176,60,7229928,7230104
743,6,12,1,2412,-50,-87,37,40:e3:d6:da:ba:25,7230306,160,42,7230146,7230306
744,6,6,1,2412,-50,-87,37,40:e3:d6:da:ba:26,7230498,380,-188,7230118,7230498
745,4,1,1,2412,-64,-87,23,f0:51:ea:e5:56:1b,7234454,896,3060,7233558,7234454
746,6,12,1,2412,-50,-87,37,40:e3:d6:da:ba:20,7235393,136,803,7235257,7235393
747,6,6,1,2412,-50,-87,37,40:e3:d6:da:ba:21,7235658,348,-83,7235310,7235658
748,6,12,1,2412,-50,-87,37,40:e3:d6:da:ba:22,7236042,156,228,7235886,7236042
749,6,12,1,2412,-50,-87,37,40:e3:d6:da:ba:23,7236251,156,53,7236095,7236251
750,6,12,1,2412,-50,-87,37,40:e3:d6:da:ba:25,7236450,136,63,7236314,7236450
751,6,12,1,2412,-50,-87,37,40:e3:d6:da:ba:20,7280470,136,43884,7280334,7280470
752,6,6,1,2412,-49,-87,38,40:e3:d6:da:ba:21,7280674,348,-144,7280326,7280674
753,6,12,1,2412,-49,-87,38,40:e3:d6:da:ba:22,7281050,156,220,7280894,7281050
754,6,12,1,2412,-49,-87,38,40:e3:d6:da:ba:23,7281267,156,61,7281111,7281267
755,6,12,1,2412,-49,-87,38,40:e3:d6:da:ba:25,7281485,136,82,7281349,7281485
756,6,12,1,2412,-48,-87,39,40:e3:d6:da:ba:20,7329512,160,47867,7329352,7329512
757,6,6,1,2412,-48,-87,39,40:e3:d6:da:ba:21,7329704,368,-176,7329336,7329704
758,6,12,1,2412,-48,-87,39,40:e3:d6:da:ba:23,7330417,184,529,7330233,7330417
759,6,12,1,2412,-48,-87,39,40:e3:d6:da:ba:24,7330705,176,112,7330529,7330705
760,6,12,1,2412,-48,-87,39,40:e3:d6:da:ba:25,7330947,160,82,7330787,7330947
761,4,1,1,2412,-72,-87,15,54:e4:3a:ec:fb:64,7340816,2160,7709,7338656,7340816
762,6,12,1,2412,-48,-87,39,40:e3:d6:da:ba:20,7392725,136,51773,7392589,7392725
763,6,6,1,2412,-48,-87,39,40:e3:d6:da:ba:21,7392911,348,-162,7392563,7392911
764,6,12,1,2412,-48,-87,39,40:e3:d6:da:ba:22,7393305,156,238,7393149,7393305
765,6,12,1,2412,-48,-87,39,40:e3:d6:da:ba:23,7393495,156,34,7393339,7393495
766,6,12,1,2412,-48,-87,39,40:e3:d6:da:ba:25,7393740,136,109,7393604,7393740
767,6,12,1,2412,-48,-87,39,40:e3:d6:da:ba:20,7414987,136,21111,7414851,7414987
768,6,6,1,2412,-48,-87,39,40:e3:d6:da:ba:21,7415182,348,-153,7414834,7415182
769,6,12,1,2412,-48,-87,39,40:e3:d6:da:ba:22,7415576,156,238,7415420,7415576
770,6,12,1,2412,-48,-87,39,40:e3:d6:da:ba:23,7415775,156,43,7415619,7415775
771,6,12,1,2412,-55,-87,32,40:e3:d6:da:ba:25,7415984,136,73,7415848,7415984
772,6,12,1,2412,-48,-87,39,40:e3:d6:da:ba:20,7431906,160,15762,7431746,7431906
773,6,6,1,2412,-48,-87,39,40:e3:d6:da:ba:21,7432107,368,-167,7431739,7432107
774,6,12,1,2412,-48,-87,39,40:e3:d6:da:ba:22,7432512,180,225,7432332,7432512
775,6,12,1,2412,-48,-87,39,40:e3:d6:da:ba:23,7432727,184,31,7432543,7432727
776,6,12,1,2412,-47,-87,40,40:e3:d6:da:ba:24,7432954,176,51,7432778,7432954
777,6,12,1,2412,-48,-87,39,40:e3:d6:da:ba:25,7433174,160,60,7433014,7433174
778,6,6,1,2412,-48,-87,39,40:e3:d6:da:ba:26,7433384,380,-170,7433004,7433384
779,4,1,1,2412,-73,-87,14,54:e4:3a:ec:fb:64,7443215,2160,7671,7441055,7443215
780,4,1,1,2412,-77,-87,10,b8:3a:5a:88:e6:e1,7447778,2376,2187,7445402,7447778
781,6,6,1,2412,-47,-87,40,e6:aa:ea:c9:ea:33,7528024,408,79838,7527616,7528024
782,6,12,1,2412,-51,-87,36,40:e3:d6:da:ba:20,7534303,160,6119,7534143,7534303
783,6,6,1,2412,-50,-87,37,40:e3:d6:da:ba:21,7534513,368,-158,7534145,7534513
784,6,12,1,2412,-50,-87,37,40:e3:d6:da:ba:22,7534908,180,215,7534728,7534908
785,6,12,1,2412,-50,-87,37,40:e3:d6:da:ba:23,7535132,184,40,7534948,7535132
786,6,12,1,2412,-50,-87,37,40:e3:d6:da:ba:24,7535359,176,51,7535183,7535359
787,6,12,1,2412,-50,-87,37,40:e3:d6:da:ba:25,7535561,160,42,7535401,7535561
788,6,6,1,2412,-50,-87,37,40:e3:d6:da:ba:26,7535780,380,-161,7535400,7535780
789,6,6,1,2412,-47,-87,40,e6:aa:ea:c9:ea:33,7540156,408,3968,7539748,7540156
790,4,1,1,2412,-74,-87,13,54:e4:3a:ec:fb:64,7545615,2160,3299,7543455,7545615
791,4,1,1,2412,-86,-87,1,b8:3a:5a:88:e6:e0,7547817,2360,-158,7545457,7547817
792,4,1,1,2412,-71,-87,16,a6:e5:7c:28:b1:d3,7554583,944,5822,7553639,7554583
793,4,1,1,2412,-86,-87,1,a6:e5:7c:28:b1:d3,7556721,944,1194,7555777,7556721
794,4,1,1,2412,-63,-87,24,a6:e5:7c:28:b1:d3,7558895,944,1230,7557951,7558895
795,4,1,1,2412,-69,-87,18,a6:e5:7c:28:b1:d3,7559973,944,134,7559029,7559973
796,6,6,1,2412,-48,-87,39,e6:aa:ea:c9:ea:33,7564386,408,4005,7563978,7564386
797,6,6,1,2412,-49,-87,38,e6:aa:ea:c9:ea:33,7576513,408,11719,7576105,7576513
798,6,12,1,2412,-50,-87,37,40:e3:d6:da:ba:20,7636688,160,60015,7636528,7636688
799,6,6,1,2412,-49,-87,38,40:e3:d6:da:ba:21,7636889,368,-167,7636521,7636889
800,6,12,1,2412,-49,-87,38,40:e3:d6:da:ba:22,7637357,180,288,7637177,7637357
801,6,12,1,2412,-49,-87,38,40:e3:d6:da:ba:23,7637562,184,21,7637378,7637562
802,6,12,1,2412,-49,-87,38,40:e3:d6:da:ba:24,7637799,176,61,7637623,7637799
803,6,12,1,2412,-49,-87,38,40:e3:d6:da:ba:25,7638009,160,50,7637849,7638009
804,6,6,1,2412,-49,-87,38,40:e3:d6:da:ba:26,7638201,380,-188,7637821,7638201
805,4,1,1,2412,-75,-87,12,54:e4:3a:ec:fb:64,7648013,2160,7652,7645853,7648013
806,6,6,1,2412,-70,-87,17,e6:aa:ea:b7:4a:dd,7661044,408,12623,7660636,7661044
807,6,6,1,2412,-69,-87,18,e6:aa:ea:b7:4a:dd,7709518,408,48066,7709110,7709518
808,6,12,1,2412,-49,-87,38,40:e3:d6:da:ba:20,7739107,160,29429,7738947,7739107
809,6,6,1,2412,-49,-87,38,40:e3:d6:da:ba:21,7739326,368,-149,7738958,7739326
810,6,12,1,2412,-49,-87,38,40:e3:d6:da:ba:22,7739731,180,225,7739551,7739731
811,6,12,1,2412,-49,-87,38,40:e3:d6:da:ba:23,7739954,184,39,7739770,7739954
812,6,12,1,2412,-49,-87,38,40:e3:d6:da:ba:24,7740164,176,34,7739988,7740164
813,6,12,1,2412,-49,-87,38,40:e3:d6:da:ba:25,7740392,160,68,7740232,7740392
814,6,6,1,2412,-49,-87,38,40:e3:d6:da:ba:26,7740611,380,-161,7740231,7740611
815,6,12,1,2412,-50,-87,37,40:e3:d6:da:ba:20,7841511,160,100740,7841351,7841511
816,6,6,1,2412,-50,-87,37,40:e3:d6:da:ba:21,7841730,368,-149,7841362,7841730
817,6,12,1,2412,-49,-87,38,40:e3:d6:da:ba:22,7842144,180,234,7841964,7842144
818,6,12,1,2412,-49,-87,38,40:e3:d6:da:ba:23,7842367,184,39,7842183,7842367
819,6,12,1,2412,-50,-87,37,40:e3:d6:da:ba:24,7842585,176,42,7842409,7842585
820,6,12,1,2412,-50,-87,37,40:e3:d6:da:ba:25,7842802,160,57,7842642,7842802
821,6,6,1,2412,-49,-87,38,40:e3:d6:da:ba:26,7843003,380,-179,7842623,7843003
822,6,6,1,2412,-48,-87,39,e6:aa:ea:c9:ea:33,7844900,408,1489,7844492,7844900
823,6,6,1,2412,-49,-87,38,e6:aa:ea:c9:ea:33,7857026,408,11718,7856618,7857026
824,6,6,1,2412,-49,-87,38,e6:aa:ea:c9:ea:33,7881256,408,23822,7880848,7881256
825,6,6,1,2412,-49,-87,38,e6:aa:ea:c9:ea:33,7893381,408,11717,7892973,7893381
826,6,12,1,2412,-49,-87,38,40:e3:d6:da:ba:20,7943896,160,50355,7943736,7943896
827,6,6,1,2412,-49,-87,38,40:e3:d6:da:ba:21,7944106,368,-158,7943738,7944106
828,6,12,1,2412,-50,-87,37,40:e3:d6:da:ba:22,7944520,180,234,7944340,7944520
829,6,12,1,2412,-51,-87,36,40:e3:d6:da:ba:25,7945181,160,501,7945021,7945181
830,6,6,1,2412,-51,-87,36,40:e3:d6:da:ba:26,7945373,380,-188,7944993,7945373
831,6,6,1,2412,-46,-89,43,,8035204,44,89787,8035160,8035204
832,6,12,1,2412,-49,-89,40,40:e3:d6:da:ba:20,8046297,160,10933,8046137,8046297
833,6,6,1,2412,-49,-89,40,40:e3:d6:da:ba:21,8046498,368,-167,8046130,8046498
834,6,12,1,2412,-49,-89,40,40:e3:d6:da:ba:22,8046893,180,215,8046713,8046893
835,6,12,1,2412,-51,-89,38,40:e3:d6:da:ba:23,8047108,184,31,8046924,8047108
836,6,12,1,2412,-51,-89,38,40:e3:d6:da:ba:25,8047555,160,287,8047395,8047555
837,6,6,1,2412,-51,-89,38,40:e3:d6:da:ba:26,8047756,380,-179,8047376,8047756
838,6,6,1,2412,-46,-89,43,,8060213,44,12413,8060169,8060213
839,4,1,1,2412,-69,-89,20,54:e4:3a:ec:fb:64,8062584,2160,211,8060424,8062584
840,6,6,1,2412,-46,-89,43,,8085206,44,22578,8085162,8085206
841,6,24,1,2412,-80,-89,9,,8109921,28,24687,8109893,8109921
842,6,12,1,2412,-49,-89,40,,8109966,32,13,8109934,8109966
843,6,12,1,2412,-49,-89,40,,8110079,44,69,8110035,8110079
844,6,6,1,2412,-47,-89,42,,8110204,44,81,8110160,8110204
845,6,12,1,2412,-49,-89,40,,8111513,36,1273,8111477,8111513
846,6,12,1,2412,-49,-89,40,,8112156,36,607,8112120,8112156
847,6,12,1,2412,-49,-89,40,,8112355,36,163,8112319,8112355
848,6,12,1,2412,-49,-89,40,,8113060,36,669,8113024,8113060
849,6,12,1,2412,-80,-89,9,,8113429,32,337,8113397,8113429
850,6,12,1,2412,-49,-89,40,,8113779,36,314,8113743,8113779
851,6,12,1,2412,-49,-89,40,,8114120,36,305,8114084,8114120
852,6,12,1,2412,-80,-89,9,,8114172,32,20,8114140,8114172
853,7,86.6667,1,2412,-48,-89,41,00:1f:26:41:f0:00,8114229,51,6,8114178,8114229
854,6,24,1,2412,-80,-89,9,,8114288,32,27,8114256,8114288
855,6,12,1,2412,-80,-89,9,22:a3:7f:87:e5:4e,8127952,44,13620,8127908,8127952
856,6,12,1,2412,-49,-89,40,,8128013,32,29,8127981,8128013
857,6,12,1,2412,-49,-89,40,40:e3:d6:da:ba:22,8149367,180,21174,8149187,8149367
858,6,12,1,2412,-49,-89,40,40:e3:d6:da:ba:24,8149782,176,239,8149606,8149782
859,6,12,1,2412,-49,-89,40,40:e3:d6:da:ba:25,8150164,160,222,8150004,8150164
860,6,6,1,2412,-49,-89,40,40:e3:d6:da:ba:26,8150356,380,-188,8149976,8150356
861,6,6,1,2412,-52,-89,37,e6:aa:ea:c9:ea:33,8159640,408,8876,8159232,8159640
862,6,6,1,2412,-52,-89,37,e6:aa:ea:c9:ea:33,8183876,408,23828,8183468,8183876
863,6,6,1,2412,-70,-89,19,e6:aa:ea:b7:4a:dd,8193912,408,9628,8193504,8193912
864,6,6,1,2412,-52,-89,37,e6:aa:ea:c9:ea:33,8196186,408,1866,8195778,8196186
865,6,6,1,2412,-70,-89,19,e6:aa:ea:b7:4a:dd,8205886,408,9292,8205478,8205886
866,6,6,1,2412,-51,-89,38,e6:aa:ea:c9:ea:33,8208223,408,1929,8207815,8208223
867,6,6,1,2412,-70,-89,19,e6:aa:ea:b7:4a:dd,8218007,408,9376,8217599,8218007
868,6,12,1,2412,-49,-89,40,40:e3:d6:da:ba:20,8251113,160,32946,8250953,8251113
869,6,6,1,2412,-49,-89,40,40:e3:d6:da:ba:21,8251322,368,-159,8250954,8251322
870,6,12,1,2412,-49,-89,40,40:e3:d6:da:ba:22,8251727,180,225,8251547,8251727
871,6,12,1,2412,-49,-89,40,40:e3:d6:da:ba:23,8251942,184,31,8251758,8251942
872,6,12,1,2412,-49,-89,40,40:e3:d6:da:ba:24,8252160,176,42,8251984,8252160
873,6,12,1,2412,-49,-89,40,40:e3:d6:da:ba:25,8252396,160,76,8252236,8252396
874,6,6,1,2412,-49,-89,40,40:e3:d6:da:ba:26,8252615,380,-161,8252235,8252615
875,4,1,1,2412,-88,-89,1,b8:3a:5a:88:e6:e0,8264741,2360,9766,8262381,8264741
876,4,1,1,2412,-86,-89,3,,8335761,304,70716,8335457,8335761
877,6,12,1,2412,-48,-89,41,40:e3:d6:da:ba:20,8353517,160,17596,8353357,8353517
878,6,6,1,2412,-48,-89,41,40:e3:d6:da:ba:21,8353745,368,-140,8353377,8353745
879,6,12,1,2412,-49,-89,40,40:e3:d6:da:ba:22,8354142,180,217,8353962,8354142
880,6,12,1,2412,-49,-89,40,40:e3:d6:da:ba:23,8354374,184,48,8354190,8354374
881,6,12,1,2412,-49,-89,40,40:e3:d6:da:ba:24,8354592,176,42,8354416,8354592
882,6,12,1,2412,-48,-89,41,40:e3:d6:da:ba:25,8354821,160,69,8354661,8354821
883,6,6,1,2412,-48,-89,41,40:e3:d6:da:ba:26,8355022,380,-179,8354642,8355022
884,6,6,1,2412,-85,-89,4,e6:aa:ea:c9:ea:1b,8453347,408,97917,8452939,8453347
885,6,12,1,2412,-48,-89,41,40:e3:d6:da:ba:20,8455892,160,2385,8455732,8455892
886,6,6,1,2412,-48,-89,41,40:e3:d6:da:ba:21,8456093,368,-167,8455725,8456093
887,6,12,1,2412,-48,-89,41,40:e3:d6:da:ba:22,8456480,180,207,8456300,8456480
888,6,12,1,2412,-48,-89,41,40:e3:d6:da:ba:23,8456704,184,40,8456520,8456704
889,6,12,1,2412,-48,-89,41,40:e3:d6:da:ba:24,8456940,176,60,8456764,8456940
890,6,12,1,2412,-48,-89,41,40:e3:d6:da:ba:25,8457141,160,41,8456981,8457141
891,6,6,1,2412,-48,-89,41,40:e3:d6:da:ba:26,8457351,380,-170,8456971,8457351
892,4,1,1,2412,-86,-89,3,a4:e5:7c:28:b1:d3,8465382,688,7343,8464694,8465382
893,4,1,1,2412,-83,-89,6,a4:e5:7c:28:b1:d3,8557618,688,91548,8556930,8557618
894,6,12,1,2412,-47,-89,42,40:e3:d6:da:ba:20,8558478,160,700,8558318,8558478
895,6,6,1,2412,-47,-89,42,40:e3:d6:da:ba:21,8558679,368,-167,8558311,8558679
896,6,12,1,2412,-47,-89,42,40:e3:d6:da:ba:22,8559084,180,225,8558904,8559084
897,6,12,1,2412,-47,-89,42,40:e3:d6:da:ba:23,8559290,184,22,8559106,8559290
898,6,12,1,2412,-47,-89,42,40:e3:d6:da:ba:24,8559526,176,60,8559350,8559526
899,6,12,1,2412,-47,-89,42,40:e3:d6:da:ba:25,8559746,160,60,8559586,8559746
900,6,6,1,2412,-47,-89,42,40:e3:d6:da:ba:26,8559947,380,-179,8559567,8559947
901,4,1,1,2412,-71,-89,18,54:e4:3a:ec:fb:64,8569607,2160,7500,8567447,8569607
902,4,1,1,2412,-87,-89,2,b8:3a:5a:88:e6:e1,8574197,2376,2214,8571821,8574197
903,6,6,1,2412,-73,-89,16,e6:aa:ea:b7:4a:dd,8622856,408,48251,8622448,8622856
904,6,12,1,2412,-46,-89,43,40:e3:d6:da:ba:20,8660717,160,37701,8660557,8660717
905,6,6,1,2412,-46,-89,43,40:e3:d6:da:ba:21,8660918,368,-167,8660550,8660918
906,6,12,1,2412,-46,-89,43,40:e3:d6:da:ba:22,8661323,180,225,8661143,8661323
907,6,12,1,2412,-46,-89,43,40:e3:d6:da:ba:23,8661537,184,30,8661353,8661537
908,6,12,1,2412,-46,-89,43,40:e3:d6:da:ba:24,8661765,176,52,8661589,8661765
909,6,12,1,2412,-46,-89,43,40:e3:d6:da:ba:25,8661966,160,41,8661806,8661966
910,6,6,1,2412,-46,-89,43,40:e3:d6:da:ba:26,8662176,380,-170,8661796,8662176
911,6,6,1,2412,-52,-89,37,e6:aa:ea:c9:ea:33,8679614,408,17030,8679206,8679614
912,6,6,1,2412,-52,-89,37,e6:aa:ea:c9:ea:33,8691744,408,11722,8691336,8691744
913,6,6,1,2412,-49,-89,40,e6:aa:ea:c9:ea:33,8703857,408,11705,8703449,8703857
914,6,6,1,2412,-49,-89,40,e6:aa:ea:c9:ea:33,8716139,408,11874,8715731,8716139
915,6,6,1,2412,-49,-89,40,e6:aa:ea:c9:ea:33,8728094,408,11547,8727686,8728094
916,6,12,1,2412,-46,-89,43,40:e3:d6:da:ba:20,8763109,160,34855,8762949,8763109
917,6,6,1,2412,-46,-89,43,40:e3:d6:da:ba:21,8763301,368,-176,8762933,8763301
918,6,12,1,2412,-46,-89,43,40:e3:d6:da:ba:22,8763715,180,234,8763535,8763715
919,6,12,1,2412,-46,-89,43,40:e3:d6:da:ba:23,8763921,184,22,8763737,8763921
920,6,12,1,2412,-46,-89,43,40:e3:d6:da:ba:24,8764148,176,51,8763972,8764148
921,6,12,1,2412,-46,-89,43,40:e3:d6:da:ba:25,8764368,160,60,8764208,8764368
922,6,6,1,2412,-46,-89,43,40:e3:d6:da:ba:26,8764586,380,-162,8764206,8764586
923,4,1,1,2412,-70,-89,19,54:e4:3a:ec:fb:64,8774404,2160,7658,8772244,8774404
924,4,1,1,2412,-64,-89,25,24:f6:77:10:02:c8,8776715,1064,1247,8775651,8776715
925,6,12,1,2412,-46,-89,43,40:e3:d6:da:ba:20,8866394,160,89519,8866234,8866394
926,6,6,1,2412,-45,-89,44,40:e3:d6:da:ba:21,8866586,368,-176,8866218,8866586
927,6,12,1,2412,-46,-89,43,40:e3:d6:da:ba:22,8866973,180,207,8866793,8866973
928,6,12,1,2412,-46,-89,43,40:e3:d6:da:ba:24,8867478,176,329,8867302,8867478
929,6,12,1,2412,-46,-89,43,40:e3:d6:da:ba:25,8867698,160,60,8867538,8867698
930,6,6,1,2412,-46,-89,43,40:e3:d6:da:ba:26,8867992,380,-86,8867612,8867992
931,4,1,1,2412,-87,-89,2,b8:3a:5a:88:e6:e1,8881782,2376,11414,8879406,8881782
932,6,12,1,2412,-47,-89,42,40:e3:d6:da:ba:20,8967894,160,85952,8967734,8967894
933,6,6,1,2412,-47,-89,42,40:e3:d6:da:ba:21,8968104,368,-158,8967736,8968104
934,6,12,1,2412,-47,-89,42,40:e3:d6:da:ba:22,8968509,180,225,8968329,8968509
935,6,12,1,2412,-46,-89,43,40:e3:d6:da:ba:23,8968793,184,100,8968609,8968793
936,6,12,1,2412,-47,-89,42,40:e3:d6:da:ba:24,8969021,176,52,8968845,8969021
937,6,12,1,2412,-47,-89,42,40:e3:d6:da:ba:25,8969231,160,50,8969071,8969231
938,6,6,1,2412,-47,-89,42,40:e3:d6:da:ba:26,8969441,380,-170,8969061,8969441
939,6,6,1,2412,-83,-89,6,e6:aa:ea:c9:ea:1b,8978301,408,8452,8977893,8978301
940,4,1,1,2412,-77,-89,12,54:e4:3a:ec:fb:64,8979202,2160,-1259,8977042,8979202
941,4,1,1,2412,-89,-89,0,b8:3a:5a:88:e6:e0,8981395,2360,-167,8979035,8981395
942,6,6,1,2412,-83,-89,6,e6:aa:ea:c9:ea:1b,9002523,408,20720,9002115,9002523
943,6,6,1,2412,-82,-89,7,e6:aa:ea:c9:ea:1b,9014641,408,11710,9014233,9014641
944,6,6,1,2412,-73,-89,16,e6:aa:ea:b7:4a:dd,9015791,408,742,9015383,9015791
945,6,6,1,2412,-73,-89,16,e6:aa:ea:b7:4a:dd,9064267,408,48068,9063859,9064267
946,6,12,1,2412,-50,-89,39,40:e3:d6:da:ba:20,9070300,160,5873,9070140,9070300
947,6,6,1,2412,-50,-89,39,40:e3:d6:da:ba:21,9070519,368,-149,9070151,9070519
948,6,12,1,2412,-50,-89,39,40:e3:d6:da:ba:22,9070915,180,216,9070735,9070915
949,6,12,1,2412,-50,-89,39,40:e3:d6:da:ba:24,9071339,176,248,9071163,9071339
950,6,12,1,2412,-50,-89,39,40:e3:d6:da:ba:25,9071550,160,51,9071390,9071550
951,6,6,1,2412,-50,-89,39,40:e3:d6:da:ba:26,9071750,380,-180,9071370,9071750
952,4,1,1,2412,-71,-89,18,54:e4:3a:ec:fb:64,9081601,2160,7691,9079441,9081601
953,6,6,1,2412,-50,-89,39,e6:aa:ea:c9:ea:33,9096691,408,14682,9096283,9096691
954,6,6,1,2412,-50,-89,39,e6:aa:ea:c9:ea:33,9120933,408,23834,9120525,9120933
955,6,6,1,2412,-50,-89,39,e6:aa:ea:c9:ea:33,9133040,408,11699,9132632,9133040
956,6,6,1,2412,-49,-89,40,e6:aa:ea:c9:ea:33,9145161,408,11713,9144753,9145161
957,6,12,1,2412,-48,-89,41,40:e3:d6:da:ba:20,9172696,160,27375,9172536,9172696
958,6,6,1,2412,-47,-89,42,40:e3:d6:da:ba:21,9172978,368,-86,9172610,9172978
959,6,12,1,2412,-48,-89,41,40:e3:d6:da:ba:22,9173383,180,225,9173203,9173383
960,6,12,1,2412,-48,-89,41,40:e3:d6:da:ba:23,9173606,184,39,9173422,9173606
961,6,12,1,2412,-48,-89,41,40:e3:d6:da:ba:24,9173860,176,78,9173684,9173860
962,6,12,1,2412,-48,-89,41,40:e3:d6:da:ba:25,9174061,160,41,9173901,9174061
963,6,6,1,2412,-48,-89,41,40:e3:d6:da:ba:26,9174262,380,-179,9173882,9174262
964,4,1,1,2412,-87,-89,2,c0:c9:e3:4d:6e:bf,9274940,872,99806,9274068,9274940
965,6,12,1,2412,-47,-89,42,40:e3:d6:da:ba:20,9275690,160,590,9275530,9275690
966,6,12,1,2412,-47,-89,42,40:e3:d6:da:ba:22,9276470,180,600,9276290,9276470
967,6,12,1,2412,-47,-89,42,40:e3:d6:da:ba:23,9276684,184,30,9276500,9276684
968,6,12,1,2412,-47,-89,42,40:e3:d6:da:ba:24,9276921,176,61,9276745,9276921
969,6,12,1,2412,-47,-89,42,40:e3:d6:da:ba:25,9277149,160,68,9276989,9277149
970,6,6,1,2412,-47,-89,42,40:e3:d6:da:ba:26,9277350,380,-179,9276970,9277350
971,6,12,1,2412,-47,-89,42,40:e3:d6:da:ba:20,9377503,160,99993,9377343,9377503
972,6,6,1,2412,-47,-89,42,40:e3:d6:da:ba:21,9377704,368,-167,9377336,9377704
973,6,12,1,2412,-47,-89,42,40:e3:d6:da:ba:22,9378118,180,234,9377938,9378118
974,6,12,1,2412,-47,-89,42,40:e3:d6:da:ba:23,9378351,184,49,9378167,9378351
975,6,12,1,2412,-47,-89,42,40:e3:d6:da:ba:24,9378587,176,60,9378411,9378587
976,6,12,1,2412,-47,-89,42,40:e3:d6:da:ba:25,9378816,160,69,9378656,9378816
977,6,6,1,2412,-47,-89,42,40:e3:d6:da:ba:26,9379008,380,-188,9378628,9379008
978,6,6,1,2412,-46,-89,43,e6:aa:ea:c9:ea:33,9412307,408,32891,9411899,9412307
979,6,6,1,2412,-47,-89,42,e6:aa:ea:c9:ea:33,9436549,408,23834,9436141,9436549
980,6,6,1,2412,-46,-89,43,e6:aa:ea:c9:ea:33,9448709,408,11752,9448301,9448709
981,6,6,1,2412,-47,-89,42,e6:aa:ea:c9:ea:33,9460799,408,11682,9460391,9460799
982,6,12,1,2412,-47,-89,42,40:e3:d6:da:ba:20,9479897,160,18938,9479737,9479897
983,6,6,1,2412,-47,-89,42,40:e3:d6:da:ba:26,9482450,380,2173,9482070,9482450
984,4,1,1,2412,-87,-89,2,b8:3a:5a:88:e6:e1,9495046,2376,10220,9492670,9495046
985,6,6,1,2412,-86,-89,3,e6:aa:ea:c9:ea:1b,9525347,408,29893,9524939,9525347
986,6,6,1,2412,-73,-89,16,e6:aa:ea:b7:4a:dd,9536459,408,10704,9536051,9536459
987,6,6,1,2412,-73,-89,16,e6:aa:ea:b7:4a:dd,9560698,408,23831,9560290,9560698
988,6,6,1,2412,-72,-89,17,e6:aa:ea:b7:4a:dd,9572801,408,11695,9572393,9572801
989,6,12,1,2412,-46,-89,43,40:e3:d6:da:ba:20,9582298,160,9337,9582138,9582298
990,6,6,1,2412,-45,-89,44,40:e3:d6:da:ba:21,9582517,368,-149,9582149,9582517
991,6,12,1,2412,-45,-89,44,40:e3:d6:da:ba:22,9582913,180,216,9582733,9582913
992,6,12,1,2412,-45,-89,44,40:e3:d6:da:ba:23,9583216,184,119,9583032,9583216
993,6,12,1,2412,-45,-89,44,40:e3:d6:da:ba:24,9583434,176,42,9583258,9583434
994,6,12,1,2412,-45,-89,44,40:e3:d6:da:ba:25,9583653,160,59,9583493,9583653
995,6,6,1,2412,-45,-89,44,40:e3:d6:da:ba:26,9583855,380,-178,9583475,9583855
996,6,6,1,2412,-73,-89,16,e6:aa:ea:b7:4a:dd,9585696,408,1433,9585288,9585696
997,4,1,1,2412,-71,-89,18,54:e4:3a:ec:fb:64,9593635,2160,5779,9591475,9593635
998,6,12,1,2412,-45,-89,44,40:e3:d6:da:ba:20,9684721,160,90926,9684561,9684721
999,6,6,1,2412,-44,-89,45,40:e3:d6:da:ba:21,9684913,368,-176,9684545,9684913
1000,6,12,1,2412,-45,-89,44,40:e3:d6:da:ba:22,9685318,180,225,9685138,9685318
1001,6,12,1,2412,-44,-89,45,40:e3:d6:da:ba:23,9685523,184,21,9685339,9685523
1002,6,12,1,2412,-44,-89,45,40:e3:d6:da:ba:24,9685741,176,42,9685565,9685741
1003,6,12,1,2412,-45,-89,44,40:e3:d6:da:ba:25,9687615,160,1714,9687455,9687615
1004,6,6,1,2412,-44,-89,45,40:e3:d6:da:ba:26,9687973,380,-22,9687593,9687973
1005,6,6,1,2412,-47,-89,42,e6:aa:ea:c9:ea:33,9727783,408,39402,9727375,9727783
1006,6,6,1,2412,-46,-89,43,e6:aa:ea:c9:ea:33,9739904,408,11713,9739496,9739904
1007,6,6,1,2412,-46,-89,43,e6:aa:ea:c9:ea:33,9753780,408,13468,9753372,9753780
1008,6,6,1,2412,-46,-89,43,e6:aa:ea:c9:ea:33,9764102,408,9914,9763694,9764102
1009,6,6,1,2412,-46,-89,43,e6:aa:ea:c9:ea:33,9776229,408,11719,9775821,9776229
1010,6,12,1,2412,-45,-89,44,40:e3:d6:da:ba:23,9787999,184,11586,9787815,9787999
1011,6,12,1,2412,-44,-89,45,40:e3:d6:da:ba:25,9788451,160,292,9788291,9788451
1012,6,6,1,2412,-44,-89,45,40:e3:d6:da:ba:26,9788676,380,-155,9788296,9788676
1013,4,1,1,2412,-71,-89,18,54:e4:3a:ec:fb:64,9798396,2160,7560,9796236,9798396
1014,4,1,1,2412,-91,-89,-2,,9830409,304,31709,9830105,9830409
1015,6,12,1,2412,-45,-89,44,40:e3:d6:da:ba:22,9890117,180,59528,9889937,9890117
1016,6,12,1,2412,-46,-89,43,40:e3:d6:da:ba:24,9890540,176,247,9890364,9890540
1017,6,12,1,2412,-45,-89,44,40:e3:d6:da:ba:25,9890783,160,83,9890623,9890783
1018,6,6,1,2412,-46,-89,43,40:e3:d6:da:ba:26,9890993,380,-170,9890613,9890993
1019,4,1,1,2412,-91,-89,-2,b8:3a:5a:88:e6:e1,9905369,2376,12000,9902993,9905369
1020,6,6,1,2412,-70,-89,19,e6:aa:ea:b7:4a:dd,9965887,408,60110,9965479,9965887
1021,6,6,1,2412,-70,-89,19,e6:aa:ea:b7:4a:dd,9977947,408,11652,9977539,9977947
1022,6,12,1,2412,-46,-89,43,40:e3:d6:da:ba:20,9994258,160,16151,9994098,9994258
1023,6,6,1,2412,-46,-89,43,40:e3:d6:da:ba:21,9994796,368,170,9994428,9994796
1024,6,12,1,2412,-46,-89,43,40:e3:d6:da:ba:22,9995182,180,206,9995002,9995182
1025,6,12,1,2412,-46,-89,43,40:e3:d6:da:ba:23,9995415,184,49,9995231,9995415
1026,6,12,1,2412,-46,-89,43,40:e3:d6:da:ba:24,9995642,176,51,9995466,9995642
1027,6,12,1,2412,-46,-89,43,40:e3:d6:da:ba:25,9995844,160,42,9995684,9995844
1028,6,6,1,2412,-46,-89,43,40:e3:d6:da:ba:26,9996035,380,-189,9995655,9996035
1029,6,6,1,2412,-70,-89,19,e6:aa:ea:b7:4a:dd,10002185,408,5742,10001777,10002185
1030,4,1,1,2412,-69,-89,20,54:e4:3a:ec:fb:64,10003193,2160,-1152,10001033,10003193
1031,6,6,1,2412,-86,-89,3,e6:aa:ea:c9:ea:1b,10023352,408,19751,10022944,10023352
1032,6,6,1,2412,-86,-89,3,e6:aa:ea:c9:ea:1b,10035463,408,11703,10035055,10035463
1033,6,6,1,2412,-86,-89,3,e6:aa:ea:c9:ea:1b,10047578,408,11707,10047170,10047578
1034,6,12,1,2412,-48,-89,41,40:e3:d6:da:ba:20,10094319,160,46581,10094159,10094319
1035,6,6,1,2412,-47,-89,42,40:e3:d6:da:ba:21,10094538,368,-149,10094170,10094538
1036,6,12,1,2412,-47,-89,42,40:e3:d6:da:ba:22,10094943,180,225,10094763,10094943
1037,6,12,1,2412,-47,-89,42,40:e3:d6:da:ba:23,10095167,184,40,10094983,10095167
1038,6,12,1,2412,-47,-89,42,40:e3:d6:da:ba:24,10095376,176,33,10095200,10095376
1039,6,12,1,2412,-47,-89,42,40:e3:d6:da:ba:25,10095605,160,69,10095445,10095605
1040,6,6,1,2412,-47,-89,42,40:e3:d6:da:ba:26,10095823,380,-162,10095443,10095823
1041,4,1,1,2412,-69,-89,20,54:e4:3a:ec:fb:64,10105594,2160,7611,10103434,10105594
1042,6,12,1,2412,-50,-89,39,40:e3:d6:da:ba:20,10196715,160,90961,10196555,10196715
1043,6,6,1,2412,-50,-89,39,40:e3:d6:da:ba:21,10196925,368,-158,10196557,10196925
1044,6,12,1,2412,-49,-89,40,40:e3:d6:da:ba:22,10197330,180,225,10197150,10197330
1045,6,12,1,2412,-49,-89,40,40:e3:d6:da:ba:23,10197562,184,48,10197378,10197562
1046,6,12,1,2412,-49,-89,40,40:e3:d6:da:ba:24,10197772,176,34,10197596,10197772
1047,6,12,1,2412,-49,-89,40,40:e3:d6:da:ba:25,10197991,160,59,10197831,10197991
1048,6,6,1,2412,-49,-89,40,40:e3:d6:da:ba:26,10198210,380,-161,10197830,10198210
1049,4,1,1,2412,-87,-89,2,b8:3a:5a:88:e6:e1,10212592,2376,12006,10210216,10212592
1050,6,6,1,2412,-47,-89,42,e6:aa:ea:c9:ea:33,10248699,408,35699,10248291,10248699
1051,6,6,1,2412,-47,-89,42,e6:aa:ea:c9:ea:33,10260715,408,11608,10260307,10260715
1052,6,6,1,2412,-47,-89,42,e6:aa:ea:c9:ea:33,10284977,408,23854,10284569,10284977
1053,6,6,1,2412,-47,-89,42,e6:aa:ea:c9:ea:33,10297061,408,11676,10296653,10297061
1054,6,6,1,2412,-51,-89,38,40:e3:d6:da:ba:21,10299340,368,1911,10298972,10299340
1055,6,12,1,2412,-50,-89,39,40:e3:d6:da:ba:24,10300178,176,662,10300002,10300178
1056,6,6,1,2412,-51,-89,38,40:e3:d6:da:ba:26,10300598,380,40,10300218,10300598
1057,4,1,1,2412,-75,-89,14,,10303238,304,2336,10302934,10303238
1058,4,1,1,2412,-87,-89,2,b8:3a:5a:88:e6:e0,10312592,2360,6994,10310232,10312592
1059,6,6,1,2412,-72,-89,17,e6:aa:ea:b7:4a:dd,10396114,408,83114,10395706,10396114
1060,6,12,1,2412,-50,-89,39,40:e3:d6:da:ba:20,10401529,160,5255,10401369,10401529
1061,6,6,1,2412,-50,-89,39,40:e3:d6:da:ba:21,10401748,368,-149,10401380,10401748
1062,6,12,1,2412,-50,-89,39,40:e3:d6:da:ba:22,10402162,180,234,10401982,10402162
1063,6,12,1,2412,-50,-89,39,40:e3:d6:da:ba:23,10402376,184,30,10402192,10402376
1064,6,12,1,2412,-50,-89,39,40:e3:d6:da:ba:24,10402594,176,42,10402418,10402594
1065,6,12,1,2412,-50,-89,39,40:e3:d6:da:ba:25,10402805,160,51,10402645,10402805
1066,6,6,1,2412,-50,-89,39,40:e3:d6:da:ba:26,10403024,380,-161,10402644,10403024
1067,6,12,1,2412,-49,-89,40,40:e3:d6:da:ba:20,10503908,160,100724,10503748,10503908
1068,6,6,1,2412,-48,-89,41,40:e3:d6:da:ba:21,10504109,368,-167,10503741,10504109
1069,6,12,1,2412,-48,-89,41,40:e3:d6:da:ba:22,10504514,180,225,10504334,10504514
1070,6,12,1,2412,-48,-89,41,40:e3:d6:da:ba:23,10504747,184,49,10504563,10504747
1071,6,12,1,2412,-48,-89,41,40:e3:d6:da:ba:24,10504956,176,33,10504780,10504956
1072,6,12,1,2412,-48,-89,41,40:e3:d6:da:ba:25,10505176,160,60,10505016,10505176
1073,6,6,1,2412,-49,-89,40,40:e3:d6:da:ba:26,10505376,380,-180,10504996,10505376
1074,6,6,1,2412,-85,-89,4,e6:aa:ea:c9:ea:1b,10545207,408,39423,10544799,10545207
1075,6,6,1,2412,-47,-89,42,e6:aa:ea:c9:ea:33,10563328,408,17713,10562920,10563328
1076,6,6,1,2412,-48,-89,41,e6:aa:ea:c9:ea:33,10575447,408,11711,10575039,10575447
1077,6,6,1,2412,-85,-89,4,e6:aa:ea:c9:ea:1b,10581550,408,5695,10581142,10581550
1078,6,6,1,2412,-49,-89,40,e6:aa:ea:c9:ea:33,10587562,408,5604,10587154,10587562
1079,6,6,1,2412,-85,-89,4,e6:aa:ea:c9:ea:1b,10593642,408,5672,10593234,10593642
1080,6,6,1,2412,-50,-89,39,e6:aa:ea:c9:ea:33,10599689,408,5639,10599281,10599689
1081,6,12,1,2412,-48,-89,41,40:e3:d6:da:ba:20,10606350,160,6501,10606190,10606350
1082,6,6,1,2412,-48,-89,41,40:e3:d6:da:ba:21,10606542,368,-176,10606174,10606542
1083,6,12,1,2412,-47,-89,42,40:e3:d6:da:ba:22,10606947,180,225,10606767,10606947
1084,6,12,1,2412,-48,-89,41,40:e3:d6:da:ba:23,10607152,184,21,10606968,10607152
1085,6,12,1,2412,-47,-89,42,40:e3:d6:da:ba:24,10607362,176,34,10607186,10607362
1086,6,12,1,2412,-47,-89,42,40:e3:d6:da:ba:25,10607573,160,51,10607413,10607573
1087,6,6,1,2412,-47,-89,42,40:e3:d6:da:ba:26,10607792,380,-161,10607412,10607792
1088,6,6,1,2412,-50,-89,39,e6:aa:ea:c9:ea:33,10611809,408,3609,10611401,10611809
1089,6,6,1,2412,-75,-89,14,e6:aa:ea:b7:4a:dd,10699520,408,87303,10699112,10699520
1090,6,12,1,2412,-67,-89,22,40:e3:d6:da:ba:20,10708818,160,9138,10708658,10708818
1091,6,12,1,2412,-47,-89,42,40:e3:d6:da:ba:23,10709702,184,700,10709518,10709702
1092,6,12,1,2412,-48,-89,41,40:e3:d6:da:ba:24,10709951,176,73,10709775,10709951
1093,6,12,1,2412,-47,-89,42,40:e3:d6:da:ba:25,10710185,160,74,10710025,10710185
1094,6,6,1,2412,-47,-89,42,40:e3:d6:da:ba:26,10710386,380,-179,10710006,10710386
1095,6,6,1,2412,-74,-89,15,e6:aa:ea:b7:4a:dd,10711832,408,1038,10711424,10711832
1096,4,1,1,2412,-57,-89,32,54:e4:3a:ec:fb:64,10719988,2160,5996,10717828,10719988
1097,6,6,1,2412,-74,-89,15,e6:aa:ea:b7:4a:dd,10735867,408,15471,10735459,10735867
1098,4,1,1,2412,-88,-89,1,,10745860,304,9689,10745556,10745860
1099,4,1,1,2412,-87,-89,2,a6:e5:7c:28:b1:d3,10784276,992,37424,10783284,10784276
1100,4,1,1,2412,-85,-89,4,,10791182,304,6602,10790878,10791182
1101,6,12,1,2412,-48,-89,41,40:e3:d6:da:ba:20,10811111,160,19769,10810951,10811111
1102,6,6,1,2412,-48,-89,41,40:e3:d6:da:ba:21,10811312,368,-167,10810944,10811312
1103,6,12,1,2412,-48,-89,41,40:e3:d6:da:ba:22,10811782,180,290,10811602,10811782
1104,6,12,1,2412,-48,-89,41,40:e3:d6:da:ba:23,10811988,184,22,10811804,10811988
1105,6,12,1,2412,-48,-89,41,40:e3:d6:da:ba:24,10812225,176,61,10812049,10812225
1106,6,12,1,2412,-48,-89,41,40:e3:d6:da:ba:25,10812435,160,50,10812275,10812435
1107,6,6,1,2412,-48,-89,41,40:e3:d6:da:ba:26,10812636,380,-179,10812256,10812636
1108,4,1,1,2412,-69,-89,20,54:e4:3a:ec:fb:64,10822388,2160,7592,10820228,10822388
1109,6,6,1,2412,-86,-89,3,e6:aa:ea:c9:ea:1b,10898728,408,75932,10898320,10898728
1110,6,6,1,2412,-86,-89,3,e6:aa:ea:c9:ea:1b,10910747,408,11611,10910339,10910747
1111,6,12,1,2412,-48,-89,41,40:e3:d6:da:ba:20,10913504,160,2597,10913344,10913504
1112,6,6,1,2412,-48,-89,41,40:e3:d6:da:ba:21,10913696,368,-176,10913328,10913696
1113,6,12,1,2412,-47,-89,42,40:e3:d6:da:ba:22,10914203,180,327,10914023,10914203
1114,6,12,1,2412,-48,-89,41,40:e3:d6:da:ba:23,10914417,184,30,10914233,10914417
1115,6,12,1,2412,-48,-89,41,40:e3:d6:da:ba:24,10914627,176,34,10914451,10914627
1116,6,6,1,2412,-48,-89,41,40:e3:d6:da:ba:26,10915035,380,28,10914655,10915035
1117,4,1,1,2412,-70,-89,19,54:e4:3a:ec:fb:64,10924786,2160,7591,10922626,10924786
1118,6,6,1,2412,-46,-89,43,e6:aa:ea:c9:ea:33,10981272,408,56078,10980864,10981272
1119,6,6,1,2412,-47,-89,42,e6:aa:ea:c9:ea:33,10994191,408,12511,10993783,10994191
1120,6,6,1,2412,-47,-89,42,e6:aa:ea:c9:ea:33,11005480,408,10881,11005072,11005480
1121,6,6,1,2412,-73,-89,16,e6:aa:ea:b7:4a:dd,11014613,408,8725,11014205,11014613
1122,6,12,1,2412,-47,-89,42,40:e3:d6:da:ba:20,11015923,160,1150,11015763,11015923
1123,6,6,1,2412,-47,-89,42,40:e3:d6:da:ba:21,11016132,368,-159,11015764,11016132
1124,6,12,1,2412,-47,-89,42,40:e3:d6:da:ba:22,11016519,180,207,11016339,11016519
1125,6,12,1,2412,-47,-89,42,40:e3:d6:da:ba:23,11016749,184,46,11016565,11016749
1126,6,12,1,2412,-47,-89,42,40:e3:d6:da:ba:24,11016967,176,42,11016791,11016967
1127,6,12,1,2412,-47,-89,42,40:e3:d6:da:ba:25,11017195,160,68,11017035,11017195
1128,6,6,1,2412,-47,-89,42,40:e3:d6:da:ba:26,11017396,380,-179,11017016,11017396
1129,6,6,1,2412,-46,-89,43,e6:aa:ea:c9:ea:33,11017838,408,34,11017430,11017838
1130,4,1,1,2412,-71,-89,18,54:e4:3a:ec:fb:64,11050411,2112,30461,11048299,11050411
1131,4,1,1,2412,-54,-89,35,54:e4:3a:ec:fb:64,11053865,2112,1342,11051753,11053865
1132,6,12,1,2412,-46,-89,43,40:e3:d6:da:ba:20,11118319,160,64294,11118159,11118319
1133,6,6,1,2412,-46,-89,43,40:e3:d6:da:ba:21,11118511,368,-176,11118143,11118511
1134,6,12,1,2412,-46,-89,43,40:e3:d6:da:ba:23,11119165,184,470,11118981,11119165
1135,6,12,1,2412,-46,-89,43,40:e3:d6:da:ba:24,11119402,176,61,11119226,11119402
1136,6,12,1,2412,-46,-89,43,40:e3:d6:da:ba:25,11119612,160,50,11119452,11119612
1137,6,6,1,2412,-46,-89,43,40:e3:d6:da:ba:26,11119804,380,-188,11119424,11119804
1138,6,12,1,2412,-45,-89,44,40:e3:d6:da:ba:20,11220731,160,100767,11220571,11220731
1139,6,12,1,2412,-45,-89,44,40:e3:d6:da:ba:22,11221344,180,433,11221164,11221344
1140,6,12,1,2412,-45,-89,44,40:e3:d6:da:ba:23,11221559,184,31,11221375,11221559
1141,6,12,1,2412,-45,-89,44,40:e3:d6:da:ba:24,11221777,176,42,11221601,11221777
1142,6,12,1,2412,-45,-89,44,40:e3:d6:da:ba:25,11221997,160,60,11221837,11221997
1143,6,6,1,2412,-45,-89,44,40:e3:d6:da:ba:26,11222207,380,-170,11221827,11222207
1144,4,1,1,2412,-44,-89,45,9c:b6:d0:e8:0f:05,11243137,864,20066,11242273,11243137
1145,6,12,1,2412,-46,-89,43,40:e3:d6:da:ba:23,11244018,156,725,11243862,11244018
1146,6,12,1,2412,-44,-89,45,,11244190,32,140,11244158,11244190
1147,4,1,1,2412,-44,-89,45,9c:b6:d0:e8:0f:05,11253357,864,8303,11252493,11253357
1148,6,12,1,2412,-46,-89,43,40:e3:d6:da:ba:23,11254202,156,689,11254046,11254202
1149,6,12,1,2412,-44,-89,45,,11254374,32,140,11254342,11254374
1150,4,1,1,2412,-44,-89,45,9c:b6:d0:e8:0f:05,11263580,864,8342,11262716,11263580
1151,6,12,1,2412,-46,-89,43,40:e3:d6:da:ba:23,11264458,156,722,11264302,11264458
1152,6,12,1,2412,-44,-89,45,,11264630,32,140,11264598,11264630
1153,4,1,1,2412,-86,-89,3,a6:e5:7c:28:b1:d3,11312888,944,47314,11311944,11312888
1154,4,1,1,2412,-85,-89,4,a6:e5:7c:28:b1:d3,11313966,944,134,11313022,11313966
1155,4,1,1,2412,-87,-89,2,a6:e5:7c:28:b1:d3,11316122,944,1212,11315178,11316122
1156,6,12,1,2412,-46,-89,43,40:e3:d6:da:ba:20,11323106,160,6824,11322946,11323106
1157,6,6,1,2412,-46,-89,43,40:e3:d6:da:ba:21,11323307,368,-167,11322939,11323307
1158,6,12,1,2412,-46,-89,43,40:e3:d6:da:ba:22,11323703,180,216,11323523,11323703
1159,6,12,1,2412,-46,-89,43,40:e3:d6:da:ba:23,11323918,184,31,11323734,11323918
1160,6,12,1,2412,-46,-89,43,40:e3:d6:da:ba:24,11324127,176,33,11323951,11324127
1161,6,12,1,2412,-46,-89,43,40:e3:d6:da:ba:25,11324355,160,68,11324195,11324355
1162,6,6,1,2412,-46,-89,43,40:e3:d6:da:ba:26,11324565,380,-170,11324185,11324565
1163,4,1,1,2412,-71,-89,18,54:e4:3a:ec:fb:64,11334382,2160,7657,11332222,11334382
1164,6,6,1,2412,-73,-89,16,e6:aa:ea:b7:4a:dd,11354048,408,19258,11353640,11354048
1165,6,6,1,2412,-71,-89,18,e6:aa:ea:b7:4a:dd,11366165,408,11709,11365757,11366165
1166,4,1,1,2412,-88,-89,1,a6:e5:7c:28:b1:d3,11399187,992,32030,11398195,11399187
1167,6,6,1,2412,-78,-89,11,e6:aa:ea:c9:ea:1b,11408014,408,8419,11407606,11408014
1168,6,6,1,2412,-82,-89,7,e6:aa:ea:c9:ea:1b,11420293,408,11871,11419885,11420293
1169,6,12,1,2412,-48,-89,41,40:e3:d6:da:ba:20,11425518,160,5065,11425358,11425518
1170,6,6,1,2412,-48,-89,41,40:e3:d6:da:ba:21,11425719,368,-167,11425351,11425719
1171,6,12,1,2412,-47,-89,42,40:e3:d6:da:ba:23,11426365,184,462,11426181,11426365
1172,6,12,1,2412,-47,-89,42,40:e3:d6:da:ba:24,11426593,176,52,11426417,11426593
1173,6,12,1,2412,-48,-89,41,40:e3:d6:da:ba:25,11426803,160,50,11426643,11426803
1174,6,6,1,2412,-48,-89,41,40:e3:d6:da:ba:26,11427022,380,-161,11426642,11427022
1175,4,1,1,2412,-89,-89,0,b8:3a:5a:88:e6:e1,11472003,2256,42725,11469747,11472003
1176,6,6,1,2412,-44,-89,45,e6:aa:ea:c9:ea:33,11513678,408,41267,11513270,11513678
1177,6,6,1,2412,-45,-89,44,e6:aa:ea:c9:ea:33,11525710,408,11624,11525302,11525710
1178,6,12,1,2412,-48,-89,41,40:e3:d6:da:ba:20,11527931,160,2061,11527771,11527931
1179,6,6,1,2412,-48,-89,41,40:e3:d6:da:ba:21,11528123,368,-176,11527755,11528123
1180,6,12,1,2412,-48,-89,41,40:e3:d6:da:ba:22,11528528,180,225,11528348,11528528
1181,6,12,1,2412,-47,-89,42,40:e3:d6:da:ba:23,11528742,184,30,11528558,11528742
1182,6,12,1,2412,-48,-89,41,40:e3:d6:da:ba:24,11528952,176,34,11528776,11528952
1183,6,12,1,2412,-49,-89,40,40:e3:d6:da:ba:25,11531737,160,2625,11531577,11531737
1184,6,6,1,2412,-48,-89,41,40:e3:d6:da:ba:26,11531964,380,-153,11531584,11531964
1185,6,6,1,2412,-45,-89,44,e6:aa:ea:c9:ea:33,11537834,408,5462,11537426,11537834
1186,4,1,1,2412,-73,-89,16,54:e4:3a:ec:fb:64,11539182,2160,-812,11537022,11539182
1187,6,6,1,2412,-45,-89,44,e6:aa:ea:c9:ea:33,11550071,408,10481,11549663,11550071
1188,6,6,1,2412,-88,-89,1,,11603347,44,53232,11603303,11603347
1189,4,1,1,2412,-90,-89,-1,a6:e5:7c:28:b1:d3,11603607,992,-732,11602615,11603607
1190,6,12,1,2412,-50,-89,39,40:e3:d6:da:ba:20,11604459,136,716,11604323,11604459
1191,6,6,1,2412,-47,-89,42,40:e3:d6:da:ba:21,11606024,348,1217,11605676,11606024
1192,6,12,1,2412,-46,-89,43,40:e3:d6:da:ba:22,11606417,156,237,11606261,11606417
1193,6,12,1,2412,-47,-89,42,40:e3:d6:da:ba:23,11609112,156,2539,11608956,11609112
1194,6,12,1,2412,-46,-89,43,40:e3:d6:da:ba:25,11609312,136,64,11609176,11609312
1195,6,12,1,2412,-46,-89,43,40:e3:d6:da:ba:20,11630314,160,20842,11630154,11630314
1196,6,6,1,2412,-46,-89,43,40:e3:d6:da:ba:21,11630524,368,-158,11630156,11630524
1197,6,12,1,2412,-46,-89,43,40:e3:d6:da:ba:22,11630999,180,295,11630819,11630999
1198,6,12,1,2412,-46,-89,43,40:e3:d6:da:ba:23,11631213,184,30,11631029,11631213
1199,6,12,1,2412,-46,-89,43,40:e3:d6:da:ba:24,11631450,176,61,11631274,11631450
1200,6,12,1,2412,-46,-89,43,40:e3:d6:da:ba:25,11631652,160,42,11631492,11631652
1201,6,6,1,2412,-46,-89,43,40:e3:d6:da:ba:26,11631844,380,-188,11631464,11631844
1202,6,6,1,2412,-80,-89,9,78:8a:20:fa:27:f9,11653308,88,21376,11653220,11653308
1203,6,12,1,2412,-46,-89,43,40:e3:d6:da:ba:20,11653533,136,89,11653397,11653533
1204,6,12,1,2412,-80,-89,9,,11653672,32,107,11653640,11653672
1205,6,6,1,2412,-46,-89,43,40:e3:d6:da:ba:21,11653772,348,-248,11653424,11653772
1206,6,12,1,2412,-46,-89,43,40:e3:d6:da:ba:22,11654158,156,230,11654002,11654158
1207,6,12,1,2412,-46,-89,43,40:e3:d6:da:ba:23,11654357,156,43,11654201,11654357
1208,6,12,1,2412,-46,-89,43,40:e3:d6:da:ba:25,11654557,136,64,11654421,11654557
1209,6,12,1,2412,-80,-89,9,,11654820,32,231,11654788,11654820
1210,4,1,1,2412,-53,-89,36,d6:6e:a6:7d:63:2f,11704082,1152,48110,11702930,11704082
1211,4,1,1,2412,-73,-89,16,54:e4:3a:ec:fb:64,11705351,2112,-843,11703239,11705351
1212,4,1,1,2412,-73,-89,16,54:e4:3a:ec:fb:64,11707582,2112,119,11705470,11707582
1213,4,1,1,2412,-53,-89,36,,11709706,304,1820,11709402,11709706
1214,6,12,1,2412,-46,-89,43,40:e3:d6:da:ba:20,11709870,136,28,11709734,11709870
1215,6,12,1,2412,-54,-89,35,,11710023,32,121,11709991,11710023
1216,6,6,1,2412,-46,-89,43,40:e3:d6:da:ba:21,11710096,348,-275,11709748,11710096
1217,6,12,1,2412,-46,-89,43,40:e3:d6:da:ba:22,11710657,156,405,11710501,11710657
1218,6,12,1,2412,-46,-89,43,40:e3:d6:da:ba:23,11710847,156,34,11710691,11710847
1219,6,12,1,2412,-46,-89,43,40:e3:d6:da:ba:25,11711283,136,300,11711147,11711283
1220,4,1,1,2412,-54,-89,35,d6:6e:a6:7d:63:2f,11724390,1152,11955,11723238,11724390
1221,6,12,1,2412,-47,-89,42,40:e3:d6:da:ba:20,11727995,136,3469,11727859,11727995
1222,6,12,1,2412,-54,-89,35,,11728147,32,120,11728115,11728147
1223,6,6,1,2412,-46,-89,43,40:e3:d6:da:ba:21,11730896,348,2401,11730548,11730896
1224,6,6,1,2412,-53,-89,36,,11731261,44,321,11731217,11731261
1225,6,12,1,2412,-46,-89,43,40:e3:d6:da:ba:22,11731334,156,-83,11731178,11731334
1226,6,12,1,2412,-46,-89,43,40:e3:d6:da:ba:23,11731573,156,83,11731417,11731573
1227,6,12,1,2412,-53,-89,36,,11731745,32,140,11731713,11731745
1228,6,12,1,2412,-46,-89,43,40:e3:d6:da:ba:25,11731822,136,-59,11731686,11731822
1229,6,12,1,2412,-52,-89,37,,11731974,32,120,11731942,11731974
1230,6,6,1,2412,-47,-89,42,40:e3:d6:da:ba:21,11735064,368,2722,11734696,11735064
1231,6,12,1,2412,-46,-89,43,40:e3:d6:da:ba:22,11735460,180,216,11735280,11735460
1232,6,12,1,2412,-46,-89,43,40:e3:d6:da:ba:23,11735674,184,30,11735490,11735674
1233,6,12,1,2412,-46,-89,43,40:e3:d6:da:ba:24,11735926,176,76,11735750,11735926
1234,6,12,1,2412,-46,-89,43,40:e3:d6:da:ba:25,11736137,160,51,11735977,11736137
1235,6,6,1,2412,-46,-89,43,40:e3:d6:da:ba:26,11736329,380,-188,11735949,11736329
1236,4,1,1,2412,-72,-89,17,54:e4:3a:ec:fb:64,11737514,2112,-927,11735402,11737514
1237,4,1,1,2412,-53,-89,36,,11739638,304,1820,11739334,11739638
1238,4,1,1,2412,-72,-89,17,54:e4:3a:ec:fb:64,11743980,2160,2182,11741820,11743980
1239,4,1,1,2412,-86,-89,3,,11776926,304,32642,11776622,11776926
1240,6,6,1,2412,-49,-89,40,e6:aa:ea:c9:ea:33,11816459,408,39125,11816051,11816459
1241,6,6,1,2412,-50,-89,39,e6:aa:ea:c9:ea:33,11828490,408,11623,11828082,11828490
1242,6,12,1,2412,-46,-89,43,40:e3:d6:da:ba:20,11835129,160,6479,11834969,11835129
1243,6,6,1,2412,-46,-89,43,40:e3:d6:da:ba:21,11835321,368,-176,11834953,11835321
1244,6,12,1,2412,-46,-89,43,40:e3:d6:da:ba:22,11835751,180,250,11835571,11835751
1245,6,12,1,2412,-46,-89,43,40:e3:d6:da:ba:23,11835999,184,64,11835815,11835999
1246,6,12,1,2412,-46,-89,43,40:e3:d6:da:ba:24,11836251,176,76,11836075,11836251
1247,6,12,1,2412,-46,-89,43,40:e3:d6:da:ba:25,11836453,160,42,11836293,11836453
1248,6,6,1,2412,-47,-89,42,40:e3:d6:da:ba:26,11836654,380,-179,11836274,11836654
1249,6,6,1,2412,-49,-89,40,e6:aa:ea:c9:ea:33,11840538,408,3476,11840130,11840538
1250,6,6,1,2412,-49,-89,40,e6:aa:ea:c9:ea:33,11857772,408,16826,11857364,11857772
1251,6,6,1,2412,-65,-89,24,e6:aa:ea:b7:4a:dd,11874851,408,16671,11874443,11874851
1252,6,12,1,2412,-45,-89,44,40:e3:d6:da:ba:20,11937628,160,62617,11937468,11937628
1253,6,6,1,2412,-45,-89,44,40:e3:d6:da:ba:21,11937838,368,-158,11937470,11937838
1254,6,12,1,2412,-44,-89,45,40:e3:d6:da:ba:22,11938225,180,207,11938045,11938225
1255,6,12,1,2412,-46,-89,43,40:e3:d6:da:ba:23,11938448,184,39,11938264,11938448
1256,6,12,1,2412,-46,-89,43,40:e3:d6:da:ba:24,11938685,176,61,11938509,11938685
1257,6,12,1,2412,-45,-89,44,40:e3:d6:da:ba:25,11938886,160,41,11938726,11938886
1258,6,6,1,2412,-45,-89,44,40:e3:d6:da:ba:26,11939078,380,-188,11938698,11939078
1259,4,1,1,2412,-57,-89,32,54:e4:3a:ec:fb:64,11948777,2160,7539,11946617,11948777
1260,4,1,1,2412,-84,-89,5,b8:3a:5a:88:e6:e0,11951110,2360,-27,11948750,11951110
1261,6,12,1,2412,-45,-89,44,40:e3:d6:da:ba:20,12039910,160,88640,12039750,12039910
1262,6,6,1,2412,-46,-89,43,40:e3:d6:da:ba:21,12040111,368,-167,12039743,12040111
1263,6,12,1,2412,-45,-89,44,40:e3:d6:da:ba:22,12040507,180,216,12040327,12040507
1264,6,12,1,2412,-46,-89,43,40:e3:d6:da:ba:23,12040721,184,30,12040537,12040721
1265,6,12,1,2412,-45,-89,44,40:e3:d6:da:ba:24,12040930,176,33,12040754,12040930
1266,6,12,1,2412,-45,-89,44,40:e3:d6:da:ba:25,12041175,160,85,12041015,12041175
1267,6,6,1,2412,-45,-89,44,40:e3:d6:da:ba:26,12041376,380,-179,12040996,12041376
1268,6,12,1,2412,-46,-89,43,40:e3:d6:da:ba:20,12142415,160,100879,12142255,12142415
1269,6,6,1,2412,-46,-89,43,40:e3:d6:da:ba:21,12142625,368,-158,12142257,12142625
1270,6,12,1,2412,-45,-89,44,40:e3:d6:da:ba:22,12143034,180,229,12142854,12143034
1271,6,12,1,2412,-46,-89,43,40:e3:d6:da:ba:23,12143240,184,22,12143056,12143240
1272,6,12,1,2412,-46,-89,43,40:e3:d6:da:ba:24,12143458,176,42,12143282,12143458
1273,6,12,1,2412,-46,-89,43,40:e3:d6:da:ba:25,12143678,160,60,12143518,12143678
1274,6,6,1,2412,-46,-89,43,40:e3:d6:da:ba:26,12143896,380,-162,12143516,12143896
1275,6,6,1,2412,-70,-89,19,e6:aa:ea:b7:4a:dd,12153451,408,9147,12153043,12153451
1276,4,1,1,2412,-68,-89,21,54:e4:3a:ec:fb:64,12154041,2160,-1570,12151881,12154041
1277,6,6,1,2412,-70,-89,19,e6:aa:ea:b7:4a:dd,12165568,408,11119,12165160,12165568
1278,6,6,1,2412,-81,-89,8,e6:aa:ea:c9:ea:1b,12171976,408,6000,12171568,12171976
1279,6,6,1,2412,-69,-89,20,e6:aa:ea:b7:4a:dd,12189805,408,17421,12189397,12189805
1280,4,1,1,2412,-88,-89,1,c0:c9:e3:4d:6e:bf,12225808,872,35131,12224936,12225808
1281,4,1,1,2412,-90,-89,-1,,12226698,304,586,12226394,12226698
1282,6,12,1,2412,-46,-89,43,40:e3:d6:da:ba:20,12244725,160,17867,12244565,12244725
1283,6,6,1,2412,-47,-89,42,40:e3:d6:da:ba:21,12244935,368,-158,12244567,12244935
1284,6,12,1,2412,-47,-89,42,40:e3:d6:da:ba:22,12246154,180,1039,12245974,12246154
1285,6,12,1,2412,-46,-89,43,40:e3:d6:da:ba:23,12246387,184,49,12246203,12246387
1286,6,12,1,2412,-46,-89,43,40:e3:d6:da:ba:24,12246614,176,51,12246438,12246614
1287,6,12,1,2412,-46,-89,43,40:e3:d6:da:ba:25,12246848,160,74,12246688,12246848
1288,6,6,1,2412,-47,-89,42,40:e3:d6:da:ba:26,12247077,380,-151,12246697,12247077
1289,4,1,1,2412,-69,-89,20,54:e4:3a:ec:fb:64,12255975,2160,6738,12253815,12255975
1290,4,1,1,2412,-86,-89,3,b8:3a:5a:88:e6:e0,12258491,2360,156,12256131,12258491
1291,6,6,1,2412,-47,-89,42,e6:aa:ea:c9:ea:33,12337938,408,79039,12337530,12337938
1292,6,12,1,2412,-47,-89,42,40:e3:d6:da:ba:20,12347112,160,9014,12346952,12347112
1293,6,6,1,2412,-47,-89,42,40:e3:d6:da:ba:21,12347313,368,-167,12346945,12347313
1294,6,12,1,2412,-46,-89,43,40:e3:d6:da:ba:22,12347700,180,207,12347520,12347700
1295,6,12,1,2412,-47,-89,42,40:e3:d6:da:ba:23,12347923,184,39,12347739,12347923
1296,6,12,1,2412,-47,-89,42,40:e3:d6:da:ba:24,12348160,176,61,12347984,12348160
1297,6,12,1,2412,-46,-89,43,40:e3:d6:da:ba:25,12348370,160,50,12348210,12348370
1298,6,6,1,2412,-47,-89,42,40:e3:d6:da:ba:26,12348571,380,-179,12348191,12348571
1299,6,6,1,2412,-47,-89,42,e6:aa:ea:c9:ea:33,12362139,408,13160,12361731,12362139
1300,6,6,1,2412,-47,-89,42,e6:aa:ea:c9:ea:33,12374397,408,11850,12373989,12374397
1301,6,6,1,2412,-47,-89,42,e6:aa:ea:c9:ea:33,12386363,408,11558,12385955,12386363
1302,6,12,1,2412,-47,-89,42,40:e3:d6:da:ba:20,12449520,160,62997,12449360,12449520
1303,6,12,1,2412,-48,-89,41,40:e3:d6:da:ba:23,12452825,184,3121,12452641,12452825
1304,6,12,1,2412,-47,-89,42,40:e3:d6:da:ba:25,12453308,160,323,12453148,12453308
1305,6,12,1,2412,-48,-89,41,40:e3:d6:da:ba:20,12551913,160,98445,12551753,12551913
1306,6,12,1,2412,-47,-89,42,40:e3:d6:da:ba:22,12552534,180,441,12552354,12552534
1307,6,12,1,2412,-47,-89,42,40:e3:d6:da:ba:23,12552841,184,123,12552657,12552841
1308,6,12,1,2412,-47,-89,42,40:e3:d6:da:ba:24,12553069,176,52,12552893,12553069
1309,6,12,1,2412,-47,-89,42,40:e3:d6:da:ba:25,12553297,160,68,12553137,12553297
1310,6,6,1,2412,-47,-89,42,40:e3:d6:da:ba:26,12553489,380,-188,12553109,12553489
1311,6,6,1,2412,-46,-89,43,e6:aa:ea:c9:ea:33,12653008,408,99111,12652600,12653008
1312,6,12,1,2412,-48,-89,41,40:e3:d6:da:ba:20,12654320,160,1152,12654160,12654320
1313,6,6,1,2412,-48,-89,41,40:e3:d6:da:ba:21,12654539,368,-149,12654171,12654539
1314,6,12,1,2412,-48,-89,41,40:e3:d6:da:ba:22,12654944,180,225,12654764,12654944
1315,6,12,1,2412,-48,-89,41,40:e3:d6:da:ba:23,12655194,184,66,12655010,12655194
1316,6,12,1,2412,-48,-89,41,40:e3:d6:da:ba:24,12655413,176,43,12655237,12655413
1317,6,12,1,2412,-48,-89,41,40:e3:d6:da:ba:25,12655638,160,65,12655478,12655638
1318,6,6,1,2412,-48,-89,41,40:e3:d6:da:ba:26,12655830,380,-188,12655450,12655830
1319,6,6,1,2412,-46,-89,43,e6:aa:ea:c9:ea:33,12665119,408,8881,12664711,12665119
1320,4,1,1,2412,-89,-89,0,b8:3a:5a:88:e6:e1,12670332,2376,2837,12667956,12670332
1321,6,6,1,2412,-73,-89,16,e6:aa:ea:b7:4a:dd,12672997,408,2257,12672589,12672997
1322,6,6,1,2412,-46,-89,43,e6:aa:ea:c9:ea:33,12689566,408,16161,12689158,12689566
1323,6,6,1,2412,-46,-89,43,e6:aa:ea:c9:ea:33,12701498,408,11524,12701090,12701498
1324,6,6,1,2412,-73,-89,16,e6:aa:ea:b7:4a:dd,12709357,408,7451,12708949,12709357
1325,6,6,1,2412,-74,-89,15,e6:aa:ea:b7:4a:dd,12721474,408,11709,12721066,12721474
1326,6,12,1,2412,-49,-89,40,40:e3:d6:da:ba:20,12756747,160,35113,12756587,12756747
1327,6,6,1,2412,-48,-89,41,40:e3:d6:da:ba:21,12756966,368,-149,12756598,12756966
1328,6,12,1,2412,-48,-89,41,40:e3:d6:da:ba:22,12757379,180,233,12757199,12757379
1329,6,12,1,2412,-48,-89,41,40:e3:d6:da:ba:23,12757612,184,49,12757428,12757612
1330,6,12,1,2412,-48,-89,41,40:e3:d6:da:ba:24,12757848,176,60,12757672,12757848
1331,6,12,1,2412,-48,-89,41,40:e3:d6:da:ba:25,12758050,160,42,12757890,12758050
1332,6,6,1,2412,-48,-89,41,40:e3:d6:da:ba:26,12758251,380,-179,12757871,12758251
1333,6,12,1,2412,-48,-89,41,40:e3:d6:da:ba:20,12859140,160,100729,12858980,12859140
1334,6,6,1,2412,-48,-89,41,40:e3:d6:da:ba:21,12859340,368,-168,12858972,12859340
1335,6,12,1,2412,-48,-89,41,40:e3:d6:da:ba:22,12859737,180,217,12859557,12859737
1336,6,12,1,2412,-48,-89,41,40:e3:d6:da:ba:23,12859969,184,48,12859785,12859969
1337,6,12,1,2412,-48,-89,41,40:e3:d6:da:ba:24,12860188,176,43,12860012,12860188
1338,6,12,1,2412,-48,-89,41,40:e3:d6:da:ba:25,12860407,160,59,12860247,12860407
1339,6,6,1,2412,-52,-89,37,40:e3:d6:da:ba:26,12860599,380,-188,12860219,12860599
1340,6,12,1,2412,-49,-89,40,40:e3:d6:da:ba:20,12961521,160,100762,12961361,12961521
1341,6,6,1,2412,-49,-89,40,40:e3:d6:da:ba:21,12961722,368,-167,12961354,12961722
1342,6,12,1,2412,-49,-89,40,40:e3:d6:da:ba:22,12962118,180,216,12961938,12962118
1343,6,12,1,2412,-49,-89,40,40:e3:d6:da:ba:23,12962324,184,22,12962140,12962324
1344,6,12,1,2412,-49,-89,40,40:e3:d6:da:ba:24,12962560,176,60,12962384,12962560
1345,6,12,1,2412,-49,-89,40,40:e3:d6:da:ba:25,12962761,160,41,12962601,12962761
1346,6,6,1,2412,-49,-89,40,40:e3:d6:da:ba:26,12962971,380,-170,12962591,12962971
1347,6,12,1,2412,-49,-89,40,40:e3:d6:da:ba:20,13063923,160,100792,13063763,13063923
1348,6,6,1,2412,-49,-89,40,40:e3:d6:da:ba:21,13064115,368,-176,13063747,13064115
1349,6,12,1,2412,-49,-89,40,40:e3:d6:da:ba:22,13064502,180,207,13064322,13064502
1350,6,12,1,2412,-49,-89,40,40:e3:d6:da:ba:23,13064707,184,21,13064523,13064707
1351,6,12,1,2412,-49,-89,40,40:e3:d6:da:ba:24,13064917,176,34,13064741,13064917
1352,6,12,1,2412,-49,-89,40,40:e3:d6:da:ba:25,13065118,160,41,13064958,13065118
1353,6,6,1,2412,-49,-89,40,40:e3:d6:da:ba:26,13065319,380,-179,13064939,13065319
1354,6,6,1,2412,-79,-89,10,e6:aa:ea:c9:ea:1b,13066484,408,757,13066076,13066484
1355,6,6,1,2412,-44,-89,45,e6:aa:ea:c9:ea:33,13070623,408,3731,13070215,13070623
1356,4,1,1,2412,-52,-89,37,54:e4:3a:ec:fb:64,13075169,2160,2386,13073009,13075169
1357,6,6,1,2412,-44,-89,45,e6:aa:ea:c9:ea:33,13082751,408,7174,13082343,13082751
1358,6,6,1,2412,-70,-89,19,e6:aa:ea:b7:4a:dd,13090842,408,7683,13090434,13090842
1359,6,6,1,2412,-44,-89,45,e6:aa:ea:c9:ea:33,13094871,408,3621,13094463,13094871
1360,6,6,1,2412,-70,-89,19,e6:aa:ea:b7:4a:dd,13102952,408,7673,13102544,13102952
1361,6,6,1,2412,-44,-89,45,e6:aa:ea:c9:ea:33,13120768,408,17408,13120360,13120768
1362,6,6,1,2412,-71,-89,18,e6:aa:ea:b7:4a:dd,13127217,408,6041,13126809,13127217
1363,6,12,1,2412,-49,-89,40,40:e3:d6:da:ba:20,13167646,160,40269,13167486,13167646
1364,6,6,1,2412,-49,-89,40,40:e3:d6:da:ba:21,13167847,368,-167,13167479,13167847
1365,6,12,1,2412,-49,-89,40,40:e3:d6:da:ba:22,13168252,180,225,13168072,13168252
1366,6,12,1,2412,-49,-89,40,40:e3:d6:da:ba:23,13168458,184,22,13168274,13168458
1367,6,12,1,2412,-49,-89,40,40:e3:d6:da:ba:24,13168667,176,33,13168491,13168667
1368,6,12,1,2412,-49,-89,40,40:e3:d6:da:ba:25,13168887,160,60,13168727,13168887
1369,6,6,1,2412,-49,-89,40,40:e3:d6:da:ba:26,13169079,380,-188,13168699,13169079
1370,4,1,1,2412,-74,-89,15,54:e4:3a:ec:fb:64,13177743,2160,6504,13175583,13177743
1371,4,1,1,2412,-88,-89,1,b8:3a:5a:88:e6:e0,13180003,2360,-100,13177643,13180003
1372,4,1,1,2412,-88,-89,1,a6:e5:7c:28:b1:d3,13242391,992,61396,13241399,13242391
1373,6,12,1,2412,-50,-89,39,40:e3:d6:da:ba:20,13268741,160,26190,13268581,13268741
1374,6,6,1,2412,-49,-89,40,40:e3:d6:da:ba:21,13268968,368,-141,13268600,13268968
1375,6,12,1,2412,-48,-89,41,40:e3:d6:da:ba:22,13269364,180,216,13269184,13269364
1376,6,12,1,2412,-49,-89,40,40:e3:d6:da:ba:23,13269569,184,21,13269385,13269569
1377,6,12,1,2412,-49,-89,40,40:e3:d6:da:ba:24,13269788,176,43,13269612,13269788
1378,6,12,1,2412,-49,-89,40,40:e3:d6:da:ba:25,13270008,160,60,13269848,13270008
1379,6,6,1,2412,-49,-89,40,40:e3:d6:da:ba:26,13270200,380,-188,13269820,13270200
1380,4,1,1,2412,-73,-89,16,54:e4:3a:ec:fb:64,13279966,2160,7606,13277806,13279966
1381,6,6,1,2412,-85,-89,4,34:f6:4b:95:fe:d4,13321783,124,41693,13321659,13321783
1382,6,6,1,2412,-49,-89,40,40:e3:d6:da:ba:21,13371316,368,49165,13370948,13371316
1383,6,12,1,2412,-49,-89,40,40:e3:d6:da:ba:23,13371936,184,436,13371752,13371936
1384,6,12,1,2412,-49,-89,40,40:e3:d6:da:ba:24,13372413,176,301,13372237,13372413
1385,6,12,1,2412,-49,-89,40,40:e3:d6:da:ba:25,13372615,160,42,13372455,13372615
1386,6,6,1,2412,-49,-89,40,40:e3:d6:da:ba:26,13372816,380,-179,13372436,13372816
1387,4,1,1,2412,-72,-89,17,54:e4:3a:ec:fb:64,13382366,2160,7390,13380206,13382366
1388,6,6,1,2412,-45,-89,44,e6:aa:ea:c9:ea:33,13385516,408,2742,13385108,13385516
1389,6,6,1,2412,-45,-89,44,e6:aa:ea:c9:ea:33,13397643,408,11719,13397235,13397643
1390,6,6,1,2412,-45,-89,44,e6:aa:ea:c9:ea:33,13434026,408,35975,13433618,13434026
1391,6,12,1,2412,-49,-89,40,40:e3:d6:da:ba:23,13474442,184,40232,13474258,13474442
1392,6,12,1,2412,-49,-89,40,40:e3:d6:da:ba:25,13474894,160,292,13474734,13474894
1393,6,6,1,2412,-49,-89,40,40:e3:d6:da:ba:26,13475095,380,-179,13474715,13475095
1394,4,1,1,2412,-72,-89,17,54:e4:3a:ec:fb:64,13484765,2160,7510,13482605,13484765
1395,6,12,1,2412,-49,-89,40,40:e3:d6:da:ba:20,13575919,160,90994,13575759,13575919
1396,6,6,1,2412,-49,-89,40,40:e3:d6:da:ba:21,13576111,368,-176,13575743,13576111
1397,6,12,1,2412,-49,-89,40,40:e3:d6:da:ba:22,13576498,180,207,13576318,13576498
1398,6,12,1,2412,-49,-89,40,40:e3:d6:da:ba:23,13576704,184,22,13576520,13576704
1399,6,12,1,2412,-49,-89,40,40:e3:d6:da:ba:24,13576931,176,51,13576755,13576931
1400,6,12,1,2412,-49,-89,40,40:e3:d6:da:ba:25,13577150,160,59,13576990,13577150
1401,6,6,1,2412,-49,-89,40,40:e3:d6:da:ba:26,13577342,380,-188,13576962,13577342
1402,4,1,1,2412,-70,-89,19,54:e4:3a:ec:fb:64,13587222,2160,7720,13585062,13587222
1403,6,6,1,2412,-68,-89,21,e6:aa:ea:b7:4a:dd,13610657,408,23027,13610249,13610657
1404,6,6,1,2412,-68,-89,21,e6:aa:ea:b7:4a:dd,13634891,408,23826,13634483,13634891
1405,6,6,1,2412,-65,-89,24,e6:aa:ea:b7:4a:dd,13647008,408,11709,13646600,13647008
1406,6,6,1,2412,-68,-89,21,e6:aa:ea:b7:4a:dd,13659124,408,11708,13658716,13659124
1407,6,12,1,2412,-50,-89,39,40:e3:d6:da:ba:20,13678330,160,19046,13678170,13678330
1408,6,6,1,2412,-50,-89,39,40:e3:d6:da:ba:21,13678522,368,-176,13678154,13678522
1409,6,12,1,2412,-50,-89,39,40:e3:d6:da:ba:22,13678952,180,250,13678772,13678952
1410,6,12,1,2412,-49,-89,40,40:e3:d6:da:ba:23,13679184,184,48,13679000,13679184
1411,6,12,1,2412,-49,-89,40,40:e3:d6:da:ba:24,13679427,176,67,13679251,13679427
1412,6,12,1,2412,-50,-89,39,40:e3:d6:da:ba:25,13679628,160,41,13679468,13679628
1413,6,6,1,2412,-50,-89,39,40:e3:d6:da:ba:26,13679838,380,-170,13679458,13679838
1414,4,1,1,2412,-86,-89,3,,13701734,304,21592,13701430,13701734
1415,6,6,1,2412,-59,-89,30,40:e3:d6:da:ba:21,13780944,368,78842,13780576,13780944
1416,6,12,1,2412,-54,-89,35,40:e3:d6:da:ba:22,13781365,180,241,13781185,13781365
1417,6,12,1,2412,-58,-89,31,40:e3:d6:da:ba:25,13782074,160,549,13781914,13782074
1418,6,6,1,2412,-51,-89,38,40:e3:d6:da:ba:26,13782281,380,-173,13781901,13782281
1419,6,12,1,2412,-51,-89,38,40:e3:d6:da:ba:20,13883128,160,100687,13882968,13883128
1420,6,6,1,2412,-50,-89,39,40:e3:d6:da:ba:21,13883347,368,-149,13882979,13883347
1421,6,12,1,2412,-50,-89,39,40:e3:d6:da:ba:22,13883761,180,234,13883581,13883761
1422,6,12,1,2412,-51,-89,38,40:e3:d6:da:ba:23,13883993,184,48,13883809,13883993
1423,6,12,1,2412,-50,-89,39,40:e3:d6:da:ba:24,13884221,176,52,13884045,13884221
1424,6,12,1,2412,-50,-89,39,40:e3:d6:da:ba:25,13884422,160,41,13884262,13884422
1425,6,6,1,2412,-50,-89,39,40:e3:d6:da:ba:26,13884641,380,-161,13884261,13884641
1426,4,1,1,2412,-57,-89,32,54:e4:3a:ec:fb:64,13894361,2160,7560,13892201,13894361
1427,6,6,1,2412,-48,-89,41,e6:aa:ea:c9:ea:33,13905121,408,10352,13904713,13905121
1428,6,6,1,2412,-48,-89,41,e6:aa:ea:c9:ea:33,13917188,408,11659,13916780,13917188
1429,6,6,1,2412,-48,-89,41,e6:aa:ea:c9:ea:33,13929315,408,11719,13928907,13929315
1430,6,6,1,2412,-48,-89,41,e6:aa:ea:c9:ea:33,13941414,408,11691,13941006,13941414
1431,6,12,1,2412,-51,-89,38,40:e3:d6:da:ba:20,13985520,160,43946,13985360,13985520
1432,6,6,1,2412,-51,-89,38,40:e3:d6:da:ba:21,13985739,368,-149,13985371,13985739
1433,6,12,1,2412,-51,-89,38,40:e3:d6:da:ba:22,13986153,180,234,13985973,13986153
1434,6,12,1,2412,-51,-89,38,40:e3:d6:da:ba:23,13986367,184,30,13986183,13986367
1435,6,12,1,2412,-51,-89,38,40:e3:d6:da:ba:24,13986577,176,34,13986401,13986577
1436,6,12,1,2412,-51,-89,38,40:e3:d6:da:ba:25,13986778,160,41,13986618,13986778
1437,6,6,1,2412,-51,-89,38,40:e3:d6:da:ba:26,13986988,380,-170,13986608,13986988
1438,4,1,1,2412,-71,-89,18,54:e4:3a:ec:fb:64,13996760,2160,7612,13994600,13996760
1439,4,1,1,2412,-66,-89,23,b8:3a:5a:88:e6:e0,13998943,2360,-177,13996583,13998943
1440,6,6,1,2412,-84,-89,5,e6:aa:ea:c9:ea:1b,14018894,408,19543,14018486,14018894
1441,6,6,1,2412,-45,-89,44,,14035193,44,16255,14035149,14035193
1442,4,1,1,2412,-57,-89,32,54:e4:3a:ec:fb:64,14058358,2112,21053,14056246,14058358
1443,4,1,1,2412,-84,-89,5,,14060487,304,1825,14060183,14060487
1444,6,6,1,2412,-44,-89,45,,14085193,44,24662,14085149,14085193
1445,6,12,1,2412,-51,-89,38,40:e3:d6:da:ba:20,14089070,160,3717,14088910,14089070
1446,6,6,1,2412,-51,-89,38,40:e3:d6:da:ba:21,14089262,368,-176,14088894,14089262
1447,6,12,1,2412,-51,-89,38,40:e3:d6:da:ba:22,14089676,180,234,14089496,14089676
1448,6,12,1,2412,-51,-89,38,40:e3:d6:da:ba:23,14089900,184,40,14089716,14089900
1449,6,12,1,2412,-51,-89,38,40:e3:d6:da:ba:24,14090136,176,60,14089960,14090136
1450,6,12,1,2412,-51,-89,38,40:e3:d6:da:ba:25,14090364,160,68,14090204,14090364
1451,6,6,1,2412,-51,-89,38,40:e3:d6:da:ba:26,14090574,380,-170,14090194,14090574
1452,6,6,1,2412,-45,-89,44,,14110194,44,19576,14110150,14110194
1453,6,6,1,2412,-65,-89,24,e6:aa:ea:b7:4a:dd,14130729,408,20127,14130321,14130729
1454,6,6,1,2412,-65,-89,24,e6:aa:ea:b7:4a:dd,14179376,408,48239,14178968,14179376
1455,6,12,1,2412,-80,-89,9,,14189830,32,10422,14189798,14189830
1456,6,24,1,2412,-79,-89,10,22:a3:7f:87:e5:4e,14190150,32,288,14190118,14190150
1457,6,12,1,2412,-51,-89,38,,14190199,32,17,14190167,14190199
1458,6,12,1,2412,-51,-89,38,40:e3:d6:da:ba:20,14190329,160,-30,14190169,14190329
1459,6,6,1,2412,-51,-89,38,40:e3:d6:da:ba:21,14190680,368,-17,14190312,14190680
1460,6,12,1,2412,-51,-89,38,40:e3:d6:da:ba:22,14191109,180,249,14190929,14191109
1461,6,12,1,2412,-51,-89,38,40:e3:d6:da:ba:23,14191473,184,180,14191289,14191473
1462,6,12,1,2412,-51,-89,38,40:e3:d6:da:ba:24,14191682,176,33,14191506,14191682
1463,6,6,1,2412,-51,-89,38,40:e3:d6:da:ba:26,14192179,380,117,14191799,14192179
1464,6,24,1,2412,-80,-89,9,22:a3:7f:87:e5:4e,14200486,32,8275,14200454,14200486
1465,6,12,1,2412,-51,-89,38,,14200535,32,17,14200503,14200535
1466,6,24,1,2412,-80,-89,9,22:a3:7f:87:e5:4e,14207822,32,7255,14207790,14207822
1467,6,12,1,2412,-51,-89,38,,14207871,32,17,14207839,14207871
1468,4,1,1,2412,-70,-89,19,54:e4:3a:ec:fb:64,14212920,2112,2937,14210808,14212920
1469,6,6,1,2412,-46,-89,43,e6:aa:ea:c9:ea:33,14220654,408,7326,14220246,14220654
1470,6,6,1,2412,-46,-89,43,e6:aa:ea:c9:ea:33,14232281,408,11219,14231873,14232281
1471,6,6,1,2412,-46,-89,43,e6:aa:ea:c9:ea:33,14244246,408,11557,14243838,14244246
1472,6,6,1,2412,-46,-89,43,e6:aa:ea:c9:ea:33,14256361,408,11707,14255953,14256361
1473,6,6,1,2412,-46,-89,43,e6:aa:ea:c9:ea:33,14268490,408,11721,14268082,14268490
1474,6,12,1,2412,-49,-89,40,40:e3:d6:da:ba:20,14292721,160,24071,14292561,14292721
1475,6,6,1,2412,-49,-89,40,40:e3:d6:da:ba:21,14292913,368,-176,14292545,14292913
1476,6,12,1,2412,-49,-89,40,40:e3:d6:da:ba:22,14293318,180,225,14293138,14293318
1477,6,12,1,2412,-49,-89,40,40:e3:d6:da:ba:23,14293550,184,48,14293366,14293550
1478,6,12,1,2412,-49,-89,40,40:e3:d6:da:ba:24,14293777,176,51,14293601,14293777
1479,6,12,1,2412,-49,-89,40,40:e3:d6:da:ba:25,14294053,160,116,14293893,14294053
1480,6,6,1,2412,-49,-89,40,40:e3:d6:da:ba:26,14294263,380,-170,14293883,14294263
1481,6,12,1,2412,-49,-89,40,,14294747,32,452,14294715,14294747
1482,4,1,1,2412,-72,-89,17,54:e4:3a:ec:fb:64,14303957,2160,7050,14301797,14303957
1483,6,12,1,2412,-80,-89,9,22:a3:7f:87:e5:4e,14325447,44,21446,14325403,14325447
1484,6,12,1,2412,-48,-89,41,,14325508,32,29,14325476,14325508
1485,6,6,1,2412,-49,-89,40,40:e3:d6:da:ba:26,14396682,380,70794,14396302,14396682
1486,4,1,1,2412,-71,-89,18,54:e4:3a:ec:fb:64,14406358,2160,7516,14404198,14406358
1487,4,1,1,2412,-87,-89,2,b8:3a:5a:88:e6:e0,14408550,2360,-168,14406190,14408550
1488,6,12,1,2412,-47,-89,42,40:e3:d6:da:ba:20,14497522,160,88812,14497362,14497522
1489,6,6,1,2412,-47,-89,42,40:e3:d6:da:ba:21,14497732,368,-158,14497364,14497732
1490,6,12,1,2412,-47,-89,42,40:e3:d6:da:ba:22,14498128,180,216,14497948,14498128
1491,6,12,1,2412,-47,-89,42,40:e3:d6:da:ba:23,14498333,184,21,14498149,14498333
1492,6,12,1,2412,-47,-89,42,40:e3:d6:da:ba:24,14498552,176,43,14498376,14498552
1493,6,12,1,2412,-47,-89,42,40:e3:d6:da:ba:25,14498780,160,68,14498620,14498780
1494,6,6,1,2412,-46,-89,43,40:e3:d6:da:ba:26,14498994,380,-166,14498614,14498994
1495,6,6,1,2412,-85,-89,4,e6:aa:ea:c9:ea:1b,14564994,408,65592,14564586,14564994
1496,6,12,1,2412,-48,-89,41,40:e3:d6:da:ba:20,14599922,160,34768,14599762,14599922
1497,6,6,1,2412,-48,-89,41,40:e3:d6:da:ba:21,14600132,368,-158,14599764,14600132
1498,6,12,1,2412,-48,-89,41,40:e3:d6:da:ba:22,14600546,180,234,14600366,14600546
1499,6,12,1,2412,-48,-89,41,40:e3:d6:da:ba:23,14600751,184,21,14600567,14600751
1500,6,12,1,2412,-48,-89,41,40:e3:d6:da:ba:24,14600978,176,51,14600802,14600978
1501,6,12,1,2412,-48,-89,41,40:e3:d6:da:ba:25,14601180,160,42,14601020,14601180
1502,6,6,1,2412,-48,-89,41,40:e3:d6:da:ba:26,14601390,380,-170,14601010,14601390
1503,6,6,1,2412,-69,-89,20,e6:aa:ea:b7:4a:dd,14674836,408,73038,14674428,14674836
1504,4,1,1,2412,-92,-89,-3,c0:c9:e3:4d:6e:bf,14692729,872,17021,14691857,14692729
1505,6,6,1,2412,-68,-89,21,e6:aa:ea:b7:4a:dd,14699069,408,5932,14698661,14699069
1506,6,12,1,2412,-48,-89,41,40:e3:d6:da:ba:20,14702323,160,3094,14702163,14702323
1507,6,6,1,2412,-49,-89,40,40:e3:d6:da:ba:21,14702514,368,-177,14702146,14702514
1508,6,12,1,2412,-50,-89,39,40:e3:d6:da:ba:22,14702901,180,207,14702721,14702901
1509,6,12,1,2412,-50,-89,39,40:e3:d6:da:ba:23,14703107,184,22,14702923,14703107
1510,6,12,1,2412,-49,-89,40,40:e3:d6:da:ba:24,14703334,176,51,14703158,14703334
1511,6,12,1,2412,-49,-89,40,40:e3:d6:da:ba:25,14703536,160,42,14703376,14703536
1512,6,6,1,2412,-49,-89,40,40:e3:d6:da:ba:26,14703745,380,-171,14703365,14703745
1513,4,1,1,2412,-70,-89,19,54:e4:3a:ec:fb:64,14713555,2160,7650,14711395,14713555
1514,6,6,1,2412,-44,-89,45,e6:aa:ea:c9:ea:33,14751667,408,37704,14751259,14751667
1515,6,6,1,2412,-44,-89,45,e6:aa:ea:c9:ea:33,14763796,408,11721,14763388,14763796
1516,6,6,1,2412,-44,-89,45,e6:aa:ea:c9:ea:33,14775920,408,11716,14775512,14775920
1517,6,6,1,2412,-44,-89,45,e6:aa:ea:c9:ea:33,14790903,408,14575,14790495,14790903
1518,6,12,1,2412,-52,-89,37,40:e3:d6:da:ba:20,14804723,160,13660,14804563,14804723
1519,6,6,1,2412,-52,-89,37,40:e3:d6:da:ba:21,14804915,368,-176,14804547,14804915
1520,6,12,1,2412,-52,-89,37,40:e3:d6:da:ba:22,14805310,180,215,14805130,14805310
1521,6,12,1,2412,-52,-89,37,40:e3:d6:da:ba:23,14805525,184,31,14805341,14805525
1522,6,12,1,2412,-52,-89,37,40:e3:d6:da:ba:24,14805762,176,61,14805586,14805762
1523,6,12,1,2412,-52,-89,37,40:e3:d6:da:ba:25,14805990,160,68,14805830,14805990
1524,6,6,1,2412,-51,-89,38,40:e3:d6:da:ba:26,14806191,380,-179,14805811,14806191
1525,4,1,1,2412,-68,-89,21,54:e4:3a:ec:fb:64,14815954,2160,7603,14813794,14815954
1526,6,12,1,2412,-49,-89,40,40:e3:d6:da:ba:23,14909424,184,93286,14909240,14909424
1527,6,12,1,2412,-49,-89,40,40:e3:d6:da:ba:24,14909643,176,43,14909467,14909643
1528,6,12,1,2412,-49,-89,40,40:e3:d6:da:ba:25,14909844,160,41,14909684,14909844
1529,6,6,1,2412,-49,-89,40,40:e3:d6:da:ba:26,14910063,380,-161,14909683,14910063
1530,6,6,1,2412,-82,-89,7,e6:aa:ea:c9:ea:1b,14949376,408,38905,14948968,14949376
1531,6,6,1,2412,-83,-89,6,e6:aa:ea:c9:ea:1b,14961498,408,11714,14961090,14961498
1532,6,6,1,2412,-82,-89,7,e6:aa:ea:c9:ea:1b,14985716,408,23810,14985308,14985716
1533,6,12,1,2412,-48,-89,41,40:e3:d6:da:ba:20,15009524,160,23648,15009364,15009524
1534,6,12,1,2412,-48,-89,41,40:e3:d6:da:ba:23,15010399,184,691,15010215,15010399
1535,6,12,1,2412,-48,-89,41,40:e3:d6:da:ba:24,15010635,176,60,15010459,15010635
1536,6,12,1,2412,-48,-89,41,40:e3:d6:da:ba:25,15010864,160,69,15010704,15010864
1537,6,6,1,2412,-48,-89,41,40:e3:d6:da:ba:26,15011056,380,-188,15010676,15011056
1538,4,1,1,2412,-88,-89,1,b8:3a:5a:88:e6:e0,15023268,2360,9852,15020908,15023268
1539,4,1,1,2412,-71,-89,18,b8:3a:5a:88:e6:e1,15025666,2376,22,15023290,15025666
1540,6,12,1,2412,-48,-89,41,40:e3:d6:da:ba:20,15114005,160,88179,15113845,15114005
1541,6,6,1,2412,-48,-89,41,40:e3:d6:da:ba:21,15114197,368,-176,15113829,15114197
1542,6,12,1,2412,-48,-89,41,40:e3:d6:da:ba:22,15114584,180,207,15114404,15114584
1543,6,12,1,2412,-48,-89,41,40:e3:d6:da:ba:23,15114805,184,37,15114621,15114805
1544,6,12,1,2412,-48,-89,41,40:e3:d6:da:ba:24,15115032,176,51,15114856,15115032
1545,6,12,1,2412,-48,-89,41,40:e3:d6:da:ba:25,15115252,160,60,15115092,15115252
1546,6,6,1,2412,-48,-89,41,40:e3:d6:da:ba:26,15115471,380,-161,15115091,15115471
1547,4,1,1,2412,-71,-89,18,54:e4:3a:ec:fb:64,15123152,2160,5521,15120992,15123152
1548,6,6,1,2412,-68,-89,21,e6:aa:ea:b7:4a:dd,15171364,408,47804,15170956,15171364
1549,4,1,1,2412,-88,-89,1,c0:c9:e3:4d:6e:bf,15185810,872,13574,15184938,15185810
1550,6,6,1,2412,-68,-89,21,e6:aa:ea:b7:4a:dd,15195597,408,9379,15195189,15195597
1551,6,12,1,2412,-49,-89,40,40:e3:d6:da:ba:20,15214334,160,18577,15214174,15214334
1552,6,6,1,2412,-49,-89,40,40:e3:d6:da:ba:21,15214553,368,-149,15214185,15214553
1553,6,12,1,2412,-49,-89,40,40:e3:d6:da:ba:22,15214940,180,207,15214760,15214940
1554,6,12,1,2412,-49,-89,40,40:e3:d6:da:ba:23,15215163,184,39,15214979,15215163
1555,6,12,1,2412,-49,-89,40,40:e3:d6:da:ba:24,15215373,176,34,15215197,15215373
1556,6,12,1,2412,-49,-89,40,40:e3:d6:da:ba:25,15215583,160,50,15215423,15215583
1557,6,6,1,2412,-49,-89,40,40:e3:d6:da:ba:26,15215784,380,-179,15215404,15215784
1558,6,6,1,2412,-68,-89,21,e6:aa:ea:b7:4a:dd,15219819,408,3627,15219411,15219819
1559,6,6,1,2412,-54,-89,35,e6:aa:ea:c9:ea:33,15259149,408,38922,15258741,15259149
1560,6,6,1,2412,-54,-89,35,e6:aa:ea:c9:ea:33,15273730,408,14173,15273322,15273730
1561,6,6,1,2412,-86,-89,3,e6:aa:ea:c9:ea:1b,15279652,408,5514,15279244,15279652
1562,6,6,1,2412,-55,-89,34,e6:aa:ea:c9:ea:33,15283468,408,3408,15283060,15283468
1563,6,6,1,2412,-55,-89,34,e6:aa:ea:c9:ea:33,15295644,408,11768,15295236,15295644
1564,6,6,1,2412,-55,-89,34,e6:aa:ea:c9:ea:33,15307620,408,11568,15307212,15307620
1565,6,6,1,2412,-84,-89,5,e6:aa:ea:c9:ea:1b,15315992,408,7964,15315584,15315992
1566,6,12,1,2412,-48,-89,41,40:e3:d6:da:ba:20,15316741,160,589,15316581,15316741
1567,6,6,1,2412,-48,-89,41,40:e3:d6:da:ba:21,15316951,368,-158,15316583,15316951
1568,6,12,1,2412,-48,-89,41,40:e3:d6:da:ba:22,15317365,180,234,15317185,15317365
1569,6,12,1,2412,-48,-89,41,40:e3:d6:da:ba:23,15317580,184,31,15317396,15317580
1570,6,12,1,2412,-48,-89,41,40:e3:d6:da:ba:24,15317807,176,51,15317631,15317807
1571,6,12,1,2412,-48,-89,41,40:e3:d6:da:ba:25,15318027,160,60,15317867,15318027
1572,6,6,1,2412,-48,-89,41,40:e3:d6:da:ba:26,15318246,380,-161,15317866,15318246
1573,4,1,1,2412,-87,-89,2,a4:e5:7c:28:b1:d3,15372784,688,53850,15372096,15372784
1574,6,12,1,2412,-47,-89,42,40:e3:d6:da:ba:20,15419126,160,46182,15418966,15419126
1575,6,6,1,2412,-47,-89,42,40:e3:d6:da:ba:21,15419345,368,-149,15418977,15419345
1576,6,12,1,2412,-47,-89,42,40:e3:d6:da:ba:22,15419732,180,207,15419552,15419732
1577,6,12,1,2412,-47,-89,42,40:e3:d6:da:ba:23,15419955,184,39,15419771,15419955
1578,6,12,1,2412,-47,-89,42,40:e3:d6:da:ba:24,15420174,176,43,15419998,15420174
1579,6,12,1,2412,-47,-89,42,40:e3:d6:da:ba:25,15420402,160,68,15420242,15420402
1580,6,6,1,2412,-48,-89,41,40:e3:d6:da:ba:26,15420603,380,-179,15420223,15420603
1581,4,1,1,2412,-74,-89,15,54:e4:3a:ec:fb:64,15430349,2160,7586,15428189,15430349
1582,4,1,1,2412,-84,-89,5,a4:e5:7c:28:b1:d3,15464333,688,33296,15463645,15464333
1583,6,12,1,2412,-47,-89,42,40:e3:d6:da:ba:20,15521527,160,57034,15521367,15521527
1584,6,6,1,2412,-47,-89,42,40:e3:d6:da:ba:21,15521719,368,-176,15521351,15521719
1585,6,12,1,2412,-47,-89,42,40:e3:d6:da:ba:22,15522124,180,225,15521944,15522124
1586,6,12,1,2412,-47,-89,42,40:e3:d6:da:ba:23,15522356,184,48,15522172,15522356
1587,6,12,1,2412,-47,-89,42,40:e3:d6:da:ba:24,15522575,176,43,15522399,15522575
1588,6,12,1,2412,-47,-89,42,40:e3:d6:da:ba:25,15522803,160,68,15522643,15522803
1589,6,6,1,2412,-47,-89,42,40:e3:d6:da:ba:26,15522995,380,-188,15522615,15522995
1590,4,1,1,2412,-72,-89,17,54:e4:3a:ec:fb:64,15532747,2160,7592,15530587,15532747
1591,6,6,1,2412,-83,-89,6,e6:aa:ea:c9:ea:1b,15585851,408,52696,15585443,15585851
1592,6,6,1,2412,-84,-89,5,e6:aa:ea:c9:ea:1b,15597984,408,11725,15597576,15597984
1593,6,6,1,2412,-70,-89,19,e6:aa:ea:b7:4a:dd,15613748,408,15356,15613340,15613748
1594,6,6,1,2412,-85,-89,4,e6:aa:ea:c9:ea:1b,15622197,408,8041,15621789,15622197
1595,6,12,1,2412,-47,-89,42,40:e3:d6:da:ba:20,15623943,160,1586,15623783,15623943
1596,6,6,1,2412,-47,-89,42,40:e3:d6:da:ba:21,15624162,368,-149,15623794,15624162
1597,6,12,1,2412,-46,-89,43,40:e3:d6:da:ba:22,15624583,180,241,15624403,15624583
1598,6,12,1,2412,-47,-89,42,40:e3:d6:da:ba:23,15624806,184,39,15624622,15624806
1599,6,12,1,2412,-47,-89,42,40:e3:d6:da:ba:24,15625024,176,42,15624848,15625024
1600,6,12,1,2412,-47,-89,42,40:e3:d6:da:ba:25,15625235,160,51,15625075,15625235
1601,6,6,1,2412,-47,-89,42,40:e3:d6:da:ba:26,15625436,380,-179,15625056,15625436
1602,6,6,1,2412,-84,-89,5,e6:aa:ea:c9:ea:1b,15634320,408,8476,15633912,15634320
1603,4,1,1,2412,-70,-89,19,54:e4:3a:ec:fb:64,15635146,2160,-1334,15632986,15635146
1604,6,6,1,2412,-55,-89,34,e6:aa:ea:c9:ea:33,15676235,408,40681,15675827,15676235
1605,6,6,1,2412,-55,-89,34,e6:aa:ea:c9:ea:33,15700463,408,23820,15700055,15700463
1606,6,6,1,2412,-56,-89,33,e6:aa:ea:c9:ea:33,15712585,408,11714,15712177,15712585
1607,6,6,1,2412,-56,-89,33,e6:aa:ea:c9:ea:33,15724859,408,11866,15724451,15724859
1608,6,12,1,2412,-46,-89,43,40:e3:d6:da:ba:20,15726417,160,1398,15726257,15726417
1609,6,6,1,2412,-47,-89,42,40:e3:d6:da:ba:21,15729142,368,2357,15728774,15729142
1610,6,12,1,2412,-47,-89,42,40:e3:d6:da:ba:22,15729545,180,223,15729365,15729545
1611,6,12,1,2412,-46,-89,43,40:e3:d6:da:ba:23,15729759,184,30,15729575,15729759
1612,6,12,1,2412,-46,-89,43,40:e3:d6:da:ba:24,15729968,176,33,15729792,15729968
1613,6,12,1,2412,-46,-89,43,40:e3:d6:da:ba:25,15730179,160,51,15730019,15730179
1614,6,6,1,2412,-46,-89,43,40:e3:d6:da:ba:26,15730371,380,-188,15729991,15730371
1615,4,1,1,2412,-68,-89,21,54:e4:3a:ec:fb:64,15737546,2160,5015,15735386,15737546
1616,4,1,1,2412,-73,-89,16,b8:3a:5a:88:e6:e0,15739748,2360,-158,15737388,15739748
1617,4,1,1,2412,-88,-89,1,b8:3a:5a:88:e6:e1,15742155,2376,31,15739779,15742155
1618,6,12,1,2412,-46,-89,43,40:e3:d6:da:ba:20,15828741,160,86426,15828581,15828741
1619,6,6,1,2412,-47,-89,42,40:e3:d6:da:ba:21,15828975,368,-134,15828607,15828975
1620,6,12,1,2412,-46,-89,43,40:e3:d6:da:ba:22,15829380,180,225,15829200,15829380
1621,6,12,1,2412,-46,-89,43,40:e3:d6:da:ba:23,15829586,184,22,15829402,15829586
1622,6,12,1,2412,-46,-89,43,40:e3:d6:da:ba:24,15829813,176,51,15829637,15829813
1623,6,12,1,2412,-46,-89,43,40:e3:d6:da:ba:25,15830033,160,60,15829873,15830033
1624,6,6,1,2412,-46,-89,43,40:e3:d6:da:ba:26,15830243,380,-170,15829863,15830243
1625,4,1,1,2412,-67,-89,22,54:e4:3a:ec:fb:64,15839945,2160,7542,15837785,15839945
1626,4,1,1,2412,-86,-89,3,a6:e5:7c:28:b1:d3,15905113,992,64176,15904121,15905113
1627,6,6,1,2412,-85,-89,4,e6:aa:ea:c9:ea:1b,15914573,408,9052,15914165,15914573
1628,6,12,1,2412,-45,-89,44,40:e3:d6:da:ba:20,15931149,160,16416,15930989,15931149
1629,6,6,1,2412,-45,-89,44,40:e3:d6:da:ba:21,15931368,368,-149,15931000,15931368
1630,6,12,1,2412,-45,-89,44,40:e3:d6:da:ba:22,15931755,180,207,15931575,15931755
1631,6,12,1,2412,-45,-89,44,40:e3:d6:da:ba:23,15931970,184,31,15931786,15931970
1632,6,12,1,2412,-45,-89,44,40:e3:d6:da:ba:24,15932206,176,60,15932030,15932206
1633,6,12,1,2412,-45,-89,44,40:e3:d6:da:ba:25,15933568,160,1202,15933408,15933568
1634,6,6,1,2412,-82,-89,7,e6:aa:ea:c9:ea:1b,15938806,408,4830,15938398,15938806
1635,4,1,1,2412,-70,-89,19,54:e4:3a:ec:fb:64,15942344,2160,1378,15940184,15942344
1636,6,12,1,2412,-46,-89,43,40:e3:d6:da:ba:20,16033550,160,91046,16033390,16033550
1637,6,6,1,2412,-46,-89,43,40:e3:d6:da:ba:21,16033751,368,-167,16033383,16033751
1638,6,12,1,2412,-46,-89,43,40:e3:d6:da:ba:22,16034165,180,234,16033985,16034165
1639,6,12,1,2412,-46,-89,43,40:e3:d6:da:ba:23,16034387,184,38,16034203,16034387
1640,4,1,1,2412,-69,-89,20,54:e4:3a:ec:fb:64,16044744,2160,8197,16042584,16044744
1641,4,1,1,2412,-85,-89,4,b8:3a:5a:88:e6:e0,16046945,2360,-159,16044585,16046945
1642,6,6,1,2412,-71,-89,18,e6:aa:ea:b7:4a:dd,16109192,408,61839,16108784,16109192
1643,6,6,1,2412,-72,-89,17,e6:aa:ea:b7:4a:dd,16121307,408,11707,16120899,16121307
1644,6,6,1,2412,-73,-89,16,e6:aa:ea:b7:4a:dd,16133432,408,11717,16133024,16133432
1645,6,12,1,2412,-46,-89,43,40:e3:d6:da:ba:20,16135938,160,2346,16135778,16135938
1646,6,6,1,2412,-46,-89,43,40:e3:d6:da:ba:21,16136130,368,-176,16135762,16136130
1647,6,12,1,2412,-46,-89,43,40:e3:d6:da:ba:22,16136517,180,207,16136337,16136517
1648,6,12,1,2412,-46,-89,43,40:e3:d6:da:ba:23,16136732,184,31,16136548,16136732
1649,6,12,1,2412,-46,-89,43,40:e3:d6:da:ba:24,16136968,176,60,16136792,16136968
1650,6,12,1,2412,-46,-89,43,40:e3:d6:da:ba:25,16137179,160,51,16137019,16137179
1651,6,6,1,2412,-45,-89,44,40:e3:d6:da:ba:26,16137389,380,-170,16137009,16137389
1652,6,6,1,2412,-73,-89,16,e6:aa:ea:b7:4a:dd,16145543,408,7746,16145135,16145543
1653,4,1,1,2412,-68,-89,21,54:e4:3a:ec:fb:64,16147285,2160,-418,16145125,16147285
1654,4,1,1,2412,-87,-89,2,c0:c9:e3:4d:6e:bf,16173297,872,25140,16172425,16173297
1655,4,1,1,2412,-66,-89,23,,16174185,304,584,16173881,16174185
1656,6,6,1,2412,-49,-89,40,e6:aa:ea:c9:ea:33,16196559,408,21966,16196151,16196559
1657,6,6,1,2412,-48,-89,41,e6:aa:ea:c9:ea:33,16208689,408,11722,16208281,16208689
1658,6,6,1,2412,-48,-89,41,e6:aa:ea:c9:ea:33,16220861,408,11764,16220453,16220861
1659,6,6,1,2412,-48,-89,41,e6:aa:ea:c9:ea:33,16232923,408,11654,16232515,16232923
1660,6,12,1,2412,-46,-89,43,40:e3:d6:da:ba:20,16238339,160,5256,16238179,16238339
1661,6,6,1,2412,-46,-89,43,40:e3:d6:da:ba:21,16238540,368,-167,16238172,16238540
1662,6,12,1,2412,-46,-89,43,40:e3:d6:da:ba:22,16238945,180,225,16238765,16238945
1663,6,12,1,2412,-46,-89,43,40:e3:d6:da:ba:23,16239168,184,39,16238984,16239168
1664,6,12,1,2412,-46,-89,43,40:e3:d6:da:ba:24,16239405,176,61,16239229,16239405
1665,6,12,1,2412,-46,-89,43,40:e3:d6:da:ba:25,16239615,160,50,16239455,16239615
1666,6,6,1,2412,-46,-89,43,40:e3:d6:da:ba:26,16239815,380,-180,16239435,16239815
1667,6,6,1,2412,-48,-89,41,e6:aa:ea:c9:ea:33,16245046,408,4823,16244638,16245046
1668,4,1,1,2412,-89,-89,0,b8:3a:5a:88:e6:e0,16251752,2360,4346,16249392,16251752
1669,6,6,1,2412,-81,-89,8,e6:aa:ea:c9:ea:1b,16322617,408,70457,16322209,16322617
1670,6,12,1,2412,-47,-89,42,40:e3:d6:da:ba:20,16343366,160,20589,16343206,16343366
1671,6,6,1,2412,-47,-89,42,40:e3:d6:da:ba:21,16343558,368,-176,16343190,16343558
1672,6,12,1,2412,-47,-89,42,40:e3:d6:da:ba:22,16343945,180,207,16343765,16343945
1673,6,12,1,2412,-47,-89,42,40:e3:d6:da:ba:23,16344168,184,39,16343984,16344168
1674,6,12,1,2412,-46,-89,43,40:e3:d6:da:ba:24,16344396,176,52,16344220,16344396
1675,6,12,1,2412,-46,-89,43,40:e3:d6:da:ba:25,16344624,160,68,16344464,16344624
1676,6,6,1,2412,-47,-89,42,40:e3:d6:da:ba:26,16344834,380,-170,16344454,16344834
1677,6,6,1,2412,-82,-89,7,e6:aa:ea:c9:ea:1b,16346859,408,1617,16346451,16346859
1678,4,1,1,2412,-67,-89,22,54:e4:3a:ec:fb:64,16351941,2160,2922,16349781,16351941
1679,4,1,1,2412,-71,-89,18,b8:3a:5a:88:e6:e0,16354133,2360,-168,16351773,16354133
1680,4,1,1,2412,-58,-89,31,b8:3a:5a:88:e6:e1,16356522,2376,13,16354146,16356522
1681,6,6,1,2412,-82,-89,7,e6:aa:ea:c9:ea:1b,16358965,408,2035,16358557,16358965
1682,4,1,1,2412,-56,-89,33,82:34:67:b3:dd:94,16366193,1152,6076,16365041,16366193
1683,6,12,1,2412,-48,-89,41,40:e3:d6:da:ba:20,16367330,136,1001,16367194,16367330
1684,6,12,1,2412,-60,-89,29,,16367482,32,120,16367450,16367482
1685,6,6,1,2412,-47,-89,42,40:e3:d6:da:ba:21,16367556,348,-274,16367208,16367556
1686,6,12,1,2412,-47,-89,42,40:e3:d6:da:ba:25,16368412,136,720,16368276,16368412
1687,6,6,1,2412,-82,-89,7,e6:aa:ea:c9:ea:1b,16371132,408,2312,16370724,16371132
1688,4,1,1,2412,-55,-89,34,82:34:67:b3:dd:94,16386450,1152,14166,16385298,16386450
1689,4,1,1,2412,-67,-89,22,54:e4:3a:ec:fb:64,16390671,2112,2109,16388559,16390671
1690,6,12,1,2412,-46,-89,43,40:e3:d6:da:ba:20,16392643,136,1836,16392507,16392643
1691,6,12,1,2412,-60,-89,29,,16392794,32,119,16392762,16392794
1692,6,6,1,2412,-46,-89,43,40:e3:d6:da:ba:21,16392868,348,-274,16392520,16392868
1693,6,6,1,2412,-59,-89,30,,16393232,44,320,16393188,16393232
1694,6,12,1,2412,-46,-89,43,40:e3:d6:da:ba:22,16393305,156,-83,16393149,16393305
1695,6,12,1,2412,-46,-89,43,40:e3:d6:da:ba:23,16393552,156,91,16393396,16393552
1696,6,12,1,2412,-46,-89,43,40:e3:d6:da:ba:25,16393751,136,63,16393615,16393751
1697,6,12,1,2412,-59,-89,30,,16393903,32,120,16393871,16393903
1698,4,1,1,2412,-66,-89,23,54:e4:3a:ec:fb:64,16394636,2112,-1379,16392524,16394636
1699,4,1,1,2412,-55,-89,34,,16396761,304,1821,16396457,16396761
1700,6,12,1,2412,-46,-89,43,40:e3:d6:da:ba:20,16443133,160,46212,16442973,16443133
1701,6,6,1,2412,-46,-89,43,40:e3:d6:da:ba:21,16443343,368,-158,16442975,16443343
1702,6,12,1,2412,-46,-89,43,40:e3:d6:da:ba:22,16443739,180,216,16443559,16443739
1703,6,12,1,2412,-45,-89,44,40:e3:d6:da:ba:23,16443995,184,72,16443811,16443995
1704,6,12,1,2412,-46,-89,43,40:e3:d6:da:ba:24,16444232,176,61,16444056,16444232
1705,6,12,1,2412,-46,-89,43,40:e3:d6:da:ba:25,16444433,160,41,16444273,16444433
1706,6,6,1,2412,-46,-89,43,40:e3:d6:da:ba:26,16444643,380,-170,16444263,16444643
1707,6,12,1,2412,-47,-89,42,40:e3:d6:da:ba:20,16545541,160,100738,16545381,16545541
1708,6,6,1,2412,-47,-89,42,40:e3:d6:da:ba:21,16545760,368,-149,16545392,16545760
1709,6,12,1,2412,-47,-89,42,40:e3:d6:da:ba:22,16546165,180,225,16545985,16546165
1710,6,12,1,2412,-47,-89,42,40:e3:d6:da:ba:23,16546388,184,39,16546204,16546388
1711,6,12,1,2412,-46,-89,43,40:e3:d6:da:ba:24,16546625,176,61,16546449,16546625
1712,6,12,1,2412,-47,-89,42,40:e3:d6:da:ba:25,16546853,160,68,16546693,16546853
1713,6,6,1,2412,-47,-89,42,40:e3:d6:da:ba:26,16547045,380,-188,16546665,16547045
1714,4,1,1,2412,-65,-89,24,54:e4:3a:ec:fb:64,16556738,2160,7533,16554578,16556738
1715,6,6,1,2412,-74,-89,15,e6:aa:ea:b7:4a:dd,16629998,408,72852,16629590,16629998
1716,6,12,1,2412,-47,-89,42,40:e3:d6:da:ba:20,16647932,160,17774,16647772,16647932
1717,6,6,1,2412,-47,-89,42,40:e3:d6:da:ba:21,16648151,368,-149,16647783,16648151
1718,6,12,1,2412,-48,-89,41,40:e3:d6:da:ba:22,16648565,180,234,16648385,16648565
1719,6,12,1,2412,-47,-89,42,40:e3:d6:da:ba:23,16648788,184,39,16648604,16648788
1720,6,12,1,2412,-48,-89,41,40:e3:d6:da:ba:24,16651804,176,2840,16651628,16651804
1721,6,12,1,2412,-47,-89,42,40:e3:d6:da:ba:25,16652014,160,50,16651854,16652014
1722,6,6,1,2412,-47,-89,42,40:e3:d6:da:ba:26,16652240,380,-154,16651860,16652240
1723,6,6,1,2412,-87,-89,2,e6:aa:ea:c9:ea:1b,16675426,408,22778,16675018,16675426
1724,6,6,1,2412,-53,-89,36,e6:aa:ea:c9:ea:33,16716431,408,40597,16716023,16716431
1725,6,12,1,2412,-48,-89,41,40:e3:d6:da:ba:20,16753007,160,36416,16752847,16753007
1726,6,6,1,2412,-48,-89,41,40:e3:d6:da:ba:21,16753199,368,-176,16752831,16753199
1727,6,12,1,2412,-48,-89,41,40:e3:d6:da:ba:23,16754252,184,869,16754068,16754252
1728,6,12,1,2412,-47,-89,42,40:e3:d6:da:ba:24,16754496,176,68,16754320,16754496
1729,6,12,1,2412,-48,-89,41,40:e3:d6:da:ba:25,16754697,160,41,16754537,16754697
1730,6,6,1,2412,-48,-89,41,40:e3:d6:da:ba:26,16754907,380,-170,16754527,16754907
1731,6,6,1,2412,-52,-89,37,e6:aa:ea:c9:ea:33,16764905,408,9590,16764497,16764905
1732,4,1,1,2412,-85,-89,4,a6:e5:7c:28:b1:d3,16765588,944,-261,16764644,16765588
1733,4,1,1,2412,-86,-89,3,a6:e5:7c:28:b1:d3,16766675,944,143,16765731,16766675
1734,4,1,1,2412,-85,-89,4,a6:e5:7c:28:b1:d3,16772912,944,5293,16771968,16772912
1735,6,12,1,2412,-49,-89,40,40:e3:d6:da:ba:20,16852736,160,79664,16852576,16852736
1736,6,6,1,2412,-49,-89,40,40:e3:d6:da:ba:21,16852937,368,-167,16852569,16852937
1737,6,12,1,2412,-48,-89,41,40:e3:d6:da:ba:22,16853342,180,225,16853162,16853342
1738,6,12,1,2412,-48,-89,41,40:e3:d6:da:ba:23,16853557,184,31,16853373,16853557
1739,6,12,1,2412,-48,-89,41,40:e3:d6:da:ba:24,16853784,176,51,16853608,16853784
1740,6,12,1,2412,-49,-89,40,40:e3:d6:da:ba:25,16854013,160,69,16853853,16854013
1741,6,6,1,2412,-48,-89,41,40:e3:d6:da:ba:26,16854214,380,-179,16853834,16854214
1742,4,1,1,2412,-68,-89,21,54:e4:3a:ec:fb:64,16863936,2160,7562,16861776,16863936
1743,6,6,1,2412,-86,-89,3,84:d4:7e:f2:42:26,16872516,380,8200,16872136,16872516
1744,6,12,1,2412,-48,-89,41,40:e3:d6:da:ba:20,16955138,160,82462,16954978,16955138
1745,6,6,1,2412,-48,-89,41,40:e3:d6:da:ba:21,16955330,368,-176,16954962,16955330
1746,6,12,1,2412,-48,-89,41,40:e3:d6:da:ba:22,16955744,180,234,16955564,16955744
1747,6,12,1,2412,-48,-89,41,40:e3:d6:da:ba:23,16955968,184,40,16955784,16955968
1748,6,12,1,2412,-48,-89,41,40:e3:d6:da:ba:24,16956204,176,60,16956028,16956204
1749,6,12,1,2412,-48,-89,41,40:e3:d6:da:ba:25,16956406,160,42,16956246,16956406
1750,6,6,1,2412,-48,-89,41,40:e3:d6:da:ba:26,16956625,380,-161,16956245,16956625
1751,4,1,1,2412,-66,-89,23,54:e4:3a:ec:fb:64,16966335,2160,7550,16964175,16966335
1752,6,12,1,2412,-48,-89,41,40:e3:d6:da:ba:20,17057537,160,91042,17057377,17057537
1753,6,6,1,2412,-48,-89,41,40:e3:d6:da:ba:21,17057747,368,-158,17057379,17057747
1754,6,12,1,2412,-47,-89,42,40:e3:d6:da:ba:22,17058152,180,225,17057972,17058152
1755,6,12,1,2412,-47,-89,42,40:e3:d6:da:ba:23,17058400,184,64,17058216,17058400
1756,6,12,1,2412,-48,-89,41,40:e3:d6:da:ba:24,17058610,176,34,17058434,17058610
1757,6,12,1,2412,-47,-89,42,40:e3:d6:da:ba:25,17058820,160,50,17058660,17058820
1758,6,6,1,2412,-47,-89,42,40:e3:d6:da:ba:26,17059044,380,-156,17058664,17059044
1759,6,6,1,2412,-69,-89,20,e6:aa:ea:b7:4a:dd,17060291,408,839,17059883,17060291
1760,6,6,1,2412,-69,-89,20,e6:aa:ea:b7:4a:dd,17072443,408,11744,17072035,17072443
1761,6,6,1,2412,-69,-89,20,e6:aa:ea:b7:4a:dd,17084523,408,11672,17084115,17084523
1762,6,6,1,2412,-67,-89,22,e6:aa:ea:b7:4a:dd,17096634,408,11703,17096226,17096634
1763,6,12,1,2412,-48,-89,41,40:e3:d6:da:ba:20,17159934,160,63140,17159774,17159934
1764,6,6,1,2412,-48,-89,41,40:e3:d6:da:ba:21,17160144,368,-158,17159776,17160144
1765,6,12,1,2412,-48,-89,41,40:e3:d6:da:ba:22,17160549,180,225,17160369,17160549
1766,6,12,1,2412,-47,-89,42,40:e3:d6:da:ba:23,17160764,184,31,17160580,17160764
1767,6,12,1,2412,-47,-89,42,40:e3:d6:da:ba:24,17161000,176,60,17160824,17161000
1768,6,12,1,2412,-48,-89,41,40:e3:d6:da:ba:25,17161220,160,60,17161060,17161220
1769,6,6,1,2412,-48,-89,41,40:e3:d6:da:ba:26,17161430,380,-170,17161050,17161430
1770,4,1,1,2412,-85,-89,4,,17170389,304,8655,17170085,17170389
1771,6,6,1,2412,-53,-89,36,e6:aa:ea:c9:ea:33,17236817,408,66020,17236409,17236817
1772,6,6,1,2412,-53,-89,36,e6:aa:ea:c9:ea:33,17248941,408,11716,17248533,17248941
1773,6,6,1,2412,-53,-89,36,e6:aa:ea:c9:ea:33,17261052,408,11703,17260644,17261052
1774,6,12,1,2412,-47,-89,42,40:e3:d6:da:ba:20,17262358,160,1146,17262198,17262358
1775,6,6,1,2412,-47,-89,42,40:e3:d6:da:ba:21,17262568,368,-158,17262200,17262568
1776,6,12,1,2412,-47,-89,42,40:e3:d6:da:ba:22,17262972,180,224,17262792,17262972
1777,6,12,1,2412,-46,-89,43,40:e3:d6:da:ba:23,17263187,184,31,17263003,17263187
1778,6,12,1,2412,-47,-89,42,40:e3:d6:da:ba:24,17263439,176,76,17263263,17263439
1779,6,12,1,2412,-47,-89,42,40:e3:d6:da:ba:25,17263668,160,69,17263508,17263668
1780,6,6,1,2412,-47,-89,42,40:e3:d6:da:ba:26,17263869,380,-179,17263489,17263869
1781,4,1,1,2412,-73,-89,16,b8:3a:5a:88:e6:e0,17275935,2360,9706,17273575,17275935
1782,6,6,1,2412,-53,-89,36,e6:aa:ea:c9:ea:33,17285292,408,8949,17284884,17285292
1783,6,12,1,2412,-47,-89,42,40:e3:d6:da:ba:20,17364741,160,79289,17364581,17364741
1784,6,6,1,2412,-47,-89,42,40:e3:d6:da:ba:21,17364951,368,-158,17364583,17364951
1785,6,12,1,2412,-47,-89,42,40:e3:d6:da:ba:22,17365356,180,225,17365176,17365356
1786,6,12,1,2412,-47,-89,42,40:e3:d6:da:ba:23,17365580,184,40,17365396,17365580
1787,6,12,1,2412,-47,-89,42,40:e3:d6:da:ba:24,17365798,176,42,17365622,17365798
1788,6,12,1,2412,-47,-89,42,40:e3:d6:da:ba:25,17366009,160,51,17365849,17366009
1789,6,6,1,2412,-46,-89,43,40:e3:d6:da:ba:26,17366228,380,-161,17365848,17366228
1790,6,6,1,2412,-68,-89,21,e6:aa:ea:b7:4a:dd,17465411,408,98775,17465003,17465411
1791,6,12,1,2412,-46,-89,43,40:e3:d6:da:ba:20,17467150,160,1579,17466990,17467150
1792,6,6,1,2412,-47,-89,42,40:e3:d6:da:ba:21,17467390,368,-128,17467022,17467390
1793,6,12,1,2412,-46,-89,43,40:e3:d6:da:ba:22,17467816,180,246,17467636,17467816
1794,6,12,1,2412,-46,-89,43,40:e3:d6:da:ba:23,17468042,184,42,17467858,17468042
1795,6,12,1,2412,-46,-89,43,40:e3:d6:da:ba:24,17468260,176,42,17468084,17468260
1796,6,12,1,2412,-47,-89,42,40:e3:d6:da:ba:25,17468462,160,42,17468302,17468462
1797,6,6,1,2412,-46,-89,43,40:e3:d6:da:ba:26,17468700,380,-142,17468320,17468700
1798,6,6,1,2412,-69,-89,20,e6:aa:ea:b7:4a:dd,17477715,408,8607,17477307,17477715
1799,4,1,1,2412,-67,-89,22,54:e4:3a:ec:fb:64,17478548,2160,-1327,17476388,17478548
1800,6,6,1,2412,-70,-89,19,e6:aa:ea:b7:4a:dd,17489648,408,10692,17489240,17489648
1801,6,6,1,2412,-69,-89,20,e6:aa:ea:b7:4a:dd,17501753,408,11697,17501345,17501753
1802,6,6,1,2412,-69,-89,20,e6:aa:ea:b7:4a:dd,17513875,408,11714,17513467,17513875
1803,6,12,1,2412,-47,-89,42,40:e3:d6:da:ba:20,17571465,160,57430,17571305,17571465
1804,6,6,1,2412,-47,-89,42,40:e3:d6:da:ba:21,17571684,368,-149,17571316,17571684
1805,6,12,1,2412,-47,-89,42,40:e3:d6:da:ba:22,17572089,180,225,17571909,17572089
1806,6,12,1,2412,-47,-89,42,40:e3:d6:da:ba:23,17572294,184,21,17572110,17572294
1807,6,12,1,2412,-47,-89,42,40:e3:d6:da:ba:24,17572531,176,61,17572355,17572531
1808,6,12,1,2412,-47,-89,42,40:e3:d6:da:ba:25,17572732,160,41,17572572,17572732
1809,6,6,1,2412,-47,-89,42,40:e3:d6:da:ba:26,17572951,380,-161,17572571,17572951
1810,4,1,1,2412,-65,-89,24,24:f6:77:10:02:c8,17618425,1064,44410,17617361,17618425
1811,4,1,1,2412,-65,-89,24,24:f6:77:10:02:c8,17630683,1064,11194,17629619,17630683
1812,4,1,1,2412,-85,-89,4,c0:c9:e3:4d:6e:bf,17660603,872,29048,17659731,17660603
1813,4,1,1,2412,-87,-89,2,,17661492,304,585,17661188,17661492
1814,6,12,1,2412,-47,-89,42,40:e3:d6:da:ba:20,17671957,160,10305,17671797,17671957
1815,6,6,1,2412,-47,-89,42,40:e3:d6:da:ba:21,17672166,368,-159,17671798,17672166
1816,6,12,1,2412,-47,-89,42,40:e3:d6:da:ba:22,17672562,180,216,17672382,17672562
1817,6,12,1,2412,-47,-89,42,40:e3:d6:da:ba:23,17672795,184,49,17672611,17672795
1818,6,12,1,2412,-47,-89,42,40:e3:d6:da:ba:24,17673004,176,33,17672828,17673004
1819,6,12,1,2412,-47,-89,42,40:e3:d6:da:ba:25,17673233,160,69,17673073,17673233
1820,6,6,1,2412,-47,-89,42,40:e3:d6:da:ba:26,17673443,380,-170,17673063,17673443
1821,4,1,1,2412,-87,-89,2,a4:e5:7c:28:b1:d3,17676454,688,2323,17675766,17676454
1822,4,1,1,2412,-54,-89,35,54:e4:3a:ec:fb:64,17683483,2160,4869,17681323,17683483
1823,4,1,1,2412,-87,-89,2,,17703069,304,19282,17702765,17703069
1824,6,6,1,2412,-86,-89,3,e6:aa:ea:c9:ea:1b,17706926,408,3449,17706518,17706926
1825,6,6,1,2412,-54,-89,35,e6:aa:ea:c9:ea:33,17759986,408,52652,17759578,17759986
1826,6,12,1,2412,-47,-89,42,40:e3:d6:da:ba:20,17774337,160,14191,17774177,17774337
1827,6,6,1,2412,-47,-89,42,40:e3:d6:da:ba:21,17774547,368,-158,17774179,17774547
1828,6,12,1,2412,-47,-89,42,40:e3:d6:da:ba:22,17774934,180,207,17774754,17774934
1829,6,12,1,2412,-47,-89,42,40:e3:d6:da:ba:24,17777725,176,2615,17777549,17777725
1830,6,12,1,2412,-47,-89,42,40:e3:d6:da:ba:25,17777953,160,68,17777793,17777953
1831,6,6,1,2412,-47,-89,42,40:e3:d6:da:ba:26,17778154,380,-179,17777774,17778154
1832,6,6,1,2412,-54,-89,35,e6:aa:ea:c9:ea:33,17784233,408,5671,17783825,17784233
1833,4,1,1,2412,-67,-89,22,54:e4:3a:ec:fb:64,17785529,2160,-864,17783369,17785529
1834,6,6,1,2412,-69,-89,20,e6:aa:ea:b7:4a:dd,17805613,408,19676,17805205,17805613
1835,6,6,1,2412,-53,-89,36,e6:aa:ea:c9:ea:33,17808472,408,2451,17808064,17808472
1836,6,6,1,2412,-68,-89,21,e6:aa:ea:b7:4a:dd,17829840,408,20960,17829432,17829840
1837,6,12,1,2412,-47,-89,42,40:e3:d6:da:ba:20,17876738,160,46738,17876578,17876738
1838,6,6,1,2412,-46,-89,43,40:e3:d6:da:ba:21,17876930,368,-176,17876562,17876930
1839,6,12,1,2412,-47,-89,42,40:e3:d6:da:ba:22,17877317,180,207,17877137,17877317
1840,6,12,1,2412,-46,-89,43,40:e3:d6:da:ba:23,17877540,184,39,17877356,17877540
1841,6,12,1,2412,-46,-89,43,40:e3:d6:da:ba:24,17877777,176,61,17877601,17877777
1842,6,12,1,2412,-46,-89,43,40:e3:d6:da:ba:25,17878005,160,68,17877845,17878005
1843,6,6,1,2412,-46,-89,43,40:e3:d6:da:ba:26,17878206,380,-179,17877826,17878206
1844,4,1,1,2412,-85,-89,4,a6:e5:7c:28:b1:d3,17952284,992,73086,17951292,17952284
1845,6,12,1,2412,-47,-89,42,40:e3:d6:da:ba:20,17979138,160,26694,17978978,17979138
1846,6,6,1,2412,-51,-89,38,40:e3:d6:da:ba:21,17979348,368,-158,17978980,17979348
1847,6,12,1,2412,-51,-89,38,40:e3:d6:da:ba:22,17979735,180,207,17979555,17979735
1848,6,12,1,2412,-51,-89,38,40:e3:d6:da:ba:25,17980361,160,466,17980201,17980361
1849,6,6,1,2412,-51,-89,38,40:e3:d6:da:ba:26,17980580,380,-161,17980200,17980580
1850,6,6,1,2412,-86,-89,3,e6:aa:ea:c9:ea:1b,18000549,408,19561,18000141,18000549
1851,6,6,1,2412,-86,-89,3,e6:aa:ea:c9:ea:1b,18024789,408,23832,18024381,18024789
1852,4,1,1,2412,-65,-89,24,54:e4:3a:ec:fb:64,18073149,2160,46200,18070989,18073149
1853,6,12,1,2412,-47,-89,42,40:e3:d6:da:ba:20,18081550,160,8241,18081390,18081550
1854,6,6,1,2412,-47,-89,42,40:e3:d6:da:ba:21,18081751,368,-167,18081383,18081751
1855,6,12,1,2412,-47,-89,42,40:e3:d6:da:ba:22,18082165,180,234,18081985,18082165
1856,6,12,1,2412,-47,-89,42,40:e3:d6:da:ba:23,18082370,184,21,18082186,18082370
1857,6,12,1,2412,-47,-89,42,40:e3:d6:da:ba:24,18082598,176,52,18082422,18082598
1858,6,12,1,2412,-47,-89,42,40:e3:d6:da:ba:25,18082826,160,68,18082666,18082826
1859,6,6,1,2412,-47,-89,42,40:e3:d6:da:ba:26,18083036,380,-170,18082656,18083036
1860,4,1,1,2412,-64,-89,25,54:e4:3a:ec:fb:64,18092726,2160,7530,18090566,18092726
1861,6,6,1,2412,-52,-89,37,e6:aa:ea:c9:ea:33,18175863,408,82729,18175455,18175863
1862,6,12,1,2412,-47,-89,42,40:e3:d6:da:ba:20,18183948,160,7925,18183788,18183948
1863,6,6,1,2412,-47,-89,42,40:e3:d6:da:ba:21,18184167,368,-149,18183799,18184167
1864,6,12,1,2412,-50,-89,39,40:e3:d6:da:ba:22,18184581,180,234,18184401,18184581
1865,6,12,1,2412,-47,-89,42,40:e3:d6:da:ba:25,18186291,160,1550,18186131,18186291
1866,4,1,1,2412,-83,-89,6,c0:c9:e3:4d:6e:bf,18192712,872,5549,18191840,18192712
1867,4,1,1,2412,-64,-89,25,54:e4:3a:ec:fb:64,18195125,2160,253,18192965,18195125
1868,6,6,1,2412,-52,-89,37,e6:aa:ea:c9:ea:33,18200117,408,4584,18199709,18200117
1869,6,6,1,2412,-52,-89,37,e6:aa:ea:c9:ea:33,18212373,408,11848,18211965,18212373
1870,4,1,1,2412,-75,-89,14,a6:e5:7c:28:b1:d3,18213990,944,673,18213046,18213990
1871,4,1,1,2412,-84,-89,5,a6:e5:7c:28:b1:d3,18215325,944,391,18214381,18215325
1872,4,1,1,2412,-69,-89,20,a6:e5:7c:28:b1:d3,18220266,944,3997,18219322,18220266
1873,4,1,1,2412,-87,-89,2,a6:e5:7c:28:b1:d3,18221371,944,161,18220427,18221371
1874,6,6,1,2412,-52,-89,37,e6:aa:ea:c9:ea:33,18224336,408,2557,18223928,18224336
1875,6,12,1,2412,-48,-89,41,40:e3:d6:da:ba:20,18286415,160,61919,18286255,18286415
1876,6,6,1,2412,-48,-89,41,40:e3:d6:da:ba:21,18286634,368,-149,18286266,18286634
1877,6,12,1,2412,-48,-89,41,40:e3:d6:da:ba:22,18287048,180,234,18286868,18287048
1878,6,12,1,2412,-48,-89,41,40:e3:d6:da:ba:23,18287262,184,30,18287078,18287262
1879,6,12,1,2412,-48,-89,41,40:e3:d6:da:ba:24,18287490,176,52,18287314,18287490
1880,6,12,1,2412,-48,-89,41,40:e3:d6:da:ba:25,18287700,160,50,18287540,18287700
1881,6,6,1,2412,-48,-89,41,40:e3:d6:da:ba:26,18287919,380,-161,18287539,18287919
1882,4,1,1,2412,-63,-89,26,54:e4:3a:ec:fb:64,18297661,2160,7582,18295501,18297661
1883,4,1,1,2412,-88,-89,1,b8:3a:5a:88:e6:e0,18299895,2360,-126,18297535,18299895
1884,6,6,1,2412,-85,-89,4,e6:aa:ea:c9:ea:1b,18354690,408,54387,18354282,18354690
1885,6,12,1,2412,-48,-89,41,40:e3:d6:da:ba:20,18390032,160,35182,18389872,18390032
1886,6,6,1,2412,-48,-89,41,40:e3:d6:da:ba:21,18390242,368,-158,18389874,18390242
1887,6,12,1,2412,-48,-89,41,40:e3:d6:da:ba:23,18390891,184,465,18390707,18390891
1888,6,12,1,2412,-48,-89,41,40:e3:d6:da:ba:24,18391119,176,52,18390943,18391119
1889,6,12,1,2412,-48,-89,41,40:e3:d6:da:ba:25,18391338,160,59,18391178,18391338
1890,6,6,1,2412,-48,-89,41,40:e3:d6:da:ba:26,18391548,380,-170,18391168,18391548
1891,6,12,1,2412,-48,-89,41,40:e3:d6:da:ba:20,18491202,160,99494,18491042,18491202
1892,6,6,1,2412,-48,-89,41,40:e3:d6:da:ba:21,18491394,368,-176,18491026,18491394
1893,6,12,1,2412,-48,-89,41,40:e3:d6:da:ba:22,18491808,180,234,18491628,18491808
1894,6,12,1,2412,-48,-89,41,40:e3:d6:da:ba:23,18492040,184,48,18491856,18492040
1895,6,12,1,2412,-48,-89,41,40:e3:d6:da:ba:24,18492277,176,61,18492101,18492277
1896,6,12,1,2412,-48,-89,41,40:e3:d6:da:ba:25,18492478,160,41,18492318,18492478
1897,6,6,1,2412,-48,-89,41,40:e3:d6:da:ba:26,18492697,380,-161,18492317,18492697
1898,6,6,1,2412,-51,-89,38,e6:aa:ea:c9:ea:33,18593249,408,100144,18592841,18593249
1899,6,12,1,2412,-48,-89,41,40:e3:d6:da:ba:20,18593676,160,267,18593516,18593676
1900,6,6,1,2412,-48,-89,41,40:e3:d6:da:ba:21,18593868,368,-176,18593500,18593868
1901,6,12,1,2412,-48,-89,41,40:e3:d6:da:ba:22,18594255,180,207,18594075,18594255
1902,6,12,1,2412,-48,-89,41,40:e3:d6:da:ba:23,18594469,184,30,18594285,18594469
1903,6,12,1,2412,-48,-89,41,40:e3:d6:da:ba:24,18594679,176,34,18594503,18594679
1904,6,12,1,2412,-48,-89,41,40:e3:d6:da:ba:25,18594898,160,59,18594738,18594898
1905,6,6,1,2412,-48,-89,41,40:e3:d6:da:ba:26,18595108,380,-170,18594728,18595108
1906,6,6,1,2412,-51,-89,38,e6:aa:ea:c9:ea:33,18617501,408,21985,18617093,18617501
1907,6,6,1,2412,-68,-89,21,e6:aa:ea:b7:4a:dd,18619050,408,1141,18618642,18619050
1908,6,6,1,2412,-51,-89,38,e6:aa:ea:c9:ea:33,18641729,408,22271,18641321,18641729
1909,6,6,1,2412,-68,-89,21,e6:aa:ea:b7:4a:dd,18643278,408,1141,18642870,18643278
1910,6,6,1,2412,-68,-89,21,e6:aa:ea:b7:4a:dd,18655402,408,11716,18654994,18655402
1911,6,12,1,2412,-48,-89,41,40:e3:d6:da:ba:20,18695961,160,40399,18695801,18695961
1912,6,6,1,2412,-48,-89,41,40:e3:d6:da:ba:21,18696162,368,-167,18695794,18696162
1913,6,12,1,2412,-48,-89,41,40:e3:d6:da:ba:22,18696549,180,207,18696369,18696549
1914,6,12,1,2412,-48,-89,41,40:e3:d6:da:ba:23,18696773,184,40,18696589,18696773
1915,6,12,1,2412,-48,-89,41,40:e3:d6:da:ba:24,18697009,176,60,18696833,18697009
1916,6,12,1,2412,-48,-89,41,40:e3:d6:da:ba:25,18697229,160,60,18697069,18697229
1917,6,6,1,2412,-48,-89,41,40:e3:d6:da:ba:26,18697448,380,-161,18697068,18697448
1918,4,1,1,2412,-89,-89,0,b8:3a:5a:88:e6:e1,18711846,2376,12022,18709470,18711846
1919,6,12,1,2412,-49,-89,40,40:e3:d6:da:ba:20,18798360,160,86354,18798200,18798360
1920,6,6,1,2412,-49,-89,40,40:e3:d6:da:ba:21,18798578,368,-150,18798210,18798578
1921,6,12,1,2412,-49,-89,40,40:e3:d6:da:ba:22,18798981,180,223,18798801,18798981
1922,6,12,1,2412,-49,-89,40,40:e3:d6:da:ba:23,18799213,184,48,18799029,18799213
1923,6,12,1,2412,-49,-89,40,40:e3:d6:da:ba:24,18799441,176,52,18799265,18799441
1924,6,12,1,2412,-49,-89,40,40:e3:d6:da:ba:25,18799642,160,41,18799482,18799642
1925,6,6,1,2412,-49,-89,40,40:e3:d6:da:ba:26,18799852,380,-170,18799472,18799852
1926,6,6,1,2412,-85,-89,4,e6:aa:ea:c9:ea:1b,18842689,408,42429,18842281,18842689
1927,6,6,1,2412,-87,-89,2,e6:aa:ea:c9:ea:1b,18891159,408,48062,18890751,18891159
1928,6,12,1,2412,-49,-89,40,40:e3:d6:da:ba:20,18901356,160,10037,18901196,18901356
1929,6,6,1,2412,-49,-89,40,40:e3:d6:da:ba:21,18901626,368,-98,18901258,18901626
1930,6,12,1,2412,-49,-89,40,40:e3:d6:da:ba:22,18902022,180,216,18901842,18902022
1931,6,12,1,2412,-49,-89,40,40:e3:d6:da:ba:23,18902236,184,30,18902052,18902236
1932,6,12,1,2412,-49,-89,40,40:e3:d6:da:ba:24,18902455,176,43,18902279,18902455
1933,6,12,1,2412,-49,-89,40,40:e3:d6:da:ba:25,18902674,160,59,18902514,18902674
1934,6,6,1,2412,-50,-89,39,40:e3:d6:da:ba:26,18902866,380,-188,18902486,18902866
1935,4,1,1,2412,-87,-89,2,b8:3a:5a:88:e6:e1,18916564,2376,11322,18914188,18916564
1936,6,12,1,2412,-49,-89,40,40:e3:d6:da:ba:20,19003164,160,86440,19003004,19003164
1937,6,6,1,2412,-49,-89,40,40:e3:d6:da:ba:21,19003365,368,-167,19002997,19003365
1938,6,12,1,2412,-49,-89,40,40:e3:d6:da:ba:22,19003770,180,225,19003590,19003770
1939,6,12,1,2412,-49,-89,40,40:e3:d6:da:ba:23,19004045,184,91,19003861,19004045
1940,6,12,1,2412,-49,-89,40,40:e3:d6:da:ba:24,19004281,176,60,19004105,19004281
1941,6,12,1,2412,-49,-89,40,40:e3:d6:da:ba:25,19004492,160,51,19004332,19004492
1942,6,6,1,2412,-49,-89,40,40:e3:d6:da:ba:26,19004693,380,-179,19004313,19004693
1943,4,1,1,2412,-67,-91,24,54:e4:3a:ec:fb:64,19014319,2160,7466,19012159,19014319
1944,6,6,1,2412,-58,-91,33,e6:aa:ea:c9:ea:33,19023031,408,8304,19022623,19023031
1945,6,6,1,2412,-58,-91,33,e6:aa:ea:c9:ea:33,19059376,408,35937,19058968,19059376
1946,6,12,1,2412,-47,-91,44,40:e3:d6:da:ba:20,19105558,160,46022,19105398,19105558
1947,6,6,1,2412,-47,-91,44,40:e3:d6:da:ba:21,19105799,368,-127,19105431,19105799
1948,6,12,1,2412,-47,-91,44,40:e3:d6:da:ba:22,19106213,180,234,19106033,19106213
1949,6,12,1,2412,-47,-91,44,40:e3:d6:da:ba:23,19106437,184,40,19106253,19106437
1950,6,12,1,2412,-47,-91,44,40:e3:d6:da:ba:24,19106664,176,51,19106488,19106664
1951,6,12,1,2412,-47,-91,44,40:e3:d6:da:ba:25,19106884,160,60,19106724,19106884
1952,6,6,1,2412,-47,-91,44,40:e3:d6:da:ba:26,19107103,380,-161,19106723,19107103
1953,4,1,1,2412,-85,-91,6,b8:3a:5a:88:e6:e0,19118912,2360,9449,19116552,19118912
1954,6,6,1,2412,-69,-91,22,e6:aa:ea:b7:4a:dd,19139064,408,19744,19138656,19139064
1955,6,6,1,2412,-69,-91,22,e6:aa:ea:b7:4a:dd,19151138,408,11666,19150730,19151138
1956,6,6,1,2412,-69,-91,22,e6:aa:ea:b7:4a:dd,19163250,408,11704,19162842,19163250
1957,6,6,1,2412,-69,-91,22,e6:aa:ea:b7:4a:dd,19187489,408,23831,19187081,19187489
1958,6,6,1,2412,-48,-91,43,40:e3:d6:da:ba:21,19209234,368,21377,19208866,19209234
1959,6,12,1,2412,-48,-91,43,40:e3:d6:da:ba:23,19209863,184,445,19209679,19209863
1960,6,12,1,2412,-48,-91,43,40:e3:d6:da:ba:24,19210081,176,42,19209905,19210081
1961,6,12,1,2412,-48,-91,43,40:e3:d6:da:ba:25,19210291,160,50,19210131,19210291
1962,6,6,1,2412,-50,-91,41,40:e3:d6:da:ba:21,19310549,368,99890,19310181,19310549
1963,6,12,1,2412,-49,-91,42,40:e3:d6:da:ba:22,19310954,180,225,19310774,19310954
1964,6,12,1,2412,-49,-91,42,40:e3:d6:da:ba:23,19311177,184,39,19310993,19311177
1965,6,12,1,2412,-49,-91,42,40:e3:d6:da:ba:24,19311405,176,52,19311229,19311405
1966,6,12,1,2412,-49,-91,42,40:e3:d6:da:ba:25,19311633,160,68,19311473,19311633
1967,6,6,1,2412,-49,-91,42,40:e3:d6:da:ba:26,19311825,380,-188,19311445,19311825
1968,4,1,1,2412,-65,-91,26,54:e4:3a:ec:fb:64,19321815,2160,7830,19319655,19321815
1969,6,6,1,2412,-52,-91,39,e6:aa:ea:c9:ea:33,19325571,408,3348,19325163,19325571
1970,6,6,1,2412,-54,-91,37,e6:aa:ea:c9:ea:33,19349655,408,23676,19349247,19349655
1971,6,6,1,2412,-54,-91,37,e6:aa:ea:c9:ea:33,19361782,408,11719,19361374,19361782
1972,6,6,1,2412,-54,-91,37,e6:aa:ea:c9:ea:33,19373891,408,11701,19373483,19373891
1973,6,12,1,2412,-47,-91,44,40:e3:d6:da:ba:20,19412768,160,38717,19412608,19412768
1974,6,6,1,2412,-47,-91,44,40:e3:d6:da:ba:21,19412978,368,-158,19412610,19412978
1975,6,12,1,2412,-47,-91,44,40:e3:d6:da:ba:22,19413365,180,207,19413185,19413365
1976,6,12,1,2412,-47,-91,44,40:e3:d6:da:ba:23,19413588,184,39,19413404,19413588
1977,6,12,1,2412,-47,-91,44,40:e3:d6:da:ba:24,19413798,176,34,19413622,19413798
1978,6,12,1,2412,-47,-91,44,40:e3:d6:da:ba:25,19414008,160,50,19413848,19414008
1979,6,6,1,2412,-47,-91,44,40:e3:d6:da:ba:26,19414218,380,-170,19413838,19414218
1980,4,1,1,2412,-89,-91,2,b8:3a:5a:88:e6:e0,19461109,2240,44651,19458869,19461109
1981,6,12,1,2412,-47,-91,44,40:e3:d6:da:ba:20,19515170,160,53901,19515010,19515170
1982,6,6,1,2412,-47,-91,44,40:e3:d6:da:ba:21,19515389,368,-149,19515021,19515389
1983,6,12,1,2412,-45,-91,46,40:e3:d6:da:ba:22,19515819,180,250,19515639,19515819
1984,6,12,1,2412,-45,-91,46,40:e3:d6:da:ba:23,19516024,184,21,19515840,19516024
1985,6,12,1,2412,-47,-91,44,40:e3:d6:da:ba:24,19516243,176,43,19516067,19516243
1986,6,12,1,2412,-47,-91,44,40:e3:d6:da:ba:25,19516462,160,59,19516302,19516462
1987,6,6,1,2412,-47,-91,44,40:e3:d6:da:ba:26,19516654,380,-188,19516274,19516654
1988,4,1,1,2412,-65,-91,26,54:e4:3a:ec:fb:64,19526348,2160,7534,19524188,19526348
1989,6,6,1,2412,-87,-91,4,84:d4:7e:f2:42:26,19534856,380,8128,19534476,19534856
1990,6,6,1,2412,-85,-91,6,e6:aa:ea:c9:ea:1b,19580714,408,45450,19580306,19580714
1991,6,6,1,2412,-84,-91,7,e6:aa:ea:c9:ea:1b,19604952,408,23830,19604544,19604952
1992,6,12,1,2412,-48,-91,43,40:e3:d6:da:ba:20,19617546,160,12434,19617386,19617546
1993,6,6,1,2412,-47,-91,44,40:e3:d6:da:ba:21,19617747,368,-167,19617379,19617747
1994,6,12,1,2412,-47,-91,44,40:e3:d6:da:ba:22,19618161,180,234,19617981,19618161
1995,6,12,1,2412,-48,-91,43,40:e3:d6:da:ba:23,19618385,184,40,19618201,19618385
1996,6,12,1,2412,-47,-91,44,40:e3:d6:da:ba:24,19618603,176,42,19618427,19618603
1997,6,12,1,2412,-47,-91,44,40:e3:d6:da:ba:25,19618832,160,69,19618672,19618832
1998,6,6,1,2412,-47,-91,44,40:e3:d6:da:ba:26,19619085,380,-127,19618705,19619085
1999,6,6,1,2412,-86,-91,5,84:d4:7e:f2:42:21,19635748,368,16295,19635380,19635748
2000,6,6,1,2412,-51,-91,40,e6:aa:ea:c9:ea:33,19640524,408,4368,19640116,19640524
2001,6,6,1,2412,-51,-91,40,e6:aa:ea:c9:ea:33,19654704,408,13772,19654296,19654704
2002,6,6,1,2412,-50,-91,41,e6:aa:ea:c9:ea:33,19676877,408,21765,19676469,19676877
2003,6,6,1,2412,-71,-91,20,e6:aa:ea:b7:4a:dd,19682984,408,5699,19682576,19682984
2004,6,6,1,2412,-70,-91,21,e6:aa:ea:b7:4a:dd,19695092,408,11700,19694684,19695092
2005,6,6,1,2412,-69,-91,22,e6:aa:ea:b7:4a:dd,19707207,408,11707,19706799,19707207
2006,6,12,1,2412,-49,-91,42,40:e3:d6:da:ba:20,19719969,160,12602,19719809,19719969
2007,6,6,1,2412,-49,-91,42,40:e3:d6:da:ba:21,19720161,368,-176,19719793,19720161
2008,6,12,1,2412,-48,-91,43,40:e3:d6:da:ba:22,19720575,180,234,19720395,19720575
2009,6,12,1,2412,-48,-91,43,40:e3:d6:da:ba:23,19720807,184,48,19720623,19720807
2010,6,12,1,2412,-48,-91,43,40:e3:d6:da:ba:24,19721073,176,90,19720897,19721073
2011,6,12,1,2412,-48,-91,43,40:e3:d6:da:ba:25,19721283,160,50,19721123,19721283
2012,6,6,1,2412,-48,-91,43,40:e3:d6:da:ba:26,19721525,380,-138,19721145,19721525
2013,6,12,1,2412,-47,-91,44,40:e3:d6:da:ba:20,19822358,160,100673,19822198,19822358
2014,6,6,1,2412,-46,-91,45,40:e3:d6:da:ba:21,19822577,368,-149,19822209,19822577
2015,6,12,1,2412,-46,-91,45,40:e3:d6:da:ba:22,19822991,180,234,19822811,19822991
2016,6,12,1,2412,-47,-91,44,40:e3:d6:da:ba:23,19823214,184,39,19823030,19823214
2017,6,12,1,2412,-46,-91,45,40:e3:d6:da:ba:24,19823451,176,61,19823275,19823451
2018,6,12,1,2412,-46,-91,45,40:e3:d6:da:ba:25,19823661,160,50,19823501,19823661
2019,6,6,1,2412,-46,-91,45,40:e3:d6:da:ba:26,19823862,380,-179,19823482,19823862
2020,4,1,1,2412,-66,-91,25,54:e4:3a:ec:fb:64,19833511,2160,7489,19831351,19833511
2021,4,5.5,1,2412,-88,-91,3,,19876368,213,42644,19876155,19876368
2022,4,1,1,2412,-86,-91,5,a6:e5:7c:28:b1:d3,19879936,944,2624,19878992,19879936
2023,4,1,1,2412,-88,-91,3,,19880891,304,651,19880587,19880891
2024,6,6,1,2412,-81,-91,10,e6:aa:ea:c9:ea:1b,19921995,408,40696,19921587,19921995
2025,6,12,1,2412,-46,-91,45,40:e3:d6:da:ba:20,19925062,160,2907,19924902,19925062
2026,6,6,1,2412,-46,-91,45,40:e3:d6:da:ba:21,19925263,368,-167,19924895,19925263
2027,6,12,1,2412,-46,-91,45,40:e3:d6:da:ba:22,19925665,180,222,19925485,19925665
2028,6,12,1,2412,-46,-91,45,40:e3:d6:da:ba:23,19925915,184,66,19925731,19925915
2029,6,12,1,2412,-46,-91,45,40:e3:d6:da:ba:24,19926134,176,43,19925958,19926134
2030,6,12,1,2412,-46,-91,45,40:e3:d6:da:ba:25,19926362,160,68,19926202,19926362
2031,4,1,1,2412,-66,-91,25,54:e4:3a:ec:fb:64,19935910,2160,7388,19933750,19935910
2032,6,6,1,2412,-84,-91,7,,19943878,44,7924,19943834,19943878
2033,4,1,1,2412,-85,-91,6,a6:e5:7c:28:b1:d3,19944354,944,-468,19943410,19944354
2034,6,6,1,2412,-82,-91,9,e6:aa:ea:c9:ea:1b,19946234,408,1472,19945826,19946234
2035,4,1,1,2412,-87,-91,4,a6:e5:7c:28:b1:d3,20001012,992,53786,20000020,20001012
2036,6,12,1,2412,-45,-91,46,40:e3:d6:da:ba:20,20027174,160,26002,20027014,20027174
2037,6,6,1,2412,-45,-91,46,40:e3:d6:da:ba:21,20027366,368,-176,20026998,20027366
2038,6,12,1,2412,-45,-91,46,40:e3:d6:da:ba:22,20030367,180,2821,20030187,20030367
2039,6,12,1,2412,-45,-91,46,40:e3:d6:da:ba:23,20030591,184,40,20030407,20030591
2040,6,12,1,2412,-45,-91,46,40:e3:d6:da:ba:24,20030833,176,66,20030657,20030833
2041,6,12,1,2412,-45,-91,46,40:e3:d6:da:ba:25,20031053,160,60,20030893,20031053
2042,6,6,1,2412,-45,-91,46,40:e3:d6:da:ba:26,20031244,380,-189,20030864,20031244
2043,6,6,1,2412,-47,-91,44,,20035181,44,3893,20035137,20035181
2044,6,6,1,2412,-46,-91,45,,20060181,44,24956,20060137,20060181
2045,6,6,1,2412,-46,-91,45,,20110179,44,49954,20110135,20110179
2046,6,6,1,2412,-46,-91,45,,20111034,44,811,20110990,20111034
2047,6,6,1,2412,-46,-91,45,,20111683,44,605,20111639,20111683
2048,6,6,1,2412,-46,-91,45,,20112330,44,603,20112286,20112330
2049,6,6,1,2412,-82,-91,9,78:8a:20:fa:27:f9,20128045,88,15627,20127957,20128045
2050,6,12,1,2412,-46,-91,45,40:e3:d6:da:ba:20,20128278,136,97,20128142,20128278
2051,6,12,1,2412,-83,-91,8,,20128416,32,106,20128384,20128416
2052,6,6,1,2412,-46,-91,45,40:e3:d6:da:ba:21,20128508,348,-256,20128160,20128508
2053,6,12,1,2412,-46,-91,45,40:e3:d6:da:ba:22,20128911,156,247,20128755,20128911
2054,6,12,1,2412,-46,-91,45,40:e3:d6:da:ba:23,20129160,156,93,20129004,20129160
2055,6,12,1,2412,-46,-91,45,40:e3:d6:da:ba:25,20129392,136,96,20129256,20129392
2056,6,12,1,2412,-46,-91,45,40:e3:d6:da:ba:20,20129554,160,2,20129394,20129554
2057,6,12,1,2412,-83,-91,8,,20129723,32,137,20129691,20129723
2058,6,6,1,2412,-46,-91,45,40:e3:d6:da:ba:21,20132312,368,2221,20131944,20132312
2059,6,12,1,2412,-46,-91,45,40:e3:d6:da:ba:22,20132717,180,225,20132537,20132717
2060,6,12,1,2412,-46,-91,45,40:e3:d6:da:ba:23,20133072,184,171,20132888,20133072
2061,6,12,1,2412,-46,-91,45,40:e3:d6:da:ba:24,20133309,176,61,20133133,20133309
2062,6,12,1,2412,-46,-91,45,40:e3:d6:da:ba:25,20133510,160,41,20133350,20133510
2063,6,6,1,2412,-46,-91,45,40:e3:d6:da:ba:26,20133711,380,-179,20133331,20133711
2064,4,1,1,2412,-65,-91,26,54:e4:3a:ec:fb:64,20140708,2160,4837,20138548,20140708
2065,4,1,1,2412,-87,-91,4,b8:3a:5a:88:e6:e0,20143141,2360,73,20140781,20143141
2066,4,1,1,2412,-88,-91,3,,20154618,304,11173,20154314,20154618
2067,6,6,1,2412,-49,-91,42,e6:aa:ea:c9:ea:33,20171889,408,16863,20171481,20171889
2068,6,6,1,2412,-82,-91,9,78:8a:20:fa:27:f9,20178114,88,6137,20178026,20178114
2069,6,12,1,2412,-47,-91,44,40:e3:d6:da:ba:20,20178344,136,94,20178208,20178344
2070,6,12,1,2412,-83,-91,8,,20178506,32,130,20178474,20178506
2071,6,6,1,2412,-47,-91,44,40:e3:d6:da:ba:21,20178597,348,-257,20178249,20178597
2072,6,6,1,2412,-83,-91,8,,20178952,44,311,20178908,20178952
2073,6,12,1,2412,-47,-91,44,40:e3:d6:da:ba:22,20179043,156,-65,20178887,20179043
2074,6,12,1,2412,-83,-91,8,,20179211,32,136,20179179,20179211
2075,6,12,1,2412,-47,-91,44,40:e3:d6:da:ba:23,20179305,156,-62,20179149,20179305
2076,6,12,1,2412,-83,-91,8,,20179463,32,126,20179431,20179463
2077,6,12,1,2412,-47,-91,44,40:e3:d6:da:ba:25,20179549,136,-50,20179413,20179549
2078,6,6,1,2412,-67,-91,24,e6:aa:ea:b7:4a:dd,20179979,408,22,20179571,20179979
2079,6,6,1,2412,-49,-91,42,e6:aa:ea:c9:ea:33,20184011,408,3624,20183603,20184011
2080,6,6,1,2412,-63,-91,28,e6:aa:ea:b7:4a:dd,20190939,408,6520,20190531,20190939
2081,6,6,1,2412,-49,-91,42,e6:aa:ea:c9:ea:33,20196135,408,4788,20195727,20196135
2082,6,6,1,2412,-66,-91,25,e6:aa:ea:b7:4a:dd,20203071,408,6528,20202663,20203071
2083,6,6,1,2412,-49,-91,42,e6:aa:ea:c9:ea:33,20208249,408,4770,20207841,20208249
2084,6,12,1,2412,-49,-91,42,40:e3:d6:da:ba:20,20231963,160,23554,20231803,20231963
2085,6,6,1,2412,-49,-91,42,40:e3:d6:da:ba:21,20232164,368,-167,20231796,20232164
2086,6,12,1,2412,-48,-91,43,40:e3:d6:da:ba:22,20232569,180,225,20232389,20232569
2087,6,12,1,2412,-48,-91,43,40:e3:d6:da:ba:23,20232775,184,22,20232591,20232775
2088,6,12,1,2412,-48,-91,43,40:e3:d6:da:ba:24,20233002,176,51,20232826,20233002
2089,6,12,1,2412,-48,-91,43,40:e3:d6:da:ba:25,20233231,160,69,20233071,20233231
2090,6,6,1,2412,-48,-91,43,40:e3:d6:da:ba:26,20233432,380,-179,20233052,20233432
2091,6,6,1,2412,-83,-91,8,e6:aa:ea:c9:ea:1b,20239360,408,5520,20238952,20239360
2092,4,1,1,2412,-56,-91,35,54:e4:3a:ec:fb:64,20243107,2160,1587,20240947,20243107
2093,6,12,1,2412,-52,-91,39,40:e3:d6:da:ba:20,20334376,160,91109,20334216,20334376
2094,6,6,1,2412,-52,-91,39,40:e3:d6:da:ba:21,20334577,368,-167,20334209,20334577
2095,6,12,1,2412,-52,-91,39,40:e3:d6:da:ba:22,20334982,180,225,20334802,20334982
2096,6,12,1,2412,-52,-91,39,40:e3:d6:da:ba:23,20335196,184,30,20335012,20335196
2097,6,12,1,2412,-52,-91,39,40:e3:d6:da:ba:24,20335415,176,43,20335239,20335415
2098,6,12,1,2412,-52,-91,39,40:e3:d6:da:ba:25,20335625,160,50,20335465,20335625
2099,6,6,1,2412,-51,-91,40,40:e3:d6:da:ba:26,20335860,380,-145,20335480,20335860
2100,6,12,1,2412,-56,-91,35,40:e3:d6:da:ba:20,20437593,160,101573,20437433,20437593
2101,6,6,1,2412,-55,-91,36,40:e3:d6:da:ba:21,20437803,368,-158,20437435,20437803
2102,6,12,1,2412,-55,-91,36,40:e3:d6:da:ba:23,20438468,184,481,20438284,20438468
2103,6,12,1,2412,-55,-91,36,40:e3:d6:da:ba:24,20438686,176,42,20438510,20438686
2104,6,12,1,2412,-55,-91,36,40:e3:d6:da:ba:25,20438897,160,51,20438737,20438897
2105,6,6,1,2412,-55,-91,36,40:e3:d6:da:ba:26,20439107,380,-170,20438727,20439107
2106,4,1,1,2412,-66,-91,25,54:e4:3a:ec:fb:64,20447906,2160,6639,20445746,20447906
2107,4,1,1,2412,-71,-91,20,b8:3a:5a:88:e6:e0,20450089,2360,-177,20447729,20450089
2108,6,6,1,2412,-68,-91,23,e6:aa:ea:b7:4a:dd,20495122,408,44625,20494714,20495122
2109,6,6,1,2412,-68,-91,23,e6:aa:ea:b7:4a:dd,20507245,408,11715,20506837,20507245
2110,6,6,1,2412,-68,-91,23,e6:aa:ea:b7:4a:dd,20519351,408,11698,20518943,20519351
2111,6,12,1,2412,-53,-91,38,40:e3:d6:da:ba:20,20522514,136,3027,20522378,20522514
2112,6,12,1,2412,-52,-91,39,40:e3:d6:da:ba:23,20523469,156,799,20523313,20523469
2113,6,12,1,2412,-52,-91,39,40:e3:d6:da:ba:25,20523669,136,64,20523533,20523669
2114,6,12,1,2412,-79,-91,12,,20523987,32,286,20523955,20523987
2115,6,12,1,2412,-83,-91,8,,20524254,32,235,20524222,20524254
2116,6,12,1,2412,-86,-91,5,,20524499,32,213,20524467,20524499
2117,6,12,1,2412,-84,-91,7,,20524719,32,188,20524687,20524719
2118,6,6,1,2412,-84,-91,7,,20525165,44,402,20525121,20525165
2119,4,1,1,2412,-81,-91,10,,20529828,304,4359,20529524,20529828
2120,6,12,1,2412,-84,-91,7,,20530171,32,311,20530139,20530171
2121,6,6,1,2412,-67,-91,24,e6:aa:ea:b7:4a:dd,20531469,408,890,20531061,20531469
2122,4,1,1,2412,-63,-91,28,54:e4:3a:ec:fb:64,20532106,2112,-1475,20529994,20532106
2123,4,1,1,2412,-81,-91,10,,20534231,304,1821,20533927,20534231
2124,6,12,1,2412,-56,-91,35,40:e3:d6:da:ba:20,20539153,160,4762,20538993,20539153
2125,6,6,1,2412,-56,-91,35,40:e3:d6:da:ba:21,20539345,368,-176,20538977,20539345
2126,6,12,1,2412,-56,-91,35,40:e3:d6:da:ba:22,20539732,180,207,20539552,20539732
2127,6,12,1,2412,-56,-91,35,40:e3:d6:da:ba:23,20539937,184,21,20539753,20539937
2128,6,12,1,2412,-56,-91,35,40:e3:d6:da:ba:24,20540165,176,52,20539989,20540165
2129,6,12,1,2412,-56,-91,35,40:e3:d6:da:ba:25,20540366,160,41,20540206,20540366
2130,6,6,1,2412,-56,-91,35,40:e3:d6:da:ba:26,20540576,380,-170,20540196,20540576
2131,6,6,1,2412,-68,-91,23,e6:aa:ea:b7:4a:dd,20543658,408,2674,20543250,20543658
2132,4,1,1,2412,-68,-91,23,54:e4:3a:ec:fb:64,20550305,2160,4487,20548145,20550305
2133,6,6,1,2412,-51,-91,40,40:e3:d6:da:ba:21,20604778,348,54125,20604430,20604778
2134,6,12,1,2412,-51,-91,40,40:e3:d6:da:ba:22,20605154,156,220,20604998,20605154
2135,6,12,1,2412,-51,-91,40,40:e3:d6:da:ba:23,20605362,156,52,20605206,20605362
2136,6,12,1,2412,-50,-91,41,40:e3:d6:da:ba:25,20605553,136,55,20605417,20605553
2137,6,12,1,2412,-50,-91,41,40:e3:d6:da:ba:20,20641556,160,35843,20641396,20641556
2138,6,6,1,2412,-50,-91,41,40:e3:d6:da:ba:21,20641748,368,-176,20641380,20641748
2139,6,12,1,2412,-50,-91,41,40:e3:d6:da:ba:22,20642134,180,206,20641954,20642134
2140,6,12,1,2412,-50,-91,41,40:e3:d6:da:ba:23,20642367,184,49,20642183,20642367
2141,6,12,1,2412,-50,-91,41,40:e3:d6:da:ba:24,20642585,176,42,20642409,20642585
2142,6,12,1,2412,-50,-91,41,40:e3:d6:da:ba:25,20642787,160,42,20642627,20642787
2143,6,6,1,2412,-83,-91,8,e6:aa:ea:c9:ea:1b,20646737,408,3542,20646329,20646737
2144,6,6,1,2412,-82,-91,9,e6:aa:ea:c9:ea:1b,20670941,408,23796,20670533,20670941
2145,6,6,1,2412,-52,-91,39,e6:aa:ea:c9:ea:33,20679780,408,8431,20679372,20679780
2146,6,6,1,2412,-52,-91,39,e6:aa:ea:c9:ea:33,20691894,408,11706,20691486,20691894
2147,6,6,1,2412,-52,-91,39,e6:aa:ea:c9:ea:33,20707554,408,15252,20707146,20707554
2148,6,6,1,2412,-52,-91,39,e6:aa:ea:c9:ea:33,20716319,408,8357,20715911,20716319
2149,6,12,1,2412,-50,-91,41,40:e3:d6:da:ba:20,20743951,160,27472,20743791,20743951
2150,6,6,1,2412,-50,-91,41,40:e3:d6:da:ba:21,20744170,368,-149,20743802,20744170
2151,6,12,1,2412,-56,-91,35,40:e3:d6:da:ba:22,20744566,180,216,20744386,20744566
2152,6,12,1,2412,-56,-91,35,40:e3:d6:da:ba:25,20745237,160,511,20745077,20745237
2153,4,1,1,2412,-68,-91,23,54:e4:3a:ec:fb:64,20755104,2160,7707,20752944,20755104
2154,6,12,1,2412,-50,-91,41,40:e3:d6:da:ba:20,20846370,160,91106,20846210,20846370
2155,6,6,1,2412,-50,-91,41,40:e3:d6:da:ba:21,20846562,368,-176,20846194,20846562
2156,6,12,1,2412,-49,-91,42,40:e3:d6:da:ba:22,20846957,180,215,20846777,20846957
2157,6,12,1,2412,-50,-91,41,40:e3:d6:da:ba:23,20847172,184,31,20846988,20847172
2158,6,12,1,2412,-50,-91,41,40:e3:d6:da:ba:24,20847400,176,52,20847224,20847400
2159,6,12,1,2412,-50,-91,41,40:e3:d6:da:ba:25,20847610,160,50,20847450,20847610
2160,6,6,1,2412,-50,-91,41,40:e3:d6:da:ba:26,20847811,380,-179,20847431,20847811
2161,6,6,1,2412,-68,-91,23,e6:aa:ea:b7:4a:dd,20912579,408,64360,20912171,20912579
2162,6,6,1,2412,-67,-91,24,e6:aa:ea:b7:4a:dd,20924689,408,11702,20924281,20924689
2163,6,12,1,2412,-48,-91,43,40:e3:d6:da:ba:20,20948760,160,23911,20948600,20948760
2164,6,12,1,2412,-48,-91,43,40:e3:d6:da:ba:22,20949364,180,424,20949184,20949364
2165,6,12,1,2412,-48,-91,43,40:e3:d6:da:ba:23,20949579,184,31,20949395,20949579
2166,6,12,1,2412,-48,-91,43,40:e3:d6:da:ba:24,20949815,176,60,20949639,20949815
2167,6,12,1,2412,-48,-91,43,40:e3:d6:da:ba:25,20950035,160,60,20949875,20950035
2168,6,6,1,2412,-48,-91,43,40:e3:d6:da:ba:26,20950227,380,-188,20949847,20950227
2169,6,6,1,2412,-67,-91,24,e6:aa:ea:b7:4a:dd,20951719,408,1084,20951311,20951719
2170,4,1,1,2412,-66,-91,25,5a:ef:8a:64:62:1b,20982131,992,29420,20981139,20982131
2171,4,1,1,2412,-70,-91,21,54:e4:3a:ec:fb:64,20985521,2112,1278,20983409,20985521
2172,4,1,1,2412,-66,-91,25,,20987648,304,1823,20987344,20987648
2173,6,12,1,2412,-49,-91,42,40:e3:d6:da:ba:20,20987812,136,28,20987676,20987812
2174,6,12,1,2412,-67,-91,24,,20987966,32,122,20987934,20987966
2175,6,6,1,2412,-49,-91,42,40:e3:d6:da:ba:21,20988322,348,8,20987974,20988322
2176,6,12,1,2412,-49,-91,42,40:e3:d6:da:ba:20,21029316,136,40858,21029180,21029316
2177,6,6,1,2412,-49,-91,42,40:e3:d6:da:ba:21,21029511,348,-153,21029163,21029511
2178,6,12,1,2412,-49,-91,42,40:e3:d6:da:ba:22,21029905,156,238,21029749,21029905
2179,6,12,1,2412,-49,-91,42,40:e3:d6:da:ba:23,21030113,156,52,21029957,21030113
2180,6,12,1,2412,-49,-91,42,40:e3:d6:da:ba:25,21030322,136,73,21030186,21030322
2181,6,12,1,2412,-49,-91,42,40:e3:d6:da:ba:20,21049496,136,19038,21049360,21049496
2182,6,6,1,2412,-49,-91,42,40:e3:d6:da:ba:21,21049673,348,-171,21049325,21049673
2183,6,12,1,2412,-49,-91,42,40:e3:d6:da:ba:22,21050049,156,220,21049893,21050049
2184,6,12,1,2412,-49,-91,42,40:e3:d6:da:ba:23,21050248,156,43,21050092,21050248
2185,6,12,1,2412,-49,-91,42,40:e3:d6:da:ba:25,21050457,136,73,21050321,21050457
2186,6,12,1,2412,-49,-91,42,40:e3:d6:da:ba:20,21051167,160,550,21051007,21051167
2187,6,6,1,2412,-49,-91,42,40:e3:d6:da:ba:21,21051377,368,-158,21051009,21051377
2188,6,12,1,2412,-49,-91,42,40:e3:d6:da:ba:22,21051773,180,216,21051593,21051773
2189,6,12,1,2412,-49,-91,42,40:e3:d6:da:ba:23,21051988,184,31,21051804,21051988
2190,6,12,1,2412,-49,-91,42,40:e3:d6:da:ba:24,21052206,176,42,21052030,21052206
2191,6,12,1,2412,-49,-91,42,40:e3:d6:da:ba:25,21052435,160,69,21052275,21052435
2192,6,6,1,2412,-49,-91,42,40:e3:d6:da:ba:26,21052645,380,-170,21052265,21052645
2193,6,12,1,2412,-49,-91,42,40:e3:d6:da:ba:20,21077377,136,24596,21077241,21077377
2194,6,6,1,2412,-49,-91,42,40:e3:d6:da:ba:21,21077581,348,-144,21077233,21077581
2195,6,12,1,2412,-49,-91,42,40:e3:d6:da:ba:22,21077984,156,247,21077828,21077984
2196,6,12,1,2412,-49,-91,42,40:e3:d6:da:ba:23,21078202,156,62,21078046,21078202
2197,6,12,1,2412,-49,-91,42,40:e3:d6:da:ba:25,21078410,136,72,21078274,21078410
2198,6,12,1,2412,-49,-91,42,40:e3:d6:da:ba:20,21099508,136,20962,21099372,21099508
2199,6,6,1,2412,-49,-91,42,40:e3:d6:da:ba:21,21099702,348,-154,21099354,21099702
2200,6,12,1,2412,-49,-91,42,40:e3:d6:da:ba:22,21100096,156,238,21099940,21100096
2201,6,12,1,2412,-49,-91,42,40:e3:d6:da:ba:23,21100314,156,62,21100158,21100314
2202,6,12,1,2412,-49,-91,42,40:e3:d6:da:ba:25,21100522,136,72,21100386,21100522
2203,6,12,1,2412,-49,-91,42,40:e3:d6:da:ba:20,21153553,160,52871,21153393,21153553
2204,6,6,1,2412,-49,-91,42,40:e3:d6:da:ba:21,21153763,368,-158,21153395,21153763
2205,6,12,1,2412,-49,-91,42,40:e3:d6:da:ba:22,21154150,180,207,21153970,21154150
2206,6,12,1,2412,-49,-91,42,40:e3:d6:da:ba:23,21154383,184,49,21154199,21154383
2207,6,12,1,2412,-49,-91,42,40:e3:d6:da:ba:24,21154619,176,60,21154443,21154619
2208,6,12,1,2412,-49,-91,42,40:e3:d6:da:ba:25,21154821,160,42,21154661,21154821
2209,6,6,1,2412,-49,-91,42,40:e3:d6:da:ba:26,21155040,380,-161,21154660,21155040
2210,4,1,1,2412,-68,-91,23,54:e4:3a:ec:fb:64,21164700,2160,7500,21162540,21164700
2211,6,6,1,2412,-55,-91,36,e6:aa:ea:c9:ea:33,21199662,408,34554,21199254,21199662
2212,6,6,1,2412,-55,-91,36,e6:aa:ea:c9:ea:33,21223637,408,23567,21223229,21223637
2213,6,6,1,2412,-55,-91,36,e6:aa:ea:c9:ea:33,21235761,408,11716,21235353,21235761
2214,6,6,1,2412,-55,-91,36,e6:aa:ea:c9:ea:33,21249595,408,13426,21249187,21249595
2215,6,12,1,2412,-49,-91,42,40:e3:d6:da:ba:20,21255954,160,6199,21255794,21255954
2216,6,6,1,2412,-48,-91,43,40:e3:d6:da:ba:21,21256221,368,-101,21255853,21256221
2217,6,12,1,2412,-48,-91,43,40:e3:d6:da:ba:22,21256617,180,216,21256437,21256617
2218,6,12,1,2412,-48,-91,43,40:e3:d6:da:ba:23,21256867,184,66,21256683,21256867
2219,6,12,1,2412,-48,-91,43,40:e3:d6:da:ba:24,21257085,176,42,21256909,21257085
2220,6,12,1,2412,-48,-91,43,40:e3:d6:da:ba:25,21257296,160,51,21257136,21257296
2221,6,6,1,2412,-48,-91,43,40:e3:d6:da:ba:26,21257497,380,-179,21257117,21257497
2222,4,1,1,2412,-65,-91,26,54:e4:3a:ec:fb:64,21267099,2160,7442,21264939,21267099
2223,6,12,1,2412,-49,-91,42,40:e3:d6:da:ba:20,21294541,136,27306,21294405,21294541
2224,6,6,1,2412,-49,-91,42,40:e3:d6:da:ba:21,21294727,348,-162,21294379,21294727
2225,6,12,1,2412,-49,-91,42,40:e3:d6:da:ba:22,21295130,156,247,21294974,21295130
2226,6,12,1,2412,-49,-91,42,40:e3:d6:da:ba:23,21295321,156,35,21295165,21295321
2227,6,12,1,2412,-49,-91,42,40:e3:d6:da:ba:25,21295538,136,81,21295402,21295538
2228,6,6,1,2412,-69,-91,22,e6:aa:ea:b7:4a:dd,21342319,408,46373,21341911,21342319
2229,6,6,1,2412,-70,-91,21,e6:aa:ea:b7:4a:dd,21354430,408,11703,21354022,21354430
2230,6,12,1,2412,-50,-91,41,40:e3:d6:da:ba:20,21358357,160,3767,21358197,21358357
2231,6,6,1,2412,-50,-91,41,40:e3:d6:da:ba:21,21358549,368,-176,21358181,21358549
2232,6,12,1,2412,-49,-91,42,40:e3:d6:da:ba:22,21359036,180,307,21358856,21359036
2233,6,12,1,2412,-50,-91,41,40:e3:d6:da:ba:23,21359569,184,349,21359385,21359569
2234,6,12,1,2412,-49,-91,42,40:e3:d6:da:ba:24,21359778,176,33,21359602,21359778
2235,6,12,1,2412,-49,-91,42,40:e3:d6:da:ba:25,21361512,160,1574,21361352,21361512
2236,6,6,1,2412,-50,-91,41,40:e3:d6:da:ba:26,21361861,380,-31,21361481,21361861
2237,6,6,1,2412,-67,-91,24,e6:aa:ea:b7:4a:dd,21366546,408,4277,21366138,21366546
2238,4,1,1,2412,-60,-91,31,54:e4:3a:ec:fb:64,21369499,2160,793,21367339,21369499
2239,4,1,1,2412,-89,-91,2,b8:3a:5a:88:e6:e0,21371700,2360,-159,21369340,21371700
2240,6,6,1,2412,-71,-91,20,e6:aa:ea:b7:4a:dd,21378657,408,6549,21378249,21378657
2241,6,12,1,2412,-51,-91,40,40:e3:d6:da:ba:20,21460845,160,82028,21460685,21460845
2242,6,6,1,2412,-51,-91,40,40:e3:d6:da:ba:21,21461080,368,-133,21460712,21461080
2243,6,12,1,2412,-51,-91,40,40:e3:d6:da:ba:22,21461485,180,225,21461305,21461485
2244,6,12,1,2412,-51,-91,40,40:e3:d6:da:ba:23,21461708,184,39,21461524,21461708
2245,6,12,1,2412,-51,-91,40,40:e3:d6:da:ba:24,21461927,176,43,21461751,21461927
2246,6,12,1,2412,-51,-91,40,40:e3:d6:da:ba:25,21462128,160,41,21461968,21462128
2247,6,6,1,2412,-50,-91,41,40:e3:d6:da:ba:26,21462320,380,-188,21461940,21462320
2248,6,6,1,2412,-84,-91,7,e6:aa:ea:c9:ea:1b,21486130,408,23402,21485722,21486130
2249,6,6,1,2412,-84,-91,7,e6:aa:ea:c9:ea:1b,21522410,408,35872,21522002,21522410
2250,4,5.5,1,2412,-59,-91,32,48:74:12:82:d8:d5,21545230,443,22377,21544787,21545230
2251,4,5.5,1,2412,-65,-91,26,48:74:12:82:d8:d5,21549413,463,3720,21548950,21549413
2252,4,5.5,1,2412,-56,-91,35,48:74:12:82:d8:d5,21553013,473,3127,21552540,21553013
2253,4,5.5,1,2412,-71,-91,20,48:74:12:82:d8:d5,21554298,457,828,21553841,21554298
2254,4,5.5,1,2412,-73,-91,18,48:74:12:82:d8:d5,21555667,448,921,21555219,21555667
2255,4,5.5,1,2412,-72,-91,19,48:74:12:82:d8:d5,21557181,460,1054,21556721,21557181
2256,4,5.5,1,2412,-63,-91,28,48:74:12:82:d8:d5,21560515,466,2868,21560049,21560515
2257,6,12,1,2412,-51,-91,40,40:e3:d6:da:ba:20,21563750,160,3075,21563590,21563750
2258,6,6,1,2412,-51,-91,40,40:e3:d6:da:ba:21,21563969,368,-149,21563601,21563969
2259,6,12,1,2412,-51,-91,40,40:e3:d6:da:ba:22,21564374,180,225,21564194,21564374
2260,6,12,1,2412,-51,-91,40,40:e3:d6:da:ba:24,21564843,176,293,21564667,21564843
2261,6,12,1,2412,-51,-91,40,40:e3:d6:da:ba:25,21565063,160,60,21564903,21565063
2262,6,6,1,2412,-51,-91,40,40:e3:d6:da:ba:26,21565282,380,-161,21564902,21565282
2263,4,5.5,1,2412,-66,-91,25,48:74:12:82:d8:d5,21569439,456,3701,21568983,21569439
2264,4,5.5,1,2412,-72,-91,19,48:74:12:82:d8:d5,21573225,451,3335,21572774,21573225
2265,4,5.5,1,2412,-72,-91,19,48:74:12:82:d8:d5,21575128,453,1450,21574675,21575128
2266,6,12,1,2412,-49,-91,42,40:e3:d6:da:ba:20,21665559,160,90271,21665399,21665559
2267,6,6,1,2412,-49,-91,42,40:e3:d6:da:ba:21,21665750,368,-177,21665382,21665750
2268,6,12,1,2412,-49,-91,42,40:e3:d6:da:ba:22,21666155,180,225,21665975,21666155
2269,6,12,1,2412,-49,-91,42,40:e3:d6:da:ba:23,21666361,184,22,21666177,21666361
2270,6,12,1,2412,-49,-91,42,40:e3:d6:da:ba:24,21666588,176,51,21666412,21666588
2271,6,6,1,2412,-49,-91,42,40:e3:d6:da:ba:26,21667000,380,32,21666620,21667000
2272,4,1,1,2412,-62,-91,29,54:e4:3a:ec:fb:64,21676696,2160,7536,21674536,21676696
2273,4,1,1,2412,-85,-91,6,b8:3a:5a:88:e6:e1,21681354,2376,2282,21678978,21681354
2274,6,6,1,2412,-58,-91,33,e6:aa:ea:c9:ea:33,21719744,408,37982,21719336,21719744
2275,6,6,1,2412,-57,-91,34,e6:aa:ea:c9:ea:33,21732165,408,12013,21731757,21732165
2276,6,6,1,2412,-60,-91,31,e6:aa:ea:c9:ea:33,21743982,408,11409,21743574,21743982
2277,6,6,1,2412,-60,-91,31,e6:aa:ea:c9:ea:33,21756284,408,11894,21755876,21756284
2278,6,12,1,2412,-49,-91,42,40:e3:d6:da:ba:20,21767963,160,11519,21767803,21767963
2279,6,6,1,2412,-49,-91,42,40:e3:d6:da:ba:21,21768182,368,-149,21767814,21768182
2280,6,12,1,2412,-49,-91,42,40:e3:d6:da:ba:22,21768578,180,216,21768398,21768578
2281,6,6,1,2412,-61,-91,30,e6:aa:ea:c9:ea:33,21768808,408,-178,21768400,21768808
2282,6,12,1,2412,-49,-91,42,40:e3:d6:da:ba:23,21769236,184,244,21769052,21769236
2283,6,12,1,2412,-49,-91,42,40:e3:d6:da:ba:24,21769463,176,51,21769287,21769463
2284,6,12,1,2412,-49,-91,42,40:e3:d6:da:ba:25,21769683,160,60,21769523,21769683
2285,6,6,1,2412,-49,-91,42,40:e3:d6:da:ba:26,21769902,380,-161,21769522,21769902
2286,4,1,1,2412,-66,-91,25,54:e4:3a:ec:fb:64,21779094,2160,7032,21776934,21779094
2287,6,6,1,2412,-70,-91,21,e6:aa:ea:b7:4a:dd,21796445,408,16943,21796037,21796445
2288,4,1,1,2412,-87,-91,4,,21798829,304,2080,21798525,21798829
2289,6,6,1,2412,-81,-91,10,e6:aa:ea:c9:ea:1b,21804375,408,5138,21803967,21804375
2290,6,12,1,2412,-48,-91,43,40:e3:d6:da:ba:20,21870446,160,65911,21870286,21870446
2291,6,6,1,2412,-48,-91,43,40:e3:d6:da:ba:21,21870638,368,-176,21870270,21870638
2292,6,12,1,2412,-48,-91,43,40:e3:d6:da:ba:22,21871052,180,234,21870872,21871052
2293,6,12,1,2412,-48,-91,43,40:e3:d6:da:ba:23,21871276,184,40,21871092,21871276
2294,6,12,1,2412,-48,-91,43,40:e3:d6:da:ba:24,21871494,176,42,21871318,21871494
2295,6,12,1,2412,-48,-91,43,40:e3:d6:da:ba:25,21871696,160,42,21871536,21871696
2296,6,6,1,2412,-48,-91,43,40:e3:d6:da:ba:26,21871897,380,-179,21871517,21871897
2297,6,12,1,2412,-49,-91,42,40:e3:d6:da:ba:20,21972795,160,100738,21972635,21972795
2298,6,6,1,2412,-49,-91,42,40:e3:d6:da:ba:21,21973014,368,-149,21972646,21973014
2299,6,12,1,2412,-49,-91,42,40:e3:d6:da:ba:22,21973401,180,207,21973221,21973401
2300,6,12,1,2412,-48,-91,43,40:e3:d6:da:ba:23,21973615,184,30,21973431,21973615
2301,6,12,1,2412,-49,-91,42,40:e3:d6:da:ba:24,21973833,176,42,21973657,21973833
2302,6,12,1,2412,-49,-91,42,40:e3:d6:da:ba:25,21974053,160,60,21973893,21974053
2303,6,6,1,2412,-49,-91,42,40:e3:d6:da:ba:26,21974254,380,-179,21973874,21974254
2304,4,1,1,2412,-56,-91,35,54:e4:3a:ec:fb:64,21983894,2160,7480,21981734,21983894
2305,6,12,1,2412,-66,-91,25,84:d4:7e:d5:12:c0,22004077,960,19223,22003117,22004077
2306,4,1,1,2412,-88,-92,4,c0:c9:e3:4d:6e:bf,22074737,872,69788,22073865,22074737
2307,6,12,1,2412,-49,-92,43,40:e3:d6:da:ba:20,22075808,160,911,22075648,22075808
2308,6,6,1,2412,-48,-92,44,40:e3:d6:da:ba:21,22076008,368,-168,22075640,22076008
2309,6,12,1,2412,-49,-92,43,40:e3:d6:da:ba:22,22077719,180,1531,22077539,22077719
2310,6,12,1,2412,-48,-92,44,40:e3:d6:da:ba:23,22078097,184,194,22077913,22078097
2311,6,12,1,2412,-48,-92,44,40:e3:d6:da:ba:24,22078306,176,33,22078130,22078306
2312,6,12,1,2412,-48,-92,44,40:e3:d6:da:ba:25,22078517,160,51,22078357,22078517
2313,6,6,1,2412,-48,-92,44,40:e3:d6:da:ba:26,22078718,380,-179,22078338,22078718
2314,6,6,1,2412,-84,-92,8,e6:aa:ea:c9:ea:1b,22110504,408,31378,22110096,22110504
2315,6,6,1,2412,-86,-92,6,e6:aa:ea:c9:ea:1b,22122617,408,11705,22122209,22122617
2316,6,6,1,2412,-85,-92,7,e6:aa:ea:c9:ea:1b,22134738,408,11713,22134330,22134738
2317,6,6,1,2412,-85,-92,7,e6:aa:ea:c9:ea:1b,22159091,408,23945,22158683,22159091
2318,6,6,1,2412,-68,-92,24,e6:aa:ea:b7:4a:dd,22165553,408,6054,22165145,22165553
2319,6,12,1,2412,-49,-92,43,40:e3:d6:da:ba:20,22177558,160,11845,22177398,22177558
2320,6,6,1,2412,-49,-92,43,40:e3:d6:da:ba:21,22178127,368,201,22177759,22178127
2321,6,12,1,2412,-48,-92,44,40:e3:d6:da:ba:22,22178541,180,234,22178361,22178541
2322,6,12,1,2412,-48,-92,44,40:e3:d6:da:ba:23,22178773,184,48,22178589,22178773
2323,6,6,1,2412,-48,-92,44,40:e3:d6:da:ba:26,22179476,380,323,22179096,22179476
2324,6,6,1,2412,-68,-92,24,e6:aa:ea:b7:4a:dd,22189795,408,9911,22189387,22189795
2325,4,1,1,2412,-61,-92,31,54:e4:3a:ec:fb:64,22190393,2160,-1562,22188233,22190393
2326,6,6,1,2412,-67,-92,25,e6:aa:ea:b7:4a:dd,22214035,408,23234,22213627,22214035
2327,6,6,1,2412,-55,-92,37,e6:aa:ea:c9:ea:33,22239530,408,25087,22239122,22239530
2328,6,6,1,2412,-55,-92,37,e6:aa:ea:c9:ea:33,22251721,408,11783,22251313,22251721
2329,4,1,1,2412,-86,-92,6,a6:e5:7c:28:b1:d3,22253749,992,1036,22252757,22253749
2330,6,6,1,2412,-54,-92,38,e6:aa:ea:c9:ea:33,22263826,408,9669,22263418,22263826
2331,6,6,1,2412,-55,-92,37,e6:aa:ea:c9:ea:33,22275885,408,11651,22275477,22275885
2332,6,12,1,2412,-49,-92,43,40:e3:d6:da:ba:20,22280015,160,3970,22279855,22280015
2333,6,6,1,2412,-49,-92,43,40:e3:d6:da:ba:21,22280216,368,-167,22279848,22280216
2334,6,12,1,2412,-49,-92,43,40:e3:d6:da:ba:22,22280630,180,234,22280450,22280630
2335,6,12,1,2412,-49,-92,43,40:e3:d6:da:ba:23,22280835,184,21,22280651,22280835
2336,6,12,1,2412,-49,-92,43,40:e3:d6:da:ba:24,22281063,176,52,22280887,22281063
2337,6,12,1,2412,-49,-92,43,40:e3:d6:da:ba:25,22281273,160,50,22281113,22281273
2338,6,6,1,2412,-49,-92,43,40:e3:d6:da:ba:26,22281492,380,-161,22281112,22281492
2339,6,6,1,2412,-55,-92,37,e6:aa:ea:c9:ea:33,22288096,408,6196,22287688,22288096
2340,4,1,1,2412,-86,-92,6,a4:e5:7c:28:b1:d3,22295986,688,7202,22295298,22295986
2341,4,1,1,2412,-86,-92,6,a6:e5:7c:28:b1:d3,22356010,992,59032,22355018,22356010
2342,6,12,1,2412,-50,-92,42,40:e3:d6:da:ba:20,22382367,160,26197,22382207,22382367
2343,6,6,1,2412,-50,-92,42,40:e3:d6:da:ba:21,22382559,368,-176,22382191,22382559
2344,6,12,1,2412,-50,-92,42,40:e3:d6:da:ba:22,22382973,180,234,22382793,22382973
2345,6,12,1,2412,-50,-92,42,40:e3:d6:da:ba:23,22383187,184,30,22383003,22383187
2346,6,12,1,2412,-50,-92,42,40:e3:d6:da:ba:24,22383397,176,34,22383221,22383397
2347,6,12,1,2412,-50,-92,42,40:e3:d6:da:ba:25,22383607,160,50,22383447,22383607
2348,6,6,1,2412,-50,-92,42,40:e3:d6:da:ba:26,22383817,380,-170,22383437,22383817
2349,4,1,1,2412,-61,-92,31,54:e4:3a:ec:fb:64,22393490,2160,7513,22391330,22393490
2350,4,1,1,2412,-86,-92,6,b8:3a:5a:88:e6:e0,22395692,2360,-158,22393332,22395692
2351,4,1,1,2412,-84,-92,8,b8:3a:5a:88:e6:e1,22399042,2376,974,22396666,22399042
2352,6,6,1,2412,-83,-92,9,e6:aa:ea:c9:ea:1b,22427463,408,28013,22427055,22427463
2353,6,6,1,2412,-84,-92,8,e6:aa:ea:c9:ea:1b,22439593,408,11722,22439185,22439593
2354,6,6,1,2412,-83,-92,9,e6:aa:ea:c9:ea:1b,22463821,408,23820,22463413,22463821
2355,6,6,1,2412,-66,-92,26,e6:aa:ea:b7:4a:dd,22480302,408,16073,22479894,22480302
2356,6,12,1,2412,-51,-92,41,40:e3:d6:da:ba:20,22484763,160,4301,22484603,22484763
2357,6,6,1,2412,-50,-92,42,40:e3:d6:da:ba:21,22484964,368,-167,22484596,22484964
2358,6,12,1,2412,-50,-92,42,40:e3:d6:da:ba:22,22485369,180,225,22485189,22485369
2359,6,12,1,2412,-50,-92,42,40:e3:d6:da:ba:23,22485584,184,31,22485400,22485584
2360,6,12,1,2412,-50,-92,42,40:e3:d6:da:ba:24,22485811,176,51,22485635,22485811
2361,6,12,1,2412,-50,-92,42,40:e3:d6:da:ba:25,22486013,160,42,22485853,22486013
2362,6,6,1,2412,-50,-92,42,40:e3:d6:da:ba:26,22486213,380,-180,22485833,22486213
2363,4,1,1,2412,-61,-92,31,54:e4:3a:ec:fb:64,22495888,2160,7515,22493728,22495888
2364,6,6,1,2412,-67,-92,25,e6:aa:ea:b7:4a:dd,22504538,408,8242,22504130,22504538
2365,6,6,1,2412,-61,-92,31,e6:aa:ea:b7:4a:dd,22516653,408,11707,22516245,22516653
2366,4,1,1,2412,-57,-92,35,62:b0:c8:8e:5e:7b,22523537,1504,5380,22522033,22523537
2367,6,12,1,2412,-51,-92,41,40:e3:d6:da:ba:23,22525045,156,1352,22524889,22525045
2368,6,12,1,2412,-60,-92,32,,22525218,32,141,22525186,22525218
2369,6,6,1,2412,-54,-92,38,e6:aa:ea:c9:ea:33,22554360,408,28734,22553952,22554360
2370,4,1,1,2412,-88,-92,4,c0:c9:e3:4d:6e:bf,22571544,872,16312,22570672,22571544
2371,6,6,1,2412,-56,-92,36,e6:aa:ea:c9:ea:33,22578597,408,6645,22578189,22578597
2372,4,1,1,2412,-57,-92,35,62:b0:c8:8e:5e:7b,22579289,1504,-812,22577785,22579289
2373,6,12,1,2412,-51,-92,41,40:e3:d6:da:ba:23,22580778,156,1333,22580622,22580778
2374,6,12,1,2412,-60,-92,32,,22580951,32,141,22580919,22580951
2375,6,12,1,2412,-51,-92,41,40:e3:d6:da:ba:20,22587725,160,6614,22587565,22587725
2376,6,6,1,2412,-51,-92,41,40:e3:d6:da:ba:21,22587917,368,-176,22587549,22587917
2377,6,12,1,2412,-50,-92,42,40:e3:d6:da:ba:22,22588313,180,216,22588133,22588313
2378,6,12,1,2412,-50,-92,42,40:e3:d6:da:ba:23,22588527,184,30,22588343,22588527
2379,6,12,1,2412,-50,-92,42,40:e3:d6:da:ba:24,22588754,176,51,22588578,22588754
2380,6,12,1,2412,-50,-92,42,40:e3:d6:da:ba:25,22588965,160,51,22588805,22588965
2381,6,6,1,2412,-51,-92,41,40:e3:d6:da:ba:26,22591476,380,2131,22591096,22591476
2382,4,1,1,2412,-61,-92,31,54:e4:3a:ec:fb:64,22598288,2160,4652,22596128,22598288
2383,6,6,1,2412,-54,-92,38,e6:aa:ea:c9:ea:33,22602832,408,4136,22602424,22602832
2384,4,1,1,2412,-74,-92,18,b8:3a:5a:88:e6:e0,22646201,2240,41129,22643961,22646201
2385,6,12,1,2412,-50,-92,42,40:e3:d6:da:ba:20,22689561,160,43200,22689401,22689561
2386,6,6,1,2412,-50,-92,42,40:e3:d6:da:ba:21,22689771,368,-158,22689403,22689771
2387,6,12,1,2412,-50,-92,42,40:e3:d6:da:ba:22,22690185,180,234,22690005,22690185
2388,6,12,1,2412,-50,-92,42,40:e3:d6:da:ba:23,22690390,184,21,22690206,22690390
2389,6,12,1,2412,-50,-92,42,40:e3:d6:da:ba:24,22690618,176,52,22690442,22690618
2390,6,12,1,2412,-50,-92,42,40:e3:d6:da:ba:25,22690819,160,41,22690659,22690819
2391,6,6,1,2412,-50,-92,42,40:e3:d6:da:ba:26,22692539,380,1340,22692159,22692539
2392,4,1,1,2412,-60,-92,32,54:e4:3a:ec:fb:64,22700688,2160,5989,22698528,22700688
2393,4,1,1,2412,-83,-92,9,b8:3a:5a:88:e6:e0,22703213,2360,165,22700853,22703213
2394,6,12,1,2412,-50,-92,42,40:e3:d6:da:ba:20,22791983,160,88610,22791823,22791983
2395,6,6,1,2412,-50,-92,42,40:e3:d6:da:ba:21,22792175,368,-176,22791807,22792175
2396,6,12,1,2412,-49,-92,43,40:e3:d6:da:ba:22,22792562,180,207,22792382,22792562
2397,6,12,1,2412,-49,-92,43,40:e3:d6:da:ba:23,22792785,184,39,22792601,22792785
2398,6,12,1,2412,-49,-92,43,40:e3:d6:da:ba:24,22792995,176,34,22792819,22792995
2399,6,12,1,2412,-49,-92,43,40:e3:d6:da:ba:25,22793214,160,59,22793054,22793214
2400,6,6,1,2412,-49,-92,43,40:e3:d6:da:ba:26,22793415,380,-179,22793035,22793415
2401,6,6,1,2412,-67,-92,25,e6:aa:ea:b7:4a:dd,22795691,408,1868,22795283,22795691
2402,6,6,1,2412,-67,-92,25,e6:aa:ea:b7:4a:dd,22807795,408,11696,22807387,22807795
2403,6,6,1,2412,-84,-92,8,e6:aa:ea:c9:ea:1b,22884366,408,76163,22883958,22884366
2404,6,12,1,2412,-49,-92,43,40:e3:d6:da:ba:20,22894376,160,9850,22894216,22894376
2405,6,6,1,2412,-49,-92,43,40:e3:d6:da:ba:21,22894577,368,-167,22894209,22894577
2406,6,12,1,2412,-49,-92,43,40:e3:d6:da:ba:22,22894991,180,234,22894811,22894991
2407,6,12,1,2412,-49,-92,43,40:e3:d6:da:ba:23,22895211,184,36,22895027,22895211
2408,6,12,1,2412,-49,-92,43,40:e3:d6:da:ba:24,22895448,176,61,22895272,22895448
2409,6,12,1,2412,-49,-92,43,40:e3:d6:da:ba:25,22895676,160,68,22895516,22895676
2410,6,6,1,2412,-49,-92,43,40:e3:d6:da:ba:26,22895895,380,-161,22895515,22895895
2411,4,1,1,2412,-57,-92,35,54:e4:3a:ec:fb:64,22905485,2160,7430,22903325,22905485
2412,4,1,1,2412,-75,-92,17,b8:3a:5a:88:e6:e0,22907992,2360,147,22905632,22907992
2413,4,5.5,1,2412,-86,-92,6,,22916296,213,8091,22916083,22916296
2414,6,12,1,2412,-49,-92,43,40:e3:d6:da:ba:20,22916369,136,-63,22916233,22916369
2415,6,6,1,2412,-49,-92,43,40:e3:d6:da:ba:21,22916573,348,-144,22916225,22916573
2416,6,12,1,2412,-49,-92,43,40:e3:d6:da:ba:22,22916958,156,229,22916802,22916958
2417,6,12,1,2412,-49,-92,43,40:e3:d6:da:ba:23,22917157,156,43,22917001,22917157
2418,4,1,1,2412,-85,-92,7,a6:e5:7c:28:b1:d3,22917499,944,-602,22916555,22917499
2419,6,12,1,2412,-49,-92,43,40:e3:d6:da:ba:25,22918888,136,1253,22918752,22918888
2420,6,6,1,2412,-48,-92,44,40:e3:d6:da:ba:21,22996998,368,77742,22996630,22996998
2421,6,12,1,2412,-48,-92,44,40:e3:d6:da:ba:22,22997394,180,216,22997214,22997394
2422,6,12,1,2412,-48,-92,44,40:e3:d6:da:ba:23,22997609,184,31,22997425,22997609
2423,6,12,1,2412,-48,-92,44,40:e3:d6:da:ba:24,22997818,176,33,22997642,22997818
2424,6,12,1,2412,-48,-92,44,40:e3:d6:da:ba:25,22998019,160,41,22997859,22998019
2425,6,6,1,2412,-48,-92,44,40:e3:d6:da:ba:26,22998211,380,-188,22997831,22998211
2426,4,1,1,2412,-83,-91,8,ce:3b:69:98:39:4b,23039859,1504,40144,23038355,23039859
2427,6,12,1,2412,-48,-91,43,40:e3:d6:da:ba:23,23041544,156,1529,23041388,23041544
2428,4,1,1,2412,-62,-91,29,c0:c9:e3:4d:6e:bf,23062705,872,20289,23061833,23062705
2429,6,6,1,2412,-55,-91,36,e6:aa:ea:c9:ea:33,23076952,408,13839,23076544,23076952
2430,6,6,1,2412,-55,-91,36,e6:aa:ea:c9:ea:33,23091155,408,13795,23090747,23091155
2431,6,12,1,2412,-48,-91,43,40:e3:d6:da:ba:20,23099178,160,7863,23099018,23099178
2432,6,6,1,2412,-47,-91,44,40:e3:d6:da:ba:21,23099388,368,-158,23099020,23099388
2433,6,12,1,2412,-47,-91,44,40:e3:d6:da:ba:22,23099802,180,234,23099622,23099802
2434,6,12,1,2412,-47,-91,44,40:e3:d6:da:ba:23,23100016,184,30,23099832,23100016
2435,6,12,1,2412,-47,-91,44,40:e3:d6:da:ba:24,23100244,176,52,23100068,23100244
2436,6,12,1,2412,-47,-91,44,40:e3:d6:da:ba:25,23100445,160,41,23100285,23100445
2437,6,6,1,2412,-47,-91,44,40:e3:d6:da:ba:26,23100637,380,-188,23100257,23100637
2438,6,6,1,2412,-55,-91,36,e6:aa:ea:c9:ea:33,23101330,408,285,23100922,23101330
2439,4,1,1,2412,-60,-91,31,54:e4:3a:ec:fb:64,23110283,2160,6793,23108123,23110283
2440,6,6,1,2412,-55,-91,36,e6:aa:ea:c9:ea:33,23113333,408,2642,23112925,23113333
2441,4,1,1,2412,-49,-91,42,b8:3a:5a:88:e6:e1,23114735,2376,-974,23112359,23114735
2442,6,6,1,2412,-55,-91,36,e6:aa:ea:c9:ea:33,23125581,408,10438,23125173,23125581
2443,6,12,1,2412,-47,-91,44,40:e3:d6:da:ba:20,23201571,160,75830,23201411,23201571
2444,6,6,1,2412,-47,-91,44,40:e3:d6:da:ba:21,23201772,368,-167,23201404,23201772
2445,6,12,1,2412,-47,-91,44,40:e3:d6:da:ba:22,23202159,180,207,23201979,23202159
2446,6,12,1,2412,-47,-91,44,40:e3:d6:da:ba:23,23202365,184,22,23202181,23202365
2447,6,12,1,2412,-47,-91,44,40:e3:d6:da:ba:24,23202601,176,60,23202425,23202601
2448,6,12,1,2412,-47,-91,44,40:e3:d6:da:ba:25,23202829,160,68,23202669,23202829
2449,6,6,1,2412,-47,-91,44,40:e3:d6:da:ba:26,23203031,380,-178,23202651,23203031
2450,6,6,1,2412,-67,-91,24,e6:aa:ea:b7:4a:dd,23262601,408,59162,23262193,23262601
2451,6,12,1,2412,-47,-91,44,40:e3:d6:da:ba:20,23303984,160,41223,23303824,23303984
2452,6,6,1,2412,-47,-91,44,40:e3:d6:da:ba:21,23304194,368,-158,23303826,23304194
2453,6,12,1,2412,-47,-91,44,40:e3:d6:da:ba:22,23304608,180,234,23304428,23304608
2454,6,12,1,2412,-47,-91,44,40:e3:d6:da:ba:23,23304841,184,49,23304657,23304841
2455,6,12,1,2412,-47,-91,44,40:e3:d6:da:ba:24,23305068,176,51,23304892,23305068
2456,6,12,1,2412,-47,-91,44,40:e3:d6:da:ba:25,23305279,160,51,23305119,23305279
2457,6,6,1,2412,-47,-91,44,40:e3:d6:da:ba:26,23305480,380,-179,23305100,23305480
2458,4,1,1,2412,-59,-91,32,54:e4:3a:ec:fb:64,23316212,2160,8572,23314052,23316212
2459,4,1,1,2412,-84,-91,7,b8:3a:5a:88:e6:e0,23330451,2240,11999,23328211,23330451
2460,6,12,1,2412,-47,-91,44,40:e3:d6:da:ba:20,23406364,160,75753,23406204,23406364
2461,6,6,1,2412,-47,-91,44,40:e3:d6:da:ba:21,23406583,368,-149,23406215,23406583
2462,6,12,1,2412,-47,-91,44,40:e3:d6:da:ba:22,23406997,180,234,23406817,23406997
2463,6,12,1,2412,-47,-91,44,40:e3:d6:da:ba:23,23407220,184,39,23407036,23407220
2464,6,12,1,2412,-47,-91,44,40:e3:d6:da:ba:24,23407448,176,52,23407272,23407448
2465,6,12,1,2412,-47,-91,44,40:e3:d6:da:ba:25,23407658,160,50,23407498,23407658
2466,6,6,1,2412,-47,-91,44,40:e3:d6:da:ba:26,23407850,380,-188,23407470,23407850
2467,4,1,1,2412,-61,-91,30,54:e4:3a:ec:fb:64,23417480,2160,7470,23415320,23417480
2468,6,12,1,2412,-47,-91,44,40:e3:d6:da:ba:22,23509405,180,91745,23509225,23509405
2469,6,12,1,2412,-47,-91,44,40:e3:d6:da:ba:24,23509882,176,301,23509706,23509882
2470,6,12,1,2412,-57,-91,34,40:e3:d6:da:ba:25,23510084,160,42,23509924,23510084
2471,4,1,1,2412,-51,-91,40,54:e4:3a:ec:fb:64,23519880,2160,7636,23517720,23519880
2472,4,1,1,2412,-86,-91,5,c0:c9:e3:4d:6e:bf,23558107,872,37355,23557235,23558107
2473,6,6,1,2412,-57,-91,34,e6:aa:ea:c9:ea:33,23596366,408,37851,23595958,23596366
2474,6,6,1,2412,-57,-91,34,e6:aa:ea:c9:ea:33,23609389,408,12615,23608981,23609389
2475,6,12,1,2412,-47,-91,44,40:e3:d6:da:ba:20,23611173,160,1624,23611013,23611173
2476,6,6,1,2412,-46,-91,45,40:e3:d6:da:ba:21,23611374,368,-167,23611006,23611374
2477,6,12,1,2412,-47,-91,44,40:e3:d6:da:ba:22,23611886,180,332,23611706,23611886
2478,6,12,1,2412,-47,-91,44,40:e3:d6:da:ba:23,23612091,184,21,23611907,23612091
2479,4,1,1,2412,-58,-91,33,02:aa:a8:dc:6d:d1,23612459,1152,-784,23611307,23612459
2480,6,12,1,2412,-46,-91,45,40:e3:d6:da:ba:24,23613627,176,992,23613451,23613627
2481,6,12,1,2412,-47,-91,44,40:e3:d6:da:ba:25,23613846,160,59,23613686,23613846
2482,6,6,1,2412,-47,-91,44,40:e3:d6:da:ba:26,23614038,380,-188,23613658,23614038
2483,6,6,1,2412,-57,-91,34,e6:aa:ea:c9:ea:33,23620616,408,6170,23620208,23620616
2484,4,1,1,2412,-61,-91,30,54:e4:3a:ec:fb:64,23622280,2160,-496,23620120,23622280
2485,4,1,1,2412,-58,-91,33,02:aa:a8:dc:6d:d1,23633555,1152,10123,23632403,23633555
2486,6,12,1,2412,-47,-91,44,40:e3:d6:da:ba:20,23634667,136,976,23634531,23634667
2487,6,6,1,2412,-47,-91,44,40:e3:d6:da:ba:21,23634844,348,-171,23634496,23634844
2488,6,12,1,2412,-47,-91,44,40:e3:d6:da:ba:22,23635238,156,238,23635082,23635238
2489,6,12,1,2412,-47,-91,44,40:e3:d6:da:ba:23,23635428,156,34,23635272,23635428
2490,6,12,1,2412,-47,-91,44,40:e3:d6:da:ba:25,23635986,136,422,23635850,23635986
2491,6,6,1,2412,-57,-91,34,e6:aa:ea:c9:ea:33,23644856,408,8462,23644448,23644856
2492,4,1,1,2412,-75,-91,16,a6:e5:7c:28:b1:d3,23681895,944,36095,23680951,23681895
2493,4,1,1,2412,-83,-91,8,a6:e5:7c:28:b1:d3,23684262,944,1423,23683318,23684262
2494,4,1,1,2412,-87,-91,4,a6:e5:7c:28:b1:d3,23690775,944,5569,23689831,23690775
2495,4,1,1,2412,-87,-91,4,a6:e5:7c:28:b1:d3,23691826,944,107,23690882,23691826
2496,6,12,1,2412,-47,-91,44,40:e3:d6:da:ba:20,23713587,160,21601,23713427,23713587
2497,6,6,1,2412,-47,-91,44,40:e3:d6:da:ba:21,23713806,368,-149,23713438,23713806
2498,6,12,1,2412,-47,-91,44,40:e3:d6:da:ba:22,23714220,180,234,23714040,23714220
2499,6,12,1,2412,-47,-91,44,40:e3:d6:da:ba:23,23714425,184,21,23714241,23714425
2500,6,12,1,2412,-47,-91,44,40:e3:d6:da:ba:24,23714653,176,52,23714477,23714653
2501,6,12,1,2412,-47,-91,44,40:e3:d6:da:ba:25,23714854,160,41,23714694,23714854
2502,6,6,1,2412,-47,-91,44,40:e3:d6:da:ba:26,23715073,380,-161,23714693,23715073
2503,4,1,1,2412,-60,-91,31,54:e4:3a:ec:fb:64,23724679,2160,7446,23722519,23724679
2504,6,6,1,2412,-67,-91,24,e6:aa:ea:b7:4a:dd,23733761,408,8674,23733353,23733761
2505,6,6,1,2412,-66,-91,25,e6:aa:ea:b7:4a:dd,23757989,408,23820,23757581,23757989
2506,6,12,1,2412,-47,-91,44,40:e3:d6:da:ba:20,23767452,136,9327,23767316,23767452
2507,6,6,1,2412,-47,-91,44,40:e3:d6:da:ba:21,23767647,348,-153,23767299,23767647
2508,6,12,1,2412,-47,-91,44,40:e3:d6:da:ba:22,23768066,156,263,23767910,23768066
2509,6,12,1,2412,-47,-91,44,40:e3:d6:da:ba:23,23768281,156,59,23768125,23768281
2510,6,12,1,2412,-47,-91,44,40:e3:d6:da:ba:25,23768514,136,97,23768378,23768514
2511,6,6,1,2412,-67,-91,24,e6:aa:ea:b7:4a:dd,23782275,408,13353,23781867,23782275
2512,6,6,1,2412,-86,-91,5,e6:aa:ea:c9:ea:1b,23815209,408,32526,23814801,23815209
2513,6,12,1,2412,-47,-91,44,40:e3:d6:da:ba:20,23815978,160,609,23815818,23815978
2514,6,6,1,2412,-47,-91,44,40:e3:d6:da:ba:21,23816170,368,-176,23815802,23816170
2515,6,12,1,2412,-47,-91,44,40:e3:d6:da:ba:22,23816607,180,257,23816427,23816607
2516,6,6,1,2412,-47,-91,44,40:e3:d6:da:ba:26,23817551,380,564,23817171,23817551
2517,4,1,1,2412,-60,-91,31,54:e4:3a:ec:fb:64,23827090,2160,7379,23824930,23827090
2518,6,12,1,2412,-48,-91,43,40:e3:d6:da:ba:20,23918543,160,91293,23918383,23918543
2519,6,6,1,2412,-47,-91,44,40:e3:d6:da:ba:21,23918753,368,-158,23918385,23918753
2520,6,12,1,2412,-47,-91,44,40:e3:d6:da:ba:22,23919140,180,207,23918960,23919140
2521,6,12,1,2412,-47,-91,44,40:e3:d6:da:ba:23,23919346,184,22,23919162,23919346
2522,6,12,1,2412,-47,-91,44,40:e3:d6:da:ba:24,23919564,176,42,23919388,23919564
2523,6,12,1,2412,-47,-91,44,40:e3:d6:da:ba:25,23919784,160,60,23919624,23919784
2524,6,6,1,2412,-47,-91,44,40:e3:d6:da:ba:26,23920003,380,-161,23919623,23920003
2525,4,1,1,2412,-58,-91,33,46:12:17:e8:66:2a,23951976,1152,30821,23950824,23951976
2526,6,12,1,2412,-49,-91,42,40:e3:d6:da:ba:25,23954182,136,2070,23954046,23954182
2527,4,1,1,2412,-55,-91,36,54:e4:3a:ec:fb:64,23956130,2112,-164,23954018,23956130
2528,4,1,1,2412,-61,-91,30,54:e4:3a:ec:fb:64,23959796,2112,1554,23957684,23959796
2529,4,1,1,2412,-58,-91,33,54:e4:3a:ec:fb:64,23962061,2112,153,23959949,23962061
2530,4,1,1,2412,-60,-91,31,,23964185,304,1820,23963881,23964185
2531,4,1,1,2412,-60,-91,31,46:12:17:e8:66:2a,23972965,1152,7628,23971813,23972965
2532,4,1,1,2412,-61,-91,30,54:e4:3a:ec:fb:64,23974255,2112,-822,23972143,23974255
2533,4,1,1,2412,-58,-91,33,,23976380,304,1821,23976076,23976380
2534,6,12,1,2412,-48,-91,43,40:e3:d6:da:ba:20,23976544,136,28,23976408,23976544
2535,6,12,1,2412,-61,-91,30,,23976696,32,120,23976664,23976696
2536,6,6,1,2412,-47,-91,44,40:e3:d6:da:ba:21,23976788,348,-256,23976440,23976788
2537,6,6,1,2412,-61,-91,30,,23977153,44,321,23977109,23977153
2538,6,12,1,2412,-48,-91,43,40:e3:d6:da:ba:22,23977243,156,-66,23977087,23977243
2539,6,12,1,2412,-61,-91,30,,23977416,32,141,23977384,23977416
2540,6,12,1,2412,-47,-91,44,40:e3:d6:da:ba:23,23977510,156,-62,23977354,23977510
2541,6,12,1,2412,-62,-91,29,,23977683,32,141,23977651,23977683
2542,6,12,1,2412,-47,-91,44,40:e3:d6:da:ba:25,23977749,136,-70,23977613,23977749
2543,6,12,1,2412,-60,-91,31,,23977902,32,121,23977870,23977902
2544,4,1,1,2412,-50,-91,41,b8:3a:5a:88:e6:e1,23996577,2256,16419,23994321,23996577
2545,6,6,1,2412,-56,-91,35,e6:aa:ea:c9:ea:33,24013283,408,16298,24012875,24013283
2546,6,12,1,2412,-48,-91,43,40:e3:d6:da:ba:20,24020767,160,7324,24020607,24020767
2547,6,6,1,2412,-48,-91,43,40:e3:d6:da:ba:21,24020986,368,-149,24020618,24020986
2548,6,12,1,2412,-48,-91,43,40:e3:d6:da:ba:22,24021391,180,225,24021211,24021391
2549,6,12,1,2412,-49,-91,42,40:e3:d6:da:ba:25,24022051,160,500,24021891,24022051
2550,6,6,1,2412,-47,-91,44,40:e3:d6:da:ba:26,24022258,380,-173,24021878,24022258
2551,4,1,1,2412,-87,-91,4,c0:c9:e3:4d:6e:bf,24048616,872,25486,24047744,24048616
2552,6,6,1,2412,-63,-91,28,e6:aa:ea:c9:ea:33,24049640,408,616,24049232,24049640
2553,6,6,1,2412,-63,-91,28,e6:aa:ea:c9:ea:33,24061856,408,11808,24061448,24061856
2554,6,6,1,2412,-84,-91,7,e6:aa:ea:c9:ea:1b,24119807,408,57543,24119399,24119807
2555,6,6,1,2412,-46,-91,45,40:e3:d6:da:ba:21,24123379,368,3204,24123011,24123379
2556,6,12,1,2412,-48,-91,43,40:e3:d6:da:ba:22,24123766,180,207,24123586,24123766
2557,6,12,1,2412,-48,-91,43,40:e3:d6:da:ba:23,24123986,184,36,24123802,24123986
2558,6,12,1,2412,-48,-91,43,40:e3:d6:da:ba:24,24124205,176,43,24124029,24124205
2559,6,6,1,2412,-84,-91,7,e6:aa:ea:c9:ea:1b,24131929,408,7316,24131521,24131929
2560,4,1,1,2412,-61,-91,30,54:e4:3a:ec:fb:64,24134274,2160,185,24132114,24134274
2561,4,1,1,2412,-86,-91,5,b8:3a:5a:88:e6:e1,24138928,2376,2278,24136552,24138928
2562,6,6,1,2412,-78,-91,13,e6:aa:ea:c9:ea:1b,24156166,408,16830,24155758,24156166
2563,6,12,1,2412,-49,-91,42,40:e3:d6:da:ba:20,24225643,160,69317,24225483,24225643
2564,6,6,1,2412,-49,-91,42,40:e3:d6:da:ba:21,24225853,368,-158,24225485,24225853
2565,6,12,1,2412,-49,-91,42,40:e3:d6:da:ba:22,24226240,180,207,24226060,24226240
2566,6,12,1,2412,-49,-91,42,40:e3:d6:da:ba:23,24226473,184,49,24226289,24226473
2567,6,12,1,2412,-49,-91,42,40:e3:d6:da:ba:24,24226700,176,51,24226524,24226700
2568,6,12,1,2412,-49,-91,42,40:e3:d6:da:ba:25,24226911,160,51,24226751,24226911
2569,6,6,1,2412,-49,-91,42,40:e3:d6:da:ba:26,24227146,380,-145,24226766,24227146
2570,4,1,1,2412,-61,-91,30,54:e4:3a:ec:fb:64,24236674,2160,7368,24234514,24236674
2571,6,6,1,2412,-68,-91,23,e6:aa:ea:b7:4a:dd,24279457,408,42375,24279049,24279457
2572,6,6,1,2412,-68,-91,23,e6:aa:ea:b7:4a:dd,24303878,408,24013,24303470,24303878
2573,6,12,1,2412,-51,-91,40,40:e3:d6:da:ba:20,24328144,160,24106,24327984,24328144
2574,6,6,1,2412,-51,-91,40,40:e3:d6:da:ba:21,24328354,368,-158,24327986,24328354
2575,6,12,1,2412,-51,-91,40,40:e3:d6:da:ba:22,24328769,180,235,24328589,24328769
2576,6,12,1,2412,-51,-91,40,40:e3:d6:da:ba:24,24329432,176,487,24329256,24329432
2577,6,12,1,2412,-51,-91,40,40:e3:d6:da:ba:25,24329642,160,50,24329482,24329642
2578,4,1,1,2412,-60,-91,31,54:e4:3a:ec:fb:64,24339109,2160,7307,24336949,24339109
2579,6,6,1,2412,-52,-91,39,e6:aa:ea:c9:ea:33,24352691,408,13174,24352283,24352691
2580,6,6,1,2412,-52,-91,39,e6:aa:ea:c9:ea:33,24364794,408,11695,24364386,24364794
2581,6,6,1,2412,-56,-91,35,e6:aa:ea:c9:ea:33,24376914,408,11712,24376506,24376914
2582,6,12,1,2412,-51,-91,40,40:e3:d6:da:ba:20,24430369,160,53295,24430209,24430369
2583,6,6,1,2412,-51,-91,40,40:e3:d6:da:ba:21,24430588,368,-149,24430220,24430588
2584,6,12,1,2412,-50,-91,41,40:e3:d6:da:ba:22,24430975,180,207,24430795,24430975
2585,6,12,1,2412,-51,-91,40,40:e3:d6:da:ba:23,24431190,184,31,24431006,24431190
2586,6,12,1,2412,-51,-91,40,40:e3:d6:da:ba:24,24431426,176,60,24431250,24431426
2587,6,12,1,2412,-51,-91,40,40:e3:d6:da:ba:25,24431655,160,69,24431495,24431655
2588,6,6,1,2412,-50,-91,41,40:e3:d6:da:ba:26,24431865,380,-170,24431485,24431865
2589,6,6,1,2412,-83,-91,8,e6:aa:ea:c9:ea:1b,24461922,408,29649,24461514,24461922
2590,6,6,1,2412,-82,-91,9,e6:aa:ea:c9:ea:1b,24474047,408,11717,24473639,24474047
2591,6,6,1,2412,-50,-91,41,40:e3:d6:da:ba:21,24534045,368,59630,24533677,24534045
2592,6,12,1,2412,-49,-91,42,40:e3:d6:da:ba:23,24534847,184,618,24534663,24534847
2593,6,12,1,2412,-49,-91,42,40:e3:d6:da:ba:24,24535074,176,51,24534898,24535074
2594,6,12,1,2412,-49,-91,42,40:e3:d6:da:ba:25,24535374,160,140,24535214,24535374
2595,6,6,1,2412,-50,-91,41,40:e3:d6:da:ba:26,24535575,380,-179,24535195,24535575
2596,4,1,1,2412,-61,-91,30,54:e4:3a:ec:fb:64,24543871,2160,6136,24541711,24543871
2597,6,12,1,2412,-50,-91,41,40:e3:d6:da:ba:20,24635189,160,91158,24635029,24635189
2598,6,12,1,2412,-50,-91,41,40:e3:d6:da:ba:22,24635821,180,452,24635641,24635821
2599,6,12,1,2412,-50,-91,41,40:e3:d6:da:ba:23,24636054,184,49,24635870,24636054
2600,6,12,1,2412,-50,-91,41,40:e3:d6:da:ba:24,24636264,176,34,24636088,24636264
2601,6,12,1,2412,-50,-91,41,40:e3:d6:da:ba:25,24636483,160,59,24636323,24636483
2602,6,6,1,2412,-50,-91,41,40:e3:d6:da:ba:26,24636693,380,-170,24636313,24636693
2603,4,1,1,2412,-59,-91,32,54:e4:3a:ec:fb:64,24646271,2160,7418,24644111,24646271
2604,6,12,1,2412,-49,-91,42,40:e3:d6:da:ba:20,24737581,160,91150,24737421,24737581
2605,6,6,1,2412,-49,-91,42,40:e3:d6:da:ba:21,24737791,368,-158,24737423,24737791
2606,6,12,1,2412,-49,-91,42,40:e3:d6:da:ba:22,24738178,180,207,24737998,24738178
2607,6,12,1,2412,-50,-91,41,40:e3:d6:da:ba:23,24738401,184,39,24738217,24738401
2608,6,12,1,2412,-50,-91,41,40:e3:d6:da:ba:24,24738638,176,61,24738462,24738638
2609,6,12,1,2412,-49,-91,42,40:e3:d6:da:ba:25,24738882,160,84,24738722,24738882
2610,6,6,1,2412,-49,-91,42,40:e3:d6:da:ba:26,24739074,380,-188,24738694,24739074
2611,6,6,1,2412,-80,-91,11,e6:aa:ea:c9:ea:1b,24754778,408,15296,24754370,24754778
2612,6,6,1,2412,-79,-91,12,e6:aa:ea:c9:ea:1b,24766555,408,11369,24766147,24766555
2613,6,6,1,2412,-69,-91,22,e6:aa:ea:b7:4a:dd,24775441,408,8478,24775033,24775441
2614,6,6,1,2412,-69,-91,22,e6:aa:ea:b7:4a:dd,24787384,408,11535,24786976,24787384
2615,6,6,1,2412,-69,-91,22,e6:aa:ea:b7:4a:dd,24823732,408,35940,24823324,24823732
2616,6,12,1,2412,-49,-91,42,40:e3:d6:da:ba:20,24842338,160,18446,24842178,24842338
2617,6,6,1,2412,-49,-91,42,40:e3:d6:da:ba:21,24842548,368,-158,24842180,24842548
2618,6,12,1,2412,-49,-91,42,40:e3:d6:da:ba:22,24842953,180,225,24842773,24842953
2619,6,12,1,2412,-49,-91,42,40:e3:d6:da:ba:23,24843167,184,30,24842983,24843167
2620,6,12,1,2412,-49,-91,42,40:e3:d6:da:ba:24,24843377,176,34,24843201,24843377
2621,6,12,1,2412,-49,-91,42,40:e3:d6:da:ba:25,24843605,160,68,24843445,24843605
2622,4,1,1,2412,-66,-91,25,54:e4:3a:ec:fb:64,24851068,2160,5303,24848908,24851068
2623,6,6,1,2412,-50,-91,41,e6:aa:ea:c9:ea:33,24860009,408,8533,24859601,24860009
2624,6,6,1,2412,-53,-91,38,e6:aa:ea:c9:ea:33,24872137,408,11720,24871729,24872137
2625,6,6,1,2412,-50,-91,41,e6:aa:ea:c9:ea:33,24884354,408,11809,24883946,24884354
2626,6,6,1,2412,-53,-91,38,e6:aa:ea:c9:ea:33,24896821,408,12059,24896413,24896821
2627,6,12,1,2412,-50,-91,41,40:e3:d6:da:ba:20,24942371,160,45390,24942211,24942371
2628,6,6,1,2412,-50,-91,41,40:e3:d6:da:ba:21,24942581,368,-158,24942213,24942581
2629,6,12,1,2412,-50,-91,41,40:e3:d6:da:ba:22,24942977,180,216,24942797,24942977
2630,6,12,1,2412,-50,-91,41,40:e3:d6:da:ba:23,24943191,184,30,24943007,24943191
2631,6,12,1,2412,-50,-91,41,40:e3:d6:da:ba:24,24943428,176,61,24943252,24943428
2632,6,12,1,2412,-50,-91,41,40:e3:d6:da:ba:25,24943638,160,50,24943478,24943638
2633,6,6,1,2412,-50,-91,41,40:e3:d6:da:ba:26,24943848,380,-170,24943468,24943848
2634,4,1,1,2412,-59,-91,32,54:e4:3a:ec:fb:64,24953468,2160,7460,24951308,24953468
2635,4,1,1,2412,-86,-91,5,,25032889,304,79117,25032585,25032889
2636,6,12,1,2412,-49,-91,42,40:e3:d6:da:ba:20,25044771,160,11722,25044611,25044771
2637,6,6,1,2412,-49,-91,42,40:e3:d6:da:ba:21,25044981,368,-158,25044613,25044981
2638,6,12,1,2412,-49,-91,42,40:e3:d6:da:ba:22,25045377,180,216,25045197,25045377
2639,6,12,1,2412,-49,-91,42,40:e3:d6:da:ba:23,25045609,184,48,25045425,25045609
2640,6,12,1,2412,-49,-91,42,40:e3:d6:da:ba:24,25045819,176,34,25045643,25045819
2641,6,12,1,2412,-49,-91,42,40:e3:d6:da:ba:25,25046035,160,56,25045875,25046035
2642,6,6,1,2412,-49,-91,42,40:e3:d6:da:ba:26,25046236,380,-179,25045856,25046236
2643,4,1,1,2412,-59,-91,32,a6:e5:7c:28:b1:d3,25125791,992,78563,25124799,25125791
2644,6,6,1,2412,-49,-91,42,40:e3:d6:da:ba:21,25147585,368,21426,25147217,25147585
2645,6,6,1,2412,-49,-91,42,40:e3:d6:da:ba:26,25148902,380,937,25148522,25148902
2646,4,1,1,2412,-62,-91,29,54:e4:3a:ec:fb:64,25158266,2160,7204,25156106,25158266
2647,6,6,1,2412,-83,-91,8,e6:aa:ea:c9:ea:1b,25186972,408,28298,25186564,25186972
2648,6,12,1,2412,-50,-91,41,40:e3:d6:da:ba:20,25249958,160,62826,25249798,25249958
2649,6,6,1,2412,-50,-91,41,40:e3:d6:da:ba:21,25250150,368,-176,25249782,25250150
2650,6,12,1,2412,-49,-91,42,40:e3:d6:da:ba:22,25250571,180,241,25250391,25250571
2651,6,12,1,2412,-49,-91,42,40:e3:d6:da:ba:24,25251021,176,274,25250845,25251021
2652,6,12,1,2412,-49,-91,42,40:e3:d6:da:ba:25,25251231,160,50,25251071,25251231
2653,6,6,1,2412,-49,-91,42,40:e3:d6:da:ba:26,25251422,380,-189,25251042,25251422
2654,6,6,1,2412,-69,-91,22,e6:aa:ea:b7:4a:dd,25295210,408,43380,25294802,25295210
2655,6,6,1,2412,-69,-91,22,e6:aa:ea:b7:4a:dd,25307329,408,11711,25306921,25307329
2656,6,6,1,2412,-70,-91,21,e6:aa:ea:b7:4a:dd,25319553,408,11816,25319145,25319553
2657,4,1,1,2412,-86,-91,5,a6:e5:7c:28:b1:d3,25325750,992,5205,25324758,25325750
2658,6,6,1,2412,-71,-91,20,e6:aa:ea:b7:4a:dd,25331581,408,5423,25331173,25331581
2659,6,6,1,2412,-71,-91,20,e6:aa:ea:b7:4a:dd,25343685,408,11696,25343277,25343685
2660,6,12,1,2412,-52,-91,39,40:e3:d6:da:ba:20,25351993,160,8148,25351833,25351993
2661,6,6,1,2412,-52,-91,39,40:e3:d6:da:ba:21,25352203,368,-158,25351835,25352203
2662,6,12,1,2412,-52,-91,39,40:e3:d6:da:ba:22,25352590,180,207,25352410,25352590
2663,6,12,1,2412,-52,-91,39,40:e3:d6:da:ba:23,25352814,184,40,25352630,25352814
2664,6,12,1,2412,-52,-91,39,40:e3:d6:da:ba:24,25353050,176,60,25352874,25353050
2665,6,12,1,2412,-53,-91,38,40:e3:d6:da:ba:25,25353252,160,42,25353092,25353252
2666,6,6,1,2412,-52,-91,39,40:e3:d6:da:ba:26,25353453,380,-179,25353073,25353453
2667,4,1,1,2412,-61,-91,30,54:e4:3a:ec:fb:64,25363065,2160,7452,25360905,25363065
2668,6,6,1,2412,-53,-91,38,e6:aa:ea:c9:ea:33,25367319,408,3846,25366911,25367319
2669,6,6,1,2412,-52,-91,39,e6:aa:ea:c9:ea:33,25379424,408,11697,25379016,25379424
2670,6,6,1,2412,-52,-91,39,e6:aa:ea:c9:ea:33,25391529,408,11697,25391121,25391529
2671,6,6,1,2412,-52,-91,39,e6:aa:ea:c9:ea:33,25403649,408,11712,25403241,25403649
2672,6,6,1,2412,-52,-91,39,e6:aa:ea:c9:ea:33,25415773,408,11716,25415365,25415773
2673,6,12,1,2412,-56,-91,35,40:e3:d6:da:ba:20,25454378,160,38445,25454218,25454378
2674,6,6,1,2412,-56,-91,35,40:e3:d6:da:ba:21,25454647,368,-99,25454279,25454647
2675,6,12,1,2412,-56,-91,35,40:e3:d6:da:ba:23,25455282,184,451,25455098,25455282
2676,6,12,1,2412,-55,-91,36,40:e3:d6:da:ba:24,25455491,176,33,25455315,25455491
2677,6,12,1,2412,-56,-91,35,40:e3:d6:da:ba:25,25455720,160,69,25455560,25455720
2678,6,6,1,2412,-51,-91,40,40:e3:d6:da:ba:26,25455930,380,-170,25455550,25455930
2679,4,1,1,2412,-61,-91,30,54:e4:3a:ec:fb:64,25465463,2160,7373,25463303,25465463
2680,6,12,1,2412,-86,-91,5,84:d4:7e:f2:42:22,25472951,180,7308,25472771,25472951
2681,6,12,1,2412,-50,-91,41,40:e3:d6:da:ba:23,25557666,184,84531,25557482,25557666
2682,6,12,1,2412,-51,-91,40,40:e3:d6:da:ba:24,25557913,176,71,25557737,25557913
2683,6,12,1,2412,-51,-91,40,40:e3:d6:da:ba:25,25558151,160,78,25557991,25558151
2684,6,6,1,2412,-51,-91,40,40:e3:d6:da:ba:26,25558370,380,-161,25557990,25558370
2685,4,1,1,2412,-59,-91,32,54:e4:3a:ec:fb:64,25567877,2160,7347,25565717,25567877
2686,6,12,1,2412,-87,-91,4,84:d4:7e:f2:42:22,25575642,180,7585,25575462,25575642
2687,6,12,1,2412,-55,-91,36,40:e3:d6:da:ba:20,25659175,160,83373,25659015,25659175
2688,6,6,1,2412,-55,-91,36,40:e3:d6:da:ba:21,25659366,368,-177,25658998,25659366
2689,6,12,1,2412,-54,-91,37,40:e3:d6:da:ba:22,25659763,180,217,25659583,25659763
2690,6,12,1,2412,-55,-91,36,40:e3:d6:da:ba:23,25659995,184,48,25659811,25659995
2691,6,12,1,2412,-55,-91,36,40:e3:d6:da:ba:24,25660223,176,52,25660047,25660223
2692,6,12,1,2412,-55,-91,36,40:e3:d6:da:ba:25,25660442,160,59,25660282,25660442
2693,6,6,1,2412,-55,-91,36,40:e3:d6:da:ba:26,25660661,380,-161,25660281,25660661
2694,4,1,1,2412,-57,-91,34,54:e4:3a:ec:fb:64,25670262,2160,7441,25668102,25670262
2695,6,6,1,2412,-50,-91,41,e6:aa:ea:c9:ea:33,25682451,408,11781,25682043,25682451
2696,6,6,1,2412,-51,-91,40,e6:aa:ea:c9:ea:33,25694516,408,11657,25694108,25694516
2697,6,6,1,2412,-83,-91,8,e6:aa:ea:c9:ea:1b,25697202,408,2278,25696794,25697202
2698,6,6,1,2412,-51,-91,40,e6:aa:ea:c9:ea:33,25706734,408,9124,25706326,25706734
2699,6,6,1,2412,-51,-91,40,e6:aa:ea:c9:ea:33,25718761,408,11619,25718353,25718761
2700,6,6,1,2412,-51,-91,40,e6:aa:ea:c9:ea:33,25731068,408,11899,25730660,25731068
2701,6,6,1,2412,-84,-91,7,e6:aa:ea:c9:ea:1b,25733478,408,2002,25733070,25733478
2702,6,12,1,2412,-53,-91,38,40:e3:d6:da:ba:20,25761584,160,27946,25761424,25761584
2703,6,6,1,2412,-53,-91,38,40:e3:d6:da:ba:21,25761785,368,-167,25761417,25761785
2704,6,12,1,2412,-52,-91,39,40:e3:d6:da:ba:22,25762181,180,216,25762001,25762181
2705,6,12,1,2412,-52,-91,39,40:e3:d6:da:ba:23,25762413,184,48,25762229,25762413
2706,6,12,1,2412,-53,-91,38,40:e3:d6:da:ba:25,25765163,160,2590,25765003,25765163
2707,6,6,1,2412,-52,-91,39,40:e3:d6:da:ba:26,25765381,380,-162,25765001,25765381
2708,4,1,1,2412,-62,-91,29,54:e4:3a:ec:fb:64,25772661,2160,5120,25770501,25772661
2709,6,6,1,2412,-69,-91,22,e6:aa:ea:b7:4a:dd,25840466,408,67397,25840058,25840466
2710,6,12,1,2412,-52,-91,39,40:e3:d6:da:ba:20,25863985,160,23359,25863825,25863985
2711,6,6,1,2412,-52,-91,39,40:e3:d6:da:ba:21,25864204,368,-149,25863836,25864204
2712,6,12,1,2412,-52,-91,39,40:e3:d6:da:ba:22,25864591,180,207,25864411,25864591
2713,6,12,1,2412,-52,-91,39,40:e3:d6:da:ba:23,25864815,184,40,25864631,25864815
2714,6,12,1,2412,-52,-91,39,40:e3:d6:da:ba:24,25865042,176,51,25864866,25865042
2715,6,12,1,2412,-52,-91,39,40:e3:d6:da:ba:25,25865270,160,68,25865110,25865270
2716,6,6,1,2412,-52,-91,39,40:e3:d6:da:ba:26,25865480,380,-170,25865100,25865480
2717,6,6,1,2412,-50,-91,41,40:e3:d6:da:ba:21,25966584,368,100736,25966216,25966584
2718,6,12,1,2412,-50,-91,41,40:e3:d6:da:ba:22,25966998,180,234,25966818,25966998
2719,6,12,1,2412,-50,-91,41,40:e3:d6:da:ba:23,25967212,184,30,25967028,25967212
2720,6,12,1,2412,-50,-91,41,40:e3:d6:da:ba:24,25967449,176,61,25967273,25967449
2721,6,12,1,2412,-50,-91,41,40:e3:d6:da:ba:25,25967650,160,41,25967490,25967650
2722,6,6,1,2412,-50,-91,41,40:e3:d6:da:ba:26,25967842,380,-188,25967462,25967842
2723,4,1,1,2412,-89,-91,2,b8:3a:5a:88:e6:e0,25979823,2360,9621,25977463,25979823
2724,6,6,1,2412,-54,-91,37,e6:aa:ea:c9:ea:33,25996630,408,16399,25996222,25996630
2725,6,6,1,2412,-53,-91,38,e6:aa:ea:c9:ea:33,26020860,408,23822,26020452,26020860
2726,6,6,1,2412,-54,-91,37,e6:aa:ea:c9:ea:33,26032978,408,11710,26032570,26032978
2727,6,6,1,2412,-53,-91,38,e6:aa:ea:c9:ea:33,26045091,408,11705,26044683,26045091
2728,4,1,1,2412,-85,-91,6,c0:c9:e3:4d:6e:bf,26059109,872,13146,26058237,26059109
2729,6,6,1,2412,-49,-91,42,40:e3:d6:da:ba:21,26069003,368,9526,26068635,26069003
2730,6,12,1,2412,-49,-91,42,40:e3:d6:da:ba:22,26069390,180,207,26069210,26069390
2731,6,12,1,2412,-49,-91,42,40:e3:d6:da:ba:23,26069628,184,54,26069444,26069628
2732,6,12,1,2412,-49,-91,42,40:e3:d6:da:ba:24,26069865,176,61,26069689,26069865
2733,6,12,1,2412,-49,-91,42,40:e3:d6:da:ba:25,26070075,160,50,26069915,26070075
2734,6,6,1,2412,-49,-91,42,40:e3:d6:da:ba:26,26070276,380,-179,26069896,26070276
2735,6,6,1,2412,-82,-91,9,e6:aa:ea:c9:ea:1b,26105011,408,34327,26104603,26105011
2736,6,6,1,2412,-48,-91,43,,26110175,44,5120,26110131,26110175
2737,6,6,1,2412,-47,-91,44,,26135172,44,24953,26135128,26135172
2738,6,6,1,2412,-81,-91,10,e6:aa:ea:c9:ea:1b,26141255,408,5675,26140847,26141255
2739,6,6,1,2412,-82,-91,9,e6:aa:ea:c9:ea:1b,26153365,408,11702,26152957,26153365
2740,6,6,1,2412,-47,-91,44,,26160172,44,6763,26160128,26160172
2741,6,6,1,2412,-47,-91,44,,26169062,44,8846,26169018,26169062
2742,6,6,1,2412,-47,-91,44,,26169820,44,714,26169776,26169820
2743,6,6,1,2412,-47,-91,44,,26172518,44,2654,26172474,26172518
2744,4,1,1,2412,-63,-91,28,54:e4:3a:ec:fb:64,26184986,2160,10308,26182826,26184986
2745,6,12,1,2412,-48,-91,43,40:e3:d6:da:ba:20,26187115,160,1969,26186955,26187115
2746,6,6,1,2412,-48,-91,43,40:e3:d6:da:ba:21,26187334,368,-149,26186966,26187334
2747,6,12,1,2412,-48,-91,43,40:e3:d6:da:ba:22,26187721,180,207,26187541,26187721
2748,6,12,1,2412,-48,-91,43,40:e3:d6:da:ba:23,26187926,184,21,26187742,26187926
2749,6,12,1,2412,-48,-91,43,40:e3:d6:da:ba:24,26188136,176,34,26187960,26188136
2750,6,12,1,2412,-48,-91,43,40:e3:d6:da:ba:25,26188364,160,68,26188204,26188364
2751,6,6,1,2412,-48,-91,43,40:e3:d6:da:ba:26,26188583,380,-161,26188203,26188583
2752,6,12,1,2412,-48,-91,43,40:e3:d6:da:ba:20,26273593,160,84850,26273433,26273593
2753,6,6,1,2412,-48,-91,43,40:e3:d6:da:ba:21,26273804,368,-157,26273436,26273804
2754,6,12,1,2412,-48,-91,43,40:e3:d6:da:ba:22,26274191,180,207,26274011,26274191
2755,6,12,1,2412,-48,-91,43,40:e3:d6:da:ba:23,26274405,184,30,26274221,26274405
2756,6,12,1,2412,-48,-91,43,40:e3:d6:da:ba:24,26274623,176,42,26274447,26274623
2757,6,12,1,2412,-48,-91,43,40:e3:d6:da:ba:25,26274852,160,69,26274692,26274852
2758,6,6,1,2412,-48,-91,43,40:e3:d6:da:ba:26,26275071,380,-161,26274691,26275071
2759,4,1,1,2412,-64,-91,27,54:e4:3a:ec:fb:64,26284657,2160,7426,26282497,26284657
2760,4,1,1,2412,-89,-91,2,b8:3a:5a:88:e6:e0,26287165,2360,148,26284805,26287165
2761,6,6,1,2412,-55,-91,36,e6:aa:ea:c9:ea:33,26312273,408,24700,26311865,26312273
2762,6,6,1,2412,-53,-91,38,e6:aa:ea:c9:ea:33,26336778,408,24097,26336370,26336778
2763,6,6,1,2412,-52,-91,39,e6:aa:ea:c9:ea:33,26348622,408,11436,26348214,26348622
2764,6,6,1,2412,-52,-91,39,e6:aa:ea:c9:ea:33,26360744,408,11714,26360336,26360744
2765,6,6,1,2412,-71,-91,20,e6:aa:ea:b7:4a:dd,26373051,408,11899,26372643,26373051
2766,6,12,1,2412,-48,-91,43,40:e3:d6:da:ba:20,26375978,160,2767,26375818,26375978
2767,6,6,1,2412,-48,-91,43,40:e3:d6:da:ba:21,26376179,368,-167,26375811,26376179
2768,6,12,1,2412,-48,-91,43,40:e3:d6:da:ba:22,26376593,180,234,26376413,26376593
2769,6,12,1,2412,-48,-91,43,40:e3:d6:da:ba:23,26376896,184,119,26376712,26376896
2770,6,12,1,2412,-48,-91,43,40:e3:d6:da:ba:24,26377132,176,60,26376956,26377132
2771,6,12,1,2412,-48,-91,43,40:e3:d6:da:ba:25,26377360,160,68,26377200,26377360
2772,6,6,1,2412,-48,-91,43,40:e3:d6:da:ba:26,26377561,380,-179,26377181,26377561
2773,4,1,1,2412,-64,-91,27,54:e4:3a:ec:fb:64,26387055,2160,7334,26384895,26387055
2774,6,6,1,2412,-84,-91,7,e6:aa:ea:c9:ea:1b,26421871,408,34408,26421463,26421871
2775,6,6,1,2412,-84,-91,7,e6:aa:ea:c9:ea:1b,26446095,408,23816,26445687,26446095
2776,6,6,1,2412,-83,-91,8,e6:aa:ea:c9:ea:1b,26458212,408,11709,26457804,26458212
2777,6,6,1,2412,-84,-91,7,e6:aa:ea:c9:ea:1b,26470321,408,11701,26469913,26470321
2778,6,12,1,2412,-47,-91,44,40:e3:d6:da:ba:20,26478395,160,7914,26478235,26478395
2779,6,6,1,2412,-47,-91,44,40:e3:d6:da:ba:21,26478614,368,-149,26478246,26478614
2780,6,12,1,2412,-47,-91,44,40:e3:d6:da:ba:22,26479019,180,225,26478839,26479019
2781,6,12,1,2412,-47,-91,44,40:e3:d6:da:ba:23,26479242,184,39,26479058,26479242
2782,6,12,1,2412,-47,-91,44,40:e3:d6:da:ba:24,26479470,176,52,26479294,26479470
2783,6,12,1,2412,-47,-91,44,40:e3:d6:da:ba:25,26479698,160,68,26479538,26479698
2784,6,6,1,2412,-47,-91,44,40:e3:d6:da:ba:26,26479890,380,-188,26479510,26479890
2785,4,1,1,2412,-86,-91,5,c0:c9:e3:4d:6e:bf,26505609,872,24847,26504737,26505609
2786,6,12,1,2412,-45,-91,46,40:e3:d6:da:ba:20,26581392,160,75623,26581232,26581392
2787,6,6,1,2412,-45,-91,46,40:e3:d6:da:ba:21,26581611,368,-149,26581243,26581611
2788,6,12,1,2412,-46,-91,45,40:e3:d6:da:ba:22,26582024,180,233,26581844,26582024
2789,6,12,1,2412,-45,-91,46,40:e3:d6:da:ba:23,26582230,184,22,26582046,26582230
2790,6,12,1,2412,-45,-91,46,40:e3:d6:da:ba:24,26582472,176,66,26582296,26582472
2791,6,12,1,2412,-46,-91,45,40:e3:d6:da:ba:25,26583205,160,573,26583045,26583205
2792,6,6,1,2412,-45,-91,46,40:e3:d6:da:ba:26,26583548,380,-37,26583168,26583548
2793,4,1,1,2412,-63,-91,28,54:e4:3a:ec:fb:64,26591855,2160,6147,26589695,26591855
2794,4,1,1,2412,-65,-91,26,0a:0a:33:c0:b9:6e,26625490,1504,32131,26623986,26625490
2795,6,12,1,2412,-45,-91,46,40:e3:d6:da:ba:23,26626984,156,1338,26626828,26626984
2796,6,12,1,2412,-46,-91,45,40:e3:d6:da:ba:20,26683190,160,56046,26683030,26683190
2797,6,6,1,2412,-46,-91,45,40:e3:d6:da:ba:21,26683400,368,-158,26683032,26683400
2798,6,12,1,2412,-45,-91,46,40:e3:d6:da:ba:22,26683814,180,234,26683634,26683814
2799,6,12,1,2412,-45,-91,46,40:e3:d6:da:ba:23,26684029,184,31,26683845,26684029
2800,6,12,1,2412,-46,-91,45,40:e3:d6:da:ba:24,26684238,176,33,26684062,26684238
2801,6,12,1,2412,-45,-91,46,40:e3:d6:da:ba:25,26684482,160,84,26684322,26684482
2802,6,6,1,2412,-45,-91,46,40:e3:d6:da:ba:26,26684683,380,-179,26684303,26684683
2803,4,1,1,2412,-89,-91,2,b8:3a:5a:88:e6:e0,26696778,2360,9735,26694418,26696778
2804,4,1,1,2412,-93,-91,-2,b8:3a:5a:88:e6:e1,26699167,2376,13,26696791,26699167
2805,6,6,1,2412,-70,-91,21,e6:aa:ea:b7:4a:dd,26753331,408,53756,26752923,26753331
2806,6,6,1,2412,-70,-91,21,e6:aa:ea:b7:4a:dd,26765556,408,11817,26765148,26765556
2807,6,6,1,2412,-70,-91,21,e6:aa:ea:b7:4a:dd,26777560,408,11596,26777152,26777560
2808,6,12,1,2412,-47,-91,44,40:e3:d6:da:ba:20,26785586,160,7866,26785426,26785586
2809,6,6,1,2412,-47,-91,44,40:e3:d6:da:ba:21,26785778,368,-176,26785410,26785778
2810,6,12,1,2412,-47,-91,44,40:e3:d6:da:ba:22,26786165,180,207,26785985,26786165
2811,6,12,1,2412,-47,-91,44,40:e3:d6:da:ba:23,26786389,184,40,26786205,26786389
2812,6,12,1,2412,-47,-91,44,40:e3:d6:da:ba:25,26787150,160,601,26786990,26787150
2813,6,6,1,2412,-47,-91,44,40:e3:d6:da:ba:26,26787351,380,-179,26786971,26787351
2814,6,6,1,2412,-71,-91,20,e6:aa:ea:b7:4a:dd,26789679,408,1920,26789271,26789679
2815,4,1,1,2412,-59,-91,32,54:e4:3a:ec:fb:64,26796652,2160,4813,26794492,26796652
2816,6,6,1,2412,-45,-91,46,e6:aa:ea:c9:ea:33,26830983,408,33923,26830575,26830983
2817,6,6,1,2412,-85,-91,6,e6:aa:ea:c9:ea:1b,26841273,408,9882,26840865,26841273
2818,6,6,1,2412,-48,-91,43,e6:aa:ea:c9:ea:33,26843115,408,1434,26842707,26843115
2819,6,6,1,2412,-47,-91,44,e6:aa:ea:c9:ea:33,26855224,408,11701,26854816,26855224
2820,6,6,1,2412,-54,-91,37,e6:aa:ea:c9:ea:33,26867367,408,11735,26866959,26867367
2821,6,6,1,2412,-47,-91,44,e6:aa:ea:c9:ea:33,26879472,408,11697,26879064,26879472
2822,6,6,1,2412,-49,-91,42,40:e3:d6:da:ba:21,26888216,368,8376,26887848,26888216
2823,6,12,1,2412,-49,-91,42,40:e3:d6:da:ba:22,26888621,180,225,26888441,26888621
2824,6,12,1,2412,-49,-91,42,40:e3:d6:da:ba:23,26888844,184,39,26888660,26888844
2825,6,12,1,2412,-49,-91,42,40:e3:d6:da:ba:24,26889062,176,42,26888886,26889062
2826,6,12,1,2412,-49,-91,42,40:e3:d6:da:ba:25,26889291,160,69,26889131,26889291
2827,6,6,1,2412,-47,-91,44,40:e3:d6:da:ba:26,26889500,380,-171,26889120,26889500
2828,4,1,1,2412,-84,-91,7,a4:e5:7c:28:b1:d3,26895562,688,5374,26894874,26895562
2829,4,1,1,2412,-60,-91,31,54:e4:3a:ec:fb:64,26899052,2160,1330,26896892,26899052
2830,4,1,1,2412,-67,-91,24,b8:3a:5a:88:e6:e0,26901262,2360,-150,26898902,26901262
2831,6,6,1,2412,-88,-91,3,84:d4:7e:f2:42:21,26906288,368,4658,26905920,26906288
2832,6,6,1,2412,-89,-91,2,84:d4:7e:f2:42:26,26907551,380,883,26907171,26907551
2833,6,12,1,2412,-49,-91,42,40:e3:d6:da:ba:20,26990382,160,82671,26990222,26990382
2834,6,6,1,2412,-48,-91,43,40:e3:d6:da:ba:21,26990583,368,-167,26990215,26990583
2835,6,12,1,2412,-48,-91,43,40:e3:d6:da:ba:22,26990997,180,234,26990817,26990997
2836,6,12,1,2412,-48,-91,43,40:e3:d6:da:ba:23,26991202,184,21,26991018,26991202
2837,6,12,1,2412,-48,-91,43,40:e3:d6:da:ba:24,26991438,176,60,26991262,26991438
2838,6,12,1,2412,-48,-91,43,40:e3:d6:da:ba:25,26991667,160,69,26991507,26991667
2839,6,6,1,2412,-48,-91,43,40:e3:d6:da:ba:26,26991868,380,-179,26991488,26991868
2840,6,6,1,2412,-88,-91,3,84:d4:7e:f2:42:26,27009939,380,17691,27009559,27009939
2841,4,1,1,2412,-85,-91,6,,27056651,304,46408,27056347,27056651
2842,4,1,1,2412,-81,-91,10,a6:e5:7c:28:b1:d3,27076698,944,19103,27075754,27076698
2843,6,12,1,2412,-53,-91,38,40:e3:d6:da:ba:20,27092803,160,15945,27092643,27092803
2844,6,6,1,2412,-53,-91,38,40:e3:d6:da:ba:21,27093004,368,-167,27092636,27093004
2845,6,12,1,2412,-52,-91,39,40:e3:d6:da:ba:22,27093418,180,234,27093238,27093418
2846,6,12,1,2412,-53,-91,38,40:e3:d6:da:ba:23,27093623,184,21,27093439,27093623
2847,6,12,1,2412,-52,-91,39,40:e3:d6:da:ba:24,27093887,176,88,27093711,27093887
2848,6,12,1,2412,-53,-91,38,40:e3:d6:da:ba:25,27094088,160,41,27093928,27094088
2849,6,6,1,2412,-52,-91,39,40:e3:d6:da:ba:26,27094289,380,-179,27093909,27094289
2850,4,1,1,2412,-64,-91,27,54:e4:3a:ec:fb:64,27103849,2160,7400,27101689,27103849
2851,4,1,1,2412,-87,-91,4,b8:3a:5a:88:e6:e0,27106099,2360,-110,27103739,27106099
2852,4,1,1,2412,-86,-91,5,b8:3a:5a:88:e6:e1,27108478,2376,3,27106102,27108478
2853,4,1,1,2412,-86,-91,5,a6:e5:7c:28:b1:d3,27142485,944,33063,27141541,27142485
2854,4,1,1,2412,-76,-91,15,a6:e5:7c:28:b1:d3,27143768,944,339,27142824,27143768
2855,6,6,1,2412,-55,-91,36,e6:aa:ea:c9:ea:33,27147779,408,3603,27147371,27147779
2856,6,6,1,2412,-52,-91,39,e6:aa:ea:c9:ea:33,27158700,408,10513,27158292,27158700
2857,6,6,1,2412,-67,-91,24,e6:aa:ea:b7:4a:dd,27194729,408,35621,27194321,27194729
2858,6,12,1,2412,-55,-91,36,40:e3:d6:da:ba:20,27195193,160,304,27195033,27195193
2859,6,6,1,2412,-55,-91,36,40:e3:d6:da:ba:21,27195385,368,-176,27195017,27195385
2860,6,12,1,2412,-54,-91,37,40:e3:d6:da:ba:22,27195781,180,216,27195601,27195781
2861,6,6,1,2412,-53,-91,38,e6:aa:ea:c9:ea:33,27196011,408,-178,27195603,27196011
2862,6,12,1,2412,-55,-91,36,40:e3:d6:da:ba:24,27196435,176,248,27196259,27196435
2863,6,12,1,2412,-55,-91,36,40:e3:d6:da:ba:25,27196637,160,42,27196477,27196637
2864,6,6,1,2412,-54,-91,37,40:e3:d6:da:ba:26,27196837,380,-180,27196457,27196837
2865,4,1,1,2412,-66,-91,25,54:e4:3a:ec:fb:64,27206249,2160,7252,27204089,27206249
2866,6,12,1,2412,-87,-91,4,84:d4:7e:f2:42:20,27213368,160,6959,27213208,27213368
2867,6,6,1,2412,-87,-91,4,84:d4:7e:f2:42:26,27214876,380,1128,27214496,27214876
2868,6,6,1,2412,-68,-91,23,e6:aa:ea:b7:4a:dd,27218956,408,3672,27218548,27218956
2869,4,1,1,2412,-87,-91,4,a6:e5:7c:28:b1:d3,27232750,944,12850,27231806,27232750
2870,4,1,1,2412,-85,-91,6,a6:e5:7c:28:b1:d3,27233828,944,134,27232884,27233828
2871,4,1,1,2412,-88,-91,3,a6:e5:7c:28:b1:d3,27238248,944,3476,27237304,27238248
2872,4,1,1,2412,-88,-91,3,a6:e5:7c:28:b1:d3,27241842,944,2650,27240898,27241842
2873,4,1,1,2412,-86,-91,5,a6:e5:7c:28:b1:d3,27242956,944,170,27242012,27242956
2874,4,1,1,2412,-85,-91,6,a6:e5:7c:28:b1:d3,27244052,944,152,27243108,27244052
2875,6,6,1,2412,-82,-91,9,e6:aa:ea:c9:ea:1b,27261295,408,16835,27260887,27261295
2876,6,6,1,2412,-84,-91,7,e6:aa:ea:c9:ea:1b,27285533,408,23830,27285125,27285533
2877,6,12,1,2412,-52,-91,39,40:e3:d6:da:ba:20,27297778,160,12085,27297618,27297778
2878,6,6,1,2412,-52,-91,39,40:e3:d6:da:ba:21,27298162,368,16,27297794,27298162
2879,6,12,1,2412,-52,-91,39,40:e3:d6:da:ba:22,27298576,180,234,27298396,27298576
2880,6,12,1,2412,-52,-91,39,40:e3:d6:da:ba:23,27298808,184,48,27298624,27298808
2881,6,12,1,2412,-52,-91,39,40:e3:d6:da:ba:24,27301492,176,2508,27301316,27301492
2882,6,6,1,2412,-52,-91,39,40:e3:d6:da:ba:26,27302063,380,191,27301683,27302063
2883,6,6,1,2412,-87,-91,4,84:d4:7e:f2:42:21,27315879,368,13448,27315511,27315879
2884,6,12,1,2412,-51,-91,40,40:e3:d6:da:ba:20,27399990,160,83951,27399830,27399990
2885,6,6,1,2412,-51,-91,40,40:e3:d6:da:ba:21,27400209,368,-149,27399841,27400209
2886,6,12,1,2412,-51,-91,40,40:e3:d6:da:ba:22,27400623,180,234,27400443,27400623
2887,6,12,1,2412,-51,-91,40,40:e3:d6:da:ba:23,27400846,184,39,27400662,27400846
2888,4,1,1,2412,-68,-91,23,54:e4:3a:ec:fb:64,27405211,2112,2253,27403099,27405211
2889,4,1,1,2412,-65,-91,26,54:e4:3a:ec:fb:64,27407541,2112,218,27405429,27407541
2890,4,1,1,2412,-68,-91,23,54:e4:3a:ec:fb:64,27409726,2112,73,27407614,27409726
2891,4,1,1,2412,-67,-91,24,54:e4:3a:ec:fb:64,27411910,2160,24,27409750,27411910
2892,6,12,1,2412,-50,-91,41,40:e3:d6:da:ba:23,27414820,156,2754,27414664,27414820
2893,6,12,1,2412,-89,-91,2,84:d4:7e:f2:42:24,27418928,176,3932,27418752,27418928
2894,4,1,1,2412,-66,-91,25,54:e4:3a:ec:fb:64,27419815,2112,-1225,27417703,27419815
2895,6,12,1,2412,-50,-91,41,40:e3:d6:da:ba:22,27503033,180,83038,27502853,27503033
2896,6,12,1,2412,-50,-91,41,40:e3:d6:da:ba:23,27503257,184,40,27503073,27503257
2897,6,12,1,2412,-51,-91,40,40:e3:d6:da:ba:24,27503475,176,42,27503299,27503475
2898,6,12,1,2412,-50,-91,41,40:e3:d6:da:ba:25,27503694,160,59,27503534,27503694
2899,6,6,1,2412,-50,-91,41,40:e3:d6:da:ba:26,27503904,380,-170,27503524,27503904
2900,4,1,1,2412,-66,-91,25,54:e4:3a:ec:fb:64,27513446,2160,7382,27511286,27513446
2901,4,1,1,2412,-84,-91,7,b8:3a:5a:88:e6:e1,27518036,2376,2214,27515660,27518036
2902,6,6,1,2412,-88,-91,3,84:d4:7e:f2:42:26,27521906,380,3490,27521526,27521906
2903,4,1,1,2412,-89,-91,2,,27533743,304,11533,27533439,27533743
2904,6,6,1,2412,-64,-91,27,e6:aa:ea:b7:4a:dd,27588669,408,54518,27588261,27588669
2905,6,6,1,2412,-84,-91,7,e6:aa:ea:c9:ea:1b,27590785,408,1708,27590377,27590785
2906,6,6,1,2412,-64,-91,27,e6:aa:ea:b7:4a:dd,27600790,408,9597,27600382,27600790
2907,6,6,1,2412,-83,-91,8,e6:aa:ea:c9:ea:1b,27602895,408,1697,27602487,27602895
2908,6,12,1,2412,-50,-91,41,40:e3:d6:da:ba:20,27604784,160,1729,27604624,27604784
2909,6,6,1,2412,-51,-91,40,40:e3:d6:da:ba:21,27604994,368,-158,27604626,27604994
2910,6,12,1,2412,-50,-91,41,40:e3:d6:da:ba:22,27605390,180,216,27605210,27605390
2911,6,12,1,2412,-51,-91,40,40:e3:d6:da:ba:23,27605622,184,48,27605438,27605622
2912,6,12,1,2412,-50,-91,41,40:e3:d6:da:ba:24,27605859,176,61,27605683,27605859
2913,6,12,1,2412,-50,-91,41,40:e3:d6:da:ba:25,27606078,160,59,27605918,27606078
2914,6,6,1,2412,-50,-91,41,40:e3:d6:da:ba:26,27606270,380,-188,27605890,27606270
2915,6,6,1,2412,-64,-91,27,e6:aa:ea:b7:4a:dd,27612899,408,6221,27612491,27612899
2916,6,6,1,2412,-84,-91,7,e6:aa:ea:c9:ea:1b,27615014,408,1707,27614606,27615014
2917,4,1,1,2412,-65,-91,26,54:e4:3a:ec:fb:64,27615846,2160,-1328,27613686,27615846
2918,6,6,1,2412,-64,-91,27,e6:aa:ea:b7:4a:dd,27625017,408,8763,27624609,27625017
2919,6,6,1,2412,-84,-91,7,e6:aa:ea:c9:ea:1b,27628189,408,2764,27627781,27628189
2920,6,6,1,2412,-49,-91,42,e6:aa:ea:c9:ea:33,27670553,408,41956,27670145,27670553
2921,6,6,1,2412,-50,-91,41,e6:aa:ea:c9:ea:33,27682677,408,11716,27682269,27682677
2922,6,6,1,2412,-50,-91,41,e6:aa:ea:c9:ea:33,27694875,408,11790,27694467,27694875
2923,6,6,1,2412,-50,-91,41,e6:aa:ea:c9:ea:33,27706915,408,11632,27706507,27706915
2924,6,12,1,2412,-51,-91,40,40:e3:d6:da:ba:20,27707370,160,295,27707210,27707370
2925,6,6,1,2412,-51,-91,40,40:e3:d6:da:ba:21,27707571,368,-167,27707203,27707571
2926,6,12,1,2412,-51,-91,40,40:e3:d6:da:ba:22,27707967,180,216,27707787,27707967
2927,6,12,1,2412,-51,-91,40,40:e3:d6:da:ba:23,27708190,184,39,27708006,27708190
2928,6,12,1,2412,-51,-91,40,40:e3:d6:da:ba:24,27708400,176,34,27708224,27708400
2929,6,12,1,2412,-51,-91,40,40:e3:d6:da:ba:25,27708610,160,50,27708450,27708610
2930,6,6,1,2412,-51,-91,40,40:e3:d6:da:ba:26,27708967,380,-23,27708587,27708967
2931,6,6,1,2412,-49,-91,42,e6:aa:ea:c9:ea:33,27722656,408,13281,27722248,27722656
2932,6,6,1,2412,-85,-91,6,84:d4:7e:f2:42:21,27726046,368,3022,27725678,27726046
2933,6,12,1,2412,-50,-91,41,40:e3:d6:da:ba:20,27809585,160,83379,27809425,27809585
2934,6,6,1,2412,-50,-91,41,40:e3:d6:da:ba:21,27809804,368,-149,27809436,27809804
2935,6,12,1,2412,-50,-91,41,40:e3:d6:da:ba:23,27810423,184,435,27810239,27810423
2936,6,12,1,2412,-50,-91,41,40:e3:d6:da:ba:24,27810651,176,52,27810475,27810651
2937,6,12,1,2412,-50,-91,41,40:e3:d6:da:ba:25,27810870,160,59,27810710,27810870
2938,6,6,1,2412,-50,-91,41,40:e3:d6:da:ba:26,27811071,380,-179,27810691,27811071
2939,6,6,1,2412,-83,-91,8,e6:aa:ea:c9:ea:1b,27908730,408,97251,27908322,27908730
2940,6,12,1,2412,-51,-91,40,40:e3:d6:da:ba:20,27912042,160,3152,27911882,27912042
2941,6,6,1,2412,-51,-91,40,40:e3:d6:da:ba:21,27912251,368,-159,27911883,27912251
2942,6,12,1,2412,-51,-91,40,40:e3:d6:da:ba:22,27912656,180,225,27912476,27912656
2943,6,12,1,2412,-51,-91,40,40:e3:d6:da:ba:23,27912862,184,22,27912678,27912862
2944,6,12,1,2412,-50,-91,41,40:e3:d6:da:ba:24,27913090,176,52,27912914,27913090
2945,6,12,1,2412,-50,-91,41,40:e3:d6:da:ba:25,27913309,160,59,27913149,27913309
2946,6,6,1,2412,-51,-91,40,40:e3:d6:da:ba:26,27913528,380,-161,27913148,27913528
2947,6,6,1,2412,-83,-91,8,e6:aa:ea:c9:ea:1b,27932938,408,19002,27932530,27932938
2948,6,6,1,2412,-68,-91,23,e6:aa:ea:b7:4a:dd,27952937,408,19591,27952529,27952937
2949,6,6,1,2412,-50,-91,41,e6:aa:ea:c9:ea:33,27985043,408,31698,27984635,27985043
2950,6,12,1,2412,-50,-91,41,40:e3:d6:da:ba:20,28014699,160,29496,28014539,28014699
2951,6,6,1,2412,-50,-91,41,40:e3:d6:da:ba:21,28014909,368,-158,28014541,28014909
2952,6,12,1,2412,-49,-91,42,40:e3:d6:da:ba:22,28015323,180,234,28015143,28015323
2953,6,12,1,2412,-50,-91,41,40:e3:d6:da:ba:23,28015537,184,30,28015353,28015537
2954,6,12,1,2412,-49,-91,42,40:e3:d6:da:ba:24,28015774,176,61,28015598,28015774
2955,6,12,1,2412,-49,-91,42,40:e3:d6:da:ba:25,28016002,160,68,28015842,28016002
2956,6,6,1,2412,-49,-91,42,40:e3:d6:da:ba:26,28016209,380,-173,28015829,28016209
2957,6,6,1,2412,-50,-91,41,e6:aa:ea:c9:ea:33,28021393,408,4776,28020985,28021393
2958,4,1,1,2412,-68,-91,23,54:e4:3a:ec:fb:64,28025441,2160,1888,28023281,28025441
2959,6,6,1,2412,-50,-91,41,e6:aa:ea:c9:ea:33,28033528,408,7679,28033120,28033528
2960,6,12,1,2412,-51,-91,40,40:e3:d6:da:ba:20,28116794,160,83106,28116634,28116794
2961,6,6,1,2412,-51,-91,40,40:e3:d6:da:ba:21,28116995,368,-167,28116627,28116995
2962,6,12,1,2412,-51,-91,40,40:e3:d6:da:ba:22,28117400,180,225,28117220,28117400
2963,6,12,1,2412,-51,-91,40,40:e3:d6:da:ba:23,28117624,184,40,28117440,28117624
2964,6,12,1,2412,-51,-91,40,40:e3:d6:da:ba:24,28117860,176,60,28117684,28117860
2965,6,12,1,2412,-51,-91,40,40:e3:d6:da:ba:25,28118071,160,51,28117911,28118071
2966,6,6,1,2412,-51,-91,40,40:e3:d6:da:ba:26,28118281,380,-170,28117901,28118281
2967,4,1,1,2412,-91,-91,0,b8:3a:5a:88:e6:e1,28130654,2376,9997,28128278,28130654
2968,6,12,1,2412,-89,-91,2,84:d4:7e:f2:42:22,28135481,180,4647,28135301,28135481
2969,4,1,1,2412,-74,-91,17,f8:89:d2:65:d2:3b,28153552,1048,17023,28152504,28153552
2970,4,1,1,2412,-44,-91,47,54:e4:3a:ec:fb:64,28154718,2112,-946,28152606,28154718
2971,6,12,1,2412,-50,-91,41,40:e3:d6:da:ba:20,28157004,136,2150,28156868,28157004
2972,6,6,1,2412,-50,-91,41,40:e3:d6:da:ba:21,28157360,348,8,28157012,28157360
2973,6,12,1,2412,-50,-91,41,40:e3:d6:da:ba:22,28157754,156,238,28157598,28157754
2974,6,12,1,2412,-50,-91,41,40:e3:d6:da:ba:23,28157978,156,68,28157822,28157978
2975,6,12,1,2412,-50,-91,41,40:e3:d6:da:ba:25,28158177,136,63,28158041,28158177
2976,4,1,1,2412,-92,-91,-1,,28160714,304,2233,28160410,28160714
2977,4,1,1,2412,-80,-91,11,f8:89:d2:65:d2:3b,28203729,1048,41967,28202681,28203729
2978,6,12,1,2412,-49,-91,42,40:e3:d6:da:ba:20,28204774,136,909,28204638,28204774
2979,6,6,1,2412,-49,-91,42,40:e3:d6:da:ba:21,28204951,348,-171,28204603,28204951
2980,6,12,1,2412,-49,-91,42,40:e3:d6:da:ba:22,28205327,156,220,28205171,28205327
2981,6,12,1,2412,-49,-91,42,40:e3:d6:da:ba:23,28205517,156,34,28205361,28205517
2982,6,12,1,2412,-49,-91,42,40:e3:d6:da:ba:25,28205708,136,55,28205572,28205708
2983,4,1,1,2412,-69,-91,22,54:e4:3a:ec:fb:64,28206212,2112,-1608,28204100,28206212
2984,4,1,1,2412,-69,-91,22,54:e4:3a:ec:fb:64,28208551,2112,227,28206439,28208551
2985,4,1,1,2412,-70,-91,21,54:e4:3a:ec:fb:64,28215372,2112,4709,28213260,28215372
2986,6,6,1,2412,-69,-91,22,e6:aa:ea:b7:4a:dd,28218881,408,3101,28218473,28218881
2987,6,12,1,2412,-49,-91,42,40:e3:d6:da:ba:20,28219317,160,276,28219157,28219317
2988,6,6,1,2412,-49,-91,42,40:e3:d6:da:ba:21,28219518,368,-167,28219150,28219518
2989,6,12,1,2412,-49,-91,42,40:e3:d6:da:ba:22,28219932,180,234,28219752,28219932
2990,6,12,1,2412,-49,-91,42,40:e3:d6:da:ba:23,28220165,184,49,28219981,28220165
2991,6,12,1,2412,-49,-91,42,40:e3:d6:da:ba:24,28220392,176,51,28220216,28220392
2992,6,12,1,2412,-49,-91,42,40:e3:d6:da:ba:25,28220603,160,51,28220443,28220603
2993,6,6,1,2412,-49,-91,42,40:e3:d6:da:ba:26,28220812,380,-171,28220432,28220812
2994,6,6,1,2412,-82,-91,9,e6:aa:ea:c9:ea:1b,28225614,408,4394,28225206,28225614
2995,4,1,1,2412,-69,-91,22,54:e4:3a:ec:fb:64,28230241,2160,2467,28228081,28230241
2996,6,6,1,2412,-69,-91,22,e6:aa:ea:b7:4a:dd,28243306,408,12657,28242898,28243306
2997,6,6,1,2412,-68,-91,23,e6:aa:ea:b7:4a:dd,28255248,408,11534,28254840,28255248
2998,6,6,1,2412,-82,-91,9,e6:aa:ea:c9:ea:1b,28261950,408,6294,28261542,28261950
2999,6,6,1,2412,-70,-91,21,e6:aa:ea:b7:4a:dd,28267352,408,4994,28266944,28267352
3000,6,12,1,2412,-49,-91,42,40:e3:d6:da:ba:20,28321590,160,54078,28321430,28321590
3001,6,6,1,2412,-48,-91,43,40:e3:d6:da:ba:21,28321924,368,-34,28321556,28321924
3002,6,12,1,2412,-48,-91,43,40:e3:d6:da:ba:22,28322311,180,207,28322131,28322311
3003,6,12,1,2412,-48,-91,43,40:e3:d6:da:ba:23,28322525,184,30,28322341,28322525
3004,6,12,1,2412,-48,-91,43,40:e3:d6:da:ba:24,28322753,176,52,28322577,28322753
3005,6,12,1,2412,-48,-91,43,40:e3:d6:da:ba:25,28322963,160,50,28322803,28322963
3006,6,6,1,2412,-48,-91,43,40:e3:d6:da:ba:26,28323182,380,-161,28322802,28323182
3007,4,1,1,2412,-67,-91,24,54:e4:3a:ec:fb:64,28332640,2160,7298,28330480,28332640
3008,6,6,1,2412,-49,-91,42,e6:aa:ea:c9:ea:33,28415022,408,81974,28414614,28415022
3009,6,12,1,2412,-48,-91,43,40:e3:d6:da:ba:20,28423988,160,8806,28423828,28423988
3010,6,6,1,2412,-48,-91,43,40:e3:d6:da:ba:21,28424198,368,-158,28423830,28424198
3011,6,12,1,2412,-48,-91,43,40:e3:d6:da:ba:23,28424866,184,484,28424682,28424866
3012,6,12,1,2412,-48,-91,43,40:e3:d6:da:ba:24,28425075,176,33,28424899,28425075
3013,6,12,1,2412,-48,-91,43,40:e3:d6:da:ba:25,28425285,160,50,28425125,28425285
3014,6,6,1,2412,-48,-91,43,40:e3:d6:da:ba:26,28425486,380,-179,28425106,28425486
3015,6,6,1,2412,-50,-91,41,e6:aa:ea:c9:ea:33,28426801,408,907,28426393,28426801
3016,4,1,1,2412,-64,-91,27,54:e4:3a:ec:fb:64,28435038,2160,6077,28432878,28435038
3017,6,6,1,2412,-50,-91,41,e6:aa:ea:c9:ea:33,28451036,408,15590,28450628,28451036
3018,6,12,1,2412,-47,-91,44,40:e3:d6:da:ba:20,28526398,160,75202,28526238,28526398
3019,6,6,1,2412,-47,-91,44,40:e3:d6:da:ba:21,28526605,368,-161,28526237,28526605
3020,6,12,1,2412,-47,-91,44,40:e3:d6:da:ba:23,28527280,184,491,28527096,28527280
3021,6,12,1,2412,-47,-91,44,40:e3:d6:da:ba:24,28527541,176,85,28527365,28527541
3022,6,12,1,2412,-47,-91,44,40:e3:d6:da:ba:25,28527742,160,41,28527582,28527742
3023,6,6,1,2412,-47,-91,44,40:e3:d6:da:ba:26,28527961,380,-161,28527581,28527961
3024,6,12,1,2412,-47,-91,44,40:e3:d6:da:ba:20,28628811,160,100690,28628651,28628811
3025,6,6,1,2412,-47,-91,44,40:e3:d6:da:ba:21,28629046,368,-133,28628678,28629046
3026,6,12,1,2412,-47,-91,44,40:e3:d6:da:ba:22,28629442,180,216,28629262,28629442
3027,6,12,1,2412,-47,-91,44,40:e3:d6:da:ba:23,28629657,184,31,28629473,28629657
3028,6,12,1,2412,-46,-91,45,40:e3:d6:da:ba:24,28629874,176,41,28629698,28629874
3029,6,12,1,2412,-47,-91,44,40:e3:d6:da:ba:25,28630077,160,43,28629917,28630077
3030,6,6,1,2412,-47,-91,44,40:e3:d6:da:ba:26,28630268,380,-189,28629888,28630268
3031,6,6,1,2412,-81,-91,10,e6:aa:ea:c9:ea:1b,28635119,408,4443,28634711,28635119
3032,6,6,1,2412,-67,-91,24,e6:aa:ea:b7:4a:dd,28636909,408,1382,28636501,28636909
3033,4,1,1,2412,-77,-91,14,b8:3a:5a:88:e6:e0,28642039,2360,2770,28639679,28642039
3034,6,6,1,2412,-81,-91,10,e6:aa:ea:c9:ea:1b,28647236,408,4789,28646828,28647236
3035,6,12,1,2412,-47,-91,44,40:e3:d6:da:ba:20,28652376,136,5004,28652240,28652376
3036,6,12,1,2412,-82,-91,9,,28652531,32,123,28652499,28652531
3037,6,6,1,2412,-47,-91,44,40:e3:d6:da:ba:21,28652605,348,-274,28652257,28652605
3038,6,12,1,2412,-47,-91,44,40:e3:d6:da:ba:22,28652981,156,220,28652825,28652981
3039,6,12,1,2412,-47,-91,44,40:e3:d6:da:ba:23,28653190,156,53,28653034,28653190
3040,6,12,1,2412,-47,-91,44,40:e3:d6:da:ba:25,28653389,136,63,28653253,28653389
3041,6,6,1,2412,-77,-91,14,e6:aa:ea:c9:ea:1b,28659353,408,5556,28658945,28659353
3042,6,6,1,2412,-67,-91,24,e6:aa:ea:b7:4a:dd,28661137,408,1376,28660729,28661137
3043,6,6,1,2412,-67,-91,24,e6:aa:ea:b7:4a:dd,28673252,408,11707,28672844,28673252
3044,6,6,1,2412,-80,-91,11,e6:aa:ea:c9:ea:1b,28683612,408,9952,28683204,28683612
3045,6,6,1,2412,-65,-91,26,e6:aa:ea:b7:4a:dd,28685387,408,1367,28684979,28685387
3046,6,12,1,2412,-82,-91,9,,28704752,32,19333,28704720,28704752
3047,6,12,1,2412,-82,-91,9,,28704995,32,211,28704963,28704995
3048,4,1,1,2412,-89,-91,2,a6:e5:7c:28:b1:d3,28705237,992,-750,28704245,28705237
3049,6,6,1,2412,-49,-91,42,e6:aa:ea:c9:ea:33,28717945,408,12300,28717537,28717945
3050,6,6,1,2412,-55,-91,36,e6:aa:ea:c9:ea:33,28730737,408,12384,28730329,28730737
3051,6,12,1,2412,-48,-91,43,40:e3:d6:da:ba:20,28731210,160,313,28731050,28731210
3052,6,6,1,2412,-47,-91,44,40:e3:d6:da:ba:21,28731420,368,-158,28731052,28731420
3053,6,12,1,2412,-47,-91,44,40:e3:d6:da:ba:22,28736269,180,4669,28736089,28736269
3054,6,6,1,2412,-47,-91,44,40:e3:d6:da:ba:26,28737224,380,575,28736844,28737224
3055,6,6,1,2412,-49,-91,42,e6:aa:ea:c9:ea:33,28754466,408,16834,28754058,28754466
3056,6,6,1,2412,-50,-91,41,e6:aa:ea:c9:ea:33,28766425,408,11551,28766017,28766425
3057,6,12,1,2412,-48,-91,43,40:e3:d6:da:ba:20,28833592,160,67007,28833432,28833592
3058,6,6,1,2412,-48,-91,43,40:e3:d6:da:ba:21,28833811,368,-149,28833443,28833811
3059,6,12,1,2412,-48,-91,43,40:e3:d6:da:ba:22,28834198,180,207,28834018,28834198
3060,6,12,1,2412,-47,-91,44,40:e3:d6:da:ba:23,28834438,184,56,28834254,28834438
3061,6,12,1,2412,-47,-91,44,40:e3:d6:da:ba:24,28834647,176,33,28834471,28834647
3062,6,12,1,2412,-48,-91,43,40:e3:d6:da:ba:25,28834876,160,69,28834716,28834876
3063,6,6,1,2412,-47,-91,44,40:e3:d6:da:ba:26,28835068,380,-188,28834688,28835068
3064,4,1,1,2412,-63,-91,28,54:e4:3a:ec:fb:64,28844635,2160,7407,28842475,28844635
3065,4,1,1,2412,-63,-91,28,54:e4:3a:ec:fb:64,28864592,2112,17845,28862480,28864592
3066,4,1,1,2412,-63,-91,28,54:e4:3a:ec:fb:64,28867246,2112,542,28865134,28867246
3067,4,1,1,2412,-63,-91,28,54:e4:3a:ec:fb:64,28869522,2112,164,28867410,28869522
3068,4,1,1,2412,-92,-91,-1,,28880192,304,10366,28879888,28880192
3069,6,12,1,2412,-48,-91,43,40:e3:d6:da:ba:20,28935997,160,55645,28935837,28935997
3070,6,6,1,2412,-49,-91,42,40:e3:d6:da:ba:21,28936189,368,-176,28935821,28936189
3071,6,12,1,2412,-48,-91,43,40:e3:d6:da:ba:22,28936576,180,207,28936396,28936576
3072,6,12,1,2412,-48,-91,43,40:e3:d6:da:ba:23,28936799,184,39,28936615,28936799
3073,6,12,1,2412,-48,-91,43,40:e3:d6:da:ba:24,28937009,176,34,28936833,28937009
3074,6,12,1,2412,-49,-91,42,40:e3:d6:da:ba:25,28937210,160,41,28937050,28937210
3075,6,6,1,2412,-48,-91,43,40:e3:d6:da:ba:26,28937402,380,-188,28937022,28937402
3076,6,6,1,2412,-64,-91,27,e6:aa:ea:b7:4a:dd,28953122,408,15312,28952714,28953122
3077,6,6,1,2412,-87,-91,4,84:d4:7e:f2:42:26,28955530,380,2028,28955150,28955530
3078,4,1,1,2412,-87,-91,4,c0:c9:e3:4d:6e:bf,28960099,872,3697,28959227,28960099
3079,6,6,1,2412,-81,-91,10,e6:aa:ea:c9:ea:1b,28964280,408,3773,28963872,28964280
3080,6,6,1,2412,-64,-91,27,e6:aa:ea:b7:4a:dd,28965227,408,539,28964819,28965227
3081,6,6,1,2412,-80,-91,11,e6:aa:ea:c9:ea:1b,28976389,408,10754,28975981,28976389
3082,6,6,1,2412,-64,-91,27,e6:aa:ea:b7:4a:dd,28977348,408,551,28976940,28977348
3083,6,6,1,2412,-80,-91,11,e6:aa:ea:c9:ea:1b,28988504,408,10748,28988096,28988504
3084,6,6,1,2412,-64,-91,27,e6:aa:ea:b7:4a:dd,28989469,408,557,28989061,28989469
3085,6,6,1,2412,-64,-91,27,e6:aa:ea:b7:4a:dd,29001588,408,11711,29001180,29001588
3086,6,6,1,2412,-51,-91,40,e6:aa:ea:c9:ea:33,29032720,408,30724,29032312,29032720
3087,6,12,1,2412,-49,-91,42,40:e3:d6:da:ba:20,29038401,160,5521,29038241,29038401
3088,6,6,1,2412,-49,-91,42,40:e3:d6:da:ba:21,29038602,368,-167,29038234,29038602
3089,6,12,1,2412,-49,-91,42,40:e3:d6:da:ba:22,29038998,180,216,29038818,29038998
3090,6,12,1,2412,-49,-91,42,40:e3:d6:da:ba:23,29039230,184,48,29039046,29039230
3091,6,12,1,2412,-49,-91,42,40:e3:d6:da:ba:24,29039449,176,43,29039273,29039449
3092,6,12,1,2412,-48,-91,43,40:e3:d6:da:ba:25,29039650,160,41,29039490,29039650
3093,6,6,1,2412,-49,-91,42,40:e3:d6:da:ba:26,29039860,380,-170,29039480,29039860
3094,6,6,1,2412,-51,-91,40,e6:aa:ea:c9:ea:33,29044853,408,4585,29044445,29044853
3095,4,1,1,2412,-64,-91,27,54:e4:3a:ec:fb:64,29049971,2160,2958,29047811,29049971
3096,6,6,1,2412,-52,-91,39,e6:aa:ea:c9:ea:33,29056968,408,6589,29056560,29056968
3097,6,6,1,2412,-52,-91,39,e6:aa:ea:c9:ea:33,29081202,408,23826,29080794,29081202
3098,6,12,1,2412,-50,-91,41,40:e3:d6:da:ba:20,29140790,160,59428,29140630,29140790
3099,6,6,1,2412,-50,-91,41,40:e3:d6:da:ba:21,29141000,368,-158,29140632,29141000
3100,6,12,1,2412,-50,-91,41,40:e3:d6:da:ba:22,29141414,180,234,29141234,29141414
3101,6,12,1,2412,-50,-91,41,40:e3:d6:da:ba:23,29141638,184,40,29141454,29141638
3102,6,12,1,2412,-50,-91,41,40:e3:d6:da:ba:24,29141856,176,42,29141680,29141856
3103,6,12,1,2412,-47,-91,44,40:e3:d6:da:ba:25,29142067,160,51,29141907,29142067
3104,6,6,1,2412,-50,-91,41,40:e3:d6:da:ba:26,29142268,380,-179,29141888,29142268
3105,4,1,1,2412,-64,-91,27,54:e4:3a:ec:fb:64,29151832,2160,7404,29149672,29151832
3106,4,1,1,2412,-90,-91,1,b8:3a:5a:88:e6:e0,29154042,2360,-150,29151682,29154042
3107,4,1,1,2412,-90,-91,1,a4:e5:7c:28:b1:d3,29212955,688,58225,29212267,29212955
3108,4,1,1,2412,-90,-91,1,,29213660,304,401,29213356,29213660
3109,4,1,1,2412,-85,-91,6,a6:e5:7c:28:b1:d3,29216754,992,2102,29215762,29216754
3110,6,12,1,2412,-49,-91,42,40:e3:d6:da:ba:20,29243192,160,26278,29243032,29243192
3111,6,6,1,2412,-49,-91,42,40:e3:d6:da:ba:21,29243393,368,-167,29243025,29243393
3112,6,12,1,2412,-49,-91,42,40:e3:d6:da:ba:22,29243798,180,225,29243618,29243798
3113,6,12,1,2412,-49,-91,42,40:e3:d6:da:ba:23,29244021,184,39,29243837,29244021
3114,6,12,1,2412,-49,-91,42,40:e3:d6:da:ba:24,29244240,176,43,29244064,29244240
3115,6,12,1,2412,-49,-91,42,40:e3:d6:da:ba:25,29244450,160,50,29244290,29244450
3116,6,6,1,2412,-49,-91,42,40:e3:d6:da:ba:26,29244651,380,-179,29244271,29244651
3117,4,1,1,2412,-64,-91,27,54:e4:3a:ec:fb:64,29254232,2160,7421,29252072,29254232
3118,4,1,1,2412,-90,-91,1,,29305210,304,50674,29304906,29305210
3119,6,12,1,2412,-48,-91,43,40:e3:d6:da:ba:20,29345616,160,40246,29345456,29345616
3120,6,6,1,2412,-48,-91,43,40:e3:d6:da:ba:21,29345835,368,-149,29345467,29345835
3121,6,12,1,2412,-47,-91,44,40:e3:d6:da:ba:22,29346265,180,250,29346085,29346265
3122,6,12,1,2412,-47,-91,44,40:e3:d6:da:ba:23,29346470,184,21,29346286,29346470
3123,6,12,1,2412,-49,-91,42,40:e3:d6:da:ba:24,29349199,176,2553,29349023,29349199
3124,6,12,1,2412,-48,-91,43,40:e3:d6:da:ba:25,29349401,160,42,29349241,29349401
3125,6,6,1,2412,-48,-91,43,40:e3:d6:da:ba:26,29349652,380,-129,29349272,29349652
3126,4,1,1,2412,-64,-91,27,54:e4:3a:ec:fb:64,29356630,2160,4818,29354470,29356630
3127,6,12,1,2412,-48,-91,43,40:e3:d6:da:ba:20,29449176,160,92386,29449016,29449176
3128,6,6,1,2412,-48,-91,43,40:e3:d6:da:ba:21,29449427,368,-117,29449059,29449427
3129,6,12,1,2412,-48,-91,43,40:e3:d6:da:ba:22,29449823,180,216,29449643,29449823
3130,6,12,1,2412,-48,-91,43,40:e3:d6:da:ba:23,29450052,184,45,29449868,29450052
3131,6,12,1,2412,-48,-91,43,40:e3:d6:da:ba:24,29450280,176,52,29450104,29450280
3132,6,12,1,2412,-48,-91,43,40:e3:d6:da:ba:25,29450481,160,41,29450321,29450481
3133,6,6,1,2412,-48,-91,43,40:e3:d6:da:ba:26,29450673,380,-188,29450293,29450673
3134,4,1,1,2412,-61,-91,30,54:e4:3a:ec:fb:64,29459029,2160,6196,29456869,29459029
3135,6,6,1,2412,-52,-91,39,e6:aa:ea:c9:ea:33,29463252,408,3815,29462844,29463252
3136,6,6,1,2412,-53,-91,38,e6:aa:ea:c9:ea:33,29475441,408,11781,29475033,29475441
3137,6,6,1,2412,-63,-91,28,e6:aa:ea:b7:4a:dd,29497638,408,21789,29497230,29497638
3138,6,6,1,2412,-63,-91,28,e6:aa:ea:b7:4a:dd,29509766,408,11720,29509358,29509766
3139,6,12,1,2412,-48,-91,43,40:e3:d6:da:ba:20,29551563,160,41637,29551403,29551563
3140,6,6,1,2412,-47,-91,44,40:e3:d6:da:ba:21,29551783,368,-148,29551415,29551783
3141,6,12,1,2412,-48,-91,43,40:e3:d6:da:ba:22,29552169,180,206,29551989,29552169
3142,6,12,1,2412,-48,-91,43,40:e3:d6:da:ba:23,29552375,184,22,29552191,29552375
3143,6,12,1,2412,-48,-91,43,40:e3:d6:da:ba:24,29552602,176,51,29552426,29552602
3144,6,12,1,2412,-48,-91,43,40:e3:d6:da:ba:25,29552804,160,42,29552644,29552804
3145,6,6,1,2412,-48,-91,43,40:e3:d6:da:ba:26,29553005,380,-179,29552625,29553005
3146,4,1,1,2412,-60,-91,31,54:e4:3a:ec:fb:64,29561429,2160,6264,29559269,29561429
3147,6,12,1,2412,-49,-91,42,40:e3:d6:da:ba:20,29652808,160,91219,29652648,29652808
3148,6,6,1,2412,-49,-91,42,40:e3:d6:da:ba:21,29653018,368,-158,29652650,29653018
3149,6,12,1,2412,-49,-91,42,40:e3:d6:da:ba:22,29653414,180,216,29653234,29653414
3150,6,12,1,2412,-49,-91,42,40:e3:d6:da:ba:23,29653637,184,39,29653453,29653637
3151,6,12,1,2412,-49,-91,42,40:e3:d6:da:ba:24,29653856,176,43,29653680,29653856
3152,6,12,1,2412,-49,-91,42,40:e3:d6:da:ba:25,29654075,160,59,29653915,29654075
3153,6,6,1,2412,-49,-91,42,40:e3:d6:da:ba:26,29654267,380,-188,29653887,29654267
3154,4,1,1,2412,-64,-91,27,54:e4:3a:ec:fb:64,29663828,2160,7401,29661668,29663828
3155,6,6,1,2412,-87,-91,4,84:d4:7e:f2:42:21,29671170,368,6974,29670802,29671170
3156,6,12,1,2412,-52,-91,39,40:e3:d6:da:ba:20,29755211,160,83881,29755051,29755211
3157,6,6,1,2412,-52,-91,39,40:e3:d6:da:ba:21,29755403,368,-176,29755035,29755403
3158,6,12,1,2412,-52,-91,39,40:e3:d6:da:ba:22,29755790,180,207,29755610,29755790
3159,6,12,1,2412,-52,-91,39,40:e3:d6:da:ba:23,29755995,184,21,29755811,29755995
3160,6,6,1,2412,-51,-91,40,40:e3:d6:da:ba:26,29756717,380,342,29756337,29756717
3161,4,1,1,2412,-66,-91,25,b8:3a:5a:88:e6:e0,29768559,2360,9482,29766199,29768559
3162,6,6,1,2412,-52,-91,39,e6:aa:ea:c9:ea:33,29777550,408,8583,29777142,29777550
3163,6,6,1,2412,-66,-91,25,e6:aa:ea:b7:4a:dd,29788771,408,10813,29788363,29788771
3164,6,6,1,2412,-51,-91,40,e6:aa:ea:c9:ea:33,29795166,408,5987,29794758,29795166
3165,6,6,1,2412,-66,-91,25,e6:aa:ea:b7:4a:dd,29800896,408,5322,29800488,29800896
3166,6,6,1,2412,-51,-91,40,e6:aa:ea:c9:ea:33,29806265,408,4961,29805857,29806265
3167,6,6,1,2412,-66,-91,25,e6:aa:ea:b7:4a:dd,29813016,408,6343,29812608,29813016
3168,6,6,1,2412,-51,-91,40,e6:aa:ea:c9:ea:33,29813903,408,479,29813495,29813903
3169,6,6,1,2412,-66,-91,25,e6:aa:ea:b7:4a:dd,29825148,408,10837,29824740,29825148
3170,4,1,1,2412,-88,-91,3,a6:e5:7c:28:b1:d3,29830626,992,4486,29829634,29830626
3171,6,6,1,2412,-67,-91,24,e6:aa:ea:b7:4a:dd,29837395,408,6361,29836987,29837395
3172,6,12,1,2412,-52,-91,39,40:e3:d6:da:ba:20,29857717,160,20162,29857557,29857717
3173,6,6,1,2412,-52,-91,39,40:e3:d6:da:ba:21,29857936,368,-149,29857568,29857936
3174,6,12,1,2412,-52,-91,39,40:e3:d6:da:ba:22,29858341,180,225,29858161,29858341
3175,6,12,1,2412,-52,-91,39,40:e3:d6:da:ba:23,29858564,184,39,29858380,29858564
3176,6,12,1,2412,-51,-91,40,40:e3:d6:da:ba:24,29858792,176,52,29858616,29858792
3177,6,12,1,2412,-52,-91,39,40:e3:d6:da:ba:25,29859011,160,59,29858851,29859011
3178,6,6,1,2412,-51,-91,40,40:e3:d6:da:ba:26,29859212,380,-179,29858832,29859212
3179,6,12,1,2412,-86,-91,5,84:d4:7e:f2:42:24,29876777,176,17389,29876601,29876777
3180,6,12,1,2412,-87,-91,4,84:d4:7e:f2:42:25,29876987,160,50,29876827,29876987
3181,6,6,1,2412,-87,-91,4,84:d4:7e:f2:42:26,29877206,380,-161,29876826,29877206
3182,6,6,1,2412,-85,-91,6,e6:aa:ea:c9:ea:1b,29907949,408,30335,29907541,29907949
3183,6,6,1,2412,-84,-91,7,e6:aa:ea:c9:ea:1b,29932184,408,23827,29931776,29932184
3184,4,1,1,2412,-87,-91,4,a6:e5:7c:28:b1:d3,29933811,992,635,29932819,29933811
3185,6,6,1,2412,-85,-91,6,e6:aa:ea:c9:ea:1b,29944293,408,10074,29943885,29944293
3186,6,12,1,2412,-51,-91,40,40:e3:d6:da:ba:20,29959996,160,15543,29959836,29959996
3187,6,6,1,2412,-51,-91,40,40:e3:d6:da:ba:21,29960197,368,-167,29959829,29960197
3188,6,12,1,2412,-51,-91,40,40:e3:d6:da:ba:22,29960602,180,225,29960422,29960602
3189,6,12,1,2412,-51,-91,40,40:e3:d6:da:ba:23,29960816,184,30,29960632,29960816
3190,6,12,1,2412,-51,-91,40,40:e3:d6:da:ba:24,29961026,176,34,29960850,29961026
3191,6,12,1,2412,-51,-91,40,40:e3:d6:da:ba:25,29961254,160,68,29961094,29961254
3192,6,6,1,2412,-51,-91,40,40:e3:d6:da:ba:26,29961473,380,-161,29961093,29961473
3193,4,1,1,2412,-67,-91,24,54:e4:3a:ec:fb:64,29971026,2160,7393,29968866,29971026
3194,6,12,1,2412,-52,-91,39,40:e3:d6:da:ba:20,30063909,160,92723,30063749,30063909
3195,6,6,1,2412,-51,-91,40,40:e3:d6:da:ba:21,30064101,368,-176,30063733,30064101
3196,6,12,1,2412,-51,-91,40,40:e3:d6:da:ba:22,30064515,180,234,30064335,30064515
3197,6,12,1,2412,-52,-91,39,40:e3:d6:da:ba:23,30064720,184,21,30064536,30064720
3198,6,12,1,2412,-51,-91,40,40:e3:d6:da:ba:24,30064930,176,34,30064754,30064930
3199,6,12,1,2412,-51,-91,40,40:e3:d6:da:ba:25,30065131,160,41,30064971,30065131
3200,6,6,1,2412,-51,-91,40,40:e3:d6:da:ba:26,30065341,380,-170,30064961,30065341
3201,6,6,1,2412,-49,-91,42,e6:aa:ea:c9:ea:33,30079993,408,14244,30079585,30079993
3202,6,6,1,2412,-87,-91,4,84:d4:7e:f2:42:21,30080575,368,214,30080207,30080575
3203,6,6,1,2412,-49,-91,42,e6:aa:ea:c9:ea:33,30092122,408,11139,30091714,30092122
3204,6,6,1,2412,-67,-91,24,e6:aa:ea:b7:4a:dd,30104192,408,11662,30103784,30104192
3205,6,6,1,2412,-48,-91,43,e6:aa:ea:c9:ea:33,30105239,408,639,30104831,30105239
3206,6,6,1,2412,-48,-91,43,e6:aa:ea:c9:ea:33,30116362,408,10715,30115954,30116362
3207,6,6,1,2412,-67,-91,24,e6:aa:ea:b7:4a:dd,30140550,408,23780,30140142,30140550
3208,6,6,1,2412,-67,-91,24,e6:aa:ea:b7:4a:dd,30152666,408,11708,30152258,30152666
3209,6,12,1,2412,-52,-91,39,40:e3:d6:da:ba:20,30164817,160,11991,30164657,30164817
3210,6,6,1,2412,-52,-91,39,40:e3:d6:da:ba:21,30165009,368,-176,30164641,30165009
3211,6,12,1,2412,-51,-91,40,40:e3:d6:da:ba:22,30165423,180,234,30165243,30165423
3212,6,12,1,2412,-51,-91,40,40:e3:d6:da:ba:23,30165646,184,39,30165462,30165646
3213,6,12,1,2412,-52,-91,39,40:e3:d6:da:ba:24,30165856,176,34,30165680,30165856
3214,6,12,1,2412,-51,-91,40,40:e3:d6:da:ba:25,30166066,160,50,30165906,30166066
3215,6,6,1,2412,-51,-91,40,40:e3:d6:da:ba:26,30166285,380,-161,30165905,30166285
3216,6,6,1,2412,-87,-91,4,84:d4:7e:f2:42:26,30184281,380,17616,30183901,30184281
3217,6,12,1,2412,-51,-91,40,40:e3:d6:da:ba:20,30267221,160,82780,30267061,30267221
3218,6,6,1,2412,-51,-91,40,40:e3:d6:da:ba:21,30267413,368,-176,30267045,30267413
3219,6,12,1,2412,-51,-91,40,40:e3:d6:da:ba:22,30267809,180,216,30267629,30267809
3220,6,12,1,2412,-51,-91,40,40:e3:d6:da:ba:23,30268024,184,31,30267840,30268024
3221,6,12,1,2412,-51,-91,40,40:e3:d6:da:ba:24,30268251,176,51,30268075,30268251
3222,6,12,1,2412,-51,-91,40,40:e3:d6:da:ba:25,30268480,160,69,30268320,30268480
3223,6,6,1,2412,-51,-91,40,40:e3:d6:da:ba:26,30268791,380,-69,30268411,30268791
3224,6,6,1,2412,-82,-91,9,e6:aa:ea:c9:ea:1b,30316981,408,47782,30316573,30316981
3225,6,6,1,2412,-81,-91,10,e6:aa:ea:c9:ea:1b,30353321,408,35932,30352913,30353321
3226,6,12,1,2412,-55,-91,36,40:e3:d6:da:ba:20,30369621,160,16140,30369461,30369621
3227,6,6,1,2412,-55,-91,36,40:e3:d6:da:ba:21,30369813,368,-176,30369445,30369813
3228,6,12,1,2412,-55,-91,36,40:e3:d6:da:ba:22,30370227,180,234,30370047,30370227
3229,6,12,1,2412,-54,-91,37,40:e3:d6:da:ba:23,30370450,184,39,30370266,30370450
3230,6,12,1,2412,-55,-91,36,40:e3:d6:da:ba:24,30370660,176,34,30370484,30370660
3231,6,6,1,2412,-53,-91,38,40:e3:d6:da:ba:26,30371120,380,80,30370740,30371120
3232,6,12,1,2412,-53,-91,38,40:e3:d6:da:ba:20,30472009,160,100729,30471849,30472009
3233,6,6,1,2412,-54,-91,37,40:e3:d6:da:ba:21,30477829,368,5452,30477461,30477829
3234,6,12,1,2412,-53,-91,38,40:e3:d6:da:ba:22,30478259,180,250,30478079,30478259
3235,6,12,1,2412,-53,-91,38,40:e3:d6:da:ba:23,30478499,184,56,30478315,30478499
3236,6,12,1,2412,-53,-91,38,40:e3:d6:da:ba:24,30478726,176,51,30478550,30478726
3237,6,12,1,2412,-53,-91,38,40:e3:d6:da:ba:25,30478936,160,50,30478776,30478936
3238,6,6,1,2412,-53,-91,38,40:e3:d6:da:ba:26,30479146,380,-170,30478766,30479146
3239,4,1,1,2412,-69,-91,22,54:e4:3a:ec:fb:64,30483022,2160,1716,30480862,30483022
3240,4,1,1,2412,-87,-91,4,b8:3a:5a:88:e6:e0,30485547,2360,165,30483187,30485547
3241,4,1,1,2412,-86,-91,5,b8:3a:5a:88:e6:e1,30487936,2376,13,30485560,30487936
3242,6,12,1,2412,-53,-91,38,40:e3:d6:da:ba:20,30574399,160,86303,30574239,30574399
3243,6,6,1,2412,-53,-91,38,40:e3:d6:da:ba:21,30574600,368,-167,30574232,30574600
3244,6,12,1,2412,-53,-91,38,40:e3:d6:da:ba:22,30574996,180,216,30574816,30574996
3245,6,12,1,2412,-53,-91,38,40:e3:d6:da:ba:23,30575219,184,39,30575035,30575219
3246,6,12,1,2412,-54,-91,37,40:e3:d6:da:ba:24,30575438,176,43,30575262,30575438
3247,6,12,1,2412,-53,-91,38,40:e3:d6:da:ba:25,30575648,160,50,30575488,30575648
3248,6,6,1,2412,-53,-91,38,40:e3:d6:da:ba:26,30575849,380,-179,30575469,30575849
3249,4,1,1,2412,-69,-91,22,54:e4:3a:ec:fb:64,30585430,2160,7421,30583270,30585430
3250,4,1,1,2412,-90,-91,1,a6:e5:7c:28:b1:d3,30594738,944,8364,30593794,30594738
3251,6,6,1,2412,-51,-91,40,e6:aa:ea:c9:ea:33,30617968,408,22822,30617560,30617968
3252,6,6,1,2412,-51,-91,40,e6:aa:ea:c9:ea:33,30625254,408,6878,30624846,30625254
3253,6,6,1,2412,-82,-91,9,e6:aa:ea:c9:ea:1b,30634940,408,9278,30634532,30634940
3254,6,6,1,2412,-52,-91,39,e6:aa:ea:c9:ea:33,30641222,408,5874,30640814,30641222
3255,6,6,1,2412,-82,-91,9,e6:aa:ea:c9:ea:1b,30646894,408,5264,30646486,30646894
3256,6,6,1,2412,-52,-91,39,e6:aa:ea:c9:ea:33,30647634,408,332,30647226,30647634
3257,6,6,1,2412,-70,-91,21,e6:aa:ea:b7:4a:dd,30649170,408,1128,30648762,30649170
3258,6,6,1,2412,-82,-91,9,e6:aa:ea:c9:ea:1b,30671129,408,21551,30670721,30671129
3259,6,12,1,2412,-54,-91,37,40:e3:d6:da:ba:20,30676799,160,5510,30676639,30676799
3260,6,6,1,2412,-54,-91,37,40:e3:d6:da:ba:21,30677009,368,-158,30676641,30677009
3261,6,12,1,2412,-54,-91,37,40:e3:d6:da:ba:22,30677414,180,225,30677234,30677414
3262,6,12,1,2412,-54,-91,37,40:e3:d6:da:ba:23,30677646,184,48,30677462,30677646
3263,6,12,1,2412,-54,-91,37,40:e3:d6:da:ba:24,30677883,176,61,30677707,30677883
3264,6,12,1,2412,-54,-91,37,40:e3:d6:da:ba:25,30678084,160,41,30677924,30678084
3265,6,6,1,2412,-54,-91,37,40:e3:d6:da:ba:26,30678285,380,-179,30677905,30678285
3266,4,1,1,2412,-63,-91,28,54:e4:3a:ec:fb:64,30687819,2160,7374,30685659,30687819
3267,6,12,1,2412,-53,-91,38,40:e3:d6:da:ba:20,30779214,160,91235,30779054,30779214
3268,6,6,1,2412,-53,-91,38,40:e3:d6:da:ba:21,30779424,368,-158,30779056,30779424
3269,6,12,1,2412,-53,-91,38,40:e3:d6:da:ba:22,30779811,180,207,30779631,30779811
3270,6,12,1,2412,-53,-91,38,40:e3:d6:da:ba:23,30781121,184,1126,30780937,30781121
3271,6,12,1,2412,-53,-91,38,40:e3:d6:da:ba:24,30781331,176,34,30781155,30781331
3272,6,12,1,2412,-53,-91,38,40:e3:d6:da:ba:25,30781550,160,59,30781390,30781550
3273,4,1,1,2412,-63,-91,28,54:e4:3a:ec:fb:64,30790218,2160,6508,30788058,30790218
3274,6,12,1,2412,-51,-91,40,40:e3:d6:da:ba:20,30881605,160,91227,30881445,30881605
3275,6,6,1,2412,-51,-91,40,40:e3:d6:da:ba:21,30881824,368,-149,30881456,30881824
3276,6,12,1,2412,-51,-91,40,40:e3:d6:da:ba:22,30882238,180,234,30882058,30882238
3277,6,12,1,2412,-51,-91,40,40:e3:d6:da:ba:23,30882443,184,21,30882259,30882443
3278,6,12,1,2412,-51,-91,40,40:e3:d6:da:ba:24,30882652,176,33,30882476,30882652
3279,6,12,1,2412,-51,-91,40,40:e3:d6:da:ba:25,30882872,160,60,30882712,30882872
3280,6,6,1,2412,-51,-91,40,40:e3:d6:da:ba:26,30883064,380,-188,30882684,30883064
3281,4,1,1,2412,-57,-91,34,54:e4:3a:ec:fb:64,30892618,2160,7394,30890458,30892618
3282,6,6,1,2412,-51,-91,40,e6:aa:ea:c9:ea:33,30915312,408,22286,30914904,30915312
3283,4,1,1,2412,-85,-91,6,c0:c9:e3:4d:6e:bf,30922902,872,6718,30922030,30922902
3284,4,1,1,2412,-89,-91,2,,30923791,304,585,30923487,30923791
3285,6,6,1,2412,-51,-91,40,e6:aa:ea:c9:ea:33,30927419,408,3220,30927011,30927419
3286,6,6,1,2412,-50,-91,41,e6:aa:ea:c9:ea:33,30939536,408,11709,30939128,30939536
3287,6,6,1,2412,-51,-91,40,e6:aa:ea:c9:ea:33,30951641,408,11697,30951233,30951641
3288,6,12,1,2412,-51,-91,40,40:e3:d6:da:ba:20,30984024,160,32223,30983864,30984024
3289,6,6,1,2412,-51,-91,40,40:e3:d6:da:ba:21,30984225,368,-167,30983857,30984225
3290,6,12,1,2412,-51,-91,40,40:e3:d6:da:ba:22,30984638,180,233,30984458,30984638
3291,6,12,1,2412,-51,-91,40,40:e3:d6:da:ba:23,30984871,184,49,30984687,30984871
3292,6,12,1,2412,-51,-91,40,40:e3:d6:da:ba:24,30985107,176,60,30984931,30985107
3293,6,12,1,2412,-51,-91,40,40:e3:d6:da:ba:25,30985309,160,42,30985149,30985309
3294,6,6,1,2412,-51,-91,40,40:e3:d6:da:ba:26,30985519,380,-170,30985139,30985519
3295,4,1,1,2412,-63,-91,28,54:e4:3a:ec:fb:64,30995016,2160,7337,30992856,30995016
3296,6,12,1,2412,-50,-91,41,40:e3:d6:da:ba:20,31086400,160,91224,31086240,31086400
3297,6,6,1,2412,-49,-91,42,40:e3:d6:da:ba:21,31086619,368,-149,31086251,31086619
3298,6,12,1,2412,-49,-91,42,40:e3:d6:da:ba:22,31087024,180,225,31086844,31087024
3299,6,12,1,2412,-50,-91,41,40:e3:d6:da:ba:23,31087247,184,39,31087063,31087247
3300,6,12,1,2412,-49,-91,42,40:e3:d6:da:ba:24,31087466,176,43,31087290,31087466
3301,6,12,1,2412,-50,-91,41,40:e3:d6:da:ba:25,31087667,160,41,31087507,31087667
3302,6,6,1,2412,-49,-91,42,40:e3:d6:da:ba:26,31087868,380,-179,31087488,31087868
3303,4,1,1,2412,-65,-91,26,54:e4:3a:ec:fb:64,31097415,2160,7387,31095255,31097415
3304,6,6,1,2412,-70,-91,21,e6:aa:ea:b7:4a:dd,31144496,408,46673,31144088,31144496
3305,6,6,1,2412,-70,-91,21,e6:aa:ea:b7:4a:dd,31156492,408,11588,31156084,31156492
3306,6,6,1,2412,-84,-91,7,e6:aa:ea:c9:ea:1b,31157171,408,271,31156763,31157171
3307,6,6,1,2412,-70,-91,21,e6:aa:ea:b7:4a:dd,31168603,408,11024,31168195,31168603
3308,6,6,1,2412,-85,-91,6,e6:aa:ea:c9:ea:1b,31169290,408,279,31168882,31169290
3309,6,12,1,2412,-50,-91,41,40:e3:d6:da:ba:20,31188841,160,19391,31188681,31188841
3310,6,6,1,2412,-51,-91,40,40:e3:d6:da:ba:21,31189061,368,-148,31188693,31189061
3311,6,12,1,2412,-51,-91,40,40:e3:d6:da:ba:22,31189448,180,207,31189268,31189448
3312,6,12,1,2412,-51,-91,40,40:e3:d6:da:ba:23,31189671,184,39,31189487,31189671
3313,6,12,1,2412,-51,-91,40,40:e3:d6:da:ba:24,31189881,176,34,31189705,31189881
3314,6,12,1,2412,-50,-91,41,40:e3:d6:da:ba:25,31190100,160,59,31189940,31190100
3315,6,6,1,2412,-50,-91,41,40:e3:d6:da:ba:26,31190319,380,-161,31189939,31190319
3316,4,1,1,2412,-60,-91,31,54:e4:3a:ec:fb:64,31199815,2160,7336,31197655,31199815
3317,6,6,1,2412,-84,-91,7,e6:aa:ea:c9:ea:1b,31205643,408,5420,31205235,31205643
3318,6,6,1,2412,-51,-91,40,e6:aa:ea:c9:ea:33,31242316,408,36265,31241908,31242316
3319,6,6,1,2412,-51,-91,40,e6:aa:ea:c9:ea:33,31254448,408,11724,31254040,31254448
3320,6,6,1,2412,-51,-91,40,e6:aa:ea:c9:ea:33,31266569,408,11713,31266161,31266569
3321,6,6,1,2412,-52,-91,39,e6:aa:ea:c9:ea:33,31278683,408,11706,31278275,31278683
3322,4,1,1,2412,-48,-91,43,c4:23:60:66:07:8d,31281132,2368,81,31278764,31281132
3323,4,1,1,2412,-44,-91,47,c4:23:60:66:07:8d,31285611,2288,2191,31283323,31285611
3324,4,1,1,2412,-59,-91,32,54:e4:3a:ec:fb:64,31288016,2112,293,31285904,31288016
3325,4,1,1,2412,-45,-91,46,,31290138,304,1818,31289834,31290138
3326,6,12,1,2412,-47,-91,44,40:e3:d6:da:ba:20,31290302,136,28,31290166,31290302
3327,6,12,1,2412,-45,-91,46,,31290454,32,120,31290422,31290454
3328,6,6,1,2412,-47,-91,44,40:e3:d6:da:ba:21,31290537,348,-265,31290189,31290537
3329,6,12,1,2412,-47,-91,44,40:e3:d6:da:ba:22,31290931,156,238,31290775,31290931
3330,6,12,1,2412,-45,-91,46,,31291103,32,140,31291071,31291103
3331,6,12,1,2412,-46,-91,45,40:e3:d6:da:ba:23,31291197,156,-62,31291041,31291197
3332,6,12,1,2412,-45,-91,46,,31291369,32,140,31291337,31291369
3333,6,12,1,2412,-47,-91,44,40:e3:d6:da:ba:25,31291455,136,-50,31291319,31291455
3334,6,12,1,2412,-47,-91,44,40:e3:d6:da:ba:20,31292754,160,1139,31292594,31292754
3335,6,6,1,2412,-47,-91,44,40:e3:d6:da:ba:21,31292946,368,-176,31292578,31292946
3336,6,12,1,2412,-47,-91,44,40:e3:d6:da:ba:22,31293360,180,234,31293180,31293360
3337,6,12,1,2412,-47,-91,44,40:e3:d6:da:ba:23,31293574,184,30,31293390,31293574
3338,6,12,1,2412,-47,-91,44,40:e3:d6:da:ba:24,31293802,176,52,31293626,31293802
3339,6,12,1,2412,-47,-91,44,40:e3:d6:da:ba:25,31294003,160,41,31293843,31294003
3340,6,6,1,2412,-47,-91,44,40:e3:d6:da:ba:26,31294195,380,-188,31293815,31294195
3341,4,1,1,2412,-61,-91,30,54:e4:3a:ec:fb:64,31302214,2160,5859,31300054,31302214
3342,6,6,1,2412,-44,-91,47,c4:23:60:66:07:8d,31349472,388,46870,31349084,31349472
3343,6,6,1,2412,-44,-91,47,c4:23:60:66:07:8d,31351972,376,2124,31351596,31351972
3344,6,12,1,2412,-48,-91,43,40:e3:d6:da:ba:20,31354665,136,2557,31354529,31354665
3345,6,12,1,2412,-44,-91,47,,31354817,32,120,31354785,31354817
3346,6,6,1,2412,-48,-91,43,40:e3:d6:da:ba:21,31354899,348,-266,31354551,31354899
3347,6,6,1,2412,-44,-91,47,,31355263,44,320,31355219,31355263
3348,6,12,1,2412,-48,-91,43,40:e3:d6:da:ba:22,31355354,156,-65,31355198,31355354
3349,6,12,1,2412,-44,-91,47,,31355526,32,140,31355494,31355526
3350,6,12,1,2412,-48,-91,43,40:e3:d6:da:ba:23,31355620,156,-62,31355464,31355620
3351,6,12,1,2412,-48,-91,43,40:e3:d6:da:ba:25,31355887,136,131,31355751,31355887
3352,6,12,1,2412,-44,-91,47,,31356039,32,120,31356007,31356039
3353,4,1,1,2412,-60,-91,31,54:e4:3a:ec:fb:64,31356367,2112,-1784,31354255,31356367
3354,4,1,1,2412,-45,-91,46,,31358489,304,1818,31358185,31358489
3355,6,12,1,2412,-50,-91,41,40:e3:d6:da:ba:20,31393622,160,34973,31393462,31393622
3356,6,6,1,2412,-49,-91,42,40:e3:d6:da:ba:21,31393832,368,-158,31393464,31393832
3357,6,12,1,2412,-49,-91,42,40:e3:d6:da:ba:23,31394451,184,435,31394267,31394451
3358,6,12,1,2412,-50,-91,41,40:e3:d6:da:ba:24,31394670,176,43,31394494,31394670
3359,6,12,1,2412,-49,-91,42,40:e3:d6:da:ba:25,31394889,160,59,31394729,31394889
3360,6,6,1,2412,-49,-91,42,40:e3:d6:da:ba:26,31395099,380,-170,31394719,31395099
3361,4,1,1,2412,-66,-91,25,54:e4:3a:ec:fb:64,31404613,2160,7354,31402453,31404613
3362,4,1,1,2412,-86,-91,5,c0:c9:e3:4d:6e:bf,31418584,872,13099,31417712,31418584
3363,4,1,1,2412,-48,-91,43,c4:23:60:66:07:8d,31438043,2368,17091,31435675,31438043
3364,4,1,1,2412,-49,-91,42,c4:23:60:66:07:8d,31442522,2288,2191,31440234,31442522
3365,6,12,1,2412,-50,-91,41,40:e3:d6:da:ba:20,31446121,136,3463,31445985,31446121
3366,6,6,1,2412,-50,-91,41,40:e3:d6:da:ba:21,31446325,348,-144,31445977,31446325
3367,4,1,1,2412,-87,-91,4,,31464277,304,17648,31463973,31464277
3368,6,6,1,2412,-67,-91,24,e6:aa:ea:b7:4a:dd,31472181,408,7496,31471773,31472181
3369,6,6,1,2412,-66,-91,25,e6:aa:ea:b7:4a:dd,31484480,408,11891,31484072,31484480
3370,6,12,1,2412,-49,-91,42,40:e3:d6:da:ba:20,31496003,160,11363,31495843,31496003
3371,6,6,1,2412,-49,-91,42,40:e3:d6:da:ba:21,31496213,368,-158,31495845,31496213
3372,6,12,1,2412,-49,-91,42,40:e3:d6:da:ba:22,31496643,180,250,31496463,31496643
3373,6,12,1,2412,-49,-91,42,40:e3:d6:da:ba:23,31496874,184,47,31496690,31496874
3374,6,12,1,2412,-49,-91,42,40:e3:d6:da:ba:24,31497101,176,51,31496925,31497101
3375,6,12,1,2412,-49,-91,42,40:e3:d6:da:ba:25,31497321,160,60,31497161,31497321
3376,6,6,1,2412,-67,-91,24,e6:aa:ea:b7:4a:dd,31497531,408,-198,31497123,31497531
3377,6,6,1,2412,-49,-91,42,40:e3:d6:da:ba:26,31497993,380,82,31497613,31497993
3378,4,1,1,2412,-87,-91,4,a4:e5:7c:28:b1:d3,31517549,688,18868,31516861,31517549
3379,6,6,1,2412,-53,-91,38,e6:aa:ea:c9:ea:33,31544791,408,26834,31544383,31544791
3380,6,6,1,2412,-53,-91,38,e6:aa:ea:c9:ea:33,31559031,408,13832,31558623,31559031
3381,6,6,1,2412,-52,-91,39,e6:aa:ea:c9:ea:33,31569098,408,9659,31568690,31569098
3382,6,6,1,2412,-54,-91,37,e6:aa:ea:c9:ea:33,31581143,408,11637,31580735,31581143
3383,6,6,1,2412,-54,-91,37,e6:aa:ea:c9:ea:33,31593276,408,11725,31592868,31593276
3384,6,12,1,2412,-47,-91,44,40:e3:d6:da:ba:20,31598715,160,5279,31598555,31598715
3385,6,6,1,2412,-47,-91,44,40:e3:d6:da:ba:21,31598907,368,-176,31598539,31598907
3386,6,12,1,2412,-47,-91,44,40:e3:d6:da:ba:22,31599294,180,207,31599114,31599294
3387,6,12,1,2412,-47,-91,44,40:e3:d6:da:ba:23,31599517,184,39,31599333,31599517
3388,6,12,1,2412,-47,-91,44,40:e3:d6:da:ba:24,31599736,176,43,31599560,31599736
3389,6,12,1,2412,-47,-91,44,40:e3:d6:da:ba:25,31599964,160,68,31599804,31599964
3390,6,6,1,2412,-47,-91,44,40:e3:d6:da:ba:26,31600156,380,-188,31599776,31600156
3391,6,6,1,2412,-69,-91,22,48:e7:da:41:38:ff,31603993,88,3749,31603905,31603993
3392,6,12,1,2412,-47,-91,44,40:e3:d6:da:ba:20,31604219,136,90,31604083,31604219
3393,6,6,1,2412,-47,-91,44,40:e3:d6:da:ba:21,31604405,348,-162,31604057,31604405
3394,6,6,1,2412,-69,-91,22,,31604769,44,320,31604725,31604769
3395,6,12,1,2412,-47,-91,44,40:e3:d6:da:ba:22,31604860,156,-65,31604704,31604860
3396,6,12,1,2412,-70,-91,21,,31605032,32,140,31605000,31605032
3397,6,12,1,2412,-47,-91,44,40:e3:d6:da:ba:23,31605126,156,-62,31604970,31605126
3398,6,12,1,2412,-46,-91,45,40:e3:d6:da:ba:25,31605379,136,117,31605243,31605379
3399,4,1,1,2412,-63,-91,28,54:e4:3a:ec:fb:64,31609412,2160,1873,31607252,31609412
3400,4,1,1,2412,-87,-91,4,a6:e5:7c:28:b1:d3,31673785,992,63381,31672793,31673785
3401,6,12,1,2412,-49,-91,42,40:e3:d6:da:ba:20,31700809,160,26864,31700649,31700809
3402,6,6,1,2412,-49,-91,42,40:e3:d6:da:ba:21,31701001,368,-176,31700633,31701001
3403,6,12,1,2412,-49,-91,42,40:e3:d6:da:ba:22,31701406,180,225,31701226,31701406
3404,6,12,1,2412,-49,-91,42,40:e3:d6:da:ba:23,31701611,184,21,31701427,31701611
3405,6,12,1,2412,-49,-91,42,40:e3:d6:da:ba:24,31701821,176,34,31701645,31701821
3406,6,12,1,2412,-48,-91,43,40:e3:d6:da:ba:25,31702031,160,50,31701871,31702031
3407,6,6,1,2412,-49,-91,42,40:e3:d6:da:ba:26,31702223,380,-188,31701843,31702223
3408,6,6,1,2412,-82,-91,9,e6:aa:ea:c9:ea:1b,31704097,408,1466,31703689,31704097
3409,6,6,1,2412,-66,-91,25,e6:aa:ea:b7:4a:dd,31800460,408,95955,31800052,31800460
3410,6,12,1,2412,-54,-91,37,40:e3:d6:da:ba:20,31803708,160,3088,31803548,31803708
3411,6,12,1,2412,-54,-91,37,40:e3:d6:da:ba:22,31806350,180,2462,31806170,31806350
3412,6,12,1,2412,-54,-91,37,40:e3:d6:da:ba:23,31807658,184,1124,31807474,31807658
3413,6,12,1,2412,-54,-91,37,40:e3:d6:da:ba:24,31808063,176,229,31807887,31808063
3414,6,12,1,2412,-54,-91,37,40:e3:d6:da:ba:25,31808281,160,58,31808121,31808281
3415,6,6,1,2412,-54,-91,37,40:e3:d6:da:ba:26,31808487,380,-174,31808107,31808487
3416,6,6,1,2412,-66,-91,25,e6:aa:ea:b7:4a:dd,31812582,408,3687,31812174,31812582
3417,4,1,1,2412,-60,-91,31,54:e4:3a:ec:fb:64,31814210,2160,-532,31812050,31814210
3418,4,1,1,2412,-89,-91,2,b8:3a:5a:88:e6:e1,31818800,2376,2214,31816424,31818800
3419,6,6,1,2412,-67,-91,24,e6:aa:ea:b7:4a:dd,31824697,408,5489,31824289,31824697
3420,6,12,1,2412,-54,-91,37,40:e3:d6:da:ba:20,31905622,160,80765,31905462,31905622
3421,6,6,1,2412,-54,-91,37,40:e3:d6:da:ba:21,31905814,368,-176,31905446,31905814
3422,6,12,1,2412,-54,-91,37,40:e3:d6:da:ba:22,31906219,180,225,31906039,31906219
3423,6,12,1,2412,-54,-91,37,40:e3:d6:da:ba:23,31906451,184,48,31906267,31906451
3424,6,12,1,2412,-54,-91,37,40:e3:d6:da:ba:24,31906661,176,34,31906485,31906661
3425,6,12,1,2412,-54,-91,37,40:e3:d6:da:ba:25,31906862,160,41,31906702,31906862
3426,6,6,1,2412,-54,-91,37,40:e3:d6:da:ba:26,31907063,380,-179,31906683,31907063
3427,4,1,1,2412,-80,-91,11,b8:3a:5a:88:e6:e0,31918934,2360,9511,31916574,31918934
3428,4,1,1,2412,-78,-91,13,,31954643,304,35405,31954339,31954643
3429,6,12,1,2412,-55,-91,36,40:e3:d6:da:ba:22,32009362,180,54539,32009182,32009362
3430,6,12,1,2412,-55,-91,36,40:e3:d6:da:ba:23,32009594,184,48,32009410,32009594
3431,6,12,1,2412,-55,-91,36,40:e3:d6:da:ba:24,32009835,176,65,32009659,32009835
3432,6,12,1,2412,-55,-91,36,40:e3:d6:da:ba:25,32010036,160,41,32009876,32010036
3433,4,1,1,2412,-89,-91,2,b8:3a:5a:88:e6:e1,32023607,2376,11195,32021231,32023607
3434,6,6,1,2412,-49,-91,42,,32032663,44,9012,32032619,32032663
3435,6,6,1,2412,-49,-91,42,,32035146,44,2439,32035102,32035146
3436,6,6,1,2412,-49,-91,42,,32040574,44,5384,32040530,32040574
3437,6,6,1,2412,-49,-91,42,,32060143,44,19525,32060099,32060143
3438,6,6,1,2412,-53,-91,38,e6:aa:ea:c9:ea:33,32065359,408,4808,32064951,32065359
3439,6,6,1,2412,-53,-91,38,e6:aa:ea:c9:ea:33,32077476,408,11709,32077068,32077476
3440,6,6,1,2412,-49,-91,42,,32081823,44,4303,32081779,32081823
3441,6,6,1,2412,-53,-91,38,e6:aa:ea:c9:ea:33,32089633,408,7402,32089225,32089633
3442,6,6,1,2412,-49,-91,42,,32093793,44,4116,32093749,32093793
3443,6,6,1,2412,-49,-91,42,,32098881,44,5044,32098837,32098881
3444,6,6,1,2412,-49,-91,42,,32110142,44,11217,32110098,32110142
3445,6,6,1,2412,-49,-91,42,,32110597,44,411,32110553,32110597
3446,6,6,1,2412,-53,-91,38,e6:aa:ea:c9:ea:33,32114463,408,3458,32114055,32114463
3447,6,12,1,2412,-56,-91,35,40:e3:d6:da:ba:20,32114919,160,296,32114759,32114919
3448,6,12,1,2412,-55,-91,36,40:e3:d6:da:ba:23,32115775,184,672,32115591,32115775
3449,6,12,1,2412,-55,-91,36,40:e3:d6:da:ba:24,32116022,176,71,32115846,32116022
3450,6,12,1,2412,-55,-91,36,40:e3:d6:da:ba:25,32116247,160,65,32116087,32116247
3451,6,6,1,2412,-55,-91,36,40:e3:d6:da:ba:26,32116458,380,-169,32116078,32116458
3452,4,1,1,2412,-59,-91,32,54:e4:3a:ec:fb:64,32121407,2160,2789,32119247,32121407
3453,6,6,1,2412,-68,-91,23,e6:aa:ea:b7:4a:dd,32206539,408,84724,32206131,32206539
3454,6,6,1,2412,-53,-91,38,40:e3:d6:da:ba:21,32213028,368,6121,32212660,32213028
3455,6,12,1,2412,-53,-91,38,40:e3:d6:da:ba:22,32213415,180,207,32213235,32213415
3456,6,12,1,2412,-53,-91,38,40:e3:d6:da:ba:23,32213647,184,48,32213463,32213647
3457,6,12,1,2412,-53,-91,38,40:e3:d6:da:ba:24,32213875,176,52,32213699,32213875
3458,6,12,1,2412,-53,-91,38,40:e3:d6:da:ba:25,32214103,160,68,32213943,32214103
3459,6,6,1,2412,-53,-91,38,40:e3:d6:da:ba:26,32214304,380,-179,32213924,32214304
3460,4,1,1,2412,-58,-91,33,54:e4:3a:ec:fb:64,32223807,2160,7343,32221647,32223807
3461,6,6,1,2412,-67,-91,24,e6:aa:ea:b7:4a:dd,32242759,408,18544,32242351,32242759
3462,6,12,1,2412,-52,-91,39,40:e3:d6:da:ba:20,32315209,160,72290,32315049,32315209
3463,6,6,1,2412,-52,-91,39,40:e3:d6:da:ba:21,32315410,368,-167,32315042,32315410
3464,6,12,1,2412,-52,-91,39,40:e3:d6:da:ba:22,32315797,180,207,32315617,32315797
3465,6,12,1,2412,-52,-91,39,40:e3:d6:da:ba:23,32316003,184,22,32315819,32316003
3466,6,12,1,2412,-52,-91,39,40:e3:d6:da:ba:24,32316221,176,42,32316045,32316221
3467,6,12,1,2412,-52,-91,39,40:e3:d6:da:ba:25,32316432,160,51,32316272,32316432
3468,6,6,1,2412,-52,-91,39,40:e3:d6:da:ba:26,32316623,380,-189,32316243,32316623
3469,4,1,1,2412,-59,-91,32,54:e4:3a:ec:fb:64,32326205,2160,7422,32324045,32326205
3470,4,1,1,2412,-88,-91,3,b8:3a:5a:88:e6:e0,32330910,2360,2345,32328550,32330910
3471,6,12,1,2412,-52,-91,39,40:e3:d6:da:ba:20,32417608,160,86538,32417448,32417608
3472,6,6,1,2412,-52,-91,39,40:e3:d6:da:ba:21,32417818,368,-158,32417450,32417818
3473,6,12,1,2412,-52,-91,39,40:e3:d6:da:ba:22,32418223,180,225,32418043,32418223
3474,6,12,1,2412,-52,-91,39,40:e3:d6:da:ba:23,32418438,184,31,32418254,32418438
3475,6,12,1,2412,-52,-91,39,40:e3:d6:da:ba:24,32418647,176,33,32418471,32418647
3476,6,12,1,2412,-52,-91,39,40:e3:d6:da:ba:25,32418876,160,69,32418716,32418876
3477,6,6,1,2412,-52,-91,39,40:e3:d6:da:ba:26,32419095,380,-161,32418715,32419095
3478,4,1,1,2412,-58,-91,33,54:e4:3a:ec:fb:64,32428604,2160,7349,32426444,32428604
3479,4,1,1,2412,-88,-91,3,b8:3a:5a:88:e6:e0,32430814,2360,-150,32428454,32430814
3480,6,12,1,2412,-53,-91,38,40:e3:d6:da:ba:20,32520033,160,89059,32519873,32520033
3481,6,6,1,2412,-52,-91,39,40:e3:d6:da:ba:21,32520243,368,-158,32519875,32520243
3482,6,12,1,2412,-52,-91,39,40:e3:d6:da:ba:22,32520657,180,234,32520477,32520657
3483,6,12,1,2412,-52,-91,39,40:e3:d6:da:ba:23,32520862,184,21,32520678,32520862
3484,6,12,1,2412,-52,-91,39,40:e3:d6:da:ba:24,32521095,176,57,32520919,32521095
3485,6,12,1,2412,-52,-91,39,40:e3:d6:da:ba:25,32521315,160,60,32521155,32521315
3486,6,6,1,2412,-52,-91,39,40:e3:d6:da:ba:26,32521534,380,-161,32521154,32521534
3487,4,1,1,2412,-51,-91,40,54:e4:3a:ec:fb:64,32531004,2160,7310,32528844,32531004
3488,4,1,1,2412,-88,-91,3,b8:3a:5a:88:e6:e1,32535576,2376,2196,32533200,32535576
3489,6,6,1,2412,-68,-91,23,e6:aa:ea:b7:4a:dd,32546091,408,10107,32545683,32546091
3490,6,6,1,2412,-53,-91,38,e6:aa:ea:c9:ea:33,32585082,408,38583,32584674,32585082
3491,6,6,1,2412,-53,-91,38,e6:aa:ea:c9:ea:33,32597190,408,11700,32596782,32597190
3492,6,6,1,2412,-53,-91,38,e6:aa:ea:c9:ea:33,32621435,408,23837,32621027,32621435
3493,6,12,1,2412,-55,-91,36,40:e3:d6:da:ba:20,32622498,160,903,32622338,32622498
3494,6,6,1,2412,-55,-91,36,40:e3:d6:da:ba:21,32622699,368,-167,32622331,32622699
3495,6,12,1,2412,-55,-91,36,40:e3:d6:da:ba:22,32623095,180,216,32622915,32623095
3496,6,12,1,2412,-55,-91,36,40:e3:d6:da:ba:23,32623327,184,48,32623143,32623327
3497,6,12,1,2412,-55,-91,36,40:e3:d6:da:ba:24,32623555,176,52,32623379,32623555
3498,6,12,1,2412,-55,-91,36,40:e3:d6:da:ba:25,32623783,160,68,32623623,32623783
3499,6,6,1,2412,-55,-91,36,40:e3:d6:da:ba:26,32623975,380,-188,32623595,32623975
3500,6,6,1,2412,-79,-91,12,e6:aa:ea:c9:ea:1b,32645173,408,20790,32644765,32645173
3501,6,6,1,2412,-79,-91,12,e6:aa:ea:c9:ea:1b,32657340,408,11759,32656932,32657340
3502,6,12,1,2412,-56,-91,35,40:e3:d6:da:ba:20,32724829,160,67329,32724669,32724829
3503,6,6,1,2412,-56,-91,35,40:e3:d6:da:ba:21,32725048,368,-149,32724680,32725048
3504,6,12,1,2412,-55,-91,36,40:e3:d6:da:ba:22,32725444,180,216,32725264,32725444
3505,6,12,1,2412,-56,-91,35,40:e3:d6:da:ba:23,32725667,184,39,32725483,32725667
3506,6,12,1,2412,-55,-91,36,40:e3:d6:da:ba:24,32725877,176,34,32725701,32725877
3507,6,12,1,2412,-55,-91,36,40:e3:d6:da:ba:25,32726096,160,59,32725936,32726096
3508,6,6,1,2412,-55,-91,36,40:e3:d6:da:ba:26,32727874,380,1398,32727494,32727874
3509,4,1,1,2412,-59,-91,32,54:e4:3a:ec:fb:64,32735801,2160,5767,32733641,32735801
3510,4,1,1,2412,-72,-91,19,b8:3a:5a:88:e6:e0,32737985,2360,-176,32735625,32737985
3511,6,6,1,2412,-53,-91,38,40:e3:d6:da:ba:21,32827452,368,89099,32827084,32827452
3512,4,1,1,2412,-59,-91,32,54:e4:3a:ec:fb:64,32838202,2160,8590,32836042,32838202
3513,4,1,1,2412,-86,-91,5,a6:e5:7c:28:b1:d3,32903281,992,64087,32902289,32903281
3514,6,6,1,2412,-52,-91,39,40:e3:d6:da:ba:21,32929860,368,26211,32929492,32929860
3515,6,12,1,2412,-52,-91,39,40:e3:d6:da:ba:22,32930247,180,207,32930067,32930247
3516,6,12,1,2412,-52,-91,39,40:e3:d6:da:ba:23,32930479,184,48,32930295,32930479
3517,6,12,1,2412,-52,-91,39,40:e3:d6:da:ba:24,32930715,176,60,32930539,32930715
3518,6,12,1,2412,-53,-91,38,40:e3:d6:da:ba:25,32930926,160,51,32930766,32930926
3519,6,6,1,2412,-52,-91,39,40:e3:d6:da:ba:26,32931136,380,-170,32930756,32931136
3520,4,1,1,2412,-59,-91,32,54:e4:3a:ec:fb:64,32940600,2160,7304,32938440,32940600
3521,4,1,1,2412,-88,-91,3,b8:3a:5a:88:e6:e1,32945208,2376,2232,32942832,32945208
3522,6,6,1,2412,-67,-91,24,e6:aa:ea:b7:4a:dd,32963838,408,18222,32963430,32963838
3523,6,6,1,2412,-81,-91,10,e6:aa:ea:c9:ea:1b,32974063,408,9817,32973655,32974063
3524,6,6,1,2412,-66,-91,25,e6:aa:ea:b7:4a:dd,32975955,408,1484,32975547,32975955
3525,6,6,1,2412,-53,-91,38,e6:aa:ea:c9:ea:33,33026392,408,50029,33025984,33026392
3526,6,12,1,2412,-53,-91,38,40:e3:d6:da:ba:20,33032022,160,5470,33031862,33032022
3527,6,6,1,2412,-53,-91,38,40:e3:d6:da:ba:21,33032214,368,-176,33031846,33032214
3528,6,12,1,2412,-53,-91,38,40:e3:d6:da:ba:22,33032610,180,216,33032430,33032610
3529,6,12,1,2412,-53,-91,38,40:e3:d6:da:ba:23,33032824,184,30,33032640,33032824
3530,6,12,1,2412,-53,-91,38,40:e3:d6:da:ba:24,33033052,176,52,33032876,33033052
3531,6,12,1,2412,-53,-91,38,40:e3:d6:da:ba:25,33033262,160,50,33033102,33033262
3532,6,6,1,2412,-53,-91,38,40:e3:d6:da:ba:26,33033463,380,-179,33033083,33033463
3533,6,6,1,2412,-52,-91,39,e6:aa:ea:c9:ea:33,33038520,408,4649,33038112,33038520
3534,4,1,1,2412,-60,-91,31,54:e4:3a:ec:fb:64,33042999,2160,2319,33040839,33042999
3535,6,6,1,2412,-52,-91,39,e6:aa:ea:c9:ea:33,33050661,408,7254,33050253,33050661
3536,6,12,1,2412,-54,-91,37,40:e3:d6:da:ba:20,33134424,160,83603,33134264,33134424
3537,6,6,1,2412,-54,-91,37,40:e3:d6:da:ba:21,33134642,368,-150,33134274,33134642
3538,6,12,1,2412,-53,-91,38,40:e3:d6:da:ba:22,33135030,180,208,33134850,33135030
3539,6,12,1,2412,-53,-91,38,40:e3:d6:da:ba:23,33135262,184,48,33135078,33135262
3540,6,12,1,2412,-54,-91,37,40:e3:d6:da:ba:24,33135489,176,51,33135313,33135489
3541,6,12,1,2412,-53,-91,38,40:e3:d6:da:ba:25,33135709,160,60,33135549,33135709
3542,6,6,1,2412,-54,-91,37,40:e3:d6:da:ba:26,33135910,380,-179,33135530,33135910
3543,4,1,1,2412,-58,-91,33,54:e4:3a:ec:fb:64,33145423,2160,7353,33143263,33145423
3544,6,12,1,2412,-53,-91,38,40:e3:d6:da:ba:20,33236833,160,91250,33236673,33236833
3545,6,6,1,2412,-51,-91,40,40:e3:d6:da:ba:21,33237067,368,-134,33236699,33237067
3546,6,12,1,2412,-53,-91,38,40:e3:d6:da:ba:22,33237455,180,208,33237275,33237455
3547,6,12,1,2412,-53,-91,38,40:e3:d6:da:ba:23,33237678,184,39,33237494,33237678
3548,6,12,1,2412,-53,-91,38,40:e3:d6:da:ba:24,33237906,176,52,33237730,33237906
3549,6,12,1,2412,-53,-91,38,40:e3:d6:da:ba:25,33238116,160,50,33237956,33238116
3550,6,6,1,2412,-53,-91,38,40:e3:d6:da:ba:26,33238326,380,-170,33237946,33238326
3551,4,1,1,2412,-59,-91,32,54:e4:3a:ec:fb:64,33247798,2160,7312,33245638,33247798
3552,6,6,1,2412,-64,-91,27,e6:aa:ea:b7:4a:dd,33277917,408,29711,33277509,33277917
3553,6,12,1,2412,-52,-91,39,40:e3:d6:da:ba:20,33339210,160,61133,33339050,33339210
3554,6,6,1,2412,-52,-91,39,40:e3:d6:da:ba:21,33339429,368,-149,33339061,33339429
3555,6,12,1,2412,-52,-91,39,40:e3:d6:da:ba:22,33339834,180,225,33339654,33339834
3556,6,12,1,2412,-52,-91,39,40:e3:d6:da:ba:23,33340049,184,31,33339865,33340049
3557,6,12,1,2412,-52,-91,39,40:e3:d6:da:ba:24,33342276,176,2051,33342100,33342276
3558,6,12,1,2412,-52,-91,39,40:e3:d6:da:ba:25,33342486,160,50,33342326,33342486
3559,6,6,1,2412,-52,-91,39,40:e3:d6:da:ba:26,33342705,380,-161,33342325,33342705
3560,4,1,1,2412,-86,-91,5,b8:3a:5a:88:e6:e0,33353634,2360,8569,33351274,33353634
3561,6,6,1,2412,-51,-91,40,e6:aa:ea:c9:ea:33,33419293,408,65251,33418885,33419293
3562,4,1,1,2412,-54,-91,37,5a:d0:a1:29:09:62,33427912,1152,7467,33426760,33427912
3563,4,1,1,2412,-63,-91,28,54:e4:3a:ec:fb:64,33429180,2112,-844,33427068,33429180
3564,6,6,1,2412,-51,-91,40,e6:aa:ea:c9:ea:33,33431452,408,1864,33431044,33431452
3565,4,1,1,2412,-59,-91,32,54:e4:3a:ec:fb:64,33432683,2112,-881,33430571,33432683
3566,4,1,1,2412,-55,-91,36,,33434808,304,1821,33434504,33434808
3567,6,12,1,2412,-52,-91,39,40:e3:d6:da:ba:20,33441612,160,6644,33441452,33441612
3568,6,6,1,2412,-52,-91,39,40:e3:d6:da:ba:21,33441813,368,-167,33441445,33441813
3569,6,12,1,2412,-52,-91,39,40:e3:d6:da:ba:22,33442227,180,234,33442047,33442227
3570,6,12,1,2412,-51,-91,40,40:e3:d6:da:ba:23,33442451,184,40,33442267,33442451
3571,6,12,1,2412,-51,-91,40,40:e3:d6:da:ba:24,33442678,176,51,33442502,33442678
3572,6,12,1,2412,-52,-91,39,40:e3:d6:da:ba:25,33442898,160,60,33442738,33442898
3573,6,6,1,2412,-52,-91,39,40:e3:d6:da:ba:26,33443117,380,-161,33442737,33443117
3574,6,6,1,2412,-51,-91,40,e6:aa:ea:c9:ea:33,33443531,408,6,33443123,33443531
3575,4,1,1,2412,-60,-91,31,54:e4:3a:ec:fb:64,33452596,2160,6905,33450436,33452596
3576,6,6,1,2412,-50,-91,41,e6:aa:ea:c9:ea:33,33467769,408,14765,33467361,33467769
3577,4,1,1,2412,-53,-91,38,2a:04:51:35:d5:ea,33480144,1152,11223,33478992,33480144
3578,6,12,1,2412,-52,-91,39,40:e3:d6:da:ba:20,33481299,136,1019,33481163,33481299
3579,6,6,1,2412,-52,-91,39,40:e3:d6:da:ba:21,33482733,348,1086,33482385,33482733
3580,6,12,1,2412,-52,-91,39,40:e3:d6:da:ba:22,33483118,156,229,33482962,33483118
3581,6,12,1,2412,-52,-91,39,40:e3:d6:da:ba:23,33483496,156,222,33483340,33483496
3582,6,12,1,2412,-52,-91,39,40:e3:d6:da:ba:25,33483696,136,64,33483560,33483696
3583,6,6,1,2412,-81,-91,10,e6:aa:ea:c9:ea:1b,33484421,408,317,33484013,33484421
3584,6,6,1,2412,-82,-91,9,e6:aa:ea:c9:ea:1b,33496549,408,11720,33496141,33496549
3585,6,12,1,2412,-52,-91,39,40:e3:d6:da:ba:20,33544031,160,47322,33543871,33544031
3586,6,6,1,2412,-52,-91,39,40:e3:d6:da:ba:21,33544250,368,-149,33543882,33544250
3587,6,12,1,2412,-51,-91,40,40:e3:d6:da:ba:22,33544671,180,241,33544491,33544671
3588,6,12,1,2412,-52,-91,39,40:e3:d6:da:ba:23,33545034,184,179,33544850,33545034
3589,6,6,1,2412,-51,-91,40,40:e3:d6:da:ba:26,33545735,380,321,33545355,33545735
3590,4,1,1,2412,-64,-91,27,54:e4:3a:ec:fb:64,33554996,2160,7101,33552836,33554996
3591,4,1,1,2412,-86,-91,5,b8:3a:5a:88:e6:e0,33557521,2360,165,33555161,33557521
3592,6,12,1,2412,-52,-91,39,40:e3:d6:da:ba:20,33646420,160,88739,33646260,33646420
3593,6,6,1,2412,-52,-91,39,40:e3:d6:da:ba:21,33646638,368,-150,33646270,33646638
3594,6,12,1,2412,-52,-91,39,40:e3:d6:da:ba:22,33647034,180,216,33646854,33647034
3595,6,12,1,2412,-51,-91,40,40:e3:d6:da:ba:23,33647240,184,22,33647056,33647240
3596,6,12,1,2412,-51,-91,40,40:e3:d6:da:ba:25,33647678,160,278,33647518,33647678
3597,6,6,1,2412,-52,-91,39,40:e3:d6:da:ba:26,33647884,380,-174,33647504,33647884
3598,6,6,1,2412,-64,-91,27,e6:aa:ea:b7:4a:dd,33671207,408,22915,33670799,33671207
3599,6,6,1,2412,-64,-91,27,e6:aa:ea:b7:4a:dd,33695443,408,23828,33695035,33695443
3600,6,6,1,2412,-64,-91,27,e6:aa:ea:b7:4a:dd,33707562,408,11711,33707154,33707562
3601,6,12,1,2412,-52,-91,39,40:e3:d6:da:ba:20,33748819,160,41097,33748659,33748819
3602,6,12,1,2412,-52,-91,39,40:e3:d6:da:ba:22,33749460,180,461,33749280,33749460
3603,6,12,1,2412,-51,-91,40,40:e3:d6:da:ba:25,33750217,160,597,33750057,33750217
3604,6,6,1,2412,-52,-91,39,40:e3:d6:da:ba:26,33750615,380,18,33750235,33750615
3605,6,6,1,2412,-49,-91,42,e6:aa:ea:c9:ea:33,33836446,408,85423,33836038,33836446
3606,6,6,1,2412,-49,-91,42,e6:aa:ea:c9:ea:33,33850123,408,13269,33849715,33850123
3607,6,12,1,2412,-52,-91,39,40:e3:d6:da:ba:20,33851215,160,932,33851055,33851215
3608,6,6,1,2412,-52,-91,39,40:e3:d6:da:ba:21,33851440,368,-143,33851072,33851440
3609,6,12,1,2412,-52,-91,39,40:e3:d6:da:ba:22,33851836,180,216,33851656,33851836
3610,6,12,1,2412,-52,-91,39,40:e3:d6:da:ba:23,33852050,184,30,33851866,33852050
3611,6,12,1,2412,-52,-91,39,40:e3:d6:da:ba:24,33852269,176,43,33852093,33852269
3612,6,12,1,2412,-52,-91,39,40:e3:d6:da:ba:25,33852488,160,59,33852328,33852488
3613,6,6,1,2412,-52,-91,39,40:e3:d6:da:ba:26,33852698,380,-170,33852318,33852698
3614,6,6,1,2412,-48,-91,43,e6:aa:ea:c9:ea:33,33860683,408,7577,33860275,33860683
3615,4,1,1,2412,-63,-91,28,54:e4:3a:ec:fb:64,33862193,2160,-650,33860033,33862193
3616,4,1,1,2412,-87,-91,4,b8:3a:5a:88:e6:e0,33864708,2360,155,33862348,33864708
3617,6,6,1,2412,-48,-91,43,e6:aa:ea:c9:ea:33,33872798,408,7682,33872390,33872798
3618,6,6,1,2412,-49,-91,42,e6:aa:ea:c9:ea:33,33884915,408,11709,33884507,33884915
3619,6,12,1,2412,-51,-91,40,40:e3:d6:da:ba:20,33953622,160,68547,33953462,33953622
3620,6,6,1,2412,-51,-91,40,40:e3:d6:da:ba:21,33953814,368,-176,33953446,33953814
3621,6,12,1,2412,-51,-91,40,40:e3:d6:da:ba:22,33954228,180,234,33954048,33954228
3622,6,12,1,2412,-51,-91,40,40:e3:d6:da:ba:23,33954433,184,21,33954249,33954433
3623,6,12,1,2412,-51,-91,40,40:e3:d6:da:ba:24,33954670,176,61,33954494,33954670
3624,6,12,1,2412,-51,-91,40,40:e3:d6:da:ba:25,33954898,160,68,33954738,33954898
3625,6,6,1,2412,-51,-91,40,40:e3:d6:da:ba:26,33955099,380,-179,33954719,33955099
3626,4,1,1,2412,-63,-91,28,54:e4:3a:ec:fb:64,33964591,2160,7332,33962431,33964591
3627,6,6,1,2412,-83,-91,8,e6:aa:ea:c9:ea:1b,33995051,408,30052,33994643,33995051
3628,6,6,1,2412,-64,-91,27,e6:aa:ea:b7:4a:dd,34023588,408,28129,34023180,34023588
3629,6,12,1,2412,-49,-91,42,40:e3:d6:da:ba:20,34056039,160,32291,34055879,34056039
3630,6,6,1,2412,-48,-91,43,40:e3:d6:da:ba:21,34056231,368,-176,34055863,34056231
3631,6,12,1,2412,-49,-91,42,40:e3:d6:da:ba:22,34056645,180,234,34056465,34056645
3632,6,12,1,2412,-49,-91,42,40:e3:d6:da:ba:23,34056860,184,31,34056676,34056860
3633,6,12,1,2412,-48,-91,43,40:e3:d6:da:ba:24,34057096,176,60,34056920,34057096
3634,6,12,1,2412,-48,-91,43,40:e3:d6:da:ba:25,34057325,160,69,34057165,34057325
3635,6,6,1,2412,-48,-91,43,40:e3:d6:da:ba:26,34057526,380,-179,34057146,34057526
3636,4,1,1,2412,-61,-91,30,54:e4:3a:ec:fb:64,34066990,2160,7304,34064830,34066990
3637,6,12,1,2412,-49,-91,42,40:e3:d6:da:ba:20,34158439,160,91289,34158279,34158439
3638,6,6,1,2412,-49,-91,42,40:e3:d6:da:ba:21,34158649,368,-158,34158281,34158649
3639,6,12,1,2412,-49,-91,42,40:e3:d6:da:ba:22,34159036,180,207,34158856,34159036
3640,6,12,1,2412,-49,-91,42,40:e3:d6:da:ba:24,34159486,176,274,34159310,34159486
3641,6,12,1,2412,-49,-91,42,40:e3:d6:da:ba:25,34159713,160,67,34159553,34159713
3642,6,6,1,2412,-49,-91,42,40:e3:d6:da:ba:26,34159951,380,-142,34159571,34159951
3643,6,6,1,2412,-50,-91,41,e6:aa:ea:c9:ea:33,34164505,408,4146,34164097,34164505
3644,6,6,1,2412,-50,-91,41,e6:aa:ea:c9:ea:33,34188624,408,23711,34188216,34188624
3645,6,12,1,2412,-50,-91,41,40:e3:d6:da:ba:20,34261164,160,72380,34261004,34261164
3646,6,6,1,2412,-49,-91,42,40:e3:d6:da:ba:21,34261383,368,-149,34261015,34261383
3647,6,12,1,2412,-49,-91,42,40:e3:d6:da:ba:22,34261810,180,247,34261630,34261810
3648,6,12,1,2412,-49,-91,42,40:e3:d6:da:ba:23,34262042,184,48,34261858,34262042
3649,6,12,1,2412,-49,-91,42,40:e3:d6:da:ba:24,34262279,176,61,34262103,34262279
3650,6,12,1,2412,-49,-91,42,40:e3:d6:da:ba:25,34262480,160,41,34262320,34262480
3651,6,6,1,2412,-49,-91,42,40:e3:d6:da:ba:26,34262699,380,-161,34262319,34262699
3652,4,1,1,2412,-62,-91,29,54:e4:3a:ec:fb:64,34271788,2160,6929,34269628,34271788
3653,6,6,1,2412,-81,-91,10,e6:aa:ea:c9:ea:1b,34300367,408,28171,34299959,34300367
3654,6,6,1,2412,-80,-91,11,e6:aa:ea:c9:ea:1b,34312474,408,11699,34312066,34312474
3655,6,12,1,2412,-49,-91,42,40:e3:d6:da:ba:20,34363216,160,50582,34363056,34363216
3656,6,6,1,2412,-49,-91,42,40:e3:d6:da:ba:21,34363417,368,-167,34363049,34363417
3657,6,12,1,2412,-49,-91,42,40:e3:d6:da:ba:22,34363813,180,216,34363633,34363813
3658,6,12,1,2412,-49,-91,42,40:e3:d6:da:ba:23,34364019,184,22,34363835,34364019
3659,6,12,1,2412,-49,-91,42,40:e3:d6:da:ba:24,34364255,176,60,34364079,34364255
3660,6,12,1,2412,-49,-91,42,40:e3:d6:da:ba:25,34364474,160,59,34364314,34364474
3661,6,6,1,2412,-49,-91,42,40:e3:d6:da:ba:26,34364684,380,-170,34364304,34364684
3662,4,1,1,2412,-58,-91,33,54:e4:3a:ec:fb:64,34374188,2160,7344,34372028,34374188
3663,6,12,1,2412,-49,-91,42,40:e3:d6:da:ba:20,34467389,160,93041,34467229,34467389
3664,6,6,1,2412,-48,-91,43,40:e3:d6:da:ba:21,34467608,368,-149,34467240,34467608
3665,6,12,1,2412,-49,-91,42,40:e3:d6:da:ba:23,34468270,184,478,34468086,34468270
3666,6,12,1,2412,-49,-91,42,40:e3:d6:da:ba:24,34468498,176,52,34468322,34468498
3667,6,12,1,2412,-49,-91,42,40:e3:d6:da:ba:25,34468812,160,154,34468652,34468812
3668,4,1,1,2412,-64,-91,27,54:e4:3a:ec:fb:64,34476588,2160,5616,34474428,34476588
3669,6,6,1,2412,-67,-91,24,e6:aa:ea:b7:4a:dd,34494487,408,17491,34494079,34494487
3670,6,6,1,2412,-67,-91,24,e6:aa:ea:b7:4a:dd,34506710,408,11815,34506302,34506710
3671,6,6,1,2412,-67,-91,24,e6:aa:ea:b7:4a:dd,34518712,408,11594,34518304,34518712
3672,6,6,1,2412,-67,-91,24,e6:aa:ea:b7:4a:dd,34542951,408,23831,34542543,34542951
3673,6,12,1,2412,-49,-91,42,40:e3:d6:da:ba:20,34568025,160,24914,34567865,34568025
3674,6,6,1,2412,-48,-91,43,40:e3:d6:da:ba:21,34568251,368,-142,34567883,34568251
3675,6,12,1,2412,-48,-91,43,40:e3:d6:da:ba:22,34568665,180,234,34568485,34568665
3676,6,12,1,2412,-48,-91,43,40:e3:d6:da:ba:23,34568879,184,30,34568695,34568879
3677,6,12,1,2412,-48,-91,43,40:e3:d6:da:ba:24,34569088,176,33,34568912,34569088
3678,6,12,1,2412,-48,-91,43,40:e3:d6:da:ba:25,34569317,160,69,34569157,34569317
3679,6,6,1,2412,-48,-91,43,40:e3:d6:da:ba:26,34569518,380,-179,34569138,34569518
3680,6,6,1,2412,-49,-91,42,e6:aa:ea:c9:ea:33,34570095,408,169,34569687,34570095
3681,4,1,1,2412,-61,-91,30,54:e4:3a:ec:fb:64,34578987,2160,6732,34576827,34578987
3682,6,6,1,2412,-50,-91,41,e6:aa:ea:c9:ea:33,34581818,408,2423,34581410,34581818
3683,4,1,1,2412,-88,-91,3,b8:3a:5a:88:e6:e1,34583568,2376,-626,34581192,34583568
3684,4,1,1,2412,-61,-91,30,54:e4:3a:ec:fb:64,34594935,2112,9255,34592823,34594935
3685,4,1,1,2412,-63,-91,28,,34597063,304,1824,34596759,34597063
3686,6,12,1,2412,-48,-91,43,40:e3:d6:da:ba:20,34597347,136,148,34597211,34597347
3687,6,6,1,2412,-48,-91,43,40:e3:d6:da:ba:21,34597825,348,130,34597477,34597825
3688,6,12,1,2412,-48,-91,43,40:e3:d6:da:ba:25,34599683,136,1722,34599547,34599683
3689,6,12,1,2412,-61,-91,30,,34599837,32,122,34599805,34599837
3690,6,12,1,2412,-61,-91,30,,34600197,32,328,34600165,34600197
3691,6,12,1,2412,-62,-91,29,,34601065,32,836,34601033,34601065
3692,6,12,1,2412,-61,-91,30,,34601286,32,189,34601254,34601286
3693,6,6,1,2412,-50,-91,41,e6:aa:ea:c9:ea:33,34606028,408,4334,34605620,34606028
3694,4,1,1,2412,-63,-91,28,ae:85:65:51:e9:8c,34614952,992,7932,34613960,34614952
3695,4,1,1,2412,-60,-91,31,54:e4:3a:ec:fb:64,34616062,2112,-1002,34613950,34616062
3696,4,1,1,2412,-63,-91,28,,34618190,304,1824,34617886,34618190
3697,6,12,1,2412,-47,-91,44,40:e3:d6:da:ba:20,34618354,136,28,34618218,34618354
3698,6,12,1,2412,-62,-91,29,,34618508,32,122,34618476,34618508
3699,6,6,1,2412,-50,-91,41,e6:aa:ea:c9:ea:33,34618580,408,-336,34618172,34618580
3700,6,6,1,2412,-47,-91,44,40:e3:d6:da:ba:21,34619052,348,124,34618704,34619052
3701,6,6,1,2412,-62,-91,29,,34619418,44,322,34619374,34619418
3702,6,12,1,2412,-47,-91,44,40:e3:d6:da:ba:22,34619509,156,-65,34619353,34619509
3703,6,12,1,2412,-62,-91,29,,34619683,32,142,34619651,34619683
3704,6,12,1,2412,-47,-91,44,40:e3:d6:da:ba:23,34619777,156,-62,34619621,34619777
3705,6,12,1,2412,-47,-91,44,40:e3:d6:da:ba:25,34621167,136,1254,34621031,34621167
3706,6,12,1,2412,-60,-91,31,,34621320,32,121,34621288,34621320
3707,6,12,1,2412,-47,-91,44,40:e3:d6:da:ba:20,34644620,136,23164,34644484,34644620
3708,6,6,1,2412,-47,-91,44,40:e3:d6:da:ba:21,34644815,348,-153,34644467,34644815
3709,6,12,1,2412,-47,-91,44,40:e3:d6:da:ba:22,34645191,156,220,34645035,34645191
3710,6,12,1,2412,-47,-91,44,40:e3:d6:da:ba:23,34645399,156,52,34645243,34645399
3711,6,12,1,2412,-47,-91,44,40:e3:d6:da:ba:25,34645590,136,55,34645454,34645590
3712,4,1,1,2412,-62,-91,29,ae:85:65:51:e9:8c,34665399,992,18817,34664407,34665399
3713,6,12,1,2412,-47,-91,44,40:e3:d6:da:ba:20,34666365,136,830,34666229,34666365
3714,6,6,1,2412,-47,-91,44,40:e3:d6:da:ba:21,34666560,348,-153,34666212,34666560
3715,6,12,1,2412,-46,-91,45,40:e3:d6:da:ba:22,34666945,156,229,34666789,34666945
3716,6,12,1,2412,-47,-91,44,40:e3:d6:da:ba:23,34667145,156,44,34666989,34667145
3717,6,12,1,2412,-46,-91,45,40:e3:d6:da:ba:25,34667353,136,72,34667217,34667353
3718,6,12,1,2412,-47,-91,44,40:e3:d6:da:ba:20,34670525,160,3012,34670365,34670525
3719,6,6,1,2412,-47,-91,44,40:e3:d6:da:ba:21,34670735,368,-158,34670367,34670735
3720,6,12,1,2412,-46,-91,45,40:e3:d6:da:ba:22,34671140,180,225,34670960,34671140
3721,6,12,1,2412,-47,-91,44,40:e3:d6:da:ba:23,34671355,184,31,34671171,34671355
3722,6,12,1,2412,-46,-91,45,40:e3:d6:da:ba:24,34671591,176,60,34671415,34671591
3723,6,12,1,2412,-46,-91,45,40:e3:d6:da:ba:25,34671802,160,51,34671642,34671802
3724,6,6,1,2412,-46,-91,45,40:e3:d6:da:ba:26,34672021,380,-161,34671641,34672021
3725,4,1,1,2412,-60,-91,31,54:e4:3a:ec:fb:64,34681385,2160,7204,34679225,34681385
3726,6,12,1,2412,-46,-91,45,40:e3:d6:da:ba:20,34694790,136,13269,34694654,34694790
3727,6,6,1,2412,-46,-91,45,40:e3:d6:da:ba:21,34694967,348,-171,34694619,34694967
3728,6,12,1,2412,-46,-91,45,40:e3:d6:da:ba:22,34695343,156,220,34695187,34695343
3729,6,12,1,2412,-46,-91,45,40:e3:d6:da:ba:23,34695542,156,43,34695386,34695542
3730,6,12,1,2412,-46,-91,45,40:e3:d6:da:ba:25,34695732,136,54,34695596,34695732
3731,6,12,1,2412,-46,-91,45,40:e3:d6:da:ba:20,34772831,160,76939,34772671,34772831
3732,6,6,1,2412,-46,-91,45,40:e3:d6:da:ba:21,34773051,368,-148,34772683,34773051
3733,6,12,1,2412,-46,-91,45,40:e3:d6:da:ba:22,34773447,180,216,34773267,34773447
3734,6,12,1,2412,-46,-91,45,40:e3:d6:da:ba:23,34773671,184,40,34773487,34773671
3735,6,12,1,2412,-46,-91,45,40:e3:d6:da:ba:24,34773898,176,51,34773722,34773898
3736,6,12,1,2412,-46,-91,45,40:e3:d6:da:ba:25,34774100,160,42,34773940,34774100
3737,6,6,1,2412,-46,-91,45,40:e3:d6:da:ba:26,34774292,380,-188,34773912,34774292
3738,4,1,1,2412,-59,-91,32,54:e4:3a:ec:fb:64,34783805,2160,7353,34781645,34783805
3739,6,6,1,2412,-87,-91,4,84:d4:7e:f2:42:21,34791022,368,6849,34790654,34791022
3740,4,1,1,2412,-88,-91,3,b8:3a:5a:88:e6:e0,34797609,2240,4347,34795369,34797609
3741,4,1,1,2412,-92,-91,-1,b8:3a:5a:88:e6:e1,34800465,2256,600,34798209,34800465
3742,6,6,1,2412,-82,-91,9,e6:aa:ea:c9:ea:1b,34824079,408,23206,34823671,34824079
3743,6,6,1,2412,-82,-91,9,e6:aa:ea:c9:ea:1b,34836188,408,11701,34835780,34836188
3744,4,1,1,2412,-88,-91,3,c0:c9:e3:4d:6e:bf,34850803,872,13743,34849931,34850803
3745,6,6,1,2412,-84,-91,7,e6:aa:ea:c9:ea:1b,34860419,408,9208,34860011,34860419
3746,6,6,1,2412,-85,-91,6,e6:aa:ea:c9:ea:1b,34872571,408,11744,34872163,34872571
3747,6,12,1,2412,-48,-91,43,40:e3:d6:da:ba:20,34875219,160,2488,34875059,34875219
3748,6,6,1,2412,-48,-91,43,40:e3:d6:da:ba:21,34875438,368,-149,34875070,34875438
3749,6,12,1,2412,-48,-91,43,40:e3:d6:da:ba:22,34875825,180,207,34875645,34875825
3750,6,12,1,2412,-48,-91,43,40:e3:d6:da:ba:23,34876039,184,30,34875855,34876039
3751,6,12,1,2412,-48,-91,43,40:e3:d6:da:ba:24,34876257,176,42,34876081,34876257
3752,6,12,1,2412,-48,-91,43,40:e3:d6:da:ba:25,34876468,160,51,34876308,34876468
3753,6,6,1,2412,-48,-91,43,40:e3:d6:da:ba:26,34876660,380,-188,34876280,34876660
3754,4,1,1,2412,-62,-91,29,54:e4:3a:ec:fb:64,34886284,2160,7464,34884124,34886284
3755,6,6,1,2412,-63,-91,28,e6:aa:ea:b7:4a:dd,34935749,408,49057,34935341,34935749
3756,6,12,1,2412,-51,-91,40,40:e3:d6:da:ba:20,34977619,160,41710,34977459,34977619
3757,6,6,1,2412,-51,-91,40,40:e3:d6:da:ba:21,34977829,368,-158,34977461,34977829
3758,6,12,1,2412,-50,-91,41,40:e3:d6:da:ba:22,34978243,180,234,34978063,34978243
3759,6,12,1,2412,-51,-91,40,40:e3:d6:da:ba:23,34978457,184,30,34978273,34978457
3760,6,12,1,2412,-51,-91,40,40:e3:d6:da:ba:24,34978667,176,34,34978491,34978667
3761,6,12,1,2412,-51,-91,40,40:e3:d6:da:ba:25,34978877,160,50,34978717,34978877
3762,6,6,1,2412,-51,-91,40,40:e3:d6:da:ba:26,34979087,380,-170,34978707,34979087
3763,6,6,1,2412,-54,-91,37,e6:aa:ea:c9:ea:33,34986263,408,6768,34985855,34986263
3764,6,6,1,2412,-55,-91,36,e6:aa:ea:c9:ea:33,34998378,408,11707,34997970,34998378
3765,4,1,1,2412,-88,-91,3,b8:3a:5a:88:e6:e0,35004243,2240,3625,35002003,35004243
3766,6,6,1,2412,-55,-91,36,e6:aa:ea:c9:ea:33,35022596,408,17945,35022188,35022596
3767,6,6,1,2412,-55,-91,36,e6:aa:ea:c9:ea:33,35037216,408,14212,35036808,35037216
3768,6,12,1,2412,-51,-91,40,40:e3:d6:da:ba:20,35080031,160,42655,35079871,35080031
3769,6,6,1,2412,-51,-91,40,40:e3:d6:da:ba:21,35080232,368,-167,35079864,35080232
3770,6,12,1,2412,-51,-91,40,40:e3:d6:da:ba:22,35080619,180,207,35080439,35080619
3771,6,12,1,2412,-51,-91,40,40:e3:d6:da:ba:23,35080825,184,22,35080641,35080825
3772,6,12,1,2412,-51,-91,40,40:e3:d6:da:ba:24,35081061,176,60,35080885,35081061
3773,6,12,1,2412,-51,-91,40,40:e3:d6:da:ba:25,35081262,160,41,35081102,35081262
3774,6,6,1,2412,-51,-91,40,40:e3:d6:da:ba:26,35081454,380,-188,35081074,35081454
3775,4,1,1,2412,-64,-91,27,54:e4:3a:ec:fb:64,35093026,2160,9412,35090866,35093026
3776,6,6,1,2412,-83,-91,8,e6:aa:ea:c9:ea:1b,35141616,408,48182,35141208,35141616
3777,6,6,1,2412,-81,-91,10,e6:aa:ea:c9:ea:1b,35165853,408,23829,35165445,35165853
3778,6,12,1,2412,-50,-91,41,40:e3:d6:da:ba:20,35182420,160,16407,35182260,35182420
3779,6,6,1,2412,-49,-91,42,40:e3:d6:da:ba:21,35182612,368,-176,35182244,35182612
3780,6,12,1,2412,-49,-91,42,40:e3:d6:da:ba:22,35182999,180,207,35182819,35182999
3781,6,12,1,2412,-48,-91,43,40:e3:d6:da:ba:23,35183247,184,64,35183063,35183247
3782,6,12,1,2412,-49,-91,42,40:e3:d6:da:ba:24,35183457,176,34,35183281,35183457
3783,6,12,1,2412,-49,-91,42,40:e3:d6:da:ba:25,35183685,160,68,35183525,35183685
3784,6,6,1,2412,-49,-91,42,40:e3:d6:da:ba:26,35183942,380,-123,35183562,35183942
3785,4,1,1,2412,-61,-91,30,54:e4:3a:ec:fb:64,35193805,2160,7703,35191645,35193805
3786,4,1,1,2412,-85,-91,6,a6:e5:7c:28:b1:d3,35204492,944,9743,35203548,35204492
3787,4,1,1,2412,-86,-91,5,a6:e5:7c:28:b1:d3,35205552,944,116,35204608,35205552
3788,4,1,1,2412,-86,-91,5,a6:e5:7c:28:b1:d3,35206603,944,107,35205659,35206603
3789,4,1,1,2412,-61,-91,30,54:e4:3a:ec:fb:64,35295780,2160,87017,35293620,35295780
3790,4,1,1,2412,-88,-91,3,b8:3a:5a:88:e6:e0,35297972,2360,-168,35295612,35297972
3791,6,6,1,2412,-68,-91,23,e6:aa:ea:b7:4a:dd,35352783,408,54403,35352375,35352783
3792,6,6,1,2412,-68,-91,23,e6:aa:ea:b7:4a:dd,35364784,408,11593,35364376,35364784
3793,6,6,1,2412,-68,-91,23,e6:aa:ea:b7:4a:dd,35376903,408,11711,35376495,35376903
3794,4,1,1,2412,-91,-91,0,,35386121,304,8914,35385817,35386121
3795,6,12,1,2412,-50,-91,41,40:e3:d6:da:ba:20,35387237,160,956,35387077,35387237
3796,6,6,1,2412,-49,-91,42,40:e3:d6:da:ba:21,35387447,368,-158,35387079,35387447
3797,6,12,1,2412,-49,-91,42,40:e3:d6:da:ba:22,35387852,180,225,35387672,35387852
3798,6,12,1,2412,-49,-91,42,40:e3:d6:da:ba:23,35388057,184,21,35387873,35388057
3799,6,12,1,2412,-49,-91,42,40:e3:d6:da:ba:24,35388294,176,61,35388118,35388294
3800,6,12,1,2412,-49,-91,42,40:e3:d6:da:ba:25,35388495,160,41,35388335,35388495
3801,6,6,1,2412,-49,-91,42,40:e3:d6:da:ba:26,35388687,380,-188,35388307,35388687
3802,4,1,1,2412,-61,-91,30,54:e4:3a:ec:fb:64,35398179,2160,7332,35396019,35398179
3803,6,12,1,2412,-50,-91,41,40:e3:d6:da:ba:20,35489621,160,91282,35489461,35489621
3804,6,12,1,2412,-50,-91,41,40:e3:d6:da:ba:22,35490314,180,513,35490134,35490314
3805,6,12,1,2412,-50,-91,41,40:e3:d6:da:ba:24,35490738,176,248,35490562,35490738
3806,6,12,1,2412,-50,-91,41,40:e3:d6:da:ba:25,35490957,160,59,35490797,35490957
3807,6,6,1,2412,-50,-91,41,40:e3:d6:da:ba:26,35491176,380,-161,35490796,35491176
3808,6,6,1,2412,-51,-91,40,e6:aa:ea:c9:ea:33,35505337,408,13753,35504929,35505337
3809,6,6,1,2412,-50,-91,41,e6:aa:ea:c9:ea:33,35517280,408,11535,35516872,35517280
3810,6,6,1,2412,-49,-91,42,e6:aa:ea:c9:ea:33,35530341,408,12653,35529933,35530341
3811,6,6,1,2412,-49,-91,42,e6:aa:ea:c9:ea:33,35541503,408,10754,35541095,35541503
3812,6,6,1,2412,-47,-91,44,e6:aa:ea:c9:ea:33,35553622,408,11711,35553214,35553622
3813,4,1,1,2412,-60,-91,31,a6:e5:7c:28:b1:d3,35591950,944,37384,35591006,35591950
3814,4,1,1,2412,-88,-91,3,a6:e5:7c:28:b1:d3,35593001,944,107,35592057,35593001
3815,6,6,1,2412,-48,-91,43,40:e3:d6:da:ba:21,35595260,368,1891,35594892,35595260
3816,6,12,1,2412,-48,-91,43,40:e3:d6:da:ba:22,35595776,180,336,35595596,35595776
3817,6,12,1,2412,-48,-91,43,40:e3:d6:da:ba:23,35596000,184,40,35595816,35596000
3818,6,12,1,2412,-48,-91,43,40:e3:d6:da:ba:24,35596931,176,755,35596755,35596931
3819,6,12,1,2412,-48,-91,43,40:e3:d6:da:ba:25,35597160,160,69,35597000,35597160
3820,6,6,1,2412,-48,-91,43,40:e3:d6:da:ba:26,35598156,380,616,35597776,35598156
3821,4,1,1,2412,-59,-91,32,54:e4:3a:ec:fb:64,35602977,2160,2661,35600817,35602977
3822,6,6,1,2412,-84,-91,7,84:d4:7e:f2:42:21,35612713,368,9368,35612345,35612713
3823,6,6,1,2412,-88,-91,3,84:d4:7e:f2:42:26,35613949,380,856,35613569,35613949
3824,6,6,1,2412,-63,-91,28,e6:aa:ea:b7:4a:dd,35643185,408,28828,35642777,35643185
3825,6,6,1,2412,-82,-91,9,e6:aa:ea:c9:ea:1b,35687474,408,43881,35687066,35687474
3826,6,6,1,2412,-62,-91,29,e6:aa:ea:b7:4a:dd,35691667,408,3785,35691259,35691667
3827,6,12,1,2412,-48,-91,43,40:e3:d6:da:ba:20,35694422,160,2595,35694262,35694422
3828,6,6,1,2412,-48,-91,43,40:e3:d6:da:ba:21,35694614,368,-176,35694246,35694614
3829,6,12,1,2412,-48,-91,43,40:e3:d6:da:ba:22,35695019,180,225,35694839,35695019
3830,6,12,1,2412,-48,-91,43,40:e3:d6:da:ba:23,35695234,184,31,35695050,35695234
3831,6,12,1,2412,-48,-91,43,40:e3:d6:da:ba:24,35695443,176,33,35695267,35695443
3832,6,12,1,2412,-48,-91,43,40:e3:d6:da:ba:25,35695644,160,41,35695484,35695644
3833,6,6,1,2412,-48,-91,43,40:e3:d6:da:ba:26,35695863,380,-161,35695483,35695863
3834,6,12,1,2412,-48,-91,43,40:e3:d6:da:ba:20,35797678,160,101655,35797518,35797678
3835,6,6,1,2412,-48,-91,43,40:e3:d6:da:ba:21,35797897,368,-149,35797529,35797897
3836,6,12,1,2412,-48,-91,43,40:e3:d6:da:ba:22,35798517,180,440,35798337,35798517
3837,6,12,1,2412,-48,-91,43,40:e3:d6:da:ba:23,35798723,184,22,35798539,35798723
3838,6,12,1,2412,-48,-91,43,40:e3:d6:da:ba:24,35798941,176,42,35798765,35798941
3839,6,12,1,2412,-48,-91,43,40:e3:d6:da:ba:25,35799152,160,51,35798992,35799152
3840,6,6,1,2412,-48,-91,43,40:e3:d6:da:ba:26,35799344,380,-188,35798964,35799344
3841,4,1,1,2412,-61,-91,30,54:e4:3a:ec:fb:64,35807776,2160,6272,35805616,35807776
3842,4,1,1,2412,-88,-91,3,c0:c9:e3:4d:6e:bf,35827918,872,19270,35827046,35827918
3843,4,1,1,2412,-90,-91,1,,35872149,304,43927,35871845,35872149
3844,6,12,1,2412,-48,-91,43,40:e3:d6:da:ba:20,35899227,160,26918,35899067,35899227
3845,6,6,1,2412,-48,-91,43,40:e3:d6:da:ba:21,35899453,368,-142,35899085,35899453
3846,6,12,1,2412,-48,-91,43,40:e3:d6:da:ba:22,35899882,180,249,35899702,35899882
3847,6,12,1,2412,-48,-91,43,40:e3:d6:da:ba:23,35900097,184,31,35899913,35900097
3848,6,12,1,2412,-48,-91,43,40:e3:d6:da:ba:24,35900324,176,51,35900148,35900324
3849,6,12,1,2412,-48,-91,43,40:e3:d6:da:ba:25,35900525,160,41,35900365,35900525
3850,6,6,1,2412,-48,-91,43,40:e3:d6:da:ba:26,35900735,380,-170,35900355,35900735
3851,6,6,1,2412,-77,-91,14,e6:aa:ea:c9:ea:1b,35992981,408,91838,35992573,35992981
3852,6,12,1,2412,-50,-91,41,40:e3:d6:da:ba:20,36001638,160,8497,36001478,36001638
3853,6,6,1,2412,-49,-91,42,40:e3:d6:da:ba:21,36001974,368,-32,36001606,36001974
3854,6,12,1,2412,-49,-91,42,40:e3:d6:da:ba:23,36004785,184,2627,36004601,36004785
3855,6,12,1,2412,-49,-91,42,40:e3:d6:da:ba:24,36004995,176,34,36004819,36004995
3856,4,1,1,2412,-64,-91,27,54:e4:3a:ec:fb:64,36012574,2160,5419,36010414,36012574
3857,4,1,1,2412,-88,-91,3,b8:3a:5a:88:e6:e0,36014857,2360,-77,36012497,36014857
3858,4,1,1,2412,-87,-91,4,b8:3a:5a:88:e6:e1,36017246,2376,13,36014870,36017246
3859,6,6,1,2412,-48,-91,43,e6:aa:ea:c9:ea:33,36025119,408,7465,36024711,36025119
3860,6,6,1,2412,-48,-91,43,e6:aa:ea:c9:ea:33,36037208,408,11681,36036800,36037208
3861,6,6,1,2412,-48,-91,43,e6:aa:ea:c9:ea:33,36052072,408,14456,36051664,36052072
3862,6,6,1,2412,-48,-91,43,e6:aa:ea:c9:ea:33,36061281,408,8801,36060873,36061281
3863,6,6,1,2412,-49,-91,42,e6:aa:ea:c9:ea:33,36074847,408,13158,36074439,36074847
3864,6,12,1,2412,-49,-91,42,40:e3:d6:da:ba:20,36104028,160,29021,36103868,36104028
3865,6,6,1,2412,-49,-91,42,40:e3:d6:da:ba:21,36104220,368,-176,36103852,36104220
3866,6,12,1,2412,-49,-91,42,40:e3:d6:da:ba:22,36104616,180,216,36104436,36104616
3867,6,12,1,2412,-49,-91,42,40:e3:d6:da:ba:23,36104849,184,49,36104665,36104849
3868,6,12,1,2412,-48,-91,43,40:e3:d6:da:ba:24,36105058,176,33,36104882,36105058
3869,6,12,1,2412,-48,-91,43,40:e3:d6:da:ba:25,36105278,160,60,36105118,36105278
3870,6,6,1,2412,-49,-91,42,40:e3:d6:da:ba:26,36105496,380,-162,36105116,36105496
3871,6,12,1,2412,-63,-91,28,84:d4:7e:d5:12:c0,36133768,960,27312,36132808,36133768
3872,6,12,1,2412,-73,-91,18,40:e3:d6:da:c4:00,36146794,960,12066,36145834,36146794
3873,6,6,1,2412,-69,-91,22,e6:aa:ea:b7:4a:dd,36175696,408,28494,36175288,36175696
3874,6,6,1,2412,-67,-91,24,e6:aa:ea:b7:4a:dd,36187726,408,11622,36187318,36187726
3875,6,6,1,2412,-70,-91,21,e6:aa:ea:b7:4a:dd,36199841,408,11707,36199433,36199841
3876,6,12,1,2412,-49,-91,42,40:e3:d6:da:ba:20,36206432,160,6431,36206272,36206432
3877,6,6,1,2412,-49,-91,42,40:e3:d6:da:ba:21,36206624,368,-176,36206256,36206624
3878,6,12,1,2412,-47,-91,44,40:e3:d6:da:ba:22,36207045,180,241,36206865,36207045
3879,6,12,1,2412,-49,-91,42,40:e3:d6:da:ba:23,36207277,184,48,36207093,36207277
3880,6,12,1,2412,-49,-91,42,40:e3:d6:da:ba:24,36207487,176,34,36207311,36207487
3881,6,12,1,2412,-49,-91,42,40:e3:d6:da:ba:25,36207697,160,50,36207537,36207697
3882,6,6,1,2412,-49,-91,42,40:e3:d6:da:ba:26,36210571,380,2494,36210191,36210571
3883,6,6,1,2412,-87,-91,4,84:d4:7e:f2:42:26,36225813,380,14862,36225433,36225813
3884,6,12,1,2412,-50,-91,41,40:e3:d6:da:ba:20,36308852,160,82879,36308692,36308852
3885,6,6,1,2412,-50,-91,41,40:e3:d6:da:ba:21,36309044,368,-176,36308676,36309044
3886,6,12,1,2412,-50,-91,41,40:e3:d6:da:ba:22,36309439,180,215,36309259,36309439
3887,6,12,1,2412,-50,-91,41,40:e3:d6:da:ba:23,36309663,184,40,36309479,36309663
3888,6,12,1,2412,-50,-91,41,40:e3:d6:da:ba:24,36309899,176,60,36309723,36309899
3889,6,12,1,2412,-50,-91,41,40:e3:d6:da:ba:25,36310128,160,69,36309968,36310128
3890,6,6,1,2412,-50,-91,41,40:e3:d6:da:ba:26,36310347,380,-161,36309967,36310347
3891,4,1,1,2412,-66,-91,25,54:e4:3a:ec:fb:64,36319771,2160,7264,36317611,36319771
3892,6,6,1,2412,-49,-91,42,e6:aa:ea:c9:ea:33,36339391,408,19212,36338983,36339391
3893,6,6,1,2412,-49,-91,42,e6:aa:ea:c9:ea:33,36351517,408,11718,36351109,36351517
3894,6,6,1,2412,-50,-91,41,e6:aa:ea:c9:ea:33,36363698,408,11773,36363290,36363698
3895,6,6,1,2412,-50,-91,41,e6:aa:ea:c9:ea:33,36375849,408,11743,36375441,36375849
3896,6,6,1,2412,-50,-91,41,e6:aa:ea:c9:ea:33,36387891,408,11634,36387483,36387891
3897,6,12,1,2412,-52,-91,39,40:e3:d6:da:ba:20,36412982,160,24931,36412822,36412982
3898,6,6,1,2412,-51,-91,40,40:e3:d6:da:ba:21,36413192,368,-158,36412824,36413192
3899,6,12,1,2412,-51,-91,40,40:e3:d6:da:ba:22,36413758,180,386,36413578,36413758
3900,6,12,1,2412,-51,-91,40,40:e3:d6:da:ba:23,36413964,184,22,36413780,36413964
3901,6,12,1,2412,-51,-91,40,40:e3:d6:da:ba:24,36414173,176,33,36413997,36414173
3902,6,12,1,2412,-51,-91,40,40:e3:d6:da:ba:25,36414402,160,69,36414242,36414402
3903,6,6,1,2412,-51,-91,40,40:e3:d6:da:ba:26,36414594,380,-188,36414214,36414594
3904,4,1,1,2412,-86,-91,5,a6:e5:7c:28:b1:d3,36486409,992,70823,36485417,36486409
3905,6,12,1,2412,-51,-91,40,40:e3:d6:da:ba:20,36513635,160,27066,36513475,36513635
3906,6,6,1,2412,-51,-91,40,40:e3:d6:da:ba:21,36513827,368,-176,36513459,36513827
3907,6,12,1,2412,-51,-91,40,40:e3:d6:da:ba:22,36514232,180,225,36514052,36514232
3908,6,12,1,2412,-51,-91,40,40:e3:d6:da:ba:23,36514455,184,39,36514271,36514455
3909,6,12,1,2412,-51,-91,40,40:e3:d6:da:ba:24,36514692,176,61,36514516,36514692
3910,6,12,1,2412,-51,-91,40,40:e3:d6:da:ba:25,36514893,160,41,36514733,36514893
3911,6,6,1,2412,-51,-91,40,40:e3:d6:da:ba:26,36515085,380,-188,36514705,36515085
3912,4,1,1,2412,-67,-91,24,54:e4:3a:ec:fb:64,36524623,2160,7378,36522463,36524623
3913,6,12,1,2412,-50,-91,41,40:e3:d6:da:ba:20,36616029,160,91246,36615869,36616029
3914,6,6,1,2412,-50,-91,41,40:e3:d6:da:ba:21,36616239,368,-158,36615871,36616239
3915,6,12,1,2412,-50,-91,41,40:e3:d6:da:ba:22,36616652,180,233,36616472,36616652
3916,6,12,1,2412,-50,-91,41,40:e3:d6:da:ba:23,36616867,184,31,36616683,36616867
3917,6,12,1,2412,-50,-91,41,40:e3:d6:da:ba:24,36617086,176,43,36616910,36617086
3918,6,12,1,2412,-50,-91,41,40:e3:d6:da:ba:25,36617296,160,50,36617136,36617296
3919,6,6,1,2412,-50,-91,41,40:e3:d6:da:ba:26,36617497,380,-179,36617117,36617497
3920,6,6,1,2412,-86,-91,5,84:d4:7e:f2:42:21,36634153,368,16288,36633785,36634153
3921,6,12,1,2412,-86,-91,5,84:d4:7e:f2:42:22,36634558,180,225,36634378,36634558
3922,6,12,1,2412,-87,-91,4,84:d4:7e:f2:42:23,36634791,180,53,36634611,36634791
3923,6,6,1,2412,-88,-91,3,84:d4:7e:f2:42:26,36635416,380,245,36635036,36635416
3924,6,6,1,2412,-50,-91,41,e6:aa:ea:c9:ea:33,36654132,408,18308,36653724,36654132
3925,6,6,1,2412,-50,-91,41,e6:aa:ea:c9:ea:33,36666220,408,11680,36665812,36666220
3926,4,1,1,2412,-52,-91,39,36:94:14:79:48:9d,36670805,1152,3433,36669653,36670805
3927,6,12,1,2412,-51,-91,40,40:e3:d6:da:ba:20,36671953,136,1012,36671817,36671953
3928,6,6,1,2412,-51,-91,40,40:e3:d6:da:ba:21,36672130,348,-171,36671782,36672130
3929,6,12,1,2412,-51,-91,40,40:e3:d6:da:ba:22,36673590,156,1304,36673434,36673590
3930,6,12,1,2412,-51,-91,40,40:e3:d6:da:ba:23,36673799,156,53,36673643,36673799
3931,6,12,1,2412,-51,-91,40,40:e3:d6:da:ba:25,36673998,136,63,36673862,36673998
3932,6,6,1,2412,-49,-91,42,e6:aa:ea:c9:ea:33,36678330,408,3924,36677922,36678330
3933,6,6,1,2412,-68,-91,23,e6:aa:ea:b7:4a:dd,36682964,408,4226,36682556,36682964
3934,6,6,1,2412,-49,-91,42,e6:aa:ea:c9:ea:33,36702565,408,19193,36702157,36702565
3935,6,12,1,2412,-51,-91,40,40:e3:d6:da:ba:20,36718427,160,15702,36718267,36718427
3936,6,6,1,2412,-51,-91,40,40:e3:d6:da:ba:21,36718628,368,-167,36718260,36718628
3937,6,12,1,2412,-51,-91,40,40:e3:d6:da:ba:22,36719155,180,347,36718975,36719155
3938,6,12,1,2412,-51,-91,40,40:e3:d6:da:ba:23,36719369,184,30,36719185,36719369
3939,6,12,1,2412,-51,-91,40,40:e3:d6:da:ba:24,36719593,176,48,36719417,36719593
3940,6,12,1,2412,-51,-91,40,40:e3:d6:da:ba:25,36719804,160,51,36719644,36719804
3941,6,6,1,2412,-51,-91,40,40:e3:d6:da:ba:26,36721647,380,1463,36721267,36721647
3942,6,6,1,2412,-66,-91,25,e6:aa:ea:b7:4a:dd,36731430,408,9375,36731022,36731430
3943,4,1,1,2412,-64,-91,27,54:e4:3a:ec:fb:64,36732016,2160,-1574,36729856,36732016
3944,6,12,1,2412,-88,-91,3,84:d4:7e:f2:42:20,36737040,160,4864,36736880,36737040
3945,6,6,1,2412,-88,-91,3,84:d4:7e:f2:42:21,36737241,368,-167,36736873,36737241
3946,6,12,1,2412,-87,-91,4,84:d4:7e:f2:42:22,36737655,180,234,36737475,36737655
3947,4,1,1,2412,-47,-91,44,76:34:ad:20:25:6a,36762943,1152,24136,36761791,36762943
3948,4,1,1,2412,-64,-91,27,54:e4:3a:ec:fb:64,36764247,2112,-808,36762135,36764247
3949,4,1,1,2412,-49,-91,42,,36766371,304,1820,36766067,36766371
3950,4,1,1,2412,-65,-91,26,54:e4:3a:ec:fb:64,36766825,2112,-1658,36764713,36766825
3951,4,1,1,2412,-64,-91,27,54:e4:3a:ec:fb:64,36786051,2112,17114,36783939,36786051
3952,4,1,1,2412,-55,-91,36,,36788176,304,1821,36787872,36788176
3953,6,6,1,2412,-50,-91,41,40:e3:d6:da:ba:21,36821126,368,32582,36820758,36821126
3954,6,12,1,2412,-50,-91,41,40:e3:d6:da:ba:22,36821521,180,215,36821341,36821521
3955,6,12,1,2412,-50,-91,41,40:e3:d6:da:ba:23,36821727,184,22,36821543,36821727
3956,6,12,1,2412,-50,-91,41,40:e3:d6:da:ba:25,36822223,160,336,36822063,36822223
3957,6,6,1,2412,-50,-91,41,40:e3:d6:da:ba:26,36822442,380,-161,36822062,36822442
3958,4,1,1,2412,-85,-91,6,b8:3a:5a:88:e6:e1,36835555,2376,10737,36833179,36835555
3959,6,6,1,2412,-81,-91,10,e6:aa:ea:c9:ea:1b,36844142,408,8179,36843734,36844142
3960,4,1,1,2412,-87,-91,4,,36854507,304,10061,36854203,36854507
3961,6,6,1,2412,-83,-91,8,e6:aa:ea:c9:ea:1b,36856257,408,1342,36855849,36856257
3962,6,12,1,2412,-49,-91,42,40:e3:d6:da:ba:20,36923237,160,66820,36923077,36923237
3963,6,6,1,2412,-49,-91,42,40:e3:d6:da:ba:21,36923437,368,-168,36923069,36923437
3964,6,12,1,2412,-48,-91,43,40:e3:d6:da:ba:22,36923852,180,235,36923672,36923852
3965,6,12,1,2412,-48,-91,43,40:e3:d6:da:ba:23,36924066,184,30,36923882,36924066
3966,6,12,1,2412,-48,-91,43,40:e3:d6:da:ba:24,36924294,176,52,36924118,36924294
3967,6,12,1,2412,-48,-91,43,40:e3:d6:da:ba:25,36924513,160,59,36924353,36924513
3968,6,6,1,2412,-48,-91,43,40:e3:d6:da:ba:26,36924705,380,-188,36924325,36924705
3969,4,1,1,2412,-66,-91,25,54:e4:3a:ec:fb:64,36934166,2160,7301,36932006,36934166
3970,6,6,1,2412,-51,-91,40,e6:aa:ea:c9:ea:33,36981022,408,46448,36980614,36981022
3971,6,6,1,2412,-51,-91,40,e6:aa:ea:c9:ea:33,36993112,408,11682,36992704,36993112
3972,6,6,1,2412,-52,-91,39,e6:aa:ea:c9:ea:33,37005229,408,11709,37004821,37005229
3973,6,6,1,2412,-52,-91,39,e6:aa:ea:c9:ea:33,37019404,408,13767,37018996,37019404
3974,6,6,1,2412,-48,-91,43,40:e3:d6:da:ba:21,37025827,368,6055,37025459,37025827
3975,6,12,1,2412,-48,-91,43,40:e3:d6:da:ba:22,37026223,180,216,37026043,37026223
3976,6,12,1,2412,-48,-91,43,40:e3:d6:da:ba:23,37026428,184,21,37026244,37026428
3977,6,12,1,2412,-48,-91,43,40:e3:d6:da:ba:24,37029021,176,2417,37028845,37029021
3978,6,12,1,2412,-48,-91,43,40:e3:d6:da:ba:25,37029250,160,69,37029090,37029250
3979,6,6,1,2412,-48,-91,43,40:e3:d6:da:ba:26,37029442,380,-188,37029062,37029442
3980,4,1,1,2412,-68,-91,23,54:e4:3a:ec:fb:64,37036607,2160,5005,37034447,37036607
3981,6,12,1,2412,-84,-91,7,84:d4:7e:f2:42:20,37043541,160,6774,37043381,37043541
3982,6,12,1,2412,-87,-91,4,84:d4:7e:f2:42:22,37044138,180,417,37043958,37044138
3983,6,12,1,2412,-87,-91,4,84:d4:7e:f2:42:24,37044567,176,253,37044391,37044567
3984,4,1,1,2412,-59,-91,32,ae:c4:df:e0:86:8d,37098954,1504,52883,37097450,37098954
3985,6,12,1,2412,-47,-91,44,40:e3:d6:da:ba:23,37101078,156,1968,37100922,37101078
3986,6,12,1,2412,-59,-91,32,,37101251,32,141,37101219,37101251
3987,4,1,1,2412,-59,-91,32,ae:c4:df:e0:86:8d,37118924,1504,16169,37117420,37118924
3988,6,12,1,2412,-47,-91,44,40:e3:d6:da:ba:23,37120404,156,1324,37120248,37120404
3989,6,12,1,2412,-61,-91,30,,37120576,32,140,37120544,37120576
3990,6,6,1,2412,-45,-91,46,40:e3:d6:da:ba:21,37129475,368,8531,37129107,37129475
3991,6,12,1,2412,-45,-91,46,40:e3:d6:da:ba:24,37130372,176,721,37130196,37130372
3992,6,12,1,2412,-44,-91,47,40:e3:d6:da:ba:25,37130582,160,50,37130422,37130582
3993,6,6,1,2412,-44,-91,47,40:e3:d6:da:ba:26,37130775,380,-187,37130395,37130775
3994,4,1,1,2412,-67,-91,24,54:e4:3a:ec:fb:64,37138965,2160,6030,37136805,37138965
3995,6,12,1,2412,-87,-91,4,84:d4:7e:f2:42:20,37145983,160,6858,37145823,37145983
3996,6,6,1,2412,-86,-91,5,84:d4:7e:f2:42:21,37146184,368,-167,37145816,37146184
3997,6,12,1,2412,-87,-91,4,84:d4:7e:f2:42:24,37147042,176,682,37146866,37147042
3998,6,12,1,2412,-86,-91,5,84:d4:7e:f2:42:25,37147243,160,41,37147083,37147243
3999,6,12,1,2412,-81,-91,10,,37175900,32,28625,37175868,37175900
4000,6,12,1,2412,-82,-91,9,,37176123,32,191,37176091,37176123
4001,6,6,1,2412,-82,-91,9,,37176570,44,403,37176526,37176570
4002,6,6,1,2412,-82,-91,9,,37177258,44,644,37177214,37177258
4003,6,12,1,2412,-82,-91,9,,37177912,32,622,37177880,37177912
4004,6,6,1,2412,-66,-91,25,e6:aa:ea:b7:4a:dd,37203144,408,24824,37202736,37203144
4005,6,6,1,2412,-66,-91,25,e6:aa:ea:b7:4a:dd,37215420,408,11868,37215012,37215420
4006,6,6,1,2412,-83,-91,8,,37226461,44,10997,37226417,37226461
4007,6,12,1,2412,-46,-91,45,40:e3:d6:da:ba:20,37231854,160,5233,37231694,37231854
4008,6,6,1,2412,-46,-91,45,40:e3:d6:da:ba:21,37232047,368,-175,37231679,37232047
4009,6,12,1,2412,-46,-91,45,40:e3:d6:da:ba:22,37232443,180,216,37232263,37232443
4010,6,12,1,2412,-46,-91,45,40:e3:d6:da:ba:23,37232675,184,48,37232491,37232675
4011,6,12,1,2412,-46,-91,45,40:e3:d6:da:ba:24,37232903,176,52,37232727,37232903
4012,6,12,1,2412,-46,-91,45,40:e3:d6:da:ba:25,37233131,160,68,37232971,37233131
4013,6,6,1,2412,-46,-91,45,40:e3:d6:da:ba:26,37233332,380,-179,37232952,37233332
4014,6,6,1,2412,-67,-91,24,e6:aa:ea:b7:4a:dd,37239496,408,5756,37239088,37239496
4015,6,12,1,2412,-89,-91,2,84:d4:7e:f2:42:22,37248968,180,9292,37248788,37248968
4016,6,6,1,2412,-85,-91,6,84:d4:7e:f2:42:26,37249836,380,488,37249456,37249836
4017,6,6,1,2412,-82,-91,9,e6:aa:ea:c9:ea:1b,37276333,408,26089,37275925,37276333
4018,6,6,1,2412,-54,-91,37,e6:aa:ea:c9:ea:33,37284371,408,7630,37283963,37284371
4019,6,6,1,2412,-54,-91,37,e6:aa:ea:c9:ea:33,37296494,408,11715,37296086,37296494
4020,6,6,1,2412,-54,-91,37,e6:aa:ea:c9:ea:33,37308607,408,11705,37308199,37308607
4021,6,12,1,2412,-47,-91,44,40:e3:d6:da:ba:20,37333279,160,24512,37333119,37333279
4022,6,12,1,2412,-47,-91,44,40:e3:d6:da:ba:22,37333894,180,435,37333714,37333894
4023,6,12,1,2412,-47,-91,44,40:e3:d6:da:ba:23,37334100,184,22,37333916,37334100
4024,6,12,1,2412,-47,-91,44,40:e3:d6:da:ba:24,37334309,176,33,37334133,37334309
4025,6,12,1,2412,-47,-91,44,40:e3:d6:da:ba:25,37334520,160,51,37334360,37334520
4026,6,6,1,2412,-47,-91,44,40:e3:d6:da:ba:26,37334712,380,-188,37334332,37334712
4027,4,1,1,2412,-69,-91,22,54:e4:3a:ec:fb:64,37343762,2160,6890,37341602,37343762
4028,6,12,1,2412,-88,-91,3,84:d4:7e:f2:42:24,37351815,176,7877,37351639,37351815
4029,6,12,1,2412,-87,-91,4,84:d4:7e:f2:42:25,37352034,160,59,37351874,37352034
4030,6,12,1,2412,-48,-91,43,40:e3:d6:da:ba:20,37435238,160,83044,37435078,37435238
4031,6,6,1,2412,-48,-91,43,40:e3:d6:da:ba:21,37435430,368,-176,37435062,37435430
4032,6,12,1,2412,-48,-91,43,40:e3:d6:da:ba:22,37435844,180,234,37435664,37435844
4033,6,12,1,2412,-48,-91,43,40:e3:d6:da:ba:23,37436058,184,30,37435874,37436058
4034,6,12,1,2412,-48,-91,43,40:e3:d6:da:ba:24,37436295,176,61,37436119,37436295
4035,6,12,1,2412,-48,-91,43,40:e3:d6:da:ba:25,37436514,160,59,37436354,37436514
4036,6,6,1,2412,-48,-91,43,40:e3:d6:da:ba:26,37436724,380,-170,37436344,37436724
4037,4,1,1,2412,-67,-91,24,54:e4:3a:ec:fb:64,37446163,2160,7279,37444003,37446163
4038,4,1,1,2412,-87,-91,4,b8:3a:5a:88:e6:e0,37448346,2360,-177,37445986,37448346
4039,6,12,1,2412,-86,-91,5,84:d4:7e:f2:42:20,37453181,160,4675,37453021,37453181
4040,6,12,1,2412,-49,-91,42,40:e3:d6:da:ba:20,37537640,160,84299,37537480,37537640
4041,6,6,1,2412,-48,-91,43,40:e3:d6:da:ba:21,37537832,368,-176,37537464,37537832
4042,6,12,1,2412,-48,-91,43,40:e3:d6:da:ba:22,37538262,180,250,37538082,37538262
4043,6,12,1,2412,-48,-91,43,40:e3:d6:da:ba:23,37538495,184,49,37538311,37538495
4044,6,12,1,2412,-48,-91,43,40:e3:d6:da:ba:24,37538704,176,33,37538528,37538704
4045,6,12,1,2412,-48,-91,43,40:e3:d6:da:ba:25,37538940,160,76,37538780,37538940
4046,6,6,1,2412,-49,-91,42,40:e3:d6:da:ba:26,37539150,380,-170,37538770,37539150
4047,4,1,1,2412,-65,-91,26,54:e4:3a:ec:fb:64,37548561,2160,7251,37546401,37548561
4048,6,6,1,2412,-53,-91,38,e6:aa:ea:c9:ea:33,37602306,408,53337,37601898,37602306
4049,6,6,1,2412,-53,-91,38,e6:aa:ea:c9:ea:33,37614424,408,11710,37614016,37614424
4050,6,6,1,2412,-53,-91,38,e6:aa:ea:c9:ea:33,37626548,408,11716,37626140,37626548
4051,6,6,1,2412,-53,-91,38,e6:aa:ea:c9:ea:33,37638684,408,11728,37638276,37638684
4052,6,12,1,2412,-49,-91,42,40:e3:d6:da:ba:20,37640032,160,1188,37639872,37640032
4053,6,6,1,2412,-49,-91,42,40:e3:d6:da:ba:21,37640233,368,-167,37639865,37640233
4054,6,12,1,2412,-48,-91,43,40:e3:d6:da:ba:22,37640620,180,207,37640440,37640620
4055,6,12,1,2412,-48,-91,43,40:e3:d6:da:ba:23,37640843,184,39,37640659,37640843
4056,6,12,1,2412,-48,-91,43,40:e3:d6:da:ba:25,37641324,160,321,37641164,37641324
4057,6,6,1,2412,-48,-91,43,40:e3:d6:da:ba:26,37641534,380,-170,37641154,37641534
4058,6,12,1,2412,-89,-91,2,84:d4:7e:f2:42:22,37658554,180,16840,37658374,37658554
4059,6,12,1,2412,-49,-91,42,40:e3:d6:da:ba:20,37742439,160,83725,37742279,37742439
4060,6,6,1,2412,-48,-91,43,40:e3:d6:da:ba:21,37742649,368,-158,37742281,37742649
4061,6,12,1,2412,-48,-91,43,40:e3:d6:da:ba:22,37743064,180,235,37742884,37743064
4062,6,12,1,2412,-48,-91,43,40:e3:d6:da:ba:23,37743296,184,48,37743112,37743296
4063,6,12,1,2412,-49,-91,42,40:e3:d6:da:ba:24,37743506,176,34,37743330,37743506
4064,6,12,1,2412,-48,-91,43,40:e3:d6:da:ba:25,37743734,160,68,37743574,37743734
4065,6,6,1,2412,-48,-91,43,40:e3:d6:da:ba:26,37743926,380,-188,37743546,37743926
4066,4,1,1,2412,-64,-91,27,54:e4:3a:ec:fb:64,37753360,2160,7274,37751200,37753360
4067,6,6,1,2412,-82,-91,9,e6:aa:ea:c9:ea:1b,37762346,408,8578,37761938,37762346
4068,4,1,1,2412,-86,-91,5,c0:c9:e3:4d:6e:bf,37794745,872,31527,37793873,37794745
4069,6,12,1,2412,-48,-91,43,40:e3:d6:da:ba:23,37800004,156,5103,37799848,37800004
4070,6,6,1,2412,-83,-91,8,e6:aa:ea:c9:ea:1b,37810605,408,10193,37810197,37810605
4071,6,12,1,2412,-48,-91,43,40:e3:d6:da:ba:20,37844850,160,34085,37844690,37844850
4072,6,6,1,2412,-48,-91,43,40:e3:d6:da:ba:21,37845069,368,-149,37844701,37845069
4073,6,12,1,2412,-48,-91,43,40:e3:d6:da:ba:22,37845456,180,207,37845276,37845456
4074,6,12,1,2412,-48,-91,43,40:e3:d6:da:ba:23,37845670,184,30,37845486,37845670
4075,6,12,1,2412,-48,-91,43,40:e3:d6:da:ba:24,37845898,176,52,37845722,37845898
4076,6,12,1,2412,-48,-91,43,40:e3:d6:da:ba:25,37846099,160,41,37845939,37846099
4077,6,6,1,2412,-48,-91,43,40:e3:d6:da:ba:26,37846318,380,-161,37845938,37846318
4078,4,1,1,2412,-68,-91,23,54:e4:3a:ec:fb:64,37855759,2160,7281,37853599,37855759
4079,4,1,1,2412,-55,-91,36,ae:c4:df:e0:86:8d,37895315,1504,38052,37893811,37895315
4080,6,12,1,2412,-49,-91,42,40:e3:d6:da:ba:20,37947891,160,52416,37947731,37947891
4081,6,12,1,2412,-48,-91,43,40:e3:d6:da:ba:22,37948527,180,456,37948347,37948527
4082,6,12,1,2412,-48,-91,43,40:e3:d6:da:ba:23,37948742,184,31,37948558,37948742
4083,6,12,1,2412,-48,-91,43,40:e3:d6:da:ba:24,37948969,176,51,37948793,37948969
4084,6,6,1,2412,-48,-91,43,40:e3:d6:da:ba:26,37949405,380,56,37949025,37949405
4085,4,1,1,2412,-64,-91,27,54:e4:3a:ec:fb:64,37958157,2160,6592,37955997,37958157
4086,6,6,1,2412,-55,-91,36,e6:aa:ea:c9:ea:33,38019476,408,60911,38019068,38019476
4087,6,6,1,2412,-55,-91,36,e6:aa:ea:c9:ea:33,38031897,408,12013,38031489,38031897
4088,6,6,1,2412,-48,-91,43,,38035114,44,3173,38035070,38035114
4089,6,6,1,2412,-55,-91,36,e6:aa:ea:c9:ea:33,38043714,408,8192,38043306,38043714
4090,6,12,1,2412,-50,-91,41,40:e3:d6:da:ba:20,38049726,160,5852,38049566,38049726
4091,6,6,1,2412,-49,-91,42,40:e3:d6:da:ba:21,38050105,368,11,38049737,38050105
4092,6,12,1,2412,-49,-91,42,40:e3:d6:da:ba:22,38050500,180,215,38050320,38050500
4093,6,12,1,2412,-49,-91,42,40:e3:d6:da:ba:23,38050735,184,51,38050551,38050735
4094,6,12,1,2412,-49,-91,42,40:e3:d6:da:ba:24,38050963,176,52,38050787,38050963
4095,6,12,1,2412,-49,-91,42,40:e3:d6:da:ba:25,38051182,160,59,38051022,38051182
4096,6,6,1,2412,-49,-91,42,40:e3:d6:da:ba:26,38051374,380,-188,38050994,38051374
4097,6,6,1,2412,-55,-91,36,e6:aa:ea:c9:ea:33,38055841,408,4059,38055433,38055841
4098,6,6,1,2412,-53,-91,38,e6:aa:ea:c9:ea:33,38068158,408,11909,38067750,38068158
4099,6,6,1,2412,-48,-91,43,,38085114,44,16912,38085070,38085114
4100,6,6,1,2412,-48,-91,43,,38110116,44,24958,38110072,38110116
4101,6,24,1,2412,-79,-91,12,,38113931,28,3787,38113903,38113931
4102,6,12,1,2412,-51,-91,40,,38113976,32,13,38113944,38113976
4103,6,12,1,2412,-51,-91,40,,38114089,44,69,38114045,38114089
4104,6,12,1,2412,-78,-91,13,,38114992,32,871,38114960,38114992
4105,6,12,1,2412,-51,-91,40,,38115100,36,72,38115064,38115100
4106,6,12,1,2412,-79,-91,12,,38115151,32,19,38115119,38115151
4107,7,86.6667,1,2412,-50,-91,41,00:1f:26:41:f0:00,38115209,51,7,38115158,38115209
4108,6,24,1,2412,-78,-91,13,,38115268,32,27,38115236,38115268
4109,6,24,1,2412,-79,-91,12,22:a3:7f:87:e5:4e,38129416,32,14116,38129384,38129416
4110,6,12,1,2412,-51,-91,40,,38129465,32,17,38129433,38129465
4111,6,6,1,2412,-66,-91,25,e6:aa:ea:b7:4a:dd,38139871,408,9998,38139463,38139871
4112,6,12,1,2412,-50,-91,41,40:e3:d6:da:ba:20,38152410,160,12379,38152250,38152410
4113,6,6,1,2412,-51,-91,40,40:e3:d6:da:ba:21,38152611,368,-167,38152243,38152611
4114,6,12,1,2412,-50,-91,41,40:e3:d6:da:ba:22,38153025,180,234,38152845,38153025
4115,6,12,1,2412,-50,-91,41,40:e3:d6:da:ba:23,38153231,184,22,38153047,38153231
4116,6,12,1,2412,-50,-91,41,40:e3:d6:da:ba:24,38153449,176,42,38153273,38153449
4117,6,12,1,2412,-50,-91,41,40:e3:d6:da:ba:25,38153669,160,60,38153509,38153669
4118,6,6,1,2412,-50,-91,41,40:e3:d6:da:ba:26,38153870,380,-179,38153490,38153870
4119,6,12,1,2412,-46,-91,45,40:e3:d6:da:ba:20,38254434,160,100404,38254274,38254434
4120,6,6,1,2412,-47,-91,44,40:e3:d6:da:ba:21,38254635,368,-167,38254267,38254635
4121,6,12,1,2412,-47,-91,44,40:e3:d6:da:ba:22,38255031,180,216,38254851,38255031
4122,6,12,1,2412,-47,-91,44,40:e3:d6:da:ba:23,38255245,184,30,38255061,38255245
4123,6,12,1,2412,-47,-91,44,40:e3:d6:da:ba:24,38255473,176,52,38255297,38255473
4124,6,12,1,2412,-47,-91,44,40:e3:d6:da:ba:25,38255674,160,41,38255514,38255674
4125,6,6,1,2412,-47,-91,44,40:e3:d6:da:ba:26,38255884,380,-170,38255504,38255884
4126,6,6,1,2412,-88,-91,3,84:d4:7e:f2:42:26,38273789,380,17525,38273409,38273789
4127,6,6,1,2412,-83,-91,8,e6:aa:ea:c9:ea:1b,38296393,408,22196,38295985,38296393
4128,6,6,1,2412,-82,-91,9,e6:aa:ea:c9:ea:1b,38332793,408,35992,38332385,38332793
4129,6,12,1,2412,-46,-91,45,40:e3:d6:da:ba:20,38356843,160,23890,38356683,38356843
4130,6,6,1,2412,-46,-91,45,40:e3:d6:da:ba:21,38357044,368,-167,38356676,38357044
4131,6,12,1,2412,-46,-91,45,40:e3:d6:da:ba:22,38357449,180,225,38357269,38357449
4132,6,12,1,2412,-46,-91,45,40:e3:d6:da:ba:23,38357654,184,21,38357470,38357654
4133,6,12,1,2412,-46,-91,45,40:e3:d6:da:ba:24,38357873,176,43,38357697,38357873
4134,6,12,1,2412,-46,-91,45,40:e3:d6:da:ba:25,38358092,160,59,38357932,38358092
4135,6,6,1,2412,-46,-91,45,40:e3:d6:da:ba:26,38358284,380,-188,38357904,38358284
4136,6,6,1,2412,-85,-91,6,84:d4:7e:f2:42:26,38376387,380,17723,38376007,38376387
4137,4,1,1,2412,-87,-91,4,a4:e5:7c:28:b1:d3,38426005,688,48930,38425317,38426005
4138,4,1,1,2412,-88,-91,3,a6:e5:7c:28:b1:d3,38432509,992,5512,38431517,38432509
4139,6,6,1,2412,-53,-91,38,e6:aa:ea:c9:ea:33,38437021,408,4104,38436613,38437021
4140,6,12,1,2412,-46,-91,45,40:e3:d6:da:ba:20,38459255,160,22074,38459095,38459255
4141,6,6,1,2412,-46,-91,45,40:e3:d6:da:ba:21,38459456,368,-167,38459088,38459456
4142,6,12,1,2412,-46,-91,45,40:e3:d6:da:ba:22,38459907,180,271,38459727,38459907
4143,6,12,1,2412,-46,-91,45,40:e3:d6:da:ba:23,38460112,184,21,38459928,38460112
4144,6,12,1,2412,-46,-91,45,40:e3:d6:da:ba:24,38460349,176,61,38460173,38460349
4145,6,12,1,2412,-46,-91,45,40:e3:d6:da:ba:25,38460589,160,80,38460429,38460589
4146,6,6,1,2412,-46,-91,45,40:e3:d6:da:ba:26,38460799,380,-170,38460419,38460799
4147,6,6,1,2412,-53,-91,38,e6:aa:ea:c9:ea:33,38461250,408,43,38460842,38461250
4148,6,6,1,2412,-53,-91,38,e6:aa:ea:c9:ea:33,38473375,408,11717,38472967,38473375
4149,6,6,1,2412,-53,-91,38,e6:aa:ea:c9:ea:33,38485491,408,11708,38485083,38485491
4150,4,1,1,2412,-69,-91,22,54:e4:3a:ec:fb:64,38515828,2112,28225,38513716,38515828
4151,6,12,1,2412,-47,-91,44,40:e3:d6:da:ba:20,38561642,160,45654,38561482,38561642
4152,6,6,1,2412,-47,-91,44,40:e3:d6:da:ba:21,38561834,368,-176,38561466,38561834
4153,6,12,1,2412,-46,-91,45,40:e3:d6:da:ba:22,38562239,180,225,38562059,38562239
4154,6,12,1,2412,-46,-91,45,40:e3:d6:da:ba:23,38562462,184,39,38562278,38562462
4155,6,12,1,2412,-46,-91,45,40:e3:d6:da:ba:24,38562681,176,43,38562505,38562681
4156,6,12,1,2412,-47,-91,44,40:e3:d6:da:ba:25,38562882,160,41,38562722,38562882
4157,6,6,1,2412,-46,-91,45,40:e3:d6:da:ba:26,38563092,380,-170,38562712,38563092
4158,6,6,1,2412,-67,-91,24,e6:aa:ea:b7:4a:dd,38659100,408,95600,38658692,38659100
4159,6,12,1,2412,-47,-91,44,40:e3:d6:da:ba:20,38664054,160,4794,38663894,38664054
4160,6,6,1,2412,-47,-91,44,40:e3:d6:da:ba:21,38664255,368,-167,38663887,38664255
4161,6,12,1,2412,-47,-91,44,40:e3:d6:da:ba:22,38664732,180,297,38664552,38664732
4162,6,12,1,2412,-47,-91,44,40:e3:d6:da:ba:23,38664965,184,49,38664781,38664965
4163,6,12,1,2412,-47,-91,44,40:e3:d6:da:ba:24,38665192,176,51,38665016,38665192
4164,6,12,1,2412,-47,-91,44,40:e3:d6:da:ba:25,38665420,160,68,38665260,38665420
4165,6,6,1,2412,-47,-91,44,40:e3:d6:da:ba:26,38665639,380,-161,38665259,38665639
4166,4,1,1,2412,-69,-91,22,54:e4:3a:ec:fb:64,38674951,2160,7152,38672791,38674951
4167,6,6,1,2412,-85,-91,6,e6:aa:ea:c9:ea:1b,38729515,408,54156,38729107,38729515
4168,6,6,1,2412,-85,-91,6,e6:aa:ea:c9:ea:1b,38753843,408,23920,38753435,38753843
4169,6,12,1,2412,-48,-91,43,40:e3:d6:da:ba:20,38766437,160,12434,38766277,38766437
4170,6,6,1,2412,-48,-91,43,40:e3:d6:da:ba:21,38766662,368,-143,38766294,38766662
4171,6,6,1,2412,-50,-91,41,e6:aa:ea:c9:ea:33,38854164,408,87094,38853756,38854164
4172,6,6,1,2412,-50,-91,41,e6:aa:ea:c9:ea:33,38866356,408,11784,38865948,38866356
4173,6,12,1,2412,-50,-91,41,40:e3:d6:da:ba:20,38868891,160,2375,38868731,38868891
4174,6,12,1,2412,-50,-91,41,40:e3:d6:da:ba:22,38869508,180,437,38869328,38869508
4175,6,12,1,2412,-50,-91,41,40:e3:d6:da:ba:23,38869723,184,31,38869539,38869723
4176,6,12,1,2412,-50,-91,41,40:e3:d6:da:ba:24,38869959,176,60,38869783,38869959
4177,6,12,1,2412,-50,-91,41,40:e3:d6:da:ba:25,38870179,160,60,38870019,38870179
4178,6,6,1,2412,-50,-91,41,40:e3:d6:da:ba:26,38870398,380,-161,38870018,38870398
4179,6,6,1,2412,-50,-91,41,e6:aa:ea:c9:ea:33,38878473,408,7667,38878065,38878473
4180,6,6,1,2412,-49,-91,42,e6:aa:ea:c9:ea:33,38890559,408,11678,38890151,38890559
4181,4,1,1,2412,-89,-91,2,a6:e5:7c:28:b1:d3,38944296,992,52745,38943304,38944296
4182,6,12,1,2412,-51,-91,40,40:e3:d6:da:ba:20,38971416,160,26960,38971256,38971416
4183,6,6,1,2412,-51,-91,40,40:e3:d6:da:ba:21,38971635,368,-149,38971267,38971635
4184,6,12,1,2412,-51,-91,40,40:e3:d6:da:ba:22,38972040,180,225,38971860,38972040
4185,6,12,1,2412,-51,-91,40,40:e3:d6:da:ba:23,38972255,184,31,38972071,38972255
4186,6,12,1,2412,-51,-91,40,40:e3:d6:da:ba:24,38972482,176,51,38972306,38972482
4187,6,12,1,2412,-51,-91,40,40:e3:d6:da:ba:25,38972711,160,69,38972551,38972711
4188,6,6,1,2412,-51,-91,40,40:e3:d6:da:ba:26,38972921,380,-170,38972541,38972921
4189,4,1,1,2412,-67,-91,24,54:e4:3a:ec:fb:64,38982149,2160,7068,38979989,38982149
4190,6,12,1,2412,-52,-91,39,40:e3:d6:da:ba:20,39073833,160,91524,39073673,39073833
4191,6,6,1,2412,-52,-91,39,40:e3:d6:da:ba:21,39074024,368,-177,39073656,39074024
4192,6,12,1,2412,-52,-91,39,40:e3:d6:da:ba:23,39074804,184,596,39074620,39074804
4193,6,12,1,2412,-52,-91,39,40:e3:d6:da:ba:24,39075014,176,34,39074838,39075014
4194,6,12,1,2412,-52,-91,39,40:e3:d6:da:ba:25,39077591,160,2417,39077431,39077591
4195,6,6,1,2412,-52,-91,39,40:e3:d6:da:ba:26,39077783,380,-188,39077403,39077783
4196,4,1,1,2412,-68,-91,23,54:e4:3a:ec:fb:64,39084549,2160,4606,39082389,39084549
4197,6,12,1,2412,-50,-91,41,40:e3:d6:da:ba:20,39176038,160,91329,39175878,39176038
4198,6,6,1,2412,-50,-91,41,40:e3:d6:da:ba:21,39176239,368,-167,39175871,39176239
4199,6,12,1,2412,-49,-91,42,40:e3:d6:da:ba:22,39177032,180,613,39176852,39177032
4200,6,12,1,2412,-50,-91,41,40:e3:d6:da:ba:23,39179110,184,1894,39178926,39179110
4201,6,12,1,2412,-50,-91,41,40:e3:d6:da:ba:24,39179329,176,43,39179153,39179329
4202,6,12,1,2412,-49,-91,42,40:e3:d6:da:ba:25,39179607,160,118,39179447,39179607
4203,6,6,1,2412,-49,-91,42,40:e3:d6:da:ba:26,39179919,380,-68,39179539,39179919
4204,4,1,1,2412,-69,-91,22,54:e4:3a:ec:fb:64,39186947,2160,4868,39184787,39186947
4205,6,6,1,2412,-87,-91,4,84:d4:7e:f2:42:21,39194881,368,7566,39194513,39194881
4206,6,6,1,2412,-67,-91,24,e6:aa:ea:b7:4a:dd,39214704,408,19415,39214296,39214704
4207,6,6,1,2412,-66,-91,25,e6:aa:ea:b7:4a:dd,39226819,408,11707,39226411,39226819
4208,6,6,1,2412,-81,-91,10,e6:aa:ea:c9:ea:1b,39262795,408,35568,39262387,39262795
4209,6,12,1,2412,-49,-91,42,40:e3:d6:da:ba:20,39278456,160,15501,39278296,39278456
4210,6,6,1,2412,-49,-91,42,40:e3:d6:da:ba:21,39278676,368,-148,39278308,39278676
4211,6,12,1,2412,-49,-91,42,40:e3:d6:da:ba:22,39279072,180,216,39278892,39279072
4212,6,12,1,2412,-49,-91,42,40:e3:d6:da:ba:23,39279286,184,30,39279102,39279286
4213,6,12,1,2412,-49,-91,42,40:e3:d6:da:ba:24,39279514,176,52,39279338,39279514
4214,6,12,1,2412,-49,-91,42,40:e3:d6:da:ba:25,39279742,160,68,39279582,39279742
4215,6,6,1,2412,-49,-91,42,40:e3:d6:da:ba:26,39279934,380,-188,39279554,39279934
4216,4,1,1,2412,-47,-91,44,54:e4:3a:ec:fb:64,39289346,2160,7252,39287186,39289346
4217,4,1,1,2412,-89,-91,2,,39324337,304,34687,39324033,39324337
4218,6,6,1,2412,-52,-91,39,e6:aa:ea:c9:ea:33,39375534,408,50789,39375126,39375534
4219,6,6,1,2412,-48,-91,43,40:e3:d6:da:ba:21,39381160,368,5258,39380792,39381160
4220,6,12,1,2412,-48,-91,43,40:e3:d6:da:ba:22,39381547,180,207,39381367,39381547
4221,6,12,1,2412,-48,-91,43,40:e3:d6:da:ba:23,39381753,184,22,39381569,39381753
4222,6,12,1,2412,-48,-91,43,40:e3:d6:da:ba:24,39381981,176,52,39381805,39381981
4223,6,12,1,2412,-48,-91,43,40:e3:d6:da:ba:25,39382191,160,50,39382031,39382191
4224,6,6,1,2412,-48,-91,43,40:e3:d6:da:ba:26,39382401,380,-170,39382021,39382401
4225,6,6,1,2412,-52,-91,39,e6:aa:ea:c9:ea:33,39387653,408,4844,39387245,39387653
4226,4,1,1,2412,-62,-91,29,54:e4:3a:ec:fb:64,39391746,2160,1933,39389586,39391746
4227,6,6,1,2412,-53,-91,38,e6:aa:ea:c9:ea:33,39399769,408,7615,39399361,39399769
4228,6,6,1,2412,-53,-91,38,e6:aa:ea:c9:ea:33,39412267,408,12090,39411859,39412267
4229,6,6,1,2412,-54,-91,37,e6:aa:ea:c9:ea:33,39423989,408,11314,39423581,39423989
4230,6,12,1,2412,-48,-91,43,40:e3:d6:da:ba:20,39483251,160,59102,39483091,39483251
4231,6,6,1,2412,-48,-91,43,40:e3:d6:da:ba:21,39483461,368,-158,39483093,39483461
4232,6,12,1,2412,-48,-91,43,40:e3:d6:da:ba:22,39483866,180,225,39483686,39483866
4233,6,12,1,2412,-48,-91,43,40:e3:d6:da:ba:23,39484089,184,39,39483905,39484089
4234,6,12,1,2412,-48,-91,43,40:e3:d6:da:ba:24,39484317,176,52,39484141,39484317
4235,6,12,1,2412,-48,-91,43,40:e3:d6:da:ba:25,39484518,160,41,39484358,39484518
4236,6,6,1,2412,-48,-91,43,40:e3:d6:da:ba:26,39484719,380,-179,39484339,39484719
4237,6,6,1,2412,-60,-91,31,e6:aa:ea:b7:4a:dd,39492862,408,7735,39492454,39492862
4238,4,1,1,2412,-64,-91,27,54:e4:3a:ec:fb:64,39494145,2160,-877,39491985,39494145
4239,6,6,1,2412,-61,-91,30,e6:aa:ea:b7:4a:dd,39541332,408,46779,39540924,39541332
4240,6,12,1,2412,-49,-91,42,40:e3:d6:da:ba:20,39585640,160,44148,39585480,39585640
4241,6,6,1,2412,-49,-91,42,40:e3:d6:da:ba:21,39585859,368,-149,39585491,39585859
4242,6,12,1,2412,-49,-91,42,40:e3:d6:da:ba:22,39586255,180,216,39586075,39586255
4243,6,12,1,2412,-49,-91,42,40:e3:d6:da:ba:24,39589067,176,2636,39588891,39589067
4244,6,6,1,2412,-83,-91,8,e6:aa:ea:c9:ea:1b,39670028,408,80553,39669620,39670028
4245,6,12,1,2412,-49,-91,42,40:e3:d6:da:ba:20,39688051,160,17863,39687891,39688051
4246,6,6,1,2412,-49,-91,42,40:e3:d6:da:ba:21,39688261,368,-158,39687893,39688261
4247,6,12,1,2412,-49,-91,42,40:e3:d6:da:ba:22,39688666,180,225,39688486,39688666
4248,6,12,1,2412,-49,-91,42,40:e3:d6:da:ba:23,39688899,184,49,39688715,39688899
4249,6,12,1,2412,-49,-91,42,40:e3:d6:da:ba:24,39689117,176,42,39688941,39689117
4250,6,12,1,2412,-49,-91,42,40:e3:d6:da:ba:25,39689363,160,86,39689203,39689363
4251,6,6,1,2412,-49,-91,42,40:e3:d6:da:ba:26,39689555,380,-188,39689175,39689555
4252,6,6,1,2412,-80,-91,11,e6:aa:ea:c9:ea:1b,39694260,408,4297,39693852,39694260
4253,6,6,1,2412,-87,-91,4,84:d4:7e:f2:42:21,39706160,368,11532,39705792,39706160
4254,4,1,1,2412,-69,-91,22,,39769226,304,62762,39768922,39769226
4255,6,12,1,2412,-50,-91,41,40:e3:d6:da:ba:20,39790444,160,21058,39790284,39790444
4256,6,12,1,2412,-50,-91,41,40:e3:d6:da:ba:22,39791042,180,418,39790862,39791042
4257,6,12,1,2412,-50,-91,41,40:e3:d6:da:ba:23,39791265,184,39,39791081,39791265
4258,6,12,1,2412,-50,-91,41,40:e3:d6:da:ba:24,39791502,176,61,39791326,39791502
4259,6,12,1,2412,-50,-91,41,40:e3:d6:da:ba:25,39791721,160,59,39791561,39791721
4260,6,6,1,2412,-50,-91,41,40:e3:d6:da:ba:26,39791931,380,-170,39791551,39791931
4261,6,6,1,2412,-50,-91,41,e6:aa:ea:c9:ea:33,39792598,408,259,39792190,39792598
4262,4,1,1,2412,-69,-91,22,54:e4:3a:ec:fb:64,39801364,2160,6606,39799204,39801364
4263,6,6,1,2412,-50,-91,41,e6:aa:ea:c9:ea:33,39804729,408,2957,39804321,39804729
4264,6,6,1,2412,-49,-91,42,e6:aa:ea:c9:ea:33,39816847,408,11710,39816439,39816847
4265,6,6,1,2412,-64,-91,27,e6:aa:ea:b7:4a:dd,39820746,408,3491,39820338,39820746
4266,6,6,1,2412,-49,-91,42,e6:aa:ea:c9:ea:33,39829189,408,8035,39828781,39829189
4267,6,6,1,2412,-63,-91,28,e6:aa:ea:b7:4a:dd,39832867,408,3270,39832459,39832867
4268,6,6,1,2412,-49,-91,42,e6:aa:ea:c9:ea:33,39841075,408,7800,39840667,39841075
4269,6,6,1,2412,-64,-91,27,e6:aa:ea:b7:4a:dd,39844982,408,3499,39844574,39844982
4270,6,6,1,2412,-59,-91,32,e6:aa:ea:b7:4a:dd,39857099,408,11709,39856691,39857099
4271,6,12,1,2412,-49,-91,42,40:e3:d6:da:ba:20,39892860,160,35601,39892700,39892860
4272,6,6,1,2412,-49,-91,42,40:e3:d6:da:ba:21,39893079,368,-149,39892711,39893079
4273,6,12,1,2412,-49,-91,42,40:e3:d6:da:ba:22,39893493,180,234,39893313,39893493
4274,6,12,1,2412,-49,-91,42,40:e3:d6:da:ba:23,39893708,184,31,39893524,39893708
4275,6,12,1,2412,-49,-91,42,40:e3:d6:da:ba:24,39893944,176,60,39893768,39893944
4276,6,12,1,2412,-49,-91,42,40:e3:d6:da:ba:25,39894164,160,60,39894004,39894164
4277,6,6,1,2412,-49,-91,42,40:e3:d6:da:ba:26,39894356,380,-188,39893976,39894356
4278,4,1,1,2412,-67,-91,24,54:e4:3a:ec:fb:64,39903741,2160,7225,39901581,39903741
4279,4,1,1,2412,-89,-91,2,,39985750,304,81705,39985446,39985750
4280,6,12,1,2412,-51,-91,40,40:e3:d6:da:ba:20,39995243,160,9333,39995083,39995243
4281,6,6,1,2412,-50,-91,41,40:e3:d6:da:ba:21,39995453,368,-158,39995085,39995453
4282,6,12,1,2412,-50,-91,41,40:e3:d6:da:ba:22,39995849,180,216,39995669,39995849
4283,6,12,1,2412,-50,-91,41,40:e3:d6:da:ba:23,39996054,184,21,39995870,39996054
4284,6,12,1,2412,-50,-91,41,40:e3:d6:da:ba:24,39996273,176,43,39996097,39996273
4285,6,12,1,2412,-50,-91,41,40:e3:d6:da:ba:25,39998846,160,2413,39998686,39998846
4286,6,6,1,2412,-51,-91,40,40:e3:d6:da:ba:26,39999047,380,-179,39998667,39999047
4287,6,12,1,2412,-86,-90,4,84:d4:7e:f2:42:20,40013164,160,13957,40013004,40013164
4288,6,6,1,2412,-87,-90,3,84:d4:7e:f2:42:21,40013365,368,-167,40012997,40013365
4289,6,12,1,2412,-86,-90,4,84:d4:7e:f2:42:22,40013752,180,207,40013572,40013752
4290,6,12,1,2412,-87,-90,3,84:d4:7e:f2:42:24,40014163,176,235,40013987,40014163
4291,6,6,1,2412,-84,-90,6,e6:aa:ea:c9:ea:1b,40077533,408,62962,40077125,40077533
4292,6,6,1,2412,-68,-90,22,e6:aa:ea:c9:ea:1b,40089671,408,11730,40089263,40089671
4293,6,12,1,2412,-54,-90,36,40:e3:d6:da:ba:20,40097649,160,7818,40097489,40097649
4294,6,6,1,2412,-54,-90,36,40:e3:d6:da:ba:21,40097859,368,-158,40097491,40097859
4295,6,12,1,2412,-54,-90,36,40:e3:d6:da:ba:22,40098246,180,207,40098066,40098246
4296,6,12,1,2412,-54,-90,36,40:e3:d6:da:ba:24,40098697,176,275,40098521,40098697
4297,6,12,1,2412,-54,-90,36,40:e3:d6:da:ba:25,40098908,160,51,40098748,40098908
4298,6,6,1,2412,-54,-90,36,40:e3:d6:da:ba:26,40099127,380,-161,40098747,40099127
4299,6,6,1,2412,-83,-90,7,e6:aa:ea:c9:ea:1b,40113869,408,14334,40113461,40113869
4300,6,12,1,2412,-86,-90,4,84:d4:7e:f2:42:20,40115553,160,1524,40115393,40115553
4301,6,6,1,2412,-67,-90,23,e6:aa:ea:b7:4a:dd,40123189,408,7228,40122781,40123189
4302,6,6,1,2412,-67,-90,23,e6:aa:ea:b7:4a:dd,40135306,408,11709,40134898,40135306
4303,6,6,1,2412,-67,-90,23,e6:aa:ea:b7:4a:dd,40147417,408,11703,40147009,40147417
4304,6,12,1,2412,-83,-90,7,40:e3:d6:de:23:a0,40193705,960,45328,40192745,40193705
4305,6,6,1,2412,-53,-90,37,40:e3:d6:da:ba:21,40200257,368,6184,40199889,40200257
4306,6,12,1,2412,-52,-90,38,40:e3:d6:da:ba:22,40200653,180,216,40200473,40200653
4307,6,12,1,2412,-52,-90,38,40:e3:d6:da:ba:23,40200886,184,49,40200702,40200886
4308,6,12,1,2412,-53,-90,37,40:e3:d6:da:ba:24,40201104,176,42,40200928,40201104
4309,6,12,1,2412,-52,-90,38,40:e3:d6:da:ba:25,40201315,160,51,40201155,40201315
4310,4,1,1,2412,-63,-90,27,54:e4:3a:ec:fb:64,40210938,2160,7463,40208778,40210938
4311,4,1,1,2412,-88,-90,2,c0:c9:e3:4d:6e:bf,40261003,872,49193,40260131,40261003
4312,6,12,1,2412,-50,-90,40,40:e3:d6:da:ba:20,40304574,160,43411,40304414,40304574
4313,6,6,1,2412,-50,-90,40,40:e3:d6:da:ba:21,40305075,368,133,40304707,40305075
4314,6,12,1,2412,-49,-90,41,40:e3:d6:da:ba:22,40305461,180,206,40305281,40305461
4315,6,12,1,2412,-49,-90,41,40:e3:d6:da:ba:23,40305676,184,31,40305492,40305676
4316,6,12,1,2412,-49,-90,41,40:e3:d6:da:ba:24,40305885,176,33,40305709,40305885
4317,6,12,1,2412,-49,-90,41,40:e3:d6:da:ba:25,40306122,160,77,40305962,40306122
4318,6,6,1,2412,-49,-90,41,40:e3:d6:da:ba:26,40306323,380,-179,40305943,40306323
4319,6,6,1,2412,-54,-90,36,e6:aa:ea:c9:ea:33,40311609,408,4878,40311201,40311609
4320,4,1,1,2412,-67,-90,23,54:e4:3a:ec:fb:64,40313337,2160,-432,40311177,40313337
4321,6,6,1,2412,-85,-90,5,84:d4:7e:f2:42:21,40322050,368,8345,40321682,40322050
4322,6,6,1,2412,-55,-90,35,e6:aa:ea:c9:ea:33,40335836,408,13378,40335428,40335836
4323,6,6,1,2412,-55,-90,35,e6:aa:ea:c9:ea:33,40360065,408,23821,40359657,40360065
4324,6,12,1,2412,-50,-90,40,40:e3:d6:da:ba:22,40405429,180,45184,40405249,40405429
4325,6,12,1,2412,-50,-90,40,40:e3:d6:da:ba:23,40405652,184,39,40405468,40405652
4326,6,12,1,2412,-50,-90,40,40:e3:d6:da:ba:24,40405871,176,43,40405695,40405871
4327,6,12,1,2412,-50,-90,40,40:e3:d6:da:ba:25,40406072,160,41,40405912,40406072
4328,6,6,1,2412,-50,-90,40,40:e3:d6:da:ba:26,40406264,380,-188,40405884,40406264
4329,6,6,1,2412,-65,-90,25,e6:aa:ea:b7:4a:dd,40438884,408,32212,40438476,40438884
4330,6,6,1,2412,-65,-90,25,e6:aa:ea:b7:4a:dd,40451009,408,11717,40450601,40451009
4331,6,6,1,2412,-64,-90,26,e6:aa:ea:b7:4a:dd,40463156,408,11739,40462748,40463156
4332,6,6,1,2412,-64,-90,26,e6:aa:ea:b7:4a:dd,40487358,408,23794,40486950,40487358
4333,6,12,1,2412,-52,-90,38,40:e3:d6:da:ba:20,40508740,160,21222,40508580,40508740
4334,6,6,1,2412,-52,-90,38,40:e3:d6:da:ba:21,40508959,368,-149,40508591,40508959
4335,6,12,1,2412,-52,-90,38,40:e3:d6:da:ba:22,40509477,180,338,40509297,40509477
4336,6,12,1,2412,-52,-90,38,40:e3:d6:da:ba:23,40509718,184,57,40509534,40509718
4337,6,12,1,2412,-52,-90,38,40:e3:d6:da:ba:24,40509946,176,52,40509770,40509946
4338,6,12,1,2412,-50,-90,40,40:e3:d6:da:ba:25,40510174,160,68,40510014,40510174
4339,6,6,1,2412,-52,-90,38,40:e3:d6:da:ba:26,40510393,380,-161,40510013,40510393
4340,6,6,1,2412,-81,-90,9,e6:aa:ea:c9:ea:1b,40521271,408,10470,40520863,40521271
4341,6,6,1,2412,-87,-90,3,84:d4:7e:f2:42:21,40525379,368,3740,40525011,40525379
4342,6,12,1,2412,-88,-90,2,84:d4:7e:f2:42:23,40525980,180,421,40525800,40525980
4343,6,12,1,2412,-87,-90,3,84:d4:7e:f2:42:24,40526194,176,38,40526018,40526194
4344,6,12,1,2412,-87,-90,3,84:d4:7e:f2:42:25,40526422,160,68,40526262,40526422
4345,6,6,1,2412,-87,-90,3,84:d4:7e:f2:42:26,40526641,380,-161,40526261,40526641
4346,6,12,1,2412,-52,-90,38,40:e3:d6:da:ba:20,40610854,160,84053,40610694,40610854
4347,6,12,1,2412,-52,-90,38,40:e3:d6:da:ba:23,40611731,184,693,40611547,40611731
4348,6,12,1,2412,-52,-90,38,40:e3:d6:da:ba:24,40611967,176,60,40611791,40611967
4349,6,12,1,2412,-52,-90,38,40:e3:d6:da:ba:25,40612187,160,60,40612027,40612187
4350,6,6,1,2412,-52,-90,38,40:e3:d6:da:ba:26,40612379,380,-188,40611999,40612379
4351,4,1,1,2412,-69,-90,21,54:e4:3a:ec:fb:64,40620535,2160,5996,40618375,40620535
4352,6,6,1,2412,-88,-90,2,84:d4:7e:f2:42:26,40629030,380,8115,40628650,40629030
4353,4,1,1,2412,-89,-90,1,a6:e5:7c:28:b1:d3,40685263,992,55241,40684271,40685263
4354,4,1,1,2412,-89,-90,1,a4:e5:7c:28:b1:d3,40711507,688,25556,40710819,40711507
4355,6,6,1,2412,-52,-90,38,40:e3:d6:da:ba:21,40712274,368,399,40711906,40712274
4356,6,12,1,2412,-52,-90,38,40:e3:d6:da:ba:22,40712670,180,216,40712490,40712670
4357,6,12,1,2412,-52,-90,38,40:e3:d6:da:ba:23,40712902,184,48,40712718,40712902
4358,6,12,1,2412,-52,-90,38,40:e3:d6:da:ba:24,40713121,176,43,40712945,40713121
4359,6,12,1,2412,-52,-90,38,40:e3:d6:da:ba:25,40713340,160,59,40713180,40713340
4360,6,6,1,2412,-52,-90,38,40:e3:d6:da:ba:26,40713541,380,-179,40713161,40713541
4361,6,6,1,2412,-55,-90,35,e6:aa:ea:c9:ea:33,40741494,408,27545,40741086,40741494
4362,6,6,1,2412,-55,-90,35,e6:aa:ea:c9:ea:33,40753614,408,11712,40753206,40753614
4363,6,6,1,2412,-55,-90,35,e6:aa:ea:c9:ea:33,40765720,408,11698,40765312,40765720
4364,6,6,1,2412,-55,-90,35,e6:aa:ea:c9:ea:33,40780150,408,14022,40779742,40780150
4365,4,1,1,2412,-89,-90,1,a6:e5:7c:28:b1:d3,40787427,992,6285,40786435,40787427
4366,6,6,1,2412,-82,-90,8,e6:aa:ea:c9:ea:1b,40801338,408,13503,40800930,40801338
4367,6,12,1,2412,-50,-90,40,40:e3:d6:da:ba:20,40814462,160,12964,40814302,40814462
4368,6,6,1,2412,-50,-90,40,40:e3:d6:da:ba:21,40814663,368,-167,40814295,40814663
4369,6,12,1,2412,-50,-90,40,40:e3:d6:da:ba:22,40815077,180,234,40814897,40815077
4370,6,12,1,2412,-50,-90,40,40:e3:d6:da:ba:23,40815301,184,40,40815117,40815301
4371,6,12,1,2412,-50,-90,40,40:e3:d6:da:ba:24,40815537,176,60,40815361,40815537
4372,6,12,1,2412,-50,-90,40,40:e3:d6:da:ba:25,40815748,160,51,40815588,40815748
4373,6,6,1,2412,-50,-90,40,40:e3:d6:da:ba:26,40815967,380,-161,40815587,40815967
4374,6,6,1,2412,-81,-90,9,e6:aa:ea:c9:ea:1b,40837655,408,21280,40837247,40837655
4375,6,6,1,2412,-68,-90,22,e6:aa:ea:b7:4a:dd,40880461,408,42398,40880053,40880461
4376,6,12,1,2412,-48,-90,42,40:e3:d6:da:ba:20,40917958,160,37337,40917798,40917958
4377,6,6,1,2412,-48,-90,42,40:e3:d6:da:ba:21,40918324,368,-2,40917956,40918324
4378,6,12,1,2412,-48,-90,42,40:e3:d6:da:ba:22,40918711,180,207,40918531,40918711
4379,6,12,1,2412,-48,-90,42,40:e3:d6:da:ba:23,40918944,184,49,40918760,40918944
4380,6,12,1,2412,-48,-90,42,40:e3:d6:da:ba:24,40919171,176,51,40918995,40919171
4381,6,12,1,2412,-48,-90,42,40:e3:d6:da:ba:25,40919391,160,60,40919231,40919391
4382,6,6,1,2412,-48,-90,42,40:e3:d6:da:ba:26,40919592,380,-179,40919212,40919592
4383,4,1,1,2412,-58,-90,32,54:e4:3a:ec:fb:64,40927732,2160,5980,40925572,40927732
4384,6,12,1,2412,-47,-90,43,40:e3:d6:da:ba:20,41019260,160,91368,41019100,41019260
4385,6,6,1,2412,-47,-90,43,40:e3:d6:da:ba:21,41019461,368,-167,41019093,41019461
4386,6,12,1,2412,-47,-90,43,40:e3:d6:da:ba:22,41019848,180,207,41019668,41019848
4387,6,12,1,2412,-47,-90,43,40:e3:d6:da:ba:23,41020053,184,21,41019869,41020053
4388,6,12,1,2412,-47,-90,43,40:e3:d6:da:ba:24,41020281,176,52,41020105,41020281
4389,6,12,1,2412,-47,-90,43,40:e3:d6:da:ba:25,41020509,160,68,41020349,41020509
4390,6,6,1,2412,-47,-90,43,40:e3:d6:da:ba:26,41020710,380,-179,41020330,41020710
4391,6,6,1,2412,-54,-90,36,e6:aa:ea:c9:ea:33,41044289,408,23171,41043881,41044289
4392,6,6,1,2412,-54,-90,36,e6:aa:ea:c9:ea:33,41056617,408,11920,41056209,41056617
4393,6,6,1,2412,-54,-90,36,e6:aa:ea:c9:ea:33,41092761,408,35736,41092353,41092761
4394,6,6,1,2412,-47,-90,43,40:e3:d6:da:ba:21,41123987,368,30858,41123619,41123987
4395,6,12,1,2412,-47,-90,43,40:e3:d6:da:ba:22,41124383,180,216,41124203,41124383
4396,6,12,1,2412,-47,-90,43,40:e3:d6:da:ba:23,41124589,184,22,41124405,41124589
4397,6,12,1,2412,-47,-90,43,40:e3:d6:da:ba:24,41124797,176,32,41124621,41124797
4398,6,12,1,2412,-47,-90,43,40:e3:d6:da:ba:25,41125000,160,43,41124840,41125000
4399,6,6,1,2412,-47,-90,43,40:e3:d6:da:ba:26,41125191,380,-189,41124811,41125191
4400,4,1,1,2412,-66,-90,24,54:e4:3a:ec:fb:64,41132531,2160,5180,41130371,41132531
4401,4,1,1,2412,-62,-90,28,24:f6:77:10:02:c8,41192281,1064,58686,41191217,41192281
4402,4,1,1,2412,-64,-90,26,24:f6:77:10:02:c8,41204515,1064,11170,41203451,41204515
4403,6,12,1,2412,-49,-90,41,40:e3:d6:da:ba:20,41224152,160,19477,41223992,41224152
4404,6,6,1,2412,-48,-90,42,40:e3:d6:da:ba:21,41224397,368,-123,41224029,41224397
4405,6,12,1,2412,-48,-90,42,40:e3:d6:da:ba:22,41224784,180,207,41224604,41224784
4406,6,12,1,2412,-48,-90,42,40:e3:d6:da:ba:23,41225007,184,39,41224823,41225007
4407,6,12,1,2412,-48,-90,42,40:e3:d6:da:ba:24,41225226,176,43,41225050,41225226
4408,6,6,1,2412,-77,-90,13,e6:aa:ea:c9:ea:1b,41232878,408,7244,41232470,41232878
4409,4,1,1,2412,-65,-90,25,54:e4:3a:ec:fb:64,41235236,2160,198,41233076,41235236
4410,4,1,1,2412,-87,-90,3,c0:c9:e3:4d:6e:bf,41250544,872,14436,41249672,41250544
4411,4,1,1,2412,-59,-90,31,24:f6:77:10:02:c8,41287864,1064,36256,41286800,41287864
4412,6,12,1,2412,-48,-90,42,40:e3:d6:da:ba:20,41326449,160,38425,41326289,41326449
4413,6,6,1,2412,-48,-90,42,40:e3:d6:da:ba:21,41326659,368,-158,41326291,41326659
4414,6,12,1,2412,-48,-90,42,40:e3:d6:da:ba:22,41327055,180,216,41326875,41327055
4415,6,12,1,2412,-48,-90,42,40:e3:d6:da:ba:23,41327279,184,40,41327095,41327279
4416,6,12,1,2412,-48,-90,42,40:e3:d6:da:ba:24,41328763,176,1308,41328587,41328763
4417,6,12,1,2412,-48,-90,42,40:e3:d6:da:ba:25,41331001,160,2078,41330841,41331001
4418,6,6,1,2412,-48,-90,42,40:e3:d6:da:ba:26,41335449,380,4068,41335069,41335449
4419,4,1,1,2412,-88,-90,2,a6:e5:7c:28:b1:d3,41346088,944,9695,41345144,41346088
4420,4,1,1,2412,-89,-90,1,a6:e5:7c:28:b1:d3,41348235,944,1203,41347291,41348235
4421,4,1,1,2412,-88,-90,2,a6:e5:7c:28:b1:d3,41350391,944,1212,41349447,41350391
4422,4,1,1,2412,-69,-90,21,a6:e5:7c:28:b1:d3,41352618,944,1283,41351674,41352618
4423,6,6,1,2412,-61,-90,29,e6:aa:ea:b7:4a:dd,41412234,408,59208,41411826,41412234
4424,6,6,1,2412,-61,-90,29,e6:aa:ea:b7:4a:dd,41424355,408,11713,41423947,41424355
4425,6,6,1,2412,-48,-90,42,40:e3:d6:da:ba:21,41429184,368,4461,41428816,41429184
4426,6,12,1,2412,-48,-90,42,40:e3:d6:da:ba:22,41429620,180,256,41429440,41429620
4427,6,12,1,2412,-48,-90,42,40:e3:d6:da:ba:25,41430429,160,649,41430269,41430429
4428,6,6,1,2412,-89,-90,1,84:d4:7e:f2:42:21,41446964,368,16167,41446596,41446964
4429,6,12,1,2412,-51,-90,39,40:e3:d6:da:ba:20,41532201,160,85077,41532041,41532201
4430,6,12,1,2412,-51,-90,39,40:e3:d6:da:ba:22,41534237,180,1856,41534057,41534237
4431,6,12,1,2412,-51,-90,39,40:e3:d6:da:ba:23,41535260,184,839,41535076,41535260
4432,6,12,1,2412,-51,-90,39,40:e3:d6:da:ba:24,41537727,176,2291,41537551,41537727
4433,6,12,1,2412,-51,-90,39,40:e3:d6:da:ba:25,41537956,160,69,41537796,41537956
4434,6,6,1,2412,-51,-90,39,40:e3:d6:da:ba:26,41538175,380,-161,41537795,41538175
4435,4,1,1,2412,-85,-90,5,b8:3a:5a:88:e6:e0,41542642,2360,2107,41540282,41542642
4436,6,6,1,2412,-52,-90,38,e6:aa:ea:c9:ea:33,41563847,408,20797,41563439,41563847
4437,6,6,1,2412,-51,-90,39,e6:aa:ea:c9:ea:33,41575991,408,11736,41575583,41575991
4438,6,6,1,2412,-51,-90,39,e6:aa:ea:c9:ea:33,41588047,408,11648,41587639,41588047
4439,6,6,1,2412,-51,-90,39,e6:aa:ea:c9:ea:33,41600152,408,11697,41599744,41600152
4440,6,6,1,2412,-51,-90,39,e6:aa:ea:c9:ea:33,41612268,408,11708,41611860,41612268
4441,6,12,1,2412,-51,-90,39,40:e3:d6:da:ba:22,41635285,180,22837,41635105,41635285
4442,6,12,1,2412,-51,-90,39,40:e3:d6:da:ba:23,41635517,184,48,41635333,41635517
4443,6,12,1,2412,-47,-90,43,40:e3:d6:da:ba:25,41637018,160,1341,41636858,41637018
4444,4,1,1,2412,-56,-90,34,54:e4:3a:ec:fb:64,41644730,2160,5552,41642570,41644730
4445,6,12,1,2412,-87,-90,3,84:d4:7e:f2:42:23,41652709,180,7799,41652529,41652709
4446,6,6,1,2412,-88,-90,2,84:d4:7e:f2:42:26,41653334,380,245,41652954,41653334
4447,4,1,1,2412,-92,-90,-2,a6:e5:7c:28:b1:d3,41723427,944,69149,41722483,41723427
4448,6,12,1,2412,-50,-90,40,40:e3:d6:da:ba:20,41736057,160,12470,41735897,41736057
4449,6,6,1,2412,-50,-90,40,40:e3:d6:da:ba:21,41736266,368,-159,41735898,41736266
4450,6,12,1,2412,-50,-90,40,40:e3:d6:da:ba:22,41736662,180,216,41736482,41736662
4451,6,12,1,2412,-50,-90,40,40:e3:d6:da:ba:23,41736868,184,22,41736684,41736868
4452,6,12,1,2412,-50,-90,40,40:e3:d6:da:ba:24,41737086,176,42,41736910,41737086
4453,6,12,1,2412,-50,-90,40,40:e3:d6:da:ba:25,41737306,160,60,41737146,41737306
4454,6,6,1,2412,-50,-90,40,40:e3:d6:da:ba:26,41737498,380,-188,41737118,41737498
4455,6,6,1,2412,-61,-90,29,e6:aa:ea:b7:4a:dd,41739526,408,1620,41739118,41739526
4456,6,6,1,2412,-80,-90,10,e6:aa:ea:c9:ea:1b,41742424,408,2490,41742016,41742424
4457,4,1,1,2412,-89,-90,1,c0:c9:e3:4d:6e:bf,41744805,872,1509,41743933,41744805
4458,6,12,1,2412,-88,-90,2,84:d4:7e:f2:42:20,41754002,160,9037,41753842,41754002
4459,6,6,1,2412,-78,-90,12,e6:aa:ea:c9:ea:1b,41754692,408,282,41754284,41754692
4460,6,6,1,2412,-81,-90,9,e6:aa:ea:c9:ea:1b,41778718,408,23618,41778310,41778718
4461,6,6,1,2412,-80,-90,10,e6:aa:ea:c9:ea:1b,41790843,408,11717,41790435,41790843
4462,6,12,1,2412,-51,-90,39,40:e3:d6:da:ba:20,41838459,160,47456,41838299,41838459
4463,6,6,1,2412,-51,-90,39,40:e3:d6:da:ba:21,41838661,368,-166,41838293,41838661
4464,6,12,1,2412,-50,-90,40,40:e3:d6:da:ba:22,41839090,180,249,41838910,41839090
4465,6,12,1,2412,-51,-90,39,40:e3:d6:da:ba:24,41839557,176,291,41839381,41839557
4466,6,12,1,2412,-51,-90,39,40:e3:d6:da:ba:25,41839786,160,69,41839626,41839786
4467,6,6,1,2412,-51,-90,39,40:e3:d6:da:ba:26,41839987,380,-179,41839607,41839987
4468,6,12,1,2412,-87,-90,3,84:d4:7e:f2:42:23,41857318,180,17151,41857138,41857318
4469,6,12,1,2412,-52,-90,38,40:e3:d6:da:ba:20,41941459,160,83981,41941299,41941459
4470,6,6,1,2412,-52,-90,38,40:e3:d6:da:ba:21,41941669,368,-158,41941301,41941669
4471,6,12,1,2412,-52,-90,38,40:e3:d6:da:ba:22,41942083,180,234,41941903,41942083
4472,6,12,1,2412,-52,-90,38,40:e3:d6:da:ba:23,41942288,184,21,41942104,41942288
4473,6,12,1,2412,-52,-90,38,40:e3:d6:da:ba:24,41942507,176,43,41942331,41942507
4474,6,12,1,2412,-52,-90,38,40:e3:d6:da:ba:25,41942717,160,50,41942557,41942717
4475,4,1,1,2412,-64,-90,26,54:e4:3a:ec:fb:64,41951723,2160,6846,41949563,41951723
4476,6,12,1,2412,-87,-90,3,84:d4:7e:f2:42:20,41958801,160,6918,41958641,41958801
4477,6,12,1,2412,-53,-91,38,40:e3:d6:da:ba:20,42043653,160,84692,42043493,42043653
4478,6,6,1,2412,-53,-91,38,40:e3:d6:da:ba:21,42043845,368,-176,42043477,42043845
4479,6,12,1,2412,-54,-91,37,40:e3:d6:da:ba:22,42046306,180,2281,42046126,42046306
4480,6,12,1,2412,-53,-91,38,40:e3:d6:da:ba:23,42046512,184,22,42046328,42046512
4481,6,12,1,2412,-54,-91,37,40:e3:d6:da:ba:24,42046740,176,52,42046564,42046740
4482,6,12,1,2412,-53,-91,38,40:e3:d6:da:ba:25,42046956,160,56,42046796,42046956
4483,6,6,1,2412,-54,-91,37,40:e3:d6:da:ba:26,42047188,380,-148,42046808,42047188
4484,4,1,1,2412,-65,-91,26,54:e4:3a:ec:fb:64,42054124,2160,4776,42051964,42054124
4485,6,6,1,2412,-54,-91,37,e6:aa:ea:c9:ea:33,42083342,408,28810,42082934,42083342
4486,6,6,1,2412,-54,-91,37,e6:aa:ea:c9:ea:33,42095461,408,11711,42095053,42095461
4487,4,1,1,2412,-89,-91,2,a6:e5:7c:28:b1:d3,42099037,944,2632,42098093,42099037
4488,4,1,1,2412,-90,-91,1,a6:e5:7c:28:b1:d3,42101148,944,1167,42100204,42101148
4489,4,1,1,2412,-83,-91,8,a6:e5:7c:28:b1:d3,42102315,944,223,42101371,42102315
4490,4,1,1,2412,-85,-91,6,a6:e5:7c:28:b1:d3,42103384,944,125,42102440,42103384
4491,4,1,1,2412,-89,-91,2,a6:e5:7c:28:b1:d3,42104489,944,161,42103545,42104489
4492,4,1,1,2412,-90,-91,1,a6:e5:7c:28:b1:d3,42105585,944,152,42104641,42105585
4493,6,6,1,2412,-54,-91,37,e6:aa:ea:c9:ea:33,42107581,408,1588,42107173,42107581
4494,6,6,1,2412,-64,-91,27,e6:aa:ea:b7:4a:dd,42108974,408,985,42108566,42108974
4495,6,6,1,2412,-54,-91,37,e6:aa:ea:c9:ea:33,42119688,408,10306,42119280,42119688
4496,6,6,1,2412,-54,-91,37,e6:aa:ea:c9:ea:33,42131817,408,11721,42131409,42131817
4497,6,12,1,2412,-55,-91,36,40:e3:d6:da:ba:20,42145753,160,13776,42145593,42145753
4498,6,6,1,2412,-55,-91,36,40:e3:d6:da:ba:21,42145972,368,-149,42145604,42145972
4499,6,12,1,2412,-55,-91,36,40:e3:d6:da:ba:22,42147974,180,1822,42147794,42147974
4500,6,12,1,2412,-55,-91,36,40:e3:d6:da:ba:23,42148343,184,185,42148159,42148343
4501,6,12,1,2412,-55,-91,36,40:e3:d6:da:ba:24,42148561,176,42,42148385,42148561
4502,6,12,1,2412,-55,-91,36,40:e3:d6:da:ba:25,42148781,160,60,42148621,42148781
4503,6,6,1,2412,-54,-91,37,40:e3:d6:da:ba:26,42148991,380,-170,42148611,42148991
4504,4,1,1,2412,-67,-91,24,54:e4:3a:ec:fb:64,42156522,2160,5371,42154362,42156522
4505,6,6,1,2412,-80,-91,11,e6:aa:ea:c9:ea:1b,42197840,408,40910,42197432,42197840
4506,4,1,1,2412,-67,-91,24,54:e4:3a:ec:fb:64,42242348,2112,42396,42240236,42242348
4507,4,1,1,2412,-66,-91,25,54:e4:3a:ec:fb:64,42245033,2112,573,42242921,42245033
4508,4,1,1,2412,-67,-91,24,54:e4:3a:ec:fb:64,42248086,2112,941,42245974,42248086
4509,6,12,1,2412,-53,-91,38,40:e3:d6:da:ba:23,42251261,184,2991,42251077,42251261
4510,6,12,1,2412,-53,-91,38,40:e3:d6:da:ba:24,42251470,176,33,42251294,42251470
4511,6,12,1,2412,-53,-91,38,40:e3:d6:da:ba:25,42251689,160,59,42251529,42251689
4512,4,1,1,2412,-66,-91,25,54:e4:3a:ec:fb:64,42258921,2160,5072,42256761,42258921
4513,6,12,1,2412,-49,-91,42,40:e3:d6:da:ba:20,42350454,160,91373,42350294,42350454
4514,6,6,1,2412,-48,-91,43,40:e3:d6:da:ba:21,42350645,368,-177,42350277,42350645
4515,6,12,1,2412,-50,-91,41,40:e3:d6:da:ba:22,42351032,180,207,42350852,42351032
4516,6,12,1,2412,-49,-91,42,40:e3:d6:da:ba:23,42351238,184,22,42351054,42351238
4517,6,12,1,2412,-48,-91,43,40:e3:d6:da:ba:24,42351481,176,67,42351305,42351481
4518,6,12,1,2412,-48,-91,43,40:e3:d6:da:ba:25,42351692,160,51,42351532,42351692
4519,6,6,1,2412,-53,-91,38,40:e3:d6:da:ba:26,42351911,380,-161,42351531,42351911
4520,4,1,1,2412,-61,-91,30,54:e4:3a:ec:fb:64,42361337,2160,7266,42359177,42361337
4521,6,6,1,2412,-61,-91,30,e6:aa:ea:b7:4a:dd,42423652,408,61907,42423244,42423652
4522,6,6,1,2412,-61,-91,30,e6:aa:ea:b7:4a:dd,42435764,408,11704,42435356,42435764
4523,6,6,1,2412,-61,-91,30,e6:aa:ea:b7:4a:dd,42447880,408,11708,42447472,42447880
4524,6,12,1,2412,-50,-91,41,40:e3:d6:da:ba:20,42453987,160,5947,42453827,42453987
4525,6,6,1,2412,-50,-91,41,40:e3:d6:da:ba:21,42454188,368,-167,42453820,42454188
4526,6,12,1,2412,-49,-91,42,40:e3:d6:da:ba:22,42454590,180,222,42454410,42454590
4527,6,12,1,2412,-50,-91,41,40:e3:d6:da:ba:23,42454804,184,30,42454620,42454804
4528,6,12,1,2412,-50,-91,41,40:e3:d6:da:ba:24,42455023,176,43,42454847,42455023
4529,6,12,1,2412,-50,-91,41,40:e3:d6:da:ba:25,42455233,160,50,42455073,42455233
4530,6,6,1,2412,-50,-91,41,40:e3:d6:da:ba:26,42455434,380,-179,42455054,42455434
4531,6,6,1,2412,-61,-91,30,e6:aa:ea:b7:4a:dd,42460001,408,4159,42459593,42460001
4532,4,1,1,2412,-65,-91,26,54:e4:3a:ec:fb:64,42463720,2160,1559,42461560,42463720
4533,6,12,1,2412,-50,-91,41,40:e3:d6:da:ba:20,42555255,160,91375,42555095,42555255
4534,6,6,1,2412,-50,-91,41,40:e3:d6:da:ba:21,42555465,368,-158,42555097,42555465
4535,6,12,1,2412,-50,-91,41,40:e3:d6:da:ba:22,42555861,180,216,42555681,42555861
4536,6,12,1,2412,-49,-91,42,40:e3:d6:da:ba:23,42556139,184,94,42555955,42556139
4537,6,12,1,2412,-50,-91,41,40:e3:d6:da:ba:24,42556366,176,51,42556190,42556366
4538,6,12,1,2412,-50,-91,41,40:e3:d6:da:ba:25,42556595,160,69,42556435,42556595
4539,6,6,1,2412,-50,-91,41,40:e3:d6:da:ba:26,42556786,380,-189,42556406,42556786
4540,4,1,1,2412,-63,-91,28,54:e4:3a:ec:fb:64,42566118,2160,7172,42563958,42566118
4541,6,6,1,2412,-83,-91,8,e6:aa:ea:c9:ea:1b,42592766,408,26240,42592358,42592766
4542,6,6,1,2412,-50,-91,41,e6:aa:ea:c9:ea:33,42602409,408,9235,42602001,42602409
4543,6,6,1,2412,-83,-91,8,e6:aa:ea:c9:ea:1b,42604891,408,2074,42604483,42604891
4544,6,6,1,2412,-49,-91,42,e6:aa:ea:c9:ea:33,42614543,408,9244,42614135,42614543
4545,6,6,1,2412,-82,-91,9,e6:aa:ea:c9:ea:1b,42617004,408,2053,42616596,42617004
4546,6,6,1,2412,-49,-91,42,e6:aa:ea:c9:ea:33,42638779,408,21367,42638371,42638779
4547,6,6,1,2412,-49,-91,42,e6:aa:ea:c9:ea:33,42650900,408,11713,42650492,42650900
4548,6,12,1,2412,-51,-91,40,40:e3:d6:da:ba:20,42657658,160,6598,42657498,42657658
4549,6,6,1,2412,-51,-91,40,40:e3:d6:da:ba:21,42657893,368,-133,42657525,42657893
4550,6,12,1,2412,-52,-91,39,40:e3:d6:da:ba:22,42658314,180,241,42658134,42658314
4551,6,12,1,2412,-52,-91,39,40:e3:d6:da:ba:23,42658519,184,21,42658335,42658519
4552,6,12,1,2412,-52,-91,39,40:e3:d6:da:ba:24,42658756,176,61,42658580,42658756
4553,6,12,1,2412,-52,-91,39,40:e3:d6:da:ba:25,42658957,160,41,42658797,42658957
4554,6,12,1,2412,-54,-91,37,40:e3:d6:da:ba:20,42760074,160,100957,42759914,42760074
4555,6,6,1,2412,-54,-91,37,40:e3:d6:da:ba:21,42760275,368,-167,42759907,42760275
4556,6,12,1,2412,-54,-91,37,40:e3:d6:da:ba:22,42760671,180,216,42760491,42760671
4557,6,12,1,2412,-53,-91,38,40:e3:d6:da:ba:23,42760903,184,48,42760719,42760903
4558,6,12,1,2412,-54,-91,37,40:e3:d6:da:ba:24,42761159,176,80,42760983,42761159
4559,6,12,1,2412,-53,-91,38,40:e3:d6:da:ba:25,42761360,160,41,42761200,42761360
4560,6,6,1,2412,-54,-91,37,40:e3:d6:da:ba:26,42761957,380,217,42761577,42761957
4561,6,12,1,2412,-53,-91,38,40:e3:d6:da:ba:20,42862540,160,100423,42862380,42862540
4562,6,6,1,2412,-53,-91,38,40:e3:d6:da:ba:21,42865320,368,2412,42864952,42865320
4563,6,12,1,2412,-53,-91,38,40:e3:d6:da:ba:22,42865716,180,216,42865536,42865716
4564,6,12,1,2412,-53,-91,38,40:e3:d6:da:ba:24,42866190,176,298,42866014,42866190
4565,6,12,1,2412,-53,-91,38,40:e3:d6:da:ba:25,42866400,160,50,42866240,42866400
4566,6,6,1,2412,-53,-91,38,40:e3:d6:da:ba:26,42866619,380,-161,42866239,42866619
4567,6,6,1,2412,-57,-91,34,e6:aa:ea:c9:ea:33,42917079,408,50052,42916671,42917079
4568,4,1,1,2412,-69,-91,22,a6:e5:7c:28:b1:d3,42938474,992,20403,42937482,42938474
4569,6,6,1,2412,-62,-91,29,e6:aa:ea:b7:4a:dd,42943075,408,4193,42942667,42943075
4570,6,6,1,2412,-58,-91,33,e6:aa:ea:c9:ea:33,42953437,408,9954,42953029,42953437
4571,6,6,1,2412,-63,-91,28,e6:aa:ea:b7:4a:dd,42955232,408,1387,42954824,42955232
4572,6,12,1,2412,-52,-91,39,40:e3:d6:da:ba:20,42964858,160,9466,42964698,42964858
4573,6,6,1,2412,-52,-91,39,40:e3:d6:da:ba:21,42965049,368,-177,42964681,42965049
4574,6,12,1,2412,-52,-91,39,40:e3:d6:da:ba:22,42966460,180,1231,42966280,42966460
4575,6,12,1,2412,-52,-91,39,40:e3:d6:da:ba:23,42966693,184,49,42966509,42966693
4576,6,12,1,2412,-51,-91,40,40:e3:d6:da:ba:24,42966978,176,109,42966802,42966978
4577,6,12,1,2412,-51,-91,40,40:e3:d6:da:ba:25,42967213,160,75,42967053,42967213
4578,6,6,1,2412,-52,-91,39,40:e3:d6:da:ba:26,42967432,380,-161,42967052,42967432
4579,6,6,1,2412,-65,-91,26,e6:aa:ea:b7:4a:dd,42968200,408,360,42967792,42968200
4580,4,1,1,2412,-69,-91,22,54:e4:3a:ec:fb:64,42975716,2160,5356,42973556,42975716
4581,6,6,1,2412,-66,-91,25,e6:aa:ea:b7:4a:dd,42979416,408,3292,42979008,42979416
4582,6,6,1,2412,-79,-91,12,e6:aa:ea:c9:ea:1b,43000163,408,20339,42999755,43000163
4583,4,1,1,2412,-82,-91,9,a4:e5:7c:28:b1:d3,43010949,688,10098,43010261,43010949
4584,6,6,1,2412,-80,-91,11,e6:aa:ea:c9:ea:1b,43048609,408,37252,43048201,43048609
4585,6,12,1,2412,-50,-91,41,40:e3:d6:da:ba:20,43067266,160,18497,43067106,43067266
4586,6,6,1,2412,-50,-91,41,40:e3:d6:da:ba:21,43067458,368,-176,43067090,43067458
4587,6,12,1,2412,-50,-91,41,40:e3:d6:da:ba:22,43067854,180,216,43067674,43067854
4588,6,12,1,2412,-50,-91,41,40:e3:d6:da:ba:23,43068069,184,31,43067885,43068069
4589,6,12,1,2412,-50,-91,41,40:e3:d6:da:ba:24,43068278,176,33,43068102,43068278
4590,6,12,1,2412,-50,-91,41,40:e3:d6:da:ba:25,43068479,160,41,43068319,43068479
4591,6,6,1,2412,-50,-91,41,40:e3:d6:da:ba:26,43068680,380,-179,43068300,43068680
4592,4,1,1,2412,-65,-91,26,54:e4:3a:ec:fb:64,43078115,2160,7275,43075955,43078115
4593,4,1,1,2412,-77,-91,14,a6:e5:7c:28:b1:d3,43163456,944,84397,43162512,43163456
4594,4,1,1,2412,-88,-91,3,,43169380,304,5620,43169076,43169380
4595,6,12,1,2412,-52,-91,39,40:e3:d6:da:ba:20,43169678,160,138,43169518,43169678
4596,6,6,1,2412,-52,-91,39,40:e3:d6:da:ba:21,43169870,368,-176,43169502,43169870
4597,6,12,1,2412,-51,-91,40,40:e3:d6:da:ba:22,43170266,180,216,43170086,43170266
4598,6,12,1,2412,-51,-91,40,40:e3:d6:da:ba:23,43170571,184,121,43170387,43170571
4599,6,12,1,2412,-51,-91,40,40:e3:d6:da:ba:24,43171325,176,578,43171149,43171325
4600,6,12,1,2412,-52,-91,39,40:e3:d6:da:ba:25,43171536,160,51,43171376,43171536
4601,6,6,1,2412,-51,-91,40,40:e3:d6:da:ba:26,43171755,380,-161,43171375,43171755
4602,4,1,1,2412,-63,-91,28,54:e4:3a:ec:fb:64,43180709,2160,6794,43178549,43180709
4603,4,1,1,2412,-63,-91,28,a6:e5:7c:28:b1:d3,43262823,944,81170,43261879,43262823
4604,4,1,1,2412,-84,-91,7,a6:e5:7c:28:b1:d3,43264022,944,255,43263078,43264022
4605,4,1,1,2412,-86,-91,5,a6:e5:7c:28:b1:d3,43265080,944,114,43264136,43265080
4606,6,12,1,2412,-53,-91,38,40:e3:d6:da:ba:20,43272645,160,7405,43272485,43272645
4607,6,6,1,2412,-53,-91,38,40:e3:d6:da:ba:21,43272837,368,-176,43272469,43272837
4608,6,12,1,2412,-52,-91,39,40:e3:d6:da:ba:22,43273224,180,207,43273044,43273224
4609,6,12,1,2412,-52,-91,39,40:e3:d6:da:ba:23,43273438,184,30,43273254,43273438
4610,6,12,1,2412,-52,-91,39,40:e3:d6:da:ba:24,43273657,176,43,43273481,43273657
4611,6,12,1,2412,-52,-91,39,40:e3:d6:da:ba:25,43273876,160,59,43273716,43273876
4612,6,6,1,2412,-53,-91,38,40:e3:d6:da:ba:26,43276410,380,2154,43276030,43276410
4613,4,1,1,2412,-63,-91,28,54:e4:3a:ec:fb:64,43282931,2160,4361,43280771,43282931
4614,6,6,1,2412,-50,-91,41,e6:aa:ea:c9:ea:33,43336373,408,53034,43335965,43336373
4615,6,6,1,2412,-50,-91,41,e6:aa:ea:c9:ea:33,43350059,408,13278,43349651,43350059
4616,6,6,1,2412,-50,-91,41,e6:aa:ea:c9:ea:33,43360596,408,10129,43360188,43360596
4617,6,6,1,2412,-50,-91,41,e6:aa:ea:c9:ea:33,43372724,408,11720,43372316,43372724
4618,6,12,1,2412,-52,-91,39,40:e3:d6:da:ba:20,43374485,160,1601,43374325,43374485
4619,6,6,1,2412,-52,-91,39,40:e3:d6:da:ba:21,43374810,368,-43,43374442,43374810
4620,6,12,1,2412,-52,-91,39,40:e3:d6:da:ba:22,43375197,180,207,43375017,43375197
4621,6,12,1,2412,-52,-91,39,40:e3:d6:da:ba:23,43375411,184,30,43375227,43375411
4622,6,12,1,2412,-52,-91,39,40:e3:d6:da:ba:24,43375621,176,34,43375445,43375621
4623,6,12,1,2412,-52,-91,39,40:e3:d6:da:ba:25,43375840,160,59,43375680,43375840
4624,6,6,1,2412,-52,-91,39,40:e3:d6:da:ba:26,43376041,380,-179,43375661,43376041
4625,6,6,1,2412,-50,-91,41,e6:aa:ea:c9:ea:33,43384846,408,8397,43384438,43384846
4626,4,1,1,2412,-59,-91,32,54:e4:3a:ec:fb:64,43385444,2160,-1562,43383284,43385444
4627,6,12,1,2412,-66,-91,25,84:d4:7e:d5:12:c0,43403794,960,17390,43402834,43403794
4628,6,12,1,2412,-50,-91,41,40:e3:d6:da:ba:20,43477735,160,73781,43477575,43477735
4629,6,6,1,2412,-50,-91,41,40:e3:d6:da:ba:21,43477936,368,-167,43477568,43477936
4630,6,12,1,2412,-50,-91,41,40:e3:d6:da:ba:22,43478381,180,265,43478201,43478381
4631,6,12,1,2412,-50,-91,41,40:e3:d6:da:ba:23,43478605,184,40,43478421,43478605
4632,6,12,1,2412,-50,-91,41,40:e3:d6:da:ba:24,43478841,176,60,43478665,43478841
4633,6,6,1,2412,-50,-91,41,40:e3:d6:da:ba:26,43481531,380,2310,43481151,43481531
4634,6,6,1,2412,-65,-91,26,e6:aa:ea:b7:4a:dd,43486355,408,4416,43485947,43486355
4635,6,6,1,2412,-65,-91,26,e6:aa:ea:b7:4a:dd,43498353,408,11590,43497945,43498353
4636,6,6,1,2412,-64,-91,27,e6:aa:ea:b7:4a:dd,43510563,408,11802,43510155,43510563
4637,6,6,1,2412,-83,-91,8,e6:aa:ea:c9:ea:1b,43534372,408,23401,43533964,43534372
4638,6,6,1,2412,-82,-91,9,e6:aa:ea:c9:ea:1b,43546486,408,11706,43546078,43546486
4639,6,6,1,2412,-82,-91,9,e6:aa:ea:c9:ea:1b,43558597,408,11703,43558189,43558597
4640,6,6,1,2412,-81,-91,10,e6:aa:ea:c9:ea:1b,43570707,408,11702,43570299,43570707
4641,6,12,1,2412,-52,-91,39,40:e3:d6:da:ba:20,43579387,160,8520,43579227,43579387
4642,6,6,1,2412,-52,-91,39,40:e3:d6:da:ba:21,43579597,368,-158,43579229,43579597
4643,6,12,1,2412,-52,-91,39,40:e3:d6:da:ba:22,43580011,180,234,43579831,43580011
4644,6,12,1,2412,-53,-91,38,40:e3:d6:da:ba:23,43582497,184,2302,43582313,43582497
4645,6,12,1,2412,-52,-91,39,40:e3:d6:da:ba:24,43582716,176,43,43582540,43582716
4646,6,12,1,2412,-52,-91,39,40:e3:d6:da:ba:25,43582917,160,41,43582757,43582917
4647,6,6,1,2412,-52,-91,39,40:e3:d6:da:ba:26,43583231,380,-66,43582851,43583231
4648,6,12,1,2412,-87,-91,4,84:d4:7e:f2:42:20,43597162,160,13771,43597002,43597162
4649,6,6,1,2412,-54,-91,37,e6:aa:ea:c9:ea:33,43663071,408,65501,43662663,43663071
4650,6,12,1,2412,-53,-91,38,40:e3:d6:da:ba:20,43681671,160,18440,43681511,43681671
4651,6,6,1,2412,-53,-91,38,40:e3:d6:da:ba:21,43681863,368,-176,43681495,43681863
4652,6,12,1,2412,-53,-91,38,40:e3:d6:da:ba:22,43682380,180,337,43682200,43682380
4653,6,12,1,2412,-53,-91,38,40:e3:d6:da:ba:23,43682595,184,31,43682411,43682595
4654,6,12,1,2412,-53,-91,38,40:e3:d6:da:ba:24,43682822,176,51,43682646,43682822
4655,6,12,1,2412,-53,-91,38,40:e3:d6:da:ba:25,43683073,160,91,43682913,43683073
4656,6,6,1,2412,-53,-91,38,40:e3:d6:da:ba:26,43683265,380,-188,43682885,43683265
4657,6,6,1,2412,-54,-91,37,e6:aa:ea:c9:ea:33,43687296,408,3623,43686888,43687296
4658,4,1,1,2412,-61,-91,30,54:e4:3a:ec:fb:64,43692510,2160,3054,43690350,43692510
4659,6,6,1,2412,-86,-91,5,84:d4:7e:f2:42:21,43699870,368,6992,43699502,43699870
4660,6,12,1,2412,-53,-91,38,40:e3:d6:da:ba:20,43784075,160,84045,43783915,43784075
4661,6,6,1,2412,-52,-91,39,40:e3:d6:da:ba:21,43784293,368,-150,43783925,43784293
4662,6,12,1,2412,-52,-91,39,40:e3:d6:da:ba:22,43784713,180,240,43784533,43784713
4663,6,12,1,2412,-52,-91,39,40:e3:d6:da:ba:23,43784946,184,49,43784762,43784946
4664,6,12,1,2412,-52,-91,39,40:e3:d6:da:ba:24,43785164,176,42,43784988,43785164
4665,6,12,1,2412,-52,-91,39,40:e3:d6:da:ba:25,43785366,160,42,43785206,43785366
4666,6,6,1,2412,-52,-91,39,40:e3:d6:da:ba:26,43785567,380,-179,43785187,43785567
4667,6,6,1,2412,-81,-91,10,e6:aa:ea:c9:ea:1b,43864490,408,78515,43864082,43864490
4668,6,6,1,2412,-81,-91,10,e6:aa:ea:c9:ea:1b,43876706,408,11808,43876298,43876706
4669,6,12,1,2412,-55,-91,36,40:e3:d6:da:ba:20,43886466,160,9600,43886306,43886466
4670,6,6,1,2412,-55,-91,36,40:e3:d6:da:ba:21,43886676,368,-158,43886308,43886676
4671,6,12,1,2412,-55,-91,36,40:e3:d6:da:ba:22,43887090,180,234,43886910,43887090
4672,6,12,1,2412,-55,-91,36,40:e3:d6:da:ba:23,43887295,184,21,43887111,43887295
4673,6,12,1,2412,-54,-91,37,40:e3:d6:da:ba:24,43887513,176,42,43887337,43887513
4674,6,12,1,2412,-55,-91,36,40:e3:d6:da:ba:25,43887724,160,51,43887564,43887724
4675,6,6,1,2412,-55,-91,36,40:e3:d6:da:ba:26,43887916,380,-188,43887536,43887916
4676,4,1,1,2412,-56,-91,35,54:e4:3a:ec:fb:64,43897307,2160,7231,43895147,43897307
4677,6,6,1,2412,-53,-91,38,e6:aa:ea:c9:ea:33,43967425,408,69710,43967017,43967425
4678,6,6,1,2412,-53,-91,38,e6:aa:ea:c9:ea:33,43979696,408,11863,43979288,43979696
4679,6,12,1,2412,-54,-91,37,40:e3:d6:da:ba:20,43988864,160,9008,43988704,43988864
4680,6,6,1,2412,-54,-91,37,40:e3:d6:da:ba:21,43989194,368,-38,43988826,43989194
4681,6,12,1,2412,-54,-91,37,40:e3:d6:da:ba:22,43989581,180,207,43989401,43989581
4682,6,12,1,2412,-54,-91,37,40:e3:d6:da:ba:23,43989802,184,37,43989618,43989802
4683,6,12,1,2412,-53,-91,38,40:e3:d6:da:ba:24,43990011,176,33,43989835,43990011
4684,6,12,1,2412,-54,-91,37,40:e3:d6:da:ba:25,43990230,160,59,43990070,43990230
4685,6,6,1,2412,-54,-91,37,40:e3:d6:da:ba:26,43990431,380,-179,43990051,43990431
4686,6,6,1,2412,-64,-91,27,e6:aa:ea:b7:4a:dd,43994452,408,3613,43994044,43994452
4687,4,1,1,2412,-62,-91,29,54:e4:3a:ec:fb:64,43999707,2160,3095,43997547,43999707
4688,6,6,1,2412,-53,-91,38,e6:aa:ea:c9:ea:33,44003777,408,3662,44003369,44003777
4689,6,6,1,2412,-65,-91,26,e6:aa:ea:b7:4a:dd,44006569,408,2384,44006161,44006569
4690,6,6,1,2412,-47,-90,43,,44010076,44,3463,44010032,44010076
4691,6,6,1,2412,-53,-90,37,e6:aa:ea:c9:ea:33,44015894,408,5410,44015486,44015894
4692,6,6,1,2412,-65,-90,25,e6:aa:ea:b7:4a:dd,44018678,408,2376,44018270,44018678
4693,6,6,1,2412,-64,-90,26,e6:aa:ea:b7:4a:dd,44030799,408,11713,44030391,44030799
4694,6,6,1,2412,-47,-90,43,,44035075,44,4232,44035031,44035075
4695,6,6,1,2412,-46,-90,44,,44036363,44,1244,44036319,44036363
4696,6,6,1,2412,-46,-90,44,,44085077,44,48670,44085033,44085077
4697,6,12,1,2412,-53,-90,37,40:e3:d6:da:ba:20,44091277,160,6040,44091117,44091277
4698,6,6,1,2412,-53,-90,37,40:e3:d6:da:ba:21,44091478,368,-167,44091110,44091478
4699,6,12,1,2412,-53,-90,37,40:e3:d6:da:ba:22,44091874,180,216,44091694,44091874
4700,6,12,1,2412,-53,-90,37,40:e3:d6:da:ba:23,44092325,184,267,44092141,44092325
4701,6,12,1,2412,-53,-90,37,40:e3:d6:da:ba:24,44092552,176,51,44092376,44092552
4702,6,12,1,2412,-53,-90,37,40:e3:d6:da:ba:25,44092753,160,41,44092593,44092753
4703,6,6,1,2412,-53,-90,37,40:e3:d6:da:ba:26,44092945,380,-188,44092565,44092945
4704,4,1,1,2412,-64,-90,26,54:e4:3a:ec:fb:64,44102106,2160,7001,44099946,44102106
4705,6,6,1,2412,-45,-90,45,,44110076,44,7926,44110032,44110076
4706,6,6,1,2412,-45,-90,45,,44116461,44,6341,44116417,44116461
4707,6,6,1,2412,-45,-90,45,,44117646,44,1141,44117602,44117646
4708,6,6,1,2412,-81,-90,9,e6:aa:ea:c9:ea:1b,44157093,408,39039,44156685,44157093
4709,6,6,1,2412,-81,-90,9,e6:aa:ea:c9:ea:1b,44169213,408,11712,44168805,44169213
4710,6,6,1,2412,-81,-90,9,e6:aa:ea:c9:ea:1b,44181326,408,11705,44180918,44181326
4711,6,12,1,2412,-53,-90,37,40:e3:d6:da:ba:20,44193663,160,12177,44193503,44193663
4712,6,6,1,2412,-53,-90,37,40:e3:d6:da:ba:21,44193882,368,-149,44193514,44193882
4713,6,12,1,2412,-53,-90,37,40:e3:d6:da:ba:22,44194287,180,225,44194107,44194287
4714,6,12,1,2412,-53,-90,37,40:e3:d6:da:ba:23,44194520,184,49,44194336,44194520
4715,6,12,1,2412,-52,-90,38,40:e3:d6:da:ba:24,44194738,176,42,44194562,44194738
4716,6,12,1,2412,-52,-90,38,40:e3:d6:da:ba:25,44194966,160,68,44194806,44194966
4717,6,6,1,2412,-53,-90,37,40:e3:d6:da:ba:26,44195158,380,-188,44194778,44195158
4718,4,1,1,2412,-63,-90,27,54:e4:3a:ec:fb:64,44204504,2160,7186,44202344,44204504
4719,4,5.5,1,2412,-78,-90,12,,44247954,213,43237,44247741,44247954
4720,4,1,1,2412,-91,-90,-1,,44256877,304,8619,44256573,44256877
4721,6,6,1,2412,-55,-90,35,e6:aa:ea:c9:ea:33,44282992,408,25707,44282584,44282992
4722,6,6,1,2412,-55,-90,35,e6:aa:ea:c9:ea:33,44294723,408,11323,44294315,44294723
4723,6,12,1,2412,-55,-90,35,40:e3:d6:da:ba:20,44296078,160,1195,44295918,44296078
4724,6,6,1,2412,-55,-90,35,40:e3:d6:da:ba:21,44296297,368,-149,44295929,44296297
4725,6,12,1,2412,-55,-90,35,40:e3:d6:da:ba:22,44296684,180,207,44296504,44296684
4726,6,12,1,2412,-54,-90,36,40:e3:d6:da:ba:23,44296934,184,66,44296750,44296934
4727,6,6,1,2412,-65,-90,25,e6:aa:ea:b7:4a:dd,44297157,408,-185,44296749,44297157
4728,6,12,1,2412,-55,-90,35,40:e3:d6:da:ba:24,44297612,176,279,44297436,44297612
4729,6,6,1,2412,-54,-90,36,40:e3:d6:da:ba:26,44298062,380,70,44297682,44298062
4730,6,6,1,2412,-54,-90,36,e6:aa:ea:c9:ea:33,44306823,408,8353,44306415,44306823
4731,6,6,1,2412,-54,-90,36,e6:aa:ea:c9:ea:33,44319135,408,11904,44318727,44319135
4732,6,6,1,2412,-65,-90,25,e6:aa:ea:b7:4a:dd,44321393,408,1850,44320985,44321393
4733,6,6,1,2412,-65,-90,25,e6:aa:ea:b7:4a:dd,44333520,408,11719,44333112,44333520
4734,6,12,1,2412,-55,-90,35,40:e3:d6:da:ba:20,44398479,160,64799,44398319,44398479
4735,6,6,1,2412,-55,-90,35,40:e3:d6:da:ba:21,44398689,368,-158,44398321,44398689
4736,6,12,1,2412,-55,-90,35,40:e3:d6:da:ba:22,44399076,180,207,44398896,44399076
4737,6,12,1,2412,-54,-90,36,40:e3:d6:da:ba:23,44399367,184,107,44399183,44399367
4738,6,12,1,2412,-54,-90,36,40:e3:d6:da:ba:24,44399594,176,51,44399418,44399594
4739,6,12,1,2412,-55,-90,35,40:e3:d6:da:ba:25,44399795,160,41,44399635,44399795
4740,6,6,1,2412,-55,-90,35,40:e3:d6:da:ba:26,44400010,380,-165,44399630,44400010
4741,6,12,1,2412,-86,-90,4,84:d4:7e:f2:42:20,44416391,160,16221,44416231,44416391
4742,6,6,1,2412,-86,-90,4,84:d4:7e:f2:42:21,44416610,368,-149,44416242,44416610
4743,6,12,1,2412,-87,-90,3,84:d4:7e:f2:42:23,44417229,180,439,44417049,44417229
4744,6,12,1,2412,-85,-90,5,84:d4:7e:f2:42:25,44417645,160,256,44417485,44417645
4745,6,6,1,2412,-87,-90,3,84:d4:7e:f2:42:26,44417855,380,-170,44417475,44417855
4746,6,6,1,2412,-82,-90,8,e6:aa:ea:c9:ea:1b,44498605,408,80342,44498197,44498605
4747,6,12,1,2412,-53,-90,37,40:e3:d6:da:ba:20,44500887,160,2122,44500727,44500887
4748,6,6,1,2412,-53,-90,37,40:e3:d6:da:ba:21,44501088,368,-167,44500720,44501088
4749,6,12,1,2412,-52,-90,38,40:e3:d6:da:ba:22,44501484,180,216,44501304,44501484
4750,6,12,1,2412,-53,-90,37,40:e3:d6:da:ba:23,44501689,184,21,44501505,44501689
4751,6,12,1,2412,-52,-90,38,40:e3:d6:da:ba:24,44501908,176,43,44501732,44501908
4752,6,12,1,2412,-53,-90,37,40:e3:d6:da:ba:25,44502109,160,41,44501949,44502109
4753,6,6,1,2412,-53,-90,37,40:e3:d6:da:ba:26,44502319,380,-170,44501939,44502319
4754,4,1,1,2412,-92,-90,-2,b8:3a:5a:88:e6:e0,44530549,2240,25990,44528309,44530549
4755,6,12,1,2412,-52,-90,38,40:e3:d6:da:ba:20,44603268,160,72559,44603108,44603268
4756,6,6,1,2412,-52,-90,38,40:e3:d6:da:ba:21,44603460,368,-176,44603092,44603460
4757,6,12,1,2412,-51,-90,39,40:e3:d6:da:ba:22,44603874,180,234,44603694,44603874
4758,6,12,1,2412,-52,-90,38,40:e3:d6:da:ba:23,44604098,184,40,44603914,44604098
4759,6,12,1,2412,-52,-90,38,40:e3:d6:da:ba:24,44604334,176,60,44604158,44604334
4760,6,12,1,2412,-52,-90,38,40:e3:d6:da:ba:25,44604563,160,69,44604403,44604563
4761,6,6,1,2412,-52,-90,38,40:e3:d6:da:ba:26,44604781,380,-162,44604401,44604781
4762,6,6,1,2412,-61,-90,29,e6:aa:ea:b7:4a:dd,44612599,408,7410,44612191,44612599
4763,4,1,1,2412,-65,-90,25,54:e4:3a:ec:fb:64,44614102,2160,-657,44611942,44614102
4764,6,6,1,2412,-61,-90,29,e6:aa:ea:b7:4a:dd,44624730,408,10220,44624322,44624730
4765,6,6,1,2412,-60,-90,30,e6:aa:ea:b7:4a:dd,44648969,408,23831,44648561,44648969
4766,6,6,1,2412,-52,-90,38,e6:aa:ea:c9:ea:33,44699744,408,50367,44699336,44699744
4767,6,6,1,2412,-53,-90,37,40:e3:d6:da:ba:21,44706866,368,6754,44706498,44706866
4768,6,12,1,2412,-52,-90,38,40:e3:d6:da:ba:22,44707295,180,249,44707115,44707295
4769,6,12,1,2412,-53,-90,37,40:e3:d6:da:ba:23,44707519,184,40,44707335,44707519
4770,6,12,1,2412,-53,-90,37,40:e3:d6:da:ba:24,44707755,176,60,44707579,44707755
4771,6,12,1,2412,-53,-90,37,40:e3:d6:da:ba:25,44707957,160,42,44707797,44707957
4772,4,1,1,2412,-75,-90,15,c0:c9:e3:4d:6e:bf,44708313,872,-516,44707441,44708313
4773,6,6,1,2412,-53,-90,37,40:e3:d6:da:ba:26,44709051,380,358,44708671,44709051
4774,6,6,1,2412,-52,-90,38,e6:aa:ea:c9:ea:33,44711692,408,2233,44711284,44711692
4775,6,6,1,2412,-52,-90,38,e6:aa:ea:c9:ea:33,44723804,408,11704,44723396,44723804
4776,6,6,1,2412,-52,-90,38,e6:aa:ea:c9:ea:33,44735924,408,11712,44735516,44735924
4777,6,6,1,2412,-52,-90,38,e6:aa:ea:c9:ea:33,44748050,408,11718,44747642,44748050
4778,4,1,1,2412,-85,-90,5,a6:e5:7c:28:b1:d3,44792995,944,44001,44792051,44792995
4779,4,1,1,2412,-87,-90,3,a6:e5:7c:28:b1:d3,44795974,944,2035,44795030,44795974
4780,4,1,1,2412,-85,-90,5,a6:e5:7c:28:b1:d3,44797052,944,134,44796108,44797052
4781,4,1,1,2412,-86,-90,4,a6:e5:7c:28:b1:d3,44798166,944,170,44797222,44798166
4782,4,1,1,2412,-86,-90,4,a6:e5:7c:28:b1:d3,44799235,944,125,44798291,44799235
4783,4,1,1,2412,-86,-90,4,a6:e5:7c:28:b1:d3,44801436,944,1257,44800492,44801436
4784,6,12,1,2412,-52,-90,38,40:e3:d6:da:ba:20,44808066,160,6470,44807906,44808066
4785,6,6,1,2412,-52,-90,38,40:e3:d6:da:ba:21,44808276,368,-158,44807908,44808276
4786,6,12,1,2412,-52,-90,38,40:e3:d6:da:ba:22,44808663,180,207,44808483,44808663
4787,6,12,1,2412,-52,-90,38,40:e3:d6:da:ba:23,44808895,184,48,44808711,44808895
4788,6,12,1,2412,-52,-90,38,40:e3:d6:da:ba:24,44809132,176,61,44808956,44809132
4789,6,12,1,2412,-52,-90,38,40:e3:d6:da:ba:25,44809342,160,50,44809182,44809342
4790,6,6,1,2412,-52,-90,38,40:e3:d6:da:ba:26,44809561,380,-161,44809181,44809561
4791,6,6,1,2412,-78,-90,12,e6:aa:ea:c9:ea:1b,44893573,408,83604,44893165,44893573
4792,6,6,1,2412,-79,-90,11,e6:aa:ea:c9:ea:1b,44905693,408,11712,44905285,44905693
4793,6,12,1,2412,-57,-90,33,40:e3:d6:da:ba:20,44910531,160,4678,44910371,44910531
4794,6,6,1,2412,-57,-90,33,40:e3:d6:da:ba:21,44910723,368,-176,44910355,44910723
4795,6,12,1,2412,-57,-90,33,40:e3:d6:da:ba:22,44911119,180,216,44910939,44911119
4796,6,12,1,2412,-57,-90,33,40:e3:d6:da:ba:23,44911357,184,54,44911173,44911357
4797,6,12,1,2412,-57,-90,33,40:e3:d6:da:ba:24,44911566,176,33,44911390,44911566
4798,6,12,1,2412,-57,-90,33,40:e3:d6:da:ba:25,44911768,160,42,44911608,44911768
4799,6,6,1,2412,-57,-90,33,40:e3:d6:da:ba:26,44911987,380,-161,44911607,44911987
4800,6,6,1,2412,-78,-90,12,e6:aa:ea:c9:ea:1b,44917805,408,5410,44917397,44917805
4801,4,1,1,2412,-64,-90,26,54:e4:3a:ec:fb:64,44921298,2160,1333,44919138,44921298
4802,4,1,1,2412,-91,-90,-1,b8:3a:5a:88:e6:e0,44923500,2360,-158,44921140,44923500
4803,6,6,1,2412,-79,-90,11,e6:aa:ea:c9:ea:1b,44942073,408,18165,44941665,44942073
4804,6,12,1,2412,-53,-90,37,40:e3:d6:da:ba:20,45013836,160,71603,45013676,45013836
4805,6,12,1,2412,-53,-90,37,40:e3:d6:da:ba:23,45014710,184,690,45014526,45014710
4806,6,12,1,2412,-53,-90,37,40:e3:d6:da:ba:24,45014919,176,33,45014743,45014919
4807,6,12,1,2412,-53,-90,37,40:e3:d6:da:ba:25,45015130,160,51,45014970,45015130
4808,6,6,1,2412,-53,-90,37,40:e3:d6:da:ba:26,45015349,380,-161,45014969,45015349
4809,6,6,1,2412,-51,-90,39,e6:aa:ea:c9:ea:33,45015763,408,6,45015355,45015763
4810,4,1,1,2412,-51,-90,39,54:e4:3a:ec:fb:64,45023712,2160,5789,45021552,45023712
4811,6,6,1,2412,-52,-90,38,e6:aa:ea:c9:ea:33,45027570,408,3450,45027162,45027570
4812,6,6,1,2412,-52,-90,38,e6:aa:ea:c9:ea:33,45039681,408,11703,45039273,45039681
4813,6,6,1,2412,-53,-90,37,e6:aa:ea:c9:ea:33,45051822,408,11733,45051414,45051822
4814,6,6,1,2412,-54,-90,36,e6:aa:ea:c9:ea:33,45063907,408,11677,45063499,45063907
4815,6,12,1,2412,-54,-90,36,40:e3:d6:da:ba:20,45115271,160,51204,45115111,45115271
4816,6,6,1,2412,-54,-90,36,40:e3:d6:da:ba:21,45115463,368,-176,45115095,45115463
4817,6,12,1,2412,-53,-90,37,40:e3:d6:da:ba:22,45115868,180,225,45115688,45115868
4818,6,12,1,2412,-54,-90,36,40:e3:d6:da:ba:23,45116091,184,39,45115907,45116091
4819,6,12,1,2412,-54,-90,36,40:e3:d6:da:ba:24,45116301,176,34,45116125,45116301
4820,4,1,1,2412,-63,-90,27,54:e4:3a:ec:fb:64,45126097,2160,7636,45123937,45126097
4821,6,6,1,2412,-64,-90,26,e6:aa:ea:b7:4a:dd,45132470,408,5965,45132062,45132470
4822,6,6,1,2412,-64,-90,26,e6:aa:ea:b7:4a:dd,45144595,408,11717,45144187,45144595
4823,6,6,1,2412,-64,-90,26,e6:aa:ea:b7:4a:dd,45180941,408,35938,45180533,45180941
4824,4,1,1,2412,-81,-90,9,c0:c9:e3:4d:6e:bf,45197138,872,15325,45196266,45197138
4825,4,1,1,2412,-91,-90,-1,,45198027,304,585,45197723,45198027
4826,6,12,1,2412,-56,-90,34,40:e3:d6:da:ba:20,45217668,160,19481,45217508,45217668
4827,6,6,1,2412,-56,-90,34,40:e3:d6:da:ba:21,45217859,368,-177,45217491,45217859
4828,6,12,1,2412,-56,-90,34,40:e3:d6:da:ba:22,45218255,180,216,45218075,45218255
4829,6,12,1,2412,-56,-90,34,40:e3:d6:da:ba:23,45218461,184,22,45218277,45218461
4830,6,12,1,2412,-56,-90,34,40:e3:d6:da:ba:24,45218685,176,48,45218509,45218685
4831,6,12,1,2412,-56,-90,34,40:e3:d6:da:ba:25,45218887,160,42,45218727,45218887
4832,4,1,1,2412,-62,-90,28,54:e4:3a:ec:fb:64,45228496,2160,7449,45226336,45228496
4833,4,1,1,2412,-91,-90,-1,a6:e5:7c:28:b1:d3,45293536,992,64048,45292544,45293536
4834,4,1,1,2412,-91,-90,-1,a4:e5:7c:28:b1:d3,45313275,688,19051,45312587,45313275
4835,6,12,1,2412,-56,-90,34,40:e3:d6:da:ba:20,45320069,160,6634,45319909,45320069
4836,6,12,1,2412,-56,-90,34,40:e3:d6:da:ba:22,45323067,180,2818,45322887,45323067
4837,6,12,1,2412,-56,-90,34,40:e3:d6:da:ba:23,45323272,184,21,45323088,45323272
4838,6,12,1,2412,-56,-90,34,40:e3:d6:da:ba:24,45323506,176,58,45323330,45323506
4839,6,12,1,2412,-56,-90,34,40:e3:d6:da:ba:25,45323734,160,68,45323574,45323734
4840,6,6,1,2412,-56,-90,34,40:e3:d6:da:ba:26,45323953,380,-161,45323573,45323953
4841,4,1,1,2412,-61,-90,29,54:e4:3a:ec:fb:64,45330896,2160,4783,45328736,45330896
4842,6,6,1,2412,-54,-90,36,e6:aa:ea:c9:ea:33,45342593,408,11289,45342185,45342593
4843,6,6,1,2412,-54,-90,36,e6:aa:ea:c9:ea:33,45355087,408,12086,45354679,45355087
4844,6,6,1,2412,-54,-90,36,e6:aa:ea:c9:ea:33,45366825,408,11330,45366417,45366825
4845,6,6,1,2412,-53,-90,37,e6:aa:ea:c9:ea:33,45379050,408,11817,45378642,45379050
4846,6,6,1,2412,-80,-90,10,e6:aa:ea:c9:ea:1b,45415348,408,35890,45414940,45415348
4847,6,12,1,2412,-53,-90,37,40:e3:d6:da:ba:20,45422491,160,6983,45422331,45422491
4848,6,6,1,2412,-53,-90,37,40:e3:d6:da:ba:21,45422683,368,-176,45422315,45422683
4849,6,12,1,2412,-52,-90,38,40:e3:d6:da:ba:22,45423454,180,591,45423274,45423454
4850,6,12,1,2412,-53,-90,37,40:e3:d6:da:ba:24,45423887,176,257,45423711,45423887
4851,6,12,1,2412,-53,-90,37,40:e3:d6:da:ba:25,45424097,160,50,45423937,45424097
4852,6,6,1,2412,-53,-90,37,40:e3:d6:da:ba:26,45424313,380,-164,45423933,45424313
4853,4,1,1,2412,-63,-90,27,54:e4:3a:ec:fb:64,45433450,2160,6977,45431290,45433450
4854,6,6,1,2412,-80,-90,10,e6:aa:ea:c9:ea:1b,45463824,408,29966,45463416,45463824
4855,6,12,1,2412,-53,-90,37,40:e3:d6:da:ba:20,45524873,160,60889,45524713,45524873
4856,6,6,1,2412,-52,-90,38,40:e3:d6:da:ba:21,45525065,368,-176,45524697,45525065
4857,6,12,1,2412,-52,-90,38,40:e3:d6:da:ba:22,45525470,180,225,45525290,45525470
4858,6,12,1,2412,-52,-90,38,40:e3:d6:da:ba:23,45525703,184,49,45525519,45525703
4859,6,12,1,2412,-52,-90,38,40:e3:d6:da:ba:24,45525912,176,33,45525736,45525912
4860,6,12,1,2412,-52,-90,38,40:e3:d6:da:ba:25,45526114,160,42,45525954,45526114
4861,6,6,1,2412,-52,-90,38,40:e3:d6:da:ba:26,45526333,380,-161,45525953,45526333
4862,4,1,1,2412,-60,-90,30,54:e4:3a:ec:fb:64,45535693,2160,7200,45533533,45535693
4863,6,6,1,2412,-64,-90,26,e6:aa:ea:b7:4a:dd,45551887,408,15786,45551479,45551887
4864,6,6,1,2412,-64,-90,26,e6:aa:ea:b7:4a:dd,45564012,408,11717,45563604,45564012
4865,6,6,1,2412,-63,-90,27,e6:aa:ea:b7:4a:dd,45588247,408,23827,45587839,45588247
4866,6,6,1,2412,-63,-90,27,e6:aa:ea:b7:4a:dd,45600361,408,11706,45599953,45600361
4867,6,12,1,2412,-54,-90,36,40:e3:d6:da:ba:20,45627269,160,26748,45627109,45627269
4868,6,6,1,2412,-54,-90,36,40:e3:d6:da:ba:21,45627461,368,-176,45627093,45627461
4869,6,12,1,2412,-53,-90,37,40:e3:d6:da:ba:22,45627848,180,207,45627668,45627848
4870,6,12,1,2412,-53,-90,37,40:e3:d6:da:ba:23,45628080,184,48,45627896,45628080
4871,6,12,1,2412,-54,-90,36,40:e3:d6:da:ba:24,45628299,176,43,45628123,45628299
4872,6,12,1,2412,-53,-90,37,40:e3:d6:da:ba:25,45628642,160,183,45628482,45628642
4873,6,6,1,2412,-53,-90,37,40:e3:d6:da:ba:26,45628945,380,-77,45628565,45628945
4874,4,1,1,2412,-69,-90,21,54:e4:3a:ec:fb:64,45638093,2160,6988,45635933,45638093
4875,6,6,1,2412,-51,-90,39,e6:aa:ea:c9:ea:33,45646449,408,7948,45646041,45646449
4876,6,6,1,2412,-51,-90,39,e6:aa:ea:c9:ea:33,45658565,408,11708,45658157,45658565
4877,6,6,1,2412,-51,-90,39,e6:aa:ea:c9:ea:33,45670677,408,11704,45670269,45670677
4878,6,6,1,2412,-51,-90,39,e6:aa:ea:c9:ea:33,45682815,408,11730,45682407,45682815
4879,6,6,1,2412,-51,-90,39,e6:aa:ea:c9:ea:33,45694905,408,11682,45694497,45694905
4880,6,6,1,2412,-85,-90,5,78:8a:20:fa:27:f9,45699839,88,4846,45699751,45699839
4881,6,12,1,2412,-54,-90,36,40:e3:d6:da:ba:20,45700096,136,121,45699960,45700096
4882,6,6,1,2412,-54,-90,36,40:e3:d6:da:ba:21,45700272,348,-172,45699924,45700272
4883,6,12,1,2412,-54,-90,36,40:e3:d6:da:ba:22,45700957,156,529,45700801,45700957
4884,6,12,1,2412,-83,-90,7,,45701303,32,314,45701271,45701303
4885,6,12,1,2412,-54,-90,36,40:e3:d6:da:ba:23,45702620,156,1161,45702464,45702620
4886,6,12,1,2412,-54,-90,36,40:e3:d6:da:ba:25,45702964,136,208,45702828,45702964
4887,6,12,1,2412,-55,-90,35,40:e3:d6:da:ba:20,45729687,160,26563,45729527,45729687
4888,6,6,1,2412,-55,-90,35,40:e3:d6:da:ba:21,45729897,368,-158,45729529,45729897
4889,6,12,1,2412,-55,-90,35,40:e3:d6:da:ba:22,45731073,180,996,45730893,45731073
4890,4,1,1,2412,-67,-90,23,54:e4:3a:ec:fb:64,45740492,2160,7259,45738332,45740492
4891,4,1,1,2412,-85,-90,5,,45751610,304,10814,45751306,45751610
4892,6,12,1,2412,-54,-90,36,40:e3:d6:da:ba:20,45832070,160,80300,45831910,45832070
4893,6,6,1,2412,-54,-90,36,40:e3:d6:da:ba:21,45832271,368,-167,45831903,45832271
4894,6,12,1,2412,-53,-90,37,40:e3:d6:da:ba:22,45832676,180,225,45832496,45832676
4895,6,12,1,2412,-54,-90,36,40:e3:d6:da:ba:23,45832900,184,40,45832716,45832900
4896,6,12,1,2412,-53,-90,37,40:e3:d6:da:ba:24,45833136,176,60,45832960,45833136
4897,6,12,1,2412,-53,-90,37,40:e3:d6:da:ba:25,45833365,160,69,45833205,45833365
4898,6,6,1,2412,-53,-90,37,40:e3:d6:da:ba:26,45833566,380,-179,45833186,45833566
4899,4,1,1,2412,-89,-90,1,a6:e5:7c:28:b1:d3,45834846,944,336,45833902,45834846
4900,4,1,1,2412,-61,-90,29,54:e4:3a:ec:fb:64,45842891,2160,5885,45840731,45842891
4901,4,1,1,2412,-84,-90,6,a6:e5:7c:28:b1:d3,45852721,944,8886,45851777,45852721
4902,4,1,1,2412,-88,-90,2,a6:e5:7c:28:b1:d3,45856943,944,3278,45855999,45856943
4903,4,1,1,2412,-70,-90,20,a6:e5:7c:28:b1:d3,45934026,944,76139,45933082,45934026
4904,6,12,1,2412,-54,-90,36,40:e3:d6:da:ba:20,45935950,160,1764,45935790,45935950
4905,6,6,1,2412,-54,-90,36,40:e3:d6:da:ba:21,45936142,368,-176,45935774,45936142
4906,6,12,1,2412,-53,-90,37,40:e3:d6:da:ba:23,45937646,184,1320,45937462,45937646
4907,6,12,1,2412,-54,-90,36,40:e3:d6:da:ba:24,45938179,176,357,45938003,45938179
4908,6,12,1,2412,-54,-90,36,40:e3:d6:da:ba:25,45938856,160,517,45938696,45938856
4909,6,6,1,2412,-54,-90,36,40:e3:d6:da:ba:26,45939048,380,-188,45938668,45939048
4910,4,1,1,2412,-58,-90,32,54:e4:3a:ec:fb:64,45945291,2160,4083,45943131,45945291
4911,6,6,1,2412,-82,-90,8,e6:aa:ea:c9:ea:1b,45960842,408,15143,45960434,45960842
4912,6,6,1,2412,-60,-90,30,e6:aa:ea:b7:4a:dd,45969184,408,7934,45968776,45969184
4913,6,6,1,2412,-60,-90,30,e6:aa:ea:b7:4a:dd,45981175,408,11583,45980767,45981175
4914,6,6,1,2412,-59,-90,31,e6:aa:ea:b7:4a:dd,45993304,408,11721,45992896,45993304
4915,6,6,1,2412,-60,-90,30,e6:aa:ea:b7:4a:dd,46005418,408,11706,46005010,46005418
4916,6,6,1,2412,-60,-91,31,e6:aa:ea:b7:4a:dd,46017537,408,11711,46017129,46017537
4917,4,1,1,2412,-69,-91,22,a6:e5:7c:28:b1:d3,46027422,944,8941,46026478,46027422
4918,4,1,1,2412,-70,-91,21,a6:e5:7c:28:b1:d3,46030947,944,2581,46030003,46030947
4919,4,1,1,2412,-90,-91,1,a6:e5:7c:28:b1:d3,46032016,944,125,46031072,46032016
4920,4,1,1,2412,-87,-91,4,a6:e5:7c:28:b1:d3,46033067,944,107,46032123,46033067
4921,4,1,1,2412,-86,-91,5,a6:e5:7c:28:b1:d3,46035343,944,1332,46034399,46035343
4922,4,1,1,2412,-88,-91,3,a6:e5:7c:28:b1:d3,46036430,944,143,46035486,46036430
4923,6,12,1,2412,-54,-91,37,40:e3:d6:da:ba:20,46038329,160,1739,46038169,46038329
4924,4,1,1,2412,-89,-91,2,a6:e5:7c:28:b1:d3,46044045,944,4772,46043101,46044045
4925,6,12,1,2412,-54,-91,37,40:e3:d6:da:ba:22,46044886,180,661,46044706,46044886
4926,6,12,1,2412,-54,-91,37,40:e3:d6:da:ba:23,46045465,184,395,46045281,46045465
4927,6,12,1,2412,-54,-91,37,40:e3:d6:da:ba:24,46045674,176,33,46045498,46045674
4928,6,12,1,2412,-53,-91,38,40:e3:d6:da:ba:25,46046746,160,912,46046586,46046746
4929,6,12,1,2412,-54,-91,37,40:e3:d6:da:ba:20,46139274,160,92368,46139114,46139274
4930,6,6,1,2412,-54,-91,37,40:e3:d6:da:ba:21,46139475,368,-167,46139107,46139475
4931,6,12,1,2412,-54,-91,37,40:e3:d6:da:ba:22,46139880,180,225,46139700,46139880
4932,6,12,1,2412,-54,-91,37,40:e3:d6:da:ba:23,46140103,184,39,46139919,46140103
4933,6,12,1,2412,-54,-91,37,40:e3:d6:da:ba:24,46140313,176,34,46140137,46140313
4934,6,12,1,2412,-54,-91,37,40:e3:d6:da:ba:25,46140540,160,67,46140380,46140540
4935,6,6,1,2412,-54,-91,37,40:e3:d6:da:ba:26,46140749,380,-171,46140369,46140749
4936,4,1,1,2412,-61,-91,30,54:e4:3a:ec:fb:64,46150088,2160,7179,46147928,46150088
4937,6,6,1,2412,-56,-91,35,e6:aa:ea:c9:ea:33,46167627,408,17131,46167219,46167627
4938,6,6,1,2412,-52,-91,39,e6:aa:ea:c9:ea:33,46177534,408,9499,46177126,46177534
4939,6,6,1,2412,-52,-91,39,e6:aa:ea:c9:ea:33,46189649,408,11707,46189241,46189649
4940,6,6,1,2412,-52,-91,39,e6:aa:ea:c9:ea:33,46201770,408,11713,46201362,46201770
4941,6,6,1,2412,-53,-91,38,e6:aa:ea:c9:ea:33,46213880,408,11702,46213472,46213880
4942,6,12,1,2412,-57,-91,34,40:e3:d6:da:ba:20,46241672,160,27632,46241512,46241672
4943,6,6,1,2412,-57,-91,34,40:e3:d6:da:ba:21,46241864,368,-176,46241496,46241864
4944,6,12,1,2412,-57,-91,34,40:e3:d6:da:ba:22,46242251,180,207,46242071,46242251
4945,6,12,1,2412,-57,-91,34,40:e3:d6:da:ba:23,46242484,184,49,46242300,46242484
4946,6,12,1,2412,-58,-91,33,40:e3:d6:da:ba:24,46242711,176,51,46242535,46242711
4947,6,12,1,2412,-57,-91,34,40:e3:d6:da:ba:25,46242931,160,60,46242771,46242931
4948,6,6,1,2412,-57,-91,34,40:e3:d6:da:ba:26,46243123,380,-188,46242743,46243123
4949,6,6,1,2412,-82,-91,9,e6:aa:ea:c9:ea:1b,46265188,408,21657,46264780,46265188
4950,6,6,1,2412,-82,-91,9,e6:aa:ea:c9:ea:1b,46277308,408,11712,46276900,46277308
4951,6,6,1,2412,-81,-91,10,e6:aa:ea:c9:ea:1b,46289418,408,11702,46289010,46289418
4952,6,6,1,2412,-82,-91,9,e6:aa:ea:c9:ea:1b,46301529,408,11703,46301121,46301529
4953,6,12,1,2412,-53,-91,38,40:e3:d6:da:ba:20,46344099,160,42410,46343939,46344099
4954,6,6,1,2412,-53,-91,38,40:e3:d6:da:ba:21,46344309,368,-158,46343941,46344309
4955,6,12,1,2412,-53,-91,38,40:e3:d6:da:ba:22,46344705,180,216,46344525,46344705
4956,6,12,1,2412,-53,-91,38,40:e3:d6:da:ba:23,46344938,184,49,46344754,46344938
4957,6,12,1,2412,-53,-91,38,40:e3:d6:da:ba:24,46345165,176,51,46344989,46345165
4958,6,12,1,2412,-53,-91,38,40:e3:d6:da:ba:25,46345384,160,59,46345224,46345384
4959,6,6,1,2412,-53,-91,38,40:e3:d6:da:ba:26,46345603,380,-161,46345223,46345603
4960,4,1,1,2412,-65,-91,26,54:e4:3a:ec:fb:64,46354887,2160,7124,46352727,46354887
4961,6,12,1,2412,-53,-91,38,40:e3:d6:da:ba:20,46372912,136,17889,46372776,46372912
4962,6,6,1,2412,-53,-91,38,40:e3:d6:da:ba:21,46373107,348,-153,46372759,46373107
4963,6,12,1,2412,-53,-91,38,40:e3:d6:da:ba:22,46374785,156,1522,46374629,46374785
4964,6,12,1,2412,-53,-91,38,40:e3:d6:da:ba:23,46374975,156,34,46374819,46374975
4965,6,12,1,2412,-89,-91,2,,46375151,32,144,46375119,46375151
4966,6,12,1,2412,-53,-91,38,40:e3:d6:da:ba:25,46375218,136,-69,46375082,46375218
4967,6,12,1,2412,-53,-91,38,40:e3:d6:da:ba:20,46391449,136,16095,46391313,46391449
4968,6,6,1,2412,-53,-91,38,40:e3:d6:da:ba:21,46392056,348,259,46391708,46392056
4969,6,12,1,2412,-53,-91,38,40:e3:d6:da:ba:22,46392773,156,561,46392617,46392773
4970,6,12,1,2412,-53,-91,38,40:e3:d6:da:ba:23,46393467,156,538,46393311,46393467
4971,6,12,1,2412,-53,-91,38,40:e3:d6:da:ba:25,46393839,136,236,46393703,46393839
4972,6,12,1,2412,-51,-91,40,40:e3:d6:da:ba:20,46413599,136,19624,46413463,46413599
4973,6,6,1,2412,-51,-91,40,40:e3:d6:da:ba:21,46413776,348,-171,46413428,46413776
4974,6,12,1,2412,-52,-91,39,40:e3:d6:da:ba:22,46414170,156,238,46414014,46414170
4975,6,12,1,2412,-52,-91,39,40:e3:d6:da:ba:23,46414379,156,53,46414223,46414379
4976,6,12,1,2412,-53,-91,38,40:e3:d6:da:ba:25,46414569,136,54,46414433,46414569
4977,6,12,1,2412,-86,-91,5,84:d4:7e:f2:42:23,46419888,160,5159,46419728,46419888
4978,6,12,1,2412,-86,-91,5,84:d4:7e:f2:42:25,46420109,140,81,46419969,46420109
4979,6,12,1,2412,-85,-91,6,84:d4:7e:f2:42:20,46433062,140,12813,46432922,46433062
4980,6,12,1,2412,-84,-91,7,84:d4:7e:f2:42:23,46433848,160,626,46433688,46433848
4981,6,12,1,2412,-85,-91,6,84:d4:7e:f2:42:25,46434070,140,82,46433930,46434070
4982,6,12,1,2412,-52,-91,39,40:e3:d6:da:ba:20,46446474,160,12244,46446314,46446474
4983,6,6,1,2412,-52,-91,39,40:e3:d6:da:ba:21,46446684,368,-158,46446316,46446684
4984,6,12,1,2412,-52,-91,39,40:e3:d6:da:ba:22,46447089,180,225,46446909,46447089
4985,6,12,1,2412,-52,-91,39,40:e3:d6:da:ba:23,46447294,184,21,46447110,46447294
4986,6,12,1,2412,-52,-91,39,40:e3:d6:da:ba:24,46447512,176,42,46447336,46447512
4987,6,12,1,2412,-52,-91,39,40:e3:d6:da:ba:25,46447714,160,42,46447554,46447714
4988,6,6,1,2412,-52,-91,39,40:e3:d6:da:ba:26,46447906,380,-188,46447526,46447906
4989,4,1,1,2412,-68,-91,23,54:e4:3a:ec:fb:64,46457630,2160,7564,46455470,46457630
4990,6,12,1,2412,-75,-91,16,84:d4:7e:f2:42:20,46464655,160,6865,46464495,46464655
4991,6,6,1,2412,-76,-91,15,84:d4:7e:f2:42:21,46464856,368,-167,46464488,46464856
4992,6,6,1,2412,-65,-91,26,e6:aa:ea:b7:4a:dd,46488642,408,23378,46488234,46488642
4993,4,5.5,1,2412,-84,-91,7,60:dd:8e:b5:da:79,46490593,389,1562,46490204,46490593
4994,6,12,1,2412,-52,-91,39,40:e3:d6:da:ba:20,46493389,136,2660,46493253,46493389
4995,6,6,1,2412,-52,-91,39,40:e3:d6:da:ba:21,46495572,348,1835,46495224,46495572
4996,6,12,1,2412,-52,-91,39,40:e3:d6:da:ba:22,46495948,156,220,46495792,46495948
4997,6,12,1,2412,-52,-91,39,40:e3:d6:da:ba:23,46496201,156,97,46496045,46496201
4998,6,12,1,2412,-52,-91,39,40:e3:d6:da:ba:25,46496401,136,64,46496265,46496401
4999,4,1,1,2412,-69,-91,22,54:e4:3a:ec:fb:64,46496887,2112,-1626,46494775,46496887
5000,4,1,1,2412,-68,-91,23,54:e4:3a:ec:fb:64,46499225,2112,226,46497113,46499225
5001,6,6,1,2412,-64,-91,27,e6:aa:ea:b7:4a:dd,46501526,408,1893,46501118,46501526
5002,6,6,1,2412,-64,-91,27,e6:aa:ea:b7:4a:dd,46512883,408,10949,46512475,46512883
5003,6,6,1,2412,-63,-91,28,e6:aa:ea:b7:4a:dd,46524997,408,11706,46524589,46524997
5004,6,6,1,2412,-63,-91,28,e6:aa:ea:b7:4a:dd,46537209,408,11804,46536801,46537209
5005,6,12,1,2412,-52,-91,39,40:e3:d6:da:ba:20,46548882,160,11513,46548722,46548882
5006,6,6,1,2412,-52,-91,39,40:e3:d6:da:ba:21,46549092,368,-158,46548724,46549092
5007,6,12,1,2412,-51,-91,40,40:e3:d6:da:ba:22,46549479,180,207,46549299,46549479
5008,6,12,1,2412,-51,-91,40,40:e3:d6:da:ba:23,46549711,184,48,46549527,46549711
5009,6,12,1,2412,-51,-91,40,40:e3:d6:da:ba:24,46549939,176,52,46549763,46549939
5010,6,12,1,2412,-51,-91,40,40:e3:d6:da:ba:25,46550140,160,41,46549980,46550140
5011,6,6,1,2412,-51,-91,40,40:e3:d6:da:ba:26,46550332,380,-188,46549952,46550332
5012,4,1,1,2412,-68,-91,23,54:e4:3a:ec:fb:64,46559684,2160,7192,46557524,46559684
5013,6,12,1,2412,-85,-91,6,84:d4:7e:f2:42:20,46566763,160,6919,46566603,46566763
5014,6,6,1,2412,-85,-91,6,84:d4:7e:f2:42:21,46566982,368,-149,46566614,46566982
5015,6,12,1,2412,-84,-91,7,84:d4:7e:f2:42:22,46567378,180,216,46567198,46567378
5016,6,12,1,2412,-53,-91,38,40:e3:d6:da:ba:20,46655111,160,87573,46654951,46655111
5017,6,6,1,2412,-53,-91,38,40:e3:d6:da:ba:21,46655312,368,-167,46654944,46655312
5018,6,12,1,2412,-53,-91,38,40:e3:d6:da:ba:23,46655941,184,445,46655757,46655941
5019,6,12,1,2412,-53,-91,38,40:e3:d6:da:ba:24,46656168,176,51,46655992,46656168
5020,6,12,1,2412,-53,-91,38,40:e3:d6:da:ba:25,46656397,160,69,46656237,46656397
5021,6,6,1,2412,-53,-91,38,40:e3:d6:da:ba:26,46656607,380,-170,46656227,46656607
5022,6,6,1,2412,-51,-91,40,e6:aa:ea:c9:ea:33,46685794,408,28779,46685386,46685794
5023,4,1,1,2412,-66,-91,25,a6:e5:7c:28:b1:d3,46700675,944,13937,46699731,46700675
5024,4,1,1,2412,-84,-91,7,a6:e5:7c:28:b1:d3,46703891,944,2272,46702947,46703891
5025,4,1,1,2412,-87,-91,4,a6:e5:7c:28:b1:d3,46705087,944,252,46704143,46705087
5026,6,6,1,2412,-51,-91,40,e6:aa:ea:c9:ea:33,46710044,408,4549,46709636,46710044
5027,4,1,1,2412,-69,-91,22,a6:e5:7c:28:b1:d3,46712778,944,1790,46711834,46712778
5028,4,1,1,2412,-87,-91,4,a6:e5:7c:28:b1:d3,46720147,944,6425,46719203,46720147
5029,6,6,1,2412,-52,-91,39,e6:aa:ea:c9:ea:33,46722175,408,1620,46721767,46722175
5030,4,1,1,2412,-69,-91,22,a6:e5:7c:28:b1:d3,46724405,944,1286,46723461,46724405
5031,6,6,1,2412,-52,-91,39,e6:aa:ea:c9:ea:33,46734282,408,9469,46733874,46734282
5032,6,12,1,2412,-52,-91,39,40:e3:d6:da:ba:20,46753675,160,19233,46753515,46753675
5033,6,6,1,2412,-51,-91,40,40:e3:d6:da:ba:21,46753876,368,-167,46753508,46753876
5034,6,12,1,2412,-51,-91,40,40:e3:d6:da:ba:22,46754317,180,261,46754137,46754317
5035,6,12,1,2412,-51,-91,40,40:e3:d6:da:ba:23,46754566,184,65,46754382,46754566
5036,4,1,1,2412,-92,-91,-1,,46789044,304,34174,46788740,46789044
5037,6,12,1,2412,-51,-91,40,40:e3:d6:da:ba:20,46856078,160,66874,46855918,46856078
5038,6,6,1,2412,-51,-91,40,40:e3:d6:da:ba:21,46856288,368,-158,46855920,46856288
5039,6,12,1,2412,-51,-91,40,40:e3:d6:da:ba:23,46858180,184,1708,46857996,46858180
5040,6,12,1,2412,-51,-91,40,40:e3:d6:da:ba:24,46858398,176,42,46858222,46858398
5041,6,12,1,2412,-51,-91,40,40:e3:d6:da:ba:25,46858627,160,69,46858467,46858627
5042,6,6,1,2412,-51,-91,40,40:e3:d6:da:ba:26,46858819,380,-188,46858439,46858819
5043,6,6,1,2412,-65,-91,26,e6:aa:ea:b7:4a:dd,46906433,408,47206,46906025,46906433
5044,6,6,1,2412,-65,-91,26,e6:aa:ea:b7:4a:dd,46918551,408,11710,46918143,46918551
5045,6,6,1,2412,-64,-91,27,e6:aa:ea:b7:4a:dd,46954905,408,35946,46954497,46954905
5046,6,12,1,2412,-51,-91,40,40:e3:d6:da:ba:20,46961857,160,6792,46961697,46961857
5047,6,6,1,2412,-51,-91,40,40:e3:d6:da:ba:21,46962067,368,-158,46961699,46962067
5048,6,12,1,2412,-51,-91,40,40:e3:d6:da:ba:22,46962481,180,234,46962301,46962481
5049,6,12,1,2412,-51,-91,40,40:e3:d6:da:ba:23,46962686,184,21,46962502,46962686
5050,6,12,1,2412,-51,-91,40,40:e3:d6:da:ba:24,46963293,176,431,46963117,46963293
5051,6,12,1,2412,-51,-91,40,40:e3:d6:da:ba:25,46963521,160,68,46963361,46963521
5052,6,6,1,2412,-51,-91,40,40:e3:d6:da:ba:26,46963731,380,-170,46963351,46963731
5053,4,1,1,2412,-62,-91,29,54:e4:3a:ec:fb:64,46969282,2160,3391,46967122,46969282
5054,4,1,1,2412,-87,-91,4,b8:3a:5a:88:e6:e1,46973872,2376,2214,46971496,46973872
5055,6,12,1,2412,-51,-91,40,40:e3:d6:da:ba:20,47060888,160,86856,47060728,47060888
5056,6,6,1,2412,-51,-91,40,40:e3:d6:da:ba:21,47061089,368,-167,47060721,47061089
5057,6,12,1,2412,-51,-91,40,40:e3:d6:da:ba:22,47061476,180,207,47061296,47061476
5058,6,12,1,2412,-51,-91,40,40:e3:d6:da:ba:23,47061708,184,48,47061524,47061708
5059,6,12,1,2412,-51,-91,40,40:e3:d6:da:ba:24,47061936,176,52,47061760,47061936
5060,6,12,1,2412,-51,-91,40,40:e3:d6:da:ba:25,47062146,160,50,47061986,47062146
5061,6,6,1,2412,-51,-91,40,40:e3:d6:da:ba:26,47062338,380,-188,47061958,47062338
5062,6,12,1,2412,-53,-91,38,40:e3:d6:da:ba:20,47135682,136,73208,47135546,47135682
5063,6,6,1,2412,-52,-91,39,40:e3:d6:da:ba:21,47135859,348,-171,47135511,47135859
5064,6,12,1,2412,-52,-91,39,40:e3:d6:da:ba:22,47136235,156,220,47136079,47136235
5065,6,12,1,2412,-52,-91,39,40:e3:d6:da:ba:23,47136435,156,44,47136279,47136435
5066,6,12,1,2412,-52,-91,39,40:e3:d6:da:ba:25,47136634,136,63,47136498,47136634
5067,6,12,1,2412,-53,-91,38,40:e3:d6:da:ba:20,47163302,160,26508,47163142,47163302
5068,6,6,1,2412,-53,-91,38,40:e3:d6:da:ba:21,47163494,368,-176,47163126,47163494
5069,6,12,1,2412,-53,-91,38,40:e3:d6:da:ba:22,47163881,180,207,47163701,47163881
5070,6,12,1,2412,-53,-91,38,40:e3:d6:da:ba:23,47164102,184,37,47163918,47164102
5071,6,12,1,2412,-53,-91,38,40:e3:d6:da:ba:24,47164311,176,33,47164135,47164311
5072,6,12,1,2412,-53,-91,38,40:e3:d6:da:ba:25,47164530,160,59,47164370,47164530
5073,6,6,1,2412,-53,-91,38,40:e3:d6:da:ba:26,47164749,380,-161,47164369,47164749
5074,4,1,1,2412,-66,-91,25,54:e4:3a:ec:fb:64,47174079,2160,7170,47171919,47174079
5075,6,6,1,2412,-82,-91,9,e6:aa:ea:c9:ea:1b,47195003,408,20516,47194595,47195003
5076,6,6,1,2412,-54,-91,37,e6:aa:ea:c9:ea:33,47206331,408,10920,47205923,47206331
5077,6,6,1,2412,-83,-91,8,e6:aa:ea:c9:ea:1b,47207129,408,390,47206721,47207129
5078,6,6,1,2412,-54,-91,37,e6:aa:ea:c9:ea:33,47218288,408,10751,47217880,47218288
5079,6,6,1,2412,-65,-91,26,e6:aa:ea:b7:4a:dd,47223266,408,4570,47222858,47223266
5080,6,6,1,2412,-53,-91,38,e6:aa:ea:c9:ea:33,47231549,408,7875,47231141,47231549
5081,6,6,1,2412,-65,-91,26,e6:aa:ea:b7:4a:dd,47235392,408,3435,47234984,47235392
5082,6,6,1,2412,-65,-91,26,e6:aa:ea:b7:4a:dd,47247532,408,11732,47247124,47247532
5083,6,6,1,2412,-64,-91,27,e6:aa:ea:b7:4a:dd,47259620,408,11680,47259212,47259620
5084,6,12,1,2412,-55,-91,36,40:e3:d6:da:ba:20,47265687,160,5907,47265527,47265687
5085,6,6,1,2412,-55,-91,36,40:e3:d6:da:ba:21,47265913,368,-142,47265545,47265913
5086,6,12,1,2412,-55,-91,36,40:e3:d6:da:ba:22,47266300,180,207,47266120,47266300
5087,6,12,1,2412,-55,-91,36,40:e3:d6:da:ba:23,47266533,184,49,47266349,47266533
5088,6,12,1,2412,-55,-91,36,40:e3:d6:da:ba:24,47266760,176,51,47266584,47266760
5089,6,12,1,2412,-55,-91,36,40:e3:d6:da:ba:25,47266961,160,41,47266801,47266961
5090,6,6,1,2412,-55,-91,36,40:e3:d6:da:ba:26,47267180,380,-161,47266800,47267180
5091,4,1,1,2412,-69,-91,22,54:e4:3a:ec:fb:64,47276479,2160,7139,47274319,47276479
5092,4,1,1,2412,-69,-91,22,b8:3a:5a:88:e6:e1,47281079,2376,2224,47278703,47281079
5093,4,5.5,1,2412,-87,-91,4,ea:56:b9:18:c7:36,47367232,403,85750,47366829,47367232
5094,6,12,1,2412,-56,-91,35,40:e3:d6:da:ba:20,47367949,136,581,47367813,47367949
5095,6,6,1,2412,-56,-91,35,40:e3:d6:da:ba:21,47368399,348,102,47368051,47368399
5096,6,12,1,2412,-56,-91,35,40:e3:d6:da:ba:25,47370050,136,1515,47369914,47370050
5097,6,12,1,2412,-56,-91,35,40:e3:d6:da:ba:20,47372934,160,2724,47372774,47372934
5098,6,6,1,2412,-56,-91,35,40:e3:d6:da:ba:21,47373239,368,-63,47372871,47373239
5099,6,12,1,2412,-56,-91,35,40:e3:d6:da:ba:22,47373635,180,216,47373455,47373635
5100,6,12,1,2412,-56,-91,35,40:e3:d6:da:ba:23,47373841,184,22,47373657,47373841
5101,6,12,1,2412,-56,-91,35,40:e3:d6:da:ba:24,47374068,176,51,47373892,47374068
5102,6,6,1,2412,-53,-91,38,40:e3:d6:da:ba:26,47374471,380,23,47374091,47374471
5103,4,1,1,2412,-69,-91,22,54:e4:3a:ec:fb:64,47378879,2160,2248,47376719,47378879
5104,6,12,1,2412,-53,-91,38,40:e3:d6:da:ba:20,47470481,160,91442,47470321,47470481
5105,6,6,1,2412,-53,-91,38,40:e3:d6:da:ba:21,47470700,368,-149,47470332,47470700
5106,6,12,1,2412,-53,-91,38,40:e3:d6:da:ba:22,47471105,180,225,47470925,47471105
5107,6,12,1,2412,-53,-91,38,40:e3:d6:da:ba:23,47471328,184,39,47471144,47471328
5108,6,12,1,2412,-53,-91,38,40:e3:d6:da:ba:24,47471564,176,60,47471388,47471564
5109,6,12,1,2412,-53,-91,38,40:e3:d6:da:ba:25,47471793,160,69,47471633,47471793
5110,6,6,1,2412,-53,-91,38,40:e3:d6:da:ba:26,47472003,380,-170,47471623,47472003
5111,6,12,1,2412,-53,-91,38,40:e3:d6:da:ba:20,47572896,160,100733,47572736,47572896
5112,6,6,1,2412,-53,-91,38,40:e3:d6:da:ba:21,47573106,368,-158,47572738,47573106
5113,6,12,1,2412,-53,-91,38,40:e3:d6:da:ba:22,47573502,180,216,47573322,47573502
5114,6,12,1,2412,-53,-91,38,40:e3:d6:da:ba:23,47573708,184,22,47573524,47573708
5115,6,12,1,2412,-53,-91,38,40:e3:d6:da:ba:24,47573996,176,112,47573820,47573996
5116,6,12,1,2412,-53,-91,38,40:e3:d6:da:ba:25,47574216,160,60,47574056,47574216
5117,6,6,1,2412,-53,-91,38,40:e3:d6:da:ba:26,47574408,380,-188,47574028,47574408
5118,4,1,1,2412,-75,-91,16,,47581031,304,6319,47580727,47581031
5119,4,1,1,2412,-64,-91,27,54:e4:3a:ec:fb:64,47585921,2160,2730,47583761,47585921
5120,6,6,1,2412,-54,-91,37,40:e3:d6:da:ba:21,47603148,348,16879,47602800,47603148
5121,6,12,1,2412,-55,-91,36,40:e3:d6:da:ba:23,47603940,156,636,47603784,47603940
5122,6,12,1,2412,-54,-91,37,40:e3:d6:da:ba:25,47604130,136,54,47603994,47604130
5123,6,6,1,2412,-54,-91,37,e6:aa:ea:c9:ea:33,47625114,408,20576,47624706,47625114
5124,6,6,1,2412,-54,-91,37,e6:aa:ea:c9:ea:33,47637237,408,11715,47636829,47637237
5125,6,6,1,2412,-64,-91,27,e6:aa:ea:b7:4a:dd,47652258,408,14613,47651850,47652258
5126,4,1,1,2412,-87,-91,4,c0:c9:e3:4d:6e:bf,47652990,872,-140,47652118,47652990
5127,6,6,1,2412,-52,-91,39,e6:aa:ea:c9:ea:33,47661501,408,8103,47661093,47661501
5128,6,6,1,2412,-51,-91,40,e6:aa:ea:c9:ea:33,47674873,408,12964,47674465,47674873
5129,6,12,1,2412,-56,-91,35,40:e3:d6:da:ba:20,47676314,160,1281,47676154,47676314
5130,6,12,1,2412,-56,-91,35,40:e3:d6:da:ba:22,47677368,180,874,47677188,47677368
5131,6,12,1,2412,-55,-91,36,40:e3:d6:da:ba:23,47677597,184,45,47677413,47677597
5132,6,12,1,2412,-56,-91,35,40:e3:d6:da:ba:24,47677825,176,52,47677649,47677825
5133,6,12,1,2412,-55,-91,36,40:e3:d6:da:ba:25,47678035,160,50,47677875,47678035
5134,6,6,1,2412,-55,-91,36,40:e3:d6:da:ba:26,47678236,380,-179,47677856,47678236
5135,4,1,1,2412,-72,-91,19,,47695654,304,17114,47695350,47695654
5136,6,6,1,2412,-84,-91,7,e6:aa:ea:c9:ea:1b,47717277,408,21215,47716869,47717277
5137,6,6,1,2412,-83,-91,8,e6:aa:ea:c9:ea:1b,47741501,408,23816,47741093,47741501
5138,6,6,1,2412,-55,-91,36,40:e3:d6:da:ba:21,47778119,368,36250,47777751,47778119
5139,6,12,1,2412,-55,-91,36,40:e3:d6:da:ba:22,47778530,180,231,47778350,47778530
5140,6,12,1,2412,-55,-91,36,40:e3:d6:da:ba:23,47778762,184,48,47778578,47778762
5141,6,12,1,2412,-55,-91,36,40:e3:d6:da:ba:24,47778999,176,61,47778823,47778999
5142,6,12,1,2412,-55,-91,36,40:e3:d6:da:ba:25,47779209,160,50,47779049,47779209
5143,6,6,1,2412,-55,-91,36,40:e3:d6:da:ba:26,47779401,380,-188,47779021,47779401
5144,6,12,1,2412,-54,-91,37,40:e3:d6:da:ba:20,47880100,160,100539,47879940,47880100
5145,6,6,1,2412,-54,-91,37,40:e3:d6:da:ba:21,47880301,368,-167,47879933,47880301
5146,6,12,1,2412,-54,-91,37,40:e3:d6:da:ba:22,47880706,180,225,47880526,47880706
5147,6,12,1,2412,-54,-91,37,40:e3:d6:da:ba:23,47880973,184,83,47880789,47880973
5148,6,12,1,2412,-54,-91,37,40:e3:d6:da:ba:24,47881200,176,51,47881024,47881200
5149,6,12,1,2412,-54,-91,37,40:e3:d6:da:ba:25,47881429,160,69,47881269,47881429
5150,6,6,1,2412,-54,-91,37,40:e3:d6:da:ba:26,47881639,380,-170,47881259,47881639
5151,4,1,1,2412,-70,-91,21,54:e4:3a:ec:fb:64,47890873,2160,7074,47888713,47890873
5152,4,1,1,2412,-90,-91,1,b8:3a:5a:88:e6:e0,47893066,2360,-167,47890706,47893066
5153,4,1,1,2412,-85,-91,6,a6:e5:7c:28:b1:d3,47964704,944,70694,47963760,47964704
5154,4,1,1,2412,-87,-91,4,a6:e5:7c:28:b1:d3,47965764,944,116,47964820,47965764
5155,4,1,1,2412,-87,-91,4,a6:e5:7c:28:b1:d3,47966851,944,143,47965907,47966851
5156,4,1,1,2412,-91,-91,0,a6:e5:7c:28:b1:d3,47968073,944,278,47967129,47968073
5157,6,12,1,2412,-55,-91,36,40:e3:d6:da:ba:20,47982482,160,14249,47982322,47982482
5158,6,6,1,2412,-55,-91,36,40:e3:d6:da:ba:21,47982673,368,-177,47982305,47982673
5159,6,12,1,2412,-55,-91,36,40:e3:d6:da:ba:22,47983102,180,249,47982922,47983102
5160,6,12,1,2412,-55,-91,36,40:e3:d6:da:ba:23,47983308,184,22,47983124,47983308
5161,6,12,1,2412,-55,-91,36,40:e3:d6:da:ba:25,47983726,160,258,47983566,47983726
5162,6,6,1,2412,-55,-91,36,40:e3:d6:da:ba:26,47983927,380,-179,47983547,47983927
5163,4,1,1,2412,-82,-91,9,b8:3a:5a:88:e6:e1,47996690,2376,10387,47994314,47996690
5164,4,1,1,2412,-90,-91,1,a6:e5:7c:28:b1:d3,48059609,944,61975,48058665,48059609
5165,4,1,1,2412,-91,-91,0,a6:e5:7c:28:b1:d3,48062801,944,2248,48061857,48062801
5166,6,12,1,2412,-56,-91,35,40:e3:d6:da:ba:20,48084921,160,21960,48084761,48084921
5167,6,6,1,2412,-56,-91,35,40:e3:d6:da:ba:21,48085140,368,-149,48084772,48085140
5168,6,12,1,2412,-56,-91,35,40:e3:d6:da:ba:22,48085545,180,225,48085365,48085545
5169,6,12,1,2412,-55,-91,36,40:e3:d6:da:ba:23,48085750,184,21,48085566,48085750
5170,6,12,1,2412,-56,-91,35,40:e3:d6:da:ba:24,48085969,176,43,48085793,48085969
5171,6,12,1,2412,-55,-91,36,40:e3:d6:da:ba:25,48086170,160,41,48086010,48086170
5172,6,6,1,2412,-55,-91,36,40:e3:d6:da:ba:26,48086371,380,-179,48085991,48086371
5173,6,6,1,2412,-84,-91,7,e6:aa:ea:c9:ea:1b,48137858,408,51079,48137450,48137858
5174,4,1,1,2412,-88,-91,3,c0:c9:e3:4d:6e:bf,48140503,872,1773,48139631,48140503
5175,6,6,1,2412,-51,-91,40,e6:aa:ea:c9:ea:33,48152716,408,11805,48152308,48152716
5176,6,6,1,2412,-51,-91,40,e6:aa:ea:c9:ea:33,48159199,408,6075,48158791,48159199
5177,6,12,1,2412,-55,-91,36,40:e3:d6:da:ba:20,48191932,160,32573,48191772,48191932
5178,6,6,1,2412,-55,-91,36,40:e3:d6:da:ba:21,48192123,368,-177,48191755,48192123
5179,6,12,1,2412,-55,-91,36,40:e3:d6:da:ba:22,48192810,180,507,48192630,48192810
5180,6,12,1,2412,-55,-91,36,40:e3:d6:da:ba:23,48193058,184,64,48192874,48193058
5181,6,12,1,2412,-55,-91,36,40:e3:d6:da:ba:25,48193496,160,278,48193336,48193496
5182,6,6,1,2412,-55,-91,36,40:e3:d6:da:ba:26,48193715,380,-161,48193335,48193715
5183,4,1,1,2412,-53,-91,38,54:e4:3a:ec:fb:64,48198104,2160,2229,48195944,48198104
5184,6,12,1,2412,-56,-91,35,40:e3:d6:da:ba:20,48289733,160,91469,48289573,48289733
5185,6,6,1,2412,-54,-91,37,40:e3:d6:da:ba:21,48289934,368,-167,48289566,48289934
5186,6,12,1,2412,-55,-91,36,40:e3:d6:da:ba:22,48290359,180,245,48290179,48290359
5187,6,12,1,2412,-55,-91,36,40:e3:d6:da:ba:23,48290564,184,21,48290380,48290564
5188,6,12,1,2412,-55,-91,36,40:e3:d6:da:ba:24,48290800,176,60,48290624,48290800
5189,6,12,1,2412,-55,-91,36,40:e3:d6:da:ba:25,48291011,160,51,48290851,48291011
5190,6,6,1,2412,-55,-91,36,40:e3:d6:da:ba:26,48291203,380,-188,48290823,48291203
5191,4,1,1,2412,-64,-91,27,54:e4:3a:ec:fb:64,48300493,2160,7130,48298333,48300493
5192,4,1,1,2412,-91,-91,0,a6:e5:7c:28:b1:d3,48334584,944,33147,48333640,48334584
5193,4,1,1,2412,-65,-91,26,a6:e5:7c:28:b1:d3,48335662,944,134,48334718,48335662
5194,4,1,1,2412,-91,-91,0,a6:e5:7c:28:b1:d3,48337863,944,1257,48336919,48337863
5195,4,1,1,2412,-82,-91,9,a6:e5:7c:28:b1:d3,48341467,944,2660,48340523,48341467
5196,4,1,1,2412,-91,-91,0,a6:e5:7c:28:b1:d3,48344667,944,2256,48343723,48344667
5197,6,12,1,2412,-55,-91,36,40:e3:d6:da:ba:20,48392100,160,47273,48391940,48392100
5198,6,6,1,2412,-55,-91,36,40:e3:d6:da:ba:21,48392310,368,-158,48391942,48392310
5199,6,12,1,2412,-55,-91,36,40:e3:d6:da:ba:22,48392706,180,216,48392526,48392706
5200,6,12,1,2412,-54,-91,37,40:e3:d6:da:ba:23,48392911,184,21,48392727,48392911
5201,6,12,1,2412,-55,-91,36,40:e3:d6:da:ba:24,48393120,176,33,48392944,48393120
5202,6,12,1,2412,-55,-91,36,40:e3:d6:da:ba:25,48393331,160,51,48393171,48393331
5203,6,6,1,2412,-54,-91,37,40:e3:d6:da:ba:26,48393561,380,-150,48393181,48393561
5204,4,1,1,2412,-69,-91,22,54:e4:3a:ec:fb:64,48402869,2160,7148,48400709,48402869
5205,6,12,1,2412,-54,-91,37,40:e3:d6:da:ba:20,48494494,160,91465,48494334,48494494
5206,6,6,1,2412,-54,-91,37,40:e3:d6:da:ba:21,48494695,368,-167,48494327,48494695
5207,6,12,1,2412,-53,-91,38,40:e3:d6:da:ba:22,48495100,180,225,48494920,48495100
5208,4,1,1,2412,-70,-91,21,54:e4:3a:ec:fb:64,48505268,2160,8008,48503108,48505268
5209,6,6,1,2412,-83,-91,8,e6:aa:ea:c9:ea:1b,48558512,408,52836,48558104,48558512
5210,6,6,1,2412,-54,-91,37,e6:aa:ea:c9:ea:33,48576084,408,17164,48575676,48576084
5211,6,6,1,2412,-55,-91,36,e6:aa:ea:c9:ea:33,48588206,408,11714,48587798,48588206
5212,6,12,1,2412,-53,-91,38,40:e3:d6:da:ba:20,48596902,160,8536,48596742,48596902
5213,6,6,1,2412,-53,-91,38,40:e3:d6:da:ba:21,48597094,368,-176,48596726,48597094
5214,6,12,1,2412,-53,-91,38,40:e3:d6:da:ba:22,48597481,180,207,48597301,48597481
5215,6,12,1,2412,-53,-91,38,40:e3:d6:da:ba:23,48597686,184,21,48597502,48597686
5216,6,12,1,2412,-53,-91,38,40:e3:d6:da:ba:24,48597905,176,43,48597729,48597905
5217,6,12,1,2412,-53,-91,38,40:e3:d6:da:ba:25,48598106,160,41,48597946,48598106
5218,6,6,1,2412,-53,-91,38,40:e3:d6:da:ba:26,48598298,380,-188,48597918,48598298
5219,6,6,1,2412,-54,-91,37,e6:aa:ea:c9:ea:33,48600343,408,1637,48599935,48600343
5220,6,6,1,2412,-83,-91,8,e6:aa:ea:c9:ea:1b,48606969,408,6218,48606561,48606969
5221,6,6,1,2412,-55,-91,36,e6:aa:ea:c9:ea:33,48612427,408,5050,48612019,48612427
5222,6,12,1,2412,-87,-91,4,84:d4:7e:f2:42:20,48614863,160,2276,48614703,48614863
5223,6,6,1,2412,-88,-91,3,84:d4:7e:f2:42:21,48615055,368,-176,48614687,48615055
5224,6,6,1,2412,-87,-91,4,84:d4:7e:f2:42:26,48616318,380,883,48615938,48616318
5225,4,1,1,2412,-89,-91,2,c0:c9:e3:4d:6e:bf,48631852,872,14662,48630980,48631852
5226,4,1,1,2412,-87,-91,4,,48632741,304,585,48632437,48632741
5227,6,12,1,2412,-55,-91,36,40:e3:d6:da:ba:20,48699293,160,66392,48699133,48699293
5228,6,6,1,2412,-55,-91,36,40:e3:d6:da:ba:21,48699524,368,-137,48699156,48699524
5229,6,12,1,2412,-54,-91,37,40:e3:d6:da:ba:22,48699929,180,225,48699749,48699929
5230,6,12,1,2412,-54,-91,37,40:e3:d6:da:ba:23,48700143,184,30,48699959,48700143
5231,6,12,1,2412,-54,-91,37,40:e3:d6:da:ba:24,48700380,176,61,48700204,48700380
5232,6,12,1,2412,-55,-91,36,40:e3:d6:da:ba:25,48700581,160,41,48700421,48700581
5233,6,6,1,2412,-54,-91,37,40:e3:d6:da:ba:26,48700791,380,-170,48700411,48700791
5234,6,6,1,2412,-64,-91,27,e6:aa:ea:b7:4a:dd,48716198,408,14999,48715790,48716198
5235,6,6,1,2412,-64,-91,27,e6:aa:ea:b7:4a:dd,48728325,408,11719,48727917,48728325
5236,6,12,1,2412,-57,-91,34,40:e3:d6:da:ba:20,48802177,160,73692,48802017,48802177
5237,6,6,1,2412,-57,-91,34,40:e3:d6:da:ba:21,48802396,368,-149,48802028,48802396
5238,6,12,1,2412,-57,-91,34,40:e3:d6:da:ba:22,48802783,180,207,48802603,48802783
5239,6,12,1,2412,-57,-91,34,40:e3:d6:da:ba:23,48803016,184,49,48802832,48803016
5240,6,12,1,2412,-57,-91,34,40:e3:d6:da:ba:24,48803252,176,60,48803076,48803252
5241,6,12,1,2412,-57,-91,34,40:e3:d6:da:ba:25,48803454,160,42,48803294,48803454
5242,6,6,1,2412,-57,-91,34,40:e3:d6:da:ba:26,48803673,380,-161,48803293,48803673
5243,4,1,1,2412,-63,-91,28,54:e4:3a:ec:fb:64,48812550,2160,6717,48810390,48812550
5244,6,6,1,2412,-87,-91,4,84:d4:7e:f2:42:21,48819775,368,6857,48819407,48819775
5245,6,6,1,2412,-55,-91,36,e6:aa:ea:c9:ea:33,48878470,408,58287,48878062,48878470
5246,6,12,1,2412,-58,-91,33,40:e3:d6:da:ba:20,48904732,160,26102,48904572,48904732
5247,6,6,1,2412,-58,-91,33,40:e3:d6:da:ba:21,48904924,368,-176,48904556,48904924
5248,6,12,1,2412,-58,-91,33,40:e3:d6:da:ba:22,48905329,180,225,48905149,48905329
5249,6,12,1,2412,-58,-91,33,40:e3:d6:da:ba:24,48905972,176,467,48905796,48905972
5250,6,12,1,2412,-58,-91,33,40:e3:d6:da:ba:25,48906174,160,42,48906014,48906174
5251,6,6,1,2412,-58,-91,33,40:e3:d6:da:ba:26,48906365,380,-189,48905985,48906365
5252,6,6,1,2412,-54,-91,37,e6:aa:ea:c9:ea:33,48914822,408,8049,48914414,48914822
5253,6,12,1,2412,-88,-91,3,84:d4:7e:f2:42:23,48922901,180,7899,48922721,48922901
5254,6,6,1,2412,-53,-91,38,e6:aa:ea:c9:ea:33,48927006,408,3697,48926598,48927006
5255,6,6,1,2412,-78,-91,13,e6:aa:ea:c9:ea:1b,48993239,408,65825,48992831,48993239
5256,6,12,1,2412,-57,-91,34,40:e3:d6:da:ba:20,49007209,160,13810,49007049,49007209
5257,6,6,1,2412,-57,-91,34,40:e3:d6:da:ba:21,49007427,368,-150,49007059,49007427
5258,6,12,1,2412,-57,-91,34,40:e3:d6:da:ba:22,49007841,180,234,49007661,49007841
5259,6,12,1,2412,-56,-91,35,40:e3:d6:da:ba:24,49008416,176,399,49008240,49008416
5260,6,12,1,2412,-57,-91,34,40:e3:d6:da:ba:25,49008636,160,60,49008476,49008636
5261,6,6,1,2412,-57,-91,34,40:e3:d6:da:ba:26,49008846,380,-170,49008466,49008846
5262,4,1,1,2412,-63,-91,28,54:e4:3a:ec:fb:64,49017265,2160,6259,49015105,49017265
5263,6,12,1,2412,-85,-91,6,84:d4:7e:f2:42:22,49025183,180,7738,49025003,49025183
5264,6,12,1,2412,-86,-91,5,84:d4:7e:f2:42:23,49025388,180,25,49025208,49025388
5265,6,12,1,2412,-86,-91,5,84:d4:7e:f2:42:24,49025612,176,48,49025436,49025612
5266,6,12,1,2412,-85,-91,6,84:d4:7e:f2:42:25,49025839,160,67,49025679,49025839
5267,6,6,1,2412,-85,-91,6,84:d4:7e:f2:42:26,49026031,380,-188,49025651,49026031
5268,6,6,1,2412,-77,-91,14,e6:aa:ea:c9:ea:1b,49029578,408,3139,49029170,49029578
5269,6,12,1,2412,-54,-91,37,40:e3:d6:da:ba:20,49108890,160,79152,49108730,49108890
5270,6,12,1,2412,-54,-91,37,40:e3:d6:da:ba:22,49109505,180,435,49109325,49109505
5271,6,12,1,2412,-54,-91,37,40:e3:d6:da:ba:23,49109720,184,31,49109536,49109720
5272,6,12,1,2412,-54,-91,37,40:e3:d6:da:ba:24,49109929,176,33,49109753,49109929
5273,6,12,1,2412,-54,-91,37,40:e3:d6:da:ba:25,49110131,160,42,49109971,49110131
5274,6,6,1,2412,-54,-91,37,40:e3:d6:da:ba:26,49110341,380,-170,49109961,49110341
5275,4,1,1,2412,-63,-91,28,54:e4:3a:ec:fb:64,49119830,2160,7329,49117670,49119830
5276,6,6,1,2412,-85,-91,6,84:d4:7e:f2:42:21,49126969,368,6771,49126601,49126969
5277,6,12,1,2412,-85,-91,6,84:d4:7e:f2:42:22,49127365,180,216,49127185,49127365
5278,6,12,1,2412,-84,-91,7,84:d4:7e:f2:42:23,49127588,180,43,49127408,49127588
5279,6,12,1,2412,-86,-91,5,84:d4:7e:f2:42:24,49127794,176,30,49127618,49127794
5280,6,12,1,2412,-84,-91,7,84:d4:7e:f2:42:25,49128004,160,50,49127844,49128004
5281,6,6,1,2412,-61,-91,30,e6:aa:ea:b7:4a:dd,49198825,408,70413,49198417,49198825
5282,6,6,1,2412,-60,-91,31,e6:aa:ea:b7:4a:dd,49210942,408,11709,49210534,49210942
5283,6,12,1,2412,-55,-91,36,40:e3:d6:da:ba:20,49211388,160,286,49211228,49211388
5284,6,6,1,2412,-55,-91,36,40:e3:d6:da:ba:21,49211607,368,-149,49211239,49211607
5285,6,12,1,2412,-55,-91,36,40:e3:d6:da:ba:22,49212012,180,225,49211832,49212012
5286,6,12,1,2412,-55,-91,36,40:e3:d6:da:ba:23,49212217,184,21,49212033,49212217
5287,6,12,1,2412,-55,-91,36,40:e3:d6:da:ba:24,49212453,176,60,49212277,49212453
5288,6,12,1,2412,-55,-91,36,40:e3:d6:da:ba:25,49212682,160,69,49212522,49212682
5289,6,6,1,2412,-55,-91,36,40:e3:d6:da:ba:26,49212892,380,-170,49212512,49212892
5290,4,5.5,1,2412,-75,-91,16,48:74:12:82:d8:d5,49217457,443,4122,49217014,49217457
5291,4,1,1,2412,-67,-91,24,54:e4:3a:ec:fb:64,49218019,2112,-1550,49215907,49218019
5292,6,12,1,2412,-55,-91,36,40:e3:d6:da:ba:22,49228628,156,10453,49228472,49228628
5293,6,12,1,2412,-69,-91,22,,49228800,32,140,49228768,49228800
5294,6,12,1,2412,-55,-91,36,40:e3:d6:da:ba:23,49228868,156,-88,49228712,49228868
5295,6,12,1,2412,-69,-91,22,,49229040,32,140,49229008,49229040
5296,4,5.5,1,2412,-74,-91,17,48:74:12:82:d8:d5,49229279,448,-209,49228831,49229279
5297,6,12,1,2412,-56,-91,35,40:e3:d6:da:ba:25,49229587,136,172,49229451,49229587
5298,6,12,1,2412,-69,-91,22,,49229739,32,120,49229707,49229739
5299,6,6,1,2412,-87,-91,4,84:d4:7e:f2:42:21,49229787,368,-320,49229419,49229787
5300,4,1,1,2412,-68,-91,23,54:e4:3a:ec:fb:64,49230684,2112,-1215,49228572,49230684
5301,4,5.5,1,2412,-74,-91,17,48:74:12:82:d8:d5,49232754,473,1597,49232281,49232754
5302,6,6,1,2412,-65,-91,26,e6:aa:ea:b7:4a:dd,49235164,408,2002,49234756,49235164
5303,4,5.5,1,2412,-74,-91,17,48:74:12:82:d8:d5,49236023,457,402,49235566,49236023
5304,6,12,1,2412,-55,-91,36,40:e3:d6:da:ba:23,49236441,156,262,49236285,49236441
5305,6,12,1,2412,-69,-91,22,,49236614,32,141,49236582,49236614
5306,6,12,1,2412,-69,-91,22,,49236857,32,211,49236825,49236857
5307,4,5.5,1,2412,-73,-91,18,48:74:12:82:d8:d5,49243171,460,5854,49242711,49243171
5308,4,5.5,1,2412,-74,-91,17,48:74:12:82:d8:d5,49245092,459,1462,49244633,49245092
5309,4,5.5,1,2412,-72,-91,19,48:74:12:82:d8:d5,49246485,466,927,49246019,49246485
5310,6,6,1,2412,-65,-91,26,e6:aa:ea:b7:4a:dd,49247308,408,415,49246900,49247308
5311,4,5.5,1,2412,-61,-91,30,48:74:12:82:d8:d5,49247836,460,68,49247376,49247836
5312,4,5.5,1,2412,-73,-91,18,48:74:12:82:d8:d5,49249451,459,1156,49248992,49249451
5313,4,1,1,2412,-72,-91,19,48:74:12:82:d8:d5,49255454,1568,4435,49253886,49255454
5314,6,12,1,2412,-55,-91,36,40:e3:d6:da:ba:20,49258012,136,2422,49257876,49258012
5315,6,12,1,2412,-55,-91,36,40:e3:d6:da:ba:22,49258619,156,451,49258463,49258619
5316,6,12,1,2412,-54,-91,37,40:e3:d6:da:ba:23,49258818,156,43,49258662,49258818
5317,6,12,1,2412,-54,-91,37,40:e3:d6:da:ba:25,49259009,136,55,49258873,49259009
5318,4,1,1,2412,-68,-91,23,54:e4:3a:ec:fb:64,49259405,2112,-1716,49257293,49259405
5319,4,1,1,2412,-69,-91,22,54:e4:3a:ec:fb:64,49267617,2112,6100,49265505,49267617
5320,6,6,1,2412,-53,-91,38,e6:aa:ea:c9:ea:33,49296001,408,27976,49295593,49296001
5321,6,6,1,2412,-53,-91,38,e6:aa:ea:c9:ea:33,49308111,408,11702,49307703,49308111
5322,6,12,1,2412,-53,-91,38,40:e3:d6:da:ba:20,49313734,160,5463,49313574,49313734
5323,6,6,1,2412,-53,-91,38,40:e3:d6:da:ba:21,49313926,368,-176,49313558,49313926
5324,6,12,1,2412,-53,-91,38,40:e3:d6:da:ba:22,49314322,180,216,49314142,49314322
5325,6,12,1,2412,-53,-91,38,40:e3:d6:da:ba:23,49314537,184,31,49314353,49314537
5326,6,12,1,2412,-53,-91,38,40:e3:d6:da:ba:24,49314746,176,33,49314570,49314746
5327,6,12,1,2412,-53,-91,38,40:e3:d6:da:ba:25,49314948,160,42,49314788,49314948
5328,6,6,1,2412,-53,-91,38,40:e3:d6:da:ba:26,49315139,380,-189,49314759,49315139
5329,6,6,1,2412,-53,-91,38,e6:aa:ea:c9:ea:33,49320242,408,4695,49319834,49320242
5330,6,6,1,2412,-81,-91,10,e6:aa:ea:c9:ea:1b,49322338,408,1688,49321930,49322338
5331,4,1,1,2412,-57,-91,34,54:e4:3a:ec:fb:64,49324462,2160,-36,49322302,49324462
5332,6,6,1,2412,-52,-91,39,e6:aa:ea:c9:ea:33,49332345,408,7475,49331937,49332345
5333,6,12,1,2412,-87,-91,4,84:d4:7e:f2:42:25,49332893,160,388,49332733,49332893
5334,6,6,1,2412,-82,-91,9,e6:aa:ea:c9:ea:1b,49334544,408,1243,49334136,49334544
5335,6,6,1,2412,-52,-91,39,e6:aa:ea:c9:ea:33,49345371,408,10419,49344963,49345371
5336,6,12,1,2412,-55,-91,36,40:e3:d6:da:ba:20,49416104,160,70573,49415944,49416104
5337,6,6,1,2412,-55,-91,36,40:e3:d6:da:ba:21,49416296,368,-176,49415928,49416296
5338,6,12,1,2412,-55,-91,36,40:e3:d6:da:ba:22,49416701,180,225,49416521,49416701
5339,6,12,1,2412,-55,-91,36,40:e3:d6:da:ba:23,49416934,184,49,49416750,49416934
5340,6,12,1,2412,-55,-91,36,40:e3:d6:da:ba:24,49417143,176,33,49416967,49417143
5341,6,12,1,2412,-55,-91,36,40:e3:d6:da:ba:25,49417353,160,50,49417193,49417353
5342,6,6,1,2412,-55,-91,36,40:e3:d6:da:ba:26,49417572,380,-161,49417192,49417572
5343,4,1,1,2412,-71,-91,20,54:e4:3a:ec:fb:64,49426860,2160,7128,49424700,49426860
5344,6,6,1,2412,-88,-91,3,84:d4:7e:f2:42:21,49434195,368,6967,49433827,49434195
5345,6,12,1,2412,-54,-91,37,40:e3:d6:da:ba:20,49518501,160,84146,49518341,49518501
5346,6,6,1,2412,-53,-91,38,40:e3:d6:da:ba:21,49518720,368,-149,49518352,49518720
5347,6,12,1,2412,-53,-91,38,40:e3:d6:da:ba:22,49519107,180,207,49518927,49519107
5348,6,12,1,2412,-53,-91,38,40:e3:d6:da:ba:23,49519322,184,31,49519138,49519322
5349,6,12,1,2412,-53,-91,38,40:e3:d6:da:ba:24,49519531,176,33,49519355,49519531
5350,6,12,1,2412,-53,-91,38,40:e3:d6:da:ba:25,49519742,160,51,49519582,49519742
5351,6,6,1,2412,-53,-91,38,40:e3:d6:da:ba:26,49519943,380,-179,49519563,49519943
5352,6,12,1,2412,-86,-91,5,84:d4:7e:f2:42:20,49536443,160,16340,49536283,49536443
5353,6,6,1,2412,-86,-91,5,84:d4:7e:f2:42:21,49536643,368,-168,49536275,49536643
5354,6,12,1,2412,-87,-91,4,84:d4:7e:f2:42:22,49537031,180,208,49536851,49537031
5355,6,12,1,2412,-85,-91,6,84:d4:7e:f2:42:24,49537468,176,261,49537292,49537468
5356,6,12,1,2412,-86,-91,5,84:d4:7e:f2:42:25,49537670,160,42,49537510,49537670
5357,6,6,1,2412,-67,-91,24,e6:aa:ea:b7:4a:dd,49550115,408,12037,49549707,49550115
5358,6,6,1,2412,-67,-91,24,e6:aa:ea:b7:4a:dd,49562427,408,11904,49562019,49562427
5359,6,12,1,2412,-51,-91,40,40:e3:d6:da:ba:20,49624262,160,61675,49624102,49624262
5360,6,6,1,2412,-51,-91,40,40:e3:d6:da:ba:21,49624463,368,-167,49624095,49624463
5361,6,12,1,2412,-51,-91,40,40:e3:d6:da:ba:22,49624859,180,216,49624679,49624859
5362,6,12,1,2412,-51,-91,40,40:e3:d6:da:ba:23,49625073,184,30,49624889,49625073
5363,6,12,1,2412,-51,-91,40,40:e3:d6:da:ba:24,49626771,176,1522,49626595,49626771
5364,6,6,1,2412,-51,-91,40,40:e3:d6:da:ba:26,49627173,380,22,49626793,49627173
5365,6,6,1,2412,-81,-91,10,e6:aa:ea:c9:ea:1b,49627979,408,398,49627571,49627979
5366,6,6,1,2412,-49,-91,42,e6:aa:ea:c9:ea:33,49635398,408,7011,49634990,49635398
5367,6,12,1,2412,-89,-91,2,84:d4:7e:f2:42:24,49639791,176,4217,49639615,49639791
5368,6,6,1,2412,-49,-91,42,e6:aa:ea:c9:ea:33,49647517,408,7318,49647109,49647517
5369,6,6,1,2412,-49,-91,42,e6:aa:ea:c9:ea:33,49659635,408,11710,49659227,49659635
5370,6,6,1,2412,-84,-91,7,e6:aa:ea:c9:ea:1b,49664322,408,4279,49663914,49664322
5371,6,12,1,2412,-52,-91,39,40:e3:d6:da:ba:20,49723289,160,58807,49723129,49723289
5372,6,6,1,2412,-52,-91,39,40:e3:d6:da:ba:21,49723481,368,-176,49723113,49723481
5373,6,12,1,2412,-52,-91,39,40:e3:d6:da:ba:22,49724040,180,379,49723860,49724040
5374,6,12,1,2412,-52,-91,39,40:e3:d6:da:ba:23,49724246,184,22,49724062,49724246
5375,6,12,1,2412,-51,-91,40,40:e3:d6:da:ba:25,49724684,160,278,49724524,49724684
5376,6,6,1,2412,-52,-91,39,40:e3:d6:da:ba:26,49724876,380,-188,49724496,49724876
5377,6,6,1,2412,-87,-91,4,84:d4:7e:f2:42:21,49754316,348,29092,49753968,49754316
5378,6,12,1,2412,-54,-91,37,40:e3:d6:da:ba:20,49827776,160,73300,49827616,49827776
5379,6,12,1,2412,-54,-91,37,40:e3:d6:da:ba:24,49829128,176,1176,49828952,49829128
5380,6,12,1,2412,-55,-91,36,40:e3:d6:da:ba:25,49829371,160,83,49829211,49829371
5381,6,6,1,2412,-62,-91,29,e6:aa:ea:b7:4a:dd,49840728,408,10949,49840320,49840728
5382,6,12,1,2412,-89,-91,2,84:d4:7e:f2:42:23,49844384,180,3476,49844204,49844384
5383,6,12,1,2412,-87,-91,4,84:d4:7e:f2:42:25,49844818,160,274,49844658,49844818
5384,6,6,1,2412,-64,-91,27,e6:aa:ea:b7:4a:dd,49864960,408,19734,49864552,49864960
5385,6,6,1,2412,-64,-91,27,e6:aa:ea:b7:4a:dd,49877076,408,11708,49876668,49877076
5386,4,1,1,2412,-74,-91,17,,49922489,304,45109,49922185,49922489
5387,6,12,1,2412,-54,-91,37,40:e3:d6:da:ba:20,49928095,160,5446,49927935,49928095
5388,6,6,1,2412,-54,-91,37,40:e3:d6:da:ba:21,49928314,368,-149,49927946,49928314
5389,6,12,1,2412,-54,-91,37,40:e3:d6:da:ba:22,49928728,180,234,49928548,49928728
5390,6,12,1,2412,-54,-91,37,40:e3:d6:da:ba:23,49928960,184,48,49928776,49928960
5391,6,12,1,2412,-54,-91,37,40:e3:d6:da:ba:24,49929196,176,60,49929020,49929196
5392,6,12,1,2412,-54,-91,37,40:e3:d6:da:ba:25,49929398,160,42,49929238,49929398
5393,6,6,1,2412,-54,-91,37,40:e3:d6:da:ba:26,49929599,380,-179,49929219,49929599
5394,4,1,1,2412,-85,-91,6,,49946163,304,16260,49945859,49946163
5395,4,1,1,2412,-60,-91,31,24:f6:77:10:02:c8,49997753,1064,50526,49996689,49997753
5396,4,1,1,2412,-57,-91,34,a6:e5:7c:28:b1:d3,50003964,992,5219,50002972,50003964
5397,6,6,1,2412,-53,-91,38,,50010050,44,6042,50010006,50010050
5398,6,12,1,2412,-55,-91,36,40:e3:d6:da:ba:20,50030510,160,20300,50030350,50030510
5399,6,6,1,2412,-55,-91,36,40:e3:d6:da:ba:21,50030702,368,-176,50030334,50030702
5400,6,12,1,2412,-55,-91,36,40:e3:d6:da:ba:22,50031116,180,234,50030936,50031116
5401,6,12,1,2412,-55,-91,36,40:e3:d6:da:ba:23,50031331,184,31,50031147,50031331
5402,6,12,1,2412,-56,-91,35,40:e3:d6:da:ba:25,50034304,160,2813,50034144,50034304
5403,6,6,1,2412,-55,-91,36,40:e3:d6:da:ba:26,50034523,380,-161,50034143,50034523
5404,6,6,1,2412,-53,-91,38,,50035052,44,485,50035008,50035052
5405,6,6,1,2412,-52,-91,39,,50110048,44,74952,50110004,50110048
5406,6,6,1,2412,-49,-91,42,e6:aa:ea:c9:ea:33,50133131,408,22675,50132723,50133131
5407,6,12,1,2412,-55,-91,36,40:e3:d6:da:ba:22,50133574,180,263,50133394,50133574
5408,6,12,1,2412,-55,-91,36,40:e3:d6:da:ba:23,50133788,184,30,50133604,50133788
5409,6,12,1,2412,-55,-91,36,40:e3:d6:da:ba:24,50134016,176,52,50133840,50134016
5410,6,12,1,2412,-55,-91,36,40:e3:d6:da:ba:25,50134235,160,59,50134075,50134235
5411,6,6,1,2412,-55,-91,36,40:e3:d6:da:ba:26,50134445,380,-170,50134065,50134445
5412,6,6,1,2412,-49,-91,42,e6:aa:ea:c9:ea:33,50143382,408,8529,50142974,50143382
5413,4,1,1,2412,-67,-91,24,54:e4:3a:ec:fb:64,50143981,2160,-1561,50141821,50143981
5414,6,6,1,2412,-48,-91,43,e6:aa:ea:c9:ea:33,50167613,408,23224,50167205,50167613
5415,6,6,1,2412,-81,-91,10,e6:aa:ea:c9:ea:1b,50186399,408,18378,50185991,50186399
5416,6,12,1,2412,-57,-91,34,40:e3:d6:da:ba:20,50235313,160,48754,50235153,50235313
5417,6,6,1,2412,-57,-91,34,40:e3:d6:da:ba:21,50235514,368,-167,50235146,50235514
5418,6,12,1,2412,-56,-91,35,40:e3:d6:da:ba:22,50235918,180,224,50235738,50235918
5419,6,12,1,2412,-57,-91,34,40:e3:d6:da:ba:23,50236133,184,31,50235949,50236133
5420,6,12,1,2412,-57,-91,34,40:e3:d6:da:ba:24,50236352,176,43,50236176,50236352
5421,6,12,1,2412,-57,-91,34,40:e3:d6:da:ba:25,50236562,160,50,50236402,50236562
5422,6,6,1,2412,-57,-91,34,40:e3:d6:da:ba:26,50236781,380,-161,50236401,50236781
5423,6,12,1,2412,-88,-91,3,84:d4:7e:f2:42:20,50253290,160,16349,50253130,50253290
5424,6,12,1,2412,-86,-91,5,84:d4:7e:f2:42:22,50253887,180,417,50253707,50253887
5425,6,12,1,2412,-87,-91,4,84:d4:7e:f2:42:23,50254092,180,25,50253912,50254092
5426,6,12,1,2412,-88,-91,3,84:d4:7e:f2:42:25,50254517,160,265,50254357,50254517
5427,6,6,1,2412,-86,-91,5,84:d4:7e:f2:42:26,50254727,380,-170,50254347,50254727
5428,6,12,1,2412,-55,-91,36,40:e3:d6:da:ba:20,50338019,160,83132,50337859,50338019
5429,6,6,1,2412,-55,-91,36,40:e3:d6:da:ba:21,50338229,368,-158,50337861,50338229
5430,6,12,1,2412,-55,-91,36,40:e3:d6:da:ba:22,50338643,180,234,50338463,50338643
5431,6,12,1,2412,-55,-91,36,40:e3:d6:da:ba:23,50338866,184,39,50338682,50338866
5432,6,12,1,2412,-55,-91,36,40:e3:d6:da:ba:24,50339103,176,61,50338927,50339103
5433,6,12,1,2412,-55,-91,36,40:e3:d6:da:ba:25,50339313,160,50,50339153,50339313
5434,6,6,1,2412,-55,-91,36,40:e3:d6:da:ba:26,50339514,380,-179,50339134,50339514
5435,6,12,1,2412,-84,-91,7,84:d4:7e:f2:42:20,50356278,160,16604,50356118,50356278
5436,6,6,1,2412,-86,-91,5,84:d4:7e:f2:42:21,50356470,368,-176,50356102,50356470
5437,6,12,1,2412,-86,-91,5,84:d4:7e:f2:42:23,50357072,180,422,50356892,50357072
5438,6,12,1,2412,-87,-91,4,84:d4:7e:f2:42:24,50357295,176,47,50357119,50357295
5439,6,12,1,2412,-86,-91,5,84:d4:7e:f2:42:25,50357506,160,51,50357346,50357506
5440,6,6,1,2412,-85,-91,6,84:d4:7e:f2:42:26,50357697,380,-189,50357317,50357697
5441,6,12,1,2412,-56,-91,35,40:e3:d6:da:ba:20,50440092,160,82235,50439932,50440092
5442,6,6,1,2412,-56,-91,35,40:e3:d6:da:ba:21,50440293,368,-167,50439925,50440293
5443,6,12,1,2412,-56,-91,35,40:e3:d6:da:ba:22,50440689,180,216,50440509,50440689
5444,6,12,1,2412,-56,-91,35,40:e3:d6:da:ba:23,50440895,184,22,50440711,50440895
5445,6,12,1,2412,-56,-91,35,40:e3:d6:da:ba:24,50441122,176,51,50440946,50441122
5446,6,12,1,2412,-56,-91,35,40:e3:d6:da:ba:25,50441324,160,42,50441164,50441324
5447,6,6,1,2412,-55,-91,36,40:e3:d6:da:ba:26,50441516,380,-188,50441136,50441516
5448,6,6,1,2412,-67,-91,24,e6:aa:ea:b7:4a:dd,50458971,408,17047,50458563,50458971
5449,6,6,1,2412,-68,-91,23,e6:aa:ea:b7:4a:dd,50471092,408,11713,50470684,50471092
5450,6,6,1,2412,-85,-91,6,e6:aa:ea:c9:ea:1b,50479209,408,7709,50478801,50479209
5451,6,6,1,2412,-84,-91,7,e6:aa:ea:c9:ea:1b,50491318,408,11701,50490910,50491318
5452,6,6,1,2412,-84,-91,7,e6:aa:ea:c9:ea:1b,50503472,408,11746,50503064,50503472
5453,6,6,1,2412,-67,-91,24,e6:aa:ea:b7:4a:dd,50507447,408,3567,50507039,50507447
5454,4,1,1,2412,-88,-91,3,a6:e5:7c:28:b1:d3,50515706,992,7267,50514714,50515706
5455,6,12,1,2412,-58,-91,33,40:e3:d6:da:ba:20,50543067,160,27201,50542907,50543067
5456,6,6,1,2412,-58,-91,33,40:e3:d6:da:ba:21,50543268,368,-167,50542900,50543268
5457,6,12,1,2412,-58,-91,33,40:e3:d6:da:ba:22,50543744,180,296,50543564,50543744
5458,6,12,1,2412,-58,-91,33,40:e3:d6:da:ba:23,50543977,184,49,50543793,50543977
5459,6,12,1,2412,-58,-91,33,40:e3:d6:da:ba:24,50544195,176,42,50544019,50544195
5460,6,12,1,2412,-58,-91,33,40:e3:d6:da:ba:25,50544406,160,51,50544246,50544406
5461,6,6,1,2412,-58,-91,33,40:e3:d6:da:ba:26,50544598,380,-188,50544218,50544598
5462,4,1,1,2412,-63,-91,28,54:e4:3a:ec:fb:64,50553363,2160,6605,50551203,50553363
5463,4,1,1,2412,-82,-91,9,70:bc:10:5f:b5:61,50572934,808,18763,50572126,50572934
5464,4,1,1,2412,-81,-91,10,70:bc:10:5f:b5:61,50573830,808,88,50573022,50573830
5465,6,12,1,2412,-58,-91,33,40:e3:d6:da:ba:20,50574626,136,660,50574490,50574626
5466,6,6,1,2412,-58,-91,33,40:e3:d6:da:ba:21,50574820,348,-154,50574472,50574820
5467,6,12,1,2412,-57,-91,34,40:e3:d6:da:ba:22,50575197,156,221,50575041,50575197
5468,6,12,1,2412,-75,-91,16,,50575349,32,120,50575317,50575349
5469,6,12,1,2412,-57,-91,34,40:e3:d6:da:ba:23,50575387,156,-118,50575231,50575387
5470,6,12,1,2412,-57,-91,34,40:e3:d6:da:ba:25,50575586,136,63,50575450,50575586
5471,6,12,1,2412,-76,-91,15,,50575824,32,206,50575792,50575824
5472,6,12,1,2412,-75,-91,16,,50576070,32,214,50576038,50576070
5473,4,1,1,2412,-61,-91,30,54:e4:3a:ec:fb:64,50586815,2112,8633,50584703,50586815
5474,4,1,1,2412,-83,-91,8,,50588940,304,1821,50588636,50588940
5475,4,1,1,2412,-89,-91,2,c0:c9:e3:4d:6e:bf,50598958,872,9146,50598086,50598958
5476,4,1,1,2412,-84,-91,7,,50599846,304,584,50599542,50599846
5477,6,12,1,2412,-56,-91,35,40:e3:d6:da:ba:20,50645102,160,45096,50644942,50645102
5478,6,6,1,2412,-56,-91,35,40:e3:d6:da:ba:21,50645294,368,-176,50644926,50645294
5479,6,12,1,2412,-56,-91,35,40:e3:d6:da:ba:22,50645681,180,207,50645501,50645681
5480,6,12,1,2412,-56,-91,35,40:e3:d6:da:ba:23,50645904,184,39,50645720,50645904
5481,6,12,1,2412,-56,-91,35,40:e3:d6:da:ba:24,50646140,176,60,50645964,50646140
5482,6,12,1,2412,-56,-91,35,40:e3:d6:da:ba:25,50646360,160,60,50646200,50646360
5483,6,6,1,2412,-56,-91,35,40:e3:d6:da:ba:26,50646552,380,-188,50646172,50646552
5484,6,6,1,2412,-56,-91,35,e6:aa:ea:c9:ea:33,50664155,408,17195,50663747,50664155
5485,6,6,1,2412,-56,-91,35,e6:aa:ea:c9:ea:33,50676261,408,11698,50675853,50676261
5486,6,6,1,2412,-57,-91,34,e6:aa:ea:c9:ea:33,50688408,408,11739,50688000,50688408
5487,6,6,1,2412,-55,-91,36,e6:aa:ea:c9:ea:33,50700583,408,11767,50700175,50700583
5488,6,12,1,2412,-56,-91,35,40:e3:d6:da:ba:20,50747293,160,46550,50747133,50747293
5489,6,6,1,2412,-56,-91,35,40:e3:d6:da:ba:21,50747503,368,-158,50747135,50747503
5490,6,12,1,2412,-56,-91,35,40:e3:d6:da:ba:20,50849694,160,102031,50849534,50849694
5491,6,6,1,2412,-56,-91,35,40:e3:d6:da:ba:21,50849886,368,-176,50849518,50849886
5492,6,12,1,2412,-56,-91,35,40:e3:d6:da:ba:22,50850300,180,234,50850120,50850300
5493,6,12,1,2412,-56,-91,35,40:e3:d6:da:ba:23,50850532,184,48,50850348,50850532
5494,6,12,1,2412,-55,-91,36,40:e3:d6:da:ba:24,50850769,176,61,50850593,50850769
5495,6,12,1,2412,-55,-91,36,40:e3:d6:da:ba:25,50850997,160,68,50850837,50850997
5496,6,6,1,2412,-55,-91,36,40:e3:d6:da:ba:26,50851198,380,-179,50850818,50851198
5497,4,1,1,2412,-69,-91,22,54:e4:3a:ec:fb:64,50860449,2160,7091,50858289,50860449
5498,6,6,1,2412,-66,-91,25,e6:aa:ea:b7:4a:dd,50876403,408,15546,50875995,50876403
5499,6,6,1,2412,-79,-91,12,e6:aa:ea:c9:ea:1b,50886958,408,10147,50886550,50886958
5500,6,6,1,2412,-67,-91,24,e6:aa:ea:b7:4a:dd,50900643,408,13277,50900235,50900643
5501,6,6,1,2412,-78,-91,13,e6:aa:ea:c9:ea:1b,50923307,408,22256,50922899,50923307
5502,6,6,1,2412,-67,-91,24,e6:aa:ea:b7:4a:dd,50924885,408,1170,50924477,50924885
5503,6,12,1,2412,-57,-91,34,40:e3:d6:da:ba:20,50952095,160,27050,50951935,50952095
5504,6,6,1,2412,-57,-91,34,40:e3:d6:da:ba:21,50952296,368,-167,50951928,50952296
5505,6,12,1,2412,-57,-91,34,40:e3:d6:da:ba:22,50952692,180,216,50952512,50952692
5506,6,12,1,2412,-57,-91,34,40:e3:d6:da:ba:23,50952906,184,30,50952722,50952906
5507,6,12,1,2412,-57,-91,34,40:e3:d6:da:ba:24,50953143,176,61,50952967,50953143
5508,6,12,1,2412,-57,-91,34,40:e3:d6:da:ba:25,50953353,160,50,50953193,50953353
5509,6,6,1,2412,-57,-91,34,40:e3:d6:da:ba:26,50953563,380,-170,50953183,50953563
5510,6,6,1,2412,-56,-91,35,e6:aa:ea:c9:ea:33,50967494,408,13523,50967086,50967494
5511,6,6,1,2412,-56,-91,35,e6:aa:ea:c9:ea:33,50979466,408,11564,50979058,50979466
5512,6,6,1,2412,-56,-91,35,e6:aa:ea:c9:ea:33,50991581,408,11707,50991173,50991581
5513,6,6,1,2412,-57,-91,34,e6:aa:ea:c9:ea:33,51003715,408,11726,51003307,51003715
5514,6,6,1,2412,-57,-92,35,e6:aa:ea:c9:ea:33,51015819,408,11696,51015411,51015819
5515,6,12,1,2412,-58,-92,34,40:e3:d6:da:ba:20,51054502,160,38523,51054342,51054502
5516,6,6,1,2412,-58,-92,34,40:e3:d6:da:ba:21,51054721,368,-149,51054353,51054721
5517,6,12,1,2412,-58,-92,34,40:e3:d6:da:ba:22,51055126,180,225,51054946,51055126
5518,6,12,1,2412,-58,-92,34,40:e3:d6:da:ba:23,51055340,184,30,51055156,51055340
5519,6,12,1,2412,-58,-92,34,40:e3:d6:da:ba:24,51055559,176,43,51055383,51055559
5520,6,12,1,2412,-58,-92,34,40:e3:d6:da:ba:25,51055787,160,68,51055627,51055787
5521,6,6,1,2412,-58,-92,34,40:e3:d6:da:ba:26,51055997,380,-170,51055617,51055997
5522,4,1,1,2412,-71,-92,21,54:e4:3a:ec:fb:64,51065247,2160,7090,51063087,51065247
5523,4,1,1,2412,-88,-92,4,b8:3a:5a:88:e6:e1,51070170,2376,2547,51067794,51070170
5524,6,12,1,2412,-57,-92,35,40:e3:d6:da:ba:20,51156896,160,86566,51156736,51156896
5525,6,6,1,2412,-56,-92,36,40:e3:d6:da:ba:21,51157106,368,-158,51156738,51157106
5526,6,12,1,2412,-57,-92,35,40:e3:d6:da:ba:22,51157493,180,207,51157313,51157493
5527,6,12,1,2412,-57,-92,35,40:e3:d6:da:ba:23,51157707,184,30,51157523,51157707
5528,6,12,1,2412,-57,-92,35,40:e3:d6:da:ba:24,51157944,176,61,51157768,51157944
5529,6,12,1,2412,-57,-92,35,40:e3:d6:da:ba:25,51158145,160,41,51157985,51158145
5530,6,6,1,2412,-57,-92,35,40:e3:d6:da:ba:26,51158355,380,-170,51157975,51158355
5531,4,1,1,2412,-71,-92,21,54:e4:3a:ec:fb:64,51167646,2160,7131,51165486,51167646
5532,6,6,1,2412,-67,-92,25,e6:aa:ea:b7:4a:dd,51203686,408,35632,51203278,51203686
5533,6,6,1,2412,-84,-92,8,e6:aa:ea:c9:ea:1b,51206242,408,2148,51205834,51206242
5534,6,6,1,2412,-67,-92,25,e6:aa:ea:b7:4a:dd,51215804,408,9154,51215396,51215804
5535,6,6,1,2412,-67,-92,25,e6:aa:ea:b7:4a:dd,51240033,408,23821,51239625,51240033
5536,6,12,1,2412,-55,-92,37,40:e3:d6:da:ba:20,51259405,160,19212,51259245,51259405
5537,6,6,1,2412,-55,-92,37,40:e3:d6:da:ba:21,51259606,368,-167,51259238,51259606
5538,6,12,1,2412,-55,-92,37,40:e3:d6:da:ba:22,51259993,180,207,51259813,51259993
5539,6,12,1,2412,-55,-92,37,40:e3:d6:da:ba:23,51260208,184,31,51260024,51260208
5540,6,12,1,2412,-55,-92,37,40:e3:d6:da:ba:24,51260435,176,51,51260259,51260435
5541,6,12,1,2412,-54,-92,38,40:e3:d6:da:ba:25,51260654,160,59,51260494,51260654
5542,6,6,1,2412,-55,-92,37,40:e3:d6:da:ba:26,51260873,380,-161,51260493,51260873
5543,6,12,1,2412,-53,-92,39,40:e3:d6:da:ba:20,51361696,160,100663,51361536,51361696
5544,6,12,1,2412,-53,-92,39,40:e3:d6:da:ba:22,51362293,180,417,51362113,51362293
5545,6,12,1,2412,-53,-92,39,40:e3:d6:da:ba:23,51362525,184,48,51362341,51362525
5546,6,12,1,2412,-53,-92,39,40:e3:d6:da:ba:24,51362735,176,34,51362559,51362735
5547,6,12,1,2412,-53,-92,39,40:e3:d6:da:ba:25,51362954,160,59,51362794,51362954
5548,6,6,1,2412,-53,-92,39,40:e3:d6:da:ba:26,51363146,380,-188,51362766,51363146
5549,4,1,1,2412,-71,-92,21,54:e4:3a:ec:fb:64,51372485,2160,7179,51370325,51372485
5550,6,12,1,2412,-52,-92,40,40:e3:d6:da:ba:20,51464345,160,91700,51464185,51464345
5551,6,6,1,2412,-52,-92,40,40:e3:d6:da:ba:21,51464555,368,-158,51464187,51464555
5552,6,12,1,2412,-53,-92,39,40:e3:d6:da:ba:22,51464960,180,225,51464780,51464960
5553,6,12,1,2412,-53,-92,39,40:e3:d6:da:ba:23,51465174,184,30,51464990,51465174
5554,6,12,1,2412,-52,-92,40,40:e3:d6:da:ba:24,51465393,176,43,51465217,51465393
5555,6,12,1,2412,-52,-92,40,40:e3:d6:da:ba:25,51465612,160,59,51465452,51465612
5556,6,6,1,2412,-52,-92,40,40:e3:d6:da:ba:26,51465858,380,-134,51465478,51465858
5557,4,1,1,2412,-71,-92,21,54:e4:3a:ec:fb:64,51474843,2160,6825,51472683,51474843
5558,6,6,1,2412,-55,-92,37,e6:aa:ea:c9:ea:33,51487398,408,12147,51486990,51487398
5559,6,6,1,2412,-55,-92,37,e6:aa:ea:c9:ea:33,51499507,408,11701,51499099,51499507
5560,6,6,1,2412,-55,-92,37,e6:aa:ea:c9:ea:33,51511624,408,11709,51511216,51511624
5561,6,6,1,2412,-81,-92,11,e6:aa:ea:c9:ea:1b,51512215,408,183,51511807,51512215
5562,6,6,1,2412,-55,-92,37,e6:aa:ea:c9:ea:33,51523747,408,11124,51523339,51523747
5563,6,6,1,2412,-81,-92,11,e6:aa:ea:c9:ea:1b,51524336,408,181,51523928,51524336
5564,6,6,1,2412,-54,-92,38,e6:aa:ea:c9:ea:33,51535854,408,11110,51535446,51535854
5565,6,6,1,2412,-81,-92,11,e6:aa:ea:c9:ea:1b,51536475,408,213,51536067,51536475
5566,6,6,1,2412,-81,-92,11,e6:aa:ea:c9:ea:1b,51548561,408,11678,51548153,51548561
5567,6,12,1,2412,-52,-92,40,40:e3:d6:da:ba:20,51568041,160,19320,51567881,51568041
5568,6,12,1,2412,-52,-92,40,40:e3:d6:da:ba:22,51568656,180,435,51568476,51568656
5569,6,12,1,2412,-52,-92,40,40:e3:d6:da:ba:23,51568871,184,31,51568687,51568871
5570,6,12,1,2412,-52,-92,40,40:e3:d6:da:ba:24,51569259,176,212,51569083,51569259
5571,6,12,1,2412,-52,-92,40,40:e3:d6:da:ba:25,51569478,160,59,51569318,51569478
5572,6,6,1,2412,-52,-92,40,40:e3:d6:da:ba:26,51569688,380,-170,51569308,51569688
5573,4,1,1,2412,-72,-92,20,54:e4:3a:ec:fb:64,51577243,2160,5395,51575083,51577243
5574,6,6,1,2412,-63,-92,29,e6:aa:ea:b7:4a:dd,51645364,408,67713,51644956,51645364
5575,6,6,1,2412,-63,-92,29,e6:aa:ea:b7:4a:dd,51657490,408,11718,51657082,51657490
5576,6,12,1,2412,-51,-92,41,40:e3:d6:da:ba:20,51668910,160,11260,51668750,51668910
5577,6,6,1,2412,-51,-92,41,40:e3:d6:da:ba:21,51669102,368,-176,51668734,51669102
5578,6,12,1,2412,-51,-92,41,40:e3:d6:da:ba:22,51669516,180,234,51669336,51669516
5579,6,12,1,2412,-51,-92,41,40:e3:d6:da:ba:23,51669721,184,21,51669537,51669721
5580,6,12,1,2412,-51,-92,41,40:e3:d6:da:ba:24,51669931,176,34,51669755,51669931
5581,6,12,1,2412,-51,-92,41,40:e3:d6:da:ba:25,51670141,160,50,51669981,51670141
5582,6,6,1,2412,-51,-92,41,40:e3:d6:da:ba:26,51670333,380,-188,51669953,51670333
5583,4,1,1,2412,-73,-92,19,54:e4:3a:ec:fb:64,51679641,2160,7148,51677481,51679641
5584,6,12,1,2412,-51,-92,41,40:e3:d6:da:ba:20,51771308,160,91507,51771148,51771308
5585,6,6,1,2412,-51,-92,41,40:e3:d6:da:ba:21,51771509,368,-167,51771141,51771509
5586,6,12,1,2412,-51,-92,41,40:e3:d6:da:ba:22,51771896,180,207,51771716,51771896
5587,6,12,1,2412,-51,-92,41,40:e3:d6:da:ba:23,51772119,184,39,51771935,51772119
5588,6,12,1,2412,-51,-92,41,40:e3:d6:da:ba:24,51772328,176,33,51772152,51772328
5589,6,12,1,2412,-51,-92,41,40:e3:d6:da:ba:25,51772577,160,89,51772417,51772577
5590,6,6,1,2412,-51,-92,41,40:e3:d6:da:ba:26,51772769,380,-188,51772389,51772769
5591,6,6,1,2412,-82,-92,10,e6:aa:ea:c9:ea:1b,51829347,408,56170,51828939,51829347
5592,6,6,1,2412,-82,-92,10,e6:aa:ea:c9:ea:1b,51841463,408,11708,51841055,51841463
5593,6,6,1,2412,-80,-92,12,e6:aa:ea:c9:ea:1b,51854570,408,12699,51854162,51854570
5594,6,6,1,2412,-82,-92,10,e6:aa:ea:c9:ea:1b,51865684,408,10706,51865276,51865684
5595,6,12,1,2412,-52,-92,40,40:e3:d6:da:ba:20,51873714,160,7870,51873554,51873714
5596,6,6,1,2412,-52,-92,40,40:e3:d6:da:ba:21,51873906,368,-176,51873538,51873906
5597,6,12,1,2412,-52,-92,40,40:e3:d6:da:ba:22,51874293,180,207,51874113,51874293
5598,6,12,1,2412,-52,-92,40,40:e3:d6:da:ba:23,51874516,184,39,51874332,51874516
5599,6,12,1,2412,-52,-92,40,40:e3:d6:da:ba:24,51874753,176,61,51874577,51874753
5600,6,12,1,2412,-52,-92,40,40:e3:d6:da:ba:25,51874954,160,41,51874794,51874954
5601,6,6,1,2412,-52,-92,40,40:e3:d6:da:ba:26,51875173,380,-161,51874793,51875173
5602,6,6,1,2412,-82,-92,10,e6:aa:ea:c9:ea:1b,51877807,408,2226,51877399,51877807
5603,4,1,1,2412,-70,-92,22,54:e4:3a:ec:fb:64,51885744,2160,5777,51883584,51885744
5604,6,12,1,2412,-88,-92,4,84:d4:7e:f2:42:20,51892287,160,6383,51892127,51892287
5605,6,12,1,2412,-86,-92,6,84:d4:7e:f2:42:25,51893577,160,1130,51893417,51893577
5606,6,6,1,2412,-87,-92,5,84:d4:7e:f2:42:26,51893787,380,-170,51893407,51893787
5607,6,6,1,2412,-54,-92,38,e6:aa:ea:c9:ea:33,51904781,408,10586,51904373,51904781
5608,6,6,1,2412,-55,-92,37,e6:aa:ea:c9:ea:33,51916896,408,11707,51916488,51916896
5609,6,6,1,2412,-64,-92,28,e6:aa:ea:b7:4a:dd,51924813,408,7509,51924405,51924813
5610,6,6,1,2412,-63,-92,29,e6:aa:ea:b7:4a:dd,51936934,408,11713,51936526,51936934
5611,6,6,1,2412,-55,-92,37,e6:aa:ea:c9:ea:33,51941147,408,3805,51940739,51941147
5612,6,6,1,2412,-63,-92,29,e6:aa:ea:b7:4a:dd,51949055,408,7500,51948647,51949055
5613,6,6,1,2412,-56,-92,36,e6:aa:ea:c9:ea:33,51953553,408,4090,51953145,51953553
5614,6,6,1,2412,-62,-92,30,e6:aa:ea:b7:4a:dd,51973281,408,19320,51972873,51973281
5615,6,12,1,2412,-51,-92,41,40:e3:d6:da:ba:20,51976101,160,2660,51975941,51976101
5616,6,6,1,2412,-51,-92,41,40:e3:d6:da:ba:21,51976293,368,-176,51975925,51976293
5617,6,12,1,2412,-51,-92,41,40:e3:d6:da:ba:22,51976751,180,278,51976571,51976751
5618,6,12,1,2412,-51,-92,41,40:e3:d6:da:ba:23,51976965,184,30,51976781,51976965
5619,6,12,1,2412,-51,-92,41,40:e3:d6:da:ba:24,51977232,176,91,51977056,51977232
5620,6,12,1,2412,-51,-92,41,40:e3:d6:da:ba:25,51977452,160,60,51977292,51977452
5621,6,6,1,2412,-51,-92,41,40:e3:d6:da:ba:26,51977661,380,-171,51977281,51977661
5622,4,1,1,2412,-91,-92,1,c0:c9:e3:4d:6e:bf,52074714,872,96181,52073842,52074714
5623,6,12,1,2412,-49,-92,43,40:e3:d6:da:ba:20,52078519,160,3645,52078359,52078519
5624,6,6,1,2412,-49,-92,43,40:e3:d6:da:ba:21,52078729,368,-158,52078361,52078729
5625,6,12,1,2412,-49,-92,43,40:e3:d6:da:ba:22,52079116,180,207,52078936,52079116
5626,6,12,1,2412,-49,-92,43,40:e3:d6:da:ba:23,52079340,184,40,52079156,52079340
5627,6,12,1,2412,-49,-92,43,40:e3:d6:da:ba:24,52079549,176,33,52079373,52079549
5628,6,12,1,2412,-49,-92,43,40:e3:d6:da:ba:25,52079760,160,51,52079600,52079760
5629,6,6,1,2412,-49,-92,43,40:e3:d6:da:ba:26,52079961,380,-179,52079581,52079961
5630,4,1,1,2412,-68,-92,24,54:e4:3a:ec:fb:64,52089238,2160,7117,52087078,52089238
5631,6,12,1,2412,-50,-92,42,40:e3:d6:da:ba:20,52180917,160,91519,52180757,52180917
5632,6,6,1,2412,-50,-92,42,40:e3:d6:da:ba:21,52181127,368,-158,52180759,52181127
5633,6,12,1,2412,-50,-92,42,40:e3:d6:da:ba:22,52181514,180,207,52181334,52181514
5634,6,12,1,2412,-49,-92,43,40:e3:d6:da:ba:23,52181729,184,31,52181545,52181729
5635,6,12,1,2412,-49,-92,43,40:e3:d6:da:ba:24,52181938,176,33,52181762,52181938
5636,6,12,1,2412,-49,-92,43,40:e3:d6:da:ba:25,52182157,160,59,52181997,52182157
5637,6,6,1,2412,-49,-92,43,40:e3:d6:da:ba:26,52182376,380,-161,52181996,52182376
5638,4,1,1,2412,-67,-92,25,54:e4:3a:ec:fb:64,52191997,2160,7461,52189837,52191997
5639,6,6,1,2412,-81,-92,11,e6:aa:ea:c9:ea:1b,52249413,408,57008,52249005,52249413
5640,6,6,1,2412,-80,-92,12,e6:aa:ea:c9:ea:1b,52273640,408,23819,52273232,52273640
5641,6,12,1,2412,-52,-92,40,40:e3:d6:da:ba:20,52283326,160,9526,52283166,52283326
5642,6,6,1,2412,-52,-92,40,40:e3:d6:da:ba:21,52283583,368,-111,52283215,52283583
5643,6,12,1,2412,-52,-92,40,40:e3:d6:da:ba:22,52283988,180,225,52283808,52283988
5644,6,12,1,2412,-52,-92,40,40:e3:d6:da:ba:23,52284212,184,40,52284028,52284212
5645,6,12,1,2412,-52,-92,40,40:e3:d6:da:ba:24,52284448,176,60,52284272,52284448
5646,6,12,1,2412,-52,-92,40,40:e3:d6:da:ba:25,52284677,160,69,52284517,52284677
5647,6,6,1,2412,-52,-92,40,40:e3:d6:da:ba:26,52284886,380,-171,52284506,52284886
5648,4,1,1,2412,-89,-92,3,a4:e5:7c:28:b1:d3,52287192,688,1618,52286504,52287192
5649,4,1,1,2412,-71,-92,21,54:e4:3a:ec:fb:64,52294037,2160,4685,52291877,52294037
5650,6,6,1,2412,-53,-92,39,,52336034,44,41953,52335990,52336034
5651,6,12,1,2412,-55,-92,37,40:e3:d6:da:ba:20,52385717,160,49523,52385557,52385717
5652,6,6,1,2412,-55,-92,37,40:e3:d6:da:ba:21,52385936,368,-149,52385568,52385936
5653,6,12,1,2412,-55,-92,37,40:e3:d6:da:ba:22,52386332,180,216,52386152,52386332
5654,6,12,1,2412,-55,-92,37,40:e3:d6:da:ba:23,52386555,184,39,52386371,52386555
5655,6,12,1,2412,-54,-92,38,40:e3:d6:da:ba:24,52386764,176,33,52386588,52386764
5656,6,12,1,2412,-55,-92,37,40:e3:d6:da:ba:25,52386984,160,60,52386824,52386984
5657,6,6,1,2412,-55,-92,37,40:e3:d6:da:ba:26,52387176,380,-188,52386796,52387176
5658,4,1,1,2412,-70,-92,22,54:e4:3a:ec:fb:64,52396435,2160,7099,52394275,52396435
5659,6,6,1,2412,-56,-92,36,e6:aa:ea:c9:ea:33,52424959,408,28116,52424551,52424959
5660,6,6,1,2412,-53,-92,39,e6:aa:ea:c9:ea:33,52449190,408,23823,52448782,52449190
5661,6,6,1,2412,-60,-92,32,e6:aa:ea:b7:4a:dd,52457582,408,7984,52457174,52457582
5662,6,6,1,2412,-55,-92,37,e6:aa:ea:c9:ea:33,52461298,408,3308,52460890,52461298
5663,6,6,1,2412,-60,-92,32,e6:aa:ea:b7:4a:dd,52469706,408,8000,52469298,52469706
5664,6,12,1,2412,-56,-92,36,40:e3:d6:da:ba:20,52488102,160,18236,52487942,52488102
5665,6,6,1,2412,-56,-92,36,40:e3:d6:da:ba:21,52488321,368,-149,52487953,52488321
5666,6,12,1,2412,-56,-92,36,40:e3:d6:da:ba:22,52488708,180,207,52488528,52488708
5667,6,12,1,2412,-56,-92,36,40:e3:d6:da:ba:23,52488931,184,39,52488747,52488931
5668,6,12,1,2412,-56,-92,36,40:e3:d6:da:ba:24,52489184,176,77,52489008,52489184
5669,6,12,1,2412,-56,-92,36,40:e3:d6:da:ba:25,52489403,160,59,52489243,52489403
5670,6,6,1,2412,-56,-92,36,40:e3:d6:da:ba:26,52489623,380,-160,52489243,52489623
5671,6,6,1,2412,-61,-92,31,e6:aa:ea:b7:4a:dd,52493946,408,3915,52493538,52493946
5672,4,1,1,2412,-71,-92,21,54:e4:3a:ec:fb:64,52498834,2160,2728,52496674,52498834
5673,6,12,1,2412,-85,-92,7,84:d4:7e:f2:42:20,52506679,160,7685,52506519,52506679
5674,6,6,1,2412,-84,-92,8,84:d4:7e:f2:42:21,52506880,368,-167,52506512,52506880
5675,6,12,1,2412,-86,-92,6,84:d4:7e:f2:42:22,52507294,180,234,52507114,52507294
5676,6,12,1,2412,-86,-92,6,84:d4:7e:f2:42:23,52507508,180,34,52507328,52507508
5677,6,12,1,2412,-86,-92,6,84:d4:7e:f2:42:24,52507722,176,38,52507546,52507722
5678,6,12,1,2412,-85,-92,7,84:d4:7e:f2:42:25,52507933,160,51,52507773,52507933
5679,6,6,1,2412,-85,-92,7,84:d4:7e:f2:42:26,52508143,380,-170,52507763,52508143
5680,4,1,1,2412,-93,-92,-1,c0:c9:e3:4d:6e:bf,52567939,872,58924,52567067,52567939
5681,6,12,1,2412,-54,-92,38,40:e3:d6:da:ba:20,52590509,160,22410,52590349,52590509
5682,6,6,1,2412,-54,-92,38,40:e3:d6:da:ba:21,52590719,368,-158,52590351,52590719
5683,6,12,1,2412,-54,-92,38,40:e3:d6:da:ba:22,52591150,180,251,52590970,52591150
5684,6,12,1,2412,-54,-92,38,40:e3:d6:da:ba:23,52591383,184,49,52591199,52591383
5685,6,12,1,2412,-54,-92,38,40:e3:d6:da:ba:24,52591610,176,51,52591434,52591610
5686,6,12,1,2412,-54,-92,38,40:e3:d6:da:ba:25,52591830,160,60,52591670,52591830
5687,6,6,1,2412,-54,-92,38,40:e3:d6:da:ba:26,52592040,380,-170,52591660,52592040
5688,4,1,1,2412,-65,-92,27,54:e4:3a:ec:fb:64,52601235,2160,7035,52599075,52601235
5689,6,6,1,2412,-82,-92,10,e6:aa:ea:c9:ea:1b,52681713,408,80070,52681305,52681713
5690,6,12,1,2412,-54,-92,38,40:e3:d6:da:ba:20,52692928,160,11055,52692768,52692928
5691,6,6,1,2412,-54,-92,38,40:e3:d6:da:ba:21,52693138,368,-158,52692770,52693138
5692,6,12,1,2412,-54,-92,38,40:e3:d6:da:ba:22,52693525,180,207,52693345,52693525
5693,6,12,1,2412,-54,-92,38,40:e3:d6:da:ba:23,52693740,184,31,52693556,52693740
5694,6,12,1,2412,-54,-92,38,40:e3:d6:da:ba:24,52693949,176,33,52693773,52693949
5695,6,12,1,2412,-54,-92,38,40:e3:d6:da:ba:25,52694151,160,42,52693991,52694151
5696,6,6,1,2412,-54,-92,38,40:e3:d6:da:ba:26,52694352,380,-179,52693972,52694352
5697,4,1,1,2412,-69,-92,23,54:e4:3a:ec:fb:64,52703777,2160,7265,52701617,52703777
5698,6,6,1,2412,-82,-92,10,e6:aa:ea:c9:ea:1b,52718051,408,13866,52717643,52718051
5699,6,12,1,2412,-54,-92,38,40:e3:d6:da:ba:20,52795330,160,77119,52795170,52795330
5700,6,6,1,2412,-54,-92,38,40:e3:d6:da:ba:21,52795522,368,-176,52795154,52795522
5701,6,12,1,2412,-54,-92,38,40:e3:d6:da:ba:22,52795909,180,207,52795729,52795909
5702,6,12,1,2412,-54,-92,38,40:e3:d6:da:ba:23,52796114,184,21,52795930,52796114
5703,6,12,1,2412,-54,-92,38,40:e3:d6:da:ba:24,52796342,176,52,52796166,52796342
5704,6,12,1,2412,-54,-92,38,40:e3:d6:da:ba:25,52796560,160,58,52796400,52796560
5705,4,1,1,2412,-70,-92,22,54:e4:3a:ec:fb:64,52806032,2160,7312,52803872,52806032
5706,6,6,1,2412,-86,-92,6,84:d4:7e:f2:42:21,52813410,368,7010,52813042,52813410
5707,6,12,1,2412,-86,-92,6,84:d4:7e:f2:42:22,52813815,180,225,52813635,52813815
5708,6,12,1,2412,-86,-92,6,84:d4:7e:f2:42:23,52814029,180,34,52813849,52814029
5709,6,12,1,2412,-85,-92,7,84:d4:7e:f2:42:24,52814261,176,56,52814085,52814261
5710,6,12,1,2412,-86,-92,6,84:d4:7e:f2:42:25,52814481,160,60,52814321,52814481
5711,6,6,1,2412,-87,-92,5,84:d4:7e:f2:42:26,52814700,380,-161,52814320,52814700
5712,6,6,1,2412,-65,-92,27,e6:aa:ea:b7:4a:dd,52887388,408,72280,52886980,52887388
5713,6,12,1,2412,-55,-92,37,40:e3:d6:da:ba:20,52897713,160,10165,52897553,52897713
5714,6,6,1,2412,-54,-92,38,40:e3:d6:da:ba:21,52897956,368,-125,52897588,52897956
5715,6,12,1,2412,-53,-92,39,40:e3:d6:da:ba:22,52898352,180,216,52898172,52898352
5716,6,12,1,2412,-53,-92,39,40:e3:d6:da:ba:23,52898557,184,21,52898373,52898557
5717,6,12,1,2412,-54,-92,38,40:e3:d6:da:ba:24,52898794,176,61,52898618,52898794
5718,6,12,1,2412,-54,-92,38,40:e3:d6:da:ba:25,52899013,160,59,52898853,52899013
5719,6,6,1,2412,-54,-92,38,40:e3:d6:da:ba:26,52899213,380,-180,52898833,52899213
5720,4,1,1,2412,-67,-92,25,54:e4:3a:ec:fb:64,52908610,2160,7237,52906450,52908610
5721,6,6,1,2412,-85,-92,7,84:d4:7e:f2:42:21,52915838,368,6860,52915470,52915838
5722,6,12,1,2412,-85,-92,7,84:d4:7e:f2:42:23,52916457,180,439,52916277,52916457
5723,6,6,1,2412,-55,-92,37,e6:aa:ea:c9:ea:33,52945197,408,28332,52944789,52945197
5724,6,6,1,2412,-54,-92,38,e6:aa:ea:c9:ea:33,52970795,408,25190,52970387,52970795
5725,6,6,1,2412,-53,-92,39,e6:aa:ea:c9:ea:33,52981355,408,10152,52980947,52981355
5726,6,6,1,2412,-53,-92,39,e6:aa:ea:c9:ea:33,52993465,408,11702,52993057,52993465
5727,6,6,1,2412,-80,-92,12,e6:aa:ea:c9:ea:1b,52998704,408,4831,52998296,52998704
5728,6,12,1,2412,-57,-92,35,40:e3:d6:da:ba:20,53000112,160,1248,52999952,53000112
5729,6,6,1,2412,-57,-92,35,40:e3:d6:da:ba:21,53000322,368,-158,52999954,53000322
5730,6,12,1,2412,-56,-92,36,40:e3:d6:da:ba:22,53002933,180,2431,53002753,53002933
5731,6,12,1,2412,-57,-92,35,40:e3:d6:da:ba:23,53003138,184,21,53002954,53003138
5732,6,12,1,2412,-57,-92,35,40:e3:d6:da:ba:24,53003382,176,68,53003206,53003382
5733,6,12,1,2412,-57,-92,35,40:e3:d6:da:ba:25,53003739,160,197,53003579,53003739
5734,6,6,1,2412,-57,-92,35,40:e3:d6:da:ba:26,53003949,380,-170,53003569,53003949
5735,4,1,1,2412,-71,-92,21,54:e4:3a:ec:fb:64,53010830,2160,4721,53008670,53010830
5736,6,6,1,2412,-87,-92,5,84:d4:7e:f2:42:21,53018195,368,6997,53017827,53018195
5737,6,12,1,2412,-85,-92,7,84:d4:7e:f2:42:22,53018609,180,234,53018429,53018609
5738,6,12,1,2412,-86,-92,6,84:d4:7e:f2:42:24,53019037,176,252,53018861,53019037
5739,6,12,1,2412,-87,-92,5,84:d4:7e:f2:42:25,53019257,160,60,53019097,53019257
5740,6,6,1,2412,-81,-92,11,e6:aa:ea:c9:ea:1b,53022939,408,3274,53022531,53022939
5741,6,6,1,2412,-75,-92,17,40:e3:d6:da:ba:21,53103002,368,79695,53102634,53103002
5742,6,12,1,2412,-58,-92,34,40:e3:d6:da:ba:22,53103663,180,481,53103483,53103663
5743,6,12,1,2412,-57,-92,35,40:e3:d6:da:ba:23,53103887,184,40,53103703,53103887
5744,6,12,1,2412,-58,-92,34,40:e3:d6:da:ba:24,53104096,176,33,53103920,53104096
5745,4,1,1,2412,-62,-92,30,54:e4:3a:ec:fb:64,53113229,2160,6973,53111069,53113229
5746,6,12,1,2412,-57,-92,35,40:e3:d6:da:ba:20,53204914,160,91525,53204754,53204914
5747,6,6,1,2412,-57,-92,35,40:e3:d6:da:ba:21,53205133,368,-149,53204765,53205133
5748,6,12,1,2412,-57,-92,35,40:e3:d6:da:ba:22,53205538,180,225,53205358,53205538
5749,6,12,1,2412,-57,-92,35,40:e3:d6:da:ba:23,53205762,184,40,53205578,53205762
5750,6,12,1,2412,-57,-92,35,40:e3:d6:da:ba:24,53205989,176,51,53205813,53205989
5751,6,12,1,2412,-57,-92,35,40:e3:d6:da:ba:25,53206190,160,41,53206030,53206190
5752,6,6,1,2412,-57,-92,35,40:e3:d6:da:ba:26,53206382,380,-188,53206002,53206382
5753,4,1,1,2412,-69,-92,23,54:e4:3a:ec:fb:64,53215629,2160,7087,53213469,53215629
5754,6,12,1,2412,-57,-92,35,40:e3:d6:da:ba:20,53307308,160,91519,53307148,53307308
5755,6,6,1,2412,-57,-92,35,40:e3:d6:da:ba:21,53307500,368,-176,53307132,53307500
5756,6,12,1,2412,-57,-92,35,40:e3:d6:da:ba:22,53307914,180,234,53307734,53307914
5757,6,12,1,2412,-57,-92,35,40:e3:d6:da:ba:23,53308138,184,40,53307954,53308138
5758,6,12,1,2412,-57,-92,35,40:e3:d6:da:ba:25,53308613,160,315,53308453,53308613
5759,4,1,1,2412,-85,-92,7,b8:3a:5a:88:e6:e0,53320239,2360,9266,53317879,53320239
5760,4,1,1,2412,-65,-92,27,02:e7:af:de:b9:fc,53325287,992,4056,53324295,53325287
5761,6,12,1,2412,-57,-92,35,40:e3:d6:da:ba:20,53326257,136,834,53326121,53326257
5762,6,6,1,2412,-57,-92,35,40:e3:d6:da:ba:21,53326434,348,-171,53326086,53326434
5763,6,6,1,2412,-69,-92,23,,53326799,44,321,53326755,53326799
5764,6,12,1,2412,-57,-92,35,40:e3:d6:da:ba:22,53326899,156,-56,53326743,53326899
5765,6,12,1,2412,-69,-92,23,,53327073,32,142,53327041,53327073
5766,6,12,1,2412,-57,-92,35,40:e3:d6:da:ba:23,53327149,156,-80,53326993,53327149
5767,6,12,1,2412,-69,-92,23,,53327323,32,142,53327291,53327323
5768,6,12,1,2412,-57,-92,35,40:e3:d6:da:ba:25,53327399,136,-60,53327263,53327399
5769,6,6,1,2412,-61,-92,31,e6:aa:ea:b7:4a:dd,53383479,408,55672,53383071,53383479
5770,6,6,1,2412,-81,-92,11,e6:aa:ea:c9:ea:1b,53405935,408,22048,53405527,53405935
5771,6,12,1,2412,-57,-92,35,40:e3:d6:da:ba:20,53409719,160,3624,53409559,53409719
5772,6,6,1,2412,-56,-92,36,40:e3:d6:da:ba:21,53409929,368,-158,53409561,53409929
5773,6,12,1,2412,-56,-92,36,40:e3:d6:da:ba:22,53410342,180,233,53410162,53410342
5774,6,12,1,2412,-55,-92,37,40:e3:d6:da:ba:23,53410548,184,22,53410364,53410548
5775,6,12,1,2412,-54,-92,38,40:e3:d6:da:ba:24,53410766,176,42,53410590,53410766
5776,6,12,1,2412,-56,-92,36,40:e3:d6:da:ba:25,53410995,160,69,53410835,53410995
5777,6,6,1,2412,-56,-92,36,40:e3:d6:da:ba:26,53411205,380,-170,53410825,53411205
5778,6,6,1,2412,-63,-92,29,e6:aa:ea:b7:4a:dd,53419792,408,8179,53419384,53419792
5779,4,1,1,2412,-67,-92,25,54:e4:3a:ec:fb:64,53420427,2160,-1525,53418267,53420427
5780,6,6,1,2412,-81,-92,11,e6:aa:ea:c9:ea:1b,53430172,408,9337,53429764,53430172
5781,6,6,1,2412,-63,-92,29,e6:aa:ea:b7:4a:dd,53432033,408,1453,53431625,53432033
5782,6,6,1,2412,-81,-92,11,e6:aa:ea:c9:ea:1b,53442299,408,9858,53441891,53442299
5783,6,6,1,2412,-82,-92,10,e6:aa:ea:c9:ea:1b,53454409,408,11702,53454001,53454409
5784,6,6,1,2412,-54,-92,38,e6:aa:ea:c9:ea:33,53466343,408,11526,53465935,53466343
5785,6,6,1,2412,-54,-92,38,e6:aa:ea:c9:ea:33,53476848,408,10097,53476440,53476848
5786,6,6,1,2412,-54,-92,38,e6:aa:ea:c9:ea:33,53488959,408,11703,53488551,53488959
5787,6,6,1,2412,-54,-92,38,e6:aa:ea:c9:ea:33,53501095,408,11728,53500687,53501095
5788,6,12,1,2412,-57,-92,35,40:e3:d6:da:ba:20,53513087,160,11832,53512927,53513087
5789,6,6,1,2412,-57,-92,35,40:e3:d6:da:ba:21,53513297,368,-158,53512929,53513297
5790,6,12,1,2412,-57,-92,35,40:e3:d6:da:ba:24,53514344,176,871,53514168,53514344
5791,6,12,1,2412,-80,-92,12,40:e3:d6:da:ba:25,53514545,160,41,53514385,53514545
5792,4,1,1,2412,-68,-92,24,54:e4:3a:ec:fb:64,53522827,2160,6122,53520667,53522827
5793,6,12,1,2412,-57,-92,35,40:e3:d6:da:ba:20,53614510,160,91523,53614350,53614510
5794,6,6,1,2412,-56,-92,36,40:e3:d6:da:ba:21,53614720,368,-158,53614352,53614720
5795,6,12,1,2412,-56,-92,36,40:e3:d6:da:ba:22,53615125,180,225,53614945,53615125
5796,6,12,1,2412,-56,-92,36,40:e3:d6:da:ba:23,53615330,184,21,53615146,53615330
5797,6,12,1,2412,-56,-92,36,40:e3:d6:da:ba:24,53615557,176,51,53615381,53615557
5798,6,12,1,2412,-56,-92,36,40:e3:d6:da:ba:25,53615786,160,69,53615626,53615786
5799,6,6,1,2412,-57,-92,35,40:e3:d6:da:ba:26,53615996,380,-170,53615616,53615996
5800,4,1,1,2412,-72,-92,20,54:e4:3a:ec:fb:64,53625226,2160,7070,53623066,53625226
5801,6,12,1,2412,-56,-92,36,40:e3:d6:da:ba:20,53716913,160,91527,53716753,53716913
5802,6,6,1,2412,-56,-92,36,40:e3:d6:da:ba:21,53717263,368,-18,53716895,53717263
5803,6,12,1,2412,-56,-92,36,40:e3:d6:da:ba:22,53717659,180,216,53717479,53717659
5804,6,12,1,2412,-56,-92,36,40:e3:d6:da:ba:24,53718258,176,423,53718082,53718258
5805,6,12,1,2412,-56,-92,36,40:e3:d6:da:ba:25,53718459,160,41,53718299,53718459
5806,6,6,1,2412,-56,-92,36,40:e3:d6:da:ba:26,53718789,380,-50,53718409,53718789
5807,6,6,1,2412,-80,-92,12,e6:aa:ea:c9:ea:1b,53747492,408,28295,53747084,53747492
5808,6,6,1,2412,-82,-92,10,e6:aa:ea:c9:ea:1b,53771727,408,23827,53771319,53771727
5809,6,6,1,2412,-55,-92,37,e6:aa:ea:c9:ea:33,53779434,408,7299,53779026,53779434
5810,4,1,1,2412,-53,-92,39,62:b0:c8:8e:5e:7b,53787208,1504,6270,53785704,53787208
5811,6,12,1,2412,-58,-92,34,40:e3:d6:da:ba:23,53788743,156,1379,53788587,53788743
5812,6,6,1,2412,-55,-92,37,e6:aa:ea:c9:ea:33,53791544,408,2393,53791136,53791544
5813,6,6,1,2412,-63,-92,29,e6:aa:ea:b7:4a:dd,53800741,408,8789,53800333,53800741
5814,6,6,1,2412,-55,-92,37,e6:aa:ea:c9:ea:33,53803659,408,2510,53803251,53803659
5815,4,1,1,2412,-54,-92,38,62:b0:c8:8e:5e:7b,53807489,1504,2326,53805985,53807489
5816,6,12,1,2412,-58,-92,34,40:e3:d6:da:ba:23,53808979,156,1334,53808823,53808979
5817,6,12,1,2412,-56,-92,36,,53809151,32,140,53809119,53809151
5818,6,6,1,2412,-60,-92,32,e6:aa:ea:b7:4a:dd,53812865,408,3306,53812457,53812865
5819,6,6,1,2412,-55,-92,37,e6:aa:ea:c9:ea:33,53815777,408,2504,53815369,53815777
5820,6,12,1,2412,-57,-92,35,40:e3:d6:da:ba:20,53819315,160,3378,53819155,53819315
5821,6,6,1,2412,-57,-92,35,40:e3:d6:da:ba:21,53819534,368,-149,53819166,53819534
5822,6,12,1,2412,-66,-92,26,40:e3:d6:da:ba:22,53819954,180,240,53819774,53819954
5823,6,12,1,2412,-54,-92,38,40:e3:d6:da:ba:25,53820619,160,505,53820459,53820619
5824,6,6,1,2412,-63,-92,29,e6:aa:ea:b7:4a:dd,53824973,408,3946,53824565,53824973
5825,4,1,1,2412,-67,-92,25,02:e7:af:de:b9:fc,53828023,992,2058,53827031,53828023
5826,6,12,1,2412,-57,-92,35,40:e3:d6:da:ba:20,53828984,136,825,53828848,53828984
5827,6,12,1,2412,-72,-92,20,,53829138,32,122,53829106,53829138
5828,4,1,1,2412,-68,-92,24,54:e4:3a:ec:fb:64,53832912,2160,1614,53830752,53832912
5829,6,12,1,2412,-72,-92,20,,53836683,32,3739,53836651,53836683
5830,6,6,1,2412,-63,-92,29,e6:aa:ea:b7:4a:dd,53837089,408,-2,53836681,53837089
5831,6,12,1,2412,-65,-92,27,,53837650,32,529,53837618,53837650
5832,4,1,1,2412,-64,-92,28,02:e7:af:de:b9:fc,53853864,992,15222,53852872,53853864
5833,6,6,1,2412,-57,-92,35,40:e3:d6:da:ba:21,53922980,368,68748,53922612,53922980
5834,6,12,1,2412,-57,-92,35,40:e3:d6:da:ba:22,53923376,180,216,53923196,53923376
5835,6,12,1,2412,-57,-92,35,40:e3:d6:da:ba:23,53923609,184,49,53923425,53923609
5836,6,12,1,2412,-57,-92,35,40:e3:d6:da:ba:24,53923836,176,51,53923660,53923836
5837,6,12,1,2412,-57,-92,35,40:e3:d6:da:ba:25,53924038,160,42,53923878,53924038
5838,6,6,1,2412,-57,-92,35,40:e3:d6:da:ba:26,53924257,380,-161,53923877,53924257
5839,6,12,1,2412,-52,-92,40,40:e3:d6:da:ba:20,54024178,160,99761,54024018,54024178
5840,6,12,1,2412,-52,-92,40,40:e3:d6:da:ba:22,54024901,180,543,54024721,54024901
5841,6,12,1,2412,-52,-92,40,40:e3:d6:da:ba:23,54025116,184,31,54024932,54025116
5842,6,12,1,2412,-52,-92,40,40:e3:d6:da:ba:24,54025353,176,61,54025177,54025353
5843,6,12,1,2412,-52,-92,40,40:e3:d6:da:ba:25,54025572,160,59,54025412,54025572
5844,6,6,1,2412,-52,-92,40,40:e3:d6:da:ba:26,54025791,380,-161,54025411,54025791
5845,6,12,1,2412,-51,-92,41,40:e3:d6:da:ba:20,54126527,160,100576,54126367,54126527
5846,6,12,1,2412,-51,-92,41,40:e3:d6:da:ba:22,54127149,180,442,54126969,54127149
5847,6,12,1,2412,-51,-92,41,40:e3:d6:da:ba:23,54127363,184,30,54127179,54127363
5848,6,12,1,2412,-52,-92,40,40:e3:d6:da:ba:24,54127573,176,34,54127397,54127573
5849,6,12,1,2412,-51,-92,41,40:e3:d6:da:ba:25,54127792,160,59,54127632,54127792
5850,6,6,1,2412,-51,-92,41,40:e3:d6:da:ba:26,54128026,380,-146,54127646,54128026
5851,6,6,1,2412,-68,-92,24,e6:aa:ea:b7:4a:dd,54128814,408,380,54128406,54128814
5852,6,6,1,2412,-68,-92,24,e6:aa:ea:b7:4a:dd,54139719,408,10497,54139311,54139719
5853,6,6,1,2412,-68,-92,24,e6:aa:ea:b7:4a:dd,54151846,408,11719,54151438,54151846
5854,6,6,1,2412,-85,-92,7,78:8a:20:fa:27:f9,54224605,88,72671,54224517,54224605
5855,6,12,1,2412,-55,-92,37,40:e3:d6:da:ba:20,54224869,136,128,54224733,54224869
5856,6,6,1,2412,-55,-92,37,40:e3:d6:da:ba:21,54225055,348,-162,54224707,54225055
5857,6,6,1,2412,-86,-92,6,,54225671,44,572,54225627,54225671
5858,6,12,1,2412,-85,-92,7,,54226540,32,837,54226508,54226540
5859,6,12,1,2412,-85,-92,7,,54226906,32,334,54226874,54226906
5860,6,12,1,2412,-84,-92,8,,54227259,32,321,54227227,54227259
5861,6,12,1,2412,-55,-92,37,40:e3:d6:da:ba:22,54227929,156,514,54227773,54227929
5862,6,12,1,2412,-55,-92,37,40:e3:d6:da:ba:23,54228128,156,43,54227972,54228128
5863,6,12,1,2412,-55,-92,37,40:e3:d6:da:ba:25,54228319,136,55,54228183,54228319
5864,6,12,1,2412,-54,-92,38,40:e3:d6:da:ba:20,54228941,160,462,54228781,54228941
5865,6,6,1,2412,-54,-92,38,40:e3:d6:da:ba:21,54229243,368,-66,54228875,54229243
5866,6,12,1,2412,-54,-92,38,40:e3:d6:da:ba:22,54229630,180,207,54229450,54229630
5867,6,12,1,2412,-54,-92,38,40:e3:d6:da:ba:23,54229836,184,22,54229652,54229836
5868,6,12,1,2412,-54,-92,38,40:e3:d6:da:ba:24,54230063,176,51,54229887,54230063
5869,6,12,1,2412,-54,-92,38,40:e3:d6:da:ba:25,54230264,160,41,54230104,54230264
5870,6,6,1,2412,-54,-92,38,40:e3:d6:da:ba:26,54230456,380,-188,54230076,54230456
5871,6,6,1,2412,-78,-92,14,e6:aa:ea:c9:ea:1b,54245888,408,15024,54245480,54245888
5872,6,6,1,2412,-85,-92,7,78:8a:20:fa:27:f9,54274676,88,28700,54274588,54274676
5873,6,12,1,2412,-54,-92,38,40:e3:d6:da:ba:20,54274935,136,123,54274799,54274935
5874,6,12,1,2412,-85,-92,7,,54275083,32,116,54275051,54275083
5875,6,6,1,2412,-53,-92,39,40:e3:d6:da:ba:21,54275165,348,-266,54274817,54275165
5876,6,12,1,2412,-53,-92,39,40:e3:d6:da:ba:22,54275568,156,247,54275412,54275568
5877,6,12,1,2412,-53,-92,39,40:e3:d6:da:ba:25,54276017,136,313,54275881,54276017
5878,6,6,1,2412,-78,-92,14,e6:aa:ea:c9:ea:1b,54283909,408,7484,54283501,54283909
5879,6,6,1,2412,-78,-92,14,e6:aa:ea:c9:ea:1b,54295442,408,11125,54295034,54295442
5880,6,6,1,2412,-54,-92,38,e6:aa:ea:c9:ea:33,54299438,408,3588,54299030,54299438
5881,6,6,1,2412,-53,-92,39,e6:aa:ea:c9:ea:33,54311490,408,11644,54311082,54311490
5882,6,6,1,2412,-53,-92,39,e6:aa:ea:c9:ea:33,54323991,408,12093,54323583,54323991
5883,6,12,1,2412,-53,-92,39,40:e3:d6:da:ba:20,54331364,160,7213,54331204,54331364
5884,6,6,1,2412,-53,-92,39,40:e3:d6:da:ba:21,54331565,368,-167,54331197,54331565
5885,6,12,1,2412,-53,-92,39,40:e3:d6:da:ba:22,54331970,180,225,54331790,54331970
5886,6,12,1,2412,-53,-92,39,40:e3:d6:da:ba:23,54332176,184,22,54331992,54332176
5887,6,12,1,2412,-53,-92,39,40:e3:d6:da:ba:24,54332385,176,33,54332209,54332385
5888,6,12,1,2412,-53,-92,39,40:e3:d6:da:ba:25,54332595,160,50,54332435,54332595
5889,6,6,1,2412,-53,-92,39,40:e3:d6:da:ba:26,54332787,380,-188,54332407,54332787
5890,6,6,1,2412,-52,-92,40,e6:aa:ea:c9:ea:33,54335722,408,2527,54335314,54335722
5891,4,1,1,2412,-65,-92,27,54:e4:3a:ec:fb:64,54350846,2160,12964,54348686,54350846
5892,6,12,1,2412,-53,-92,39,40:e3:d6:da:ba:23,54431151,156,80149,54430995,54431151
5893,6,12,1,2412,-53,-92,39,40:e3:d6:da:ba:20,54433712,160,2401,54433552,54433712
5894,6,6,1,2412,-53,-92,39,40:e3:d6:da:ba:21,54433913,368,-167,54433545,54433913
5895,6,12,1,2412,-53,-92,39,40:e3:d6:da:ba:22,54434343,180,250,54434163,54434343
5896,6,12,1,2412,-53,-92,39,40:e3:d6:da:ba:23,54434566,184,39,54434382,54434566
5897,6,12,1,2412,-53,-92,39,40:e3:d6:da:ba:24,54434793,176,51,54434617,54434793
5898,6,12,1,2412,-53,-92,39,40:e3:d6:da:ba:25,54435013,160,60,54434853,54435013
5899,6,6,1,2412,-53,-92,39,40:e3:d6:da:ba:26,54435223,380,-170,54434843,54435223
5900,4,1,1,2412,-65,-92,27,54:e4:3a:ec:fb:64,54444418,2160,7035,54442258,54444418
5901,4,1,1,2412,-51,-92,41,62:b0:c8:8e:5e:7b,54450858,1504,4936,54449354,54450858
5902,6,12,1,2412,-54,-92,38,40:e3:d6:da:ba:20,54536128,160,85110,54535968,54536128
5903,6,6,1,2412,-53,-92,39,40:e3:d6:da:ba:21,54536346,368,-150,54535978,54536346
5904,6,12,1,2412,-53,-92,39,40:e3:d6:da:ba:22,54536767,180,241,54536587,54536767
5905,6,12,1,2412,-54,-92,38,40:e3:d6:da:ba:23,54536973,184,22,54536789,54536973
5906,6,12,1,2412,-53,-92,39,40:e3:d6:da:ba:24,54537182,176,33,54537006,54537182
5907,6,12,1,2412,-53,-92,39,40:e3:d6:da:ba:25,54537428,160,86,54537268,54537428
5908,6,6,1,2412,-53,-92,39,40:e3:d6:da:ba:26,54537655,380,-153,54537275,54537655
5909,4,1,1,2412,-89,-92,3,b8:3a:5a:88:e6:e0,54549030,2360,9015,54546670,54549030
5910,6,6,1,2412,-80,-92,12,e6:aa:ea:c9:ea:1b,54563058,408,13620,54562650,54563058
5911,6,6,1,2412,-79,-92,13,e6:aa:ea:c9:ea:1b,54575175,408,11709,54574767,54575175
5912,4,1,1,2412,-92,-92,0,a4:e5:7c:28:b1:d3,54594482,688,18619,54593794,54594482
5913,6,6,1,2412,-78,-92,14,e6:aa:ea:c9:ea:1b,54599403,408,4513,54598995,54599403
5914,6,6,1,2412,-79,-92,13,e6:aa:ea:c9:ea:1b,54611578,408,11767,54611170,54611578
5915,6,6,1,2412,-63,-92,29,e6:aa:ea:b7:4a:dd,54635757,408,23771,54635349,54635757
5916,6,12,1,2412,-54,-92,38,40:e3:d6:da:ba:20,54638511,160,2594,54638351,54638511
5917,6,6,1,2412,-54,-92,38,40:e3:d6:da:ba:21,54638730,368,-149,54638362,54638730
5918,6,12,1,2412,-54,-92,38,40:e3:d6:da:ba:22,54639135,180,225,54638955,54639135
5919,6,12,1,2412,-54,-92,38,40:e3:d6:da:ba:24,54639643,176,332,54639467,54639643
5920,6,12,1,2412,-54,-92,38,40:e3:d6:da:ba:25,54639872,160,69,54639712,54639872
5921,6,6,1,2412,-54,-92,38,40:e3:d6:da:ba:26,54640082,380,-170,54639702,54640082
5922,6,6,1,2412,-64,-92,28,e6:aa:ea:b7:4a:dd,54659999,408,19509,54659591,54659999
5923,6,6,1,2412,-63,-92,29,e6:aa:ea:b7:4a:dd,54672110,408,11703,54671702,54672110
5924,6,6,1,2412,-63,-92,29,e6:aa:ea:b7:4a:dd,54684231,408,11713,54683823,54684231
5925,6,6,1,2412,-51,-92,41,e6:aa:ea:c9:ea:33,54716843,408,32204,54716435,54716843
5926,6,6,1,2412,-52,-92,40,e6:aa:ea:c9:ea:33,54728968,408,11717,54728560,54728968
5927,6,12,1,2412,-55,-92,37,40:e3:d6:da:ba:20,54740912,160,11784,54740752,54740912
5928,6,6,1,2412,-52,-92,40,e6:aa:ea:c9:ea:33,54741087,408,-233,54740679,54741087
5929,6,6,1,2412,-55,-92,37,40:e3:d6:da:ba:21,54743479,368,2024,54743111,54743479
5930,6,12,1,2412,-55,-92,37,40:e3:d6:da:ba:22,54743889,180,230,54743709,54743889
5931,6,12,1,2412,-55,-92,37,40:e3:d6:da:ba:23,54744133,184,60,54743949,54744133
5932,6,12,1,2412,-55,-92,37,40:e3:d6:da:ba:24,54744385,176,76,54744209,54744385
5933,6,12,1,2412,-55,-92,37,40:e3:d6:da:ba:25,54744586,160,41,54744426,54744586
5934,6,6,1,2412,-55,-92,37,40:e3:d6:da:ba:26,54744787,380,-179,54744407,54744787
5935,4,1,1,2412,-67,-92,25,54:e4:3a:ec:fb:64,54751615,2160,4668,54749455,54751615
5936,6,6,1,2412,-63,-92,29,e6:aa:ea:c9:ea:33,54765315,408,13292,54764907,54765315
5937,6,12,1,2412,-55,-92,37,40:e3:d6:da:ba:20,54843333,160,77858,54843173,54843333
5938,6,6,1,2412,-54,-92,38,40:e3:d6:da:ba:21,54843552,368,-149,54843184,54843552
5939,6,12,1,2412,-54,-92,38,40:e3:d6:da:ba:22,54843966,180,234,54843786,54843966
5940,6,12,1,2412,-54,-92,38,40:e3:d6:da:ba:23,54844214,184,64,54844030,54844214
5941,6,12,1,2412,-54,-92,38,40:e3:d6:da:ba:24,54844458,176,68,54844282,54844458
5942,6,12,1,2412,-54,-92,38,40:e3:d6:da:ba:25,54844659,160,41,54844499,54844659
5943,6,6,1,2412,-54,-92,38,40:e3:d6:da:ba:26,54844860,380,-179,54844480,54844860
5944,4,1,1,2412,-67,-92,25,54:e4:3a:ec:fb:64,54854015,2160,6995,54851855,54854015
5945,6,12,1,2412,-54,-92,38,40:e3:d6:da:ba:20,54945716,160,91541,54945556,54945716
5946,6,12,1,2412,-54,-92,38,40:e3:d6:da:ba:22,54946396,180,500,54946216,54946396
5947,6,12,1,2412,-58,-92,34,40:e3:d6:da:ba:23,54946619,184,39,54946435,54946619
5948,6,12,1,2412,-54,-92,38,40:e3:d6:da:ba:24,54946838,176,43,54946662,54946838
5949,6,12,1,2412,-54,-92,38,40:e3:d6:da:ba:25,54947066,160,68,54946906,54947066
5950,6,6,1,2412,-54,-92,38,40:e3:d6:da:ba:26,54947285,380,-161,54946905,54947285
5951,6,6,1,2412,-51,-92,41,e6:aa:ea:c9:ea:33,55035232,408,87539,55034824,55035232
5952,6,6,1,2412,-51,-92,41,e6:aa:ea:c9:ea:33,55047349,408,11709,55046941,55047349
5953,6,12,1,2412,-54,-92,38,40:e3:d6:da:ba:20,55048137,160,628,55047977,55048137
5954,6,6,1,2412,-54,-92,38,40:e3:d6:da:ba:21,55048338,368,-167,55047970,55048338
5955,6,12,1,2412,-54,-92,38,40:e3:d6:da:ba:22,55048743,180,225,55048563,55048743
5956,6,12,1,2412,-54,-92,38,40:e3:d6:da:ba:23,55048957,184,30,55048773,55048957
5957,6,12,1,2412,-54,-92,38,40:e3:d6:da:ba:24,55050328,176,1195,55050152,55050328
5958,6,12,1,2412,-54,-92,38,40:e3:d6:da:ba:25,55050547,160,59,55050387,55050547
5959,6,6,1,2412,-54,-92,38,40:e3:d6:da:ba:26,55050766,380,-161,55050386,55050766
5960,6,6,1,2412,-52,-92,40,e6:aa:ea:c9:ea:33,55071580,408,20406,55071172,55071580
5961,6,6,1,2412,-52,-92,40,e6:aa:ea:c9:ea:33,55083702,408,11714,55083294,55083702
5962,6,6,1,2412,-78,-92,14,e6:aa:ea:c9:ea:1b,55085367,408,1257,55084959,55085367
5963,6,6,1,2412,-81,-92,11,e6:aa:ea:c9:ea:1b,55109609,408,23834,55109201,55109609
5964,4,1,1,2412,-88,-92,4,a6:e5:7c:28:b1:d3,55126055,992,15454,55125063,55126055
5965,6,12,1,2412,-54,-92,38,40:e3:d6:da:ba:20,55150527,160,24312,55150367,55150527
5966,6,6,1,2412,-54,-92,38,40:e3:d6:da:ba:21,55150728,368,-167,55150360,55150728
5967,6,12,1,2412,-54,-92,38,40:e3:d6:da:ba:22,55151184,180,276,55151004,55151184
5968,6,12,1,2412,-54,-92,38,40:e3:d6:da:ba:23,55151416,184,48,55151232,55151416
5969,6,12,1,2412,-54,-92,38,40:e3:d6:da:ba:24,55151626,176,34,55151450,55151626
5970,6,12,1,2412,-54,-92,38,40:e3:d6:da:ba:25,55151836,160,50,55151676,55151836
5971,6,6,1,2412,-54,-92,38,40:e3:d6:da:ba:26,55152028,380,-188,55151648,55152028
5972,6,6,1,2412,-65,-92,27,e6:aa:ea:b7:4a:dd,55156581,408,4145,55156173,55156581
5973,4,1,1,2412,-71,-92,21,54:e4:3a:ec:fb:64,55161213,2160,2472,55159053,55161213
5974,6,6,1,2412,-64,-92,28,e6:aa:ea:b7:4a:dd,55180815,408,19194,55180407,55180815
5975,6,6,1,2412,-64,-92,28,e6:aa:ea:b7:4a:dd,55205059,408,23836,55204651,55205059
5976,4,1,1,2412,-89,-92,3,a6:e5:7c:28:b1:d3,55226288,992,20237,55225296,55226288
5977,6,6,1,2412,-56,-92,36,40:e3:d6:da:ba:21,55254669,368,28013,55254301,55254669
5978,6,12,1,2412,-56,-92,36,40:e3:d6:da:ba:23,55257252,184,2399,55257068,55257252
5979,6,12,1,2412,-56,-92,36,40:e3:d6:da:ba:24,55257471,176,43,55257295,55257471
5980,6,12,1,2412,-56,-92,36,40:e3:d6:da:ba:25,55257672,160,41,55257512,55257672
5981,4,1,1,2412,-70,-92,22,54:e4:3a:ec:fb:64,55263612,2160,3780,55261452,55263612
5982,6,12,1,2412,-87,-92,5,84:d4:7e:f2:42:20,55270843,160,7071,55270683,55270843
5983,4,1,1,2412,-88,-92,4,a6:e5:7c:28:b1:d3,55328464,992,56629,55327472,55328464
5984,6,6,1,2412,-53,-92,39,e6:aa:ea:c9:ea:33,55350988,408,22116,55350580,55350988
5985,6,12,1,2412,-56,-92,36,40:e3:d6:da:ba:20,55355335,160,4187,55355175,55355335
5986,6,12,1,2412,-56,-92,36,40:e3:d6:da:ba:22,55355968,180,453,55355788,55355968
5987,6,12,1,2412,-56,-92,36,40:e3:d6:da:ba:23,55356173,184,21,55355989,55356173
5988,6,12,1,2412,-56,-92,36,40:e3:d6:da:ba:24,55356382,176,33,55356206,55356382
5989,6,12,1,2412,-56,-92,36,40:e3:d6:da:ba:25,55356602,160,60,55356442,55356602
5990,6,6,1,2412,-56,-92,36,40:e3:d6:da:ba:26,55356794,380,-188,55356414,55356794
5991,6,6,1,2412,-53,-92,39,e6:aa:ea:c9:ea:33,55362758,408,5556,55362350,55362758
5992,6,6,1,2412,-53,-92,39,e6:aa:ea:c9:ea:33,55375135,408,11969,55374727,55375135
5993,6,6,1,2412,-52,-92,40,e6:aa:ea:c9:ea:33,55386995,408,11452,55386587,55386995
5994,6,6,1,2412,-53,-92,39,e6:aa:ea:c9:ea:33,55399117,408,11714,55398709,55399117
5995,6,12,1,2412,-58,-92,34,40:e3:d6:da:ba:20,55457733,160,58456,55457573,55457733
5996,6,6,1,2412,-58,-92,34,40:e3:d6:da:ba:21,55457952,368,-149,55457584,55457952
5997,6,12,1,2412,-58,-92,34,40:e3:d6:da:ba:22,55458366,180,234,55458186,55458366
5998,6,12,1,2412,-58,-92,34,40:e3:d6:da:ba:23,55458572,184,22,55458388,55458572
5999,6,12,1,2412,-58,-92,34,40:e3:d6:da:ba:24,55458799,176,51,55458623,55458799
6000,6,12,1,2412,-58,-92,34,40:e3:d6:da:ba:25,55459000,160,41,55458840,55459000
6001,6,6,1,2412,-57,-92,35,40:e3:d6:da:ba:26,55459219,380,-161,55458839,55459219
6002,6,12,1,2412,-57,-92,35,40:e3:d6:da:ba:20,55467228,136,7873,55467092,55467228
6003,6,6,1,2412,-58,-92,34,40:e3:d6:da:ba:21,55467423,348,-153,55467075,55467423
6004,6,12,1,2412,-58,-92,34,40:e3:d6:da:ba:22,55467928,156,349,55467772,55467928
6005,6,12,1,2412,-58,-92,34,40:e3:d6:da:ba:23,55468118,156,34,55467962,55468118
6006,6,12,1,2412,-54,-92,38,40:e3:d6:da:ba:25,55474161,136,5907,55474025,55474161
6007,6,12,1,2412,-55,-92,37,40:e3:d6:da:ba:20,55474332,136,35,55474196,55474332
6008,6,6,1,2412,-59,-92,33,40:e3:d6:da:ba:21,55474527,348,-153,55474179,55474527
6009,6,12,1,2412,-59,-92,33,40:e3:d6:da:ba:23,55477115,156,2432,55476959,55477115
6010,6,12,1,2412,-58,-92,34,40:e3:d6:da:ba:25,55477324,136,73,55477188,55477324
6011,6,12,1,2412,-88,-92,4,84:d4:7e:f2:42:24,55477629,176,129,55477453,55477629
6012,4,1,1,2412,-87,-92,5,,55518210,304,40277,55517906,55518210
6013,6,12,1,2412,-57,-92,35,40:e3:d6:da:ba:20,55560350,160,41980,55560190,55560350
6014,6,6,1,2412,-57,-92,35,40:e3:d6:da:ba:21,55560551,368,-167,55560183,55560551
6015,6,12,1,2412,-57,-92,35,40:e3:d6:da:ba:22,55560965,180,234,55560785,55560965
6016,6,12,1,2412,-55,-92,37,40:e3:d6:da:ba:23,55561204,184,55,55561020,55561204
6017,6,12,1,2412,-57,-92,35,40:e3:d6:da:ba:24,55561440,176,60,55561264,55561440
6018,6,12,1,2412,-57,-92,35,40:e3:d6:da:ba:25,55561642,160,42,55561482,55561642
6019,6,6,1,2412,-57,-92,35,40:e3:d6:da:ba:26,55561843,380,-179,55561463,55561843
6020,4,1,1,2412,-68,-92,24,54:e4:3a:ec:fb:64,55570809,2160,6806,55568649,55570809
6021,6,6,1,2412,-63,-92,29,e6:aa:ea:b7:4a:dd,55574694,408,3477,55574286,55574694
6022,6,6,1,2412,-63,-92,29,e6:aa:ea:b7:4a:dd,55598923,408,23821,55598515,55598923
6023,6,6,1,2412,-63,-92,29,e6:aa:ea:b7:4a:dd,55611048,408,11717,55610640,55611048
6024,6,6,1,2412,-80,-92,12,e6:aa:ea:c9:ea:1b,55617971,408,6515,55617563,55617971
6025,6,6,1,2412,-79,-92,13,e6:aa:ea:c9:ea:1b,55630047,408,11668,55629639,55630047
6026,6,6,1,2412,-79,-92,13,e6:aa:ea:c9:ea:1b,55654279,408,23824,55653871,55654279
6027,6,12,1,2412,-57,-92,35,40:e3:d6:da:ba:20,55662522,160,8083,55662362,55662522
6028,6,6,1,2412,-56,-92,36,40:e3:d6:da:ba:21,55662741,368,-149,55662373,55662741
6029,6,12,1,2412,-56,-92,36,40:e3:d6:da:ba:22,55663137,180,216,55662957,55663137
6030,6,12,1,2412,-56,-92,36,40:e3:d6:da:ba:23,55663351,184,30,55663167,55663351
6031,6,12,1,2412,-56,-92,36,40:e3:d6:da:ba:24,55663588,176,61,55663412,55663588
6032,4,1,1,2412,-67,-92,25,54:e4:3a:ec:fb:64,55673208,2160,7460,55671048,55673208
6033,6,12,1,2412,-87,-92,5,84:d4:7e:f2:42:24,55683467,176,10083,55683291,55683467
6034,6,12,1,2412,-88,-92,4,84:d4:7e:f2:42:25,55683686,160,59,55683526,55683686
6035,6,6,1,2412,-88,-92,4,84:d4:7e:f2:42:26,55683906,380,-160,55683526,55683906
6036,6,12,1,2412,-57,-92,35,40:e3:d6:da:ba:20,55764919,160,80853,55764759,55764919
6037,6,12,1,2412,-57,-92,35,40:e3:d6:da:ba:22,55765525,180,426,55765345,55765525
6038,6,12,1,2412,-57,-92,35,40:e3:d6:da:ba:23,55765739,184,30,55765555,55765739
6039,6,12,1,2412,-57,-92,35,40:e3:d6:da:ba:24,55765967,176,52,55765791,55765967
6040,6,12,1,2412,-57,-92,35,40:e3:d6:da:ba:25,55766313,160,186,55766153,55766313
6041,6,6,1,2412,-57,-92,35,40:e3:d6:da:ba:26,55766532,380,-161,55766152,55766532
6042,6,6,1,2412,-52,-92,40,e6:aa:ea:c9:ea:33,55769917,408,2977,55769509,55769917
6043,6,6,1,2412,-53,-92,39,e6:aa:ea:c9:ea:33,55782033,408,11708,55781625,55782033
6044,6,6,1,2412,-53,-92,39,e6:aa:ea:c9:ea:33,55794488,408,12047,55794080,55794488
6045,6,6,1,2412,-53,-92,39,e6:aa:ea:c9:ea:33,55806246,408,11350,55805838,55806246
6046,6,6,1,2412,-53,-92,39,e6:aa:ea:c9:ea:33,55818365,408,11711,55817957,55818365
6047,6,12,1,2412,-55,-92,37,40:e3:d6:da:ba:20,55867336,160,48811,55867176,55867336
6048,6,6,1,2412,-55,-92,37,40:e3:d6:da:ba:21,55867555,368,-149,55867187,55867555
6049,6,12,1,2412,-55,-92,37,40:e3:d6:da:ba:22,55867950,180,215,55867770,55867950
6050,6,12,1,2412,-55,-92,37,40:e3:d6:da:ba:23,55868156,184,22,55867972,55868156
6051,6,12,1,2412,-55,-92,37,40:e3:d6:da:ba:24,55868383,176,51,55868207,55868383
6052,6,12,1,2412,-55,-92,37,40:e3:d6:da:ba:25,55868603,160,60,55868443,55868603
6053,6,6,1,2412,-55,-92,37,40:e3:d6:da:ba:26,55868804,380,-179,55868424,55868804
6054,4,1,1,2412,-69,-92,23,54:e4:3a:ec:fb:64,55878007,2160,7043,55875847,55878007
6055,6,12,1,2412,-55,-92,37,40:e3:d6:da:ba:20,55969722,160,91555,55969562,55969722
6056,6,6,1,2412,-55,-92,37,40:e3:d6:da:ba:21,55969938,368,-152,55969570,55969938
6057,6,12,1,2412,-55,-92,37,40:e3:d6:da:ba:22,55970334,180,216,55970154,55970334
6058,6,12,1,2412,-55,-92,37,40:e3:d6:da:ba:23,55970558,184,40,55970374,55970558
6059,6,12,1,2412,-54,-92,38,40:e3:d6:da:ba:24,55970767,176,33,55970591,55970767
6060,6,12,1,2412,-55,-92,37,40:e3:d6:da:ba:25,55970977,160,50,55970817,55970977
6061,6,6,1,2412,-55,-92,37,40:e3:d6:da:ba:26,55971169,380,-188,55970789,55971169
6062,4,1,1,2412,-68,-92,24,54:e4:3a:ec:fb:64,55980405,2160,7076,55978245,55980405
6063,4,1,1,2412,-89,-92,3,a6:e5:7c:28:b1:d3,55990073,944,8724,55989129,55990073
6064,6,12,1,2412,-85,-92,7,84:d4:7e:f2:42:23,55992154,180,1901,55991974,55992154
6065,6,12,1,2412,-87,-92,5,84:d4:7e:f2:42:24,55992387,176,57,55992211,55992387
6066,6,12,1,2412,-86,-92,6,84:d4:7e:f2:42:25,55992597,160,50,55992437,55992597
6067,6,6,1,2412,-88,-92,4,84:d4:7e:f2:42:26,55992798,380,-179,55992418,55992798
6068,6,6,1,2412,-53,-92,39,,56010022,44,17180,56009978,56010022
6069,6,6,1,2412,-53,-92,39,,56035023,44,24957,56034979,56035023
6070,6,6,1,2412,-53,-92,39,,56059476,44,24409,56059432,56059476
6071,6,12,1,2412,-58,-92,34,40:e3:d6:da:ba:20,56072129,160,12493,56071969,56072129
6072,6,6,1,2412,-58,-92,34,40:e3:d6:da:ba:21,56072338,368,-159,56071970,56072338
6073,6,12,1,2412,-57,-92,35,40:e3:d6:da:ba:22,56072734,180,216,56072554,56072734
6074,6,12,1,2412,-59,-92,33,40:e3:d6:da:ba:23,56072967,184,49,56072783,56072967
6075,6,12,1,2412,-59,-92,33,40:e3:d6:da:ba:24,56073203,176,60,56073027,56073203
6076,6,12,1,2412,-57,-92,35,40:e3:d6:da:ba:25,56073405,160,42,56073245,56073405
6077,6,6,1,2412,-57,-92,35,40:e3:d6:da:ba:26,56073640,380,-145,56073260,56073640
6078,4,1,1,2412,-67,-92,25,54:e4:3a:ec:fb:64,56082804,2160,7004,56080644,56082804
6079,6,6,1,2412,-64,-92,28,e6:aa:ea:b7:4a:dd,56095822,408,12610,56095414,56095822
6080,6,6,1,2412,-64,-92,28,e6:aa:ea:b7:4a:dd,56107994,408,11764,56107586,56107994
6081,6,6,1,2412,-63,-92,29,e6:aa:ea:b7:4a:dd,56120063,408,11661,56119655,56120063
6082,6,6,1,2412,-61,-92,31,e6:aa:ea:b7:4a:dd,56132170,408,11699,56131762,56132170
6083,6,6,1,2412,-64,-92,28,e6:aa:ea:b7:4a:dd,56144292,408,11714,56143884,56144292
6084,6,12,1,2412,-58,-92,34,40:e3:d6:da:ba:20,56174540,160,30088,56174380,56174540
6085,6,6,1,2412,-59,-92,33,40:e3:d6:da:ba:21,56174750,368,-158,56174382,56174750
6086,6,12,1,2412,-58,-92,34,40:e3:d6:da:ba:22,56175137,180,207,56174957,56175137
6087,6,12,1,2412,-58,-92,34,40:e3:d6:da:ba:23,56175343,184,22,56175159,56175343
6088,6,12,1,2412,-58,-92,34,40:e3:d6:da:ba:24,56175579,176,60,56175403,56175579
6089,6,12,1,2412,-58,-92,34,40:e3:d6:da:ba:25,56175790,160,51,56175630,56175790
6090,6,6,1,2412,-58,-92,34,40:e3:d6:da:ba:26,56176047,380,-123,56175667,56176047
6091,4,1,1,2412,-67,-92,25,54:e4:3a:ec:fb:64,56185307,2160,7100,56183147,56185307
6092,6,12,1,2412,-85,-92,7,84:d4:7e:f2:42:24,56193408,176,7925,56193232,56193408
6093,6,12,1,2412,-85,-92,7,84:d4:7e:f2:42:25,56193636,160,68,56193476,56193636
6094,6,6,1,2412,-84,-92,8,84:d4:7e:f2:42:26,56193846,380,-170,56193466,56193846
6095,6,12,1,2412,-56,-92,36,40:e3:d6:da:ba:20,56276929,160,82923,56276769,56276929
6096,6,6,1,2412,-55,-92,37,40:e3:d6:da:ba:21,56277130,368,-167,56276762,56277130
6097,6,12,1,2412,-55,-92,37,40:e3:d6:da:ba:22,56277517,180,207,56277337,56277517
6098,6,12,1,2412,-55,-92,37,40:e3:d6:da:ba:23,56277731,184,30,56277547,56277731
6099,6,12,1,2412,-55,-92,37,40:e3:d6:da:ba:24,56277950,176,43,56277774,56277950
6100,6,12,1,2412,-55,-92,37,40:e3:d6:da:ba:25,56278169,160,59,56278009,56278169
6101,6,6,1,2412,-55,-92,37,40:e3:d6:da:ba:26,56278370,380,-179,56277990,56278370
6102,4,1,1,2412,-63,-92,29,54:e4:3a:ec:fb:64,56287602,2160,7072,56285442,56287602
6103,6,6,1,2412,-58,-92,34,e6:aa:ea:c9:ea:33,56290415,408,2405,56290007,56290415
6104,6,12,1,2412,-85,-92,7,84:d4:7e:f2:42:20,56295065,160,4490,56294905,56295065
6105,6,6,1,2412,-87,-92,5,84:d4:7e:f2:42:21,56295266,368,-167,56294898,56295266
6106,6,12,1,2412,-85,-92,7,84:d4:7e:f2:42:22,56295680,180,234,56295500,56295680
6107,6,6,1,2412,-85,-92,7,84:d4:7e:f2:42:26,56296557,380,497,56296177,56296557
6108,6,6,1,2412,-58,-92,34,e6:aa:ea:c9:ea:33,56305118,408,8153,56304710,56305118
6109,6,6,1,2412,-58,-92,34,e6:aa:ea:c9:ea:33,56314503,408,8977,56314095,56314503
6110,6,6,1,2412,-58,-92,34,e6:aa:ea:c9:ea:33,56326638,408,11727,56326230,56326638
6111,6,6,1,2412,-58,-92,34,e6:aa:ea:c9:ea:33,56338760,408,11714,56338352,56338760
6112,6,12,1,2412,-54,-92,38,40:e3:d6:da:ba:20,56379331,160,40411,56379171,56379331
6113,6,6,1,2412,-54,-92,38,40:e3:d6:da:ba:21,56379550,368,-149,56379182,56379550
6114,6,12,1,2412,-54,-92,38,40:e3:d6:da:ba:22,56379946,180,216,56379766,56379946
6115,6,12,1,2412,-54,-92,38,40:e3:d6:da:ba:23,56380151,184,21,56379967,56380151
6116,6,12,1,2412,-54,-92,38,40:e3:d6:da:ba:24,56380361,176,34,56380185,56380361
6117,6,12,1,2412,-54,-92,38,40:e3:d6:da:ba:25,56380562,160,41,56380402,56380562
6118,6,6,1,2412,-54,-92,38,40:e3:d6:da:ba:26,56380772,380,-170,56380392,56380772
6119,4,1,1,2412,-62,-92,30,54:e4:3a:ec:fb:64,56390002,2160,7070,56387842,56390002
6120,6,12,1,2412,-54,-92,38,40:e3:d6:da:ba:23,56483206,184,93020,56483022,56483206
6121,6,6,1,2412,-55,-92,37,40:e3:d6:da:ba:26,56483907,380,321,56483527,56483907
6122,4,1,1,2412,-65,-92,27,54:e4:3a:ec:fb:64,56496395,2160,10328,56494235,56496395
6123,6,6,1,2412,-64,-92,28,e6:aa:ea:b7:4a:dd,56525185,408,28382,56524777,56525185
6124,6,6,1,2412,-64,-92,28,e6:aa:ea:b7:4a:dd,56537306,408,11713,56536898,56537306
6125,6,6,1,2412,-63,-92,29,e6:aa:ea:b7:4a:dd,56561539,408,23825,56561131,56561539
6126,6,12,1,2412,-55,-92,37,40:e3:d6:da:ba:20,56584128,160,22429,56583968,56584128
6127,6,6,1,2412,-56,-92,36,40:e3:d6:da:ba:21,56584320,368,-176,56583952,56584320
6128,6,12,1,2412,-55,-92,37,40:e3:d6:da:ba:22,56584716,180,216,56584536,56584716
6129,6,12,1,2412,-55,-92,37,40:e3:d6:da:ba:23,56584930,184,30,56584746,56584930
6130,6,12,1,2412,-55,-92,37,40:e3:d6:da:ba:24,56585158,176,52,56584982,56585158
6131,6,12,1,2412,-55,-92,37,40:e3:d6:da:ba:25,56585368,160,50,56585208,56585368
6132,6,6,1,2412,-55,-92,37,40:e3:d6:da:ba:26,56585560,380,-188,56585180,56585560
6133,4,1,1,2412,-67,-92,25,54:e4:3a:ec:fb:64,56594803,2160,7083,56592643,56594803
6134,6,6,1,2412,-78,-92,14,e6:aa:ea:c9:ea:1b,56650264,408,55053,56649856,56650264
6135,6,12,1,2412,-54,-92,38,40:e3:d6:da:ba:20,56686526,160,36102,56686366,56686526
6136,6,6,1,2412,-54,-92,38,40:e3:d6:da:ba:21,56686727,368,-167,56686359,56686727
6137,6,12,1,2412,-54,-92,38,40:e3:d6:da:ba:22,56687132,180,225,56686952,56687132
6138,6,12,1,2412,-54,-92,38,40:e3:d6:da:ba:23,56687355,184,39,56687171,56687355
6139,6,12,1,2412,-54,-92,38,40:e3:d6:da:ba:24,56687564,176,33,56687388,56687564
6140,6,12,1,2412,-54,-92,38,40:e3:d6:da:ba:25,56687766,160,42,56687606,56687766
6141,6,6,1,2412,-54,-92,38,40:e3:d6:da:ba:26,56687976,380,-170,56687596,56687976
6142,4,1,1,2412,-67,-92,25,54:e4:3a:ec:fb:64,56697199,2160,7063,56695039,56697199
6143,6,6,1,2412,-88,-92,4,84:d4:7e:f2:42:21,56704617,368,7050,56704249,56704617
6144,6,6,1,2412,-55,-92,37,e6:aa:ea:c9:ea:33,56707920,408,2895,56707512,56707920
6145,6,6,1,2412,-55,-92,37,e6:aa:ea:c9:ea:33,56720044,408,11716,56719636,56720044
6146,6,6,1,2412,-54,-92,38,e6:aa:ea:c9:ea:33,56732240,408,11788,56731832,56732240
6147,6,6,1,2412,-54,-92,38,e6:aa:ea:c9:ea:33,56744273,408,11625,56743865,56744273
6148,6,6,1,2412,-54,-92,38,e6:aa:ea:c9:ea:33,56756388,408,11707,56755980,56756388
6149,6,12,1,2412,-54,-92,38,40:e3:d6:da:ba:22,56789577,180,33009,56789397,56789577
6150,6,12,1,2412,-54,-92,38,40:e3:d6:da:ba:23,56789809,184,48,56789625,56789809
6151,6,12,1,2412,-54,-92,38,40:e3:d6:da:ba:24,56790052,176,67,56789876,56790052
6152,6,12,1,2412,-54,-92,38,40:e3:d6:da:ba:25,56790271,160,59,56790111,56790271
6153,6,6,1,2412,-54,-92,38,40:e3:d6:da:ba:26,56790481,380,-170,56790101,56790481
6154,4,1,1,2412,-68,-92,24,54:e4:3a:ec:fb:64,56799599,2160,6958,56797439,56799599
6155,4,1,1,2412,-70,-92,22,b8:3a:5a:88:e6:e0,56801792,2360,-167,56799432,56801792
6156,4,1,1,2412,-92,-92,0,a6:e5:7c:28:b1:d3,56864396,992,61612,56863404,56864396
6157,6,12,1,2412,-56,-92,36,40:e3:d6:da:ba:20,56891324,160,26768,56891164,56891324
6158,6,6,1,2412,-56,-92,36,40:e3:d6:da:ba:21,56891515,368,-177,56891147,56891515
6159,6,12,1,2412,-56,-92,36,40:e3:d6:da:ba:22,56891911,180,216,56891731,56891911
6160,6,12,1,2412,-56,-92,36,40:e3:d6:da:ba:23,56892144,184,49,56891960,56892144
6161,6,12,1,2412,-56,-92,36,40:e3:d6:da:ba:24,56892380,176,60,56892204,56892380
6162,6,12,1,2412,-56,-92,36,40:e3:d6:da:ba:25,56892591,160,51,56892431,56892591
6163,6,6,1,2412,-56,-92,36,40:e3:d6:da:ba:26,56892791,380,-180,56892411,56892791
6164,4,1,1,2412,-91,-92,1,b8:3a:5a:88:e6:e0,56904491,2360,9340,56902131,56904491
6165,6,6,1,2412,-86,-92,6,84:d4:7e:f2:42:21,56909528,368,4669,56909160,56909528
6166,6,12,1,2412,-88,-92,4,84:d4:7e:f2:42:22,56909923,180,215,56909743,56909923
6167,4,1,1,2412,-90,-92,2,a6:e5:7c:28:b1:d3,56966560,992,55645,56965568,56966560
6168,6,12,1,2412,-56,-92,36,40:e3:d6:da:ba:20,56994357,160,27637,56994197,56994357
6169,6,6,1,2412,-56,-92,36,40:e3:d6:da:ba:21,56994566,368,-159,56994198,56994566
6170,6,12,1,2412,-56,-92,36,40:e3:d6:da:ba:22,56995030,180,284,56994850,56995030
6171,6,12,1,2412,-56,-92,36,40:e3:d6:da:ba:23,56995236,184,22,56995052,56995236
6172,6,12,1,2412,-56,-92,36,40:e3:d6:da:ba:24,56995463,176,51,56995287,56995463
6173,6,12,1,2412,-56,-92,36,40:e3:d6:da:ba:25,56995665,160,42,56995505,56995665
6174,6,6,1,2412,-56,-92,36,40:e3:d6:da:ba:26,56995857,380,-188,56995477,56995857
6175,4,1,1,2412,-67,-92,25,54:e4:3a:ec:fb:64,57004396,2160,6379,57002236,57004396
6176,6,6,1,2412,-60,-92,32,e6:aa:ea:b7:4a:dd,57033167,408,28363,57032759,57033167
6177,6,6,1,2412,-60,-92,32,e6:aa:ea:b7:4a:dd,57045299,408,11724,57044891,57045299
6178,6,6,1,2412,-59,-92,33,e6:aa:ea:b7:4a:dd,57057411,408,11704,57057003,57057411
6179,4,1,1,2412,-88,-92,4,,57066550,304,8835,57066246,57066550
6180,6,6,1,2412,-58,-92,34,e6:aa:ea:b7:4a:dd,57069529,408,2571,57069121,57069529
6181,6,6,1,2412,-58,-92,34,e6:aa:ea:b7:4a:dd,57081644,408,11707,57081236,57081644
6182,6,12,1,2412,-58,-92,34,40:e3:d6:da:ba:20,57096123,160,14319,57095963,57096123
6183,6,6,1,2412,-57,-92,35,40:e3:d6:da:ba:21,57096342,368,-149,57095974,57096342
6184,6,12,1,2412,-58,-92,34,40:e3:d6:da:ba:23,57097294,184,768,57097110,57097294
6185,6,12,1,2412,-57,-92,35,40:e3:d6:da:ba:24,57097522,176,52,57097346,57097522
6186,6,12,1,2412,-58,-92,34,40:e3:d6:da:ba:25,57097732,160,50,57097572,57097732
6187,6,6,1,2412,-57,-92,35,40:e3:d6:da:ba:26,57097942,380,-170,57097562,57097942
6188,4,1,1,2412,-69,-92,23,54:e4:3a:ec:fb:64,57106796,2160,6694,57104636,57106796
6189,6,12,1,2412,-88,-92,4,84:d4:7e:f2:42:22,57115379,180,8403,57115199,57115379
6190,6,6,1,2412,-56,-92,36,e6:aa:ea:c9:ea:33,57125211,408,9424,57124803,57125211
6191,6,6,1,2412,-56,-92,36,e6:aa:ea:c9:ea:33,57137331,408,11712,57136923,57137331
6192,6,6,1,2412,-56,-92,36,e6:aa:ea:c9:ea:33,57161574,408,23835,57161166,57161574
6193,6,6,1,2412,-55,-92,37,e6:aa:ea:c9:ea:33,57173700,408,11718,57173292,57173700
6194,6,12,1,2412,-58,-92,34,40:e3:d6:da:ba:20,57198525,160,24665,57198365,57198525
6195,6,6,1,2412,-58,-92,34,40:e3:d6:da:ba:21,57198735,368,-158,57198367,57198735
6196,6,12,1,2412,-58,-92,34,40:e3:d6:da:ba:22,57199121,180,206,57198941,57199121
6197,6,12,1,2412,-58,-92,34,40:e3:d6:da:ba:23,57199342,184,37,57199158,57199342
6198,6,12,1,2412,-58,-92,34,40:e3:d6:da:ba:24,57199551,176,33,57199375,57199551
6199,6,12,1,2412,-58,-92,34,40:e3:d6:da:ba:25,57199795,160,84,57199635,57199795
6200,6,6,1,2412,-58,-92,34,40:e3:d6:da:ba:26,57200002,380,-173,57199622,57200002
6201,6,12,1,2412,-87,-92,5,84:d4:7e:f2:42:25,57217653,160,17491,57217493,57217653
6202,6,12,1,2412,-58,-92,34,40:e3:d6:da:ba:20,57300925,160,83112,57300765,57300925
6203,6,12,1,2412,-59,-92,33,40:e3:d6:da:ba:23,57301761,184,652,57301577,57301761
6204,6,12,1,2412,-58,-92,34,40:e3:d6:da:ba:24,57301998,176,61,57301822,57301998
6205,4,1,1,2412,-88,-92,4,b8:3a:5a:88:e6:e1,57314702,2376,10328,57312326,57314702
6206,6,12,1,2412,-87,-92,5,84:d4:7e:f2:42:20,57318790,160,3928,57318630,57318790
6207,6,12,1,2412,-87,-92,5,84:d4:7e:f2:42:22,57319387,180,417,57319207,57319387
6208,6,12,1,2412,-86,-92,6,84:d4:7e:f2:42:25,57320017,160,470,57319857,57320017
6209,6,6,1,2412,-85,-92,7,84:d4:7e:f2:42:26,57320218,380,-179,57319838,57320218
6210,6,6,1,2412,-56,-92,36,e6:aa:ea:b7:4a:dd,57348043,408,27417,57347635,57348043
6211,6,6,1,2412,-56,-92,36,e6:aa:ea:b7:4a:dd,57372277,408,23826,57371869,57372277
6212,4,1,1,2412,-48,-92,44,be:87:98:21:d7:91,57374872,1152,1443,57373720,57374872
6213,4,1,1,2412,-68,-92,24,54:e4:3a:ec:fb:64,57378497,2112,1513,57376385,57378497
6214,4,1,1,2412,-48,-92,44,,57380622,304,1821,57380318,57380622
6215,6,12,1,2412,-59,-92,33,40:e3:d6:da:ba:20,57380786,136,28,57380650,57380786
6216,6,12,1,2412,-48,-92,44,,57380938,32,120,57380906,57380938
6217,6,6,1,2412,-59,-92,33,40:e3:d6:da:ba:21,57381043,348,-243,57380695,57381043
6218,6,6,1,2412,-48,-92,44,,57381407,44,320,57381363,57381407
6219,6,12,1,2412,-60,-92,32,40:e3:d6:da:ba:22,57381501,156,-62,57381345,57381501
6220,6,12,1,2412,-48,-92,44,,57381673,32,140,57381641,57381673
6221,6,12,1,2412,-59,-92,33,40:e3:d6:da:ba:23,57381749,156,-80,57381593,57381749
6222,6,12,1,2412,-48,-92,44,,57381922,32,141,57381890,57381922
6223,6,12,1,2412,-59,-92,33,40:e3:d6:da:ba:25,57381998,136,-60,57381862,57381998
6224,6,12,1,2412,-47,-92,45,,57382151,32,121,57382119,57382151
6225,6,6,1,2412,-56,-92,36,e6:aa:ea:b7:4a:dd,57384391,408,1832,57383983,57384391
6226,6,6,1,2412,-47,-92,45,,57385021,44,586,57384977,57385021
6227,4,1,1,2412,-46,-92,46,be:87:98:21:d7:91,57389462,1152,3289,57388310,57389462
6228,4,1,1,2412,-68,-92,24,54:e4:3a:ec:fb:64,57390735,2112,-839,57388623,57390735
6229,4,1,1,2412,-69,-92,23,54:e4:3a:ec:fb:64,57393164,2112,317,57391052,57393164
6230,4,1,1,2412,-46,-92,46,,57395289,304,1821,57394985,57395289
6231,6,12,1,2412,-60,-92,32,40:e3:d6:da:ba:20,57395452,136,27,57395316,57395452
6232,6,12,1,2412,-46,-92,46,,57395605,32,121,57395573,57395605
6233,6,6,1,2412,-60,-92,32,40:e3:d6:da:ba:21,57395679,348,-274,57395331,57395679
6234,6,6,1,2412,-46,-92,46,,57396043,44,320,57395999,57396043
6235,6,12,1,2412,-59,-92,33,40:e3:d6:da:ba:22,57396125,156,-74,57395969,57396125
6236,6,12,1,2412,-46,-92,46,,57396297,32,140,57396265,57396297
6237,6,12,1,2412,-60,-92,32,40:e3:d6:da:ba:23,57396383,156,-70,57396227,57396383
6238,6,12,1,2412,-46,-92,46,,57396555,32,140,57396523,57396555
6239,6,12,1,2412,-59,-92,33,40:e3:d6:da:ba:25,57396623,136,-68,57396487,57396623
6240,6,12,1,2412,-46,-92,46,,57396775,32,120,57396743,57396775
6241,6,6,1,2412,-56,-92,36,e6:aa:ea:b7:4a:dd,57397219,408,36,57396811,57397219
6242,6,12,1,2412,-60,-92,32,40:e3:d6:da:ba:20,57403331,160,5952,57403171,57403331
6243,6,6,1,2412,-59,-92,33,40:e3:d6:da:ba:21,57403550,368,-149,57403182,57403550
6244,6,12,1,2412,-59,-92,33,40:e3:d6:da:ba:22,57403946,180,216,57403766,57403946
6245,6,12,1,2412,-59,-92,33,40:e3:d6:da:ba:23,57404160,184,30,57403976,57404160
6246,6,12,1,2412,-59,-92,33,40:e3:d6:da:ba:24,57404379,176,43,57404203,57404379
6247,6,12,1,2412,-59,-92,33,40:e3:d6:da:ba:25,57404589,160,50,57404429,57404589
6248,6,6,1,2412,-60,-92,32,40:e3:d6:da:ba:26,57404790,380,-179,57404410,57404790
6249,6,12,1,2412,-85,-92,7,84:d4:7e:f2:42:20,57421206,160,16256,57421046,57421206
6250,6,6,1,2412,-85,-92,7,84:d4:7e:f2:42:21,57421407,368,-167,57421039,57421407
6251,6,12,1,2412,-85,-92,7,84:d4:7e:f2:42:22,57421794,180,207,57421614,57421794
6252,6,12,1,2412,-85,-92,7,84:d4:7e:f2:42:23,57422008,180,34,57421828,57422008
6253,6,12,1,2412,-85,-92,7,84:d4:7e:f2:42:24,57422241,176,57,57422065,57422241
6254,6,12,1,2412,-86,-92,6,84:d4:7e:f2:42:25,57422469,160,68,57422309,57422469
6255,6,6,1,2412,-84,-92,8,84:d4:7e:f2:42:26,57422689,380,-160,57422309,57422689
6256,6,12,1,2412,-58,-92,34,40:e3:d6:da:ba:20,57505740,160,82891,57505580,57505740
6257,6,6,1,2412,-58,-92,34,40:e3:d6:da:ba:21,57505948,368,-160,57505580,57505948
6258,6,12,1,2412,-57,-92,35,40:e3:d6:da:ba:23,57506592,184,460,57506408,57506592
6259,6,12,1,2412,-57,-92,35,40:e3:d6:da:ba:24,57506811,176,43,57506635,57506811
6260,6,12,1,2412,-58,-92,34,40:e3:d6:da:ba:25,57507012,160,41,57506852,57507012
6261,6,6,1,2412,-57,-92,35,40:e3:d6:da:ba:26,57507340,380,-52,57506960,57507340
6262,4,1,1,2412,-70,-92,22,54:e4:3a:ec:fb:64,57516393,2160,6893,57514233,57516393
6263,6,12,1,2412,-86,-92,6,84:d4:7e:f2:42:20,57523591,160,7038,57523431,57523591
6264,6,6,1,2412,-85,-92,7,84:d4:7e:f2:42:21,57523802,368,-157,57523434,57523802
6265,6,12,1,2412,-86,-92,6,84:d4:7e:f2:42:22,57524197,180,215,57524017,57524197
6266,6,12,1,2412,-87,-92,5,84:d4:7e:f2:42:23,57524411,180,34,57524231,57524411
6267,6,12,1,2412,-85,-92,7,84:d4:7e:f2:42:24,57524644,176,57,57524468,57524644
6268,4,1,1,2412,-58,-92,34,92:60:1f:80:d7:66,57554260,1152,28464,57553108,57554260
6269,6,12,1,2412,-56,-92,36,40:e3:d6:da:ba:20,57558467,136,4071,57558331,57558467
6270,6,6,1,2412,-57,-92,35,40:e3:d6:da:ba:21,57558652,348,-163,57558304,57558652
6271,6,12,1,2412,-56,-92,36,40:e3:d6:da:ba:22,57559046,156,238,57558890,57559046
6272,6,12,1,2412,-56,-92,36,40:e3:d6:da:ba:23,57559237,156,35,57559081,57559237
6273,6,12,1,2412,-57,-92,35,40:e3:d6:da:ba:25,57559427,136,54,57559291,57559427
6274,6,12,1,2412,-56,-92,36,40:e3:d6:da:ba:20,57608141,160,48554,57607981,57608141
6275,6,6,1,2412,-56,-92,36,40:e3:d6:da:ba:21,57608351,368,-158,57607983,57608351
6276,6,12,1,2412,-56,-92,36,40:e3:d6:da:ba:22,57608738,180,207,57608558,57608738
6277,6,12,1,2412,-55,-92,37,40:e3:d6:da:ba:23,57608970,184,48,57608786,57608970
6278,6,12,1,2412,-55,-92,37,40:e3:d6:da:ba:24,57609197,176,51,57609021,57609197
6279,6,12,1,2412,-55,-92,37,40:e3:d6:da:ba:25,57609408,160,51,57609248,57609408
6280,6,6,1,2412,-55,-92,37,40:e3:d6:da:ba:26,57609618,380,-170,57609238,57609618
6281,4,1,1,2412,-50,-92,42,de:0e:5d:2e:85:1e,57614727,1152,3957,57613575,57614727
6282,4,1,1,2412,-69,-92,23,54:e4:3a:ec:fb:64,57615994,2112,-845,57613882,57615994
6283,6,6,1,2412,-55,-92,37,40:e3:d6:da:ba:21,57618552,348,2210,57618204,57618552
6284,6,6,1,2412,-51,-92,41,,57618917,44,321,57618873,57618917
6285,6,12,1,2412,-55,-92,37,40:e3:d6:da:ba:22,57619016,156,-57,57618860,57619016
6286,6,12,1,2412,-50,-92,42,,57619189,32,141,57619157,57619189
6287,6,12,1,2412,-55,-92,37,40:e3:d6:da:ba:23,57619283,156,-62,57619127,57619283
6288,6,12,1,2412,-50,-92,42,,57619456,32,141,57619424,57619456
6289,4,1,1,2412,-70,-92,22,54:e4:3a:ec:fb:64,57619685,2160,-1931,57617525,57619685
6290,4,1,1,2412,-49,-92,43,de:0e:5d:2e:85:1e,57633709,1152,12872,57632557,57633709
6291,6,6,1,2412,-48,-92,44,,57635020,44,1267,57634976,57635020
6292,4,1,1,2412,-70,-92,22,54:e4:3a:ec:fb:64,57637814,2112,682,57635702,57637814
6293,4,1,1,2412,-48,-92,44,,57639939,304,1821,57639635,57639939
6294,6,12,1,2412,-55,-92,37,40:e3:d6:da:ba:20,57640102,136,27,57639966,57640102
6295,6,12,1,2412,-49,-92,43,,57640255,32,121,57640223,57640255
6296,6,6,1,2412,-55,-92,37,40:e3:d6:da:ba:21,57640338,348,-265,57639990,57640338
6297,6,6,1,2412,-49,-92,43,,57640702,44,320,57640658,57640702
6298,6,12,1,2412,-55,-92,37,40:e3:d6:da:ba:22,57640793,156,-65,57640637,57640793
6299,6,12,1,2412,-49,-92,43,,57640965,32,140,57640933,57640965
6300,6,12,1,2412,-55,-92,37,40:e3:d6:da:ba:23,57641033,156,-88,57640877,57641033
6301,6,12,1,2412,-49,-92,43,,57641205,32,140,57641173,57641205
6302,6,12,1,2412,-55,-92,37,40:e3:d6:da:ba:25,57641281,136,-60,57641145,57641281
6303,6,12,1,2412,-49,-92,43,,57641433,32,120,57641401,57641433
6304,6,6,1,2412,-53,-92,39,e6:aa:ea:c9:ea:33,57648512,408,6671,57648104,57648512
6305,6,6,1,2412,-54,-92,38,e6:aa:ea:c9:ea:33,57672756,408,23836,57672348,57672756
6306,6,6,1,2412,-53,-92,39,e6:aa:ea:c9:ea:33,57684877,408,11713,57684469,57684877
6307,6,6,1,2412,-80,-92,12,e6:aa:ea:c9:ea:1b,57694034,408,8749,57693626,57694034
6308,6,6,1,2412,-54,-92,38,e6:aa:ea:c9:ea:33,57697072,408,2630,57696664,57697072
6309,6,12,1,2412,-54,-92,38,40:e3:d6:da:ba:20,57710527,160,13295,57710367,57710527
6310,6,6,1,2412,-54,-92,38,40:e3:d6:da:ba:21,57710737,368,-158,57710369,57710737
6311,6,12,1,2412,-54,-92,38,40:e3:d6:da:ba:22,57711142,180,225,57710962,57711142
6312,6,12,1,2412,-54,-92,38,40:e3:d6:da:ba:23,57711366,184,40,57711182,57711366
6313,6,12,1,2412,-54,-92,38,40:e3:d6:da:ba:24,57711602,176,60,57711426,57711602
6314,6,12,1,2412,-54,-92,38,40:e3:d6:da:ba:25,57713894,160,2132,57713734,57713894
6315,6,6,1,2412,-54,-92,38,40:e3:d6:da:ba:26,57714113,380,-161,57713733,57714113
6316,6,6,1,2412,-80,-92,12,e6:aa:ea:c9:ea:1b,57718308,408,3787,57717900,57718308
6317,4,1,1,2412,-71,-92,21,54:e4:3a:ec:fb:64,57721409,2160,941,57719249,57721409
6318,6,12,1,2412,-84,-92,8,84:d4:7e:f2:42:20,57728881,160,7312,57728721,57728881
6319,6,6,1,2412,-86,-92,6,84:d4:7e:f2:42:21,57729073,368,-176,57728705,57729073
6320,6,12,1,2412,-54,-92,38,40:e3:d6:da:ba:20,57783704,136,54495,57783568,57783704
6321,6,6,1,2412,-54,-92,38,40:e3:d6:da:ba:21,57783909,348,-143,57783561,57783909
6322,6,12,1,2412,-54,-92,38,40:e3:d6:da:ba:22,57784285,156,220,57784129,57784285
6323,6,12,1,2412,-54,-92,38,40:e3:d6:da:ba:23,57784484,156,43,57784328,57784484
6324,6,12,1,2412,-54,-92,38,40:e3:d6:da:ba:25,57784701,136,81,57784565,57784701
6325,4,1,1,2412,-52,-92,40,2a:5f:ed:38:e8:76,57803264,1152,17411,57802112,57803264
6326,6,12,1,2412,-54,-92,38,40:e3:d6:da:ba:20,57812928,160,9504,57812768,57812928
6327,6,6,1,2412,-54,-92,38,40:e3:d6:da:ba:21,57813120,368,-176,57812752,57813120
6328,6,12,1,2412,-54,-92,38,40:e3:d6:da:ba:22,57813507,180,207,57813327,57813507
6329,6,12,1,2412,-54,-92,38,40:e3:d6:da:ba:23,57813730,184,39,57813546,57813730
6330,6,12,1,2412,-54,-92,38,40:e3:d6:da:ba:24,57813940,176,34,57813764,57813940
6331,6,12,1,2412,-53,-92,39,40:e3:d6:da:ba:25,57814150,160,50,57813990,57814150
6332,6,6,1,2412,-54,-92,38,40:e3:d6:da:ba:26,57814342,380,-188,57813962,57814342
6333,6,6,1,2412,-60,-92,32,e6:aa:ea:b7:4a:dd,57868013,408,53263,57867605,57868013
6334,6,6,1,2412,-61,-92,31,e6:aa:ea:b7:4a:dd,57892245,408,23824,57891837,57892245
6335,6,6,1,2412,-61,-92,31,e6:aa:ea:b7:4a:dd,57904356,408,11703,57903948,57904356
6336,6,12,1,2412,-55,-92,37,40:e3:d6:da:ba:20,57915342,160,10826,57915182,57915342
6337,6,6,1,2412,-55,-92,37,40:e3:d6:da:ba:21,57915542,368,-168,57915174,57915542
6338,6,12,1,2412,-54,-92,38,40:e3:d6:da:ba:22,57915947,180,225,57915767,57915947
6339,6,12,1,2412,-54,-92,38,40:e3:d6:da:ba:23,57916153,184,22,57915969,57916153
6340,6,12,1,2412,-54,-92,38,40:e3:d6:da:ba:24,57916389,176,60,57916213,57916389
6341,6,12,1,2412,-54,-92,38,40:e3:d6:da:ba:25,57916618,160,69,57916458,57916618
6342,6,6,1,2412,-54,-92,38,40:e3:d6:da:ba:26,57916837,380,-161,57916457,57916837
6343,6,6,1,2412,-61,-92,31,e6:aa:ea:b7:4a:dd,57917261,408,16,57916853,57917261
6344,4,1,1,2412,-71,-92,21,54:e4:3a:ec:fb:64,57925989,2160,6568,57923829,57925989
6345,6,12,1,2412,-55,-92,37,40:e3:d6:da:ba:20,58017748,160,91599,58017588,58017748
6346,6,6,1,2412,-55,-92,37,40:e3:d6:da:ba:21,58017949,368,-167,58017581,58017949
6347,6,12,1,2412,-55,-92,37,40:e3:d6:da:ba:22,58018345,180,216,58018165,58018345
6348,6,12,1,2412,-55,-92,37,40:e3:d6:da:ba:23,58018577,184,48,58018393,58018577
6349,6,12,1,2412,-55,-92,37,40:e3:d6:da:ba:24,58018814,176,61,58018638,58018814
6350,6,12,1,2412,-55,-92,37,40:e3:d6:da:ba:25,58019015,160,41,58018855,58019015
6351,6,6,1,2412,-55,-92,37,40:e3:d6:da:ba:26,58019225,380,-170,58018845,58019225
6352,4,1,1,2412,-69,-92,23,54:e4:3a:ec:fb:64,58028388,2160,7003,58026228,58028388
6353,6,12,1,2412,-84,-92,8,84:d4:7e:f2:42:22,58036737,180,8169,58036557,58036737
6354,6,6,1,2412,-88,-92,4,84:d4:7e:f2:42:26,58038694,380,1577,58038314,58038694
6355,6,6,1,2412,-51,-92,41,e6:aa:ea:c9:ea:33,58065796,408,26694,58065388,58065796
6356,6,6,1,2412,-51,-92,41,e6:aa:ea:c9:ea:33,58077911,408,11707,58077503,58077911
6357,4,1,1,2412,-49,-92,43,c6:e5:28:70:a9:85,58088667,1152,9604,58087515,58088667
6358,6,6,1,2412,-51,-92,41,e6:aa:ea:c9:ea:33,58090035,408,960,58089627,58090035
6359,6,6,1,2412,-51,-92,41,e6:aa:ea:c9:ea:33,58102211,408,11768,58101803,58102211
6360,6,6,1,2412,-51,-92,41,e6:aa:ea:c9:ea:33,58114256,408,11637,58113848,58114256
6361,6,12,1,2412,-56,-92,36,40:e3:d6:da:ba:20,58120131,160,5715,58119971,58120131
6362,6,6,1,2412,-56,-92,36,40:e3:d6:da:ba:21,58120350,368,-149,58119982,58120350
6363,6,12,1,2412,-56,-92,36,40:e3:d6:da:ba:23,58121006,184,472,58120822,58121006
6364,6,12,1,2412,-56,-92,36,40:e3:d6:da:ba:24,58121224,176,42,58121048,58121224
6365,6,12,1,2412,-56,-92,36,40:e3:d6:da:ba:25,58121426,160,42,58121266,58121426
6366,6,6,1,2412,-56,-92,36,40:e3:d6:da:ba:26,58121645,380,-161,58121265,58121645
6367,4,1,1,2412,-68,-92,24,54:e4:3a:ec:fb:64,58130788,2160,6983,58128628,58130788
6368,6,6,1,2412,-77,-92,15,e6:aa:ea:c9:ea:1b,58148941,408,17745,58148533,58148941
6369,6,6,1,2412,-78,-92,14,e6:aa:ea:c9:ea:1b,58161052,408,11703,58160644,58161052
6370,6,12,1,2412,-57,-92,35,40:e3:d6:da:ba:20,58222553,160,61341,58222393,58222553
6371,6,6,1,2412,-57,-92,35,40:e3:d6:da:ba:21,58222754,368,-167,58222386,58222754
6372,6,12,1,2412,-57,-92,35,40:e3:d6:da:ba:22,58223159,180,225,58222979,58223159
6373,6,12,1,2412,-57,-92,35,40:e3:d6:da:ba:23,58223383,184,40,58223199,58223383
6374,6,12,1,2412,-57,-92,35,40:e3:d6:da:ba:24,58223610,176,51,58223434,58223610
6375,6,12,1,2412,-57,-92,35,40:e3:d6:da:ba:25,58223830,160,60,58223670,58223830
6376,6,6,1,2412,-57,-92,35,40:e3:d6:da:ba:26,58224048,380,-162,58223668,58224048
6377,4,1,1,2412,-64,-92,28,54:e4:3a:ec:fb:64,58233187,2160,6979,58231027,58233187
6378,4,1,1,2412,-87,-92,5,b8:3a:5a:88:e6:e0,58235380,2360,-167,58233020,58235380
6379,6,12,1,2412,-87,-92,5,84:d4:7e:f2:42:22,58241041,180,5481,58240861,58241041
6380,6,12,1,2412,-87,-92,5,84:d4:7e:f2:42:23,58241264,180,43,58241084,58241264
6381,6,12,1,2412,-87,-92,5,84:d4:7e:f2:42:24,58241479,176,39,58241303,58241479
6382,6,12,1,2412,-86,-92,6,84:d4:7e:f2:42:25,58241689,160,50,58241529,58241689
6383,6,6,1,2412,-87,-92,5,84:d4:7e:f2:42:26,58241881,380,-188,58241501,58241881
6384,6,6,1,2412,-68,-92,24,e6:aa:ea:b7:4a:dd,58286146,408,43857,58285738,58286146
6385,6,6,1,2412,-63,-92,29,e6:aa:ea:b7:4a:dd,58310388,408,23834,58309980,58310388
6386,6,6,1,2412,-69,-92,23,e6:aa:ea:b7:4a:dd,58322501,408,11705,58322093,58322501
6387,6,12,1,2412,-58,-92,34,40:e3:d6:da:ba:20,58325299,160,2638,58325139,58325299
6388,6,6,1,2412,-58,-92,34,40:e3:d6:da:ba:21,58325491,368,-176,58325123,58325491
6389,6,12,1,2412,-58,-92,34,40:e3:d6:da:ba:22,58325905,180,234,58325725,58325905
6390,6,12,1,2412,-58,-92,34,40:e3:d6:da:ba:23,58326120,184,31,58325936,58326120
6391,6,12,1,2412,-58,-92,34,40:e3:d6:da:ba:24,58326347,176,51,58326171,58326347
6392,6,12,1,2412,-58,-92,34,40:e3:d6:da:ba:25,58326549,160,42,58326389,58326549
6393,6,6,1,2412,-58,-92,34,40:e3:d6:da:ba:26,58326826,380,-103,58326446,58326826
6394,6,6,1,2412,-69,-92,23,e6:aa:ea:b7:4a:dd,58334612,408,7378,58334204,58334612
6395,4,1,1,2412,-88,-92,4,b8:3a:5a:88:e6:e0,58337875,2360,903,58335515,58337875
6396,6,12,1,2412,-83,-92,9,84:d4:7e:f2:42:25,58344070,160,6035,58343910,58344070
6397,6,6,1,2412,-83,-92,9,84:d4:7e:f2:42:26,58344262,380,-188,58343882,58344262
6398,6,6,1,2412,-55,-92,37,e6:aa:ea:c9:ea:33,58381596,408,36926,58381188,58381596
6399,6,6,1,2412,-56,-92,36,e6:aa:ea:c9:ea:33,58393615,408,11611,58393207,58393615
6400,6,6,1,2412,-56,-92,36,e6:aa:ea:c9:ea:33,58405744,408,11721,58405336,58405744
6401,6,6,1,2412,-56,-92,36,e6:aa:ea:c9:ea:33,58418696,408,12544,58418288,58418696
6402,6,12,1,2412,-58,-92,34,40:e3:d6:da:ba:20,58427335,160,8479,58427175,58427335
6403,6,6,1,2412,-58,-92,34,40:e3:d6:da:ba:21,58427527,368,-176,58427159,58427527
6404,6,12,1,2412,-58,-92,34,40:e3:d6:da:ba:22,58427913,180,206,58427733,58427913
6405,6,12,1,2412,-58,-92,34,40:e3:d6:da:ba:23,58428119,184,22,58427935,58428119
6406,6,12,1,2412,-58,-92,34,40:e3:d6:da:ba:24,58428328,176,33,58428152,58428328
6407,6,12,1,2412,-58,-92,34,40:e3:d6:da:ba:25,58428539,160,51,58428379,58428539
6408,6,6,1,2412,-57,-92,35,40:e3:d6:da:ba:26,58428758,380,-161,58428378,58428758
6409,6,6,1,2412,-84,-92,8,e6:aa:ea:c9:ea:1b,58429395,408,229,58428987,58429395
6410,6,6,1,2412,-56,-92,36,e6:aa:ea:c9:ea:33,58430031,408,228,58429623,58430031
6411,6,6,1,2412,-85,-92,7,84:d4:7e:f2:42:21,58445508,368,15109,58445140,58445508
6412,6,12,1,2412,-86,-92,6,84:d4:7e:f2:42:23,58446126,180,438,58445946,58446126
6413,6,6,1,2412,-86,-92,6,84:d4:7e:f2:42:26,58446734,380,228,58446354,58446734
6414,4,1,1,2412,-71,-92,21,54:e4:3a:ec:fb:64,58517807,2112,68961,58515695,58517807
6415,4,1,1,2412,-71,-92,21,54:e4:3a:ec:fb:64,58525971,2112,6052,58523859,58525971
6416,4,1,1,2412,-71,-92,21,54:e4:3a:ec:fb:64,58528354,2112,271,58526242,58528354
6417,6,12,1,2412,-56,-92,36,40:e3:d6:da:ba:20,58530651,160,2137,58530491,58530651
6418,6,12,1,2412,-56,-92,36,40:e3:d6:da:ba:22,58531288,180,457,58531108,58531288
6419,6,12,1,2412,-56,-92,36,40:e3:d6:da:ba:23,58531494,184,22,58531310,58531494
6420,6,12,1,2412,-56,-92,36,40:e3:d6:da:ba:24,58531703,176,33,58531527,58531703
6421,6,12,1,2412,-56,-92,36,40:e3:d6:da:ba:25,58531931,160,68,58531771,58531931
6422,6,6,1,2412,-56,-92,36,40:e3:d6:da:ba:26,58532236,380,-75,58531856,58532236
6423,4,1,1,2412,-70,-92,22,54:e4:3a:ec:fb:64,58540385,2160,5989,58538225,58540385
6424,6,12,1,2412,-85,-92,7,84:d4:7e:f2:42:20,58547715,160,7170,58547555,58547715
6425,6,6,1,2412,-85,-92,7,84:d4:7e:f2:42:21,58547906,368,-177,58547538,58547906
6426,6,12,1,2412,-85,-92,7,84:d4:7e:f2:42:22,58548302,180,216,58548122,58548302
6427,6,12,1,2412,-85,-92,7,84:d4:7e:f2:42:23,58548517,180,35,58548337,58548517
6428,6,12,1,2412,-86,-92,6,84:d4:7e:f2:42:24,58548722,176,29,58548546,58548722
6429,6,12,1,2412,-86,-92,6,84:d4:7e:f2:42:25,58548951,160,69,58548791,58548951
6430,6,6,1,2412,-86,-92,6,84:d4:7e:f2:42:26,58549161,380,-170,58548781,58549161
6431,4,1,1,2412,-69,-92,23,54:e4:3a:ec:fb:64,58558228,2112,6955,58556116,58558228
6432,4,1,1,2412,-69,-92,23,54:e4:3a:ec:fb:64,58560612,2112,272,58558500,58560612
6433,4,1,1,2412,-69,-92,23,54:e4:3a:ec:fb:64,58565486,2112,2762,58563374,58565486
6434,6,12,1,2412,-83,-92,9,40:e3:d6:f7:0b:40,58586675,960,20229,58585715,58586675
6435,6,12,1,2412,-55,-92,37,40:e3:d6:da:ba:20,58632132,160,45297,58631972,58632132
6436,6,6,1,2412,-55,-92,37,40:e3:d6:da:ba:21,58632324,368,-176,58631956,58632324
6437,6,12,1,2412,-55,-92,37,40:e3:d6:da:ba:22,58632738,180,234,58632558,58632738
6438,6,12,1,2412,-55,-92,37,40:e3:d6:da:ba:23,58632961,184,39,58632777,58632961
6439,6,12,1,2412,-55,-92,37,40:e3:d6:da:ba:24,58633189,176,52,58633013,58633189
6440,6,12,1,2412,-55,-92,37,40:e3:d6:da:ba:25,58633408,160,59,58633248,58633408
6441,6,6,1,2412,-55,-92,37,40:e3:d6:da:ba:26,58633609,380,-179,58633229,58633609
6442,4,1,1,2412,-66,-92,26,54:e4:3a:ec:fb:64,58642783,2160,7014,58640623,58642783
6443,6,6,1,2412,-85,-92,7,84:d4:7e:f2:42:26,58651534,380,8371,58651154,58651534
6444,6,6,1,2412,-61,-92,31,e6:aa:ea:b7:4a:dd,58702911,408,50969,58702503,58702911
6445,6,6,1,2412,-61,-92,31,e6:aa:ea:b7:4a:dd,58715030,408,11711,58714622,58715030
6446,6,6,1,2412,-61,-92,31,e6:aa:ea:b7:4a:dd,58727141,408,11703,58726733,58727141
6447,6,12,1,2412,-57,-92,35,40:e3:d6:da:ba:20,58734536,160,7235,58734376,58734536
6448,6,6,1,2412,-57,-92,35,40:e3:d6:da:ba:21,58734746,368,-158,58734378,58734746
6449,6,12,1,2412,-56,-92,36,40:e3:d6:da:ba:22,58735160,180,234,58734980,58735160
6450,6,12,1,2412,-58,-92,34,40:e3:d6:da:ba:23,58735381,184,37,58735197,58735381
6451,6,12,1,2412,-56,-92,36,40:e3:d6:da:ba:24,58735617,176,60,58735441,58735617
6452,6,12,1,2412,-57,-92,35,40:e3:d6:da:ba:25,58735818,160,41,58735658,58735818
6453,6,6,1,2412,-56,-92,36,40:e3:d6:da:ba:26,58736037,380,-161,58735657,58736037
6454,6,6,1,2412,-60,-92,32,e6:aa:ea:b7:4a:dd,58739249,408,2804,58738841,58739249
6455,4,1,1,2412,-66,-92,26,54:e4:3a:ec:fb:64,58745182,2160,3773,58743022,58745182
6456,6,6,1,2412,-61,-92,31,e6:aa:ea:b7:4a:dd,58751370,408,5780,58750962,58751370
6457,6,12,1,2412,-87,-92,5,84:d4:7e:f2:42:20,58752500,160,970,58752340,58752500
6458,6,12,1,2412,-88,-92,4,84:d4:7e:f2:42:23,58753311,180,631,58753131,58753311
6459,6,6,1,2412,-54,-92,38,e6:aa:ea:c9:ea:33,58799443,408,45724,58799035,58799443
6460,6,6,1,2412,-54,-92,38,e6:aa:ea:c9:ea:33,58811571,408,11720,58811163,58811571
6461,6,6,1,2412,-54,-92,38,e6:aa:ea:c9:ea:33,58823697,408,11718,58823289,58823697
6462,6,6,1,2412,-54,-92,38,e6:aa:ea:c9:ea:33,58835825,408,11720,58835417,58835825
6463,6,12,1,2412,-57,-92,35,40:e3:d6:da:ba:20,58836947,160,962,58836787,58836947
6464,6,6,1,2412,-57,-92,35,40:e3:d6:da:ba:21,58837166,368,-149,58836798,58837166
6465,6,12,1,2412,-57,-92,35,40:e3:d6:da:ba:22,58837553,180,207,58837373,58837553
6466,6,12,1,2412,-57,-92,35,40:e3:d6:da:ba:23,58837777,184,40,58837593,58837777
6467,6,12,1,2412,-57,-92,35,40:e3:d6:da:ba:24,58838004,176,51,58837828,58838004
6468,6,12,1,2412,-57,-92,35,40:e3:d6:da:ba:25,58838215,160,51,58838055,58838215
6469,6,6,1,2412,-57,-92,35,40:e3:d6:da:ba:26,58838407,380,-188,58838027,58838407
6470,6,6,1,2412,-88,-92,4,84:d4:7e:f2:42:21,58855072,368,16297,58854704,58855072
6471,6,12,1,2412,-87,-92,5,84:d4:7e:f2:42:22,58855459,180,207,58855279,58855459
6472,6,12,1,2412,-87,-92,5,84:d4:7e:f2:42:23,58855691,180,52,58855511,58855691
6473,6,12,1,2412,-88,-92,4,84:d4:7e:f2:42:24,58855906,176,39,58855730,58855906
6474,6,6,1,2412,-77,-92,15,e6:aa:ea:c9:ea:1b,58886667,408,30353,58886259,58886667
6475,6,12,1,2412,-57,-92,35,40:e3:d6:da:ba:20,58939352,160,52525,58939192,58939352
6476,6,6,1,2412,-57,-92,35,40:e3:d6:da:ba:21,58939571,368,-149,58939203,58939571
6477,6,12,1,2412,-57,-92,35,40:e3:d6:da:ba:22,58939958,180,207,58939778,58939958
6478,6,12,1,2412,-57,-92,35,40:e3:d6:da:ba:23,58940191,184,49,58940007,58940191
6479,6,6,1,2412,-55,-92,37,40:e3:d6:da:ba:26,58940836,380,265,58940456,58940836
6480,4,1,1,2412,-68,-92,24,54:e4:3a:ec:fb:64,58955993,2160,12997,58953833,58955993
6481,6,12,1,2412,-84,-92,8,84:d4:7e:f2:42:20,58958012,160,1859,58957852,58958012
6482,6,12,1,2412,-86,-92,6,84:d4:7e:f2:42:23,58958841,180,649,58958661,58958841
6483,6,12,1,2412,-85,-92,7,84:d4:7e:f2:42:24,58959047,176,30,58958871,58959047
6484,6,12,1,2412,-85,-92,7,84:d4:7e:f2:42:25,58959248,160,41,58959088,58959248
6485,6,6,1,2412,-85,-92,7,84:d4:7e:f2:42:26,58959440,380,-188,58959060,58959440
6486,4,1,1,2412,-62,-93,31,c0:c9:e3:4d:6e:bf,59023163,872,62851,59022291,59023163
6487,6,12,1,2412,-59,-93,34,40:e3:d6:da:ba:20,59041760,160,18437,59041600,59041760
6488,6,6,1,2412,-59,-93,34,40:e3:d6:da:ba:21,59041952,368,-176,59041584,59041952
6489,6,12,1,2412,-59,-93,34,40:e3:d6:da:ba:22,59042348,180,216,59042168,59042348
6490,6,12,1,2412,-59,-93,34,40:e3:d6:da:ba:23,59042572,184,40,59042388,59042572
6491,6,12,1,2412,-57,-93,36,40:e3:d6:da:ba:24,59042789,176,41,59042613,59042789
6492,6,12,1,2412,-57,-93,36,40:e3:d6:da:ba:25,59043034,160,85,59042874,59043034
6493,6,6,1,2412,-59,-93,34,40:e3:d6:da:ba:26,59043254,380,-160,59042874,59043254
6494,6,6,1,2412,-64,-93,29,e6:aa:ea:b7:4a:dd,59044011,408,349,59043603,59044011
6495,4,1,1,2412,-68,-93,25,54:e4:3a:ec:fb:64,59053288,2160,7117,59051128,59053288
6496,6,6,1,2412,-63,-93,30,e6:aa:ea:b7:4a:dd,59055321,408,1625,59054913,59055321
6497,6,6,1,2412,-63,-93,30,e6:aa:ea:b7:4a:dd,59067070,408,11341,59066662,59067070
6498,6,12,1,2412,-57,-93,36,40:e3:d6:da:ba:20,59144139,160,76909,59143979,59144139
6499,6,6,1,2412,-57,-93,36,40:e3:d6:da:ba:21,59144340,368,-167,59143972,59144340
6500,6,12,1,2412,-57,-93,36,40:e3:d6:da:ba:22,59144736,180,216,59144556,59144736
6501,6,12,1,2412,-57,-93,36,40:e3:d6:da:ba:23,59144974,184,54,59144790,59144974
6502,6,12,1,2412,-57,-93,36,40:e3:d6:da:ba:24,59145184,176,34,59145008,59145184
6503,6,12,1,2412,-57,-93,36,40:e3:d6:da:ba:25,59145394,160,50,59145234,59145394
6504,6,6,1,2412,-57,-93,36,40:e3:d6:da:ba:26,59145586,380,-188,59145206,59145586
6505,6,6,1,2412,-81,-93,12,e6:aa:ea:c9:ea:1b,59167501,408,21507,59167093,59167501
6506,4,1,1,2412,-90,-93,3,a4:e5:7c:28:b1:d3,59206896,688,38707,59206208,59206896
6507,6,12,1,2412,-57,-93,36,40:e3:d6:da:ba:22,59248857,180,41781,59248677,59248857
6508,6,12,1,2412,-57,-93,36,40:e3:d6:da:ba:23,59249245,184,204,59249061,59249245
6509,6,12,1,2412,-57,-93,36,40:e3:d6:da:ba:24,59249472,176,51,59249296,59249472
6510,6,12,1,2412,-86,-93,7,84:d4:7e:f2:42:22,59265024,180,15372,59264844,59265024
6511,6,12,1,2412,-84,-93,9,84:d4:7e:f2:42:24,59265471,176,271,59265295,59265471
6512,6,12,1,2412,-86,-93,7,84:d4:7e:f2:42:25,59265691,160,60,59265531,59265691
6513,6,6,1,2412,-58,-93,35,e6:aa:ea:c9:ea:33,59320610,408,54511,59320202,59320610
6514,6,6,1,2412,-58,-93,35,e6:aa:ea:c9:ea:33,59332731,408,11713,59332323,59332731
6515,6,6,1,2412,-58,-93,35,e6:aa:ea:c9:ea:33,59344844,408,11705,59344436,59344844
6516,6,6,1,2412,-61,-93,32,e6:aa:ea:b7:4a:dd,59345269,408,17,59344861,59345269
6517,6,12,1,2412,-56,-93,37,40:e3:d6:da:ba:20,59348934,160,3505,59348774,59348934
6518,6,12,1,2412,-56,-93,37,40:e3:d6:da:ba:22,59349522,180,408,59349342,59349522
6519,6,12,1,2412,-56,-93,37,40:e3:d6:da:ba:23,59349746,184,40,59349562,59349746
6520,6,12,1,2412,-56,-93,37,40:e3:d6:da:ba:24,59349973,176,51,59349797,59349973
6521,6,12,1,2412,-56,-93,37,40:e3:d6:da:ba:25,59350201,160,68,59350041,59350201
6522,6,6,1,2412,-56,-93,37,40:e3:d6:da:ba:26,59350411,380,-170,59350031,59350411
6523,6,6,1,2412,-57,-93,36,e6:aa:ea:c9:ea:33,59356964,408,6145,59356556,59356964
6524,6,6,1,2412,-62,-93,31,e6:aa:ea:b7:4a:dd,59357380,408,8,59356972,59357380
6525,6,12,1,2412,-84,-93,9,84:d4:7e:f2:42:20,59366798,160,9258,59366638,59366798
6526,6,12,1,2412,-84,-93,9,84:d4:7e:f2:42:22,59367431,180,453,59367251,59367431
6527,6,12,1,2412,-84,-93,9,84:d4:7e:f2:42:23,59367636,180,25,59367456,59367636
6528,6,12,1,2412,-84,-93,9,84:d4:7e:f2:42:24,59367851,176,39,59367675,59367851
6529,6,6,1,2412,-62,-93,31,e6:aa:ea:b7:4a:dd,59370125,408,1866,59369717,59370125
6530,6,6,1,2412,-61,-93,32,e6:aa:ea:b7:4a:dd,59381614,408,11081,59381206,59381614
6531,6,12,1,2412,-58,-93,35,40:e3:d6:da:ba:20,59451335,160,69561,59451175,59451335
6532,6,6,1,2412,-58,-93,35,40:e3:d6:da:ba:21,59451545,368,-158,59451177,59451545
6533,6,12,1,2412,-53,-93,40,40:e3:d6:da:ba:22,59451932,180,207,59451752,59451932
6534,6,12,1,2412,-58,-93,35,40:e3:d6:da:ba:24,59452365,176,257,59452189,59452365
6535,6,12,1,2412,-58,-93,35,40:e3:d6:da:ba:25,59452566,160,41,59452406,59452566
6536,6,6,1,2412,-58,-93,35,40:e3:d6:da:ba:26,59452758,380,-188,59452378,59452758
6537,4,1,1,2412,-64,-93,29,54:e4:3a:ec:fb:64,59461977,2160,7059,59459817,59461977
6538,6,12,1,2412,-84,-93,9,84:d4:7e:f2:42:20,59469320,160,7183,59469160,59469320
6539,6,6,1,2412,-84,-93,9,84:d4:7e:f2:42:21,59469539,368,-149,59469171,59469539
6540,6,12,1,2412,-85,-93,8,84:d4:7e:f2:42:22,59469934,180,215,59469754,59469934
6541,6,12,1,2412,-85,-93,8,84:d4:7e:f2:42:23,59470167,180,53,59469987,59470167
6542,6,12,1,2412,-85,-93,8,84:d4:7e:f2:42:24,59470399,176,56,59470223,59470399
6543,6,6,1,2412,-85,-93,8,84:d4:7e:f2:42:26,59470810,380,31,59470430,59470810
6544,6,12,1,2412,-58,-93,35,40:e3:d6:da:ba:20,59553757,160,82787,59553597,59553757
6545,6,6,1,2412,-59,-93,34,40:e3:d6:da:ba:21,59553949,368,-176,59553581,59553949
6546,6,12,1,2412,-59,-93,34,40:e3:d6:da:ba:22,59554354,180,225,59554174,59554354
6547,6,12,1,2412,-59,-93,34,40:e3:d6:da:ba:23,59554586,184,48,59554402,59554586
6548,6,12,1,2412,-59,-93,34,40:e3:d6:da:ba:24,59554796,176,34,59554620,59554796
6549,6,12,1,2412,-59,-93,34,40:e3:d6:da:ba:25,59555024,160,68,59554864,59555024
6550,6,6,1,2412,-59,-93,34,40:e3:d6:da:ba:26,59557622,380,2218,59557242,59557622
6551,4,1,1,2412,-68,-93,25,54:e4:3a:ec:fb:64,59567004,2160,7222,59564844,59567004
6552,6,6,1,2412,-78,-93,15,e6:aa:ea:c9:ea:1b,59587253,408,19841,59586845,59587253
6553,6,6,1,2412,-78,-93,15,e6:aa:ea:c9:ea:1b,59599366,408,11705,59598958,59599366
6554,6,6,1,2412,-78,-93,15,e6:aa:ea:c9:ea:1b,59611490,408,11716,59611082,59611490
6555,6,6,1,2412,-59,-93,34,e6:aa:ea:c9:ea:33,59634974,408,23076,59634566,59634974
6556,6,6,1,2412,-79,-93,14,e6:aa:ea:c9:ea:1b,59635723,408,341,59635315,59635723
6557,6,6,1,2412,-59,-93,34,e6:aa:ea:c9:ea:33,59647092,408,10961,59646684,59647092
6558,6,12,1,2412,-59,-93,34,40:e3:d6:da:ba:20,59656161,160,8909,59656001,59656161
6559,6,6,1,2412,-59,-93,34,40:e3:d6:da:ba:21,59656353,368,-176,59655985,59656353
6560,6,12,1,2412,-64,-93,29,40:e3:d6:da:ba:22,59656749,180,216,59656569,59656749
6561,6,12,1,2412,-59,-93,34,40:e3:d6:da:ba:23,59656963,184,30,59656779,59656963
6562,6,12,1,2412,-59,-93,34,40:e3:d6:da:ba:24,59657173,176,34,59656997,59657173
6563,6,12,1,2412,-58,-93,35,40:e3:d6:da:ba:25,59657374,160,41,59657214,59657374
6564,6,6,1,2412,-59,-93,34,40:e3:d6:da:ba:26,59657584,380,-170,59657204,59657584
6565,6,6,1,2412,-60,-93,33,e6:aa:ea:c9:ea:33,59659215,408,1223,59658807,59659215
6566,6,6,1,2412,-58,-93,35,e6:aa:ea:b7:4a:dd,59660737,408,1114,59660329,59660737
6567,4,1,1,2412,-68,-93,25,54:e4:3a:ec:fb:64,59666774,2160,3877,59664614,59666774
6568,6,6,1,2412,-60,-93,33,e6:aa:ea:c9:ea:33,59671331,408,4149,59670923,59671331
6569,6,6,1,2412,-58,-93,35,e6:aa:ea:b7:4a:dd,59672860,408,1121,59672452,59672860
6570,6,6,1,2412,-58,-93,35,e6:aa:ea:b7:4a:dd,59684980,408,11712,59684572,59684980
6571,6,12,1,2412,-61,-93,32,40:e3:d6:da:ba:20,59758548,160,73408,59758388,59758548
6572,6,6,1,2412,-60,-93,33,40:e3:d6:da:ba:21,59758758,368,-158,59758390,59758758
6573,6,12,1,2412,-60,-93,33,40:e3:d6:da:ba:22,59759145,180,207,59758965,59759145
6574,6,12,1,2412,-60,-93,33,40:e3:d6:da:ba:23,59759369,184,40,59759185,59759369
6575,6,12,1,2412,-60,-93,33,40:e3:d6:da:ba:24,59759605,176,60,59759429,59759605
6576,6,12,1,2412,-60,-93,33,40:e3:d6:da:ba:25,59759807,160,42,59759647,59759807
6577,6,6,1,2412,-60,-93,33,40:e3:d6:da:ba:26,59760026,380,-161,59759646,59760026
6578,4,1,1,2412,-68,-93,25,54:e4:3a:ec:fb:64,59769174,2160,6988,59767014,59769174
6579,4,1,1,2412,-92,-93,1,a6:e5:7c:28:b1:d3,59834087,992,63921,59833095,59834087
6580,6,12,1,2412,-60,-93,33,40:e3:d6:da:ba:20,59860937,160,26690,59860777,59860937
6581,6,6,1,2412,-59,-93,34,40:e3:d6:da:ba:21,59861147,368,-158,59860779,59861147
6582,6,12,1,2412,-58,-93,35,40:e3:d6:da:ba:22,59861648,180,321,59861468,59861648
6583,6,12,1,2412,-59,-93,34,40:e3:d6:da:ba:23,59861862,184,30,59861678,59861862
6584,6,12,1,2412,-59,-93,34,40:e3:d6:da:ba:24,59862099,176,61,59861923,59862099
6585,6,12,1,2412,-59,-93,34,40:e3:d6:da:ba:25,59862328,160,69,59862168,59862328
6586,6,6,1,2412,-59,-93,34,40:e3:d6:da:ba:26,59862553,380,-155,59862173,59862553
6587,6,12,1,2412,-57,-93,36,40:e3:d6:da:ba:20,59963340,160,100627,59963180,59963340
6588,6,6,1,2412,-57,-93,36,40:e3:d6:da:ba:21,59963532,368,-176,59963164,59963532
6589,6,12,1,2412,-57,-93,36,40:e3:d6:da:ba:22,59963919,180,207,59963739,59963919
6590,6,12,1,2412,-58,-93,35,40:e3:d6:da:ba:23,59964125,184,22,59963941,59964125
6591,6,12,1,2412,-53,-93,40,40:e3:d6:da:ba:24,59964368,176,67,59964192,59964368
6592,6,12,1,2412,-53,-93,40,40:e3:d6:da:ba:25,59964578,160,50,59964418,59964578
6593,6,6,1,2412,-58,-93,35,40:e3:d6:da:ba:26,59964805,380,-153,59964425,59964805
6594,6,12,1,2412,-64,-93,29,84:d4:7e:d5:12:c0,59994160,960,28395,59993200,59994160
6595,6,12,1,2412,-56,-93,37,40:e3:d6:da:ba:20,60065739,160,71419,60065579,60065739
6596,6,6,1,2412,-56,-93,37,40:e3:d6:da:ba:21,60065957,368,-150,60065589,60065957
6597,6,12,1,2412,-56,-93,37,40:e3:d6:da:ba:23,60066583,184,442,60066399,60066583
6598,6,12,1,2412,-56,-93,37,40:e3:d6:da:ba:24,60066810,176,51,60066634,60066810
6599,6,12,1,2412,-56,-93,37,40:e3:d6:da:ba:25,60067276,160,306,60067116,60067276
6600,6,6,1,2412,-56,-93,37,40:e3:d6:da:ba:26,60067477,380,-179,60067097,60067477
6601,4,1,1,2412,-69,-93,24,54:e4:3a:ec:fb:64,60076407,2160,6770,60074247,60076407
6602,6,12,1,2412,-87,-93,6,84:d4:7e:f2:42:24,60084679,176,8096,60084503,60084679
6603,6,12,1,2412,-88,-93,5,84:d4:7e:f2:42:25,60084880,160,41,60084720,60084880
6604,6,6,1,2412,-87,-93,6,84:d4:7e:f2:42:26,60085099,380,-161,60084719,60085099
6605,6,6,1,2412,-78,-93,15,e6:aa:ea:c9:ea:1b,60110226,408,24719,60109818,60110226
6606,6,6,1,2412,-79,-93,14,e6:aa:ea:c9:ea:1b,60122341,408,11707,60121933,60122341
6607,6,6,1,2412,-54,-93,39,e6:aa:ea:c9:ea:33,60155295,408,32546,60154887,60155295
6608,6,12,1,2412,-58,-93,35,40:e3:d6:da:ba:20,60168147,160,12692,60167987,60168147
6609,6,6,1,2412,-58,-93,35,40:e3:d6:da:ba:21,60168348,368,-167,60167980,60168348
6610,6,12,1,2412,-58,-93,35,40:e3:d6:da:ba:22,60168743,180,215,60168563,60168743
6611,6,12,1,2412,-57,-93,36,40:e3:d6:da:ba:23,60168958,184,31,60168774,60168958
6612,6,12,1,2412,-58,-93,35,40:e3:d6:da:ba:24,60169194,176,60,60169018,60169194
6613,6,12,1,2412,-58,-93,35,40:e3:d6:da:ba:25,60169423,160,69,60169263,60169423
6614,6,6,1,2412,-58,-93,35,40:e3:d6:da:ba:26,60169633,380,-170,60169253,60169633
6615,6,6,1,2412,-64,-93,29,e6:aa:ea:b7:4a:dd,60170404,408,363,60169996,60170404
6616,6,6,1,2412,-55,-93,38,e6:aa:ea:c9:ea:33,60191645,408,20833,60191237,60191645
6617,6,6,1,2412,-64,-93,29,e6:aa:ea:b7:4a:dd,60193358,408,1305,60192950,60193358
6618,6,6,1,2412,-56,-93,37,e6:aa:ea:c9:ea:33,60203762,408,9996,60203354,60203762
6619,6,6,1,2412,-64,-93,29,e6:aa:ea:b7:4a:dd,60205471,408,1301,60205063,60205471
6620,6,6,1,2412,-64,-93,29,e6:aa:ea:b7:4a:dd,60217601,408,11722,60217193,60217601
6621,6,12,1,2412,-56,-93,37,40:e3:d6:da:ba:20,60270562,160,52801,60270402,60270562
6622,6,6,1,2412,-57,-93,36,40:e3:d6:da:ba:21,60270786,368,-144,60270418,60270786
6623,6,12,1,2412,-56,-93,37,40:e3:d6:da:ba:23,60271431,184,461,60271247,60271431
6624,6,12,1,2412,-56,-93,37,40:e3:d6:da:ba:24,60271685,176,78,60271509,60271685
6625,6,12,1,2412,-55,-93,38,40:e3:d6:da:ba:25,60271929,160,84,60271769,60271929
6626,6,6,1,2412,-56,-93,37,40:e3:d6:da:ba:26,60272258,380,-51,60271878,60272258
6627,4,1,1,2412,-64,-93,29,54:e4:3a:ec:fb:64,60281169,2160,6751,60279009,60281169
6628,6,12,1,2412,-54,-93,39,40:e3:d6:da:ba:20,60372942,160,91613,60372782,60372942
6629,6,12,1,2412,-54,-93,39,40:e3:d6:da:ba:22,60373530,180,408,60373350,60373530
6630,6,12,1,2412,-54,-93,39,40:e3:d6:da:ba:23,60373745,184,31,60373561,60373745
6631,6,12,1,2412,-54,-93,39,40:e3:d6:da:ba:24,60373981,176,60,60373805,60373981
6632,6,12,1,2412,-54,-93,39,40:e3:d6:da:ba:25,60374210,160,69,60374050,60374210
6633,6,6,1,2412,-54,-93,39,40:e3:d6:da:ba:26,60374429,380,-161,60374049,60374429
6634,6,12,1,2412,-87,-93,6,84:d4:7e:f2:42:22,60391616,180,17007,60391436,60391616
6635,6,6,1,2412,-86,-93,7,84:d4:7e:f2:42:26,60392465,380,469,60392085,60392465
6636,6,6,1,2412,-82,-93,11,e6:aa:ea:c9:ea:1b,60439498,408,46625,60439090,60439498
6637,6,6,1,2412,-82,-93,11,e6:aa:ea:c9:ea:1b,60451623,408,11717,60451215,60451623
6638,6,6,1,2412,-55,-93,38,e6:aa:ea:c9:ea:33,60471207,408,19176,60470799,60471207
6639,6,12,1,2412,-54,-93,39,40:e3:d6:da:ba:20,60475342,160,3975,60475182,60475342
6640,6,6,1,2412,-54,-93,39,40:e3:d6:da:ba:21,60475561,368,-149,60475193,60475561
6641,6,12,1,2412,-54,-93,39,40:e3:d6:da:ba:22,60475957,180,216,60475777,60475957
6642,6,12,1,2412,-54,-93,39,40:e3:d6:da:ba:23,60476180,184,39,60475996,60476180
6643,6,12,1,2412,-54,-93,39,40:e3:d6:da:ba:24,60476416,176,60,60476240,60476416
6644,6,12,1,2412,-54,-93,39,40:e3:d6:da:ba:25,60476627,160,51,60476467,60476627
6645,6,6,1,2412,-54,-93,39,40:e3:d6:da:ba:26,60476819,380,-188,60476439,60476819
6646,6,6,1,2412,-54,-93,39,e6:aa:ea:c9:ea:33,60483283,408,6056,60482875,60483283
6647,6,6,1,2412,-54,-93,39,e6:aa:ea:c9:ea:33,60495738,408,12047,60495330,60495738
6648,6,6,1,2412,-53,-93,40,e6:aa:ea:c9:ea:33,60507570,408,11424,60507162,60507570
6649,6,6,1,2412,-53,-93,40,e6:aa:ea:c9:ea:33,60519649,408,11671,60519241,60519649
6650,6,12,1,2412,-57,-93,36,40:e3:d6:da:ba:20,60577954,160,58145,60577794,60577954
6651,6,6,1,2412,-57,-93,36,40:e3:d6:da:ba:21,60578146,368,-176,60577778,60578146
6652,6,12,1,2412,-57,-93,36,40:e3:d6:da:ba:22,60578679,180,353,60578499,60578679
6653,6,12,1,2412,-57,-93,36,40:e3:d6:da:ba:23,60578902,184,39,60578718,60578902
6654,6,12,1,2412,-57,-93,36,40:e3:d6:da:ba:24,60579112,176,34,60578936,60579112
6655,6,12,1,2412,-57,-93,36,40:e3:d6:da:ba:25,60579322,160,50,60579162,60579322
6656,6,6,1,2412,-57,-93,36,40:e3:d6:da:ba:26,60579532,380,-170,60579152,60579532
6657,4,1,1,2412,-67,-93,26,54:e4:3a:ec:fb:64,60588366,2160,6674,60586206,60588366
6658,6,6,1,2412,-86,-93,7,84:d4:7e:f2:42:21,60595825,368,7091,60595457,60595825
6659,6,6,1,2412,-86,-93,7,84:d4:7e:f2:42:26,60597062,380,857,60596682,60597062
6660,4,1,1,2412,-91,-93,2,a6:e5:7c:28:b1:d3,60615662,944,17656,60614718,60615662
6661,4,1,1,2412,-91,-93,2,a6:e5:7c:28:b1:d3,60616722,944,116,60615778,60616722
6662,6,12,1,2412,-58,-93,35,40:e3:d6:da:ba:20,60680141,160,63259,60679981,60680141
6663,6,12,1,2412,-57,-93,36,40:e3:d6:da:ba:22,60680738,180,417,60680558,60680738
6664,6,12,1,2412,-56,-93,37,40:e3:d6:da:ba:23,60680961,184,39,60680777,60680961
6665,6,12,1,2412,-57,-93,36,40:e3:d6:da:ba:24,60681180,176,43,60681004,60681180
6666,6,12,1,2412,-57,-93,36,40:e3:d6:da:ba:25,60681408,160,68,60681248,60681408
6667,6,6,1,2412,-57,-93,36,40:e3:d6:da:ba:26,60682310,380,522,60681930,60682310
6668,4,1,1,2412,-87,-93,6,b8:3a:5a:88:e6:e1,60695356,2376,10670,60692980,60695356
6669,6,6,1,2412,-87,-93,6,84:d4:7e:f2:42:21,60698222,368,2498,60697854,60698222
6670,6,12,1,2412,-87,-93,6,84:d4:7e:f2:42:22,60698609,180,207,60698429,60698609
6671,6,6,1,2412,-62,-93,31,e6:aa:ea:b7:4a:dd,60701567,408,2550,60701159,60701567
6672,6,6,1,2412,-64,-93,29,e6:aa:ea:b7:4a:dd,60725809,408,23834,60725401,60725809
6673,6,6,1,2412,-64,-93,29,e6:aa:ea:b7:4a:dd,60737922,408,11705,60737514,60737922
6674,6,6,1,2412,-57,-93,36,40:e3:d6:da:ba:21,60782797,368,44507,60782429,60782797
6675,6,12,1,2412,-57,-93,36,40:e3:d6:da:ba:22,60783203,180,226,60783023,60783203
6676,6,12,1,2412,-57,-93,36,40:e3:d6:da:ba:23,60783417,184,30,60783233,60783417
6677,6,12,1,2412,-56,-93,37,40:e3:d6:da:ba:24,60783644,176,51,60783468,60783644
6678,6,12,1,2412,-56,-93,37,40:e3:d6:da:ba:25,60783864,160,60,60783704,60783864
6679,6,6,1,2412,-57,-93,36,40:e3:d6:da:ba:26,60784056,380,-188,60783676,60784056
6680,6,12,1,2412,-87,-93,6,84:d4:7e:f2:42:20,60800415,160,16199,60800255,60800415
6681,6,6,1,2412,-87,-93,6,84:d4:7e:f2:42:21,60800616,368,-167,60800248,60800616
6682,6,12,1,2412,-87,-93,6,84:d4:7e:f2:42:22,60801003,180,207,60800823,60801003
6683,6,12,1,2412,-88,-93,5,84:d4:7e:f2:42:23,60801208,180,25,60801028,60801208
6684,6,12,1,2412,-57,-93,36,40:e3:d6:da:ba:20,60884964,160,83596,60884804,60884964
6685,6,12,1,2412,-57,-93,36,40:e3:d6:da:ba:22,60885552,180,408,60885372,60885552
6686,6,12,1,2412,-57,-93,36,40:e3:d6:da:ba:23,60885757,184,21,60885573,60885757
6687,6,12,1,2412,-57,-93,36,40:e3:d6:da:ba:24,60886003,176,70,60885827,60886003
6688,6,12,1,2412,-57,-93,36,40:e3:d6:da:ba:25,60886213,160,50,60886053,60886213
6689,6,6,1,2412,-57,-93,36,40:e3:d6:da:ba:26,60886414,380,-179,60886034,60886414
6690,6,12,1,2412,-87,-93,6,84:d4:7e:f2:42:24,60903904,176,17314,60903728,60903904
6691,6,12,1,2412,-86,-93,7,84:d4:7e:f2:42:25,60904115,160,51,60903955,60904115
6692,6,6,1,2412,-57,-93,36,40:e3:d6:da:ba:21,60987585,368,83102,60987217,60987585
6693,6,12,1,2412,-56,-93,37,40:e3:d6:da:ba:22,60987998,180,233,60987818,60987998
6694,6,12,1,2412,-56,-93,37,40:e3:d6:da:ba:23,60988204,184,22,60988020,60988204
6695,6,12,1,2412,-57,-93,36,40:e3:d6:da:ba:24,60988414,176,34,60988238,60988414
6696,6,12,1,2412,-57,-93,36,40:e3:d6:da:ba:25,60988633,160,59,60988473,60988633
6697,6,6,1,2412,-56,-93,37,40:e3:d6:da:ba:26,60988852,380,-161,60988472,60988852
6698,6,6,1,2412,-58,-93,35,e6:aa:ea:c9:ea:33,60991264,408,2004,60990856,60991264
6699,6,6,1,2412,-58,-93,35,e6:aa:ea:c9:ea:33,61003380,408,11708,61002972,61003380
6700,6,6,1,2412,-62,-93,31,e6:aa:ea:b7:4a:dd,61004702,408,914,61004294,61004702
6701,6,12,1,2412,-81,-93,12,84:d4:7e:f2:42:22,61005903,180,1021,61005723,61005903
6702,6,12,1,2412,-88,-93,5,84:d4:7e:f2:42:23,61006136,180,53,61005956,61006136
6703,6,12,1,2412,-84,-93,9,84:d4:7e:f2:42:24,61006341,176,29,61006165,61006341
6704,6,6,1,2412,-57,-93,36,e6:aa:ea:c9:ea:33,61015491,408,8742,61015083,61015491
6705,6,6,1,2412,-62,-93,31,e6:aa:ea:b7:4a:dd,61016813,408,914,61016405,61016813
6706,6,6,1,2412,-57,-93,36,e6:aa:ea:c9:ea:33,61027619,408,10398,61027211,61027619
6707,6,6,1,2412,-62,-93,31,e6:aa:ea:b7:4a:dd,61028929,408,902,61028521,61028929
6708,6,6,1,2412,-57,-93,36,e6:aa:ea:c9:ea:33,61039776,408,10439,61039368,61039776
6709,6,6,1,2412,-62,-93,31,e6:aa:ea:b7:4a:dd,61041056,408,872,61040648,61041056
6710,6,6,1,2412,-61,-93,32,e6:aa:ea:b7:4a:dd,61053178,408,11714,61052770,61053178
6711,6,6,1,2412,-57,-93,36,40:e3:d6:da:ba:21,61089937,368,36391,61089569,61089937
6712,6,12,1,2412,-57,-93,36,40:e3:d6:da:ba:22,61090323,180,206,61090143,61090323
6713,6,12,1,2412,-57,-93,36,40:e3:d6:da:ba:23,61090538,184,31,61090354,61090538
6714,6,12,1,2412,-57,-93,36,40:e3:d6:da:ba:24,61090774,176,60,61090598,61090774
6715,6,12,1,2412,-57,-93,36,40:e3:d6:da:ba:25,61090976,160,42,61090816,61090976
6716,6,6,1,2412,-57,-93,36,40:e3:d6:da:ba:26,61091177,380,-179,61090797,61091177
6717,4,1,1,2412,-70,-93,23,54:e4:3a:ec:fb:64,61100385,2160,7048,61098225,61100385
6718,6,12,1,2412,-87,-93,6,84:d4:7e:f2:42:20,61107618,160,7073,61107458,61107618
6719,6,12,1,2412,-57,-93,36,40:e3:d6:da:ba:20,61192263,160,84485,61192103,61192263
6720,6,6,1,2412,-57,-93,36,40:e3:d6:da:ba:21,61192473,368,-158,61192105,61192473
6721,6,12,1,2412,-57,-93,36,40:e3:d6:da:ba:22,61192887,180,234,61192707,61192887
6722,6,12,1,2412,-57,-93,36,40:e3:d6:da:ba:23,61193110,184,39,61192926,61193110
6723,6,12,1,2412,-57,-93,36,40:e3:d6:da:ba:24,61193347,176,61,61193171,61193347
6724,6,12,1,2412,-57,-93,36,40:e3:d6:da:ba:25,61193557,160,50,61193397,61193557
6725,6,6,1,2412,-57,-93,36,40:e3:d6:da:ba:26,61193767,380,-170,61193387,61193767
6726,6,12,1,2412,-89,-93,4,84:d4:7e:f2:42:20,61210028,160,16101,61209868,61210028
6727,6,6,1,2412,-80,-93,13,e6:aa:ea:c9:ea:1b,61266668,408,56232,61266260,61266668
6728,6,12,1,2412,-57,-93,36,40:e3:d6:da:ba:20,61294568,160,27740,61294408,61294568
6729,6,6,1,2412,-57,-93,36,40:e3:d6:da:ba:21,61294787,368,-149,61294419,61294787
6730,6,12,1,2412,-57,-93,36,40:e3:d6:da:ba:22,61295192,180,225,61295012,61295192
6731,6,12,1,2412,-57,-93,36,40:e3:d6:da:ba:24,61295666,176,298,61295490,61295666
6732,6,12,1,2412,-57,-93,36,40:e3:d6:da:ba:25,61295868,160,42,61295708,61295868
6733,6,6,1,2412,-57,-93,36,40:e3:d6:da:ba:26,61296069,380,-179,61295689,61296069
6734,6,12,1,2412,-86,-93,7,84:d4:7e:f2:42:20,61312409,160,16180,61312249,61312409
6735,6,12,1,2412,-87,-93,6,84:d4:7e:f2:42:22,61313033,180,444,61312853,61313033
6736,6,12,1,2412,-87,-93,6,84:d4:7e:f2:42:23,61313239,180,26,61313059,61313239
6737,6,6,1,2412,-57,-93,36,e6:aa:ea:b7:4a:dd,61319772,408,6125,61319364,61319772
6738,6,6,1,2412,-53,-93,40,e6:aa:ea:c9:ea:33,61330315,408,10135,61329907,61330315
6739,6,6,1,2412,-62,-93,31,e6:aa:ea:b7:4a:dd,61331899,408,1176,61331491,61331899
6740,6,6,1,2412,-53,-93,40,e6:aa:ea:c9:ea:33,61342460,408,10153,61342052,61342460
6741,6,6,1,2412,-61,-93,32,e6:aa:ea:b7:4a:dd,61356126,408,13258,61355718,61356126
6742,6,12,1,2412,-57,-93,36,40:e3:d6:da:ba:20,61396967,160,40681,61396807,61396967
6743,6,6,1,2412,-57,-93,36,40:e3:d6:da:ba:21,61397168,368,-167,61396800,61397168
6744,6,12,1,2412,-57,-93,36,40:e3:d6:da:ba:22,61397555,180,207,61397375,61397555
6745,6,12,1,2412,-57,-93,36,40:e3:d6:da:ba:23,61397760,184,21,61397576,61397760
6746,6,12,1,2412,-55,-93,38,40:e3:d6:da:ba:24,61397970,176,34,61397794,61397970
6747,6,12,1,2412,-56,-93,37,40:e3:d6:da:ba:25,61398170,160,40,61398010,61398170
6748,6,6,1,2412,-57,-93,36,40:e3:d6:da:ba:26,61398390,380,-160,61398010,61398390
6749,6,6,1,2412,-88,-93,5,84:d4:7e:f2:42:21,61415028,368,16270,61414660,61415028
6750,4,1,1,2412,-91,-93,2,c0:c9:e3:4d:6e:bf,61489237,872,73337,61488365,61489237
6751,4,1,1,2412,-63,-93,30,,61490126,304,585,61489822,61490126
6752,6,12,1,2412,-58,-93,35,40:e3:d6:da:ba:20,61499997,160,9711,61499837,61499997
6753,6,6,1,2412,-58,-93,35,40:e3:d6:da:ba:21,61500216,368,-149,61499848,61500216
6754,6,12,1,2412,-58,-93,35,40:e3:d6:da:ba:23,61500852,184,452,61500668,61500852
6755,6,12,1,2412,-58,-93,35,40:e3:d6:da:ba:24,61501071,176,43,61500895,61501071
6756,6,12,1,2412,-58,-93,35,40:e3:d6:da:ba:25,61501290,160,59,61501130,61501290
6757,6,6,1,2412,-58,-93,35,40:e3:d6:da:ba:26,61501482,380,-188,61501102,61501482
6758,4,1,1,2412,-89,-93,4,a6:e5:7c:28:b1:d3,61574825,992,72351,61573833,61574825
6759,6,12,1,2412,-58,-93,35,40:e3:d6:da:ba:20,61601746,160,26761,61601586,61601746
6760,6,6,1,2412,-58,-93,35,40:e3:d6:da:ba:21,61601947,368,-167,61601579,61601947
6761,6,12,1,2412,-58,-93,35,40:e3:d6:da:ba:22,61602343,180,216,61602163,61602343
6762,6,12,1,2412,-57,-93,36,40:e3:d6:da:ba:23,61602548,184,21,61602364,61602548
6763,6,12,1,2412,-57,-93,36,40:e3:d6:da:ba:24,61602785,176,61,61602609,61602785
6764,6,12,1,2412,-58,-93,35,40:e3:d6:da:ba:25,61602986,160,41,61602826,61602986
6765,6,6,1,2412,-57,-93,36,40:e3:d6:da:ba:26,61603187,380,-179,61602807,61603187
6766,6,6,1,2412,-60,-93,33,e6:aa:ea:b7:4a:dd,61634957,408,31362,61634549,61634957
6767,6,6,1,2412,-60,-93,33,e6:aa:ea:b7:4a:dd,61647086,408,11721,61646678,61647086
6768,6,6,1,2412,-60,-93,33,e6:aa:ea:b7:4a:dd,61659196,408,11702,61658788,61659196
6769,6,6,1,2412,-61,-93,32,e6:aa:ea:b7:4a:dd,61671312,408,11708,61670904,61671312
6770,6,6,1,2412,-61,-93,32,e6:aa:ea:b7:4a:dd,61683430,408,11710,61683022,61683430
6771,6,12,1,2412,-56,-93,37,40:e3:d6:da:ba:20,61704158,160,20568,61703998,61704158
6772,6,6,1,2412,-56,-93,37,40:e3:d6:da:ba:21,61704377,368,-149,61704009,61704377
6773,6,12,1,2412,-55,-93,38,40:e3:d6:da:ba:22,61704782,180,225,61704602,61704782
6774,6,12,1,2412,-55,-93,38,40:e3:d6:da:ba:25,61705486,160,544,61705326,61705486
6775,6,6,1,2412,-55,-93,38,40:e3:d6:da:ba:26,61705705,380,-161,61705325,61705705
6776,6,6,1,2412,-81,-93,12,e6:aa:ea:c9:ea:1b,61801867,408,95754,61801459,61801867
6777,6,12,1,2412,-55,-93,38,40:e3:d6:da:ba:20,61806715,160,4688,61806555,61806715
6778,6,6,1,2412,-55,-93,38,40:e3:d6:da:ba:21,61806925,368,-158,61806557,61806925
6779,6,12,1,2412,-55,-93,38,40:e3:d6:da:ba:22,61807329,180,224,61807149,61807329
6780,6,12,1,2412,-55,-93,38,40:e3:d6:da:ba:23,61807535,184,22,61807351,61807535
6781,6,12,1,2412,-55,-93,38,40:e3:d6:da:ba:24,61807771,176,60,61807595,61807771
6782,6,12,1,2412,-55,-93,38,40:e3:d6:da:ba:25,61807982,160,51,61807822,61807982
6783,6,6,1,2412,-55,-93,38,40:e3:d6:da:ba:26,61808192,380,-170,61807812,61808192
6784,4,1,1,2412,-72,-93,21,54:e4:3a:ec:fb:64,61817157,2160,6805,61814997,61817157
6785,6,6,1,2412,-51,-93,42,e6:aa:ea:c9:ea:33,61826248,408,8683,61825840,61826248
6786,6,6,1,2412,-51,-93,42,e6:aa:ea:c9:ea:33,61850831,408,24175,61850423,61850831
6787,6,6,1,2412,-51,-93,42,e6:aa:ea:c9:ea:33,61865800,408,14561,61865392,61865800
6788,4,1,1,2412,-77,-93,16,a6:e5:7c:28:b1:d3,61882365,992,15573,61881373,61882365
6789,6,12,1,2412,-58,-93,35,40:e3:d6:da:ba:20,61908968,160,26443,61908808,61908968
6790,6,6,1,2412,-57,-93,36,40:e3:d6:da:ba:21,61909169,368,-167,61908801,61909169
6791,6,12,1,2412,-57,-93,36,40:e3:d6:da:ba:22,61909565,180,216,61909385,61909565
6792,6,12,1,2412,-57,-93,36,40:e3:d6:da:ba:23,61909788,184,39,61909604,61909788
6793,6,12,1,2412,-58,-93,35,40:e3:d6:da:ba:24,61910013,176,49,61909837,61910013
6794,6,6,1,2412,-55,-93,38,40:e3:d6:da:ba:26,61910487,380,94,61910107,61910487
6795,4,1,1,2412,-75,-93,18,54:e4:3a:ec:fb:64,61919555,2160,6908,61917395,61919555
6796,6,6,1,2412,-90,-93,3,84:d4:7e:f2:42:21,61928827,368,8904,61928459,61928827
6797,6,12,1,2412,-56,-93,37,40:e3:d6:da:ba:20,62011489,160,82502,62011329,62011489
6798,6,6,1,2412,-56,-93,37,40:e3:d6:da:ba:21,62011714,368,-143,62011346,62011714
6799,6,12,1,2412,-56,-93,37,40:e3:d6:da:ba:23,62012343,184,445,62012159,62012343
6800,6,12,1,2412,-56,-93,37,40:e3:d6:da:ba:24,62012580,176,61,62012404,62012580
6801,6,12,1,2412,-56,-93,37,40:e3:d6:da:ba:25,62012799,160,59,62012639,62012799
6802,6,6,1,2412,-56,-93,37,40:e3:d6:da:ba:26,62013018,380,-161,62012638,62013018
6803,6,6,1,2412,-86,-93,7,84:d4:7e:f2:42:21,62029429,368,16043,62029061,62029429
6804,6,6,1,2412,-60,-93,33,e6:aa:ea:b7:4a:dd,62052907,408,23070,62052499,62052907
6805,6,6,1,2412,-59,-93,34,e6:aa:ea:b7:4a:dd,62065031,408,11716,62064623,62065031
6806,6,6,1,2412,-60,-93,33,e6:aa:ea:b7:4a:dd,62077141,408,11702,62076733,62077141
6807,6,6,1,2412,-60,-93,33,e6:aa:ea:b7:4a:dd,62101393,408,23844,62100985,62101393
6808,6,6,1,2412,-80,-93,13,e6:aa:ea:c9:ea:1b,62106847,408,5046,62106439,62106847
6809,6,12,1,2412,-55,-93,38,40:e3:d6:da:ba:20,62113793,160,6786,62113633,62113793
6810,6,6,1,2412,-55,-93,38,40:e3:d6:da:ba:21,62114002,368,-159,62113634,62114002
6811,6,12,1,2412,-55,-93,38,40:e3:d6:da:ba:22,62114404,180,222,62114224,62114404
6812,6,12,1,2412,-55,-93,38,40:e3:d6:da:ba:23,62114637,184,49,62114453,62114637
6813,6,12,1,2412,-55,-93,38,40:e3:d6:da:ba:24,62115051,176,238,62114875,62115051
6814,6,12,1,2412,-55,-93,38,40:e3:d6:da:ba:25,62115280,160,69,62115120,62115280
6815,6,6,1,2412,-54,-93,39,40:e3:d6:da:ba:26,62115472,380,-188,62115092,62115472
6816,6,6,1,2412,-80,-93,13,e6:aa:ea:c9:ea:1b,62118972,408,3092,62118564,62118972
6817,4,1,1,2412,-65,-93,28,54:e4:3a:ec:fb:64,62124354,2160,3222,62122194,62124354
6818,6,6,1,2412,-79,-93,14,e6:aa:ea:c9:ea:1b,62143328,408,18566,62142920,62143328
6819,6,12,1,2412,-54,-93,39,40:e3:d6:da:ba:20,62216175,160,72687,62216015,62216175
6820,6,6,1,2412,-54,-93,39,40:e3:d6:da:ba:21,62216367,368,-176,62215999,62216367
6821,6,12,1,2412,-55,-93,38,40:e3:d6:da:ba:23,62216969,184,418,62216785,62216969
6822,6,12,1,2412,-59,-93,34,40:e3:d6:da:ba:24,62217178,176,33,62217002,62217178
6823,6,12,1,2412,-55,-93,38,40:e3:d6:da:ba:25,62217379,160,41,62217219,62217379
6824,6,6,1,2412,-55,-93,38,40:e3:d6:da:ba:26,62217589,380,-170,62217209,62217589
6825,6,12,1,2412,-85,-93,8,84:d4:7e:f2:42:22,62234631,180,16862,62234451,62234631
6826,6,12,1,2412,-85,-93,8,84:d4:7e:f2:42:23,62234837,180,26,62234657,62234837
6827,6,12,1,2412,-85,-93,8,84:d4:7e:f2:42:24,62235051,176,38,62234875,62235051
6828,6,12,1,2412,-86,-93,7,84:d4:7e:f2:42:25,62235261,160,50,62235101,62235261
6829,6,6,1,2412,-84,-93,9,84:d4:7e:f2:42:26,62235471,380,-170,62235091,62235471
6830,6,12,1,2412,-62,-93,31,40:e3:d6:da:ba:20,62318571,160,82940,62318411,62318571
6831,6,6,1,2412,-54,-93,39,40:e3:d6:da:ba:21,62318781,368,-158,62318413,62318781
6832,6,12,1,2412,-54,-93,39,40:e3:d6:da:ba:22,62319186,180,225,62319006,62319186
6833,6,12,1,2412,-54,-93,39,40:e3:d6:da:ba:23,62319418,184,48,62319234,62319418
6834,6,12,1,2412,-54,-93,39,40:e3:d6:da:ba:24,62319786,176,192,62319610,62319786
6835,6,12,1,2412,-54,-93,39,40:e3:d6:da:ba:25,62319988,160,42,62319828,62319988
6836,6,6,1,2412,-54,-93,39,40:e3:d6:da:ba:26,62320188,380,-180,62319808,62320188
6837,4,1,1,2412,-64,-93,29,54:e4:3a:ec:fb:64,62329152,2160,6804,62326992,62329152
6838,6,6,1,2412,-51,-93,42,e6:aa:ea:c9:ea:33,62347488,408,17928,62347080,62347488
6839,6,6,1,2412,-52,-93,41,e6:aa:ea:c9:ea:33,62357240,408,9344,62356832,62357240
6840,6,6,1,2412,-70,-93,23,e6:aa:ea:b7:4a:dd,62368318,408,10670,62367910,62368318
6841,6,6,1,2412,-68,-93,25,e6:aa:ea:b7:4a:dd,62380450,408,11724,62380042,62380450
6842,6,6,1,2412,-53,-93,40,e6:aa:ea:c9:ea:33,62381545,408,687,62381137,62381545
6843,6,6,1,2412,-54,-93,39,e6:aa:ea:c9:ea:33,62395083,408,13130,62394675,62395083
6844,6,6,1,2412,-65,-93,28,e6:aa:ea:b7:4a:dd,62404872,408,9381,62404464,62404872
6845,6,6,1,2412,-63,-93,30,e6:aa:ea:b7:4a:dd,62416795,408,11515,62416387,62416795
6846,6,12,1,2412,-58,-93,35,40:e3:d6:da:ba:20,62420964,160,4009,62420804,62420964
6847,6,6,1,2412,-58,-93,35,40:e3:d6:da:ba:21,62421183,368,-149,62420815,62421183
6848,6,12,1,2412,-58,-93,35,40:e3:d6:da:ba:22,62421570,180,207,62421390,62421570
6849,6,12,1,2412,-58,-93,35,40:e3:d6:da:ba:23,62424428,184,2674,62424244,62424428
6850,6,12,1,2412,-58,-93,35,40:e3:d6:da:ba:24,62424637,176,33,62424461,62424637
6851,6,12,1,2412,-58,-93,35,40:e3:d6:da:ba:25,62425048,160,251,62424888,62425048
6852,6,6,1,2412,-58,-93,35,40:e3:d6:da:ba:26,62425267,380,-161,62424887,62425267
6853,4,1,1,2412,-70,-93,23,54:e4:3a:ec:fb:64,62431552,2160,4125,62429392,62431552
6854,4,1,1,2412,-90,-93,3,c0:c9:e3:4d:6e:bf,62474324,872,41900,62473452,62474324
6855,6,12,1,2412,-58,-93,35,40:e3:d6:da:ba:20,62523846,160,49362,62523686,62523846
6856,6,6,1,2412,-58,-93,35,40:e3:d6:da:ba:21,62524038,368,-176,62523670,62524038
6857,6,12,1,2412,-58,-93,35,40:e3:d6:da:ba:22,62524443,180,225,62524263,62524443
6858,6,12,1,2412,-58,-93,35,40:e3:d6:da:ba:23,62524675,184,48,62524491,62524675
6859,4,1,1,2412,-66,-93,27,54:e4:3a:ec:fb:64,62533950,2160,7115,62531790,62533950
6860,6,12,1,2412,-57,-93,36,40:e3:d6:da:ba:20,62625777,160,91667,62625617,62625777
6861,6,6,1,2412,-57,-93,36,40:e3:d6:da:ba:21,62625996,368,-149,62625628,62625996
6862,6,12,1,2412,-57,-93,36,40:e3:d6:da:ba:22,62626383,180,207,62626203,62626383
6863,6,12,1,2412,-57,-93,36,40:e3:d6:da:ba:23,62626597,184,30,62626413,62626597
6864,6,12,1,2412,-57,-93,36,40:e3:d6:da:ba:24,62626816,176,43,62626640,62626816
6865,6,12,1,2412,-57,-93,36,40:e3:d6:da:ba:25,62627044,160,68,62626884,62627044
6866,6,6,1,2412,-57,-93,36,40:e3:d6:da:ba:26,62627263,380,-161,62626883,62627263
6867,4,1,1,2412,-60,-93,33,54:e4:3a:ec:fb:64,62636349,2160,6926,62634189,62636349
6868,6,6,1,2412,-89,-93,4,84:d4:7e:f2:42:26,62645787,380,9058,62645407,62645787
6869,6,6,1,2412,-80,-93,13,e6:aa:ea:c9:ea:1b,62665035,408,18840,62664627,62665035
6870,6,6,1,2412,-81,-93,12,e6:aa:ea:c9:ea:1b,62677152,408,11709,62676744,62677152
6871,6,12,1,2412,-56,-93,37,40:e3:d6:da:ba:20,62728169,160,50857,62728009,62728169
6872,6,12,1,2412,-56,-93,37,40:e3:d6:da:ba:22,62728803,180,454,62728623,62728803
6873,6,12,1,2412,-56,-93,37,40:e3:d6:da:ba:23,62729009,184,22,62728825,62729009
6874,6,12,1,2412,-88,-93,5,84:d4:7e:f2:42:20,62746011,160,16842,62745851,62746011
6875,6,6,1,2412,-88,-93,5,84:d4:7e:f2:42:21,62746230,368,-149,62745862,62746230
6876,6,6,1,2412,-84,-93,9,78:8a:20:fa:27:f9,62748887,88,2569,62748799,62748887
6877,6,12,1,2412,-56,-93,37,40:e3:d6:da:ba:20,62749136,136,113,62749000,62749136
6878,6,6,1,2412,-56,-93,37,40:e3:d6:da:ba:21,62749322,348,-162,62748974,62749322
6879,6,12,1,2412,-56,-93,37,40:e3:d6:da:ba:22,62749707,156,229,62749551,62749707
6880,6,12,1,2412,-56,-93,37,40:e3:d6:da:ba:25,62750182,136,339,62750046,62750182
6881,6,12,1,2412,-56,-93,37,40:e3:d6:da:ba:20,62799184,136,48866,62799048,62799184
6882,6,12,1,2412,-84,-93,9,,62799357,32,141,62799325,62799357
6883,6,6,1,2412,-57,-93,36,40:e3:d6:da:ba:21,62799430,348,-275,62799082,62799430
6884,6,12,1,2412,-56,-93,37,40:e3:d6:da:ba:22,62800177,156,591,62800021,62800177
6885,6,12,1,2412,-56,-93,37,40:e3:d6:da:ba:23,62800376,156,43,62800220,62800376
6886,6,12,1,2412,-56,-93,37,40:e3:d6:da:ba:25,62800776,136,264,62800640,62800776
6887,6,12,1,2412,-57,-93,36,40:e3:d6:da:ba:20,62830560,160,29624,62830400,62830560
6888,6,6,1,2412,-58,-93,35,40:e3:d6:da:ba:21,62830751,368,-177,62830383,62830751
6889,6,12,1,2412,-56,-93,37,40:e3:d6:da:ba:22,62831162,180,231,62830982,62831162
6890,6,12,1,2412,-56,-93,37,40:e3:d6:da:ba:24,62831610,176,272,62831434,62831610
6891,6,12,1,2412,-56,-93,37,40:e3:d6:da:ba:25,62831821,160,51,62831661,62831821
6892,6,6,1,2412,-58,-93,35,40:e3:d6:da:ba:26,62832021,380,-180,62831641,62832021
6893,6,12,1,2412,-84,-93,9,84:d4:7e:f2:42:20,62850571,160,18390,62850411,62850571
6894,6,12,1,2412,-86,-93,7,84:d4:7e:f2:42:23,62852603,180,1852,62852423,62852603
6895,6,12,1,2412,-87,-93,6,84:d4:7e:f2:42:24,62852808,176,29,62852632,62852808
6896,6,6,1,2412,-87,-93,6,84:d4:7e:f2:42:26,62853219,380,31,62852839,62853219
6897,6,6,1,2412,-53,-93,40,e6:aa:ea:c9:ea:33,62878333,408,24706,62877925,62878333
6898,6,6,1,2412,-65,-93,28,e6:aa:ea:b7:4a:dd,62887928,408,9187,62887520,62887928
6899,6,6,1,2412,-53,-93,40,e6:aa:ea:c9:ea:33,62890454,408,2118,62890046,62890454
6900,6,6,1,2412,-60,-93,33,e6:aa:ea:c9:ea:33,62902573,408,11711,62902165,62902573
6901,6,6,1,2412,-66,-93,27,e6:aa:ea:b7:4a:dd,62912175,408,9194,62911767,62912175
6902,6,6,1,2412,-53,-93,40,e6:aa:ea:c9:ea:33,62914686,408,2103,62914278,62914686
6903,6,6,1,2412,-66,-93,27,e6:aa:ea:b7:4a:dd,62924296,408,9202,62923888,62924296
6904,6,12,1,2412,-58,-93,35,40:e3:d6:da:ba:20,62933224,160,8768,62933064,62933224
6905,6,6,1,2412,-58,-93,35,40:e3:d6:da:ba:21,62933433,368,-159,62933065,62933433
6906,6,12,1,2412,-58,-93,35,40:e3:d6:da:ba:22,62933829,180,216,62933649,62933829
6907,6,12,1,2412,-58,-93,35,40:e3:d6:da:ba:23,62934044,184,31,62933860,62934044
6908,6,12,1,2412,-58,-93,35,40:e3:d6:da:ba:24,62934271,176,51,62934095,62934271
6909,6,12,1,2412,-59,-93,34,40:e3:d6:da:ba:25,62934473,160,42,62934313,62934473
6910,6,6,1,2412,-59,-93,34,40:e3:d6:da:ba:26,62934683,380,-170,62934303,62934683
6911,6,12,1,2412,-86,-93,7,84:d4:7e:f2:42:23,62951661,180,16798,62951481,62951661
6912,6,12,1,2412,-85,-93,8,84:d4:7e:f2:42:25,62952122,160,301,62951962,62952122
6913,6,12,1,2412,-59,-93,34,40:e3:d6:da:ba:20,63035353,160,83071,63035193,63035353
6914,6,6,1,2412,-59,-93,34,40:e3:d6:da:ba:21,63035545,368,-176,63035177,63035545
6915,6,12,1,2412,-59,-93,34,40:e3:d6:da:ba:22,63035998,180,273,63035818,63035998
6916,6,12,1,2412,-59,-93,34,40:e3:d6:da:ba:23,63036230,184,48,63036046,63036230
6917,6,12,1,2412,-59,-93,34,40:e3:d6:da:ba:24,63036449,176,43,63036273,63036449
6918,6,12,1,2412,-59,-93,34,40:e3:d6:da:ba:25,63036668,160,59,63036508,63036668
6919,6,6,1,2412,-59,-93,34,40:e3:d6:da:ba:26,63036995,380,-53,63036615,63036995
6920,4,1,1,2412,-72,-93,21,54:e4:3a:ec:fb:64,63045947,2160,6792,63043787,63045947
6921,6,12,1,2412,-87,-93,6,84:d4:7e:f2:42:22,63053809,180,7682,63053629,63053809
6922,6,6,1,2412,-87,-93,6,84:d4:7e:f2:42:26,63054658,380,469,63054278,63054658
6923,4,1,1,2412,-71,-93,22,54:e4:3a:ec:fb:64,63069590,2112,12820,63067478,63069590
6924,4,1,1,2412,-73,-93,20,54:e4:3a:ec:fb:64,63073431,2112,1729,63071319,63073431
6925,4,1,1,2412,-71,-93,22,54:e4:3a:ec:fb:64,63084905,2112,9362,63082793,63084905
6926,4,1,1,2412,-72,-93,21,54:e4:3a:ec:fb:64,63089986,2112,2969,63087874,63089986
6927,4,1,1,2412,-71,-93,22,54:e4:3a:ec:fb:64,63093134,2112,1036,63091022,63093134
6928,6,12,1,2412,-59,-93,34,40:e3:d6:da:ba:20,63137753,160,44459,63137593,63137753
6929,6,6,1,2412,-59,-93,34,40:e3:d6:da:ba:21,63137954,368,-167,63137586,63137954
6930,6,12,1,2412,-60,-93,33,40:e3:d6:da:ba:22,63138351,180,217,63138171,63138351
6931,6,12,1,2412,-59,-93,34,40:e3:d6:da:ba:23,63138565,184,30,63138381,63138565
6932,6,12,1,2412,-59,-93,34,40:e3:d6:da:ba:24,63138774,176,33,63138598,63138774
6933,6,6,1,2412,-55,-93,38,40:e3:d6:da:ba:26,63139253,380,99,63138873,63139253
6934,6,6,1,2412,-83,-93,10,e6:aa:ea:c9:ea:1b,63186898,408,47237,63186490,63186898
6935,6,6,1,2412,-81,-93,12,e6:aa:ea:c9:ea:1b,63199006,408,11700,63198598,63199006
6936,6,12,1,2412,-59,-93,34,40:e3:d6:da:ba:20,63240172,160,41006,63240012,63240172
6937,6,6,1,2412,-59,-93,34,40:e3:d6:da:ba:21,63241498,368,958,63241130,63241498
6938,6,12,1,2412,-59,-93,34,40:e3:d6:da:ba:22,63242738,180,1060,63242558,63242738
6939,6,12,1,2412,-59,-93,34,40:e3:d6:da:ba:23,63242962,184,40,63242778,63242962
6940,6,12,1,2412,-59,-93,34,40:e3:d6:da:ba:24,63243190,176,52,63243014,63243190
6941,6,12,1,2412,-59,-93,34,40:e3:d6:da:ba:25,63243418,160,68,63243258,63243418
6942,4,1,1,2412,-72,-93,21,54:e4:3a:ec:fb:64,63250744,2160,5166,63248584,63250744
6943,6,12,1,2412,-61,-93,32,40:e3:d6:da:ba:20,63342568,160,91664,63342408,63342568
6944,6,6,1,2412,-59,-93,34,40:e3:d6:da:ba:21,63342759,368,-177,63342391,63342759
6945,6,12,1,2412,-60,-93,33,40:e3:d6:da:ba:22,63343146,180,207,63342966,63343146
6946,6,12,1,2412,-60,-93,33,40:e3:d6:da:ba:23,63343379,184,49,63343195,63343379
6947,6,12,1,2412,-60,-93,33,40:e3:d6:da:ba:24,63343606,176,51,63343430,63343606
6948,6,12,1,2412,-60,-93,33,40:e3:d6:da:ba:25,63343835,160,69,63343675,63343835
6949,6,6,1,2412,-59,-93,34,40:e3:d6:da:ba:26,63344036,380,-179,63343656,63344036
6950,4,1,1,2412,-70,-93,23,54:e4:3a:ec:fb:64,63353144,2160,6948,63350984,63353144
6951,6,12,1,2412,-88,-93,5,84:d4:7e:f2:42:23,63361312,180,7988,63361132,63361312
6952,6,12,1,2412,-88,-93,5,84:d4:7e:f2:42:24,63361518,176,30,63361342,63361518
6953,6,6,1,2412,-56,-93,37,e6:aa:ea:c9:ea:33,63385383,408,23457,63384975,63385383
6954,6,6,1,2412,-57,-93,36,e6:aa:ea:c9:ea:33,63397494,408,11703,63397086,63397494
6955,6,6,1,2412,-57,-93,36,e6:aa:ea:c9:ea:33,63409609,408,11707,63409201,63409609
6956,6,6,1,2412,-64,-93,29,e6:aa:ea:b7:4a:dd,63420247,408,10230,63419839,63420247
6957,6,6,1,2412,-57,-93,36,e6:aa:ea:c9:ea:33,63421759,408,1104,63421351,63421759
6958,6,6,1,2412,-64,-93,29,e6:aa:ea:b7:4a:dd,63432362,408,10195,63431954,63432362
6959,6,6,1,2412,-63,-93,30,e6:aa:ea:b7:4a:dd,63444480,408,11710,63444072,63444480
6960,6,6,1,2412,-57,-93,36,40:e3:d6:da:ba:21,63445146,368,298,63444778,63445146
6961,6,12,1,2412,-58,-93,35,40:e3:d6:da:ba:22,63445566,180,240,63445386,63445566
6962,6,12,1,2412,-58,-93,35,40:e3:d6:da:ba:23,63445798,184,48,63445614,63445798
6963,6,12,1,2412,-58,-93,35,40:e3:d6:da:ba:24,63446008,176,34,63445832,63446008
6964,6,12,1,2412,-58,-93,35,40:e3:d6:da:ba:25,63446227,160,59,63446067,63446227
6965,6,6,1,2412,-57,-93,36,40:e3:d6:da:ba:26,63446443,380,-164,63446063,63446443
6966,6,12,1,2412,-57,-93,36,40:e3:d6:da:ba:20,63547374,160,100771,63547214,63547374
6967,6,6,1,2412,-56,-93,37,40:e3:d6:da:ba:21,63547593,368,-149,63547225,63547593
6968,6,12,1,2412,-57,-93,36,40:e3:d6:da:ba:22,63548007,180,234,63547827,63548007
6969,6,12,1,2412,-57,-93,36,40:e3:d6:da:ba:23,63548231,184,40,63548047,63548231
6970,6,12,1,2412,-57,-93,36,40:e3:d6:da:ba:24,63548440,176,33,63548264,63548440
6971,6,12,1,2412,-56,-93,37,40:e3:d6:da:ba:25,63548735,160,135,63548575,63548735
6972,6,6,1,2412,-56,-93,37,40:e3:d6:da:ba:26,63548927,380,-188,63548547,63548927
6973,4,1,1,2412,-71,-93,22,54:e4:3a:ec:fb:64,63557941,2160,6854,63555781,63557941
6974,6,6,1,2412,-89,-93,4,84:d4:7e:f2:42:21,63565439,368,7130,63565071,63565439
6975,6,12,1,2412,-88,-93,5,84:d4:7e:f2:42:24,63566282,176,667,63566106,63566282
6976,6,6,1,2412,-83,-93,10,e6:aa:ea:c9:ea:1b,63594528,408,27838,63594120,63594528
6977,6,6,1,2412,-82,-93,11,e6:aa:ea:c9:ea:1b,63606647,408,11711,63606239,63606647
6978,6,12,1,2412,-59,-93,34,40:e3:d6:da:ba:20,63649756,160,42949,63649596,63649756
6979,6,6,1,2412,-59,-93,34,40:e3:d6:da:ba:21,63649975,368,-149,63649607,63649975
6980,6,12,1,2412,-59,-93,34,40:e3:d6:da:ba:22,63650362,180,207,63650182,63650362
6981,6,12,1,2412,-59,-93,34,40:e3:d6:da:ba:23,63653163,184,2617,63652979,63653163
6982,6,12,1,2412,-59,-93,34,40:e3:d6:da:ba:24,63653399,176,60,63653223,63653399
6983,6,12,1,2412,-58,-93,35,40:e3:d6:da:ba:25,63653619,160,60,63653459,63653619
6984,6,6,1,2412,-59,-93,34,40:e3:d6:da:ba:26,63653829,380,-170,63653449,63653829
6985,4,1,1,2412,-74,-93,19,54:e4:3a:ec:fb:64,63660341,2160,4352,63658181,63660341
6986,6,12,1,2412,-86,-93,7,84:d4:7e:f2:42:23,63668472,180,7951,63668292,63668472
6987,6,12,1,2412,-86,-93,7,84:d4:7e:f2:42:25,63668916,160,284,63668756,63668916
6988,6,6,1,2412,-84,-93,9,84:d4:7e:f2:42:26,63669116,380,-180,63668736,63669116
6989,6,12,1,2412,-60,-93,33,40:e3:d6:da:ba:20,63752156,160,82880,63751996,63752156
6990,6,12,1,2412,-61,-93,32,40:e3:d6:da:ba:23,63752977,184,637,63752793,63752977
6991,6,12,1,2412,-60,-93,33,40:e3:d6:da:ba:24,63753213,176,60,63753037,63753213
6992,6,12,1,2412,-60,-93,33,40:e3:d6:da:ba:25,63753433,160,60,63753273,63753433
6993,4,1,1,2412,-70,-93,23,54:e4:3a:ec:fb:64,63762741,2160,7148,63760581,63762741
6994,6,6,1,2412,-58,-93,35,e6:aa:ea:c9:ea:33,63803061,408,39912,63802653,63803061
6995,6,6,1,2412,-57,-93,36,e6:aa:ea:c9:ea:33,63815174,408,11705,63814766,63815174
6996,6,6,1,2412,-56,-93,37,e6:aa:ea:c9:ea:33,63827485,408,11903,63827077,63827485
6997,6,6,1,2412,-56,-93,37,e6:aa:ea:b7:4a:dd,63837951,408,10058,63837543,63837951
6998,6,6,1,2412,-56,-93,37,e6:aa:ea:c9:ea:33,63839425,408,1066,63839017,63839425
6999,6,6,1,2412,-55,-93,38,e6:aa:ea:c9:ea:33,63851816,408,11983,63851408,63851816
7000,6,12,1,2412,-57,-93,36,40:e3:d6:da:ba:20,63854561,160,2585,63854401,63854561
7001,6,6,1,2412,-57,-93,36,40:e3:d6:da:ba:21,63854771,368,-158,63854403,63854771
7002,6,12,1,2412,-57,-93,36,40:e3:d6:da:ba:22,63855176,180,225,63854996,63855176
7003,6,12,1,2412,-57,-93,36,40:e3:d6:da:ba:23,63855391,184,31,63855207,63855391
7004,6,12,1,2412,-57,-93,36,40:e3:d6:da:ba:24,63855618,176,51,63855442,63855618
7005,6,6,1,2412,-59,-93,34,40:e3:d6:da:ba:26,63856021,380,23,63855641,63856021
7006,6,6,1,2412,-56,-93,37,e6:aa:ea:b7:4a:dd,63862196,408,5767,63861788,63862196
7007,4,1,1,2412,-69,-93,24,54:e4:3a:ec:fb:64,63865139,2160,783,63862979,63865139
7008,6,12,1,2412,-58,-93,35,40:e3:d6:da:ba:20,63956968,160,91669,63956808,63956968
7009,6,6,1,2412,-58,-93,35,40:e3:d6:da:ba:21,63957160,368,-176,63956792,63957160
7010,6,12,1,2412,-58,-93,35,40:e3:d6:da:ba:22,63957564,180,224,63957384,63957564
7011,6,12,1,2412,-58,-93,35,40:e3:d6:da:ba:23,63957779,184,31,63957595,63957779
7012,6,12,1,2412,-58,-93,35,40:e3:d6:da:ba:24,63957997,176,42,63957821,63957997
7013,6,12,1,2412,-58,-93,35,40:e3:d6:da:ba:25,63958208,160,51,63958048,63958208
7014,6,6,1,2412,-58,-93,35,40:e3:d6:da:ba:26,63958409,380,-179,63958029,63958409
7015,6,12,1,2412,-89,-93,4,84:d4:7e:f2:42:20,63974815,160,16246,63974655,63974815
7016,6,6,1,2412,-89,-93,4,84:d4:7e:f2:42:21,63975006,368,-177,63974638,63975006
7017,6,12,1,2412,-89,-93,4,84:d4:7e:f2:42:22,63975411,180,225,63975231,63975411
7018,6,12,1,2412,-88,-93,5,84:d4:7e:f2:42:23,63975616,180,25,63975436,63975616
7019,6,12,1,2412,-89,-93,4,84:d4:7e:f2:42:25,63976023,160,247,63975863,63976023
7020,6,6,1,2412,-89,-93,4,84:d4:7e:f2:42:26,63976215,380,-188,63975835,63976215
7021,4,1,1,2412,-91,-93,2,,63996432,304,19913,63996128,63996432
7022,6,6,1,2412,-82,-93,11,e6:aa:ea:c9:ea:1b,64014241,408,17401,64013833,64014241
7023,6,12,1,2412,-58,-93,35,40:e3:d6:da:ba:20,64059398,160,44997,64059238,64059398
7024,6,6,1,2412,-57,-93,36,40:e3:d6:da:ba:21,64059599,368,-167,64059231,64059599
7025,6,12,1,2412,-58,-93,35,40:e3:d6:da:ba:22,64060013,180,234,64059833,64060013
7026,6,12,1,2412,-58,-93,35,40:e3:d6:da:ba:23,64060237,184,40,64060053,64060237
7027,6,12,1,2412,-58,-93,35,40:e3:d6:da:ba:24,64060473,176,60,64060297,64060473
7028,6,12,1,2412,-58,-93,35,40:e3:d6:da:ba:25,64060683,160,50,64060523,64060683
7029,6,6,1,2412,-58,-93,35,40:e3:d6:da:ba:26,64060876,380,-187,64060496,64060876
7030,6,12,1,2412,-84,-93,9,84:d4:7e:f2:42:20,64077215,160,16179,64077055,64077215
7031,6,6,1,2412,-88,-93,5,84:d4:7e:f2:42:21,64077434,368,-149,64077066,64077434
7032,6,12,1,2412,-87,-93,6,84:d4:7e:f2:42:22,64077830,180,216,64077650,64077830
7033,6,12,1,2412,-86,-93,7,84:d4:7e:f2:42:23,64078036,180,26,64077856,64078036
7034,6,12,1,2412,-86,-93,7,84:d4:7e:f2:42:24,64078259,176,47,64078083,64078259
7035,6,6,1,2412,-86,-93,7,84:d4:7e:f2:42:26,64078680,380,41,64078300,64078680
7036,6,6,1,2412,-56,-93,37,40:e3:d6:da:ba:21,64163421,368,84373,64163053,64163421
7037,6,12,1,2412,-56,-93,37,40:e3:d6:da:ba:22,64163808,180,207,64163628,64163808
7038,6,12,1,2412,-56,-93,37,40:e3:d6:da:ba:23,64164040,184,48,64163856,64164040
7039,6,12,1,2412,-56,-93,37,40:e3:d6:da:ba:24,64164267,176,51,64164091,64164267
7040,6,12,1,2412,-54,-93,39,40:e3:d6:da:ba:25,64164559,160,132,64164399,64164559
7041,6,6,1,2412,-54,-93,39,40:e3:d6:da:ba:26,64164760,380,-179,64164380,64164760
7042,4,1,1,2412,-66,-93,27,54:e4:3a:ec:fb:64,64172336,2160,5416,64170176,64172336
7043,6,12,1,2412,-88,-93,5,84:d4:7e:f2:42:23,64180451,180,7935,64180271,64180451
7044,6,6,1,2412,-55,-93,38,e6:aa:ea:c9:ea:33,64221041,408,40182,64220633,64221041
7045,6,6,1,2412,-55,-93,38,e6:aa:ea:c9:ea:33,64233167,408,11718,64232759,64233167
7046,6,6,1,2412,-64,-93,29,e6:aa:ea:b7:4a:dd,64243049,408,9474,64242641,64243049
7047,6,6,1,2412,-56,-93,37,e6:aa:ea:c9:ea:33,64245279,408,1822,64244871,64245279
7048,6,6,1,2412,-56,-93,37,e6:aa:ea:c9:ea:33,64257399,408,11712,64256991,64257399
7049,6,12,1,2412,-55,-93,38,40:e3:d6:da:ba:20,64264160,160,6601,64264000,64264160
7050,6,6,1,2412,-56,-93,37,40:e3:d6:da:ba:21,64264379,368,-149,64264011,64264379
7051,6,12,1,2412,-56,-93,37,40:e3:d6:da:ba:22,64264793,180,234,64264613,64264793
7052,6,12,1,2412,-56,-93,37,40:e3:d6:da:ba:23,64264999,184,22,64264815,64264999
7053,6,12,1,2412,-55,-93,38,40:e3:d6:da:ba:24,64265217,176,42,64265041,64265217
7054,6,12,1,2412,-56,-93,37,40:e3:d6:da:ba:25,64265437,160,60,64265277,64265437
7055,6,6,1,2412,-56,-93,37,40:e3:d6:da:ba:26,64265629,380,-188,64265249,64265629
7056,6,6,1,2412,-69,-93,24,e6:aa:ea:b7:4a:dd,64267297,408,1260,64266889,64267297
7057,6,6,1,2412,-57,-93,36,e6:aa:ea:c9:ea:33,64269511,408,1806,64269103,64269511
7058,4,1,1,2412,-65,-93,28,54:e4:3a:ec:fb:64,64274735,2160,3064,64272575,64274735
7059,6,6,1,2412,-63,-93,30,e6:aa:ea:b7:4a:dd,64279414,408,4271,64279006,64279414
7060,6,6,1,2412,-63,-93,30,e6:aa:ea:b7:4a:dd,64291532,408,11710,64291124,64291532
7061,6,6,1,2412,-80,-93,13,e6:aa:ea:c9:ea:1b,64323445,408,31505,64323037,64323445
7062,6,12,1,2412,-56,-93,37,40:e3:d6:da:ba:20,64366571,160,42966,64366411,64366571
7063,6,6,1,2412,-56,-93,37,40:e3:d6:da:ba:21,64366781,368,-158,64366413,64366781
7064,6,12,1,2412,-56,-93,37,40:e3:d6:da:ba:22,64367186,180,225,64367006,64367186
7065,6,12,1,2412,-56,-93,37,40:e3:d6:da:ba:23,64367391,184,21,64367207,64367391
7066,6,12,1,2412,-56,-93,37,40:e3:d6:da:ba:24,64367619,176,52,64367443,64367619
7067,6,12,1,2412,-55,-93,38,40:e3:d6:da:ba:25,64367847,160,68,64367687,64367847
7068,6,6,1,2412,-56,-93,37,40:e3:d6:da:ba:26,64368057,380,-170,64367677,64368057
7069,4,1,1,2412,-68,-93,25,54:e4:3a:ec:fb:64,64377221,2160,7004,64375061,64377221
7070,6,12,1,2412,-87,-93,6,84:d4:7e:f2:42:20,64384425,160,7044,64384265,64384425
7071,6,12,1,2412,-88,-93,5,84:d4:7e:f2:42:22,64385040,180,435,64384860,64385040
7072,6,12,1,2412,-89,-93,4,84:d4:7e:f2:42:23,64385264,180,44,64385084,64385264
7073,6,12,1,2412,-86,-93,7,84:d4:7e:f2:42:24,64385478,176,38,64385302,64385478
7074,6,12,1,2412,-87,-93,6,84:d4:7e:f2:42:25,64385680,160,42,64385520,64385680
7075,6,6,1,2412,-87,-93,6,84:d4:7e:f2:42:26,64385889,380,-171,64385509,64385889
7076,6,12,1,2412,-55,-93,38,40:e3:d6:da:ba:23,64470610,184,84537,64470426,64470610
7077,6,12,1,2412,-55,-93,38,40:e3:d6:da:ba:24,64470828,176,42,64470652,64470828
7078,6,12,1,2412,-55,-93,38,40:e3:d6:da:ba:25,64471039,160,51,64470879,64471039
7079,6,6,1,2412,-55,-93,38,40:e3:d6:da:ba:26,64471231,380,-188,64470851,64471231
7080,4,1,1,2412,-69,-93,24,54:e4:3a:ec:fb:64,64479535,2160,6144,64477375,64479535
7081,6,6,1,2412,-54,-93,39,e6:aa:ea:c9:ea:33,64536414,408,56471,64536006,64536414
7082,6,6,1,2412,-54,-93,39,e6:aa:ea:c9:ea:33,64548524,408,11702,64548116,64548524
7083,6,6,1,2412,-53,-93,40,e6:aa:ea:c9:ea:33,64560643,408,11711,64560235,64560643
7084,6,12,1,2412,-56,-93,37,40:e3:d6:da:ba:20,64571360,160,10557,64571200,64571360
7085,6,6,1,2412,-56,-93,37,40:e3:d6:da:ba:21,64571552,368,-176,64571184,64571552
7086,6,12,1,2412,-56,-93,37,40:e3:d6:da:ba:22,64571939,180,207,64571759,64571939
7087,6,12,1,2412,-56,-93,37,40:e3:d6:da:ba:23,64572145,184,22,64571961,64572145
7088,6,12,1,2412,-56,-93,37,40:e3:d6:da:ba:24,64572372,176,51,64572196,64572372
7089,6,12,1,2412,-56,-93,37,40:e3:d6:da:ba:25,64572573,160,41,64572413,64572573
7090,6,6,1,2412,-56,-93,37,40:e3:d6:da:ba:26,64572765,380,-188,64572385,64572765
7091,6,6,1,2412,-53,-93,40,e6:aa:ea:c9:ea:33,64573180,408,7,64572772,64573180
7092,6,6,1,2412,-53,-93,40,e6:aa:ea:c9:ea:33,64584953,408,11365,64584545,64584953
7093,6,12,1,2412,-57,-93,36,40:e3:d6:da:ba:22,64674392,180,89259,64674212,64674392
7094,6,12,1,2412,-57,-93,36,40:e3:d6:da:ba:23,64674615,184,39,64674431,64674615
7095,6,12,1,2412,-57,-93,36,40:e3:d6:da:ba:24,64674843,176,52,64674667,64674843
7096,6,12,1,2412,-57,-93,36,40:e3:d6:da:ba:25,64675071,160,68,64674911,64675071
7097,6,6,1,2412,-57,-93,36,40:e3:d6:da:ba:26,64675290,380,-161,64674910,64675290
7098,4,1,1,2412,-68,-93,25,54:e4:3a:ec:fb:64,64684333,2160,6883,64682173,64684333
7099,6,6,1,2412,-83,-93,10,e6:aa:ea:c9:ea:1b,64757113,408,72372,64756705,64757113
7100,6,6,1,2412,-62,-93,31,e6:aa:ea:b7:4a:dd,64774613,408,17092,64774205,64774613
7101,6,12,1,2412,-57,-93,36,40:e3:d6:da:ba:20,64776176,160,1403,64776016,64776176
7102,6,6,1,2412,-57,-93,36,40:e3:d6:da:ba:21,64776395,368,-149,64776027,64776395
7103,6,12,1,2412,-57,-93,36,40:e3:d6:da:ba:22,64776791,180,216,64776611,64776791
7104,6,12,1,2412,-57,-93,36,40:e3:d6:da:ba:23,64777014,184,39,64776830,64777014
7105,6,12,1,2412,-57,-93,36,40:e3:d6:da:ba:24,64777242,176,52,64777066,64777242
7106,6,12,1,2412,-57,-93,36,40:e3:d6:da:ba:25,64777470,160,68,64777310,64777470
7107,6,6,1,2412,-57,-93,36,40:e3:d6:da:ba:26,64777680,380,-170,64777300,64777680
7108,6,6,1,2412,-83,-93,10,e6:aa:ea:c9:ea:1b,64781613,408,3525,64781205,64781613
7109,4,1,1,2412,-68,-93,25,54:e4:3a:ec:fb:64,64786732,2160,2959,64784572,64786732
7110,6,12,1,2412,-88,-93,5,84:d4:7e:f2:42:22,64794614,180,7702,64794434,64794614
7111,6,6,1,2412,-62,-93,31,e6:aa:ea:b7:4a:dd,64798839,408,3817,64798431,64798839
7112,6,6,1,2412,-62,-93,31,e6:aa:ea:b7:4a:dd,64810952,408,11705,64810544,64810952
7113,6,12,1,2412,-58,-93,35,40:e3:d6:da:ba:20,64878562,160,67450,64878402,64878562
7114,6,6,1,2412,-57,-93,36,40:e3:d6:da:ba:21,64878763,368,-167,64878395,64878763
7115,6,12,1,2412,-57,-93,36,40:e3:d6:da:ba:22,64879159,180,216,64878979,64879159
7116,6,12,1,2412,-58,-93,35,40:e3:d6:da:ba:23,64879392,184,49,64879208,64879392
7117,6,12,1,2412,-57,-93,36,40:e3:d6:da:ba:24,64879611,176,43,64879435,64879611
7118,6,12,1,2412,-57,-93,36,40:e3:d6:da:ba:25,64879822,160,51,64879662,64879822
7119,6,6,1,2412,-57,-93,36,40:e3:d6:da:ba:26,64880032,380,-170,64879652,64880032
7120,6,12,1,2412,-85,-93,8,84:d4:7e:f2:42:24,64897529,176,17321,64897353,64897529
7121,6,12,1,2412,-87,-93,6,84:d4:7e:f2:42:23,64966694,160,69005,64966534,64966694
7122,6,12,1,2412,-88,-93,5,84:d4:7e:f2:42:25,64966897,140,63,64966757,64966897
7123,6,12,1,2412,-57,-93,36,40:e3:d6:da:ba:20,64982083,160,15026,64981923,64982083
7124,6,6,1,2412,-57,-93,36,40:e3:d6:da:ba:21,64982314,368,-137,64981946,64982314
7125,6,12,1,2412,-57,-93,36,40:e3:d6:da:ba:22,64982728,180,234,64982548,64982728
7126,6,12,1,2412,-57,-93,36,40:e3:d6:da:ba:23,64983945,184,1033,64983761,64983945
7127,6,12,1,2412,-57,-93,36,40:e3:d6:da:ba:24,64984164,176,43,64983988,64984164
7128,6,12,1,2412,-57,-93,36,40:e3:d6:da:ba:25,64984383,160,59,64984223,64984383
7129,6,6,1,2412,-57,-93,36,40:e3:d6:da:ba:26,64984633,380,-130,64984253,64984633
7130,4,1,1,2412,-66,-93,27,54:e4:3a:ec:fb:64,64991529,2160,4736,64989369,64991529
7131,6,6,1,2412,-81,-93,12,e6:aa:ea:c9:ea:1b,65050827,408,58890,65050419,65050827
7132,6,6,1,2412,-54,-93,39,e6:aa:ea:c9:ea:33,65056041,408,4806,65055633,65056041
7133,6,6,1,2412,-67,-93,26,e6:aa:ea:b7:4a:dd,65077112,408,20663,65076704,65077112
7134,6,6,1,2412,-53,-93,40,e6:aa:ea:c9:ea:33,65080274,408,2754,65079866,65080274
7135,6,12,1,2412,-58,-93,35,40:e3:d6:da:ba:20,65083363,160,2929,65083203,65083363
7136,6,6,1,2412,-58,-93,35,40:e3:d6:da:ba:21,65083582,368,-149,65083214,65083582
7137,6,12,1,2412,-58,-93,35,40:e3:d6:da:ba:22,65083996,180,234,65083816,65083996
7138,6,12,1,2412,-58,-93,35,40:e3:d6:da:ba:23,65084381,184,201,65084197,65084381
7139,6,12,1,2412,-58,-93,35,40:e3:d6:da:ba:24,65084608,176,51,65084432,65084608
7140,6,12,1,2412,-58,-93,35,40:e3:d6:da:ba:25,65084818,160,50,65084658,65084818
7141,6,6,1,2412,-58,-93,35,40:e3:d6:da:ba:26,65085043,380,-155,65084663,65085043
7142,6,6,1,2412,-82,-93,11,e6:aa:ea:c9:ea:1b,65087178,408,1727,65086770,65087178
7143,6,6,1,2412,-67,-93,26,e6:aa:ea:b7:4a:dd,65089166,408,1580,65088758,65089166
7144,6,6,1,2412,-66,-93,27,e6:aa:ea:b7:4a:dd,65101292,408,11718,65100884,65101292
7145,6,6,1,2412,-52,-93,41,e6:aa:ea:c9:ea:33,65104582,408,2882,65104174,65104582
7146,6,6,1,2412,-65,-93,28,e6:aa:ea:b7:4a:dd,65113399,408,8409,65112991,65113399
7147,6,6,1,2412,-65,-93,28,e6:aa:ea:b7:4a:dd,65125519,408,11712,65125111,65125519
7148,6,12,1,2412,-58,-93,35,40:e3:d6:da:ba:22,65186531,180,60832,65186351,65186531
7149,6,12,1,2412,-58,-93,35,40:e3:d6:da:ba:23,65186745,184,30,65186561,65186745
7150,6,12,1,2412,-57,-93,36,40:e3:d6:da:ba:24,65186973,176,52,65186797,65186973
7151,6,12,1,2412,-58,-93,35,40:e3:d6:da:ba:25,65187192,160,59,65187032,65187192
7152,6,6,1,2412,-58,-93,35,40:e3:d6:da:ba:26,65187384,380,-188,65187004,65187384
7153,4,1,1,2412,-69,-93,24,54:e4:3a:ec:fb:64,65196328,2160,6784,65194168,65196328
7154,4,1,1,2412,-87,-93,6,b8:3a:5a:88:e6:e0,65198511,2360,-177,65196151,65198511
7155,6,12,1,2412,-60,-93,33,40:e3:d6:da:ba:20,65288221,160,89550,65288061,65288221
7156,6,6,1,2412,-60,-93,33,40:e3:d6:da:ba:21,65288440,368,-149,65288072,65288440
7157,6,12,1,2412,-59,-93,34,40:e3:d6:da:ba:22,65288836,180,216,65288656,65288836
7158,6,12,1,2412,-60,-93,33,40:e3:d6:da:ba:23,65289059,184,39,65288875,65289059
7159,6,12,1,2412,-60,-93,33,40:e3:d6:da:ba:24,65289287,176,52,65289111,65289287
7160,6,12,1,2412,-60,-93,33,40:e3:d6:da:ba:25,65289497,160,50,65289337,65289497
7161,6,6,1,2412,-60,-93,33,40:e3:d6:da:ba:26,65289689,380,-188,65289309,65289689
7162,4,1,1,2412,-70,-93,23,54:e4:3a:ec:fb:64,65298727,2160,6878,65296567,65298727
7163,6,6,1,2412,-60,-93,33,40:e3:d6:da:ba:21,65393248,368,94153,65392880,65393248
7164,6,12,1,2412,-59,-93,34,40:e3:d6:da:ba:22,65393635,180,207,65393455,65393635
7165,6,12,1,2412,-60,-93,33,40:e3:d6:da:ba:23,65393840,184,21,65393656,65393840
7166,6,12,1,2412,-59,-93,34,40:e3:d6:da:ba:24,65394059,176,43,65393883,65394059
7167,6,12,1,2412,-59,-93,34,40:e3:d6:da:ba:25,65394260,160,41,65394100,65394260
7168,6,6,1,2412,-60,-93,33,40:e3:d6:da:ba:26,65394461,380,-179,65394081,65394461
7169,4,1,1,2412,-69,-93,24,54:e4:3a:ec:fb:64,65408947,2160,12326,65406787,65408947
7170,6,12,1,2412,-60,-93,33,40:e3:d6:da:ba:20,65492964,160,83857,65492804,65492964
7171,6,6,1,2412,-60,-93,33,40:e3:d6:da:ba:21,65493165,368,-167,65492797,65493165
7172,6,12,1,2412,-60,-93,33,40:e3:d6:da:ba:22,65493552,180,207,65493372,65493552
7173,6,12,1,2412,-60,-93,33,40:e3:d6:da:ba:23,65493757,184,21,65493573,65493757
7174,6,12,1,2412,-60,-93,33,40:e3:d6:da:ba:24,65493976,176,43,65493800,65493976
7175,6,12,1,2412,-60,-93,33,40:e3:d6:da:ba:25,65494204,160,68,65494044,65494204
7176,6,6,1,2412,-60,-93,33,40:e3:d6:da:ba:26,65494396,380,-188,65494016,65494396
7177,6,6,1,2412,-68,-93,25,e6:aa:ea:b7:4a:dd,65494919,408,115,65494511,65494919
7178,6,6,1,2412,-68,-93,25,e6:aa:ea:b7:4a:dd,65507131,408,11804,65506723,65507131
7179,6,6,1,2412,-68,-93,25,e6:aa:ea:b7:4a:dd,65519164,408,11625,65518756,65519164
7180,4,1,1,2412,-65,-93,28,54:e4:3a:ec:fb:64,65535327,2160,14003,65533167,65535327
7181,6,6,1,2412,-82,-93,11,e6:aa:ea:c9:ea:1b,65572619,408,36884,65572211,65572619
7182,6,6,1,2412,-55,-93,38,e6:aa:ea:c9:ea:33,65577170,408,4143,65576762,65577170
7183,6,6,1,2412,-82,-93,11,e6:aa:ea:c9:ea:1b,65584728,408,7150,65584320,65584728
7184,6,6,1,2412,-55,-93,38,e6:aa:ea:c9:ea:33,65589287,408,4151,65588879,65589287
7185,6,12,1,2412,-60,-93,33,40:e3:d6:da:ba:20,65595376,160,5929,65595216,65595376
7186,6,6,1,2412,-60,-93,33,40:e3:d6:da:ba:21,65595586,368,-158,65595218,65595586
7187,6,12,1,2412,-60,-93,33,40:e3:d6:da:ba:22,65596175,180,409,65595995,65596175
7188,6,12,1,2412,-60,-93,33,40:e3:d6:da:ba:23,65596380,184,21,65596196,65596380
7189,6,12,1,2412,-60,-93,33,40:e3:d6:da:ba:24,65596598,176,42,65596422,65596598
7190,6,12,1,2412,-60,-93,33,40:e3:d6:da:ba:25,65596827,160,69,65596667,65596827
7191,6,6,1,2412,-60,-93,33,40:e3:d6:da:ba:26,65597037,380,-170,65596657,65597037
7192,6,6,1,2412,-55,-93,38,e6:aa:ea:c9:ea:33,65604409,408,6964,65604001,65604409
7193,4,1,1,2412,-68,-93,25,54:e4:3a:ec:fb:64,65606151,2160,-418,65603991,65606151
7194,6,6,1,2412,-55,-93,38,e6:aa:ea:c9:ea:33,65613517,408,6958,65613109,65613517
7195,6,6,1,2412,-55,-93,38,e6:aa:ea:c9:ea:33,65625656,408,11731,65625248,65625656
7196,6,12,1,2412,-57,-93,36,40:e3:d6:da:ba:20,65697786,160,71970,65697626,65697786
7197,6,6,1,2412,-57,-93,36,40:e3:d6:da:ba:21,65697996,368,-158,65697628,65697996
7198,6,12,1,2412,-57,-93,36,40:e3:d6:da:ba:22,65698401,180,225,65698221,65698401
7199,6,12,1,2412,-56,-93,37,40:e3:d6:da:ba:23,65698633,184,48,65698449,65698633
7200,6,12,1,2412,-57,-93,36,40:e3:d6:da:ba:24,65698843,176,34,65698667,65698843
7201,6,6,1,2412,-57,-93,36,40:e3:d6:da:ba:26,65699271,380,48,65698891,65699271
7202,4,1,1,2412,-74,-93,19,54:e4:3a:ec:fb:64,65708325,2160,6894,65706165,65708325
7203,4,1,1,2412,-89,-93,4,b8:3a:5a:88:e6:e1,65713221,2376,2520,65710845,65713221
7204,6,12,1,2412,-59,-93,34,40:e3:d6:da:ba:20,65800165,160,86784,65800005,65800165
7205,6,6,1,2412,-59,-93,34,40:e3:d6:da:ba:21,65800357,368,-176,65799989,65800357
7206,6,12,1,2412,-59,-93,34,40:e3:d6:da:ba:22,65800753,180,216,65800573,65800753
7207,6,12,1,2412,-59,-93,34,40:e3:d6:da:ba:23,65800977,184,40,65800793,65800977
7208,6,12,1,2412,-59,-93,34,40:e3:d6:da:ba:24,65801213,176,60,65801037,65801213
7209,6,12,1,2412,-59,-93,34,40:e3:d6:da:ba:25,65801433,160,60,65801273,65801433
7210,6,6,1,2412,-59,-93,34,40:e3:d6:da:ba:26,65801652,380,-161,65801272,65801652
7211,6,6,1,2412,-68,-93,25,e6:aa:ea:b7:4a:dd,65809893,408,7833,65809485,65809893
7212,4,1,1,2412,-68,-93,25,54:e4:3a:ec:fb:64,65810724,2160,-1329,65808564,65810724
7213,6,6,1,2412,-68,-93,25,e6:aa:ea:b7:4a:dd,65822131,408,10999,65821723,65822131
7214,6,6,1,2412,-68,-93,25,e6:aa:ea:b7:4a:dd,65834137,408,11598,65833729,65834137
7215,6,6,1,2412,-69,-93,24,e6:aa:ea:b7:4a:dd,65846399,408,11854,65845991,65846399
7216,6,6,1,2412,-69,-93,24,e6:aa:ea:b7:4a:dd,65858376,408,11569,65857968,65858376
7217,6,12,1,2412,-58,-93,35,40:e3:d6:da:ba:22,65903175,180,44619,65902995,65903175
7218,6,12,1,2412,-58,-93,35,40:e3:d6:da:ba:23,65903389,184,30,65903205,65903389
7219,6,12,1,2412,-58,-93,35,40:e3:d6:da:ba:24,65903641,176,76,65903465,65903641
7220,6,12,1,2412,-58,-93,35,40:e3:d6:da:ba:25,65903852,160,51,65903692,65903852
7221,6,6,1,2412,-58,-93,35,40:e3:d6:da:ba:26,65904071,380,-161,65903691,65904071
7222,4,1,1,2412,-70,-93,23,54:e4:3a:ec:fb:64,65913122,2160,6891,65910962,65913122
7223,6,6,1,2412,-83,-93,10,e6:aa:ea:c9:ea:1b,65938322,408,24792,65937914,65938322
7224,6,6,1,2412,-59,-93,34,e6:aa:ea:c9:ea:33,65994542,408,55812,65994134,65994542
7225,6,12,1,2412,-59,-93,34,40:e3:d6:da:ba:20,66005021,160,10319,66004861,66005021
7226,6,12,1,2412,-59,-93,34,40:e3:d6:da:ba:22,66005643,180,442,66005463,66005643
7227,6,12,1,2412,-59,-93,34,40:e3:d6:da:ba:23,66005870,184,43,66005686,66005870
7228,6,12,1,2412,-59,-93,34,40:e3:d6:da:ba:24,66006079,176,33,66005903,66006079
7229,6,12,1,2412,-59,-93,34,40:e3:d6:da:ba:25,66006281,160,42,66006121,66006281
7230,6,6,1,2412,-59,-93,34,40:e3:d6:da:ba:26,66006473,380,-188,66006093,66006473
7231,6,6,1,2412,-59,-93,34,e6:aa:ea:c9:ea:33,66006914,408,33,66006506,66006914
7232,4,1,1,2412,-84,-93,9,b8:3a:5a:88:e6:e1,66020103,2376,10813,66017727,66020103
7233,6,6,1,2412,-59,-93,34,e6:aa:ea:c9:ea:33,66030909,408,10398,66030501,66030909
7234,6,6,1,2412,-57,-93,36,e6:aa:ea:c9:ea:33,66043022,408,11705,66042614,66043022
7235,6,12,1,2412,-60,-93,33,40:e3:d6:da:ba:20,66107384,160,64202,66107224,66107384
7236,6,6,1,2412,-60,-93,33,40:e3:d6:da:ba:21,66107603,368,-149,66107235,66107603
7237,6,12,1,2412,-60,-93,33,40:e3:d6:da:ba:22,66108008,180,225,66107828,66108008
7238,6,12,1,2412,-61,-93,32,40:e3:d6:da:ba:23,66108213,184,21,66108029,66108213
7239,6,12,1,2412,-60,-93,33,40:e3:d6:da:ba:24,66108450,176,61,66108274,66108450
7240,6,12,1,2412,-60,-93,33,40:e3:d6:da:ba:25,66108669,160,59,66108509,66108669
7241,6,6,1,2412,-60,-93,33,40:e3:d6:da:ba:26,66108870,380,-179,66108490,66108870
7242,6,6,1,2412,-62,-93,31,e6:aa:ea:b7:4a:dd,66125707,408,16429,66125299,66125707
7243,6,12,1,2412,-89,-93,4,84:d4:7e:f2:42:25,66126521,160,654,66126361,66126521
7244,6,6,1,2412,-89,-93,4,84:d4:7e:f2:42:26,66126713,380,-188,66126333,66126713
7245,6,6,1,2412,-62,-93,31,e6:aa:ea:b7:4a:dd,66137834,408,10713,66137426,66137834
7246,6,6,1,2412,-63,-93,30,e6:aa:ea:b7:4a:dd,66149947,408,11705,66149539,66149947
7247,6,12,1,2412,-57,-93,36,40:e3:d6:da:ba:20,66209782,160,59675,66209622,66209782
7248,6,6,1,2412,-57,-93,36,40:e3:d6:da:ba:21,66209974,368,-176,66209606,66209974
7249,6,12,1,2412,-56,-93,37,40:e3:d6:da:ba:22,66210360,180,206,66210180,66210360
7250,6,12,1,2412,-56,-93,37,40:e3:d6:da:ba:23,66210566,184,22,66210382,66210566
7251,6,12,1,2412,-56,-93,37,40:e3:d6:da:ba:24,66210802,176,60,66210626,66210802
7252,6,12,1,2412,-56,-93,37,40:e3:d6:da:ba:25,66211022,160,60,66210862,66211022
7253,6,6,1,2412,-56,-93,37,40:e3:d6:da:ba:26,66211222,380,-180,66210842,66211222
7254,4,1,1,2412,-66,-93,27,54:e4:3a:ec:fb:64,66220319,2160,6937,66218159,66220319
7255,4,1,1,2412,-90,-93,3,b8:3a:5a:88:e6:e0,66222503,2360,-176,66220143,66222503
7256,6,12,1,2412,-88,-93,5,84:d4:7e:f2:42:23,66228488,180,5805,66228308,66228488
7257,6,12,1,2412,-89,-93,4,84:d4:7e:f2:42:24,66228712,176,48,66228536,66228712
7258,6,12,1,2412,-88,-93,5,84:d4:7e:f2:42:25,66228931,160,59,66228771,66228931
7259,6,12,1,2412,-55,-93,38,40:e3:d6:da:ba:20,66312189,160,83098,66312029,66312189
7260,6,6,1,2412,-55,-93,38,40:e3:d6:da:ba:21,66312381,368,-176,66312013,66312381
7261,6,12,1,2412,-55,-93,38,40:e3:d6:da:ba:22,66312768,180,207,66312588,66312768
7262,6,12,1,2412,-55,-93,38,40:e3:d6:da:ba:23,66313001,184,49,66312817,66313001
7263,6,12,1,2412,-55,-93,38,40:e3:d6:da:ba:24,66313237,176,60,66313061,66313237
7264,6,12,1,2412,-55,-93,38,40:e3:d6:da:ba:25,66313465,160,68,66313305,66313465
7265,6,6,1,2412,-55,-93,38,40:e3:d6:da:ba:26,66313666,380,-179,66313286,66313666
7266,6,6,1,2412,-87,-93,6,84:d4:7e:f2:42:26,66331527,380,17481,66331147,66331527
7267,4,1,1,2412,-91,-93,2,,66409824,304,77993,66409520,66409824
7268,6,12,1,2412,-57,-93,36,40:e3:d6:da:ba:20,66414674,160,4690,66414514,66414674
7269,6,6,1,2412,-56,-93,37,40:e3:d6:da:ba:21,66415008,368,-34,66414640,66415008
7270,6,12,1,2412,-57,-93,36,40:e3:d6:da:ba:22,66415413,180,225,66415233,66415413
7271,6,12,1,2412,-57,-93,36,40:e3:d6:da:ba:23,66415628,184,31,66415444,66415628
7272,6,12,1,2412,-56,-93,37,40:e3:d6:da:ba:24,66415846,176,42,66415670,66415846
7273,6,12,1,2412,-56,-93,37,40:e3:d6:da:ba:25,66416074,160,68,66415914,66416074
7274,6,6,1,2412,-56,-93,37,40:e3:d6:da:ba:26,66416293,380,-161,66415913,66416293
7275,4,1,1,2412,-65,-93,28,54:e4:3a:ec:fb:64,66425278,2160,6825,66423118,66425278
7276,6,6,1,2412,-82,-93,11,e6:aa:ea:c9:ea:1b,66435799,408,10113,66435391,66435799
7277,6,6,1,2412,-49,-93,44,,66459948,44,24105,66459904,66459948
7278,6,6,1,2412,-82,-93,11,e6:aa:ea:c9:ea:1b,66460364,408,8,66459956,66460364
7279,6,6,1,2412,-49,-93,44,,66484948,44,24540,66484904,66484948
7280,4,1,1,2412,-88,-93,5,a6:e5:7c:28:b1:d3,66490189,992,4249,66489197,66490189
7281,6,6,1,2412,-49,-93,44,,66502439,44,12206,66502395,66502439
7282,6,6,1,2412,-49,-93,44,,66503689,44,1206,66503645,66503689
7283,6,6,1,2412,-49,-93,44,,66504937,44,1204,66504893,66504937
7284,6,6,1,2412,-49,-93,44,,66509948,44,4967,66509904,66509948
7285,6,6,1,2412,-54,-93,39,e6:aa:ea:c9:ea:33,66514228,408,3872,66513820,66514228
7286,6,12,1,2412,-59,-93,34,40:e3:d6:da:ba:20,66516996,160,2608,66516836,66516996
7287,6,6,1,2412,-59,-93,34,40:e3:d6:da:ba:21,66517197,368,-167,66516829,66517197
7288,6,12,1,2412,-59,-93,34,40:e3:d6:da:ba:22,66517584,180,207,66517404,66517584
7289,6,12,1,2412,-59,-93,34,40:e3:d6:da:ba:23,66517799,184,31,66517615,66517799
7290,6,12,1,2412,-59,-93,34,40:e3:d6:da:ba:24,66518035,176,60,66517859,66518035
7291,6,12,1,2412,-59,-93,34,40:e3:d6:da:ba:25,66518246,160,51,66518086,66518246
7292,6,6,1,2412,-58,-93,35,40:e3:d6:da:ba:26,66518456,380,-170,66518076,66518456
7293,6,6,1,2412,-54,-93,39,e6:aa:ea:c9:ea:33,66526346,408,7482,66525938,66526346
7294,6,6,1,2412,-49,-93,44,,66534954,44,8564,66534910,66534954
7295,6,6,1,2412,-53,-93,40,e6:aa:ea:c9:ea:33,66538839,408,3477,66538431,66538839
7296,6,6,1,2412,-61,-93,32,e6:aa:ea:b7:4a:dd,66543590,408,4343,66543182,66543590
7297,6,6,1,2412,-53,-93,40,e6:aa:ea:c9:ea:33,66550590,408,6592,66550182,66550590
7298,6,6,1,2412,-49,-93,44,,66551014,44,380,66550970,66551014
7299,6,6,1,2412,-61,-93,32,e6:aa:ea:b7:4a:dd,66555710,408,4288,66555302,66555710
7300,6,6,1,2412,-52,-93,41,e6:aa:ea:c9:ea:33,66562728,408,6610,66562320,66562728
7301,6,6,1,2412,-49,-93,44,,66566185,44,3413,66566141,66566185
7302,6,6,1,2412,-49,-93,44,,66567742,44,1513,66567698,66567742
7303,6,6,1,2412,-61,-93,32,e6:aa:ea:b7:4a:dd,66580097,408,11947,66579689,66580097
7304,6,6,1,2412,-49,-93,44,,66584950,44,4809,66584906,66584950
7305,6,6,1,2412,-49,-93,44,,66603685,44,18691,66603641,66603685
7306,6,12,1,2412,-60,-93,33,40:e3:d6:da:ba:20,66619370,160,15525,66619210,66619370
7307,6,6,1,2412,-59,-93,34,40:e3:d6:da:ba:21,66619562,368,-176,66619194,66619562
7308,6,12,1,2412,-59,-93,34,40:e3:d6:da:ba:22,66619949,180,207,66619769,66619949
7309,6,12,1,2412,-59,-93,34,40:e3:d6:da:ba:23,66620164,184,31,66619980,66620164
7310,6,12,1,2412,-59,-93,34,40:e3:d6:da:ba:24,66620382,176,42,66620206,66620382
7311,6,12,1,2412,-59,-93,34,40:e3:d6:da:ba:25,66620626,160,84,66620466,66620626
7312,6,6,1,2412,-87,-93,6,84:d4:7e:f2:42:21,66637429,368,16435,66637061,66637429
7313,6,6,1,2412,-49,-93,44,,66669934,44,32461,66669890,66669934
7314,6,6,1,2412,-49,-93,44,,66673687,44,3709,66673643,66673687
7315,6,6,1,2412,-49,-93,44,,66674938,44,1207,66674894,66674938
7316,6,12,1,2412,-60,-93,33,40:e3:d6:da:ba:20,66685953,136,10879,66685817,66685953
7317,6,6,1,2412,-60,-93,33,40:e3:d6:da:ba:21,66686148,348,-153,66685800,66686148
7318,6,12,1,2412,-60,-93,33,40:e3:d6:da:ba:22,66686524,156,220,66686368,66686524
7319,6,12,1,2412,-60,-93,33,40:e3:d6:da:ba:23,66686732,156,52,66686576,66686732
7320,6,12,1,2412,-60,-93,33,40:e3:d6:da:ba:25,66686923,136,55,66686787,66686923
7321,4,1,1,2412,-74,-93,19,a6:e5:7c:28:b1:d3,66694517,992,6602,66693525,66694517
7322,4,1,1,2412,-55,-93,38,3a:50:7a:9a:89:3a,66705065,1152,9396,66703913,66705065
7323,6,12,1,2412,-60,-93,33,40:e3:d6:da:ba:20,66706188,136,987,66706052,66706188
7324,6,6,1,2412,-59,-93,34,40:e3:d6:da:ba:21,66706374,348,-162,66706026,66706374
7325,6,12,1,2412,-59,-93,34,40:e3:d6:da:ba:22,66706777,156,247,66706621,66706777
7326,6,12,1,2412,-59,-93,34,40:e3:d6:da:ba:23,66706968,156,35,66706812,66706968
7327,6,12,1,2412,-59,-93,34,40:e3:d6:da:ba:25,66707158,136,54,66707022,66707158
7328,6,6,1,2412,-49,-93,44,,66709946,44,2744,66709902,66709946
7329,6,6,1,2412,-49,-93,44,,66721301,44,11311,66721257,66721301
7330,6,12,1,2412,-59,-93,34,40:e3:d6:da:ba:20,66721771,160,310,66721611,66721771
7331,6,6,1,2412,-59,-93,34,40:e3:d6:da:ba:21,66721963,368,-176,66721595,66721963
7332,6,12,1,2412,-59,-93,34,40:e3:d6:da:ba:23,66722606,184,459,66722422,66722606
7333,6,12,1,2412,-59,-93,34,40:e3:d6:da:ba:24,66722842,176,60,66722666,66722842
7334,6,12,1,2412,-59,-93,34,40:e3:d6:da:ba:25,66723061,160,59,66722901,66723061
7335,6,6,1,2412,-59,-93,34,40:e3:d6:da:ba:26,66723272,380,-169,66722892,66723272
7336,6,6,1,2412,-83,-93,10,e6:aa:ea:c9:ea:1b,66729834,408,6154,66729426,66729834
7337,4,1,1,2412,-57,-93,36,a6:8c:4e:91:fa:ba,66744041,1152,13055,66742889,66744041
7338,4,1,1,2412,-72,-93,21,54:e4:3a:ec:fb:64,66745342,2112,-811,66743230,66745342
7339,4,1,1,2412,-73,-93,20,54:e4:3a:ec:fb:64,66747581,2112,127,66745469,66747581
7340,4,1,1,2412,-57,-93,36,,66749706,304,1821,66749402,66749706
7341,6,12,1,2412,-59,-93,34,40:e3:d6:da:ba:20,66749870,136,28,66749734,66749870
7342,6,12,1,2412,-59,-93,34,,66750022,32,120,66749990,66750022
7343,6,6,1,2412,-59,-93,34,40:e3:d6:da:ba:21,66750123,348,-247,66749775,66750123
7344,6,6,1,2412,-59,-93,34,,66750486,44,319,66750442,66750486
7345,6,12,1,2412,-59,-93,34,40:e3:d6:da:ba:22,66750559,156,-83,66750403,66750559
7346,6,12,1,2412,-59,-93,34,,66750731,32,140,66750699,66750731
7347,6,12,1,2412,-59,-93,34,40:e3:d6:da:ba:25,66751007,136,140,66750871,66751007
7348,6,12,1,2412,-59,-93,34,,66751159,32,120,66751127,66751159
7349,6,6,1,2412,-49,-93,44,,66759945,44,8742,66759901,66759945
7350,4,1,1,2412,-58,-93,35,a6:8c:4e:91:fa:ba,66764422,1152,3325,66763270,66764422
7351,6,12,1,2412,-60,-93,33,40:e3:d6:da:ba:20,66765560,136,1002,66765424,66765560
7352,6,6,1,2412,-60,-93,33,40:e3:d6:da:ba:21,66767717,348,1809,66767369,66767717
7353,6,12,1,2412,-60,-93,33,40:e3:d6:da:ba:22,66768120,156,247,66767964,66768120
7354,6,12,1,2412,-63,-93,30,,66768292,32,140,66768260,66768292
7355,6,12,1,2412,-60,-93,33,40:e3:d6:da:ba:23,66768359,156,-89,66768203,66768359
7356,6,12,1,2412,-63,-93,30,,66768531,32,140,66768499,66768531
7357,6,12,1,2412,-60,-93,33,40:e3:d6:da:ba:25,66768617,136,-50,66768481,66768617
7358,6,12,1,2412,-63,-93,30,,66768768,32,119,66768736,66768768
7359,6,6,1,2412,-49,-93,44,,66784945,44,16133,66784901,66784945
7360,6,6,1,2412,-49,-93,44,,66809946,44,24957,66809902,66809946
7361,6,6,1,2412,-49,-93,44,,66823232,44,13242,66823188,66823232
7362,6,12,1,2412,-59,-93,34,40:e3:d6:da:ba:20,66827119,160,3727,66826959,66827119
7363,6,6,1,2412,-59,-93,34,40:e3:d6:da:ba:21,66827338,368,-149,66826970,66827338
7364,6,12,1,2412,-58,-93,35,40:e3:d6:da:ba:22,66827752,180,234,66827572,66827752
7365,6,12,1,2412,-58,-93,35,40:e3:d6:da:ba:23,66827967,184,31,66827783,66827967
7366,6,12,1,2412,-58,-93,35,40:e3:d6:da:ba:24,66828185,176,42,66828009,66828185
7367,6,12,1,2412,-59,-93,34,40:e3:d6:da:ba:25,66828396,160,51,66828236,66828396
7368,6,6,1,2412,-58,-93,35,40:e3:d6:da:ba:26,66828606,380,-170,66828226,66828606
7369,6,6,1,2412,-48,-93,45,,66852433,44,23783,66852389,66852433
7370,6,6,1,2412,-48,-93,45,,66884944,44,32467,66884900,66884944
7371,6,6,1,2412,-48,-93,45,,66908682,44,23694,66908638,66908682
7372,6,6,1,2412,-48,-93,45,,66917431,44,8705,66917387,66917431
7373,6,6,1,2412,-48,-93,45,,66919931,44,2456,66919887,66919931
7374,6,12,1,2412,-57,-93,36,40:e3:d6:da:ba:20,66929162,160,9071,66929002,66929162
7375,6,6,1,2412,-57,-93,36,40:e3:d6:da:ba:21,66929381,368,-149,66929013,66929381
7376,6,12,1,2412,-56,-93,37,40:e3:d6:da:ba:22,66929821,180,260,66929641,66929821
7377,6,12,1,2412,-56,-93,37,40:e3:d6:da:ba:23,66930045,184,40,66929861,66930045
7378,6,12,1,2412,-56,-93,37,40:e3:d6:da:ba:24,66930254,176,33,66930078,66930254
7379,4,1,1,2412,-74,-93,19,54:e4:3a:ec:fb:64,66937113,2160,4699,66934953,66937113
7380,6,12,1,2412,-86,-93,7,84:d4:7e:f2:42:20,66944426,160,7153,66944266,66944426
7381,6,6,1,2412,-61,-93,32,e6:aa:ea:b7:4a:dd,66961334,408,16500,66960926,66961334
7382,6,6,1,2412,-62,-93,31,e6:aa:ea:b7:4a:dd,66973244,408,11502,66972836,66973244
7383,6,6,1,2412,-62,-93,31,e6:aa:ea:b7:4a:dd,66985374,408,11722,66984966,66985374
7384,6,6,1,2412,-62,-93,31,e6:aa:ea:b7:4a:dd,66997480,408,11698,66997072,66997480
7385,6,12,1,2412,-56,-93,37,40:e3:d6:da:ba:20,67029046,160,31406,67028886,67029046
7386,6,6,1,2412,-56,-93,37,40:e3:d6:da:ba:21,67029257,368,-157,67028889,67029257
7387,6,12,1,2412,-56,-93,37,40:e3:d6:da:ba:22,67029671,180,234,67029491,67029671
7388,6,12,1,2412,-56,-93,37,40:e3:d6:da:ba:23,67029903,184,48,67029719,67029903
7389,6,12,1,2412,-56,-93,37,40:e3:d6:da:ba:24,67030113,176,34,67029937,67030113
7390,6,12,1,2412,-56,-93,37,40:e3:d6:da:ba:25,67030341,160,68,67030181,67030341
7391,6,6,1,2412,-56,-93,37,40:e3:d6:da:ba:26,67030533,380,-188,67030153,67030533
7392,6,6,1,2412,-54,-93,39,e6:aa:ea:c9:ea:33,67034854,408,3913,67034446,67034854
7393,4,1,1,2412,-70,-93,23,54:e4:3a:ec:fb:64,67039513,2160,2499,67037353,67039513
7394,6,6,1,2412,-85,-93,8,84:d4:7e:f2:42:26,67048697,380,8804,67048317,67048697
7395,6,6,1,2412,-54,-93,39,e6:aa:ea:c9:ea:33,67059081,408,9976,67058673,67059081
7396,6,6,1,2412,-53,-93,40,e6:aa:ea:c9:ea:33,67071356,408,11867,67070948,67071356
7397,6,6,1,2412,-54,-93,39,e6:aa:ea:c9:ea:33,67083317,408,11553,67082909,67083317
7398,6,6,1,2412,-78,-93,15,e6:aa:ea:c9:ea:1b,67095279,408,11554,67094871,67095279
7399,6,12,1,2412,-58,-93,35,40:e3:d6:da:ba:25,67133205,160,37766,67133045,67133205
7400,6,6,1,2412,-58,-93,35,40:e3:d6:da:ba:26,67133396,380,-189,67133016,67133396
7401,6,12,1,2412,-87,-93,6,84:d4:7e:f2:42:20,67149233,160,15677,67149073,67149233
7402,6,6,1,2412,-86,-93,7,84:d4:7e:f2:42:21,67149424,368,-177,67149056,67149424
7403,4,1,1,2412,-59,-93,34,66:2e:21:86:ab:1e,67209698,1152,59122,67208546,67209698
7404,6,12,1,2412,-58,-93,35,40:e3:d6:da:ba:20,67212991,136,3157,67212855,67212991
7405,6,6,1,2412,-58,-93,35,40:e3:d6:da:ba:21,67213185,348,-154,67212837,67213185
7406,6,12,1,2412,-58,-93,35,40:e3:d6:da:ba:22,67213681,156,340,67213525,67213681
7407,6,12,1,2412,-58,-93,35,40:e3:d6:da:ba:23,67213872,156,35,67213716,67213872
7408,6,12,1,2412,-58,-93,35,40:e3:d6:da:ba:25,67214081,136,73,67213945,67214081
7409,4,1,1,2412,-71,-93,22,54:e4:3a:ec:fb:64,67215818,2112,-375,67213706,67215818
7410,4,1,1,2412,-56,-93,37,,67217942,304,1820,67217638,67217942
7411,6,12,1,2412,-62,-93,31,40:e3:d6:da:ba:22,67234395,180,16273,67234215,67234395
7412,6,12,1,2412,-62,-93,31,40:e3:d6:da:ba:23,67234627,184,48,67234443,67234627
7413,6,12,1,2412,-62,-93,31,40:e3:d6:da:ba:24,67234837,176,34,67234661,67234837
7414,6,12,1,2412,-62,-93,31,40:e3:d6:da:ba:25,67235065,160,68,67234905,67235065
7415,6,6,1,2412,-61,-93,32,40:e3:d6:da:ba:26,67235275,380,-170,67234895,67235275
7416,4,1,1,2412,-70,-93,23,54:e4:3a:ec:fb:64,67244311,2160,6876,67242151,67244311
7417,6,12,1,2412,-89,-93,4,84:d4:7e:f2:42:20,67251650,160,7179,67251490,67251650
7418,6,6,1,2412,-87,-93,6,84:d4:7e:f2:42:21,67251851,368,-167,67251483,67251851
7419,6,12,1,2412,-88,-93,5,84:d4:7e:f2:42:24,67252711,176,684,67252535,67252711
7420,6,6,1,2412,-88,-93,5,84:d4:7e:f2:42:26,67253141,380,50,67252761,67253141
7421,6,12,1,2412,-59,-93,34,40:e3:d6:da:ba:20,67336180,160,82879,67336020,67336180
7422,6,6,1,2412,-59,-93,34,40:e3:d6:da:ba:21,67338687,368,2139,67338319,67338687
7423,6,12,1,2412,-59,-93,34,40:e3:d6:da:ba:22,67340696,180,1829,67340516,67340696
7424,6,12,1,2412,-60,-93,33,40:e3:d6:da:ba:23,67341083,184,203,67340899,67341083
7425,6,12,1,2412,-59,-93,34,40:e3:d6:da:ba:24,67341292,176,33,67341116,67341292
7426,6,12,1,2412,-59,-93,34,40:e3:d6:da:ba:25,67341493,160,41,67341333,67341493
7427,6,6,1,2412,-63,-93,30,e6:aa:ea:b7:4a:dd,67378238,408,36337,67377830,67378238
7428,6,6,1,2412,-61,-93,32,e6:aa:ea:b7:4a:dd,67426708,408,48062,67426300,67426708
7429,6,12,1,2412,-62,-93,31,40:e3:d6:da:ba:20,67442280,160,15412,67442120,67442280
7430,6,6,1,2412,-62,-93,31,40:e3:d6:da:ba:21,67442488,368,-160,67442120,67442488
7431,6,12,1,2412,-62,-93,31,40:e3:d6:da:ba:22,67442875,180,207,67442695,67442875
7432,6,12,1,2412,-62,-93,31,40:e3:d6:da:ba:23,67443098,184,39,67442914,67443098
7433,6,12,1,2412,-62,-93,31,40:e3:d6:da:ba:24,67443335,176,61,67443159,67443335
7434,6,12,1,2412,-62,-93,31,40:e3:d6:da:ba:25,67443554,160,59,67443394,67443554
7435,6,6,1,2412,-62,-93,31,40:e3:d6:da:ba:26,67443746,380,-188,67443366,67443746
7436,6,6,1,2412,-57,-93,36,e6:aa:ea:c9:ea:33,67451916,408,7762,67451508,67451916
7437,6,6,1,2412,-88,-93,5,84:d4:7e:f2:42:26,67457910,380,5614,67457530,67457910
7438,6,6,1,2412,-57,-93,36,e6:aa:ea:c9:ea:33,67464030,408,5712,67463622,67464030
7439,6,6,1,2412,-58,-93,35,e6:aa:ea:c9:ea:33,67478345,408,13907,67477937,67478345
7440,6,12,1,2412,-58,-93,35,40:e3:d6:da:ba:20,67540979,160,62474,67540819,67540979
7441,6,6,1,2412,-59,-93,34,40:e3:d6:da:ba:21,67541171,368,-176,67540803,67541171
7442,6,12,1,2412,-57,-93,36,40:e3:d6:da:ba:23,67541848,184,493,67541664,67541848
7443,6,12,1,2412,-59,-93,34,40:e3:d6:da:ba:24,67542059,176,35,67541883,67542059
7444,6,12,1,2412,-59,-93,34,40:e3:d6:da:ba:25,67542260,160,41,67542100,67542260
7445,6,6,1,2412,-59,-93,34,40:e3:d6:da:ba:26,67542452,380,-188,67542072,67542452
7446,6,12,1,2412,-87,-93,6,84:d4:7e:f2:42:22,67560113,180,17481,67559933,67560113
7447,6,12,1,2412,-86,-93,7,84:d4:7e:f2:42:23,67560337,180,44,67560157,67560337
7448,6,6,1,2412,-86,-93,7,84:d4:7e:f2:42:26,67560954,380,237,67560574,67560954
7449,6,6,1,2412,-82,-93,11,e6:aa:ea:c9:ea:1b,67579086,408,17724,67578678,67579086
7450,6,6,1,2412,-83,-93,10,e6:aa:ea:c9:ea:1b,67603327,408,23833,67602919,67603327
7451,6,12,1,2412,-59,-93,34,40:e3:d6:da:ba:20,67644018,160,40531,67643858,67644018
7452,6,6,1,2412,-59,-93,34,40:e3:d6:da:ba:21,67644237,368,-149,67643869,67644237
7453,6,12,1,2412,-59,-93,34,40:e3:d6:da:ba:22,67644916,180,499,67644736,67644916
7454,6,12,1,2412,-59,-93,34,40:e3:d6:da:ba:23,67645131,184,31,67644947,67645131
7455,6,12,1,2412,-59,-93,34,40:e3:d6:da:ba:24,67645340,176,33,67645164,67645340
7456,6,12,1,2412,-59,-93,34,40:e3:d6:da:ba:25,67645550,160,50,67645390,67645550
7457,6,6,1,2412,-59,-93,34,40:e3:d6:da:ba:26,67645742,380,-188,67645362,67645742
7458,6,6,1,2412,-88,-93,5,84:d4:7e:f2:42:21,67662234,368,16124,67661866,67662234
7459,6,12,1,2412,-88,-93,5,84:d4:7e:f2:42:22,67662622,180,208,67662442,67662622
7460,6,12,1,2412,-87,-93,6,84:d4:7e:f2:42:23,67662845,180,43,67662665,67662845
7461,6,12,1,2412,-87,-93,6,84:d4:7e:f2:42:24,67663059,176,38,67662883,67663059
7462,6,12,1,2412,-87,-93,6,84:d4:7e:f2:42:25,67663288,160,69,67663128,67663288
7463,6,6,1,2412,-89,-93,4,84:d4:7e:f2:42:26,67663489,380,-179,67663109,67663489
7464,6,12,1,2412,-59,-93,34,40:e3:d6:da:ba:20,67745775,160,82126,67745615,67745775
7465,6,6,1,2412,-59,-93,34,40:e3:d6:da:ba:21,67745994,368,-149,67745626,67745994
7466,6,12,1,2412,-59,-93,34,40:e3:d6:da:ba:23,67746614,184,436,67746430,67746614
7467,6,12,1,2412,-59,-93,34,40:e3:d6:da:ba:24,67746841,176,51,67746665,67746841
7468,6,12,1,2412,-59,-93,34,40:e3:d6:da:ba:25,67747061,160,60,67746901,67747061
7469,6,6,1,2412,-59,-93,34,40:e3:d6:da:ba:26,67747252,380,-189,67746872,67747252
7470,4,1,1,2412,-70,-93,23,54:e4:3a:ec:fb:64,67756307,2160,6895,67754147,67756307
7471,6,12,1,2412,-89,-93,4,84:d4:7e:f2:42:20,67763634,160,7167,67763474,67763634
7472,6,6,1,2412,-88,-93,5,84:d4:7e:f2:42:21,67763826,368,-176,67763458,67763826
7473,6,12,1,2412,-59,-93,34,40:e3:d6:da:ba:22,67848974,180,84968,67848794,67848974
7474,6,12,1,2412,-59,-93,34,40:e3:d6:da:ba:23,67849180,184,22,67848996,67849180
7475,6,12,1,2412,-59,-93,34,40:e3:d6:da:ba:24,67849389,176,33,67849213,67849389
7476,6,12,1,2412,-59,-93,34,40:e3:d6:da:ba:25,67849599,160,50,67849439,67849599
7477,6,6,1,2412,-59,-93,34,40:e3:d6:da:ba:26,67849800,380,-179,67849420,67849800
7478,4,1,1,2412,-70,-93,23,54:e4:3a:ec:fb:64,67858705,2160,6745,67856545,67858705
7479,6,12,1,2412,-87,-93,6,84:d4:7e:f2:42:20,67866061,160,7196,67865901,67866061
7480,6,6,1,2412,-87,-93,6,84:d4:7e:f2:42:21,67866280,368,-149,67865912,67866280
7481,6,12,1,2412,-89,-93,4,84:d4:7e:f2:42:22,67866675,180,215,67866495,67866675
7482,6,12,1,2412,-88,-93,5,84:d4:7e:f2:42:23,67866881,180,26,67866701,67866881
7483,6,12,1,2412,-88,-93,5,84:d4:7e:f2:42:24,67867114,176,57,67866938,67867114
7484,6,12,1,2412,-89,-93,4,84:d4:7e:f2:42:25,67867324,160,50,67867164,67867324
7485,6,6,1,2412,-87,-93,6,84:d4:7e:f2:42:26,67867525,380,-179,67867145,67867525
7486,6,6,1,2412,-57,-93,36,e6:aa:ea:c9:ea:33,67872473,408,4540,67872065,67872473
7487,4,1,1,2412,-74,-93,19,c0:c9:e3:4d:6e:bf,67888036,872,14691,67887164,67888036
7488,6,6,1,2412,-68,-93,25,e6:aa:ea:b7:4a:dd,67910114,408,21670,67909706,67910114
7489,4,1,1,2412,-92,-93,1,a6:e5:7c:28:b1:d3,67925801,992,14695,67924809,67925801
7490,4,1,1,2412,-91,-93,2,,67932879,304,6774,67932575,67932879
7491,6,6,1,2412,-68,-93,25,e6:aa:ea:b7:4a:dd,67946544,408,13257,67946136,67946544
7492,6,12,1,2412,-60,-93,33,40:e3:d6:da:ba:20,67950585,160,3881,67950425,67950585
7493,6,6,1,2412,-59,-93,34,40:e3:d6:da:ba:21,67950777,368,-176,67950409,67950777
7494,6,12,1,2412,-59,-93,34,40:e3:d6:da:ba:22,67951191,180,234,67951011,67951191
7495,6,12,1,2412,-59,-93,34,40:e3:d6:da:ba:23,67951414,184,39,67951230,67951414
7496,6,12,1,2412,-59,-93,34,40:e3:d6:da:ba:24,67951633,176,43,67951457,67951633
7497,6,12,1,2412,-59,-93,34,40:e3:d6:da:ba:25,67951852,160,59,67951692,67951852
7498,6,6,1,2412,-59,-93,34,40:e3:d6:da:ba:26,67952044,380,-188,67951664,67952044
7499,4,1,1,2412,-64,-93,29,54:e4:3a:ec:fb:64,67961106,2160,6902,67958946,67961106
7500,6,6,1,2412,-81,-93,12,e6:aa:ea:c9:ea:1b,67987119,408,25605,67986711,67987119
7501,6,6,1,2412,-82,-93,11,e6:aa:ea:c9:ea:1b,68035578,408,48051,68035170,68035578
7502,6,12,1,2412,-60,-93,33,40:e3:d6:da:ba:20,68052996,160,17258,68052836,68052996
7503,6,6,1,2412,-60,-93,33,40:e3:d6:da:ba:21,68053197,368,-167,68052829,68053197
7504,6,12,1,2412,-59,-93,34,40:e3:d6:da:ba:22,68053584,180,207,68053404,68053584
7505,6,12,1,2412,-59,-93,34,40:e3:d6:da:ba:23,68053939,184,171,68053755,68053939
7506,6,12,1,2412,-60,-93,33,40:e3:d6:da:ba:24,68054158,176,43,68053982,68054158
7507,6,12,1,2412,-59,-93,34,40:e3:d6:da:ba:25,68054387,160,69,68054227,68054387
7508,6,6,1,2412,-60,-93,33,40:e3:d6:da:ba:26,68054606,380,-161,68054226,68054606
7509,6,12,1,2412,-60,-93,33,,68118886,32,64248,68118854,68118886
7510,6,12,1,2412,-60,-93,33,,68119016,44,86,68118972,68119016
7511,6,12,1,2412,-60,-93,33,,68129222,36,10170,68129186,68129222
7512,6,12,1,2412,-87,-93,6,,68129274,32,20,68129242,68129274
7513,6,12,1,2412,-60,-93,33,,68129500,36,190,68129464,68129500
7514,6,12,1,2412,-60,-93,33,,68129928,36,392,68129892,68129928
7515,6,12,1,2412,-86,-93,7,,68129980,32,20,68129948,68129980
7516,7,86.6667,1,2412,-60,-93,33,00:1f:26:41:f0:00,68130038,51,7,68129987,68130038
7517,6,12,1,2412,-87,-93,6,22:a3:7f:87:e5:4e,68149091,44,19009,68149047,68149091
7518,6,12,1,2412,-60,-93,33,,68149152,32,29,68149120,68149152
7519,6,12,1,2412,-61,-93,32,40:e3:d6:da:ba:20,68155379,160,6067,68155219,68155379
7520,6,6,1,2412,-58,-93,35,40:e3:d6:da:ba:21,68155598,368,-149,68155230,68155598
7521,6,12,1,2412,-60,-93,33,40:e3:d6:da:ba:22,68156081,180,303,68155901,68156081
7522,6,12,1,2412,-60,-93,33,40:e3:d6:da:ba:23,68156313,184,48,68156129,68156313
7523,6,12,1,2412,-60,-93,33,40:e3:d6:da:ba:24,68156522,176,33,68156346,68156522
7524,6,12,1,2412,-60,-93,33,40:e3:d6:da:ba:25,68156751,160,69,68156591,68156751
7525,6,6,1,2412,-58,-93,35,40:e3:d6:da:ba:26,68156942,380,-189,68156562,68156942
7526,6,6,1,2412,-62,-93,31,40:e3:d6:da:ba:21,68258434,368,101124,68258066,68258434
7527,6,12,1,2412,-62,-93,31,40:e3:d6:da:ba:22,68258848,180,234,68258668,68258848
7528,6,12,1,2412,-62,-93,31,40:e3:d6:da:ba:24,68260350,176,1326,68260174,68260350
7529,6,12,1,2412,-62,-93,31,40:e3:d6:da:ba:25,68260579,160,69,68260419,68260579
7530,6,6,1,2412,-62,-93,31,40:e3:d6:da:ba:26,68260798,380,-161,68260418,68260798
7531,4,1,1,2412,-67,-93,26,54:e4:3a:ec:fb:64,68268302,2160,5344,68266142,68268302
7532,6,6,1,2412,-69,-93,24,e6:aa:ea:b7:4a:dd,68316498,408,47788,68316090,68316498
7533,6,6,1,2412,-68,-93,25,e6:aa:ea:b7:4a:dd,68340740,408,23834,68340332,68340740
7534,6,12,1,2412,-60,-93,33,40:e3:d6:da:ba:20,68360184,160,19284,68360024,68360184
7535,6,6,1,2412,-60,-93,33,40:e3:d6:da:ba:21,68360385,368,-167,68360017,68360385
7536,6,12,1,2412,-61,-93,32,40:e3:d6:da:ba:22,68360790,180,225,68360610,68360790
7537,6,12,1,2412,-61,-93,32,40:e3:d6:da:ba:23,68361014,184,40,68360830,68361014
7538,6,12,1,2412,-60,-93,33,40:e3:d6:da:ba:25,68361451,160,277,68361291,68361451
7539,4,1,1,2412,-67,-93,26,54:e4:3a:ec:fb:64,68371980,2160,8369,68369820,68371980
7540,6,6,1,2412,-56,-93,37,e6:aa:ea:c9:ea:33,68404382,408,31994,68403974,68404382
7541,6,6,1,2412,-56,-93,37,e6:aa:ea:c9:ea:33,68416501,408,11711,68416093,68416501
7542,6,6,1,2412,-56,-93,37,e6:aa:ea:c9:ea:33,68428619,408,11710,68428211,68428619
7543,6,6,1,2412,-56,-93,37,e6:aa:ea:c9:ea:33,68440849,408,11822,68440441,68440849
7544,6,12,1,2412,-61,-93,32,40:e3:d6:da:ba:20,68462602,160,21593,68462442,68462602
7545,6,6,1,2412,-61,-93,32,40:e3:d6:da:ba:21,68462811,368,-159,68462443,68462811
7546,6,12,1,2412,-61,-93,32,40:e3:d6:da:ba:22,68463207,180,216,68463027,68463207
7547,6,12,1,2412,-61,-93,32,40:e3:d6:da:ba:23,68463413,184,22,68463229,68463413
7548,6,12,1,2412,-61,-93,32,40:e3:d6:da:ba:24,68463640,176,51,68463464,68463640
7549,6,12,1,2412,-61,-93,32,40:e3:d6:da:ba:25,68466194,160,2394,68466034,68466194
7550,6,6,1,2412,-61,-93,32,40:e3:d6:da:ba:26,68466404,380,-170,68466024,68466404
7551,4,1,1,2412,-71,-93,22,54:e4:3a:ec:fb:64,68473100,2160,4536,68470940,68473100
7552,6,12,1,2412,-59,-93,34,40:e3:d6:da:ba:20,68564984,160,91724,68564824,68564984
7553,6,12,1,2412,-62,-93,31,40:e3:d6:da:ba:22,68565590,180,426,68565410,68565590
7554,6,12,1,2412,-59,-93,34,40:e3:d6:da:ba:23,68565795,184,21,68565611,68565795
7555,6,12,1,2412,-62,-93,31,40:e3:d6:da:ba:24,68566005,176,34,68565829,68566005
7556,6,12,1,2412,-62,-93,31,40:e3:d6:da:ba:25,68566224,160,59,68566064,68566224
7557,6,6,1,2412,-62,-93,31,40:e3:d6:da:ba:26,68566425,380,-179,68566045,68566425
7558,4,1,1,2412,-74,-93,19,54:e4:3a:ec:fb:64,68575499,2160,6914,68573339,68575499
7559,6,12,1,2412,-60,-93,33,40:e3:d6:da:ba:20,68667394,160,91735,68667234,68667394
7560,6,6,1,2412,-60,-93,33,40:e3:d6:da:ba:21,68667674,368,-88,68667306,68667674
7561,6,12,1,2412,-60,-93,33,40:e3:d6:da:ba:22,68668061,180,207,68667881,68668061
7562,6,12,1,2412,-60,-93,33,40:e3:d6:da:ba:23,68668275,184,30,68668091,68668275
7563,6,12,1,2412,-60,-93,33,40:e3:d6:da:ba:24,68668484,176,33,68668308,68668484
7564,6,12,1,2412,-60,-93,33,40:e3:d6:da:ba:25,68668686,160,42,68668526,68668686
7565,6,6,1,2412,-60,-93,33,40:e3:d6:da:ba:26,68668933,380,-133,68668553,68668933
7566,6,6,1,2412,-56,-93,37,e6:aa:ea:c9:ea:33,68719373,408,50032,68718965,68719373
7567,6,6,1,2412,-56,-93,37,e6:aa:ea:c9:ea:33,68731484,408,11703,68731076,68731484
7568,6,6,1,2412,-56,-93,37,e6:aa:ea:c9:ea:33,68743600,408,11708,68743192,68743600
7569,6,12,1,2412,-58,-93,35,40:e3:d6:da:ba:20,68769787,160,26027,68769627,68769787
7570,4,1,1,2412,-68,-93,25,54:e4:3a:ec:fb:64,68780865,2160,8918,68778705,68780865
7571,6,6,1,2412,-88,-93,5,84:d4:7e:f2:42:21,68788081,368,6848,68787713,68788081
7572,6,6,1,2412,-82,-93,11,e6:aa:ea:c9:ea:1b,68827225,408,38736,68826817,68827225
7573,6,12,1,2412,-55,-93,38,40:e3:d6:da:ba:20,68873499,160,46114,68873339,68873499
7574,6,12,1,2412,-55,-93,38,40:e3:d6:da:ba:22,68874102,180,423,68873922,68874102
7575,6,12,1,2412,-55,-93,38,40:e3:d6:da:ba:23,68874334,184,48,68874150,68874334
7576,6,12,1,2412,-55,-93,38,40:e3:d6:da:ba:24,68874543,176,33,68874367,68874543
7577,6,12,1,2412,-55,-93,38,40:e3:d6:da:ba:25,68874763,160,60,68874603,68874763
7578,6,6,1,2412,-55,-93,38,40:e3:d6:da:ba:26,68874973,380,-170,68874593,68874973
7579,6,12,1,2412,-56,-93,37,40:e3:d6:da:ba:20,68974607,160,99474,68974447,68974607
7580,6,12,1,2412,-56,-93,37,40:e3:d6:da:ba:22,68975213,180,426,68975033,68975213
7581,6,12,1,2412,-56,-93,37,40:e3:d6:da:ba:23,68975436,184,39,68975252,68975436
7582,6,12,1,2412,-56,-93,37,40:e3:d6:da:ba:24,68975664,176,52,68975488,68975664
7583,6,12,1,2412,-56,-93,37,40:e3:d6:da:ba:25,68975865,160,41,68975705,68975865
7584,6,6,1,2412,-56,-93,37,40:e3:d6:da:ba:26,68976066,380,-179,68975686,68976066
7585,4,1,1,2412,-74,-93,19,54:e4:3a:ec:fb:64,68985097,2160,6871,68982937,68985097
7586,6,6,1,2412,-57,-93,36,e6:aa:ea:c9:ea:33,69036136,408,50631,69035728,69036136
7587,6,6,1,2412,-57,-93,36,e6:aa:ea:c9:ea:33,69046408,408,9864,69046000,69046408
7588,6,12,1,2412,-58,-93,35,40:e3:d6:da:ba:20,69076992,160,30424,69076832,69076992
7589,6,6,1,2412,-58,-93,35,40:e3:d6:da:ba:21,69077202,368,-158,69076834,69077202
7590,6,12,1,2412,-58,-93,35,40:e3:d6:da:ba:22,69077589,180,207,69077409,69077589
7591,6,12,1,2412,-58,-93,35,40:e3:d6:da:ba:23,69077795,184,22,69077611,69077795
7592,6,12,1,2412,-58,-93,35,40:e3:d6:da:ba:24,69078013,176,42,69077837,69078013
7593,6,12,1,2412,-58,-93,35,40:e3:d6:da:ba:25,69078215,160,42,69078055,69078215
7594,6,6,1,2412,-58,-93,35,40:e3:d6:da:ba:26,69078407,380,-188,69078027,69078407
7595,4,1,1,2412,-75,-93,18,54:e4:3a:ec:fb:64,69087496,2160,6929,69085336,69087496
7596,6,12,1,2412,-60,-93,33,40:e3:d6:da:ba:20,69179395,160,91739,69179235,69179395
7597,6,6,1,2412,-60,-93,33,40:e3:d6:da:ba:21,69179605,368,-158,69179237,69179605
7598,6,12,1,2412,-60,-93,33,40:e3:d6:da:ba:22,69180001,180,216,69179821,69180001
7599,6,12,1,2412,-60,-93,33,40:e3:d6:da:ba:23,69180224,184,39,69180040,69180224
7600,6,12,1,2412,-60,-93,33,40:e3:d6:da:ba:24,69181539,176,1139,69181363,69181539
7601,6,12,1,2412,-60,-93,33,40:e3:d6:da:ba:25,69181741,160,42,69181581,69181741
7602,6,6,1,2412,-60,-93,33,40:e3:d6:da:ba:26,69181950,380,-171,69181570,69181950
7603,6,6,1,2412,-67,-93,26,e6:aa:ea:b7:4a:dd,69277401,408,95043,69276993,69277401
7604,6,12,1,2412,-59,-93,34,40:e3:d6:da:ba:20,69281783,160,4222,69281623,69281783
7605,6,6,1,2412,-59,-93,34,40:e3:d6:da:ba:21,69281993,368,-158,69281625,69281993
7606,6,12,1,2412,-59,-93,34,40:e3:d6:da:ba:22,69282380,180,207,69282200,69282380
7607,6,12,1,2412,-59,-93,34,40:e3:d6:da:ba:23,69282648,184,84,69282464,69282648
7608,6,12,1,2412,-59,-93,34,40:e3:d6:da:ba:24,69282876,176,52,69282700,69282876
7609,6,6,1,2412,-59,-93,34,40:e3:d6:da:ba:26,69283296,380,40,69282916,69283296
7610,6,6,1,2412,-67,-93,26,e6:aa:ea:b7:4a:dd,69289510,408,5806,69289102,69289510
7611,6,6,1,2412,-83,-93,10,e6:aa:ea:c9:ea:1b,69373878,408,83960,69373470,69373878
7612,6,12,1,2412,-59,-93,34,40:e3:d6:da:ba:20,69384200,160,10162,69384040,69384200
7613,6,6,1,2412,-59,-93,34,40:e3:d6:da:ba:21,69384419,368,-149,69384051,69384419
7614,6,12,1,2412,-58,-93,35,40:e3:d6:da:ba:22,69384815,180,216,69384635,69384815
7615,6,12,1,2412,-58,-93,35,40:e3:d6:da:ba:23,69385108,184,109,69384924,69385108
7616,6,12,1,2412,-58,-93,35,40:e3:d6:da:ba:24,69385318,176,34,69385142,69385318
7617,6,12,1,2412,-58,-93,35,40:e3:d6:da:ba:25,69385537,160,59,69385377,69385537
7618,6,6,1,2412,-58,-93,35,40:e3:d6:da:ba:26,69385756,380,-161,69385376,69385756
7619,6,6,1,2412,-60,-93,33,e6:aa:ea:c9:ea:33,69466242,408,80078,69465834,69466242
7620,6,6,1,2412,-59,-93,34,e6:aa:ea:c9:ea:33,69476948,408,10298,69476540,69476948
7621,6,12,1,2412,-57,-93,36,40:e3:d6:da:ba:20,69486590,160,9482,69486430,69486590
7622,6,6,1,2412,-56,-93,37,40:e3:d6:da:ba:21,69486809,368,-149,69486441,69486809
7623,6,12,1,2412,-57,-93,36,40:e3:d6:da:ba:22,69487223,180,234,69487043,69487223
7624,6,12,1,2412,-56,-93,37,40:e3:d6:da:ba:23,69487437,184,30,69487253,69487437
7625,6,12,1,2412,-57,-93,36,40:e3:d6:da:ba:24,69487656,176,43,69487480,69487656
7626,6,12,1,2412,-57,-93,36,40:e3:d6:da:ba:25,69487857,160,41,69487697,69487857
7627,6,6,1,2412,-56,-93,37,40:e3:d6:da:ba:26,69488076,380,-161,69487696,69488076
7628,6,6,1,2412,-61,-93,32,e6:aa:ea:c9:ea:33,69488932,408,448,69488524,69488932
7629,6,12,1,2412,-58,-93,35,40:e3:d6:da:ba:20,69588990,160,99898,69588830,69588990
7630,6,6,1,2412,-58,-93,35,40:e3:d6:da:ba:21,69589209,368,-149,69588841,69589209
7631,6,12,1,2412,-57,-93,36,40:e3:d6:da:ba:22,69589623,180,234,69589443,69589623
7632,6,12,1,2412,-57,-93,36,40:e3:d6:da:ba:23,69589846,184,39,69589662,69589846
7633,6,12,1,2412,-58,-93,35,40:e3:d6:da:ba:24,69590065,176,43,69589889,69590065
7634,6,12,1,2412,-57,-93,36,40:e3:d6:da:ba:25,69590284,160,59,69590124,69590284
7635,6,6,1,2412,-57,-93,36,40:e3:d6:da:ba:26,69590476,380,-188,69590096,69590476
7636,4,1,1,2412,-72,-93,21,54:e4:3a:ec:fb:64,69599491,2160,6855,69597331,69599491
7637,6,6,1,2412,-81,-93,12,e6:aa:ea:c9:ea:1b,69667272,408,67373,69666864,69667272
7638,6,6,1,2412,-62,-93,31,e6:aa:ea:b7:4a:dd,69671007,408,3327,69670599,69671007
7639,6,12,1,2412,-60,-93,33,40:e3:d6:da:ba:20,69691536,160,20369,69691376,69691536
7640,6,6,1,2412,-60,-93,33,40:e3:d6:da:ba:21,69691755,368,-149,69691387,69691755
7641,6,12,1,2412,-60,-93,33,40:e3:d6:da:ba:23,69692401,184,462,69692217,69692401
7642,6,12,1,2412,-60,-93,33,40:e3:d6:da:ba:24,69692976,176,399,69692800,69692976
7643,6,12,1,2412,-60,-93,33,40:e3:d6:da:ba:25,69693187,160,51,69693027,69693187
7644,6,6,1,2412,-59,-93,34,e6:aa:ea:b7:4a:dd,69707374,408,13779,69706966,69707374
7645,6,6,1,2412,-82,-93,11,e6:aa:ea:c9:ea:1b,69715702,408,7920,69715294,69715702
7646,6,12,1,2412,-58,-93,35,40:e3:d6:da:ba:20,69793852,160,77990,69793692,69793852
7647,6,12,1,2412,-58,-93,35,40:e3:d6:da:ba:22,69794892,180,860,69794712,69794892
7648,6,12,1,2412,-58,-93,35,40:e3:d6:da:ba:23,69797096,184,2020,69796912,69797096
7649,6,12,1,2412,-63,-93,30,40:e3:d6:da:ba:24,69797333,176,61,69797157,69797333
7650,6,6,1,2412,-60,-93,33,e6:aa:ea:c9:ea:33,69857655,408,59914,69857247,69857655
7651,6,6,1,2412,-61,-93,32,e6:aa:ea:c9:ea:33,69883923,408,25860,69883515,69883923
7652,6,6,1,2412,-60,-93,33,e6:aa:ea:c9:ea:33,69894143,408,9812,69893735,69894143
7653,6,12,1,2412,-61,-93,32,40:e3:d6:da:ba:22,69896842,180,2519,69896662,69896842
7654,6,12,1,2412,-57,-93,36,40:e3:d6:da:ba:23,69897081,184,55,69896897,69897081
7655,6,6,1,2412,-60,-93,33,e6:aa:ea:c9:ea:33,69906112,408,8623,69905704,69906112
7656,6,12,1,2412,-59,-93,34,40:e3:d6:da:ba:20,69999561,160,93289,69999401,69999561
7657,6,6,1,2412,-60,-93,33,40:e3:d6:da:ba:21,69999762,368,-167,69999394,69999762
7658,6,12,1,2412,-59,-93,34,40:e3:d6:da:ba:22,70000157,180,215,69999977,70000157
7659,6,12,1,2412,-59,-93,34,40:e3:d6:da:ba:23,70000363,184,22,70000179,70000363
7660,6,12,1,2412,-60,-93,33,40:e3:d6:da:ba:25,70000801,160,278,70000641,70000801
7661,6,6,1,2412,-59,-93,34,40:e3:d6:da:ba:26,70001011,380,-170,70000631,70001011
7662,4,1,1,2412,-77,-93,16,54:e4:3a:ec:fb:64,70009623,2160,6452,70007463,70009623
7663,6,6,1,2412,-81,-93,12,e6:aa:ea:c9:ea:1b,70086138,408,76107,70085730,70086138
7664,6,6,1,2412,-63,-93,30,e6:aa:ea:b7:4a:dd,70088476,408,1930,70088068,70088476
7665,6,12,1,2412,-59,-93,34,40:e3:d6:da:ba:20,70102008,160,13372,70101848,70102008
7666,6,6,1,2412,-59,-93,34,40:e3:d6:da:ba:21,70102227,368,-149,70101859,70102227
7667,6,12,1,2412,-59,-93,34,40:e3:d6:da:ba:22,70102641,180,234,70102461,70102641
7668,6,12,1,2412,-59,-93,34,40:e3:d6:da:ba:24,70104007,176,1190,70103831,70104007
7669,6,12,1,2412,-58,-93,35,40:e3:d6:da:ba:25,70104209,160,42,70104049,70104209
7670,6,6,1,2412,-59,-93,34,40:e3:d6:da:ba:26,70104427,380,-162,70104047,70104427
7671,4,1,1,2412,-68,-93,25,54:e4:3a:ec:fb:64,70113310,2160,6723,70111150,70113310
7672,6,6,1,2412,-63,-93,30,e6:aa:ea:b7:4a:dd,70124840,408,11122,70124432,70124840
7673,6,12,1,2412,-61,-93,32,40:e3:d6:da:ba:20,70203395,160,78395,70203235,70203395
7674,6,6,1,2412,-61,-93,32,40:e3:d6:da:ba:21,70203614,368,-149,70203246,70203614
7675,6,12,1,2412,-61,-93,32,40:e3:d6:da:ba:22,70204001,180,207,70203821,70204001
7676,6,6,1,2412,-61,-93,32,40:e3:d6:da:ba:26,70204870,380,489,70204490,70204870
7677,4,1,1,2412,-73,-93,20,54:e4:3a:ec:fb:64,70213886,2160,6856,70211726,70213886
7678,4,1,1,2412,-91,-93,2,b8:3a:5a:88:e6:e0,70217654,2360,1408,70215294,70217654
7679,6,6,1,2412,-58,-93,35,e6:aa:ea:c9:ea:33,70275641,408,57579,70275233,70275641
7680,6,6,1,2412,-59,-93,34,e6:aa:ea:c9:ea:33,70287760,408,11711,70287352,70287760
7681,6,6,1,2412,-60,-93,33,e6:aa:ea:c9:ea:33,70300056,408,11888,70299648,70300056
7682,6,12,1,2412,-63,-93,30,40:e3:d6:da:ba:20,70305811,160,5595,70305651,70305811
7683,6,6,1,2412,-63,-93,30,40:e3:d6:da:ba:21,70306004,368,-175,70305636,70306004
7684,6,12,1,2412,-63,-93,30,40:e3:d6:da:ba:22,70306417,180,233,70306237,70306417
7685,6,12,1,2412,-63,-93,30,40:e3:d6:da:ba:23,70306623,184,22,70306439,70306623
7686,6,12,1,2412,-63,-93,30,40:e3:d6:da:ba:24,70306841,176,42,70306665,70306841
7687,6,12,1,2412,-63,-93,30,40:e3:d6:da:ba:25,70307052,160,51,70306892,70307052
7688,6,6,1,2412,-58,-93,35,e6:aa:ea:c9:ea:33,70312160,408,4700,70311752,70312160
7689,4,1,1,2412,-69,-93,24,54:e4:3a:ec:fb:64,70316286,2160,1966,70314126,70316286
7690,6,6,1,2412,-60,-93,33,e6:aa:ea:c9:ea:33,70325807,408,9113,70325399,70325807
7691,6,6,1,2412,-63,-93,30,e6:aa:ea:b7:4a:dd,70405627,408,79412,70405219,70405627
7692,6,6,1,2412,-60,-93,33,40:e3:d6:da:ba:21,70408496,368,2501,70408128,70408496
7693,6,12,1,2412,-60,-93,33,40:e3:d6:da:ba:23,70409115,184,435,70408931,70409115
7694,6,12,1,2412,-60,-93,33,40:e3:d6:da:ba:24,70409351,176,60,70409175,70409351
7695,4,1,1,2412,-68,-93,25,54:e4:3a:ec:fb:64,70418684,2160,7173,70416524,70418684
7696,6,6,1,2412,-63,-93,30,e6:aa:ea:b7:4a:dd,70454275,408,35183,70453867,70454275
7697,6,12,1,2412,-59,-93,34,40:e3:d6:da:ba:20,70510609,160,56174,70510449,70510609
7698,6,6,1,2412,-59,-93,34,40:e3:d6:da:ba:21,70510810,368,-167,70510442,70510810
7699,6,12,1,2412,-58,-93,35,40:e3:d6:da:ba:22,70511224,180,234,70511044,70511224
7700,6,12,1,2412,-58,-93,35,40:e3:d6:da:ba:23,70511439,184,31,70511255,70511439
7701,6,12,1,2412,-58,-93,35,40:e3:d6:da:ba:24,70511657,176,42,70511481,70511657
7702,6,12,1,2412,-58,-93,35,40:e3:d6:da:ba:25,70511868,160,51,70511708,70511868
7703,6,6,1,2412,-58,-93,35,40:e3:d6:da:ba:26,70512069,380,-179,70511689,70512069
7704,6,6,1,2412,-55,-93,38,e6:aa:ea:c9:ea:33,70590468,408,77991,70590060,70590468
7705,6,12,1,2412,-58,-93,35,40:e3:d6:da:ba:20,70613212,160,22584,70613052,70613212
7706,6,6,1,2412,-59,-93,34,40:e3:d6:da:ba:21,70613449,368,-131,70613081,70613449
7707,6,12,1,2412,-58,-93,35,40:e3:d6:da:ba:22,70613845,180,216,70613665,70613845
7708,6,12,1,2412,-58,-93,35,40:e3:d6:da:ba:23,70614060,184,31,70613876,70614060
7709,6,12,1,2412,-59,-93,34,40:e3:d6:da:ba:25,70614516,160,296,70614356,70614516
7710,6,6,1,2412,-59,-93,34,40:e3:d6:da:ba:26,70614735,380,-161,70614355,70614735
7711,6,6,1,2412,-56,-93,37,e6:aa:ea:c9:ea:33,70615158,408,15,70614750,70615158
7712,6,6,1,2412,-56,-93,37,e6:aa:ea:c9:ea:33,70626983,408,11417,70626575,70626983
7713,6,12,1,2412,-62,-93,31,40:e3:d6:da:ba:20,70715402,160,88259,70715242,70715402
7714,6,6,1,2412,-62,-93,31,40:e3:d6:da:ba:21,70715594,368,-176,70715226,70715594
7715,6,12,1,2412,-62,-93,31,40:e3:d6:da:ba:22,70715999,180,225,70715819,70715999
7716,6,12,1,2412,-61,-93,32,40:e3:d6:da:ba:24,70716469,176,294,70716293,70716469
7717,6,12,1,2412,-61,-93,32,40:e3:d6:da:ba:25,70716697,160,68,70716537,70716697
7718,6,6,1,2412,-61,-93,32,40:e3:d6:da:ba:26,70716916,380,-161,70716536,70716916
7719,6,12,1,2412,-63,-93,30,40:e3:d6:da:ba:20,70817965,160,100889,70817805,70817965
7720,6,6,1,2412,-62,-93,31,40:e3:d6:da:ba:21,70818157,368,-176,70817789,70818157
7721,6,12,1,2412,-62,-93,31,40:e3:d6:da:ba:22,70818614,180,277,70818434,70818614
7722,6,12,1,2412,-62,-93,31,40:e3:d6:da:ba:23,70818909,184,111,70818725,70818909
7723,6,12,1,2412,-63,-93,30,40:e3:d6:da:ba:24,70819145,176,60,70818969,70819145
7724,6,12,1,2412,-62,-93,31,40:e3:d6:da:ba:25,70819374,160,69,70819214,70819374
7725,6,6,1,2412,-62,-93,31,40:e3:d6:da:ba:26,70819593,380,-161,70819213,70819593
7726,6,12,1,2412,-63,-93,30,40:e3:d6:da:ba:20,70920214,160,100461,70920054,70920214
7727,6,6,1,2412,-63,-93,30,40:e3:d6:da:ba:21,70922955,368,2373,70922587,70922955
7728,6,12,1,2412,-63,-93,30,40:e3:d6:da:ba:22,70923413,180,278,70923233,70923413
7729,6,12,1,2412,-63,-93,30,40:e3:d6:da:ba:23,70923618,184,21,70923434,70923618
7730,6,12,1,2412,-63,-93,30,40:e3:d6:da:ba:24,70923828,176,34,70923652,70923828
7731,6,12,1,2412,-63,-93,30,40:e3:d6:da:ba:25,70924029,160,41,70923869,70924029
7732,6,6,1,2412,-62,-93,31,40:e3:d6:da:ba:26,70924221,380,-188,70923841,70924221
7733,4,1,1,2412,-73,-93,20,54:e4:3a:ec:fb:64,70930681,2160,4300,70928521,70930681
7734,6,6,1,2412,-66,-93,27,e6:aa:ea:b7:4a:dd,70950232,408,19143,70949824,70950232
7735,6,6,1,2412,-67,-93,26,e6:aa:ea:b7:4a:dd,70974466,408,23826,70974058,70974466
7736,6,6,1,2412,-59,-93,34,e6:aa:ea:c9:ea:33,71007598,408,32724,71007190,71007598
7737,6,6,1,2412,-59,-93,34,e6:aa:ea:c9:ea:33,71019714,408,11708,71019306,71019714
7738,6,6,1,2412,-63,-93,30,40:e3:d6:da:ba:21,71022792,368,2710,71022424,71022792
7739,6,12,1,2412,-63,-93,30,40:e3:d6:da:ba:22,71023197,180,225,71023017,71023197
7740,6,12,1,2412,-63,-93,30,40:e3:d6:da:ba:23,71023412,184,31,71023228,71023412
7741,6,12,1,2412,-60,-93,33,40:e3:d6:da:ba:24,71023639,176,51,71023463,71023639
7742,6,12,1,2412,-62,-93,31,40:e3:d6:da:ba:25,71023850,160,51,71023690,71023850
7743,6,6,1,2412,-58,-93,35,e6:aa:ea:c9:ea:33,71031835,408,7577,71031427,71031835
7744,4,1,1,2412,-72,-93,21,54:e4:3a:ec:fb:64,71033080,2160,-915,71030920,71033080
7745,6,6,1,2412,-58,-93,35,e6:aa:ea:c9:ea:33,71056066,408,22578,71055658,71056066
7746,6,12,1,2412,-63,-93,30,40:e3:d6:da:ba:22,71125589,180,69343,71125409,71125589
7747,6,12,1,2412,-63,-93,30,40:e3:d6:da:ba:23,71125794,184,21,71125610,71125794
7748,6,12,1,2412,-62,-93,31,40:e3:d6:da:ba:24,71126022,176,52,71125846,71126022
7749,6,12,1,2412,-63,-93,30,40:e3:d6:da:ba:25,71126232,160,50,71126072,71126232
7750,6,6,1,2412,-62,-93,31,40:e3:d6:da:ba:26,71126424,380,-188,71126044,71126424
7751,4,1,1,2412,-68,-93,25,54:e4:3a:ec:fb:64,71135478,2160,6894,71133318,71135478
7752,6,6,1,2412,-88,-93,5,84:d4:7e:f2:42:26,71144272,380,8414,71143892,71144272
7753,6,12,1,2412,-62,-93,31,40:e3:d6:da:ba:20,71227392,160,82960,71227232,71227392
7754,6,6,1,2412,-62,-93,31,40:e3:d6:da:ba:21,71227584,368,-176,71227216,71227584
7755,6,12,1,2412,-60,-93,33,40:e3:d6:da:ba:22,71228148,180,384,71227968,71228148
7756,6,12,1,2412,-60,-93,33,40:e3:d6:da:ba:23,71228372,184,40,71228188,71228372
7757,6,12,1,2412,-61,-93,32,40:e3:d6:da:ba:24,71229523,176,975,71229347,71229523
7758,6,12,1,2412,-61,-93,32,40:e3:d6:da:ba:25,71229751,160,68,71229591,71229751
7759,6,6,1,2412,-63,-93,30,40:e3:d6:da:ba:26,71229943,380,-188,71229563,71229943
7760,6,6,1,2412,-88,-93,5,84:d4:7e:f2:42:26,71246662,380,16339,71246282,71246662
7761,6,12,1,2412,-60,-93,33,40:e3:d6:da:ba:22,71276463,156,29645,71276307,71276463
7762,6,12,1,2412,-60,-93,33,40:e3:d6:da:ba:25,71277027,136,428,71276891,71277027
7763,6,12,1,2412,-60,-93,33,40:e3:d6:da:ba:20,71329792,160,52605,71329632,71329792
7764,6,6,1,2412,-61,-93,32,40:e3:d6:da:ba:21,71329993,368,-167,71329625,71329993
7765,6,12,1,2412,-60,-93,33,40:e3:d6:da:ba:22,71332748,180,2575,71332568,71332748
7766,6,12,1,2412,-59,-93,34,40:e3:d6:da:ba:23,71332953,184,21,71332769,71332953
7767,6,12,1,2412,-59,-93,34,40:e3:d6:da:ba:24,71333172,176,43,71332996,71333172
7768,6,6,1,2412,-82,-93,11,e6:aa:ea:c9:ea:1b,71343913,408,10333,71343505,71343913
7769,6,6,1,2412,-68,-93,25,e6:aa:ea:c9:ea:1b,71356010,408,11689,71355602,71356010
7770,6,6,1,2412,-79,-93,14,e6:aa:ea:c9:ea:1b,71392357,408,35939,71391949,71392357
7771,6,12,1,2412,-60,-93,33,40:e3:d6:da:ba:20,71432363,160,39846,71432203,71432363
7772,6,6,1,2412,-61,-93,32,40:e3:d6:da:ba:21,71432573,368,-158,71432205,71432573
7773,6,12,1,2412,-60,-93,33,40:e3:d6:da:ba:22,71432978,180,225,71432798,71432978
7774,6,12,1,2412,-60,-93,33,40:e3:d6:da:ba:23,71433202,184,40,71433018,71433202
7775,6,12,1,2412,-60,-93,33,40:e3:d6:da:ba:24,71433438,176,60,71433262,71433438
7776,6,12,1,2412,-61,-93,32,40:e3:d6:da:ba:25,71433667,160,69,71433507,71433667
7777,6,6,1,2412,-61,-93,32,40:e3:d6:da:ba:26,71433885,380,-162,71433505,71433885
7778,4,1,1,2412,-68,-93,25,54:e4:3a:ec:fb:64,71442675,2160,6630,71440515,71442675
7779,6,6,1,2412,-63,-93,30,e6:aa:ea:b7:4a:dd,71445595,408,2512,71445187,71445595
7780,6,6,1,2412,-63,-93,30,e6:aa:ea:b7:4a:dd,71481947,408,35944,71481539,71481947
7781,6,6,1,2412,-58,-93,35,e6:aa:ea:c9:ea:33,71527223,408,44868,71526815,71527223
7782,6,12,1,2412,-60,-93,33,40:e3:d6:da:ba:20,71534614,160,7231,71534454,71534614
7783,6,6,1,2412,-60,-93,33,40:e3:d6:da:ba:21,71534824,368,-158,71534456,71534824
7784,6,12,1,2412,-61,-93,32,40:e3:d6:da:ba:23,71535443,184,435,71535259,71535443
7785,6,12,1,2412,-60,-93,33,40:e3:d6:da:ba:24,71535680,176,61,71535504,71535680
7786,6,12,1,2412,-60,-93,33,40:e3:d6:da:ba:25,71535899,160,59,71535739,71535899
7787,6,6,1,2412,-60,-93,33,40:e3:d6:da:ba:26,71536118,380,-161,71535738,71536118
7788,6,6,1,2412,-57,-93,36,e6:aa:ea:c9:ea:33,71551469,408,14943,71551061,71551469
7789,6,6,1,2412,-58,-93,35,e6:aa:ea:c9:ea:33,71577458,408,25581,71577050,71577458
7790,4,1,1,2412,-69,-93,24,da:d4:22:2e:9b:67,71610974,992,32524,71609982,71610974
7791,4,1,1,2412,-77,-93,16,54:e4:3a:ec:fb:64,71612103,2112,-983,71609991,71612103
7792,4,1,1,2412,-69,-93,24,,71614230,304,1823,71613926,71614230
7793,6,12,1,2412,-72,-93,21,,71614549,32,287,71614517,71614549
7794,6,6,1,2412,-72,-93,21,,71614965,44,372,71614921,71614965
7795,6,12,1,2412,-72,-93,21,,71615229,32,232,71615197,71615229
7796,6,12,1,2412,-72,-93,21,,71615590,32,329,71615558,71615590
7797,6,12,1,2412,-70,-93,23,,71634467,32,18845,71634435,71634467
7798,4,1,1,2412,-59,-93,34,54:e4:3a:ec:fb:64,71635663,2112,-916,71633551,71635663
7799,4,1,1,2412,-70,-93,23,,71637791,304,1824,71637487,71637791
7800,6,12,1,2412,-61,-93,32,40:e3:d6:da:ba:20,71637946,160,-5,71637786,71637946
7801,6,6,1,2412,-61,-93,32,40:e3:d6:da:ba:21,71638138,368,-176,71637770,71638138
7802,6,12,1,2412,-60,-93,33,40:e3:d6:da:ba:22,71638525,180,207,71638345,71638525
7803,6,12,1,2412,-60,-93,33,40:e3:d6:da:ba:23,71638739,184,30,71638555,71638739
7804,6,12,1,2412,-61,-93,32,40:e3:d6:da:ba:24,71638967,176,52,71638791,71638967
7805,6,12,1,2412,-60,-93,33,40:e3:d6:da:ba:25,71639195,160,68,71639035,71639195
7806,6,6,1,2412,-60,-93,33,40:e3:d6:da:ba:26,71639387,380,-188,71639007,71639387
7807,4,1,1,2412,-72,-93,21,54:e4:3a:ec:fb:64,71647475,2160,5928,71645315,71647475
7808,6,12,1,2412,-60,-93,33,40:e3:d6:da:ba:25,71740765,160,93130,71740605,71740765
7809,6,6,1,2412,-60,-93,33,40:e3:d6:da:ba:26,71741109,380,-36,71740729,71741109
7810,6,6,1,2412,-81,-93,12,e6:aa:ea:c9:ea:1b,71763515,408,21998,71763107,71763515
7811,6,6,1,2412,-82,-93,11,e6:aa:ea:c9:ea:1b,71811993,408,48070,71811585,71811993
7812,6,12,1,2412,-61,-93,32,40:e3:d6:da:ba:20,71841805,160,29652,71841645,71841805
7813,6,12,1,2412,-60,-93,33,40:e3:d6:da:ba:22,71843250,180,1265,71843070,71843250
7814,6,12,1,2412,-60,-93,33,40:e3:d6:da:ba:23,71843455,184,21,71843271,71843455
7815,6,6,1,2412,-61,-93,32,40:e3:d6:da:ba:26,71844093,380,258,71843713,71844093
7816,6,6,1,2412,-65,-93,28,e6:aa:ea:c9:ea:33,71854869,408,10368,71854461,71854869
7817,6,6,1,2412,-57,-93,36,e6:aa:ea:c9:ea:33,71867157,408,11880,71866749,71867157
7818,6,6,1,2412,-55,-93,38,e6:aa:ea:c9:ea:33,71879088,408,11523,71878680,71879088
7819,6,6,1,2412,-57,-93,36,e6:aa:ea:c9:ea:33,71891419,408,11923,71891011,71891419
7820,6,12,1,2412,-61,-93,32,40:e3:d6:da:ba:20,71944476,160,52897,71944316,71944476
7821,6,12,1,2412,-60,-93,33,40:e3:d6:da:ba:22,71945100,180,444,71944920,71945100
7822,6,12,1,2412,-58,-93,35,40:e3:d6:da:ba:23,71945314,184,30,71945130,71945314
7823,6,12,1,2412,-59,-93,34,40:e3:d6:da:ba:24,71945566,176,76,71945390,71945566
7824,6,12,1,2412,-60,-93,33,40:e3:d6:da:ba:25,71945768,160,42,71945608,71945768
7825,6,6,1,2412,-62,-93,31,e6:aa:ea:b7:4a:dd,71977964,408,31788,71977556,71977964
7826,6,6,1,2412,-62,-93,31,e6:aa:ea:b7:4a:dd,72002198,408,23826,72001790,72002198
7827,6,6,1,2412,-62,-93,31,e6:aa:ea:b7:4a:dd,72014316,408,11710,72013908,72014316
7828,6,12,1,2412,-59,-93,34,40:e3:d6:da:ba:20,72046596,160,32120,72046436,72046596
7829,6,6,1,2412,-59,-93,34,40:e3:d6:da:ba:21,72046788,368,-176,72046420,72046788
7830,6,12,1,2412,-59,-93,34,40:e3:d6:da:ba:22,72047175,180,207,72046995,72047175
7831,6,12,1,2412,-59,-93,34,40:e3:d6:da:ba:23,72047380,184,21,72047196,72047380
7832,6,12,1,2412,-59,-93,34,40:e3:d6:da:ba:24,72047608,176,52,72047432,72047608
7833,6,12,1,2412,-60,-93,33,40:e3:d6:da:ba:25,72047818,160,50,72047658,72047818
7834,6,6,1,2412,-60,-93,33,40:e3:d6:da:ba:26,72048028,380,-170,72047648,72048028
7835,4,1,1,2412,-72,-93,21,54:e4:3a:ec:fb:64,72057071,2160,6883,72054911,72057071
7836,6,12,1,2412,-60,-93,33,40:e3:d6:da:ba:20,72149010,160,91779,72148850,72149010
7837,6,6,1,2412,-60,-93,33,40:e3:d6:da:ba:21,72149202,368,-176,72148834,72149202
7838,6,12,1,2412,-60,-93,33,40:e3:d6:da:ba:22,72149727,180,345,72149547,72149727
7839,6,12,1,2412,-60,-93,33,40:e3:d6:da:ba:23,72149933,184,22,72149749,72149933
7840,6,12,1,2412,-60,-93,33,40:e3:d6:da:ba:25,72150370,160,277,72150210,72150370
7841,6,6,1,2412,-60,-93,33,40:e3:d6:da:ba:26,72150580,380,-170,72150200,72150580
7842,6,6,1,2412,-56,-93,37,e6:aa:ea:c9:ea:33,72171827,408,20839,72171419,72171827
7843,6,6,1,2412,-57,-93,36,e6:aa:ea:c9:ea:33,72181704,408,9469,72181296,72181704
7844,6,6,1,2412,-57,-93,36,e6:aa:ea:c9:ea:33,72193820,408,11708,72193412,72193820
7845,6,6,1,2412,-57,-93,36,e6:aa:ea:c9:ea:33,72205937,408,11709,72205529,72205937
7846,6,12,1,2412,-60,-93,33,40:e3:d6:da:ba:20,72251414,160,45317,72251254,72251414
7847,6,6,1,2412,-59,-93,34,40:e3:d6:da:ba:21,72251606,368,-176,72251238,72251606
7848,6,12,1,2412,-60,-93,33,40:e3:d6:da:ba:22,72252020,180,234,72251840,72252020
7849,6,12,1,2412,-59,-93,34,40:e3:d6:da:ba:23,72252253,184,49,72252069,72252253
7850,6,12,1,2412,-60,-93,33,40:e3:d6:da:ba:24,72252471,176,42,72252295,72252471
7851,6,12,1,2412,-60,-93,33,40:e3:d6:da:ba:25,72252682,160,51,72252522,72252682
7852,6,6,1,2412,-60,-93,33,40:e3:d6:da:ba:26,72252883,380,-179,72252503,72252883
7853,4,1,1,2412,-72,-93,21,54:e4:3a:ec:fb:64,72263756,2160,8713,72261596,72263756
7854,6,6,1,2412,-82,-93,11,e6:aa:ea:c9:ea:1b,72298720,408,34556,72298312,72298720
7855,6,6,1,2412,-81,-93,12,e6:aa:ea:c9:ea:1b,72322958,408,23830,72322550,72322958
7856,6,12,1,2412,-62,-93,31,40:e3:d6:da:ba:20,72353810,160,30692,72353650,72353810
7857,6,6,1,2412,-62,-93,31,40:e3:d6:da:ba:21,72354029,368,-149,72353661,72354029
7858,6,12,1,2412,-61,-93,32,40:e3:d6:da:ba:22,72354415,180,206,72354235,72354415
7859,6,12,1,2412,-62,-93,31,40:e3:d6:da:ba:23,72354639,184,40,72354455,72354639
7860,6,12,1,2412,-58,-93,35,40:e3:d6:da:ba:24,72354849,176,34,72354673,72354849
7861,6,6,1,2412,-63,-93,30,e6:aa:ea:b7:4a:dd,72395877,408,40620,72395469,72395877
7862,6,6,1,2412,-65,-93,28,e6:aa:ea:b7:4a:dd,72407990,408,11705,72407582,72407990
7863,6,6,1,2412,-66,-93,27,e6:aa:ea:b7:4a:dd,72432243,408,23845,72431835,72432243
7864,4,1,1,2412,-54,-93,39,be:08:08:51:0c:2a,72438154,1128,4783,72437026,72438154
7865,6,12,1,2412,-61,-93,32,40:e3:d6:da:ba:20,72439270,136,980,72439134,72439270
7866,6,12,1,2412,-56,-93,37,,72439422,32,120,72439390,72439422
7867,6,6,1,2412,-61,-93,32,40:e3:d6:da:ba:21,72439523,348,-247,72439175,72439523
7868,6,6,1,2412,-56,-93,37,,72439887,44,320,72439843,72439887
7869,6,12,1,2412,-61,-93,32,40:e3:d6:da:ba:22,72439960,156,-83,72439804,72439960
7870,6,12,1,2412,-56,-93,37,,72440132,32,140,72440100,72440132
7871,6,12,1,2412,-61,-93,32,40:e3:d6:da:ba:23,72440217,156,-71,72440061,72440217
7872,6,12,1,2412,-61,-93,32,40:e3:d6:da:ba:25,72442965,136,2612,72442829,72442965
7873,6,12,1,2412,-56,-93,37,,72443117,32,120,72443085,72443117
7874,6,12,1,2412,-62,-93,31,40:e3:d6:da:ba:20,72456209,160,12932,72456049,72456209
7875,6,6,1,2412,-61,-93,32,40:e3:d6:da:ba:21,72456419,368,-158,72456051,72456419
7876,6,12,1,2412,-62,-93,31,40:e3:d6:da:ba:23,72457246,184,643,72457062,72457246
7877,6,12,1,2412,-63,-93,30,40:e3:d6:da:ba:24,72457483,176,61,72457307,72457483
7878,6,12,1,2412,-59,-93,34,40:e3:d6:da:ba:25,72457717,160,74,72457557,72457717
7879,6,6,1,2412,-59,-93,34,40:e3:d6:da:ba:26,72457919,380,-178,72457539,72457919
7880,4,1,1,2412,-55,-93,38,be:08:08:51:0c:2a,72460028,1128,981,72458900,72460028
7881,4,1,1,2412,-71,-93,22,54:e4:3a:ec:fb:64,72461269,2112,-871,72459157,72461269
7882,4,1,1,2412,-54,-93,39,,72463394,304,1821,72463090,72463394
7883,6,12,1,2412,-61,-93,32,40:e3:d6:da:ba:20,72463568,136,38,72463432,72463568
7884,6,12,1,2412,-56,-93,37,,72463720,32,120,72463688,72463720
7885,6,6,1,2412,-62,-93,31,40:e3:d6:da:ba:21,72463802,348,-266,72463454,72463802
7886,6,12,1,2412,-62,-93,31,40:e3:d6:da:ba:22,72464490,156,532,72464334,72464490
7887,6,12,1,2412,-56,-93,37,,72464662,32,140,72464630,72464662
7888,6,12,1,2412,-61,-93,32,40:e3:d6:da:ba:23,72464857,156,39,72464701,72464857
7889,6,12,1,2412,-56,-93,37,,72465029,32,140,72464997,72465029
7890,6,12,1,2412,-61,-93,32,40:e3:d6:da:ba:25,72465124,136,-41,72464988,72465124
7891,6,12,1,2412,-56,-93,37,,72465276,32,120,72465244,72465276
7892,4,1,1,2412,-72,-93,21,54:e4:3a:ec:fb:64,72466667,2160,-769,72464507,72466667
7893,6,12,1,2412,-62,-93,31,40:e3:d6:da:ba:20,72558623,160,91796,72558463,72558623
7894,6,6,1,2412,-62,-93,31,40:e3:d6:da:ba:21,72558815,368,-176,72558447,72558815
7895,6,12,1,2412,-62,-93,31,40:e3:d6:da:ba:22,72559220,180,225,72559040,72559220
7896,6,12,1,2412,-62,-93,31,40:e3:d6:da:ba:23,72559426,184,22,72559242,72559426
7897,6,12,1,2412,-62,-93,31,40:e3:d6:da:ba:24,72559635,176,33,72559459,72559635
7898,6,12,1,2412,-62,-93,31,40:e3:d6:da:ba:25,72559837,160,42,72559677,72559837
7899,6,6,1,2412,-62,-93,31,40:e3:d6:da:ba:26,72560115,380,-102,72559735,72560115
7900,6,6,1,2412,-63,-93,30,e6:aa:ea:c9:ea:33,72574628,408,14105,72574220,72574628
7901,6,6,1,2412,-56,-93,37,e6:aa:ea:c9:ea:33,72586760,408,11724,72586352,72586760
7902,4,1,1,2412,-89,-93,4,b6:0e:02:3b:1e:f9,72615905,1152,27993,72614753,72615905
7903,6,12,1,2412,-62,-93,31,40:e3:d6:da:ba:20,72617031,136,990,72616895,72617031
7904,6,6,1,2412,-62,-93,31,40:e3:d6:da:ba:21,72617208,348,-171,72616860,72617208
7905,6,12,1,2412,-61,-93,32,40:e3:d6:da:ba:22,72617584,156,220,72617428,72617584
7906,6,12,1,2412,-61,-93,32,40:e3:d6:da:ba:23,72617982,156,242,72617826,72617982
7907,6,12,1,2412,-62,-93,31,40:e3:d6:da:ba:25,72618190,136,72,72618054,72618190
7908,4,1,1,2412,-88,-93,5,b6:0e:02:3b:1e:f9,72637124,1152,17782,72635972,72637124
7909,6,12,1,2412,-62,-93,31,40:e3:d6:da:ba:20,72638248,136,988,72638112,72638248
7910,6,6,1,2412,-62,-93,31,40:e3:d6:da:ba:21,72638443,348,-153,72638095,72638443
7911,6,12,1,2412,-62,-93,31,40:e3:d6:da:ba:22,72638828,156,229,72638672,72638828
7912,6,12,1,2412,-61,-93,32,40:e3:d6:da:ba:23,72639018,156,34,72638862,72639018
7913,6,12,1,2412,-61,-93,32,40:e3:d6:da:ba:25,72639209,136,55,72639073,72639209
7914,6,12,1,2412,-62,-93,31,40:e3:d6:da:ba:20,72661013,160,21644,72660853,72661013
7915,6,6,1,2412,-61,-93,32,40:e3:d6:da:ba:21,72661214,368,-167,72660846,72661214
7916,6,12,1,2412,-62,-93,31,40:e3:d6:da:ba:22,72661600,180,206,72661420,72661600
7917,6,12,1,2412,-61,-93,32,40:e3:d6:da:ba:23,72661815,184,31,72661631,72661815
7918,6,12,1,2412,-62,-93,31,40:e3:d6:da:ba:24,72662024,176,33,72661848,72662024
7919,6,12,1,2412,-62,-93,31,40:e3:d6:da:ba:25,72662226,160,42,72662066,72662226
7920,4,1,1,2412,-71,-93,22,54:e4:3a:ec:fb:64,72671466,2160,7080,72669306,72671466
7921,6,6,1,2412,-67,-93,26,e6:aa:ea:b7:4a:dd,72711027,408,39153,72710619,72711027
7922,6,6,1,2412,-64,-93,29,e6:aa:ea:b7:4a:dd,72723142,408,11707,72722734,72723142
7923,6,6,1,2412,-68,-93,25,e6:aa:ea:b7:4a:dd,72747372,408,23822,72746964,72747372
7924,6,12,1,2412,-61,-93,32,40:e3:d6:da:ba:20,72763419,160,15887,72763259,72763419
7925,6,6,1,2412,-62,-93,31,40:e3:d6:da:ba:21,72763647,368,-140,72763279,72763647
7926,6,12,1,2412,-61,-93,32,40:e3:d6:da:ba:22,72764060,180,233,72763880,72764060
7927,6,12,1,2412,-62,-93,31,40:e3:d6:da:ba:23,72764275,184,31,72764091,72764275
7928,6,12,1,2412,-61,-93,32,40:e3:d6:da:ba:24,72764502,176,51,72764326,72764502
7929,6,12,1,2412,-62,-93,31,40:e3:d6:da:ba:25,72764704,160,42,72764544,72764704
7930,6,6,1,2412,-61,-93,32,40:e3:d6:da:ba:26,72764905,380,-179,72764525,72764905
7931,6,6,1,2412,-83,-93,10,e6:aa:ea:c9:ea:1b,72846889,408,81576,72846481,72846889
7932,6,12,1,2412,-60,-93,33,40:e3:d6:da:ba:20,72865945,160,18896,72865785,72865945
7933,6,12,1,2412,-59,-93,34,40:e3:d6:da:ba:22,72866613,180,488,72866433,72866613
7934,6,12,1,2412,-61,-93,32,40:e3:d6:da:ba:24,72867169,176,380,72866993,72867169
7935,6,12,1,2412,-60,-93,33,40:e3:d6:da:ba:25,72867407,160,78,72867247,72867407
7936,6,6,1,2412,-59,-93,34,e6:aa:ea:c9:ea:33,72913092,408,45277,72912684,72913092
7937,6,6,1,2412,-59,-93,34,e6:aa:ea:c9:ea:33,72925210,408,11710,72924802,72925210
7938,6,12,1,2412,-62,-93,31,40:e3:d6:da:ba:20,72968201,160,42831,72968041,72968201
7939,6,6,1,2412,-61,-93,32,40:e3:d6:da:ba:21,72968402,368,-167,72968034,72968402
7940,6,12,1,2412,-62,-93,31,40:e3:d6:da:ba:22,72970855,180,2273,72970675,72970855
7941,6,12,1,2412,-61,-93,32,40:e3:d6:da:ba:23,72971087,184,48,72970903,72971087
7942,6,12,1,2412,-61,-93,32,40:e3:d6:da:ba:24,72971324,176,61,72971148,72971324
7943,6,12,1,2412,-61,-93,32,40:e3:d6:da:ba:25,72971552,160,68,72971392,72971552
7944,6,6,1,2412,-61,-93,32,40:e3:d6:da:ba:26,72971806,380,-126,72971426,72971806
7945,4,1,1,2412,-71,-93,22,54:e4:3a:ec:fb:64,72978664,2160,4698,72976504,72978664
7946,6,12,1,2412,-62,-93,31,40:e3:d6:da:ba:20,73071696,160,92872,73071536,73071696
7947,6,12,1,2412,-61,-93,32,40:e3:d6:da:ba:22,73072377,180,501,73072197,73072377
7948,6,12,1,2412,-62,-93,31,40:e3:d6:da:ba:23,73072583,184,22,73072399,73072583
7949,6,12,1,2412,-62,-93,31,40:e3:d6:da:ba:24,73072810,176,51,73072634,73072810
7950,6,12,1,2412,-62,-93,31,40:e3:d6:da:ba:25,73073030,160,60,73072870,73073030
7951,6,6,1,2412,-61,-93,32,40:e3:d6:da:ba:26,73073222,380,-188,73072842,73073222
7952,4,1,1,2412,-71,-93,22,54:e4:3a:ec:fb:64,73081062,2160,5680,73078902,73081062
7953,6,6,1,2412,-67,-93,26,e6:aa:ea:b7:4a:dd,73116613,408,35143,73116205,73116613
7954,6,6,1,2412,-67,-93,26,e6:aa:ea:b7:4a:dd,73140842,408,23821,73140434,73140842
7955,6,6,1,2412,-85,-93,8,e6:aa:ea:c9:ea:1b,73149763,408,8513,73149355,73149763
7956,6,6,1,2412,-66,-93,27,e6:aa:ea:b7:4a:dd,73152962,408,2791,73152554,73152962
7957,6,12,1,2412,-62,-93,31,40:e3:d6:da:ba:20,73173267,160,20145,73173107,73173267
7958,6,12,1,2412,-62,-93,31,40:e3:d6:da:ba:22,73173873,180,426,73173693,73173873
7959,6,12,1,2412,-62,-93,31,40:e3:d6:da:ba:23,73174079,184,22,73173895,73174079
7960,6,12,1,2412,-62,-93,31,40:e3:d6:da:ba:24,73174297,176,42,73174121,73174297
7961,6,12,1,2412,-62,-93,31,40:e3:d6:da:ba:25,73174517,160,60,73174357,73174517
7962,6,6,1,2412,-62,-93,31,40:e3:d6:da:ba:26,73174709,380,-188,73174329,73174709
7963,4,1,1,2412,-71,-93,22,54:e4:3a:ec:fb:64,73183764,2160,6895,73181604,73183764
7964,6,6,1,2412,-58,-93,35,e6:aa:ea:c9:ea:33,73203342,408,19170,73202934,73203342
7965,6,6,1,2412,-61,-93,32,e6:aa:ea:c9:ea:33,73227489,408,23739,73227081,73227489
7966,6,6,1,2412,-58,-93,35,e6:aa:ea:c9:ea:33,73239607,408,11710,73239199,73239607
7967,6,12,1,2412,-62,-93,31,40:e3:d6:da:ba:20,73275783,160,36016,73275623,73275783
7968,6,6,1,2412,-62,-93,31,40:e3:d6:da:ba:21,73275975,368,-176,73275607,73275975
7969,6,12,1,2412,-62,-93,31,40:e3:d6:da:ba:25,73277015,160,880,73276855,73277015
7970,6,6,1,2412,-62,-93,31,40:e3:d6:da:ba:26,73277225,380,-170,73276845,73277225
7971,6,12,1,2412,-62,-93,31,40:e3:d6:da:ba:20,73377807,160,100422,73377647,73377807
7972,6,6,1,2412,-62,-93,31,40:e3:d6:da:ba:21,73378017,368,-158,73377649,73378017
7973,6,12,1,2412,-62,-93,31,40:e3:d6:da:ba:22,73378404,180,207,73378224,73378404
7974,6,12,1,2412,-62,-93,31,40:e3:d6:da:ba:23,73378652,184,64,73378468,73378652
7975,6,12,1,2412,-62,-93,31,40:e3:d6:da:ba:24,73378879,176,51,73378703,73378879
7976,6,12,1,2412,-62,-93,31,40:e3:d6:da:ba:25,73379080,160,41,73378920,73379080
7977,6,6,1,2412,-62,-93,31,40:e3:d6:da:ba:26,73379290,380,-170,73378910,73379290
7978,4,1,1,2412,-63,-93,30,54:e4:3a:ec:fb:64,73388259,2160,6809,73386099,73388259
7979,6,6,1,2412,-67,-93,26,e6:aa:ea:b7:4a:dd,73432163,408,43496,73431755,73432163
7980,6,6,1,2412,-67,-93,26,e6:aa:ea:b7:4a:dd,73444112,408,11541,73443704,73444112
7981,6,6,1,2412,-66,-93,27,e6:aa:ea:b7:4a:dd,73456155,408,11635,73455747,73456155
7982,6,6,1,2412,-67,-93,26,e6:aa:ea:b7:4a:dd,73468264,408,11701,73467856,73468264
7983,6,12,1,2412,-63,-93,30,40:e3:d6:da:ba:20,73480208,160,11784,73480048,73480208
7984,6,6,1,2412,-63,-93,30,40:e3:d6:da:ba:21,73480427,368,-149,73480059,73480427
7985,6,12,1,2412,-59,-93,34,40:e3:d6:da:ba:22,73480823,180,216,73480643,73480823
7986,6,12,1,2412,-62,-93,31,40:e3:d6:da:ba:23,73481261,184,254,73481077,73481261
7987,6,12,1,2412,-62,-93,31,40:e3:d6:da:ba:24,73481489,176,52,73481313,73481489
7988,6,12,1,2412,-62,-93,31,40:e3:d6:da:ba:25,73481717,160,68,73481557,73481717
7989,6,6,1,2412,-63,-93,30,40:e3:d6:da:ba:26,73481927,380,-170,73481547,73481927
