,phy,data_rate,channel,frequency,signal_dbm,noise_dbm,snr,tx_addr,timestamp,duration,ifs,start_tsf,end_tsf
0,4,1,1,2412,-77,-92,15,b0:e4:d5:32:ec:8a,67952,1960,,65992,67952
1,6,6,1,2412,-77,-92,15,e2:db:d1:d1:b0:4a,86866,444,18470,86422,86866
2,6,6,1,2412,-77,-92,15,e2:db:d1:d1:b0:4d,87775,408,501,87367,87775
3,6,6,1,2412,-78,-92,14,e2:db:d1:d1:b0:4f,88216,408,33,87808,88216
4,4,11,1,2412,-82,-92,10,,89107,107,784,89000,89107
5,4,1,1,2412,-85,-92,7,,89657,352,198,89305,89657
6,4,1,1,2412,-72,-92,20,3c:bd:c5:ee:96:6d,97820,2512,5651,95308,97820
7,4,1,1,2412,-87,-92,5,bc:98:df:ff:0f:8b,101444,2568,1056,98876,101444
8,4,11,1,2412,-81,-92,11,48:dd:0c:7d:86:27,110450,362,8644,110088,110450
9,4,11,1,2412,-81,-92,11,48:dd:0c:7d:86:23,110825,323,52,110502,110825
10,4,11,1,2412,-80,-92,12,48:dd:0c:7d:86:25,111160,382,-47,110778,111160
11,6,6,1,2412,-76,-92,16,76:a2:c1:67:70:44,127225,308,15757,126917,127225
12,6,6,1,2412,-77,-92,15,76:a2:c1:67:70:44,127565,308,32,127257,127565
13,6,6,1,2412,-78,-92,14,e0:db:d1:d0:b0:48,128012,308,139,127704,128012
14,6,6,1,2412,-77,-92,15,b2:e2:49:f6:8a:4e,128461,308,141,128153,128461
15,4,1,1,2412,-84,-92,8,,130575,304,1810,130271,130575
16,4,1,1,2412,-86,-92,6,78:67:0e:38:6c:d3,137236,2736,3925,134500,137236
17,4,1,1,2412,-87,-92,5,78:67:0e:38:6c:d2,140028,832,1960,139196,140028
18,4,11,1,2412,-86,-92,6,4c:01:43:ec:a0:69,141109,361,720,140748,141109
19,4,11,1,2412,-77,-92,15,48:dd:0c:90:e3:83,146713,323,5281,146390,146713
20,4,11,1,2412,-83,-92,9,48:dd:0c:90:e3:85,147048,382,-47,146666,147048
21,4,1,1,2412,-89,-92,3,78:67:0e:c4:a8:42,148618,2736,-1166,145882,148618
22,6,6,1,2412,-77,-92,15,f8:4f:ad:f9:af:82,151506,156,2732,151350,151506
23,6,6,1,2412,-77,-92,15,f8:4f:ad:f9:af:82,152581,632,443,151949,152581
24,6,6,1,2412,-77,-92,15,e0:db:d1:d0:b0:48,153988,156,1251,153832,153988
25,6,6,1,2412,-77,-92,15,f8:4f:ad:f9:af:82,163052,196,8868,162856,163052
26,6,6,1,2412,-78,-92,14,f8:4f:ad:f9:af:82,164329,156,1121,164173,164329
27,4,1,1,2412,-79,-92,13,b0:e4:d5:32:ec:8a,170352,1960,4063,168392,170352
28,4,1,1,2412,-84,-92,8,,174082,304,3426,173778,174082
29,6,6,1,2412,-77,-92,15,f8:4f:ad:f9:af:82,174997,248,667,174749,174997
30,6,6,1,2412,-77,-92,15,f8:4f:ad:f9:af:82,177154,224,1933,176930,177154
31,4,1,1,2412,-84,-92,8,b4:b5:2f:17:0c:b9,188012,1376,9482,186636,188012
32,6,6,1,2412,-77,-92,15,e2:db:d1:d1:b0:4b,189712,408,1292,189304,189712
33,6,6,1,2412,-77,-92,15,e2:db:d1:d1:b0:4d,190153,408,33,189745,190153
34,6,6,1,2412,-78,-92,14,e2:db:d1:d1:b0:4f,190612,408,51,190204,190612
35,4,1,1,2412,-81,-92,11,3c:bd:c5:ee:96:6d,200237,2512,7113,197725,200237
36,4,1,1,2412,-86,-92,6,bc:98:df:ff:0f:8b,203821,2568,1016,201253,203821
37,4,11,1,2412,-82,-92,10,48:dd:0c:7d:86:27,212826,362,8643,212464,212826
38,4,11,1,2412,-82,-92,10,48:dd:0c:7d:86:23,213201,323,52,212878,213201
39,4,11,1,2412,-82,-92,10,48:dd:0c:7d:86:25,213536,382,-47,213154,213536
40,4,1,1,2412,-87,-92,5,78:67:0e:38:6c:d3,214178,3472,-2830,210706,214178
41,4,1,1,2412,-87,-92,5,78:67:0e:38:6c:d3,217804,3472,154,214332,217804
42,4,1,1,2412,-84,-92,8,,227436,448,9184,226988,227436
43,6,6,1,2412,-77,-92,15,10:86:8c:5f:93:1e,234407,336,6635,234071,234407
44,4,1,1,2412,-87,-92,5,78:67:0e:38:6c:d3,239636,2736,2493,236900,239636
45,4,11,1,2412,-77,-92,15,48:dd:0c:90:e3:83,249113,323,9154,248790,249113
46,4,11,1,2412,-84,-92,8,48:dd:0c:90:e3:85,249448,382,-47,249066,249448
47,4,1,1,2412,-84,-92,8,78:67:0e:c4:a8:42,251018,2736,-1166,248282,251018
48,4,1,1,2412,-87,-92,5,,256752,304,5430,256448,256752
49,6,6,1,2412,-79,-92,13,12:86:8c:5f:93:1e,258201,332,1117,257869,258201
50,4,1,1,2412,-79,-92,13,b0:e4:d5:32:ec:8a,272751,1960,12590,270791,272751
51,4,1,1,2412,-87,-92,5,,276531,304,3476,276227,276531
52,4,11,1,2412,-82,-92,10,48:dd:0c:90:e3:8e,279620,277,2812,279343,279620
53,4,11,1,2412,-81,-92,11,48:dd:0c:90:e3:8e,280504,284,600,280220,280504
54,4,1,1,2412,-83,-92,9,b4:b5:2f:17:0c:b9,290437,1376,8557,289061,290437
55,6,6,1,2412,-77,-92,15,e2:db:d1:d1:b0:4a,291669,444,788,291225,291669
56,6,6,1,2412,-78,-92,14,e2:db:d1:d1:b0:4b,292137,408,60,291729,292137
57,6,6,1,2412,-78,-92,14,e2:db:d1:d1:b0:4d,292596,408,51,292188,292596
58,6,6,1,2412,-77,-92,15,e2:db:d1:d1:b0:4f,293036,408,32,292628,293036
59,4,1,1,2412,-81,-92,11,3c:bd:c5:ee:96:6d,303732,2512,8184,301220,303732
60,4,11,1,2412,-82,-92,10,48:dd:0c:7d:86:27,315226,362,11132,314864,315226
61,4,11,1,2412,-82,-92,10,48:dd:0c:7d:86:23,315600,323,51,315277,315600
62,4,11,1,2412,-81,-92,11,48:dd:0c:7d:86:25,315936,382,-46,315554,315936
63,4,1,1,2412,-86,-92,6,,319385,304,3145,319081,319385
64,4,1,1,2412,-87,-92,5,78:67:0e:38:6c:d3,342036,2736,19915,339300,342036
65,4,1,1,2412,-85,-92,7,,345767,448,3283,345319,345767
66,4,11,1,2412,-78,-92,14,48:dd:0c:90:e3:83,351513,323,5423,351190,351513
67,4,11,1,2412,-82,-92,10,48:dd:0c:90:e3:85,351848,382,-47,351466,351848
68,4,1,1,2412,-86,-92,6,78:67:0e:c4:a8:42,353418,2736,-1166,350682,353418
69,4,1,1,2412,-87,-92,5,,365152,352,11382,364800,365152
70,4,1,1,2412,-84,-92,8,,367756,352,2252,367404,367756
71,4,1,1,2412,-84,-92,8,,368900,304,840,368596,368900
72,4,1,1,2412,-87,-92,5,ac:67:84:84:8a:07,382296,416,12980,381880,382296
73,4,1,1,2412,-87,-92,5,ac:67:84:84:8a:07,383447,416,735,383031,383447
74,4,1,1,2412,-81,-92,11,b4:b5:2f:17:0c:b9,392815,1376,7992,391439,392815
75,6,6,1,2412,-76,-92,16,e2:db:d1:d1:b0:4b,394560,408,1337,394152,394560
76,6,6,1,2412,-77,-92,15,e2:db:d1:d1:b0:4d,395010,408,42,394602,395010
77,6,6,1,2412,-78,-92,14,e2:db:d1:d1:b0:4f,395442,408,24,395034,395442
78,4,1,1,2412,-81,-92,11,3c:bd:c5:ee:96:6d,406067,2512,8113,403555,406067
79,4,1,1,2412,-87,-92,5,bc:98:df:ff:0f:8b,408627,2568,-8,406059,408627
80,4,11,1,2412,-81,-92,11,48:dd:0c:7d:86:27,417626,362,8637,417264,417626
81,4,11,1,2412,-82,-92,10,48:dd:0c:7d:86:23,418000,323,51,417677,418000
82,4,11,1,2412,-82,-92,10,48:dd:0c:7d:86:25,418335,382,-47,417953,418335
83,4,1,1,2412,-87,-92,5,ac:67:84:84:8a:07,423715,416,4964,423299,423715
84,4,1,1,2412,-85,-92,7,,424401,304,382,424097,424401
85,4,1,1,2412,-85,-92,7,,425807,352,1054,425455,425807
86,4,1,1,2412,-84,-92,8,,428858,304,2747,428554,428858
87,4,1,1,2412,-85,-92,7,ac:67:84:84:8a:07,443496,416,14222,443080,443496
88,6,6,1,2412,-79,-92,13,b4:e6:2d:b4:ff:71,450666,64,7106,450602,450666
89,4,1,1,2412,-72,-92,20,b4:e6:2d:b4:ff:71,452290,416,1208,451874,452290
90,4,1,1,2412,-77,-92,15,b4:e6:2d:b4:ff:71,452831,416,125,452415,452831
91,4,1,1,2412,-78,-92,14,,453257,304,122,452953,453257
92,4,11,1,2412,-77,-92,15,48:dd:0c:90:e3:83,453986,323,406,453663,453986
93,4,11,1,2412,-82,-92,10,48:dd:0c:90:e3:85,454322,382,-46,453940,454322
94,4,1,1,2412,-86,-92,6,78:67:0e:c4:a8:42,455818,2736,-1240,453082,455818
95,4,1,1,2412,-84,-92,8,,462348,304,6226,462044,462348
96,4,1,1,2412,-88,-92,4,00:26:62:eb:ea:74,468860,968,5544,467892,468860
97,4,1,1,2412,-85,-92,7,,476841,304,7677,476537,476841
98,4,1,1,2412,-78,-92,14,b0:e4:d5:32:ec:8a,477550,1960,-1251,475590,477550
99,4,1,1,2412,-86,-92,6,ac:67:84:84:8a:07,480390,416,2424,479974,480390
100,6,6,1,2412,-77,-92,15,e2:db:d1:d1:b0:4b,496958,408,16160,496550,496958
101,6,6,1,2412,-78,-92,14,e2:db:d1:d1:b0:4d,497417,408,51,497009,497417
102,6,6,1,2412,-79,-92,13,e2:db:d1:d1:b0:4f,497849,408,24,497441,497849
103,4,1,1,2412,-86,-92,6,10:7b:44:eb:35:60,504800,1960,4991,502840,504800
104,4,1,1,2412,-80,-92,12,3c:bd:c5:ee:96:6d,508128,2512,816,505616,508128
105,4,1,1,2412,-81,-92,11,b8:f8:53:cb:31:f1,510720,976,1616,509744,510720
106,4,1,1,2412,-87,-92,5,,519802,304,8778,519498,519802
107,4,11,1,2412,-81,-92,11,48:dd:0c:7d:86:27,520025,362,-139,519663,520025
108,4,11,1,2412,-82,-92,10,48:dd:0c:7d:86:23,520400,323,52,520077,520400
109,4,11,1,2412,-82,-92,10,48:dd:0c:7d:86:25,520735,382,-47,520353,520735
110,4,1,1,2412,-88,-92,4,ac:67:84:84:8a:07,522554,416,1403,522138,522554
111,4,1,1,2412,-88,-92,4,,522982,304,124,522678,522982
112,4,5.5,1,2412,-85,-92,7,,531957,213,8762,531744,531957
113,4,1,1,2412,-88,-92,4,ac:67:84:84:8a:07,532220,416,-153,531804,532220
114,4,1,1,2412,-87,-92,5,,534593,448,1925,534145,534593
115,4,1,1,2412,-89,-92,3,,535090,384,113,534706,535090
116,4,1,1,2412,-87,-92,5,,535488,448,-50,535040,535488
117,4,1,1,2412,-87,-92,5,,542208,304,6416,541904,542208
118,4,11,1,2412,-84,-92,8,4c:01:43:ec:a0:63,551078,322,8548,550756,551078
119,4,11,1,2412,-81,-92,11,48:dd:0c:90:e3:85,556647,382,5187,556265,556647
120,4,1,1,2412,-83,-92,9,78:67:0e:c4:a8:42,558218,2736,-1165,555482,558218
121,4,11,1,2412,-85,-92,7,,562722,203,4301,562519,562722
122,4,11,1,2412,-85,-92,7,,563814,207,885,563607,563814
123,4,1,1,2412,-87,-92,5,ac:67:84:84:8a:07,574459,416,10229,574043,574459
124,4,1,1,2412,-92,-92,0,,574887,304,124,574583,574887
125,4,1,1,2412,-76,-92,16,b0:e4:d5:32:ec:8a,579949,1960,3102,577989,579949
126,4,11,1,2412,-80,-92,12,48:dd:0c:92:4b:ee,594270,284,14037,593986,594270
127,4,1,1,2412,-89,-92,3,ac:67:84:84:8a:07,595405,416,719,594989,595405
128,4,1,1,2412,-83,-92,9,b4:b5:2f:17:0c:b9,598047,1376,1266,596671,598047
129,6,6,1,2412,-77,-92,15,e2:db:d1:d1:b0:4a,599279,444,788,598835,599279
130,6,6,1,2412,-77,-92,15,e2:db:d1:d1:b0:4b,599765,408,78,599357,599765
131,6,6,1,2412,-78,-92,14,e2:db:d1:d1:b0:4d,600224,408,51,599816,600224
132,6,6,1,2412,-78,-92,14,e2:db:d1:d1:b0:4f,600655,408,23,600247,600655
133,4,1,1,2412,-79,-92,13,3c:bd:c5:ee:96:6d,609851,2512,6684,607339,609851
134,4,1,1,2412,-86,-92,6,bc:98:df:ff:0f:8b,615502,2568,3083,612934,615502
135,4,11,1,2412,-81,-92,11,48:dd:0c:7d:86:27,622425,362,6561,622063,622425
136,4,11,1,2412,-82,-92,10,48:dd:0c:7d:86:23,622800,323,52,622477,622800
137,4,1,1,2412,-84,-92,8,,626840,304,3736,626536,626840
138,4,1,1,2412,-80,-92,12,,637034,384,9810,636650,637034
139,4,11,1,2412,-82,-92,10,48:dd:0c:7d:86:23,648306,254,11018,648052,648306
140,6,6,1,2412,-77,-92,15,f8:4f:ad:f9:af:82,650704,548,1850,650156,650704
141,4,11,1,2412,-79,-92,13,48:dd:0c:90:e3:87,658337,362,7271,657975,658337
142,4,11,1,2412,-78,-92,14,48:dd:0c:90:e3:83,658712,323,52,658389,658712
143,4,1,1,2412,-85,-92,7,78:67:0e:c4:a8:42,660618,2736,-830,657882,660618
144,4,1,1,2412,-84,-92,8,,669945,304,9023,669641,669945
145,4,11,1,2412,-87,-92,5,4c:01:43:d7:f3:23,678275,254,8076,678021,678275
146,4,11,1,2412,-84,-92,8,4c:01:43:ec:a0:63,679016,254,487,678762,679016
147,4,1,1,2412,-76,-92,16,b0:e4:d5:32:ec:8a,682349,1960,1373,680389,682349
148,4,1,1,2412,-85,-92,7,,687099,304,4446,686795,687099
149,4,1,1,2412,-83,-92,9,b4:b5:2f:17:0c:b9,700023,1376,11548,698647,700023
150,6,6,1,2412,-78,-92,14,e2:db:d1:d1:b0:4b,701750,408,1319,701342,701750
151,6,6,1,2412,-76,-92,16,e2:db:d1:d1:b0:4d,702191,408,33,701783,702191
152,6,6,1,2412,-78,-92,14,e2:db:d1:d1:b0:4f,702623,408,24,702215,702623
153,4,11,1,2412,-84,-92,8,,705372,107,2642,705265,705372
154,4,1,1,2412,-86,-92,6,,706012,352,288,705660,706012
155,4,1,1,2412,-80,-92,12,3c:bd:c5:ee:96:6d,712930,2512,4406,710418,712930
156,4,1,1,2412,-86,-92,6,bc:98:df:ff:0f:8b,715827,2568,329,713259,715827
157,4,11,1,2412,-81,-92,11,48:dd:0c:7d:86:27,724825,362,8636,724463,724825
158,4,11,1,2412,-81,-92,11,48:dd:0c:7d:86:23,725200,323,52,724877,725200
159,4,11,1,2412,-82,-92,10,48:dd:0c:7d:86:25,725535,382,-47,725153,725535
160,4,1,1,2412,-86,-92,6,,728054,352,2167,727702,728054
161,4,1,1,2412,-89,-92,3,,739800,384,11362,739416,739800
162,4,1,1,2412,-87,-92,5,,740198,448,-50,739750,740198
163,4,1,1,2412,-87,-92,5,,740677,384,95,740293,740677
164,4,1,1,2412,-87,-92,5,,741075,448,-50,740627,741075
165,4,1,1,2412,-85,-92,7,,744362,304,2983,744058,744362
166,6,6,1,2412,-78,-92,14,10:86:8c:5f:93:1e,745943,336,1245,745607,745943
167,4,1,1,2412,-84,-92,8,,746797,304,550,746493,746797
168,4,1,1,2412,-87,-92,5,78:67:0e:38:6c:d3,751637,2736,2104,748901,751637
169,4,11,1,2412,-84,-92,8,4c:01:43:ec:a0:63,755876,322,3917,755554,755876
170,4,11,1,2412,-79,-92,13,48:dd:0c:90:e3:87,760737,362,4499,760375,760737
171,4,11,1,2412,-77,-92,15,48:dd:0c:90:e3:83,761112,323,52,760789,761112
172,4,11,1,2412,-83,-92,9,48:dd:0c:90:e3:85,761447,382,-47,761065,761447
173,4,1,1,2412,-86,-92,6,78:67:0e:c4:a8:42,763017,2736,-1166,760281,763017
174,4,1,1,2412,-89,-92,3,00:26:62:eb:ea:74,776186,968,12201,775218,776186
175,4,1,1,2412,-79,-92,13,b0:e4:d5:32:ec:8a,784748,1960,6602,782788,784748
176,4,1,1,2412,-84,-92,8,b4:b5:2f:17:0c:b9,802413,1376,16289,801037,802413
177,6,6,1,2412,-77,-92,15,e2:db:d1:d1:b0:4a,803646,444,789,803202,803646
178,6,6,1,2412,-78,-92,14,e2:db:d1:d1:b0:4b,804531,408,477,804123,804531
179,6,6,1,2412,-78,-92,14,e2:db:d1:d1:b0:4d,805338,408,399,804930,805338
180,6,6,1,2412,-78,-92,14,e2:db:d1:d1:b0:4f,805770,408,24,805362,805770
181,4,1,1,2412,-87,-92,5,ac:67:84:84:8a:07,824181,416,17995,823765,824181
182,4,1,1,2412,-90,-92,2,,824610,304,125,824306,824610
183,4,11,1,2412,-82,-92,10,48:dd:0c:7d:86:27,827225,362,2253,826863,827225
184,4,11,1,2412,-81,-92,11,48:dd:0c:7d:86:23,827599,323,51,827276,827599
185,4,11,1,2412,-80,-92,12,48:dd:0c:7d:86:25,827935,382,-46,827553,827935
186,4,1,1,2412,-86,-92,6,ac:67:84:84:8a:07,830975,416,2624,830559,830975
187,4,1,1,2412,-86,-92,6,,842958,448,11535,842510,842958
188,4,11,1,2412,-85,-92,7,4c:01:43:ec:a0:69,857901,361,14582,857540,857901
189,4,11,1,2412,-86,-92,6,4c:01:43:ec:a0:63,858275,322,52,857953,858275
190,4,11,1,2412,-85,-92,7,4c:01:43:ec:a0:66,858609,387,-53,858222,858609
191,4,11,1,2412,-75,-92,17,48:dd:0c:90:e3:87,863137,362,4166,862775,863137
192,4,11,1,2412,-77,-92,15,48:dd:0c:90:e3:83,863511,323,51,863188,863511
193,4,11,1,2412,-82,-92,10,48:dd:0c:90:e3:85,863846,382,-47,863464,863846
194,4,1,1,2412,-84,-92,8,78:67:0e:c4:a8:42,865417,2736,-1165,862681,865417
195,4,1,1,2412,-87,-92,5,ac:67:84:84:8a:07,873386,416,7553,872970,873386
196,4,1,1,2412,-89,-92,3,,873815,304,125,873511,873815
197,4,1,1,2412,-84,-92,8,78:67:0e:c4:a8:42,876346,848,1683,875498,876346
198,4,1,1,2412,-78,-92,14,b0:e4:d5:32:ec:8a,887147,1960,8841,885187,887147
199,4,1,1,2412,-86,-92,6,ac:67:84:84:8a:07,893961,416,6398,893545,893961
200,6,6,1,2412,-77,-92,15,f8:4f:ad:f9:af:82,902666,576,8129,902090,902666
201,4,1,1,2412,-80,-92,12,b4:b5:2f:17:0c:b9,904822,1376,780,903446,904822
202,6,6,1,2412,-78,-92,14,e2:db:d1:d1:b0:4b,906558,408,1328,906150,906558
203,6,6,1,2412,-77,-92,15,e2:db:d1:d1:b0:4d,906990,408,24,906582,906990
204,6,6,1,2412,-78,-92,14,e2:db:d1:d1:b0:4f,907421,408,23,907013,907421
205,4,1,1,2412,-83,-92,9,ac:67:84:84:8a:07,914175,416,6338,913759,914175
206,4,1,1,2412,-80,-92,12,3c:bd:c5:ee:96:6d,917041,2512,354,914529,917041
207,4,1,1,2412,-87,-92,5,bc:98:df:ff:0f:8b,920612,2568,1003,918044,920612
208,4,11,1,2412,-81,-92,11,48:dd:0c:7d:86:27,929625,362,8651,929263,929625
209,4,11,1,2412,-81,-92,11,48:dd:0c:7d:86:23,929999,323,51,929676,929999
210,4,1,1,2412,-82,-92,10,,945335,384,14952,944951,945335
211,4,1,1,2412,-85,-92,7,,945734,448,-49,945286,945734
212,4,1,1,2412,-88,-92,4,,946629,448,447,946181,946629
213,4,1,1,2412,-87,-92,5,78:67:0e:38:6c:d3,956437,2736,7072,953701,956437
214,4,11,1,2412,-84,-92,8,4c:01:43:ec:a0:69,960328,361,3530,959967,960328
215,4,11,1,2412,-86,-92,6,4c:01:43:ec:a0:66,961036,387,321,960649,961036
216,4,11,1,2412,-76,-92,16,48:dd:0c:90:e3:87,965536,362,4138,965174,965536
217,4,11,1,2412,-78,-92,14,48:dd:0c:90:e3:83,965911,323,52,965588,965911
218,4,11,1,2412,-83,-92,9,48:dd:0c:90:e3:85,966246,382,-47,965864,966246
219,4,1,1,2412,-83,-92,9,78:67:0e:c4:a8:42,967817,2736,-1165,965081,967817
220,4,1,1,2412,-80,-92,12,,976536,304,8415,976232,976536
221,4,1,1,2412,-82,-92,10,,977694,304,854,977390,977694
222,6,6,1,2412,-77,-92,15,10:86:8c:5f:93:1e,978366,336,336,978030,978366
223,4,1,1,2412,-78,-92,14,b0:e4:d5:32:ec:8a,989546,1960,9220,987586,989546
224,6,6,1,2412,-77,-92,15,e2:db:d1:d1:b0:4a,1008480,444,18490,1008036,1008480
225,6,6,1,2412,-77,-92,15,e2:db:d1:d1:b0:4b,1008974,408,86,1008566,1008974
226,6,6,1,2412,-78,-92,14,e2:db:d1:d1:b0:4d,1009433,408,51,1009025,1009433
227,6,6,1,2412,-78,-92,14,e2:db:d1:d1:b0:4f,1009874,408,33,1009466,1009874
228,4,1,1,2412,-87,-91,4,bc:98:df:ff:0f:8b,1022883,2568,10441,1020315,1022883
229,6,6,1,2412,-79,-91,12,52:86:8c:5f:93:1e,1026206,332,2991,1025874,1026206
230,4,11,1,2412,-77,-91,14,48:dd:0c:7d:86:27,1032024,362,5456,1031662,1032024
231,4,11,1,2412,-81,-91,10,48:dd:0c:7d:86:23,1032399,323,52,1032076,1032399
232,4,11,1,2412,-81,-91,10,48:dd:0c:7d:86:25,1032734,382,-47,1032352,1032734
233,4,1,1,2412,-75,-91,16,60:b7:6e:d3:6c:f6,1035940,2152,1054,1033788,1035940
234,4,1,1,2412,-81,-91,10,,1048547,448,12159,1048099,1048547
235,4,1,1,2412,-86,-91,5,,1049424,448,429,1048976,1049424
236,4,11,1,2412,-82,-91,9,48:dd:0c:7d:86:23,1049942,254,264,1049688,1049942
237,4,11,1,2412,-82,-91,9,48:dd:0c:90:e3:83,1050244,254,48,1049990,1050244
238,6,6,1,2412,-78,-91,13,10:86:8c:5f:93:1e,1056215,336,5635,1055879,1056215
239,4,1,1,2412,-87,-91,4,78:67:0e:38:6c:d3,1058837,2736,-114,1056101,1058837
240,4,1,1,2412,-86,-91,5,78:67:0e:38:6c:d3,1061629,848,1944,1060781,1061629
241,4,11,1,2412,-86,-91,5,4c:01:43:ec:a0:66,1063407,387,1391,1063020,1063407
242,4,11,1,2412,-79,-91,12,48:dd:0c:90:e3:87,1067936,362,4167,1067574,1067936
243,4,1,1,2412,-84,-91,7,,1070304,304,2064,1070000,1070304
244,6,6,1,2412,-78,-91,13,12:86:8c:5f:93:1e,1077626,332,6990,1077294,1077626
245,4,1,1,2412,-77,-91,14,b0:e4:d5:32:ec:8a,1091946,1960,12360,1089986,1091946
246,6,6,1,2412,-79,-91,12,32:86:8c:5f:93:1e,1103007,332,10729,1102675,1103007
247,6,6,1,2412,-78,-91,13,e2:db:d1:d1:b0:4b,1111323,408,7908,1110915,1111323
248,6,6,1,2412,-78,-91,13,e2:db:d1:d1:b0:4d,1111773,408,42,1111365,1111773
249,4,1,1,2412,-80,-91,11,3c:bd:c5:ee:96:6d,1122550,2512,8265,1120038,1122550
250,4,1,1,2412,-80,-91,11,88:71:b1:b4:0e:c7,1125142,3552,-960,1121590,1125142
251,4,1,1,2412,-81,-91,10,88:71:b1:b4:0e:c7,1128774,3624,8,1125150,1128774
252,4,1,1,2412,-80,-91,11,88:71:b1:b4:0e:c7,1133020,3968,278,1129052,1133020
253,4,1,1,2412,-82,-91,9,88:71:b1:b4:0e:c7,1146233,4792,8421,1141441,1146233
254,4,1,1,2412,-81,-91,10,88:71:b1:b4:0e:c7,1151105,4792,80,1146313,1151105
255,6,6,1,2412,-78,-91,13,f8:4f:ad:f9:af:82,1155960,656,4199,1155304,1155960
256,4,1,1,2412,-81,-91,10,88:71:b1:b4:0e:c7,1166172,4064,6148,1162108,1166172
257,6,6,1,2412,-79,-91,12,12:86:8c:5f:93:1e,1182931,332,16427,1182599,1182931
258,6,6,1,2412,-76,-91,15,e2:db:d1:d1:b0:4a,1213261,444,29886,1212817,1213261
259,6,6,1,2412,-78,-91,13,e2:db:d1:d1:b0:4b,1213738,408,69,1213330,1213738
260,6,6,1,2412,-77,-91,14,e2:db:d1:d1:b0:4d,1214188,408,42,1213780,1214188
261,4,1,1,2412,-85,-91,6,ac:67:84:84:8a:07,1220692,416,6088,1220276,1220692
262,4,11,1,2412,-82,-91,9,48:dd:0c:7d:86:23,1232892,254,11946,1232638,1232892
263,4,11,1,2412,-83,-91,8,48:dd:0c:90:e3:83,1233805,254,659,1233551,1233805
264,4,11,1,2412,-83,-91,8,48:dd:0c:7d:86:27,1236831,362,2664,1236469,1236831
265,4,11,1,2412,-83,-91,8,48:dd:0c:7d:86:23,1237205,323,51,1236882,1237205
266,4,11,1,2412,-80,-91,11,48:dd:0c:7d:86:25,1237541,382,-46,1237159,1237541
267,6,6,1,2412,-79,-91,12,b4:e6:2d:b4:ff:71,1240769,64,3164,1240705,1240769
268,6,6,1,2412,-80,-91,11,b4:e6:2d:b4:ff:71,1241057,64,224,1240993,1241057
269,6,6,1,2412,-80,-91,11,b4:e6:2d:b4:ff:71,1241282,64,161,1241218,1241282
270,6,6,1,2412,-79,-91,12,b4:e6:2d:b4:ff:71,1241462,64,116,1241398,1241462
271,6,6,1,2412,-79,-91,12,b4:e6:2d:b4:ff:71,1241633,64,107,1241569,1241633
272,6,6,1,2412,-79,-91,12,b4:e6:2d:b4:ff:71,1242198,64,501,1242134,1242198
273,4,1,1,2412,-79,-91,12,b4:e6:2d:b4:ff:71,1249979,416,7365,1249563,1249979
274,4,1,1,2412,-80,-91,11,b4:e6:2d:b4:ff:71,1253225,416,2830,1252809,1253225
275,4,1,1,2412,-85,-91,6,,1254192,448,519,1253744,1254192
276,4,1,1,2412,-81,-91,10,,1255923,304,1427,1255619,1255923
277,6,6,1,2412,-79,-91,12,10:86:8c:5f:93:1e,1256727,336,468,1256391,1256727
278,4,1,1,2412,-87,-91,4,78:67:0e:38:6c:d3,1263637,2736,4174,1260901,1263637
279,4,11,1,2412,-79,-91,12,48:dd:0c:90:e3:83,1273110,323,9150,1272787,1273110
280,4,11,1,2412,-78,-91,13,48:dd:0c:90:e3:85,1273446,382,-46,1273064,1273446
281,4,1,1,2412,-87,-91,4,78:67:0e:c4:a8:42,1275016,2736,-1166,1272280,1275016
282,6,6,1,2412,-79,-91,12,12:86:8c:5f:93:1e,1284237,332,8889,1283905,1284237
283,4,1,1,2412,-76,-91,15,b0:e4:d5:32:ec:8a,1296744,1960,10547,1294784,1296744
284,4,1,1,2412,-82,-91,9,b4:b5:2f:17:0c:b9,1300051,1328,1979,1298723,1300051
285,4,1,1,2412,-89,-91,2,bc:98:df:ff:0f:8b,1304970,3176,1743,1301794,1304970
286,4,1,1,2412,-84,-91,7,b4:b5:2f:17:0c:b9,1308300,1328,2002,1306972,1308300
287,4,1,1,2412,-82,-91,9,b4:b5:2f:17:0c:b9,1309950,1328,322,1308622,1309950
288,4,1,1,2412,-80,-91,11,b4:b5:2f:17:0c:b9,1311600,1328,322,1310272,1311600
289,4,1,1,2412,-83,-91,8,ac:67:84:84:8a:07,1330105,416,18089,1329689,1330105
290,6,6,1,2412,-78,-91,13,52:86:8c:5f:93:1e,1335025,332,4588,1334693,1335025
291,4,11,1,2412,-83,-91,8,48:dd:0c:7d:86:27,1339224,362,3837,1338862,1339224
292,4,11,1,2412,-83,-91,8,48:dd:0c:7d:86:23,1339598,323,51,1339275,1339598
293,4,11,1,2412,-84,-91,7,48:dd:0c:7d:86:25,1339933,382,-47,1339551,1339933
294,4,1,1,2412,-88,-91,3,,1356531,384,16214,1356147,1356531
295,4,1,1,2412,-85,-91,6,,1357816,448,837,1357368,1357816
296,4,1,1,2412,-85,-91,6,7c:f6:66:d3:26:e0,1368829,2208,8805,1366621,1368829
297,6,6,1,2412,-78,-91,13,12:86:8c:5f:93:1e,1384609,332,15448,1384277,1384609
298,4,1,1,2412,-77,-91,14,b0:e4:d5:32:ec:8a,1399144,1960,12575,1397184,1399144
299,6,6,1,2412,-78,-91,13,f8:4f:ad:f9:af:82,1404649,1360,4145,1403289,1404649
300,6,6,1,2412,-79,-91,12,32:86:8c:5f:93:1e,1410209,332,5228,1409877,1410209
301,4,1,1,2412,-83,-91,8,b4:b5:2f:17:0c:b9,1416817,1376,5232,1415441,1416817
302,6,6,1,2412,-78,-91,13,e2:db:d1:d1:b0:4a,1418058,444,797,1417614,1418058
303,6,6,1,2412,-77,-91,14,e2:db:d1:d1:b0:4b,1418526,408,60,1418118,1418526
304,6,6,1,2412,-77,-91,14,e2:db:d1:d1:b0:4f,1419426,408,492,1419018,1419426
305,4,1,1,2412,-76,-91,15,3c:bd:c5:ee:96:6d,1429019,2512,7081,1426507,1429019
306,4,1,1,2412,-82,-91,9,ac:67:84:84:8a:07,1431554,416,2119,1431138,1431554
307,4,1,1,2412,-80,-91,11,3c:bd:c5:ee:96:6a,1432668,1056,58,1431612,1432668
308,4,1,1,2412,-87,-91,4,bc:98:df:ff:0f:8b,1434452,2568,-784,1431884,1434452
309,4,1,1,2412,-89,-91,2,bc:98:df:ff:0f:8a,1439030,976,3602,1438054,1439030
310,4,1,1,2412,-86,-91,5,bc:98:df:ff:0f:8a,1440017,976,11,1439041,1440017
311,4,11,1,2412,-84,-91,7,48:dd:0c:7d:86:27,1441623,362,1244,1441261,1441623
312,4,11,1,2412,-82,-91,9,48:dd:0c:7d:86:23,1441998,323,52,1441675,1441998
313,4,11,1,2412,-83,-91,8,48:dd:0c:7d:86:25,1442333,382,-47,1441951,1442333
314,4,1,1,2412,-87,-91,4,bc:98:df:ff:0f:8b,1444709,432,1944,1444277,1444709
315,4,1,1,2412,-85,-91,6,,1459666,448,14509,1459218,1459666
316,4,1,1,2412,-86,-91,5,,1460543,448,429,1460095,1460543
317,6,6,1,2412,-79,-91,12,10:86:8c:5f:93:1e,1461482,336,603,1461146,1461482
318,4,1,1,2412,-85,-91,6,78:67:0e:38:6c:d3,1468438,2736,4220,1465702,1468438
319,4,1,1,2412,-84,-91,7,ac:67:84:84:8a:07,1473580,416,4726,1473164,1473580
320,6,6,1,2412,-79,-91,12,12:86:8c:5f:93:1e,1487656,332,13744,1487324,1487656
321,4,1,1,2412,-86,-91,5,,1491489,352,3481,1491137,1491489
322,4,1,1,2412,-89,-91,2,00:26:62:eb:ea:74,1492866,968,409,1491898,1492866
323,4,1,1,2412,-83,-91,8,,1494632,352,1414,1494280,1494632
324,4,1,1,2412,-80,-91,11,b0:e4:d5:32:ec:8a,1501543,1960,4951,1499583,1501543
325,6,6,1,2412,-79,-91,12,32:86:8c:5f:93:1e,1512610,332,10735,1512278,1512610
326,4,1,1,2412,-88,-91,3,b4:b5:2f:17:0c:b9,1519215,1376,5229,1517839,1519215
327,6,6,1,2412,-77,-91,14,e2:db:d1:d1:b0:4a,1520474,444,815,1520030,1520474
328,6,6,1,2412,-78,-91,13,e2:db:d1:d1:b0:4d,1521392,408,510,1520984,1521392
329,6,6,1,2412,-77,-91,14,e2:db:d1:d1:b0:4f,1521842,408,42,1521434,1521842
330,4,1,1,2412,-57,-91,34,3c:bd:c5:ee:96:6d,1532131,2512,7777,1529619,1532131
331,4,1,1,2412,-85,-91,6,bc:98:df:ff:0f:8b,1536477,2568,1778,1533909,1536477
332,6,6,1,2412,-79,-91,12,52:86:8c:5f:93:1e,1539017,332,2208,1538685,1539017
333,4,11,1,2412,-82,-91,9,48:dd:0c:7d:86:27,1544023,362,4644,1543661,1544023
334,4,11,1,2412,-82,-91,9,48:dd:0c:7d:86:23,1544398,323,52,1544075,1544398
335,4,11,1,2412,-82,-91,9,48:dd:0c:7d:86:25,1544733,382,-47,1544351,1544733
336,4,1,1,2412,-87,-91,4,,1562468,448,17287,1562020,1562468
337,4,1,1,2412,-86,-91,5,,1563372,448,456,1562924,1563372
338,6,6,1,2412,-79,-91,12,10:86:8c:5f:93:1e,1565630,336,1922,1565294,1565630
339,4,11,1,2412,-86,-91,5,4c:01:43:ec:a0:69,1574693,361,8702,1574332,1574693
340,4,11,1,2412,-81,-91,10,48:dd:0c:90:e3:85,1580645,382,5570,1580263,1580645
341,6,6,1,2412,-79,-91,12,12:86:8c:5f:93:1e,1589578,332,8601,1589246,1589578
342,4,1,1,2412,-79,-91,12,b0:e4:d5:32:ec:8a,1603942,1960,12404,1601982,1603942
343,6,6,1,2412,-79,-91,12,32:86:8c:5f:93:1e,1615011,332,10737,1614679,1615011
344,6,6,1,2412,-77,-91,14,e2:db:d1:d1:b0:4b,1623342,408,7923,1622934,1623342
345,6,6,1,2412,-77,-91,14,e2:db:d1:d1:b0:4d,1623774,408,24,1623366,1623774
346,6,6,1,2412,-77,-91,14,e2:db:d1:d1:b0:4f,1624206,408,24,1623798,1624206
347,4,1,1,2412,-78,-91,13,3c:bd:c5:ee:96:6d,1634545,2512,7827,1632033,1634545
348,4,1,1,2412,-86,-91,5,bc:98:df:ff:0f:8b,1637407,2568,294,1634839,1637407
349,6,6,1,2412,-80,-91,11,52:86:8c:5f:93:1e,1640612,332,2873,1640280,1640612
350,4,11,1,2412,-82,-91,9,48:dd:0c:7d:86:27,1646423,362,5449,1646061,1646423
351,4,11,1,2412,-81,-91,10,48:dd:0c:7d:86:23,1646797,323,51,1646474,1646797
352,4,1,1,2412,-91,-91,0,,1664845,384,17664,1664461,1664845
353,4,1,1,2412,-86,-91,5,,1665243,448,-50,1664795,1665243
354,4,1,1,2412,-84,-91,7,,1666138,448,447,1665690,1666138
355,6,6,1,2412,-78,-91,13,10:86:8c:5f:93:1e,1670719,336,4245,1670383,1670719
356,4,1,1,2412,-86,-91,5,78:67:0e:38:6c:d3,1673238,2736,-217,1670502,1673238
357,4,1,1,2412,-84,-91,7,7c:f6:66:c0:cf:b8,1676030,2208,584,1673822,1676030
358,4,11,1,2412,-80,-91,11,48:dd:0c:90:e3:85,1683044,382,6632,1682662,1683044
359,4,1,1,2412,-86,-91,5,78:67:0e:c4:a8:42,1684616,2736,-1164,1681880,1684616
360,4,1,1,2412,-81,-91,10,c8:9e:43:bc:eb:ff,1695057,3496,6945,1691561,1695057
361,4,1,1,2412,-78,-91,13,b0:e4:d5:32:ec:8a,1706342,1960,9325,1704382,1706342
362,4,1,1,2412,-83,-91,8,b4:b5:2f:17:0c:b9,1724040,1376,16322,1722664,1724040
363,4,1,1,2412,-79,-91,12,3c:bd:c5:ee:96:6d,1736220,2512,9668,1733708,1736220
364,4,1,1,2412,-85,-91,6,,1768983,448,32315,1768535,1768983
365,6,6,1,2412,-81,-91,10,10:86:8c:5f:93:1e,1770788,336,1469,1770452,1770788
366,4,1,1,2412,-87,-91,4,ac:67:84:84:8a:07,1772415,416,1211,1771999,1772415
367,4,1,1,2412,-88,-91,3,,1772843,304,124,1772539,1772843
368,4,1,1,2412,-88,-91,3,78:67:0e:38:6c:d3,1775638,2736,59,1772902,1775638
369,6,6,1,2412,-78,-91,13,32:86:8c:5f:93:1e,1822310,332,46340,1821978,1822310
370,4,1,1,2412,-86,-91,5,04:a2:22:ca:52:26,1823136,2512,-1686,1820624,1823136
371,4,1,1,2412,-86,-91,5,b4:b5:2f:17:0c:b9,1826416,1376,1904,1825040,1826416
372,6,6,1,2412,-76,-91,15,e2:db:d1:d1:b0:4a,1827648,444,788,1827204,1827648
373,6,6,1,2412,-77,-91,14,e2:db:d1:d1:b0:4b,1828116,408,60,1827708,1828116
374,4,1,1,2412,-86,-91,5,ac:67:84:84:8a:07,1829598,416,1066,1829182,1829598
375,4,1,1,2412,-88,-91,3,,1830026,304,124,1829722,1830026
376,4,11,1,2412,-80,-91,11,48:dd:0c:7d:86:2e,1832946,277,2643,1832669,1832946
377,4,11,1,2412,-81,-91,10,48:dd:0c:7d:86:2e,1833883,284,653,1833599,1833883
378,4,1,1,2412,-77,-91,14,3c:bd:c5:ee:96:6d,1838619,2512,2224,1836107,1838619
379,4,1,1,2412,-88,-91,3,bc:98:df:ff:0f:8b,1843637,2568,2450,1841069,1843637
380,6,6,1,2412,-79,-91,12,52:86:8c:5f:93:1e,1846489,332,2520,1846157,1846489
381,4,11,1,2412,-81,-91,10,48:dd:0c:7d:86:27,1851223,362,4372,1850861,1851223
382,4,11,1,2412,-82,-91,9,48:dd:0c:7d:86:23,1851597,323,51,1851274,1851597
383,4,11,1,2412,-80,-91,11,48:dd:0c:7d:86:25,1851932,382,-47,1851550,1851932
384,4,1,1,2412,-80,-91,11,,1862384,304,10148,1862080,1862384
385,4,1,1,2412,-85,-91,6,,1870820,448,7988,1870372,1870820
386,4,1,1,2412,-88,-91,3,,1871946,448,678,1871498,1871946
387,4,1,1,2412,-85,-91,6,78:67:0e:38:6c:d3,1878066,2736,3384,1875330,1878066
388,4,1,1,2412,-78,-91,13,,1884922,352,6504,1884570,1884922
389,4,1,1,2412,-77,-91,14,,1885773,352,499,1885421,1885773
390,4,1,1,2412,-78,-91,13,,1886624,352,499,1886272,1886624
391,4,11,1,2412,-84,-91,7,48:dd:0c:90:e3:85,1887844,382,838,1887462,1887844
392,4,1,1,2412,-84,-91,7,78:67:0e:c4:a8:42,1889416,2736,-1164,1886680,1889416
393,4,1,1,2412,-85,-91,6,,1892804,352,3036,1892452,1892804
394,6,6,1,2412,-79,-91,12,12:86:8c:5f:93:1e,1898309,332,5173,1897977,1898309
395,6,6,1,2412,-77,-91,14,e2:db:d1:d1:b0:4d,1930973,408,32256,1930565,1930973
396,6,6,1,2412,-77,-91,14,e2:db:d1:d1:b0:4f,1931414,408,33,1931006,1931414
397,4,1,1,2412,-78,-91,13,3c:bd:c5:ee:96:6d,1943573,2512,9647,1941061,1943573
398,6,6,1,2412,-79,-91,12,52:86:8c:5f:93:1e,1947813,332,3908,1947481,1947813
399,4,11,1,2412,-82,-91,9,48:dd:0c:7d:86:27,1953622,362,5447,1953260,1953622
400,6,24,1,2412,-82,-91,9,,1958770,28,5120,1958742,1958770
401,4,11,1,2412,-86,-91,5,4c:01:43:ec:a0:63,1960058,254,1034,1959804,1960058
402,4,1,1,2412,-89,-91,2,04:a2:22:de:87:a6,1972895,2512,10325,1970383,1972895
403,4,1,1,2412,-86,-91,5,78:67:0e:38:6c:d3,1980441,2736,4810,1977705,1980441
404,6,6,1,2412,-78,-91,13,10:86:8c:5f:93:1e,1983066,336,2289,1982730,1983066
405,4,1,1,2412,-86,-91,5,78:67:0e:38:6c:d2,1983561,832,-337,1982729,1983561
406,4,11,1,2412,-77,-91,14,48:dd:0c:90:e3:83,1989908,323,6024,1989585,1989908
407,4,11,1,2412,-76,-91,15,48:dd:0c:90:e3:85,1990244,382,-46,1989862,1990244
408,4,1,1,2412,-88,-91,3,78:67:0e:c4:a8:42,1991815,2736,-1165,1989079,1991815
409,6,6,1,2412,-78,-91,13,12:86:8c:5f:93:1e,2000056,332,7909,1999724,2000056
410,4,1,1,2412,-86,-91,5,,2003251,304,2891,2002947,2003251
411,6,6,1,2412,-79,-91,12,32:86:8c:5f:93:1e,2024614,332,21031,2024282,2024614
412,6,6,1,2412,-77,-89,12,e2:db:d1:d1:b0:4d,2033551,408,8529,2033143,2033551
413,6,6,1,2412,-77,-89,12,e2:db:d1:d1:b0:4f,2033992,408,33,2033584,2033992
414,4,1,1,2412,-89,-89,0,7a:a2:22:ca:52:27,2034907,2216,-1301,2032691,2034907
415,4,1,1,2412,-90,-89,-1,10:7b:44:eb:35:60,2042913,1960,6046,2040953,2042913
416,4,1,1,2412,-78,-89,11,3c:bd:c5:ee:96:6d,2045709,2512,284,2043197,2045709
417,6,6,1,2412,-79,-89,10,52:86:8c:5f:93:1e,2052170,332,6129,2051838,2052170
418,4,11,1,2412,-83,-89,6,48:dd:0c:7d:86:27,2056022,362,3490,2055660,2056022
419,4,11,1,2412,-82,-89,7,48:dd:0c:7d:86:23,2056397,323,52,2056074,2056397
420,4,1,1,2412,-89,-89,0,60:b7:6e:d3:6c:f6,2059942,2152,1393,2057790,2059942
421,6,6,1,2412,-78,-89,11,10:86:8c:5f:93:1e,2077675,336,17397,2077339,2077675
422,4,1,1,2412,-81,-89,8,,2093131,352,15104,2092779,2093131
423,4,11,1,2412,-86,-89,3,,2097443,107,4205,2097336,2097443
424,4,1,1,2412,-85,-89,4,,2097839,352,44,2097487,2097839
425,4,1,1,2412,-86,-89,3,78:67:0e:c4:a8:41,2098683,832,12,2097851,2098683
426,6,6,1,2412,-79,-89,10,12:86:8c:5f:93:1e,2101539,332,2524,2101207,2101539
427,4,1,1,2412,-78,-89,11,b0:e4:d5:32:ec:8a,2115939,1960,12440,2113979,2115939
428,4,1,1,2412,-88,-89,1,ac:67:84:84:8a:07,2122370,416,6015,2121954,2122370
429,4,1,1,2412,-91,-89,-2,,2122798,304,124,2122494,2122798
430,4,1,1,2412,-81,-89,8,,2126893,304,3791,2126589,2126893
431,6,6,1,2412,-78,-89,11,32:86:8c:5f:93:1e,2127349,332,124,2127017,2127349
432,4,1,1,2412,-85,-89,4,b4:b5:2f:17:0c:b9,2133633,1376,4908,2132257,2133633
433,6,6,1,2412,-77,-89,12,e2:db:d1:d1:b0:4a,2134893,444,816,2134449,2134893
434,6,6,1,2412,-77,-89,12,e2:db:d1:d1:b0:4b,2135360,408,59,2134952,2135360
435,6,6,1,2412,-78,-89,11,e2:db:d1:d1:b0:4d,2135801,408,33,2135393,2135801
436,6,6,1,2412,-77,-89,12,e2:db:d1:d1:b0:4f,2136260,408,51,2135852,2136260
437,4,1,1,2412,-86,-89,3,c8:9e:43:bc:eb:ff,2142255,3496,2499,2138759,2142255
438,4,1,1,2412,-87,-89,2,bc:98:df:ff:0f:8b,2149750,2568,4927,2147182,2149750
439,6,6,1,2412,-79,-89,10,52:86:8c:5f:93:1e,2152728,332,2646,2152396,2152728
440,4,11,1,2412,-80,-89,9,48:dd:0c:7d:86:27,2158422,362,5332,2158060,2158422
441,4,11,1,2412,-82,-89,7,48:dd:0c:7d:86:23,2158796,323,51,2158473,2158796
442,4,1,1,2412,-84,-89,5,,2169157,304,10057,2168853,2169157
443,6,6,1,2412,-79,-89,10,10:86:8c:5f:93:1e,2178781,336,9288,2178445,2178781
444,4,1,1,2412,-86,-89,3,,2180629,448,1400,2180181,2180629
445,4,1,1,2412,-87,-89,2,,2181506,448,429,2181058,2181506
446,4,1,1,2412,-87,-89,2,78:67:0e:38:6c:d3,2185299,2736,1057,2182563,2185299
447,4,11,1,2412,-83,-89,6,4c:01:43:ec:a0:63,2189460,322,3839,2189138,2189460
448,4,11,1,2412,-76,-89,13,48:dd:0c:90:e3:83,2194708,323,4925,2194385,2194708
449,4,11,1,2412,-82,-89,7,48:dd:0c:90:e3:85,2195043,382,-47,2194661,2195043
450,4,1,1,2412,-80,-89,9,78:67:0e:c4:a8:42,2196615,2736,-1164,2193879,2196615
451,6,6,1,2412,-79,-89,10,12:86:8c:5f:93:1e,2204035,332,7088,2203703,2204035
452,4,1,1,2412,-85,-89,4,,2216795,304,12456,2216491,2216795
453,4,1,1,2412,-78,-89,11,b0:e4:d5:32:ec:8a,2218338,1960,-417,2216378,2218338
454,6,6,1,2412,-80,-89,9,32:86:8c:5f:93:1e,2229415,332,10745,2229083,2229415
455,4,1,1,2412,-84,-89,5,b4:b5:2f:17:0c:b9,2236027,1376,5236,2234651,2236027
456,6,6,1,2412,-76,-89,13,e2:db:d1:d1:b0:4a,2237277,444,806,2236833,2237277
457,6,6,1,2412,-77,-89,12,e2:db:d1:d1:b0:4b,2237772,408,87,2237364,2237772
458,6,6,1,2412,-76,-89,13,e2:db:d1:d1:b0:4d,2238231,408,51,2237823,2238231
459,6,6,1,2412,-78,-89,11,e2:db:d1:d1:b0:4f,2238663,408,24,2238255,2238663
460,4,1,1,2412,-77,-89,12,3c:bd:c5:ee:96:6d,2248222,2512,7047,2245710,2248222
461,4,1,1,2412,-87,-89,2,bc:98:df:ff:0f:8b,2251816,2568,1026,2249248,2251816
462,6,6,1,2412,-78,-89,11,52:86:8c:5f:93:1e,2255302,332,3154,2254970,2255302
463,4,11,1,2412,-81,-89,8,48:dd:0c:7d:86:27,2260822,362,5158,2260460,2260822
464,4,11,1,2412,-81,-89,8,48:dd:0c:7d:86:23,2261196,323,51,2260873,2261196
465,4,11,1,2412,-81,-89,8,48:dd:0c:7d:86:25,2261531,382,-47,2261149,2261531
466,4,1,1,2412,-83,-89,6,,2262679,304,844,2262375,2262679
467,4,1,1,2412,-83,-89,6,,2270253,304,7270,2269949,2270253
468,4,1,1,2412,-84,-89,5,,2276903,304,6346,2276599,2276903
469,4,11,1,2412,-84,-89,5,,2277798,107,788,2277691,2277798
470,4,1,1,2412,-85,-89,4,e6:14:7c:fb:0e:43,2280033,1888,347,2278145,2280033
471,6,6,1,2412,-80,-89,9,10:86:8c:5f:93:1e,2281776,336,1407,2281440,2281776
472,4,1,1,2412,-84,-89,5,,2284501,352,2373,2284149,2284501
473,4,1,1,2412,-86,-89,3,78:67:0e:38:6c:d3,2287639,2736,402,2284903,2287639
474,4,11,1,2412,-77,-89,12,48:dd:0c:90:e3:83,2297108,323,9146,2296785,2297108
475,6,6,1,2412,-79,-89,10,12:86:8c:5f:93:1e,2306354,332,8914,2306022,2306354
476,4,1,1,2412,-70,-89,19,7a:a2:22:ca:52:27,2308450,2168,-72,2306282,2308450
477,4,1,1,2412,-79,-89,10,b0:e4:d5:32:ec:8a,2320738,1960,10328,2318778,2320738
478,6,6,1,2412,-79,-89,10,32:86:8c:5f:93:1e,2334829,332,13759,2334497,2334829
479,6,6,1,2412,-76,-89,13,e2:db:d1:d1:b0:4b,2340158,408,4921,2339750,2340158
480,6,6,1,2412,-77,-89,12,e2:db:d1:d1:b0:4d,2340590,408,24,2340182,2340590
481,4,11,1,2412,-84,-89,5,,2344285,203,3492,2344082,2344285
482,4,1,1,2412,-77,-89,12,3c:bd:c5:ee:96:6d,2350709,2512,3912,2348197,2350709
483,4,11,1,2412,-81,-89,8,48:dd:0c:7d:86:27,2363221,362,12150,2362859,2363221
484,4,1,1,2412,-88,-89,1,ac:67:84:84:8a:07,2377839,416,14202,2377423,2377839
485,6,6,1,2412,-79,-89,10,10:86:8c:5f:93:1e,2383243,336,5068,2382907,2383243
486,4,11,1,2412,-85,-89,4,,2386941,203,3495,2386738,2386941
487,4,1,1,2412,-86,-89,3,78:67:0e:38:6c:d3,2390039,2736,362,2387303,2390039
488,4,11,1,2412,-85,-89,4,4c:01:43:ec:a0:69,2393883,361,3483,2393522,2393883
489,4,11,1,2412,-77,-89,12,48:dd:0c:90:e3:87,2399133,362,4888,2398771,2399133
490,4,11,1,2412,-76,-89,13,48:dd:0c:90:e3:83,2399507,323,51,2399184,2399507
491,4,11,1,2412,-78,-89,11,48:dd:0c:90:e3:85,2399843,382,-46,2399461,2399843
492,4,1,1,2412,-85,-89,4,78:67:0e:c4:a8:42,2401415,2736,-1164,2398679,2401415
493,6,6,1,2412,-77,-89,12,f8:4f:ad:f9:af:82,2405343,1360,2568,2403983,2405343
494,6,6,1,2412,-76,-89,13,f8:4f:ad:f9:af:82,2406966,1332,291,2405634,2406966
495,6,6,1,2412,-79,-89,10,12:86:8c:5f:93:1e,2409226,332,1928,2408894,2409226
496,4,1,1,2412,-87,-89,2,4c:01:43:db:2d:92,2431505,1040,21239,2430465,2431505
497,6,6,1,2412,-79,-89,10,32:86:8c:5f:93:1e,2435074,332,3237,2434742,2435074
498,4,1,1,2412,-84,-89,5,b4:b5:2f:17:0c:b9,2440821,1376,4371,2439445,2440821
499,6,6,1,2412,-76,-89,13,e2:db:d1:d1:b0:4a,2442053,444,788,2441609,2442053
500,6,6,1,2412,-76,-89,13,e2:db:d1:d1:b0:4b,2442521,408,60,2442113,2442521
501,4,1,1,2412,-77,-89,12,3c:bd:c5:ee:96:6d,2453015,2512,7982,2450503,2453015
502,6,6,1,2412,-79,-89,10,52:86:8c:5f:93:1e,2459817,332,6470,2459485,2459817
503,4,5.5,1,2412,-88,-89,1,,2462971,117,3037,2462854,2462971
504,4,11,1,2412,-80,-89,9,48:dd:0c:7d:86:27,2465621,362,2288,2465259,2465621
505,4,11,1,2412,-81,-89,8,48:dd:0c:7d:86:23,2465996,323,52,2465673,2465996
506,4,11,1,2412,-81,-89,8,48:dd:0c:7d:86:25,2466331,382,-47,2465949,2466331
507,6,6,1,2412,-80,-89,9,10:86:8c:5f:93:1e,2485544,336,18877,2485208,2485544
508,4,1,1,2412,-88,-89,1,,2487508,448,1516,2487060,2487508
509,4,11,1,2412,-85,-89,4,,2489592,203,1881,2489389,2489592
510,4,1,1,2412,-87,-89,2,78:67:0e:38:6c:d3,2495656,2736,3328,2492920,2495656
511,4,11,1,2412,-77,-89,12,48:dd:0c:90:e3:83,2501907,323,5928,2501584,2501907
512,4,11,1,2412,-82,-89,7,48:dd:0c:90:e3:85,2502242,382,-47,2501860,2502242
513,4,1,1,2412,-83,-89,6,78:67:0e:c4:a8:42,2503815,2736,-1163,2501079,2503815
514,6,6,1,2412,-79,-89,10,12:86:8c:5f:93:1e,2511683,332,7536,2511351,2511683
515,4,1,1,2412,-85,-89,4,,2513979,304,1992,2513675,2513979
516,4,1,1,2412,-80,-89,9,b0:e4:d5:32:ec:8a,2525536,1960,9597,2523576,2525536
517,6,6,1,2412,-78,-89,11,32:86:8c:5f:93:1e,2536618,332,10750,2536286,2536618
518,4,1,1,2412,-84,-89,5,b4:b5:2f:17:0c:b9,2543217,1376,5223,2541841,2543217
519,6,6,1,2412,-77,-89,12,e2:db:d1:d1:b0:4a,2544476,444,815,2544032,2544476
520,6,6,1,2412,-75,-89,14,e2:db:d1:d1:b0:4b,2544962,408,78,2544554,2544962
521,6,6,1,2412,-76,-89,13,e2:db:d1:d1:b0:4d,2545404,408,34,2544996,2545404
522,6,6,1,2412,-77,-89,12,e2:db:d1:d1:b0:4f,2545844,408,32,2545436,2545844
523,4,1,1,2412,-78,-89,11,3c:bd:c5:ee:96:6d,2555440,2512,7084,2552928,2555440
524,4,1,1,2412,-88,-89,1,bc:98:df:ff:0f:8b,2559830,2568,1822,2557262,2559830
525,6,6,1,2412,-79,-89,10,52:86:8c:5f:93:1e,2562253,332,2091,2561921,2562253
526,4,11,1,2412,-80,-89,9,48:dd:0c:7d:86:27,2568021,362,5406,2567659,2568021
527,4,11,1,2412,-81,-89,8,48:dd:0c:7d:86:23,2568395,323,51,2568072,2568395
528,4,11,1,2412,-81,-89,8,48:dd:0c:7d:86:25,2568731,382,-46,2568349,2568731
529,4,11,1,2412,-86,-89,3,,2569205,203,271,2569002,2569205
530,4,1,1,2412,-85,-89,4,ac:67:84:84:8a:07,2572613,416,2992,2572197,2572613
531,4,1,1,2412,-84,-89,5,,2575618,304,2701,2575314,2575618
532,6,6,1,2412,-79,-89,10,10:86:8c:5f:93:1e,2589648,336,13694,2589312,2589648
533,4,1,1,2412,-87,-89,2,78:67:0e:38:6c:d3,2594839,2736,2455,2592103,2594839
534,4,1,1,2412,-87,-89,2,a4:e5:7c:33:02:31,2597631,832,1960,2596799,2597631
535,4,11,1,2412,-76,-89,13,48:dd:0c:90:e3:83,2604307,323,6353,2603984,2604307
536,4,11,1,2412,-82,-89,7,48:dd:0c:90:e3:85,2604642,382,-47,2604260,2604642
537,4,1,1,2412,-83,-89,6,78:67:0e:c4:a8:42,2606214,2736,-1164,2603478,2606214
538,6,6,1,2412,-79,-89,10,12:86:8c:5f:93:1e,2614056,332,7510,2613724,2614056
539,4,1,1,2412,-85,-89,4,,2618144,304,3784,2617840,2618144
540,4,1,1,2412,-87,-89,2,ac:67:84:84:8a:07,2623875,416,5315,2623459,2623875
541,4,1,1,2412,-89,-89,0,,2624303,304,124,2623999,2624303
542,4,1,1,2412,-79,-89,10,b0:e4:d5:32:ec:8a,2627936,1960,1673,2625976,2627936
543,4,11,1,2412,-85,-89,4,,2633246,203,5107,2633043,2633246
544,4,1,1,2412,-83,-89,6,,2638682,304,5132,2638378,2638682
545,6,6,1,2412,-76,-89,13,e2:db:d1:d1:b0:4b,2647350,408,8260,2646942,2647350
546,4,1,1,2412,-78,-89,11,3c:bd:c5:ee:96:6d,2658019,2512,8157,2655507,2658019
547,4,1,1,2412,-77,-89,12,b8:f8:53:cb:31:f1,2660611,976,1616,2659635,2660611
548,4,1,1,2412,-84,-89,5,,2665571,304,4656,2665267,2665571
549,4,11,1,2412,-84,-89,5,,2666481,107,803,2666374,2666481
550,6,6,1,2412,-80,-89,9,52:86:8c:5f:93:1e,2666749,332,-64,2666417,2666749
551,4,11,1,2412,-83,-89,6,,2669062,203,2110,2668859,2669062
552,4,11,1,2412,-82,-89,7,48:dd:0c:7d:86:23,2670795,323,1410,2670472,2670795
553,4,11,1,2412,-80,-89,9,48:dd:0c:7d:86:25,2671130,382,-47,2670748,2671130
554,4,1,1,2412,-87,-89,2,78:67:0e:38:6c:d3,2697239,2736,23373,2694503,2697239
555,4,1,1,2412,-86,-89,3,,2700741,304,3198,2700437,2700741
556,4,1,1,2412,-80,-89,9,,2702490,352,1397,2702138,2702490
557,4,1,1,2412,-78,-89,11,,2705045,352,2203,2704693,2705045
558,4,1,1,2412,-77,-89,12,,2705893,352,496,2705541,2705893
559,4,11,1,2412,-77,-89,12,48:dd:0c:90:e3:83,2706707,323,491,2706384,2706707
560,4,11,1,2412,-83,-89,6,48:dd:0c:90:e3:85,2707042,382,-47,2706660,2707042
561,4,11,1,2412,-85,-89,4,,2707753,107,604,2707646,2707753
562,4,1,1,2412,-83,-89,6,78:67:0e:c4:a8:42,2708614,2736,-1875,2705878,2708614
563,6,6,1,2412,-79,-89,10,12:86:8c:5f:93:1e,2716845,332,7899,2716513,2716845
564,4,11,1,2412,-85,-89,4,,2723228,203,6180,2723025,2723228
565,4,1,1,2412,-77,-89,12,b0:e4:d5:32:ec:8a,2730335,1960,5147,2728375,2730335
566,4,11,1,2412,-84,-89,5,4c:01:43:ec:a0:63,2735014,254,4425,2734760,2735014
567,6,6,1,2412,-80,-89,9,32:86:8c:5f:93:1e,2741419,332,6073,2741087,2741419
568,6,6,1,2412,-76,-89,13,e2:db:d1:d1:b0:4b,2749731,408,7904,2749323,2749731
569,6,6,1,2412,-77,-89,12,e2:db:d1:d1:b0:4d,2750173,408,34,2749765,2750173
570,6,6,1,2412,-77,-89,12,e2:db:d1:d1:b0:4f,2750623,408,42,2750215,2750623
571,4,11,1,2412,-83,-89,6,,2759033,203,8207,2758830,2759033
572,4,1,1,2412,-78,-89,11,3c:bd:c5:ee:96:6d,2760217,2512,-1328,2757705,2760217
573,6,6,1,2412,-79,-89,10,52:86:8c:5f:93:1e,2767019,332,6470,2766687,2767019
574,4,11,1,2412,-80,-89,9,48:dd:0c:7d:86:27,2772820,362,5439,2772458,2772820
575,4,11,1,2412,-81,-89,8,48:dd:0c:7d:86:23,2773195,323,52,2772872,2773195
576,4,11,1,2412,-81,-89,8,48:dd:0c:7d:86:25,2773530,382,-47,2773148,2773530
577,4,11,1,2412,-85,-89,4,,2778323,203,4590,2778120,2778323
578,6,6,1,2412,-80,-89,9,10:86:8c:5f:93:1e,2792726,336,14067,2792390,2792726
579,4,1,1,2412,-89,-89,0,,2796983,448,3809,2796535,2796983
580,4,1,1,2412,-87,-89,2,78:67:0e:38:6c:d3,2799639,2736,-80,2796903,2799639
581,4,11,1,2412,-83,-89,6,48:dd:0c:90:e3:85,2809442,382,9421,2809060,2809442
582,4,1,1,2412,-87,-89,2,78:67:0e:c4:a8:42,2811014,2736,-1164,2808278,2811014
583,6,6,1,2412,-80,-89,9,12:86:8c:5f:93:1e,2818830,332,7484,2818498,2818830
584,4,1,1,2412,-84,-89,5,78:67:0e:c4:a8:42,2827439,848,7761,2826591,2827439
585,4,1,1,2412,-78,-89,11,b0:e4:d5:32:ec:8a,2832734,1960,3335,2830774,2832734
586,6,6,1,2412,-79,-89,10,32:86:8c:5f:93:1e,2843820,332,10754,2843488,2843820
587,4,1,1,2412,-84,-89,5,b4:b5:2f:17:0c:b9,2850418,1376,5222,2849042,2850418
588,6,6,1,2412,-77,-89,12,e2:db:d1:d1:b0:4a,2851677,444,815,2851233,2851677
589,6,6,1,2412,-76,-89,13,e2:db:d1:d1:b0:4b,2852172,408,87,2851764,2852172
590,6,6,1,2412,-77,-89,12,e2:db:d1:d1:b0:4d,2852604,408,24,2852196,2852604
591,6,6,1,2412,-77,-89,12,e2:db:d1:d1:b0:4f,2853036,408,24,2852628,2853036
592,4,1,1,2412,-79,-89,10,3c:bd:c5:ee:96:6d,2863335,2512,7787,2860823,2863335
593,4,1,1,2412,-87,-89,2,bc:98:df:ff:0f:8b,2866198,2568,295,2863630,2866198
594,6,6,1,2412,-79,-89,10,52:86:8c:5f:93:1e,2869420,332,2890,2869088,2869420
595,4,11,1,2412,-81,-89,8,48:dd:0c:7d:86:27,2875220,362,5438,2874858,2875220
596,4,11,1,2412,-81,-89,8,48:dd:0c:7d:86:23,2875595,323,52,2875272,2875595
597,4,11,1,2412,-81,-89,8,48:dd:0c:7d:86:25,2875930,382,-47,2875548,2875930
598,4,1,1,2412,-87,-89,2,ac:67:84:84:8a:07,2880395,416,4049,2879979,2880395
599,4,11,1,2412,-80,-89,9,48:dd:0c:7d:86:2e,2896905,296,16214,2896609,2896905
600,6,6,1,2412,-80,-89,9,10:86:8c:5f:93:1e,2897057,336,-184,2896721,2897057
601,4,11,1,2412,-83,-89,6,48:dd:0c:7d:86:2e,2898001,296,648,2897705,2898001
602,4,11,1,2412,-81,-89,8,48:dd:0c:7d:86:2e,2898354,311,42,2898043,2898354
603,4,1,1,2412,-88,-89,1,,2898666,448,-136,2898218,2898666
604,4,11,1,2412,-83,-89,6,48:dd:0c:7d:86:2e,2899466,311,489,2899155,2899466
605,4,1,1,2412,-88,-89,1,78:67:0e:38:6c:d3,2902040,2736,-162,2899304,2902040
606,6,6,1,2412,-79,-89,10,12:86:8c:5f:93:1e,2921710,332,19338,2921378,2921710
607,4,1,1,2412,-84,-89,5,,2926299,304,4285,2925995,2926299
608,4,1,1,2412,-83,-89,6,,2930769,304,4166,2930465,2930769
609,4,1,1,2412,-80,-89,9,b0:e4:d5:32:ec:8a,2935134,1960,2405,2933174,2935134
610,6,6,1,2412,-80,-89,9,32:86:8c:5f:93:1e,2948837,332,13371,2948505,2948837
611,4,1,1,2412,-84,-89,5,b4:b5:2f:17:0c:b9,2952828,1376,2615,2951452,2952828
612,6,6,1,2412,-76,-89,13,e2:db:d1:d1:b0:4a,2954060,444,788,2953616,2954060
613,6,6,1,2412,-76,-89,13,e2:db:d1:d1:b0:4b,2954552,408,84,2954144,2954552
614,6,6,1,2412,-76,-89,13,e2:db:d1:d1:b0:4d,2955002,408,42,2954594,2955002
615,6,6,1,2412,-76,-89,13,e2:db:d1:d1:b0:4f,2955434,408,24,2955026,2955434
616,4,1,1,2412,-78,-89,11,3c:bd:c5:ee:96:6d,2965014,2512,7068,2962502,2965014
617,4,1,1,2412,-86,-89,3,bc:98:df:ff:0f:8b,2969011,2568,1429,2966443,2969011
618,6,6,1,2412,-80,-89,9,52:86:8c:5f:93:1e,2971897,332,2554,2971565,2971897
619,4,1,1,2412,-85,-89,4,,2975951,352,3702,2975599,2975951
620,4,11,1,2412,-81,-89,8,48:dd:0c:7d:86:27,2977620,362,1307,2977258,2977620
621,4,11,1,2412,-81,-89,8,48:dd:0c:7d:86:23,2977995,323,52,2977672,2977995
622,4,11,1,2412,-81,-89,8,48:dd:0c:7d:86:25,2978330,382,-47,2977948,2978330
623,4,11,1,2412,-85,-89,4,,2979139,107,702,2979032,2979139
624,4,1,1,2412,-85,-89,4,,2990519,304,11076,2990215,2990519
625,4,1,1,2412,-86,-89,3,,2990870,352,-1,2990518,2990870
626,4,11,1,2412,-84,-89,5,,2992449,107,1472,2992342,2992449
627,6,6,1,2412,-80,-89,9,10:86:8c:5f:93:1e,2999986,336,7201,2999650,2999986
628,4,1,1,2412,-89,-89,0,,3001033,384,663,3000649,3001033
629,4,1,1,2412,-88,-89,1,,3001431,448,-50,3000983,3001431
630,4,1,1,2412,-87,-89,2,,3002317,448,438,3001869,3002317
631,4,1,1,2412,-89,-89,0,ac:67:84:84:8a:07,3007124,416,4391,3006708,3007124
632,4,1,1,2412,-89,-89,0,,3007553,304,125,3007249,3007553
633,4,11,1,2412,-86,-89,3,4c:01:43:ec:a0:63,3008650,322,775,3008328,3008650
634,4,1,1,2412,-76,-89,13,,3010552,304,1598,3010248,3010552
635,4,11,1,2412,-77,-89,12,48:dd:0c:90:e3:83,3013906,323,3031,3013583,3013906
636,4,1,1,2412,-80,-89,9,b0:e4:d5:32:ec:8a,3037533,1960,21667,3035573,3037533
637,6,6,1,2412,-79,-89,10,32:86:8c:5f:93:1e,3048695,332,10830,3048363,3048695
638,6,6,1,2412,-76,-89,13,e2:db:d1:d1:b0:4b,3056994,408,7891,3056586,3056994
639,6,6,1,2412,-77,-89,12,e2:db:d1:d1:b0:4d,3057426,408,24,3057018,3057426
640,6,6,1,2412,-77,-89,12,e2:db:d1:d1:b0:4f,3057858,408,24,3057450,3057858
641,4,1,1,2412,-87,-89,2,ac:67:84:84:8a:07,3059475,416,1201,3059059,3059475
642,4,1,1,2412,-82,-89,7,60:32:b1:64:4c:f2,3060457,3224,-2242,3057233,3060457
643,4,1,1,2412,-78,-89,11,3c:bd:c5:ee:96:6d,3067464,2512,4495,3064952,3067464
644,6,6,1,2412,-80,-89,9,52:86:8c:5f:93:1e,3074547,332,6751,3074215,3074547
645,4,1,1,2412,-86,-89,3,ac:67:84:84:8a:07,3079175,416,4212,3078759,3079175
646,4,1,1,2412,-89,-89,0,,3079603,304,124,3079299,3079603
647,4,11,1,2412,-80,-89,9,48:dd:0c:7d:86:27,3080020,362,55,3079658,3080020
648,4,11,1,2412,-81,-89,8,48:dd:0c:7d:86:23,3080394,323,51,3080071,3080394
649,4,11,1,2412,-80,-89,9,48:dd:0c:7d:86:25,3080730,382,-46,3080348,3080730
650,4,1,1,2412,-86,-89,3,,3091712,304,10678,3091408,3091712
651,4,11,1,2412,-83,-89,6,,3092101,107,282,3091994,3092101
652,4,1,1,2412,-86,-89,3,,3092816,352,363,3092464,3092816
653,4,11,1,2412,-84,-89,5,,3094659,107,1736,3094552,3094659
654,4,11,1,2412,-84,-89,5,,3095165,107,399,3095058,3095165
655,4,1,1,2412,-84,-89,5,,3095538,352,21,3095186,3095538
656,4,1,1,2412,-84,-89,5,,3096917,352,1027,3096565,3096917
657,6,6,1,2412,-80,-89,9,10:86:8c:5f:93:1e,3100254,336,3001,3099918,3100254
658,4,1,1,2412,-85,-89,4,,3105120,448,4418,3104672,3105120
659,4,11,1,2412,-83,-89,6,48:dd:0c:90:e3:83,3106011,254,637,3105757,3106011
660,4,11,1,2412,-81,-89,8,48:dd:0c:7d:86:23,3106314,254,49,3106060,3106314
661,4,1,1,2412,-87,-89,2,78:67:0e:38:6c:d3,3106840,2736,-2210,3104104,3106840
662,4,11,1,2412,-77,-89,12,48:dd:0c:90:e3:83,3116306,323,9143,3115983,3116306
663,4,11,1,2412,-82,-89,7,48:dd:0c:90:e3:85,3116641,382,-47,3116259,3116641
664,4,1,1,2412,-83,-89,6,78:67:0e:c4:a8:42,3118214,2736,-1163,3115478,3118214
665,4,1,1,2412,-86,-89,3,ac:67:84:84:8a:07,3122344,416,3714,3121928,3122344
666,4,1,1,2412,-79,-89,10,b0:e4:d5:32:ec:8a,3139932,1960,15628,3137972,3139932
667,6,6,1,2412,-80,-89,9,32:86:8c:5f:93:1e,3151022,332,10758,3150690,3151022
668,6,6,1,2412,-77,-89,12,e2:db:d1:d1:b0:4a,3158879,444,7413,3158435,3158879
669,6,6,1,2412,-77,-89,12,e2:db:d1:d1:b0:4b,3159356,408,69,3158948,3159356
670,6,6,1,2412,-77,-89,12,e2:db:d1:d1:b0:4d,3159788,408,24,3159380,3159788
671,6,6,1,2412,-77,-89,12,e2:db:d1:d1:b0:4f,3160229,408,33,3159821,3160229
672,4,1,1,2412,-83,-89,6,60:32:b1:64:4c:f2,3162804,3224,-649,3159580,3162804
673,4,1,1,2412,-78,-89,11,3c:bd:c5:ee:96:6d,3169936,2512,4620,3167424,3169936
674,4,1,1,2412,-82,-89,7,bc:98:df:ff:0f:8b,3173758,2568,1254,3171190,3173758
675,6,6,1,2412,-81,-89,8,52:86:8c:5f:93:1e,3176881,332,2791,3176549,3176881
676,4,11,1,2412,-80,-89,9,48:dd:0c:7d:86:27,3182420,362,5177,3182058,3182420
677,4,11,1,2412,-80,-89,9,48:dd:0c:7d:86:23,3182794,323,51,3182471,3182794
678,4,11,1,2412,-80,-89,9,48:dd:0c:7d:86:25,3183129,382,-47,3182747,3183129
679,6,6,1,2412,-81,-89,8,10:86:8c:5f:93:1e,3204058,336,20593,3203722,3204058
680,4,1,1,2412,-86,-89,3,,3207094,448,2588,3206646,3207094
681,4,1,1,2412,-88,-89,1,ac:67:84:84:8a:07,3207562,416,52,3207146,3207562
682,4,1,1,2412,-86,-89,3,78:67:0e:38:6c:d3,3209326,2736,-972,3206590,3209326
683,4,1,1,2412,-86,-89,3,78:67:0e:38:6c:d3,3212118,848,1944,3211270,3212118
684,4,1,1,2412,-85,-89,4,3c:bd:c5:ad:f6:9e,3212977,1056,-197,3211921,3212977
685,4,11,1,2412,-83,-89,6,48:dd:0c:90:e3:85,3219041,382,5682,3218659,3219041
686,6,6,1,2412,-77,-89,12,f8:4f:ad:f9:af:82,3220220,156,1023,3220064,3220220
687,4,1,1,2412,-84,-89,5,78:67:0e:c4:a8:42,3220613,2736,-2343,3217877,3220613
688,6,6,1,2412,-76,-89,13,e0:db:d1:d0:b0:48,3223487,156,2718,3223331,3223487
689,6,6,1,2412,-79,-89,10,12:86:8c:5f:93:1e,3228409,332,4590,3228077,3228409
690,4,1,1,2412,-87,-89,2,ac:67:84:84:8a:07,3229087,416,262,3228671,3229087
691,4,1,1,2412,-90,-89,-1,,3229516,304,125,3229212,3229516
692,4,1,1,2412,-85,-89,4,,3230265,448,301,3229817,3230265
693,6,6,1,2412,-76,-89,13,f8:4f:ad:f9:af:82,3231703,196,1242,3231507,3231703
694,4,1,1,2412,-87,-89,2,ac:67:84:84:8a:07,3232630,416,511,3232214,3232630
695,4,1,1,2412,-90,-89,-1,,3233059,304,125,3232755,3233059
696,6,6,1,2412,-77,-89,12,f8:4f:ad:f9:af:82,3234830,156,1615,3234674,3234830
697,6,6,1,2412,-80,-89,9,32:86:8c:5f:93:1e,3253423,332,18261,3253091,3253423
698,6,6,1,2412,-76,-89,13,f8:4f:ad:f9:af:82,3254462,656,383,3253806,3254462
699,4,1,1,2412,-87,-89,2,ac:67:84:84:8a:07,3256344,416,1466,3255928,3256344
700,6,6,1,2412,-77,-89,12,f8:4f:ad:f9:af:82,3257356,632,380,3256724,3257356
701,4,1,1,2412,-85,-89,4,b4:b5:2f:17:0c:b9,3260044,1376,1312,3258668,3260044
702,6,6,1,2412,-76,-89,13,e2:db:d1:d1:b0:4a,3261303,444,815,3260859,3261303
703,6,6,1,2412,-77,-89,12,e2:db:d1:d1:b0:4b,3261780,408,69,3261372,3261780
704,6,6,1,2412,-77,-89,12,e2:db:d1:d1:b0:4d,3262221,408,33,3261813,3262221
705,6,6,1,2412,-77,-89,12,e2:db:d1:d1:b0:4f,3262653,408,24,3262245,3262653
706,4,1,1,2412,-79,-89,10,3c:bd:c5:ee:96:6d,3272324,2512,7159,3269812,3272324
707,4,1,1,2412,-87,-89,2,ac:67:84:84:8a:07,3274859,416,2119,3274443,3274859
708,6,6,1,2412,-79,-89,10,52:86:8c:5f:93:1e,3279023,332,3832,3278691,3279023
709,4,11,1,2412,-80,-89,9,48:dd:0c:7d:86:27,3284819,362,5434,3284457,3284819
710,4,11,1,2412,-79,-89,10,48:dd:0c:7d:86:23,3285194,323,52,3284871,3285194
711,4,11,1,2412,-80,-89,9,48:dd:0c:7d:86:25,3285529,382,-47,3285147,3285529
712,4,11,1,2412,-79,-89,10,48:dd:0c:7d:86:23,3288871,254,3088,3288617,3288871
713,4,11,1,2412,-82,-89,7,48:dd:0c:90:e3:83,3289471,254,346,3289217,3289471
714,4,1,1,2412,-88,-89,1,ac:67:84:84:8a:07,3292551,416,2664,3292135,3292551
715,6,6,1,2412,-80,-89,9,10:86:8c:5f:93:1e,3304696,336,11809,3304360,3304696
716,6,6,1,2412,-79,-89,10,b4:e6:2d:b4:ff:71,3306208,64,1448,3306144,3306208
717,6,6,1,2412,-80,-89,9,b4:e6:2d:b4:ff:71,3306469,64,197,3306405,3306469
718,6,6,1,2412,-79,-89,10,b4:e6:2d:b4:ff:71,3306685,64,152,3306621,3306685
719,6,6,1,2412,-80,-89,9,b4:e6:2d:b4:ff:71,3306892,64,143,3306828,3306892
720,4,1,1,2412,-84,-89,5,,3307828,304,632,3307524,3307828
721,4,1,1,2412,-84,-89,5,,3309101,304,969,3308797,3309101
722,4,11,1,2412,-76,-89,13,48:dd:0c:90:e3:83,3321105,323,11681,3320782,3321105
723,4,11,1,2412,-84,-89,5,48:dd:0c:90:e3:85,3321440,382,-47,3321058,3321440
724,4,1,1,2412,-85,-89,4,78:67:0e:c4:a8:42,3327181,2736,3005,3324445,3327181
725,6,6,1,2412,-76,-89,13,f8:4f:ad:f9:af:82,3330815,248,3386,3330567,3330815
726,6,6,1,2412,-80,-89,9,12:86:8c:5f:93:1e,3332187,332,1040,3331855,3332187
727,6,6,1,2412,-76,-89,13,f8:4f:ad:f9:af:82,3333650,224,1239,3333426,3333650
728,4,1,1,2412,-89,-89,0,00:26:62:eb:ea:74,3336077,968,1459,3335109,3336077
729,4,1,1,2412,-85,-89,4,,3342891,304,6510,3342587,3342891
730,4,1,1,2412,-88,-89,1,ce:9e:43:bc:eb:ff,3350312,3800,3621,3346512,3350312
731,4,1,1,2412,-90,-89,-1,b4:b5:2f:17:0c:b9,3362437,1376,10749,3361061,3362437
732,6,6,1,2412,-76,-89,13,e2:db:d1:d1:b0:4a,3363678,444,797,3363234,3363678
733,6,6,1,2412,-77,-89,12,e2:db:d1:d1:b0:4b,3364146,408,60,3363738,3364146
734,6,6,1,2412,-76,-89,13,e2:db:d1:d1:b0:4d,3364578,408,24,3364170,3364578
735,6,6,1,2412,-77,-89,12,e2:db:d1:d1:b0:4f,3365010,408,24,3364602,3365010
736,4,1,1,2412,-85,-89,4,,3370207,304,4893,3369903,3370207
737,4,1,1,2412,-81,-89,8,3c:bd:c5:ee:96:6d,3374621,2512,1902,3372109,3374621
738,6,6,1,2412,-78,-89,11,52:86:8c:5f:93:1e,3381423,332,6470,3381091,3381423
739,4,11,1,2412,-79,-89,10,48:dd:0c:7d:86:27,3387219,362,5434,3386857,3387219
740,4,11,1,2412,-79,-89,10,48:dd:0c:7d:86:23,3387594,323,52,3387271,3387594
741,4,11,1,2412,-80,-89,9,48:dd:0c:7d:86:25,3387929,382,-47,3387547,3387929
742,6,6,1,2412,-79,-89,10,10:86:8c:5f:93:1e,3407133,336,18868,3406797,3407133
743,4,1,1,2412,-82,-89,7,,3410089,304,2652,3409785,3410089
744,4,1,1,2412,-85,-89,4,78:67:0e:38:6c:d3,3414040,2736,1215,3411304,3414040
745,4,1,1,2412,-85,-89,4,,3419105,448,4617,3418657,3419105
746,4,1,1,2412,-84,-89,5,78:67:0e:c4:a8:42,3425413,2736,3572,3422677,3425413
747,6,6,1,2412,-81,-89,8,12:86:8c:5f:93:1e,3432624,332,6879,3432292,3432624
748,4,1,1,2412,-78,-89,11,b0:e4:d5:32:ec:8a,3447130,1960,12546,3445170,3447130
749,4,11,1,2412,-83,-89,6,,3450440,107,3203,3450333,3450440
750,4,1,1,2412,-83,-89,6,,3451079,352,287,3450727,3451079
751,4,11,1,2412,-84,-89,5,,3453074,107,1888,3452967,3453074
752,4,1,1,2412,-85,-89,4,,3453719,352,293,3453367,3453719
753,6,6,1,2412,-81,-89,8,32:86:8c:5f:93:1e,3458224,332,4173,3457892,3458224
754,4,1,1,2412,-83,-89,6,ac:67:84:84:8a:07,3460201,416,1561,3459785,3460201
755,4,1,1,2412,-81,-89,8,b4:b5:2f:17:0c:b9,3464838,1376,3261,3463462,3464838
756,6,6,1,2412,-76,-89,13,e2:db:d1:d1:b0:4d,3467033,408,1787,3466625,3467033
757,4,1,1,2412,-82,-89,7,,3475633,304,8296,3475329,3475633
758,4,1,1,2412,-78,-89,11,3c:bd:c5:ee:96:6d,3477028,2512,-1117,3474516,3477028
759,4,1,1,2412,-89,-89,0,bc:98:df:ff:0f:8b,3480597,2568,1001,3478029,3480597
760,6,6,1,2412,-81,-89,8,52:86:8c:5f:93:1e,3483998,332,3069,3483666,3483998
761,4,11,1,2412,-80,-89,9,48:dd:0c:7d:86:27,3489619,362,5259,3489257,3489619
762,4,11,1,2412,-78,-89,11,48:dd:0c:7d:86:23,3489993,323,51,3489670,3489993
763,4,11,1,2412,-80,-89,9,48:dd:0c:7d:86:25,3490329,382,-46,3489947,3490329
764,6,6,1,2412,-79,-89,10,b4:e6:2d:b4:ff:71,3490599,64,206,3490535,3490599
765,6,6,1,2412,-81,-89,8,,3490679,44,36,3490635,3490679
766,4,11,1,2412,-84,-89,5,,3500780,107,9994,3500673,3500780
767,4,1,1,2412,-83,-89,6,1c:f2:9a:10:7c:14,3501468,2360,-1672,3499108,3501468
768,4,1,1,2412,-84,-89,5,1c:f2:9a:10:7c:14,3503839,2520,-149,3501319,3503839
769,6,6,1,2412,-81,-89,8,10:86:8c:5f:93:1e,3513914,336,9739,3513578,3513914
770,4,1,1,2412,-87,-89,2,,3515405,448,1043,3514957,3515405
771,4,1,1,2412,-89,-89,0,,3515911,384,122,3515527,3515911
772,4,1,1,2412,-88,-89,1,,3516309,448,-50,3515861,3516309
773,4,11,1,2412,-85,-89,4,,3527751,107,11335,3527644,3527751
774,4,1,1,2412,-85,-89,4,78:67:0e:c4:a8:42,3527974,2736,-2513,3525238,3527974
775,4,1,1,2412,-83,-89,6,1c:f2:9a:33:8c:d5,3530774,1664,1136,3529110,3530774
776,4,11,1,2412,-83,-89,6,,3532568,107,1687,3532461,3532568
777,4,1,1,2412,-85,-89,4,1c:f2:9a:33:8c:d5,3533258,3960,-3270,3529298,3533258
778,4,1,1,2412,-84,-89,5,1c:f2:9a:33:8c:d5,3537229,2656,1315,3534573,3537229
779,6,6,1,2412,-80,-89,9,12:86:8c:5f:93:1e,3539740,332,2179,3539408,3539740
780,4,1,1,2412,-85,-89,4,1c:f2:9a:33:8c:d5,3540361,4120,-3499,3536241,3540361
781,4,1,1,2412,-83,-89,6,1c:f2:9a:33:8c:d5,3544492,2816,1315,3541676,3544492
782,4,1,1,2412,-77,-89,12,b0:e4:d5:32:ec:8a,3549530,1960,3078,3547570,3549530
783,6,6,1,2412,-81,-89,8,32:86:8c:5f:93:1e,3560625,332,10763,3560293,3560625
784,6,6,1,2412,-78,-89,11,e2:db:d1:d1:b0:4d,3569392,408,8359,3568984,3569392
785,6,6,1,2412,-76,-89,13,e2:db:d1:d1:b0:4f,3569824,408,24,3569416,3569824
786,4,1,1,2412,-88,-89,1,ce:9e:43:bc:eb:ff,3571494,3800,-2130,3567694,3571494
787,4,1,1,2412,-79,-89,10,3c:bd:c5:ee:96:6d,3580483,2512,6477,3577971,3580483
788,4,1,1,2412,-87,-89,2,bc:98:df:ff:0f:8b,3582996,2568,-55,3580428,3582996
789,6,6,1,2412,-80,-89,9,52:86:8c:5f:93:1e,3586225,332,2897,3585893,3586225
790,4,11,1,2412,-80,-89,9,48:dd:0c:7d:86:27,3592019,362,5432,3591657,3592019
791,4,11,1,2412,-80,-89,9,48:dd:0c:7d:86:23,3592393,323,51,3592070,3592393
792,4,11,1,2412,-80,-89,9,48:dd:0c:7d:86:25,3592728,382,-47,3592346,3592728
793,4,11,1,2412,-88,-89,1,4c:01:43:d7:f3:29,3604210,361,11121,3603849,3604210
794,4,1,1,2412,-86,-89,3,ac:67:84:84:8a:07,3605915,416,1289,3605499,3605915
795,4,1,1,2412,-87,-89,2,,3606343,304,124,3606039,3606343
796,6,6,1,2412,-79,-89,10,10:86:8c:5f:93:1e,3611992,336,5313,3611656,3611992
797,4,1,1,2412,-86,-89,3,,3624559,352,12215,3624207,3624559
798,4,1,1,2412,-87,-89,2,ac:67:84:84:8a:07,3629706,416,4731,3629290,3629706
799,4,1,1,2412,-84,-89,5,78:67:0e:c4:a8:42,3630213,2736,-2229,3627477,3630213
800,6,6,1,2412,-81,-89,8,12:86:8c:5f:93:1e,3639238,332,8693,3638906,3639238
801,4,1,1,2412,-88,-89,1,00:26:62:eb:ea:74,3643279,968,3073,3642311,3643279
802,4,1,1,2412,-77,-89,12,b0:e4:d5:32:ec:8a,3651929,1960,6690,3649969,3651929
803,6,6,1,2412,-80,-89,9,32:86:8c:5f:93:1e,3663026,332,10765,3662694,3663026
804,4,1,1,2412,-84,-89,5,b4:b5:2f:17:0c:b9,3669631,1376,5229,3668255,3669631
805,6,6,1,2412,-77,-89,12,e2:db:d1:d1:b0:4a,3673603,444,3528,3673159,3673603
806,6,6,1,2412,-76,-89,13,e2:db:d1:d1:b0:4d,3674529,408,518,3674121,3674529
807,6,6,1,2412,-77,-89,12,e2:db:d1:d1:b0:4f,3674979,408,42,3674571,3674979
808,4,1,1,2412,-79,-89,10,3c:bd:c5:ee:96:6d,3682568,2512,5077,3680056,3682568
809,6,6,1,2412,-80,-89,9,52:86:8c:5f:93:1e,3688626,332,5726,3688294,3688626
810,4,11,1,2412,-81,-89,8,48:dd:0c:7d:86:27,3694418,362,5430,3694056,3694418
811,4,11,1,2412,-80,-89,9,48:dd:0c:7d:86:23,3694793,323,52,3694470,3694793
812,4,11,1,2412,-80,-89,9,48:dd:0c:7d:86:25,3695128,382,-47,3694746,3695128
813,4,1,1,2412,-89,-89,0,bc:98:df:ff:0f:8b,3708872,3176,10568,3705696,3708872
814,4,1,1,2412,-87,-89,2,bc:98:df:ff:0f:8b,3712901,3176,853,3709725,3712901
815,6,6,1,2412,-80,-89,9,10:86:8c:5f:93:1e,3716247,336,3010,3715911,3716247
816,6,6,1,2412,-76,-89,13,f8:4f:ad:f9:af:82,3721868,576,5045,3721292,3721868
817,6,6,1,2412,-76,-89,13,f8:4f:ad:f9:af:82,3725419,548,3003,3724871,3725419
818,4,11,1,2412,-77,-89,12,48:dd:0c:90:e3:83,3730704,323,4962,3730381,3730704
819,4,1,1,2412,-84,-89,5,78:67:0e:c4:a8:42,3732613,2736,-827,3729877,3732613
820,6,6,1,2412,-79,-89,10,12:86:8c:5f:93:1e,3740214,332,7269,3739882,3740214
821,6,6,1,2412,-81,-89,8,32:86:8c:5f:93:1e,3765435,332,24889,3765103,3765435
822,4,1,1,2412,-85,-89,4,b4:b5:2f:17:0c:b9,3772033,1376,5222,3770657,3772033
823,6,6,1,2412,-76,-89,13,e2:db:d1:d1:b0:4a,3773301,444,824,3772857,3773301
824,6,6,1,2412,-77,-89,12,e2:db:d1:d1:b0:4b,3773787,408,78,3773379,3773787
825,6,6,1,2412,-77,-89,12,e2:db:d1:d1:b0:4d,3774246,408,51,3773838,3774246
826,6,6,1,2412,-77,-89,12,e2:db:d1:d1:b0:4f,3774687,408,33,3774279,3774687
827,4,1,1,2412,-89,-89,0,,3778263,304,3272,3777959,3778263
828,4,1,1,2412,-78,-89,11,3c:bd:c5:ee:96:6d,3784225,2512,3450,3781713,3784225
829,4,1,1,2412,-87,-89,2,bc:98:df:ff:0f:8b,3787805,2568,1012,3785237,3787805
830,6,6,1,2412,-80,-89,9,52:86:8c:5f:93:1e,3791168,332,3031,3790836,3791168
831,4,1,1,2412,-89,-89,0,ce:9e:43:bc:eb:ff,3792676,3800,-2292,3788876,3792676
832,4,11,1,2412,-90,-89,-1,6a:08:58:52:39:cc,3810149,358,17115,3809791,3810149
833,6,6,1,2412,-81,-89,8,10:86:8c:5f:93:1e,3818470,336,7985,3818134,3818470
834,4,1,1,2412,-86,-89,3,78:67:0e:38:6c:d3,3823641,2736,2435,3820905,3823641
835,4,11,1,2412,-86,-89,3,,3842073,107,18325,3841966,3842073
836,6,6,1,2412,-80,-89,9,12:86:8c:5f:93:1e,3842227,332,-178,3841895,3842227
837,4,11,1,2412,-84,-89,5,,3843165,107,831,3843058,3843165
838,4,1,1,2412,-84,-89,5,,3843786,352,269,3843434,3843786
839,4,1,1,2412,-84,-89,5,,3846275,352,2137,3845923,3846275
840,4,1,1,2412,-78,-89,11,b0:e4:d5:32:ec:8a,3856728,1960,8493,3854768,3856728
841,6,6,1,2412,-80,-89,9,32:86:8c:5f:93:1e,3867896,332,10836,3867564,3867896
842,4,1,1,2412,-85,-89,4,b4:b5:2f:17:0c:b9,3874435,1376,5163,3873059,3874435
843,6,6,1,2412,-76,-89,13,e2:db:d1:d1:b0:4a,3875685,444,806,3875241,3875685
844,6,6,1,2412,-77,-89,12,e2:db:d1:d1:b0:4b,3876180,408,87,3875772,3876180
845,6,6,1,2412,-77,-89,12,e2:db:d1:d1:b0:4d,3876621,408,33,3876213,3876621
846,6,6,1,2412,-76,-89,13,e2:db:d1:d1:b0:4f,3877062,408,33,3876654,3877062
847,4,1,1,2412,-79,-89,10,3c:bd:c5:ee:96:6d,3881547,432,4053,3881115,3881547
848,4,1,1,2412,-83,-89,6,,3881989,304,138,3881685,3881989
849,6,6,1,2412,-81,-89,8,,3882142,44,109,3882098,3882142
850,4,1,1,2412,-79,-89,10,3c:bd:c5:ee:96:6d,3887322,2520,2660,3884802,3887322
851,6,6,1,2412,-79,-89,10,52:86:8c:5f:93:1e,3893427,332,5773,3893095,3893427
852,4,11,1,2412,-80,-89,9,48:dd:0c:7d:86:27,3899219,362,5430,3898857,3899219
853,4,11,1,2412,-80,-89,9,48:dd:0c:7d:86:23,3899594,323,52,3899271,3899594
854,4,11,1,2412,-80,-89,9,48:dd:0c:7d:86:25,3899929,382,-47,3899547,3899929
855,4,1,1,2412,-87,-89,2,c8:9e:43:bc:eb:ff,3906878,3496,3453,3903382,3906878
856,6,6,1,2412,-80,-89,9,10:86:8c:5f:93:1e,3919028,336,11814,3918692,3919028
857,4,1,1,2412,-88,-89,1,78:67:0e:38:6c:d3,3926041,2736,4277,3923305,3926041
858,4,11,1,2412,-83,-89,6,48:dd:0c:90:e3:85,3935839,382,9416,3935457,3935839
859,4,1,1,2412,-85,-89,4,78:67:0e:c4:a8:42,3937412,2736,-1163,3934676,3937412
860,6,6,1,2412,-80,-89,9,12:86:8c:5f:93:1e,3944628,332,6884,3944296,3944628
861,4,1,1,2412,-84,-89,5,,3955884,352,10904,3955532,3955884
862,4,11,1,2412,-86,-89,3,,3957529,107,1538,3957422,3957529
863,4,1,1,2412,-79,-89,10,b0:e4:d5:32:ec:8a,3959127,1960,-362,3957167,3959127
864,4,1,1,2412,-84,-89,5,,3967337,352,7858,3966985,3967337
865,4,1,1,2412,-86,-89,3,,3968201,352,512,3967849,3968201
866,6,6,1,2412,-78,-89,11,32:86:8c:5f:93:1e,3970425,332,1892,3970093,3970425
867,4,1,1,2412,-86,-89,3,ac:67:84:84:8a:07,3972644,416,1803,3972228,3972644
868,6,6,1,2412,-76,-89,13,f8:4f:ad:f9:af:82,3974172,576,952,3973596,3974172
869,6,6,1,2412,-76,-89,13,f8:4f:ad:f9:af:82,3976352,548,1632,3975804,3976352
870,6,6,1,2412,-77,-89,12,e2:db:d1:d1:b0:4a,3978086,444,1290,3977642,3978086
871,6,6,1,2412,-76,-89,13,e2:db:d1:d1:b0:4b,3978581,408,87,3978173,3978581
872,6,6,1,2412,-77,-89,12,e2:db:d1:d1:b0:4d,3979021,408,32,3978613,3979021
873,4,1,1,2412,-88,-89,1,60:32:b1:64:4c:f2,3981461,3224,-784,3978237,3981461
874,4,1,1,2412,-79,-89,10,3c:bd:c5:ee:96:6d,3989318,2520,5337,3986798,3989318
875,4,1,1,2412,-88,-89,1,bc:98:df:ff:0f:8b,3992494,2568,608,3989926,3992494
876,6,6,1,2412,-79,-89,10,52:86:8c:5f:93:1e,3995828,332,3002,3995496,3995828
877,4,11,1,2412,-79,-89,10,48:dd:0c:7d:86:27,4001619,362,5429,4001257,4001619
878,4,11,1,2412,-79,-89,10,48:dd:0c:7d:86:23,4001993,323,51,4001670,4001993
879,4,11,1,2412,-78,-89,11,48:dd:0c:7d:86:25,4002329,382,-46,4001947,4002329
880,6,24,1,2412,-82,-89,7,,4014811,28,12454,4014783,4014811
881,6,6,1,2412,-79,-89,10,10:86:8c:5f:93:1e,4023279,336,8132,4022943,4023279
882,4,1,1,2412,-87,-89,2,78:67:0e:38:6c:d3,4028441,2736,2426,4025705,4028441
883,4,11,1,2412,-78,-89,11,48:dd:0c:90:e3:83,4037903,323,9139,4037580,4037903
884,4,11,1,2412,-83,-89,6,48:dd:0c:90:e3:85,4038239,382,-46,4037857,4038239
885,4,1,1,2412,-85,-89,4,78:67:0e:c4:a8:42,4039812,2736,-1163,4037076,4039812
886,6,6,1,2412,-81,-89,8,12:86:8c:5f:93:1e,4047028,332,6884,4046696,4047028
887,4,1,1,2412,-86,-89,3,ac:67:84:84:8a:07,4055979,416,8535,4055563,4055979
888,4,1,1,2412,-78,-89,11,b0:e4:d5:32:ec:8a,4061526,1960,3587,4059566,4061526
889,6,6,1,2412,-80,-89,9,32:86:8c:5f:93:1e,4072628,332,10770,4072296,4072628
890,4,1,1,2412,-84,-89,5,b4:b5:2f:17:0c:b9,4079238,1376,5234,4077862,4079238
891,6,6,1,2412,-77,-89,12,e2:db:d1:d1:b0:4a,4080497,444,815,4080053,4080497
892,6,6,1,2412,-76,-89,13,e2:db:d1:d1:b0:4b,4080993,408,88,4080585,4080993
893,6,6,1,2412,-77,-89,12,e2:db:d1:d1:b0:4d,4081424,408,23,4081016,4081424
894,6,6,1,2412,-77,-89,12,e2:db:d1:d1:b0:4f,4081856,408,24,4081448,4081856
895,4,1,1,2412,-89,-89,0,ce:f4:11:65:3f:f8,4083412,2072,-516,4081340,4083412
896,4,1,1,2412,-88,-89,1,0e:b9:49:67:a0:d6,4087076,416,3248,4086660,4087076
897,4,1,1,2412,-88,-89,1,,4089145,448,1621,4088697,4089145
898,4,1,1,2412,-79,-89,10,3c:bd:c5:ee:96:6d,4091418,2520,-247,4088898,4091418
899,6,24,1,2412,-82,-89,7,,4093783,28,2337,4093755,4093783
900,4,1,1,2412,-86,-89,3,bc:98:df:ff:0f:8b,4095237,2568,-1114,4092669,4095237
901,4,1,1,2412,-84,-89,5,,4098165,352,2576,4097813,4098165
902,6,6,1,2412,-80,-89,9,52:86:8c:5f:93:1e,4099164,332,667,4098832,4099164
903,6,24,1,2412,-82,-89,7,,4105360,28,6168,4105332,4105360
904,4,1,1,2412,-89,-89,0,bc:98:df:ff:0f:8b,4119780,3176,11244,4116604,4119780
905,4,1,1,2412,-86,-89,3,ac:67:84:84:8a:07,4122896,416,2700,4122480,4122896
906,4,1,1,2412,-88,-89,1,d8:a0:11:10:f3:bc,4133633,832,9905,4132801,4133633
907,6,6,1,2412,-77,-89,12,10:86:8c:5f:93:1e,4135214,336,1245,4134878,4135214
908,4,1,1,2412,-83,-89,6,,4140984,352,5418,4140632,4140984
909,4,1,1,2412,-84,-89,5,78:67:0e:c4:a8:42,4142212,2736,-1508,4139476,4142212
910,4,11,1,2412,-83,-89,6,,4145603,203,3188,4145400,4145603
911,4,1,1,2412,-86,-89,3,,4146644,352,689,4146292,4146644
912,6,6,1,2412,-81,-89,8,12:86:8c:5f:93:1e,4149429,332,2453,4149097,4149429
913,4,1,1,2412,-78,-89,11,b0:e4:d5:32:ec:8a,4163926,1960,12537,4161966,4163926
914,4,1,1,2412,-85,-89,4,,4174641,304,10411,4174337,4174641
915,6,6,1,2412,-79,-89,10,32:86:8c:5f:93:1e,4175097,332,124,4174765,4175097
916,4,1,1,2412,-85,-89,4,,4178137,304,2736,4177833,4178137
917,4,1,1,2412,-85,-89,4,ac:67:84:84:8a:07,4178465,416,-88,4178049,4178465
918,4,1,1,2412,-84,-89,5,ac:67:84:84:8a:07,4179805,416,924,4179389,4179805
919,4,1,1,2412,-85,-89,4,b4:b5:2f:17:0c:b9,4181640,1376,459,4180264,4181640
920,4,1,1,2412,-79,-89,10,3c:bd:c5:ee:96:6d,4193813,2520,9653,4191293,4193813
921,4,1,1,2412,-85,-89,4,bc:98:df:ff:0f:8b,4197619,2568,1238,4195051,4197619
922,6,6,1,2412,-80,-89,9,52:86:8c:5f:93:1e,4200630,332,2679,4200298,4200630
923,4,11,1,2412,-79,-89,10,48:dd:0c:7d:86:27,4206418,362,5426,4206056,4206418
924,4,11,1,2412,-79,-89,10,48:dd:0c:7d:86:23,4206793,323,52,4206470,4206793
925,4,11,1,2412,-79,-89,10,48:dd:0c:7d:86:25,4207128,382,-47,4206746,4207128
926,4,1,1,2412,-83,-89,6,,4221699,304,14267,4221395,4221699
927,4,1,1,2412,-86,-89,3,ac:67:84:84:8a:07,4223136,416,1021,4222720,4223136
928,6,6,1,2412,-76,-89,13,f8:4f:ad:f9:af:82,4224640,576,928,4224064,4224640
929,6,6,1,2412,-77,-89,12,f8:4f:ad:f9:af:82,4225940,548,752,4225392,4225940
930,6,6,1,2412,-80,-89,9,10:86:8c:5f:93:1e,4228431,336,2155,4228095,4228431
931,4,11,1,2412,-80,-89,9,10:86:8c:5f:93:26,4229056,347,278,4228709,4229056
932,6,6,1,2412,-79,-89,10,b4:e6:2d:b4:ff:71,4230330,64,1210,4230266,4230330
933,6,6,1,2412,-80,-89,9,b4:e6:2d:b4:ff:71,4230600,64,206,4230536,4230600
934,6,6,1,2412,-79,-89,10,,4230681,44,37,4230637,4230681
935,4,1,1,2412,-88,-89,1,78:67:0e:38:6c:d3,4233241,2736,-176,4230505,4233241
936,4,11,1,2412,-83,-89,6,,4236296,107,2948,4236189,4236296
937,4,11,1,2412,-78,-89,11,48:dd:0c:90:e3:83,4242703,323,6084,4242380,4242703
938,6,6,1,2412,-80,-89,9,12:86:8c:5f:93:1e,4251844,332,8809,4251512,4251844
939,6,6,1,2412,-81,-89,8,ac:4c:a5:42:0b:8e,4254077,212,2021,4253865,4254077
940,4,1,1,2412,-80,-89,9,3c:bd:c5:ee:96:6d,4259496,3280,2139,4256216,4259496
941,4,1,1,2412,-80,-89,9,,4262788,304,2988,4262484,4262788
942,6,6,1,2412,-78,-89,11,f8:4f:ad:f9:af:82,4263065,656,-379,4262409,4263065
943,6,6,1,2412,-77,-89,12,f8:4f:ad:f9:af:82,4263772,632,75,4263140,4263772
944,4,1,1,2412,-78,-89,11,b0:e4:d5:32:ec:8a,4266360,1960,628,4264400,4266360
945,4,1,1,2412,-84,-89,5,,4270635,304,3971,4270331,4270635
946,4,11,1,2412,-85,-89,4,,4272770,107,2028,4272663,4272770
947,4,1,1,2412,-85,-89,4,,4277545,304,4471,4277241,4277545
948,6,24,1,2412,-84,-89,5,,4278057,28,484,4278029,4278057
949,4,1,1,2412,-85,-89,4,,4279061,352,652,4278709,4279061
950,6,6,1,2412,-81,-89,8,ac:4c:a5:42:0b:8e,4279332,212,59,4279120,4279332
951,4,1,1,2412,-84,-89,5,b4:b5:2f:17:0c:b9,4284717,1376,4009,4283341,4284717
952,6,6,1,2412,-77,-89,12,e2:db:d1:d1:b0:4a,4285959,444,798,4285515,4285959
953,6,6,1,2412,-77,-89,12,e2:db:d1:d1:b0:4b,4286426,408,59,4286018,4286426
954,6,6,1,2412,-77,-89,12,e2:db:d1:d1:b0:4d,4286885,408,51,4286477,4286885
955,4,11,1,2412,-80,-89,9,48:dd:0c:7d:86:27,4308818,362,21571,4308456,4308818
956,4,11,1,2412,-79,-89,10,48:dd:0c:7d:86:23,4309193,323,52,4308870,4309193
957,4,11,1,2412,-80,-89,9,48:dd:0c:7d:86:25,4309528,382,-47,4309146,4309528
958,4,1,1,2412,-87,-89,2,,4316660,304,6828,4316356,4316660
959,6,6,1,2412,-79,-89,10,10:86:8c:5f:93:1e,4330623,336,13627,4330287,4330623
960,4,1,1,2412,-87,-89,2,,4333990,304,3063,4333686,4333990
961,6,24,1,2412,-83,-89,6,,4334220,28,202,4334192,4334220
962,4,11,1,2412,-78,-89,11,48:dd:0c:90:e3:83,4345103,323,10560,4344780,4345103
963,4,11,1,2412,-82,-89,7,48:dd:0c:90:e3:85,4345438,382,-47,4345056,4345438
964,4,1,1,2412,-87,-89,2,c8:9e:43:bc:eb:ff,4349714,3496,780,4346218,4349714
965,4,11,1,2412,-79,-89,10,48:dd:0c:7d:86:25,4354737,377,4646,4354360,4354737
966,6,24,1,2412,-84,-89,5,,4357623,28,2858,4357595,4357623
967,4,1,1,2412,-85,-89,4,,4361138,304,3211,4360834,4361138
968,6,6,1,2412,-81,-89,8,12:86:8c:5f:93:1e,4361298,332,-172,4360966,4361298
969,4,1,1,2412,-85,-89,4,ac:67:84:84:8a:07,4364437,416,2723,4364021,4364437
970,4,1,1,2412,-78,-89,11,b0:e4:d5:32:ec:8a,4368724,1960,2327,4366764,4368724
971,4,1,1,2412,-85,-89,4,,4381181,304,12153,4380877,4381181
972,4,1,1,2412,-84,-89,5,b4:b5:2f:17:0c:b9,4386443,1376,3886,4385067,4386443
973,6,6,1,2412,-76,-89,13,e2:db:d1:d1:b0:4a,4387676,444,789,4387232,4387676
974,6,6,1,2412,-77,-89,12,e2:db:d1:d1:b0:4b,4388143,408,59,4387735,4388143
975,6,6,1,2412,-77,-89,12,e2:db:d1:d1:b0:4d,4388593,408,42,4388185,4388593
976,6,6,1,2412,-77,-89,12,e2:db:d1:d1:b0:4f,4389034,408,33,4388626,4389034
977,4,1,1,2412,-79,-89,10,3c:bd:c5:ee:96:6d,4398671,2520,7117,4396151,4398671
978,6,24,1,2412,-83,-89,6,,4406338,28,7639,4406310,4406338
979,6,6,1,2412,-81,-89,8,52:86:8c:5f:93:1e,4406398,332,-272,4406066,4406398
980,4,11,1,2412,-80,-89,9,48:dd:0c:7d:86:27,4411218,362,4458,4410856,4411218
981,4,11,1,2412,-80,-89,9,48:dd:0c:7d:86:23,4411592,323,51,4411269,4411592
982,4,11,1,2412,-81,-89,8,48:dd:0c:7d:86:25,4411928,382,-46,4411546,4411928
983,6,6,1,2412,-79,-89,10,b4:e6:2d:b4:ff:71,4412479,64,487,4412415,4412479
984,6,6,1,2412,-79,-89,10,,4412559,44,36,4412515,4412559
985,6,24,1,2412,-83,-89,6,,4413784,28,1197,4413756,4413784
986,6,24,1,2412,-83,-89,6,,4425021,28,11209,4424993,4425021
987,6,6,1,2412,-79,-89,10,10:86:8c:5f:93:1e,4431031,336,5674,4430695,4431031
988,6,24,1,2412,-82,-89,7,,4437592,28,6533,4437564,4437592
989,4,1,1,2412,-86,-89,3,78:67:0e:38:6c:d3,4438042,2736,-2286,4435306,4438042
990,4,1,1,2412,-88,-89,1,,4441198,384,2772,4440814,4441198
991,4,1,1,2412,-88,-89,1,,4441596,448,-50,4441148,4441596
992,4,11,1,2412,-78,-89,11,48:dd:0c:90:e3:83,4447502,323,5583,4447179,4447502
993,4,11,1,2412,-81,-89,8,48:dd:0c:90:e3:85,4447838,382,-46,4447456,4447838
994,4,1,1,2412,-86,-89,3,78:67:0e:c4:a8:42,4449411,2736,-1163,4446675,4449411
995,4,1,1,2412,-84,-89,5,b4:b5:2f:17:0c:b9,4488845,1376,38058,4487469,4488845
996,6,6,1,2412,-76,-89,13,e2:db:d1:d1:b0:4a,4490095,444,806,4489651,4490095
997,6,6,1,2412,-76,-89,13,e2:db:d1:d1:b0:4b,4490572,408,69,4490164,4490572
998,6,6,1,2412,-76,-89,13,e2:db:d1:d1:b0:4d,4491014,408,34,4490606,4491014
999,6,6,1,2412,-77,-89,12,e2:db:d1:d1:b0:4f,4491454,408,32,4491046,4491454
1000,4,1,1,2412,-78,-89,11,3c:bd:c5:ee:96:6d,4501012,2520,7038,4498492,4501012
1001,4,1,1,2412,-79,-89,10,b8:f8:53:cb:31:f1,4503603,976,1615,4502627,4503603
1002,6,6,1,2412,-83,-89,6,,4507183,44,3536,4507139,4507183
1003,6,6,1,2412,-80,-89,9,52:86:8c:5f:93:1e,4510465,332,2950,4510133,4510465
1004,4,1,1,2412,-84,-89,5,1c:f2:9a:33:8c:d5,4511154,1664,-975,4509490,4511154
1005,4,11,1,2412,-80,-89,9,48:dd:0c:7d:86:25,4514327,382,2791,4513945,4514327
1006,6,6,1,2412,-79,-89,10,10:86:8c:5f:93:1e,4535282,336,20619,4534946,4535282
1007,4,1,1,2412,-86,-89,3,78:67:0e:38:6c:d3,4540442,2736,2424,4537706,4540442
1008,4,11,1,2412,-81,-89,8,4c:01:43:ec:a0:63,4544633,322,3869,4544311,4544633
1009,4,11,1,2412,-78,-89,11,48:dd:0c:90:e3:87,4549528,362,4533,4549166,4549528
1010,4,11,1,2412,-76,-89,13,48:dd:0c:90:e3:83,4549902,323,51,4549579,4549902
1011,4,11,1,2412,-82,-89,7,48:dd:0c:90:e3:85,4550237,382,-47,4549855,4550237
1012,4,1,1,2412,-89,-89,0,,4551026,384,405,4550642,4551026
1013,4,1,1,2412,-87,-89,2,,4551425,448,-49,4550977,4551425
1014,4,1,1,2412,-83,-89,6,78:67:0e:c4:a8:42,4551811,2736,-2350,4549075,4551811
1015,4,11,1,2412,-78,-89,11,,4556108,203,4094,4555905,4556108
1016,6,6,1,2412,-79,-89,10,12:86:8c:5f:93:1e,4559032,332,2592,4558700,4559032
1017,4,1,1,2412,-90,-89,-1,d2:9e:43:bc:eb:ff,4566813,3600,4181,4563213,4566813
1018,6,6,1,2412,-80,-89,9,32:86:8c:5f:93:1e,4584669,332,17524,4584337,4584669
1019,6,24,1,2412,-82,-89,7,,4585071,28,374,4585043,4585071
1020,4,1,1,2412,-85,-89,4,b4:b5:2f:17:0c:b9,4591247,1376,4800,4589871,4591247
1021,6,6,1,2412,-76,-89,13,e2:db:d1:d1:b0:4a,4592506,444,815,4592062,4592506
1022,6,6,1,2412,-77,-89,12,e2:db:d1:d1:b0:4b,4592992,408,78,4592584,4592992
1023,6,6,1,2412,-77,-89,12,e2:db:d1:d1:b0:4d,4593442,408,42,4593034,4593442
1024,6,6,1,2412,-77,-89,12,e2:db:d1:d1:b0:4f,4593874,408,24,4593466,4593874
1025,4,1,1,2412,-79,-89,10,3c:bd:c5:ee:96:6d,4603425,2512,7039,4600913,4603425
1026,4,1,1,2412,-87,-89,2,bc:98:df:ff:0f:8b,4606916,2568,923,4604348,4606916
1027,6,6,1,2412,-81,-89,8,52:86:8c:5f:93:1e,4610233,332,2985,4609901,4610233
1028,4,11,1,2412,-80,-89,9,48:dd:0c:7d:86:27,4616017,362,5422,4615655,4616017
1029,4,11,1,2412,-80,-89,9,48:dd:0c:7d:86:23,4616392,323,52,4616069,4616392
1030,4,11,1,2412,-80,-89,9,48:dd:0c:7d:86:25,4616727,382,-47,4616345,4616727
1031,4,1,1,2412,-87,-89,2,68:54:fd:aa:49:4f,4624077,912,6438,4623165,4624077
1032,6,24,1,2412,-83,-89,6,,4626920,32,2811,4626888,4626920
1033,4,11,1,2412,-86,-89,3,,4629393,107,2366,4629286,4629393
1034,6,6,1,2412,-80,-89,9,10:86:8c:5f:93:1e,4635865,336,6136,4635529,4635865
1035,4,1,1,2412,-85,-89,4,,4640569,352,4352,4640217,4640569
1036,4,11,1,2412,-83,-89,6,,4642403,107,1727,4642296,4642403
1037,4,1,1,2412,-87,-89,2,78:67:0e:38:6c:d3,4642842,2736,-2297,4640106,4642842
1038,4,1,1,2412,-85,-89,4,,4645616,352,2422,4645264,4645616
1039,4,11,1,2412,-76,-89,13,48:dd:0c:90:e3:87,4651927,362,5949,4651565,4651927
1040,4,11,1,2412,-75,-89,14,48:dd:0c:90:e3:83,4652302,323,52,4651979,4652302
1041,4,1,1,2412,-85,-89,4,78:67:0e:c4:a8:42,4654211,2736,-827,4651475,4654211
1042,6,6,1,2412,-81,-89,8,12:86:8c:5f:93:1e,4661433,332,6890,4661101,4661433
1043,6,24,1,2412,-83,-89,6,,4670667,28,9206,4670639,4670667
1044,4,1,1,2412,-87,-89,2,68:54:fd:aa:49:4f,4671504,912,-75,4670592,4671504
1045,6,6,1,2412,-84,-89,5,,4673792,68,2220,4673724,4673792
1046,4,1,1,2412,-86,-89,3,ac:67:84:84:8a:07,4674660,416,452,4674244,4674660
1047,6,6,1,2412,-80,-89,9,32:86:8c:5f:93:1e,4687033,332,12041,4686701,4687033
1048,4,1,1,2412,-86,-89,3,b4:b5:2f:17:0c:b9,4693649,1376,5240,4692273,4693649
1049,6,6,1,2412,-76,-89,13,e2:db:d1:d1:b0:4a,4694899,444,806,4694455,4694899
1050,6,6,1,2412,-77,-89,12,e2:db:d1:d1:b0:4b,4695367,408,60,4694959,4695367
1051,6,6,1,2412,-77,-89,12,e2:db:d1:d1:b0:4d,4695808,408,33,4695400,4695808
1052,6,6,1,2412,-76,-89,13,e2:db:d1:d1:b0:4f,4696240,408,24,4695832,4696240
1053,4,1,1,2412,-78,-89,11,3c:bd:c5:ee:96:6d,4705811,2512,7059,4703299,4705811
1054,4,1,1,2412,-80,-89,9,bc:98:df:ff:0f:8b,4709405,2568,1026,4706837,4709405
1055,6,6,1,2412,-81,-89,8,52:86:8c:5f:93:1e,4712729,332,2992,4712397,4712729
1056,4,11,1,2412,-79,-89,10,48:dd:0c:7d:86:27,4718417,362,5326,4718055,4718417
1057,4,11,1,2412,-80,-89,9,48:dd:0c:7d:86:23,4718792,323,52,4718469,4718792
1058,4,11,1,2412,-80,-89,9,48:dd:0c:7d:86:25,4719127,382,-47,4718745,4719127
1059,4,1,1,2412,-86,-89,3,ac:67:84:84:8a:07,4727852,416,8309,4727436,4727852
1060,4,1,1,2412,-86,-89,3,ac:67:84:84:8a:07,4729103,416,835,4728687,4729103
1061,6,6,1,2412,-80,-89,9,10:86:8c:5f:93:1e,4740521,336,11082,4740185,4740521
1062,4,1,1,2412,-87,-89,2,78:67:0e:38:6c:d3,4745512,2736,2255,4742776,4745512
1063,4,1,1,2412,-85,-89,4,,4748822,448,2862,4748374,4748822
1064,4,11,1,2412,-85,-89,4,48:dd:0c:90:e3:85,4755037,382,5833,4754655,4755037
1065,4,1,1,2412,-81,-89,8,78:67:0e:c4:a8:42,4756611,2736,-1162,4753875,4756611
1066,4,11,1,2412,-80,-89,9,48:dd:0c:90:e3:83,4759400,254,2535,4759146,4759400
1067,4,11,1,2412,-78,-89,11,48:dd:0c:7d:86:23,4760274,254,620,4760020,4760274
1068,6,6,1,2412,-80,-89,9,12:86:8c:5f:93:1e,4763834,332,3228,4763502,4763834
1069,4,1,1,2412,-86,-89,3,,4776040,304,11902,4775736,4776040
1070,4,1,1,2412,-79,-89,10,b0:e4:d5:32:ec:8a,4778322,1960,322,4776362,4778322
1071,4,1,1,2412,-86,-89,3,ac:67:84:84:8a:07,4784001,416,5263,4783585,4784001
1072,4,1,1,2412,-89,-89,0,,4784429,304,124,4784125,4784429
1073,4,1,1,2412,-85,-89,4,68:54:fd:aa:49:4f,4784853,912,-488,4783941,4784853
1074,4,1,1,2412,-85,-89,4,b4:b5:2f:17:0c:b9,4796051,1376,9822,4794675,4796051
1075,6,6,1,2412,-77,-89,12,e2:db:d1:d1:b0:4b,4797751,408,1292,4797343,4797751
1076,6,6,1,2412,-77,-89,12,e2:db:d1:d1:b0:4d,4798183,408,24,4797775,4798183
1077,6,6,1,2412,-77,-89,12,e2:db:d1:d1:b0:4f,4798632,408,41,4798224,4798632
1078,4,1,1,2412,-89,-89,0,ce:f4:11:65:3f:f8,4800211,2072,-493,4798139,4800211
1079,4,1,1,2412,-77,-89,12,3c:bd:c5:ee:96:6d,4808221,2512,5498,4805709,4808221
1080,6,6,1,2412,-81,-89,8,52:86:8c:5f:93:1e,4815111,332,6558,4814779,4815111
1081,4,11,1,2412,-80,-89,9,48:dd:0c:7d:86:27,4820817,362,5344,4820455,4820817
1082,4,11,1,2412,-80,-89,9,48:dd:0c:7d:86:23,4821191,323,51,4820868,4821191
1083,4,11,1,2412,-79,-89,10,48:dd:0c:7d:86:25,4821527,382,-46,4821145,4821527
1084,4,1,1,2412,-87,-89,2,ac:67:84:84:8a:07,4821881,416,-62,4821465,4821881
1085,4,1,1,2412,-90,-89,-1,,4822310,304,125,4822006,4822310
1086,6,24,1,2412,-82,-89,7,,4823885,28,1547,4823857,4823885
1087,4,1,1,2412,-85,-89,4,78:67:0e:c4:a8:42,4827274,848,2541,4826426,4827274
1088,4,1,1,2412,-84,-89,5,ac:67:84:84:8a:07,4830361,416,2671,4829945,4830361
1089,6,24,1,2412,-82,-89,7,,4838490,28,8101,4838462,4838490
1090,6,6,1,2412,-79,-89,10,10:86:8c:5f:93:1e,4840717,336,1891,4840381,4840717
1091,4,1,1,2412,-77,-89,12,,4855540,304,14519,4855236,4855540
1092,4,11,1,2412,-76,-89,13,48:dd:0c:90:e3:83,4857101,323,1238,4856778,4857101
1093,4,11,1,2412,-84,-89,5,48:dd:0c:90:e3:85,4857437,382,-46,4857055,4857437
1094,4,1,1,2412,-85,-89,4,78:67:0e:c4:a8:42,4859237,2736,-936,4856501,4859237
1095,4,1,1,2412,-88,-89,1,ac:67:84:84:8a:07,4873955,416,14302,4873539,4873955
1096,4,1,1,2412,-89,-89,0,,4874383,304,124,4874079,4874383
1097,4,1,1,2412,-83,-89,6,,4875638,304,951,4875334,4875638
1098,4,1,1,2412,-79,-89,10,b0:e4:d5:32:ec:8a,4880721,1960,3123,4878761,4880721
1099,6,6,1,2412,-77,-89,12,f8:4f:ad:f9:af:82,4883233,156,2356,4883077,4883233
1100,6,6,1,2412,-80,-89,9,12:86:8c:5f:93:1e,4886935,332,3370,4886603,4886935
1101,6,6,1,2412,-76,-89,13,e0:db:d1:d0:b0:48,4890219,380,2904,4889839,4890219
1102,6,6,1,2412,-76,-89,13,e0:db:d1:d0:b0:48,4891078,384,475,4890694,4891078
1103,6,6,1,2412,-77,-89,12,e0:db:d1:d0:b0:48,4896968,392,5498,4896576,4896968
1104,4,1,1,2412,-84,-89,5,b4:b5:2f:17:0c:b9,4898452,1376,108,4897076,4898452
1105,6,6,1,2412,-77,-89,12,e2:db:d1:d1:b0:4a,4899693,444,797,4899249,4899693
1106,6,6,1,2412,-77,-89,12,e2:db:d1:d1:b0:4b,4900171,408,70,4899763,4900171
1107,6,6,1,2412,-77,-89,12,e2:db:d1:d1:b0:4d,4900620,408,41,4900212,4900620
1108,6,6,1,2412,-77,-89,12,e2:db:d1:d1:b0:4f,4901070,408,42,4900662,4901070
1109,4,1,1,2412,-85,-89,4,68:54:fd:aa:49:4f,4914848,912,12866,4913936,4914848
1110,6,6,1,2412,-80,-89,9,52:86:8c:5f:93:1e,4917474,332,2294,4917142,4917474
1111,4,11,1,2412,-80,-89,9,48:dd:0c:7d:86:27,4923217,362,5381,4922855,4923217
1112,4,11,1,2412,-80,-89,9,48:dd:0c:7d:86:23,4923591,323,51,4923268,4923591
1113,4,11,1,2412,-80,-89,9,48:dd:0c:7d:86:25,4923927,382,-46,4923545,4923927
1114,4,1,1,2412,-87,-89,2,ac:67:84:84:8a:07,4927861,416,3518,4927445,4927861
1115,4,1,1,2412,-85,-89,4,68:54:fd:aa:49:4f,4932489,2248,2380,4930241,4932489
1116,6,24,1,2412,-82,-89,7,,4935110,32,2589,4935078,4935110
1117,6,24,1,2412,-82,-89,7,,4935310,32,168,4935278,4935310
1118,4,1,1,2412,-86,-89,3,68:54:fd:df:ca:29,4936692,2248,-866,4934444,4936692
1119,6,24,1,2412,-83,-89,6,,4939283,32,2559,4939251,4939283
1120,4,11,1,2412,-88,-89,1,,4943348,203,3862,4943145,4943348
1121,6,6,1,2412,-79,-89,10,10:86:8c:5f:93:1e,4943453,336,-231,4943117,4943453
1122,4,1,1,2412,-85,-89,4,68:54:fd:df:ca:29,4945480,2144,-117,4943336,4945480
1123,4,11,1,2412,-86,-89,3,,4948655,207,2968,4948448,4948655
1124,4,1,1,2412,-85,-89,4,68:54:fd:df:ca:29,4949751,2144,-1048,4947607,4949751
1125,4,1,1,2412,-84,-89,5,78:67:0e:38:6c:d3,4952228,2736,-259,4949492,4952228
1126,4,1,1,2412,-84,-89,5,68:54:fd:df:ca:29,4960582,2144,6210,4958438,4960582
1127,4,1,1,2412,-85,-89,4,78:67:0e:c4:a8:42,4963435,2736,117,4960699,4963435
1128,4,11,1,2412,-85,-89,4,,4966312,207,2670,4966105,4966312
1129,4,1,1,2412,-85,-89,4,68:54:fd:df:ca:29,4966893,2144,-1563,4964749,4966893
1130,6,6,1,2412,-80,-89,9,12:86:8c:5f:93:1e,4969208,332,1983,4968876,4969208
1131,4,1,1,2412,-88,-89,1,68:54:fd:df:ca:29,4970313,2144,-1039,4968169,4970313
1132,4,11,1,2412,-85,-89,4,,4972911,207,2391,4972704,4972911
1133,4,1,1,2412,-87,-89,2,68:54:fd:df:ca:29,4973345,2144,-1710,4971201,4973345
1134,4,1,1,2412,-82,-89,7,ac:67:84:84:8a:07,4975775,416,2014,4975359,4975775
1135,4,1,1,2412,-82,-89,7,,4976255,304,176,4975951,4976255
1136,4,1,1,2412,-77,-89,12,00:26:62:eb:ea:74,4980103,968,2880,4979135,4980103
1137,4,1,1,2412,-80,-89,9,b0:e4:d5:32:ec:8a,4983120,1960,1057,4981160,4983120
1138,6,24,1,2412,-83,-89,6,,4990170,28,7022,4990142,4990170
1139,4,1,1,2412,-84,-89,5,,4991476,304,1002,4991172,4991476
1140,4,1,1,2412,-86,-89,3,68:54:fd:aa:49:4f,4991838,912,-550,4990926,4991838
1141,4,11,1,2412,-86,-89,3,,4993763,203,1722,4993560,4993763
1142,6,6,1,2412,-81,-89,8,32:86:8c:5f:93:1e,4994247,332,152,4993915,4994247
1143,4,11,1,2412,-85,-89,4,,4995102,207,648,4994895,4995102
1144,4,11,1,2412,-86,-89,3,,4996252,203,947,4996049,4996252
1145,4,1,1,2412,-84,-89,5,68:54:fd:aa:49:4f,4997282,912,118,4996370,4997282
1146,4,1,1,2412,-84,-89,5,b4:b5:2f:17:0c:b9,5000854,1376,2196,4999478,5000854
1147,6,6,1,2412,-77,-89,12,e2:db:d1:d1:b0:4a,5002096,444,798,5001652,5002096
1148,6,6,1,2412,-77,-89,12,e2:db:d1:d1:b0:4b,5002573,408,69,5002165,5002573
1149,6,6,1,2412,-77,-89,12,e2:db:d1:d1:b0:4d,5003005,408,24,5002597,5003005
1150,6,6,1,2412,-77,-89,12,e2:db:d1:d1:b0:4f,5003436,408,23,5003028,5003436
1151,6,6,1,2412,-80,-88,8,52:86:8c:5f:93:1e,5020350,332,16582,5020018,5020350
1152,4,1,1,2412,-85,-88,3,,5033658,352,12956,5033306,5033658
1153,4,1,1,2412,-84,-88,4,,5036217,352,2207,5035865,5036217
1154,4,1,1,2412,-85,-88,3,68:54:fd:aa:49:4f,5036856,912,-273,5035944,5036856
1155,4,1,1,2412,-89,-88,-1,ce:9e:43:bc:eb:ff,5041063,4512,-305,5036551,5041063
1156,6,6,1,2412,-80,-88,8,10:86:8c:5f:93:1e,5045663,336,4264,5045327,5045663
1157,4,1,1,2412,-83,-88,5,78:67:0e:c4:a8:42,5063810,2736,15411,5061074,5063810
1158,4,1,1,2412,-89,-88,-1,ac:67:84:84:8a:07,5074579,416,10353,5074163,5074579
1159,4,11,1,2412,-85,-88,3,,5078764,207,3978,5078557,5078764
1160,4,1,1,2412,-87,-88,1,68:54:fd:aa:49:4f,5079198,912,-478,5078286,5079198
1161,4,1,1,2412,-78,-88,10,b0:e4:d5:32:ec:8a,5085520,1960,4362,5083560,5085520
1162,6,6,1,2412,-80,-88,8,32:86:8c:5f:93:1e,5096636,332,10784,5096304,5096636
1163,4,1,1,2412,-84,-88,4,b4:b5:2f:17:0c:b9,5103256,1376,5244,5101880,5103256
1164,6,6,1,2412,-77,-88,11,e2:db:d1:d1:b0:4a,5104488,444,788,5104044,5104488
1165,6,6,1,2412,-76,-88,12,e2:db:d1:d1:b0:4b,5104965,408,69,5104557,5104965
1166,6,6,1,2412,-77,-88,11,e2:db:d1:d1:b0:4d,5105424,408,51,5105016,5105424
1167,6,6,1,2412,-77,-88,11,e2:db:d1:d1:b0:4f,5105856,408,24,5105448,5105856
1168,4,1,1,2412,-83,-88,5,,5111797,352,5589,5111445,5111797
1169,4,1,1,2412,-86,-88,2,ac:67:84:84:8a:07,5112561,416,348,5112145,5112561
1170,4,11,1,2412,-83,-88,5,,5113614,107,946,5113507,5113614
1171,4,1,1,2412,-80,-88,8,3c:bd:c5:ee:96:6d,5115426,2512,-700,5112914,5115426
1172,4,1,1,2412,-85,-88,3,68:54:fd:aa:49:4f,5118730,912,2392,5117818,5118730
1173,4,1,1,2412,-87,-88,1,,5126355,352,7273,5126003,5126355
1174,4,1,1,2412,-87,-88,1,,5127202,352,495,5126850,5127202
1175,4,11,1,2412,-80,-88,8,48:dd:0c:7d:86:27,5128016,362,452,5127654,5128016
1176,6,6,1,2412,-80,-88,8,10:86:8c:5f:93:1e,5147837,336,19485,5147501,5147837
1177,4,1,1,2412,-84,-88,4,78:67:0e:c4:a8:41,5148264,832,-405,5147432,5148264
1178,4,1,1,2412,-85,-88,3,78:67:0e:38:6c:d3,5154939,2736,3939,5152203,5154939
1179,4,11,1,2412,-80,-88,8,48:dd:0c:90:e3:83,5165390,323,10128,5165067,5165390
1180,4,11,1,2412,-84,-88,4,48:dd:0c:90:e3:85,5165725,382,-47,5165343,5165725
1181,6,6,1,2412,-81,-88,7,,5165996,52,219,5165944,5165996
1182,4,1,1,2412,-83,-88,5,78:67:0e:c4:a8:42,5166210,2736,-2522,5163474,5166210
1183,4,1,1,2412,-84,-88,4,,5169984,304,3470,5169680,5169984
1184,4,1,1,2412,-85,-88,3,,5171652,304,1364,5171348,5171652
1185,4,1,1,2412,-85,-88,3,,5172932,304,976,5172628,5172932
1186,6,6,1,2412,-80,-88,8,12:86:8c:5f:93:1e,5173436,332,172,5173104,5173436
1187,4,1,1,2412,-87,-88,1,bc:98:df:ff:0f:8b,5174522,3176,-2090,5171346,5174522
1188,4,1,1,2412,-85,-88,3,,5181774,448,6804,5181326,5181774
1189,6,6,1,2412,-80,-88,8,32:86:8c:5f:93:1e,5199375,332,17269,5199043,5199375
1190,4,1,1,2412,-84,-88,4,b4:b5:2f:17:0c:b9,5205658,1376,4907,5204282,5205658
1191,6,6,1,2412,-77,-88,11,e2:db:d1:d1:b0:4a,5206899,444,797,5206455,5206899
1192,6,6,1,2412,-76,-88,12,e2:db:d1:d1:b0:4b,5207376,408,69,5206968,5207376
1193,6,6,1,2412,-76,-88,12,e2:db:d1:d1:b0:4d,5207826,408,42,5207418,5207826
1194,4,11,1,2412,-83,-88,5,,5212666,203,4637,5212463,5212666
1195,4,1,1,2412,-85,-88,3,,5224290,304,11320,5223986,5224290
1196,6,6,1,2412,-80,-88,8,52:86:8c:5f:93:1e,5224747,332,125,5224415,5224747
1197,6,24,1,2412,-82,-88,6,,5238487,28,13712,5238459,5238487
1198,6,6,1,2412,-80,-88,8,10:86:8c:5f:93:1e,5252095,336,13272,5251759,5252095
1199,4,1,1,2412,-86,-88,2,,5253110,304,711,5252806,5253110
1200,4,1,1,2412,-81,-88,7,ac:67:84:84:8a:07,5254377,416,851,5253961,5254377
1201,4,1,1,2412,-86,-88,2,78:67:0e:38:6c:d3,5257454,2736,341,5254718,5257454
1202,4,11,1,2412,-86,-88,2,4c:01:43:ec:a0:66,5261759,387,3918,5261372,5261759
1203,4,11,1,2412,-77,-88,11,48:dd:0c:90:e3:87,5266326,362,4205,5265964,5266326
1204,4,11,1,2412,-78,-88,10,48:dd:0c:90:e3:83,5266700,323,51,5266377,5266700
1205,4,11,1,2412,-83,-88,5,48:dd:0c:90:e3:85,5267036,382,-46,5266654,5267036
1206,4,1,1,2412,-84,-88,4,78:67:0e:c4:a8:42,5268610,2736,-1162,5265874,5268610
1207,6,6,1,2412,-81,-88,7,12:86:8c:5f:93:1e,5275838,332,6896,5275506,5275838
1208,4,1,1,2412,-86,-88,2,68:54:fd:aa:49:4f,5276372,912,-378,5275460,5276372
1209,4,1,1,2412,-80,-88,8,b0:e4:d5:32:ec:8a,5290318,1960,11986,5288358,5290318
1210,4,1,1,2412,-84,-88,4,,5294915,304,4293,5294611,5294915
1211,6,6,1,2412,-79,-88,9,32:86:8c:5f:93:1e,5301513,332,6266,5301181,5301513
1212,4,1,1,2412,-88,-88,0,ac:67:84:84:8a:07,5307144,416,5215,5306728,5307144
1213,4,1,1,2412,-89,-88,-1,b4:b5:2f:17:0c:b9,5308060,1376,-460,5306684,5308060
1214,6,6,1,2412,-77,-88,11,e2:db:d1:d1:b0:4a,5309310,444,806,5308866,5309310
1215,6,6,1,2412,-77,-88,11,e2:db:d1:d1:b0:4b,5309787,408,69,5309379,5309787
1216,6,6,1,2412,-77,-88,11,e2:db:d1:d1:b0:4d,5310237,408,42,5309829,5310237
1217,6,6,1,2412,-76,-88,12,e2:db:d1:d1:b0:4f,5310687,408,42,5310279,5310687
1218,4,1,1,2412,-86,-88,2,68:54:fd:aa:49:4f,5316866,912,5267,5315954,5316866
1219,6,24,1,2412,-82,-88,6,,5318431,32,1533,5318399,5318431
1220,4,1,1,2412,-79,-88,9,3c:bd:c5:ee:96:6d,5320268,2512,-675,5317756,5320268
1221,6,6,1,2412,-80,-88,8,52:86:8c:5f:93:1e,5327038,332,6438,5326706,5327038
1222,4,11,1,2412,-80,-88,8,48:dd:0c:7d:86:27,5332816,362,5416,5332454,5332816
1223,4,11,1,2412,-80,-88,8,48:dd:0c:7d:86:23,5333190,323,51,5332867,5333190
1224,4,11,1,2412,-80,-88,8,48:dd:0c:7d:86:25,5333526,382,-46,5333144,5333526
1225,4,1,1,2412,-89,-88,-1,ce:9e:43:bc:eb:ff,5340950,3800,3624,5337150,5340950
1226,6,6,1,2412,-80,-88,8,10:86:8c:5f:93:1e,5356368,336,15082,5356032,5356368
1227,4,1,1,2412,-87,-88,1,68:54:fd:aa:49:4f,5357253,912,-27,5356341,5357253
1228,6,6,1,2412,-80,-88,8,b4:e6:2d:b4:ff:71,5358354,64,1037,5358290,5358354
1229,6,24,1,2412,-82,-88,6,,5358625,32,239,5358593,5358625
1230,6,6,1,2412,-80,-88,8,b4:e6:2d:b4:ff:71,5358733,64,44,5358669,5358733
1231,6,6,1,2412,-80,-88,8,,5358813,44,36,5358769,5358813
1232,4,1,1,2412,-85,-88,3,78:67:0e:38:6c:d3,5359643,2736,-1906,5356907,5359643
1233,4,1,1,2412,-82,-88,6,66:32:b1:64:4c:f2,5362965,2696,626,5360269,5362965
1234,4,11,1,2412,-78,-88,10,48:dd:0c:90:e3:83,5369100,323,5812,5368777,5369100
1235,4,11,1,2412,-82,-88,6,48:dd:0c:90:e3:85,5369435,382,-47,5369053,5369435
1236,4,1,1,2412,-85,-88,3,,5369959,304,220,5369655,5369959
1237,6,6,1,2412,-81,-88,7,12:86:8c:5f:93:1e,5378799,332,8508,5378467,5378799
1238,4,1,1,2412,-84,-88,4,,5384313,304,5210,5384009,5384313
1239,6,24,1,2412,-83,-88,5,,5385208,28,867,5385180,5385208
1240,4,1,1,2412,-86,-88,2,,5388883,304,3371,5388579,5388883
1241,6,24,1,2412,-83,-88,5,,5391909,28,2998,5391881,5391909
1242,4,1,1,2412,-89,-88,-1,ac:67:84:84:8a:07,5395647,416,3322,5395231,5395647
1243,6,24,1,2412,-82,-88,6,,5397857,28,2182,5397829,5397857
1244,4,11,1,2412,-86,-88,2,,5400377,207,2313,5400170,5400377
1245,4,1,1,2412,-74,-88,14,68:54:fd:aa:49:4f,5400811,912,-478,5399899,5400811
1246,6,6,1,2412,-76,-88,12,e2:db:d1:d1:b0:4f,5413071,408,11852,5412663,5413071
1247,4,11,1,2412,-85,-88,3,,5419295,203,6021,5419092,5419295
1248,4,1,1,2412,-82,-88,6,,5420678,352,1031,5420326,5420678
1249,4,1,1,2412,-85,-88,3,,5421026,304,44,5420722,5421026
1250,4,1,1,2412,-84,-88,4,,5421533,352,155,5421181,5421533
1251,4,1,1,2412,-85,-88,3,,5422379,352,494,5422027,5422379
1252,4,1,1,2412,-79,-88,9,3c:bd:c5:ee:96:6a,5425278,1056,1843,5424222,5425278
1253,4,1,1,2412,-79,-88,9,ac:67:84:84:8a:07,5430372,416,4678,5429956,5430372
1254,6,6,1,2412,-80,-88,8,52:86:8c:5f:93:1e,5430624,332,-80,5430292,5430624
1255,4,11,1,2412,-86,-88,2,,5434244,107,3513,5434137,5434244
1256,4,11,1,2412,-79,-88,9,48:dd:0c:7d:86:27,5435216,362,610,5434854,5435216
1257,4,11,1,2412,-80,-88,8,48:dd:0c:7d:86:23,5435590,323,51,5435267,5435590
1258,4,11,1,2412,-81,-88,7,48:dd:0c:7d:86:25,5435925,382,-47,5435543,5435925
1259,4,1,1,2412,-85,-88,3,,5437125,304,896,5436821,5437125
1260,4,1,1,2412,-85,-88,3,,5438909,352,1432,5438557,5438909
1261,6,24,1,2412,-82,-88,6,,5441442,32,2501,5441410,5441442
1262,4,1,1,2412,-87,-88,1,,5448967,304,7221,5448663,5448967
1263,6,6,1,2412,-79,-88,9,10:86:8c:5f:93:1e,5456898,336,7595,5456562,5456898
1264,4,1,1,2412,-74,-88,14,78:67:0e:38:6c:d3,5462043,2736,2409,5459307,5462043
1265,4,1,1,2412,-83,-88,5,66:32:b1:64:4c:f2,5465298,2696,559,5462602,5465298
1266,4,11,1,2412,-78,-88,10,48:dd:0c:90:e3:83,5471500,323,5879,5471177,5471500
1267,4,11,1,2412,-81,-88,7,48:dd:0c:90:e3:85,5471835,382,-47,5471453,5471835
1268,4,1,1,2412,-85,-88,3,78:67:0e:c4:a8:42,5473410,2736,-1161,5470674,5473410
1269,6,6,1,2412,-77,-88,11,f8:4f:ad:f9:af:82,5477023,1360,2253,5475663,5477023
1270,6,6,1,2412,-77,-88,11,f8:4f:ad:f9:af:82,5478416,1332,61,5477084,5478416
1271,6,6,1,2412,-81,-88,7,12:86:8c:5f:93:1e,5481327,332,2579,5480995,5481327
1272,4,1,1,2412,-86,-88,2,68:54:fd:aa:49:4f,5483068,912,829,5482156,5483068
1273,4,1,1,2412,-79,-88,9,b0:e4:d5:32:ec:8a,5495117,1960,10089,5493157,5495117
1274,6,6,1,2412,-80,-88,8,32:86:8c:5f:93:1e,5506261,332,10812,5505929,5506261
1275,4,1,1,2412,-85,-88,3,b4:b5:2f:17:0c:b9,5512863,1376,5226,5511487,5512863
1276,6,6,1,2412,-76,-88,12,e2:db:d1:d1:b0:4a,5514096,444,789,5513652,5514096
1277,6,6,1,2412,-76,-88,12,e2:db:d1:d1:b0:4b,5514572,408,68,5514164,5514572
1278,6,6,1,2412,-77,-88,11,e2:db:d1:d1:b0:4d,5515013,408,33,5514605,5515013
1279,6,6,1,2412,-77,-88,11,e2:db:d1:d1:b0:4f,5515463,408,42,5515055,5515463
1280,4,1,1,2412,-84,-88,4,,5518919,304,3152,5518615,5518919
1281,4,1,1,2412,-86,-88,2,68:54:fd:aa:49:4f,5520221,912,390,5519309,5520221
1282,4,1,1,2412,-79,-88,9,3c:bd:c5:ee:96:6d,5525032,2512,2299,5522520,5525032
1283,6,6,1,2412,-81,-88,7,52:86:8c:5f:93:1e,5532281,332,6917,5531949,5532281
1284,6,24,1,2412,-81,-88,7,,5533794,28,1485,5533766,5533794
1285,4,11,1,2412,-81,-88,7,48:dd:0c:7d:86:27,5537615,362,3459,5537253,5537615
1286,4,11,1,2412,-80,-88,8,48:dd:0c:7d:86:23,5537990,323,52,5537667,5537990
1287,4,11,1,2412,-79,-88,9,48:dd:0c:7d:86:25,5538325,382,-47,5537943,5538325
1288,6,6,1,2412,-80,-88,8,b4:e6:2d:b4:ff:71,5538631,64,242,5538567,5538631
1289,4,1,1,2412,-85,-88,3,,5539023,304,88,5538719,5539023
1290,6,6,1,2412,-80,-88,8,b4:e6:2d:b4:ff:71,5539512,64,425,5539448,5539512
1291,6,6,1,2412,-79,-88,9,,5539592,44,36,5539548,5539592
1292,6,24,1,2412,-82,-88,6,,5545037,28,5417,5545009,5545037
1293,6,6,1,2412,-80,-88,8,10:86:8c:5f:93:1e,5557524,336,12151,5557188,5557524
1294,4,11,1,2412,-83,-88,5,48:dd:0c:90:e3:85,5574235,382,16329,5573853,5574235
1295,4,1,1,2412,-83,-88,5,78:67:0e:c4:a8:42,5575810,2736,-1161,5573074,5575810
1296,4,1,1,2412,-84,-88,4,,5578996,304,2882,5578692,5578996
1297,6,24,1,2412,-83,-88,5,,5581446,32,2418,5581414,5581446
1298,6,6,1,2412,-80,-88,8,12:86:8c:5f:93:1e,5583040,332,1262,5582708,5583040
1299,4,1,1,2412,-86,-88,2,ac:67:84:84:8a:07,5592694,416,9238,5592278,5592694
1300,4,1,1,2412,-88,-88,0,,5593122,304,124,5592818,5593122
1301,4,1,1,2412,-80,-88,8,b0:e4:d5:32:ec:8a,5597516,1960,2434,5595556,5597516
1302,6,6,1,2412,-80,-88,8,32:86:8c:5f:93:1e,5608640,332,10792,5608308,5608640
1303,4,1,1,2412,-84,-88,4,b4:b5:2f:17:0c:b9,5615265,1376,5249,5613889,5615265
1304,6,6,1,2412,-76,-88,12,e2:db:d1:d1:b0:4a,5616515,444,806,5616071,5616515
1305,6,6,1,2412,-76,-88,12,e2:db:d1:d1:b0:4b,5616983,408,60,5616575,5616983
1306,6,6,1,2412,-77,-88,11,e2:db:d1:d1:b0:4d,5617415,408,24,5617007,5617415
1307,6,6,1,2412,-77,-88,11,e2:db:d1:d1:b0:4f,5617874,408,51,5617466,5617874
1308,4,1,1,2412,-80,-88,8,,5619372,304,1194,5619068,5619372
1309,4,1,1,2412,-79,-88,9,3c:bd:c5:ee:96:6d,5627410,2512,5526,5624898,5627410
1310,6,24,1,2412,-82,-88,6,,5630079,28,2641,5630051,5630079
1311,4,1,1,2412,-87,-88,1,bc:98:df:ff:0f:8b,5631515,2568,-1132,5628947,5631515
1312,4,1,1,2412,-89,-88,-1,a8:7e:ea:bf:89:e3,5634111,976,1620,5633135,5634111
1313,6,6,1,2412,-81,-88,7,52:86:8c:5f:93:1e,5636153,332,1710,5635821,5636153
1314,6,24,1,2412,-83,-88,5,,5636661,32,476,5636629,5636661
1315,6,24,1,2412,-83,-88,5,,5636825,32,132,5636793,5636825
1316,4,1,1,2412,-83,-88,5,,5639558,304,2429,5639254,5639558
1317,4,11,1,2412,-79,-88,9,48:dd:0c:7d:86:27,5640027,362,107,5639665,5640027
1318,4,11,1,2412,-79,-88,9,48:dd:0c:7d:86:25,5640737,382,328,5640355,5640737
1319,6,24,1,2412,-83,-88,5,,5641446,32,677,5641414,5641446
1320,4,1,1,2412,-84,-88,4,68:54:fd:df:ca:29,5642187,912,-171,5641275,5642187
1321,6,24,1,2412,-82,-88,6,,5643496,32,1277,5643464,5643496
1322,6,24,1,2412,-82,-88,6,,5658788,28,15264,5658760,5658788
1323,6,6,1,2412,-79,-88,9,10:86:8c:5f:93:1e,5660018,336,894,5659682,5660018
1324,4,1,1,2412,-85,-88,3,,5665374,304,5052,5665070,5665374
1325,4,1,1,2412,-84,-88,4,78:67:0e:c4:a8:42,5681859,2736,13749,5679123,5681859
1326,6,24,1,2412,-82,-88,6,,5684957,32,3066,5684925,5684957
1327,6,6,1,2412,-79,-88,9,12:86:8c:5f:93:1e,5686629,332,1340,5686297,5686629
1328,6,24,1,2412,-82,-88,6,,5688989,32,2328,5688957,5688989
1329,4,1,1,2412,-85,-88,3,68:54:fd:df:ca:29,5689797,912,-104,5688885,5689797
1330,4,11,1,2412,-86,-88,2,,5692481,203,2481,5692278,5692481
1331,4,1,1,2412,-79,-88,9,b0:e4:d5:32:ec:8a,5699916,1960,5475,5697956,5699916
1332,4,1,1,2412,-86,-88,2,ac:67:84:84:8a:07,5706296,416,5964,5705880,5706296
1333,4,1,1,2412,-90,-88,-2,,5706724,304,124,5706420,5706724
1334,6,24,1,2412,-82,-88,6,,5710818,28,4066,5710790,5710818
1335,6,6,1,2412,-80,-88,8,32:86:8c:5f:93:1e,5711040,332,-110,5710708,5711040
1336,4,1,1,2412,-84,-88,4,68:54:fd:aa:49:4f,5715927,912,3975,5715015,5715927
1337,4,11,1,2412,-80,-88,8,ba:1f:47:ca:32:d7,5717210,295,988,5716915,5717210
1338,6,6,1,2412,-76,-88,12,e2:db:d1:d1:b0:4b,5719367,408,1749,5718959,5719367
1339,6,6,1,2412,-77,-88,11,e2:db:d1:d1:b0:4d,5719808,408,33,5719400,5719808
1340,6,6,1,2412,-77,-88,11,e2:db:d1:d1:b0:4f,5720258,408,42,5719850,5720258
1341,4,1,1,2412,-85,-88,3,68:54:fd:df:ca:29,5726007,912,4837,5725095,5726007
1342,4,1,1,2412,-86,-88,2,ac:67:84:84:8a:07,5729859,416,3436,5729443,5729859
1343,4,1,1,2412,-90,-88,-2,,5730287,304,124,5729983,5730287
1344,4,1,1,2412,-77,-88,11,3c:bd:c5:ee:96:6d,5730910,2512,-1889,5728398,5730910
1345,6,6,1,2412,-80,-88,8,52:86:8c:5f:93:1e,5736641,332,5399,5736309,5736641
1346,4,1,1,2412,-85,-88,3,,5739865,304,2920,5739561,5739865
1347,4,11,1,2412,-80,-88,8,48:dd:0c:7d:86:27,5742415,362,2188,5742053,5742415
1348,4,11,1,2412,-80,-88,8,48:dd:0c:7d:86:23,5742790,323,52,5742467,5742790
1349,4,11,1,2412,-80,-88,8,48:dd:0c:7d:86:25,5743125,382,-47,5742743,5743125
1350,4,1,1,2412,-86,-88,2,68:54:fd:aa:49:4f,5758826,912,14789,5757914,5758826
1351,6,24,1,2412,-82,-88,6,,5760234,32,1376,5760202,5760234
1352,6,6,1,2412,-81,-88,7,10:86:8c:5f:93:1e,5762264,336,1694,5761928,5762264
1353,6,24,1,2412,-82,-88,6,,5768971,32,6675,5768939,5768971
1354,4,1,1,2412,-86,-88,2,78:67:0e:38:6c:d3,5769244,2736,-2463,5766508,5769244
1355,4,11,1,2412,-86,-88,2,,5772037,203,2590,5771834,5772037
1356,4,1,1,2412,-86,-88,2,ac:67:84:84:8a:07,5772216,416,-237,5771800,5772216
1357,4,1,1,2412,-78,-88,10,,5777030,304,4510,5776726,5777030
1358,4,1,1,2412,-84,-88,4,78:67:0e:c4:a8:42,5780705,2736,939,5777969,5780705
1359,6,6,1,2412,-80,-88,8,12:86:8c:5f:93:1e,5787945,332,6908,5787613,5787945
1360,4,1,1,2412,-87,-88,1,ac:67:84:84:8a:07,5795183,416,6822,5794767,5795183
1361,4,1,1,2412,-89,-88,-1,,5801286,304,5799,5800982,5801286
1362,4,1,1,2412,-77,-88,11,b0:e4:d5:32:ec:8a,5802315,1960,-931,5800355,5802315
1363,4,1,1,2412,-86,-88,2,,5811205,304,8586,5810901,5811205
1364,6,6,1,2412,-81,-88,7,32:86:8c:5f:93:1e,5813441,332,1904,5813109,5813441
1365,4,1,1,2412,-86,-88,2,b4:b5:2f:17:0c:b9,5820069,1376,5252,5818693,5820069
1366,6,6,1,2412,-77,-88,11,e2:db:d1:d1:b0:4a,5821310,444,797,5820866,5821310
1367,6,6,1,2412,-77,-88,11,e2:db:d1:d1:b0:4d,5822255,408,537,5821847,5822255
1368,4,1,1,2412,-83,-88,5,,5828761,304,6202,5828457,5828761
1369,4,1,1,2412,-84,-88,4,,5830229,352,1116,5829877,5830229
1370,4,1,1,2412,-86,-88,2,ac:67:84:84:8a:07,5831634,416,989,5831218,5831634
1371,4,1,1,2412,-88,-88,0,,5832062,304,124,5831758,5832062
1372,4,11,1,2412,-84,-88,4,,5832321,107,152,5832214,5832321
1373,4,1,1,2412,-79,-88,9,3c:bd:c5:ee:96:6d,5832705,2512,-2128,5830193,5832705
1374,6,6,1,2412,-81,-88,7,52:86:8c:5f:93:1e,5839041,332,6004,5838709,5839041
1375,4,11,1,2412,-79,-88,9,48:dd:0c:7d:86:27,5844815,362,5412,5844453,5844815
1376,4,11,1,2412,-80,-88,8,48:dd:0c:7d:86:23,5845189,323,51,5844866,5845189
1377,4,11,1,2412,-79,-88,9,48:dd:0c:7d:86:25,5845525,382,-46,5845143,5845525
1378,6,24,1,2412,-83,-88,5,,5855199,28,9646,5855171,5855199
1379,4,11,1,2412,-89,-88,-1,4c:01:43:d7:f3:26,5857707,387,2121,5857320,5857707
1380,6,6,1,2412,-80,-88,8,10:86:8c:5f:93:1e,5864689,336,6646,5864353,5864689
1381,6,24,1,2412,-82,-88,6,,5870368,28,5651,5870340,5870368
1382,4,1,1,2412,-86,-88,2,78:67:0e:38:6c:d3,5871644,2736,-1460,5868908,5871644
1383,4,1,1,2412,-83,-88,5,68:54:fd:df:ca:29,5876593,912,4037,5875681,5876593
1384,4,11,1,2412,-78,-88,10,48:dd:0c:90:e3:87,5880724,362,3769,5880362,5880724
1385,4,11,1,2412,-78,-88,10,48:dd:0c:90:e3:83,5881099,323,52,5880776,5881099
1386,4,11,1,2412,-84,-88,4,48:dd:0c:90:e3:85,5881434,382,-47,5881052,5881434
1387,4,1,1,2412,-85,-88,3,68:54:fd:df:ca:29,5882564,912,218,5881652,5882564
1388,4,1,1,2412,-85,-88,3,78:67:0e:c4:a8:42,5883810,2736,-1490,5881074,5883810
1389,4,1,1,2412,-87,-88,1,d2:9e:43:bc:eb:ff,5900435,3600,13025,5896835,5900435
1390,6,6,1,2412,-81,-88,7,32:86:8c:5f:93:1e,5915842,332,15075,5915510,5915842
1391,4,1,1,2412,-84,-88,4,b4:b5:2f:17:0c:b9,5922470,1376,5252,5921094,5922470
1392,6,6,1,2412,-76,-88,12,e2:db:d1:d1:b0:4a,5923721,444,807,5923277,5923721
1393,6,6,1,2412,-77,-88,11,e2:db:d1:d1:b0:4b,5924207,408,78,5923799,5924207
1394,6,6,1,2412,-76,-88,12,e2:db:d1:d1:b0:4d,5924638,408,23,5924230,5924638
1395,6,6,1,2412,-77,-88,11,e2:db:d1:d1:b0:4f,5925097,408,51,5924689,5925097
1396,4,11,1,2412,-85,-88,3,,5929093,203,3793,5928890,5929093
1397,4,1,1,2412,-87,-88,1,,5929582,304,185,5929278,5929582
1398,4,1,1,2412,-78,-88,10,3c:bd:c5:ee:96:6d,5935386,2512,3292,5932874,5935386
1399,4,1,1,2412,-88,-88,0,bc:98:df:ff:0f:8b,5938194,2568,240,5935626,5938194
1400,6,6,1,2412,-81,-88,7,52:86:8c:5f:93:1e,5941442,332,2916,5941110,5941442
1401,4,11,1,2412,-79,-88,9,48:dd:0c:7d:86:25,5947924,382,6100,5947542,5947924
1402,6,24,1,2412,-83,-88,5,,5957616,28,9664,5957588,5957616
1403,6,24,1,2412,-83,-88,5,,5965953,32,8305,5965921,5965953
1404,4,1,1,2412,-86,-88,2,68:54:fd:df:ca:29,5967197,912,332,5966285,5967197
1405,4,1,1,2412,-84,-88,4,,5969502,304,2001,5969198,5969502
1406,6,6,1,2412,-81,-88,7,10:86:8c:5f:93:1e,5969958,336,120,5969622,5969958
1407,4,1,1,2412,-88,-88,0,ac:67:84:84:8a:07,5971612,416,1238,5971196,5971612
1408,4,1,1,2412,-87,-88,1,78:67:0e:38:6c:d3,5974044,2736,-304,5971308,5974044
1409,4,11,1,2412,-86,-88,2,4c:01:43:ec:a0:63,5978287,322,3921,5977965,5978287
1410,4,11,1,2412,-78,-88,10,48:dd:0c:90:e3:87,5983124,362,4475,5982762,5983124
1411,4,11,1,2412,-77,-88,11,48:dd:0c:90:e3:83,5983499,323,52,5983176,5983499
1412,4,11,1,2412,-77,-88,11,48:dd:0c:90:e3:85,5983834,382,-47,5983452,5983834
1413,4,1,1,2412,-86,-88,2,78:67:0e:c4:a8:42,5985409,2736,-1161,5982673,5985409
1414,4,1,1,2412,-86,-88,2,,5994267,448,8410,5993819,5994267
1415,6,6,1,2412,-81,-88,7,12:86:8c:5f:93:1e,5995796,332,1197,5995464,5995796
1416,4,1,1,2412,-85,-88,3,,5996750,304,650,5996446,5996750
1417,6,6,1,2412,-80,-88,8,32:86:8c:5f:93:1e,6018243,332,21161,6017911,6018243
1418,4,1,1,2412,-85,-88,3,b4:b5:2f:17:0c:b9,6024872,1376,5253,6023496,6024872
1419,6,6,1,2412,-76,-88,12,e2:db:d1:d1:b0:4a,6026105,444,789,6025661,6026105
1420,6,6,1,2412,-77,-88,11,e2:db:d1:d1:b0:4b,6026590,408,77,6026182,6026590
1421,6,6,1,2412,-77,-88,11,e2:db:d1:d1:b0:4d,6027049,408,51,6026641,6027049
1422,6,24,1,2412,-82,-88,6,,6031209,28,4132,6031181,6031209
1423,4,1,1,2412,-78,-88,10,3c:bd:c5:ee:96:6d,6037010,2512,3289,6034498,6037010
1424,4,1,1,2412,-88,-88,0,,6042830,304,5516,6042526,6042830
1425,6,6,1,2412,-81,-88,7,52:86:8c:5f:93:1e,6045954,332,2792,6045622,6045954
1426,4,1,1,2412,-87,-88,1,68:54:fd:df:ca:29,6048260,912,1394,6047348,6048260
1427,4,11,1,2412,-79,-88,9,48:dd:0c:7d:86:27,6049614,362,992,6049252,6049614
1428,4,11,1,2412,-80,-88,8,48:dd:0c:7d:86:23,6049989,323,52,6049666,6049989
1429,4,11,1,2412,-80,-88,8,48:dd:0c:7d:86:25,6050324,382,-47,6049942,6050324
1430,6,6,1,2412,-82,-88,6,,6050753,68,361,6050685,6050753
1431,4,11,1,2412,-87,-88,1,,6051427,203,471,6051224,6051427
1432,4,1,1,2412,-84,-88,4,,6056828,304,5097,6056524,6056828
1433,4,1,1,2412,-87,-88,1,ac:67:84:84:8a:07,6066963,416,9719,6066547,6066963
1434,4,1,1,2412,-90,-88,-2,,6067391,304,124,6067087,6067391
1435,4,1,1,2412,-87,-88,1,,6069066,304,1371,6068762,6069066
1436,6,6,1,2412,-80,-88,8,10:86:8c:5f:93:1e,6069737,336,335,6069401,6069737
1437,4,1,1,2412,-86,-88,2,ac:67:84:84:8a:07,6076227,416,6074,6075811,6076227
1438,4,11,1,2412,-82,-88,6,48:dd:0c:90:e3:85,6086234,382,9625,6085852,6086234
1439,4,1,1,2412,-85,-88,3,78:67:0e:c4:a8:42,6087809,2736,-1161,6085073,6087809
1440,4,1,1,2412,-85,-88,3,,6090769,352,2608,6090417,6090769
1441,4,11,1,2412,-84,-88,4,,6092592,107,1716,6092485,6092592
1442,4,1,1,2412,-85,-88,3,,6093816,352,872,6093464,6093816
1443,4,1,1,2412,-85,-88,3,68:54:fd:df:ca:29,6095193,912,465,6094281,6095193
1444,6,6,1,2412,-80,-88,8,12:86:8c:5f:93:1e,6096527,332,1002,6096195,6096527
1445,6,6,1,2412,-82,-88,6,,6097061,68,466,6096993,6097061
1446,4,11,1,2412,-86,-88,2,,6097546,207,278,6097339,6097546
1447,4,1,1,2412,-86,-88,2,68:54:fd:df:ca:29,6097979,912,-479,6097067,6097979
1448,4,11,1,2412,-84,-88,4,,6099459,203,1277,6099256,6099459
1449,4,1,1,2412,-86,-88,2,68:54:fd:df:ca:29,6101842,912,1471,6100930,6101842
1450,4,1,1,2412,-77,-88,11,b0:e4:d5:32:ec:8a,6109513,1960,5711,6107553,6109513
1451,4,1,1,2412,-88,-88,0,68:54:fd:df:ca:29,6112161,912,1736,6111249,6112161
1452,6,6,1,2412,-80,-88,8,32:86:8c:5f:93:1e,6120644,332,8151,6120312,6120644
1453,4,1,1,2412,-86,-88,2,38:01:46:30:1a:ca,6122819,848,1327,6121971,6122819
1454,6,6,1,2412,-76,-88,12,e2:db:d1:d1:b0:4a,6128459,444,5196,6128015,6128459
1455,6,6,1,2412,-77,-88,11,76:a2:c1:67:70:44,6133277,308,4510,6132969,6133277
1456,6,6,1,2412,-76,-88,12,e0:db:d1:d0:b0:48,6133699,308,114,6133391,6133699
1457,4,1,1,2412,-87,-88,1,ac:67:84:84:8a:07,6139098,416,4983,6138682,6139098
1458,4,1,1,2412,-87,-88,1,bc:98:df:ff:0f:8b,6142905,2568,1239,6140337,6142905
1459,6,6,1,2412,-80,-88,8,52:86:8c:5f:93:1e,6146292,332,3055,6145960,6146292
1460,4,11,1,2412,-81,-88,7,48:dd:0c:7d:86:27,6152014,362,5360,6151652,6152014
1461,4,11,1,2412,-80,-88,8,48:dd:0c:7d:86:23,6152389,323,52,6152066,6152389
1462,4,11,1,2412,-80,-88,8,48:dd:0c:7d:86:25,6152724,382,-47,6152342,6152724
1463,6,6,1,2412,-81,-88,7,10:86:8c:5f:93:1e,6171965,336,18905,6171629,6171965
1464,4,1,1,2412,-84,-88,4,,6174174,304,1905,6173870,6174174
1465,4,1,1,2412,-86,-88,2,68:54:fd:df:ca:29,6174865,912,-221,6173953,6174865
1466,6,24,1,2412,-82,-88,6,,6176000,28,1107,6175972,6176000
1467,6,6,1,2412,-82,-88,6,,6177291,68,1223,6177223,6177291
1468,4,11,1,2412,-88,-88,0,,6178407,203,913,6178204,6178407
1469,4,1,1,2412,-86,-88,2,78:67:0e:38:6c:d3,6178844,2736,-2299,6176108,6178844
1470,4,11,1,2412,-83,-88,5,48:dd:0c:90:e3:85,6188633,382,9407,6188251,6188633
1471,6,6,1,2412,-76,-88,12,f8:4f:ad:f9:af:82,6189232,156,443,6189076,6189232
1472,6,6,1,2412,-77,-88,11,f8:4f:ad:f9:af:82,6190029,656,141,6189373,6190029
1473,6,6,1,2412,-80,-88,8,12:86:8c:5f:93:1e,6197444,332,7083,6197112,6197444
1474,6,6,1,2412,-78,-88,10,f8:4f:ad:f9:af:82,6203272,196,5632,6203076,6203272
1475,4,1,1,2412,-84,-88,4,,6203703,352,79,6203351,6203703
1476,6,6,1,2412,-77,-88,11,f8:4f:ad:f9:af:82,6205029,156,1170,6204873,6205029
1477,6,24,1,2412,-82,-88,6,,6210337,32,5276,6210305,6210337
1478,4,1,1,2412,-77,-88,11,b0:e4:d5:32:ec:8a,6211912,1960,-385,6209952,6211912
1479,6,6,1,2412,-81,-88,7,32:86:8c:5f:93:1e,6223044,332,10800,6222712,6223044
1480,4,1,1,2412,-86,-88,2,b4:b5:2f:17:0c:b9,6229677,1376,5257,6228301,6229677
1481,6,6,1,2412,-77,-88,11,e2:db:d1:d1:b0:4a,6230918,444,797,6230474,6230918
1482,4,1,1,2412,-78,-88,10,3c:bd:c5:ee:96:6d,6241837,2512,8407,6239325,6241837
1483,4,1,1,2412,-87,-88,1,bc:98:df:ff:0f:8b,6245740,2568,1335,6243172,6245740
1484,6,6,1,2412,-80,-88,8,52:86:8c:5f:93:1e,6248645,332,2573,6248313,6248645
1485,4,11,1,2412,-80,-88,8,48:dd:0c:7d:86:27,6254414,362,5407,6254052,6254414
1486,4,11,1,2412,-79,-88,9,48:dd:0c:7d:86:23,6254788,323,51,6254465,6254788
1487,4,11,1,2412,-80,-88,8,48:dd:0c:7d:86:25,6255124,382,-46,6254742,6255124
1488,6,6,1,2412,-76,-88,12,f8:4f:ad:f9:af:82,6274544,248,19172,6274296,6274544
1489,6,6,1,2412,-76,-88,12,f8:4f:ad:f9:af:82,6274993,224,225,6274769,6274993
1490,6,6,1,2412,-81,-88,7,10:86:8c:5f:93:1e,6276112,336,783,6275776,6276112
1491,6,24,1,2412,-83,-88,5,,6277852,28,1712,6277824,6277852
1492,6,6,1,2412,-85,-88,3,,6280031,44,2135,6279987,6280031
1493,4,1,1,2412,-86,-88,2,78:67:0e:38:6c:d3,6281974,2736,-793,6279238,6281974
1494,4,1,1,2412,-85,-88,3,7c:f6:66:d3:26:e0,6284748,2208,566,6282540,6284748
1495,4,11,1,2412,-77,-88,11,48:dd:0c:90:e3:87,6290323,362,5213,6289961,6290323
1496,4,11,1,2412,-77,-88,11,48:dd:0c:90:e3:83,6290698,323,52,6290375,6290698
1497,4,11,1,2412,-82,-88,6,48:dd:0c:90:e3:85,6291033,382,-47,6290651,6291033
1498,4,1,1,2412,-85,-88,3,78:67:0e:c4:a8:42,6292609,2736,-1160,6289873,6292609
1499,6,6,1,2412,-81,-88,7,12:86:8c:5f:93:1e,6299845,332,6904,6299513,6299845
1500,4,1,1,2412,-78,-88,10,b0:e4:d5:32:ec:8a,6314312,1960,12507,6312352,6314312
1501,6,6,1,2412,-79,-88,9,32:86:8c:5f:93:1e,6325445,332,10801,6325113,6325445
1502,4,1,1,2412,-86,-88,2,b4:b5:2f:17:0c:b9,6332078,1376,5257,6330702,6332078
1503,6,6,1,2412,-76,-88,12,e2:db:d1:d1:b0:4a,6333328,444,806,6332884,6333328
1504,6,6,1,2412,-74,-88,14,e2:db:d1:d1:b0:4b,6333814,408,78,6333406,6333814
1505,6,6,1,2412,-77,-88,11,e2:db:d1:d1:b0:4d,6334255,408,33,6333847,6334255
1506,6,6,1,2412,-77,-88,11,e2:db:d1:d1:b0:4f,6334695,408,32,6334287,6334695
1507,4,1,1,2412,-87,-88,1,c8:9e:43:bc:eb:ff,6340844,3496,2653,6337348,6340844
1508,4,1,1,2412,-80,-88,8,3c:bd:c5:ee:96:6d,6345210,2512,1854,6342698,6345210
1509,4,1,1,2412,-87,-88,1,bc:98:df:ff:0f:8b,6347713,2568,-65,6345145,6347713
1510,6,6,1,2412,-80,-88,8,52:86:8c:5f:93:1e,6351045,332,3000,6350713,6351045
1511,6,24,1,2412,-82,-88,6,,6351811,28,738,6351783,6351811
1512,4,11,1,2412,-87,-88,1,,6352085,207,67,6351878,6352085
1513,4,1,1,2412,-85,-88,3,68:54:fd:df:ca:29,6352518,912,-479,6351606,6352518
1514,4,1,1,2412,-86,-88,2,68:54:fd:df:ca:29,6354677,912,1247,6353765,6354677
1515,4,11,1,2412,-80,-88,8,48:dd:0c:7d:86:27,6356814,362,1775,6356452,6356814
1516,4,11,1,2412,-79,-88,9,48:dd:0c:7d:86:23,6357188,323,51,6356865,6357188
1517,4,11,1,2412,-80,-88,8,48:dd:0c:7d:86:25,6357523,382,-47,6357141,6357523
1518,6,24,1,2412,-82,-88,6,,6358065,28,514,6358037,6358065
1519,4,11,1,2412,-86,-88,2,,6359218,203,950,6359015,6359218
1520,6,24,1,2412,-83,-88,5,,6360022,32,772,6359990,6360022
1521,4,1,1,2412,-85,-88,3,68:54:fd:df:ca:29,6360495,912,-439,6359583,6360495
1522,6,24,1,2412,-82,-88,6,,6362878,32,2351,6362846,6362878
1523,6,6,1,2412,-85,-88,3,,6373834,44,10912,6373790,6373834
1524,4,1,1,2412,-85,-88,3,,6375453,304,1315,6375149,6375453
1525,6,6,1,2412,-80,-88,8,10:86:8c:5f:93:1e,6379048,336,3259,6378712,6379048
1526,4,1,1,2412,-85,-88,3,78:67:0e:38:6c:d3,6383644,2736,1860,6380908,6383644
1527,4,1,1,2412,-85,-88,3,,6389324,304,5376,6389020,6389324
1528,4,1,1,2412,-88,-88,0,,6394316,448,4544,6393868,6394316
1529,4,1,1,2412,-84,-88,4,78:67:0e:c4:a8:42,6395102,2736,-1950,6392366,6395102
1530,6,6,1,2412,-82,-88,6,,6401151,68,5981,6401083,6401151
1531,4,1,1,2412,-86,-88,2,68:54:fd:df:ca:29,6401694,912,-369,6400782,6401694
1532,6,6,1,2412,-80,-88,8,12:86:8c:5f:93:1e,6402777,332,751,6402445,6402777
1533,6,6,1,2412,-83,-88,5,,6404575,68,1730,6404507,6404575
1534,4,1,1,2412,-84,-88,4,,6425682,304,20803,6425378,6425682
1535,6,6,1,2412,-79,-88,9,32:86:8c:5f:93:1e,6427846,332,1832,6427514,6427846
1536,6,6,1,2412,-77,-88,11,e2:db:d1:d1:b0:4b,6436180,408,7926,6435772,6436180
1537,6,6,1,2412,-77,-88,11,e2:db:d1:d1:b0:4d,6436620,408,32,6436212,6436620
1538,6,6,1,2412,-77,-88,11,e2:db:d1:d1:b0:4f,6437070,408,42,6436662,6437070
1539,4,1,1,2412,-86,-88,2,68:54:fd:df:ca:29,6441668,912,3686,6440756,6441668
1540,6,6,1,2412,-83,-88,5,,6443563,68,1827,6443495,6443563
1541,4,1,1,2412,-78,-88,10,3c:bd:c5:ee:96:6d,6450226,2512,4151,6447714,6450226
1542,6,6,1,2412,-79,-88,9,52:86:8c:5f:93:1e,6453964,332,3406,6453632,6453964
1543,4,11,1,2412,-81,-88,7,48:dd:0c:7d:86:27,6459213,362,4887,6458851,6459213
1544,4,11,1,2412,-80,-88,8,48:dd:0c:7d:86:23,6459588,323,52,6459265,6459588
1545,4,11,1,2412,-79,-88,9,48:dd:0c:7d:86:25,6459923,382,-47,6459541,6459923
1546,4,1,1,2412,-85,-88,3,,6467806,304,7579,6467502,6467806
1547,4,1,1,2412,-84,-88,4,68:54:fd:df:ca:29,6482080,912,13362,6481168,6482080
1548,4,11,1,2412,-87,-88,1,,6484532,203,2249,6484329,6484532
1549,4,1,1,2412,-81,-88,7,78:67:0e:38:6c:d3,6486045,2736,-1223,6483309,6486045
1550,4,1,1,2412,-84,-88,4,,6489231,304,2882,6488927,6489231
1551,4,11,1,2412,-83,-88,5,48:dd:0c:90:e3:85,6495833,382,6220,6495451,6495833
1552,4,1,1,2412,-86,-88,2,,6496136,448,-145,6495688,6496136
1553,4,1,1,2412,-82,-88,6,78:67:0e:c4:a8:42,6497408,2736,-1464,6494672,6497408
1554,6,6,1,2412,-81,-88,7,12:86:8c:5f:93:1e,6507440,332,9700,6507108,6507440
1555,4,1,1,2412,-87,-88,1,ac:67:84:84:8a:07,6508184,416,328,6507768,6508184
1556,6,24,1,2412,-83,-88,5,,6510364,28,2152,6510336,6510364
1557,4,1,1,2412,-79,-88,9,b0:e4:d5:32:ec:8a,6519110,1960,6786,6517150,6519110
1558,4,11,1,2412,-85,-88,3,,6525316,203,6003,6525113,6525316
1559,4,1,1,2412,-84,-88,4,,6526081,304,461,6525777,6526081
1560,6,6,1,2412,-81,-88,7,32:86:8c:5f:93:1e,6530247,332,3834,6529915,6530247
1561,4,1,1,2412,-84,-88,4,b4:b5:2f:17:0c:b9,6536881,1376,5258,6535505,6536881
1562,6,6,1,2412,-77,-88,11,e2:db:d1:d1:b0:4d,6539085,408,1796,6538677,6539085
1563,6,6,1,2412,-77,-88,11,e2:db:d1:d1:b0:4f,6539544,408,51,6539136,6539544
1564,4,1,1,2412,-79,-88,9,3c:bd:c5:ee:96:6d,6549686,2512,7630,6547174,6549686
1565,4,1,1,2412,-89,-88,-1,bc:98:df:ff:0f:8b,6552800,2568,546,6550232,6552800
1566,4,1,1,2412,-89,-88,-1,bc:98:df:ff:0f:8a,6555396,1184,1412,6554212,6555396
1567,6,6,1,2412,-81,-88,7,52:86:8c:5f:93:1e,6556435,332,707,6556103,6556435
1568,4,1,1,2412,-88,-88,0,d2:9e:43:bc:eb:ff,6557452,3600,-2583,6553852,6557452
1569,4,1,1,2412,-85,-88,3,,6568956,304,11200,6568652,6568956
1570,6,24,1,2412,-82,-88,6,,6574798,28,5814,6574770,6574798
1571,6,6,1,2412,-80,-88,8,10:86:8c:5f:93:1e,6581462,336,6328,6581126,6581462
1572,4,1,1,2412,-86,-88,2,78:67:0e:38:6c:d3,6588445,2736,4247,6585709,6588445
1573,4,1,1,2412,-85,-88,3,fa:28:63:d6:43:34,6591220,976,1799,6590244,6591220
1574,4,1,1,2412,-84,-88,4,7c:f6:66:c0:cf:b8,6592207,2208,-1221,6589999,6592207
1575,4,11,1,2412,-77,-88,11,48:dd:0c:90:e3:87,6597523,362,4954,6597161,6597523
1576,4,11,1,2412,-78,-88,10,48:dd:0c:90:e3:83,6597897,323,51,6597574,6597897
1577,4,11,1,2412,-84,-88,4,48:dd:0c:90:e3:85,6598232,382,-47,6597850,6598232
1578,4,1,1,2412,-85,-88,3,78:67:0e:c4:a8:42,6599808,2736,-1160,6597072,6599808
1579,6,6,1,2412,-80,-88,8,12:86:8c:5f:93:1e,6607047,332,6907,6606715,6607047
1580,4,1,1,2412,-85,-88,3,,6612124,304,4773,6611820,6612124
1581,4,11,1,2412,-85,-88,3,,6612513,107,282,6612406,6612513
1582,4,1,1,2412,-79,-88,9,b0:e4:d5:32:ec:8a,6621510,1960,7037,6619550,6621510
1583,4,1,1,2412,-85,-88,3,,6626341,352,4479,6625989,6626341
1584,4,1,1,2412,-86,-88,2,,6628865,352,2172,6628513,6628865
1585,6,6,1,2412,-80,-88,8,32:86:8c:5f:93:1e,6632647,332,3450,6632315,6632647
1586,6,6,1,2412,-76,-88,12,e2:db:d1:d1:b0:4a,6640515,444,7424,6640071,6640515
1587,6,6,1,2412,-76,-88,12,e2:db:d1:d1:b0:4b,6641010,408,87,6640602,6641010
1588,6,6,1,2412,-77,-88,11,e2:db:d1:d1:b0:4d,6641451,408,33,6641043,6641451
1589,6,6,1,2412,-77,-88,11,e2:db:d1:d1:b0:4f,6641883,408,24,6641475,6641883
1590,4,1,1,2412,-78,-88,10,3c:bd:c5:ee:96:6d,6651416,2512,7021,6648904,6651416
1591,4,1,1,2412,-78,-88,10,b8:f8:53:cb:31:f1,6654062,976,1670,6653086,6654062
1592,4,1,1,2412,-87,-88,1,bc:98:df:ff:0f:8b,6654996,2568,-1634,6652428,6654996
1593,6,6,1,2412,-81,-88,7,52:86:8c:5f:93:1e,6658248,332,2920,6657916,6658248
1594,4,11,1,2412,-81,-88,7,48:dd:0c:7d:86:27,6664013,362,5403,6663651,6664013
1595,4,11,1,2412,-80,-88,8,48:dd:0c:7d:86:23,6664388,323,52,6664065,6664388
1596,4,11,1,2412,-79,-88,9,48:dd:0c:7d:86:25,6664723,382,-47,6664341,6664723
1597,4,1,1,2412,-77,-88,11,78:67:0e:c4:a8:42,6702208,2736,34749,6699472,6702208
1598,6,6,1,2412,-80,-88,8,12:86:8c:5f:93:1e,6709448,332,6908,6709116,6709448
1599,4,11,1,2412,-79,-88,9,ba:1f:47:ca:32:d7,6716435,295,6692,6716140,6716435
1600,4,11,1,2412,-80,-88,8,48:dd:0c:7d:86:2e,6717653,305,913,6717348,6717653
1601,4,11,1,2412,-84,-88,4,48:dd:0c:7d:86:2e,6718190,305,232,6717885,6718190
1602,4,1,1,2412,-76,-88,12,b0:e4:d5:32:ec:8a,6723909,1960,3759,6721949,6723909
1603,6,6,1,2412,-81,-88,7,32:86:8c:5f:93:1e,6735048,332,10807,6734716,6735048
1604,6,6,1,2412,-76,-88,12,e2:db:d1:d1:b0:4a,6742944,444,7452,6742500,6742944
1605,6,6,1,2412,-77,-88,11,e2:db:d1:d1:b0:4b,6743412,408,60,6743004,6743412
1606,6,6,1,2412,-77,-88,11,e2:db:d1:d1:b0:4d,6743871,408,51,6743463,6743871
1607,6,6,1,2412,-76,-88,12,e2:db:d1:d1:b0:4f,6744312,408,33,6743904,6744312
1608,4,1,1,2412,-78,-88,10,3c:bd:c5:ee:96:6d,6754323,2512,7499,6751811,6754323
1609,4,1,1,2412,-81,-88,7,bc:98:df:ff:0f:8b,6757392,2568,501,6754824,6757392
1610,6,6,1,2412,-80,-88,8,52:86:8c:5f:93:1e,6760743,332,3019,6760411,6760743
1611,4,11,1,2412,-80,-88,8,48:dd:0c:7d:86:27,6766413,362,5308,6766051,6766413
1612,4,11,1,2412,-80,-88,8,48:dd:0c:7d:86:23,6766787,323,51,6766464,6766787
1613,4,11,1,2412,-80,-88,8,48:dd:0c:7d:86:25,6767123,382,-46,6766741,6767123
1614,6,6,1,2412,-79,-88,9,10:86:8c:5f:93:1e,6788845,336,21386,6788509,6788845
1615,6,6,1,2412,-76,-88,12,f8:4f:ad:f9:af:82,6789674,576,253,6789098,6789674
1616,4,11,1,2412,-76,-88,12,48:dd:0c:90:e3:85,6803032,382,12976,6802650,6803032
1617,4,1,1,2412,-92,-88,-4,,6804172,384,756,6803788,6804172
1618,4,1,1,2412,-87,-88,1,,6804570,448,-50,6804122,6804570
1619,6,6,1,2412,-80,-88,8,12:86:8c:5f:93:1e,6811849,332,6947,6811517,6811849
1620,4,11,1,2412,-82,-88,6,48:dd:0c:90:e3:83,6815389,254,3286,6815135,6815389
1621,4,11,1,2412,-79,-88,9,48:dd:0c:7d:86:23,6816377,254,734,6816123,6816377
1622,6,24,1,2412,-85,-88,3,,6823103,28,6698,6823075,6823103
1623,6,24,1,2412,-83,-88,5,,6823438,28,307,6823410,6823438
1624,6,24,1,2412,-83,-88,5,,6823706,28,240,6823678,6823706
1625,4,1,1,2412,-85,-88,3,ac:67:84:84:8a:07,6824579,416,457,6824163,6824579
1626,6,24,1,2412,-83,-88,5,,6825247,28,640,6825219,6825247
1627,4,1,1,2412,-78,-88,10,b0:e4:d5:32:ec:8a,6826308,1960,-899,6824348,6826308
1628,6,24,1,2412,-82,-88,6,,6830401,28,4065,6830373,6830401
1629,6,6,1,2412,-80,-88,8,32:86:8c:5f:93:1e,6837448,332,6715,6837116,6837448
1630,6,24,1,2412,-82,-88,6,,6838287,28,811,6838259,6838287
1631,4,1,1,2412,-89,-88,-1,b4:b5:2f:17:0c:b9,6844087,1376,4424,6842711,6844087
1632,6,6,1,2412,-77,-88,11,e2:db:d1:d1:b0:4a,6845346,444,815,6844902,6845346
1633,6,6,1,2412,-77,-88,11,e2:db:d1:d1:b0:4b,6845823,408,69,6845415,6845823
1634,6,6,1,2412,-77,-88,11,e2:db:d1:d1:b0:4d,6846255,408,24,6845847,6846255
1635,6,6,1,2412,-78,-88,10,e2:db:d1:d1:b0:4f,6846704,408,41,6846296,6846704
1636,4,1,1,2412,-84,-88,4,78:67:0e:c4:a8:42,6847974,848,422,6847126,6847974
1637,6,6,1,2412,-81,-88,7,52:86:8c:5f:93:1e,6863049,332,14743,6862717,6863049
1638,4,11,1,2412,-80,-88,8,48:dd:0c:7d:86:27,6868813,362,5402,6868451,6868813
1639,4,11,1,2412,-80,-88,8,48:dd:0c:7d:86:23,6869187,323,51,6868864,6869187
1640,4,11,1,2412,-81,-88,7,48:dd:0c:7d:86:25,6869522,382,-47,6869140,6869522
1641,4,1,1,2412,-86,-88,2,ac:67:84:84:8a:07,6870243,416,305,6869827,6870243
1642,6,6,1,2412,-81,-88,7,10:86:8c:5f:93:1e,6891209,336,20630,6890873,6891209
1643,6,24,1,2412,-83,-88,5,,6893809,28,2572,6893781,6893809
1644,4,1,1,2412,-88,-88,0,78:67:0e:38:6c:d3,6895645,2736,-900,6892909,6895645
1645,4,1,1,2412,-87,-88,1,78:67:0e:c4:a8:42,6907164,2736,8783,6904428,6907164
1646,6,6,1,2412,-80,-88,8,12:86:8c:5f:93:1e,6914249,332,6753,6913917,6914249
1647,4,1,1,2412,-78,-88,10,b0:e4:d5:32:ec:8a,6928708,1960,12499,6926748,6928708
1648,6,6,1,2412,-81,-88,7,32:86:8c:5f:93:1e,6939850,332,10810,6939518,6939850
1649,6,6,1,2412,-76,-88,12,e2:db:d1:d1:b0:4b,6948224,408,7966,6947816,6948224
1650,6,6,1,2412,-77,-88,11,e2:db:d1:d1:b0:4d,6948665,408,33,6948257,6948665
1651,6,6,1,2412,-76,-88,12,e2:db:d1:d1:b0:4f,6949124,408,51,6948716,6949124
1652,4,1,1,2412,-78,-88,10,3c:bd:c5:ee:96:6d,6959373,2512,7737,6956861,6959373
1653,6,6,1,2412,-81,-88,7,52:86:8c:5f:93:1e,6965488,332,5783,6965156,6965488
1654,4,11,1,2412,-81,-88,7,48:dd:0c:7d:86:27,6971212,362,5362,6970850,6971212
1655,4,11,1,2412,-79,-88,9,48:dd:0c:7d:86:23,6971587,323,52,6971264,6971587
1656,4,11,1,2412,-78,-88,10,48:dd:0c:7d:86:25,6971922,382,-47,6971540,6971922
1657,6,24,1,2412,-83,-88,5,,6973810,28,1860,6973782,6973810
1658,6,6,1,2412,-80,-88,8,10:86:8c:5f:93:1e,6991050,336,16904,6990714,6991050
1659,4,1,1,2412,-86,-88,2,78:67:0e:38:6c:d3,6998045,2736,4259,6995309,6998045
1660,4,11,1,2412,-78,-88,10,48:dd:0c:90:e3:83,7007496,323,9128,7007173,7007496
1661,4,11,1,2412,-83,-88,5,48:dd:0c:90:e3:85,7007831,382,-47,7007449,7007831
1662,4,1,1,2412,-85,-88,3,,7016561,352,8378,7016209,7016561
1663,6,6,1,2412,-80,-88,8,12:86:8c:5f:93:1e,7017215,332,322,7016883,7017215
1664,4,1,1,2412,-87,-88,1,,7029883,448,12220,7029435,7029883
1665,4,1,1,2412,-88,-88,0,,7030769,448,438,7030321,7030769
1666,6,6,1,2412,-76,-88,12,f8:4f:ad:f9:af:82,7040932,576,9587,7040356,7040932
1667,4,1,1,2412,-84,-88,4,,7043708,304,2472,7043404,7043708
1668,6,6,1,2412,-81,-88,7,32:86:8c:5f:93:1e,7044149,332,109,7043817,7044149
1669,6,6,1,2412,-77,-88,11,e2:db:d1:d1:b0:4a,7050149,444,5556,7049705,7050149
1670,6,6,1,2412,-76,-88,12,e2:db:d1:d1:b0:4b,7050626,408,69,7050218,7050626
1671,6,6,1,2412,-77,-88,11,e2:db:d1:d1:b0:4d,7051076,408,42,7050668,7051076
1672,6,6,1,2412,-77,-88,11,e2:db:d1:d1:b0:4f,7051526,408,42,7051118,7051526
1673,6,24,1,2412,-83,-88,5,,7053814,28,2260,7053786,7053814
1674,4,1,1,2412,-79,-88,9,3c:bd:c5:ee:96:6d,7061028,2512,4702,7058516,7061028
1675,4,1,1,2412,-84,-88,4,bc:98:df:ff:0f:8b,7064579,2568,983,7062011,7064579
1676,6,6,1,2412,-80,-88,8,52:86:8c:5f:93:1e,7067850,332,2939,7067518,7067850
1677,6,24,1,2412,-82,-88,6,,7070334,28,2456,7070306,7070334
1678,4,11,1,2412,-80,-88,8,48:dd:0c:7d:86:27,7073612,362,2916,7073250,7073612
1679,4,11,1,2412,-79,-88,9,48:dd:0c:7d:86:23,7073987,323,52,7073664,7073987
1680,4,11,1,2412,-80,-88,8,40:b0:34:b7:01:d4,7078995,318,4690,7078677,7078995
1681,4,11,1,2412,-80,-88,8,48:dd:0c:7d:86:2e,7079451,328,128,7079123,7079451
1682,4,11,1,2412,-83,-88,5,,7087725,107,8167,7087618,7087725
1683,4,11,1,2412,-85,-88,3,,7089596,107,1764,7089489,7089596
1684,4,11,1,2412,-83,-88,5,,7090276,107,573,7090169,7090276
1685,4,11,1,2412,-82,-88,6,,7090974,107,591,7090867,7090974
1686,4,1,1,2412,-86,-88,2,,7092194,448,772,7091746,7092194
1687,4,1,1,2412,-80,-88,8,04:a2:22:de:87:a6,7092908,2512,-1798,7090396,7092908
1688,6,6,1,2412,-79,-88,9,10:86:8c:5f:93:1e,7095854,336,2610,7095518,7095854
1689,6,6,1,2412,-79,-88,9,b4:e6:2d:b4:ff:71,7097730,64,1812,7097666,7097730
1690,6,6,1,2412,-80,-88,8,,7097810,44,36,7097766,7097810
1691,4,1,1,2412,-84,-88,4,78:67:0e:38:6c:d3,7100446,2736,-100,7097710,7100446
1692,4,1,1,2412,-80,-88,8,,7103632,304,2882,7103328,7103632
1693,4,11,1,2412,-77,-88,11,48:dd:0c:90:e3:87,7109521,362,5527,7109159,7109521
1694,4,11,1,2412,-76,-88,12,48:dd:0c:90:e3:83,7109896,323,52,7109573,7109896
1695,4,11,1,2412,-83,-88,5,48:dd:0c:90:e3:85,7110231,382,-47,7109849,7110231
1696,4,1,1,2412,-85,-88,3,78:67:0e:c4:a8:42,7111807,2736,-1160,7109071,7111807
1697,6,6,1,2412,-80,-88,8,12:86:8c:5f:93:1e,7119051,332,6912,7118719,7119051
1698,4,1,1,2412,-84,-88,4,,7122404,304,3049,7122100,7122404
1699,4,1,1,2412,-83,-88,5,,7125609,304,2901,7125305,7125609
1700,4,1,1,2412,-78,-88,10,b0:e4:d5:32:ec:8a,7133506,1960,5937,7131546,7133506
1701,4,1,1,2412,-85,-88,3,,7144026,304,10216,7143722,7144026
1702,6,6,1,2412,-79,-88,9,32:86:8c:5f:93:1e,7144651,332,293,7144319,7144651
1703,4,11,1,2412,-78,-88,10,10:86:8c:5f:93:26,7148971,347,3973,7148624,7148971
1704,4,1,1,2412,-84,-88,4,b4:b5:2f:17:0c:b9,7151292,1376,945,7149916,7151292
1705,6,6,1,2412,-76,-88,12,e2:db:d1:d1:b0:4a,7152551,444,815,7152107,7152551
1706,6,6,1,2412,-76,-88,12,e2:db:d1:d1:b0:4b,7153046,408,87,7152638,7153046
1707,6,6,1,2412,-77,-88,11,e2:db:d1:d1:b0:4d,7153487,408,33,7153079,7153487
1708,6,6,1,2412,-75,-88,13,e2:db:d1:d1:b0:4f,7153927,408,32,7153519,7153927
1709,6,24,1,2412,-82,-88,6,,7157640,28,3685,7157612,7157640
1710,4,1,1,2412,-84,-88,4,,7160056,304,2112,7159752,7160056
1711,4,1,1,2412,-84,-88,4,,7160811,304,451,7160507,7160811
1712,4,1,1,2412,-83,-88,5,b4:b5:2f:17:0c:b9,7161292,1328,-847,7159964,7161292
1713,4,1,1,2412,-78,-88,10,3c:bd:c5:ee:96:6d,7162651,3280,-1921,7159371,7162651
1714,4,1,1,2412,-78,-88,10,3c:bd:c5:ee:96:6d,7166687,2512,1524,7164175,7166687
1715,4,11,1,2412,-78,-88,10,48:dd:0c:7d:86:27,7176012,362,8963,7175650,7176012
1716,4,11,1,2412,-79,-88,9,48:dd:0c:7d:86:23,7176386,323,51,7176063,7176386
1717,4,11,1,2412,-78,-88,10,48:dd:0c:7d:86:25,7176722,382,-46,7176340,7176722
1718,4,1,1,2412,-86,-88,2,,7186942,304,9916,7186638,7186942
1719,4,1,1,2412,-81,-88,7,,7189346,304,2100,7189042,7189346
1720,6,6,1,2412,-76,-88,12,f8:4f:ad:f9:af:82,7194049,656,4047,7193393,7194049
1721,6,6,1,2412,-80,-88,8,10:86:8c:5f:93:1e,7197729,336,3344,7197393,7197729
1722,4,1,1,2412,-87,-88,1,78:67:0e:38:6c:d3,7202846,2736,2381,7200110,7202846
1723,4,1,1,2412,-83,-88,5,78:67:0e:38:6c:d3,7205621,848,1927,7204773,7205621
1724,4,1,1,2412,-81,-88,7,3c:bd:c5:ad:f6:9e,7206480,1056,-197,7205424,7206480
1725,4,1,1,2412,-82,-88,6,7c:f6:66:cd:4c:69,7207547,2208,-1141,7205339,7207547
1726,4,11,1,2412,-76,-88,12,48:dd:0c:90:e3:87,7211921,362,4012,7211559,7211921
1727,4,11,1,2412,-78,-88,10,48:dd:0c:90:e3:83,7212296,323,52,7211973,7212296
1728,4,11,1,2412,-82,-88,6,48:dd:0c:90:e3:85,7212631,382,-47,7212249,7212631
1729,6,24,1,2412,-83,-88,5,,7213809,28,1150,7213781,7213809
1730,4,1,1,2412,-84,-88,4,78:67:0e:c4:a8:42,7214207,2736,-2338,7211471,7214207
1731,4,1,1,2412,-86,-88,2,ac:67:84:84:8a:07,7217100,416,2477,7216684,7217100
1732,4,11,1,2412,-80,-88,8,48:dd:0c:7d:86:23,7217964,254,610,7217710,7217964
1733,4,11,1,2412,-82,-88,6,48:dd:0c:90:e3:83,7218266,254,48,7218012,7218266
1734,6,6,1,2412,-79,-88,9,b4:e6:2d:b4:ff:71,7229997,64,11667,7229933,7229997
1735,6,6,1,2412,-80,-88,8,,7230077,44,36,7230033,7230077
1736,4,1,1,2412,-83,-88,5,,7231370,304,989,7231066,7231370
1737,6,24,1,2412,-83,-88,5,,7233497,28,2099,7233469,7233497
1738,4,1,1,2412,-80,-88,8,b0:e4:d5:32:ec:8a,7235906,1960,449,7233946,7235906
1739,6,6,1,2412,-80,-88,8,32:86:8c:5f:93:1e,7247207,332,10969,7246875,7247207
1740,4,1,1,2412,-83,-88,5,,7251876,304,4365,7251572,7251876
1741,4,1,1,2412,-85,-88,3,b4:b5:2f:17:0c:b9,7253694,1376,442,7252318,7253694
1742,6,6,1,2412,-77,-88,11,e2:db:d1:d1:b0:4a,7254926,444,788,7254482,7254926
1743,6,6,1,2412,-77,-88,11,e2:db:d1:d1:b0:4b,7255403,408,69,7254995,7255403
1744,6,6,1,2412,-78,-88,10,e2:db:d1:d1:b0:4d,7255853,408,42,7255445,7255853
1745,6,6,1,2412,-75,-88,13,e2:db:d1:d1:b0:4f,7256302,408,41,7255894,7256302
1746,4,1,1,2412,-84,-88,4,,7265511,352,8857,7265159,7265511
1747,4,1,1,2412,-78,-88,10,3c:bd:c5:ee:96:6d,7265807,2512,-2216,7263295,7265807
1748,4,1,1,2412,-84,-88,4,,7268484,352,2325,7268132,7268484
1749,4,1,1,2412,-83,-88,5,,7269026,352,190,7268674,7269026
1750,4,1,1,2412,-87,-88,1,bc:98:df:ff:0f:8b,7269408,2568,-2186,7266840,7269408
1751,4,1,1,2412,-85,-88,3,,7272017,352,2257,7271665,7272017
1752,4,1,1,2412,-83,-88,5,,7272466,352,97,7272114,7272466
1753,4,1,1,2412,-84,-88,4,,7272966,352,148,7272614,7272966
1754,4,1,1,2412,-86,-88,2,ac:67:84:84:8a:07,7273401,416,19,7272985,7273401
1755,4,1,1,2412,-86,-88,2,,7274226,352,473,7273874,7274226
1756,4,1,1,2412,-83,-88,5,,7274695,352,117,7274343,7274695
1757,6,6,1,2412,-81,-88,7,52:86:8c:5f:93:1e,7275401,332,374,7275069,7275401
1758,4,1,1,2412,-84,-88,4,,7276571,304,866,7276267,7276571
1759,4,1,1,2412,-86,-88,2,,7277623,304,748,7277319,7277623
1760,4,11,1,2412,-80,-88,8,48:dd:0c:7d:86:27,7278412,362,427,7278050,7278412
1761,4,11,1,2412,-80,-88,8,48:dd:0c:7d:86:23,7278786,323,51,7278463,7278786
1762,4,11,1,2412,-76,-88,12,48:dd:0c:7d:86:25,7279121,382,-47,7278739,7279121
1763,6,6,1,2412,-76,-88,12,f8:4f:ad:f9:af:82,7295558,580,15857,7294978,7295558
1764,6,6,1,2412,-80,-88,8,10:86:8c:5f:93:1e,7298602,336,2708,7298266,7298602
1765,6,24,1,2412,-83,-88,5,,7305065,28,6435,7305037,7305065
1766,4,1,1,2412,-86,-88,2,78:67:0e:38:6c:d3,7305381,2736,-2420,7302645,7305381
1767,4,11,1,2412,-84,-88,4,4c:01:43:ec:a0:63,7309402,322,3699,7309080,7309402
1768,4,11,1,2412,-78,-88,10,48:dd:0c:90:e3:83,7314695,323,4970,7314372,7314695
1769,4,11,1,2412,-83,-88,5,48:dd:0c:90:e3:85,7315031,382,-46,7314649,7315031
1770,4,1,1,2412,-83,-88,5,78:67:0e:c4:a8:42,7316607,2736,-1160,7313871,7316607
1771,6,6,1,2412,-84,-88,4,,7319396,44,2745,7319352,7319396
1772,4,1,1,2412,-84,-88,4,,7325698,304,5998,7325394,7325698
1773,4,1,1,2412,-87,-88,1,ce:9e:43:bc:eb:ff,7331589,3800,2091,7327789,7331589
1774,6,6,1,2412,-77,-88,11,e2:db:d1:d1:b0:4b,7357796,408,25799,7357388,7357796
1775,6,6,1,2412,-77,-88,11,e2:db:d1:d1:b0:4d,7358228,408,24,7357820,7358228
1776,6,6,1,2412,-78,-88,10,e2:db:d1:d1:b0:4f,7358659,408,23,7358251,7358659
1777,4,1,1,2412,-86,-88,2,,7368849,304,9886,7368545,7368849
1778,4,1,1,2412,-87,-88,1,0e:b9:49:67:a0:d6,7371564,416,2299,7371148,7371564
1779,6,6,1,2412,-80,-88,8,52:86:8c:5f:93:1e,7375053,332,3157,7374721,7375053
1780,4,11,1,2412,-80,-88,8,48:dd:0c:7d:86:27,7380811,362,5396,7380449,7380811
1781,4,11,1,2412,-80,-88,8,48:dd:0c:7d:86:23,7381186,323,52,7380863,7381186
1782,4,11,1,2412,-80,-88,8,48:dd:0c:7d:86:25,7381521,382,-47,7381139,7381521
1783,4,11,1,2412,-86,-88,2,,7388678,107,7050,7388571,7388678
1784,4,1,1,2412,-83,-88,5,,7389451,304,469,7389147,7389451
1785,4,1,1,2412,-83,-88,5,,7390940,352,1137,7390588,7390940
1786,4,1,1,2412,-85,-88,3,4c:01:43:db:2d:92,7391798,848,10,7390950,7391798
1787,4,11,1,2412,-79,-88,9,48:dd:0c:7d:86:23,7400850,254,8798,7400596,7400850
1788,4,1,1,2412,-86,-88,2,78:67:0e:38:6c:d3,7407646,2736,4060,7404910,7407646
1789,4,11,1,2412,-77,-88,11,48:dd:0c:90:e3:87,7416721,362,8713,7416359,7416721
1790,4,11,1,2412,-84,-88,4,48:dd:0c:90:e3:85,7417430,382,327,7417048,7417430
1791,4,1,1,2412,-86,-88,2,78:67:0e:c4:a8:42,7419007,2736,-1159,7416271,7419007
1792,6,6,1,2412,-81,-88,7,12:86:8c:5f:93:1e,7426430,332,7091,7426098,7426430
1793,4,1,1,2412,-88,-88,0,,7433891,448,7013,7433443,7433891
1794,4,1,1,2412,-88,-88,0,,7434795,448,456,7434347,7434795
1795,4,1,1,2412,-84,-88,4,,7439566,352,4419,7439214,7439566
1796,4,1,1,2412,-78,-88,10,b0:e4:d5:32:ec:8a,7440704,1960,-822,7438744,7440704
1797,6,6,1,2412,-78,-88,10,32:86:8c:5f:93:1e,7451853,332,10817,7451521,7451853
1798,4,1,1,2412,-85,-88,3,b4:b5:2f:17:0c:b9,7458497,1376,5268,7457121,7458497
1799,6,6,1,2412,-75,-88,13,e2:db:d1:d1:b0:4a,7462133,444,3192,7461689,7462133
1800,6,6,1,2412,-77,-88,11,e2:db:d1:d1:b0:4f,7463519,408,978,7463111,7463519
1801,4,1,1,2412,-84,-88,4,,7468263,304,4440,7467959,7468263
1802,4,1,1,2412,-79,-88,9,3c:bd:c5:ee:96:6d,7470712,2512,-63,7468200,7470712
1803,4,1,1,2412,-88,-88,0,ac:67:84:84:8a:07,7473247,416,2119,7472831,7473247
1804,4,1,1,2412,-88,-88,0,bc:98:df:ff:0f:8b,7474112,2568,-1703,7471544,7474112
1805,6,6,1,2412,-81,-88,7,52:86:8c:5f:93:1e,7477454,332,3010,7477122,7477454
1806,6,24,1,2412,-81,-88,7,,7477909,28,427,7477881,7477909
1807,4,11,1,2412,-84,-88,4,,7478986,203,874,7478783,7478986
1808,6,24,1,2412,-82,-88,6,,7480074,32,1056,7480042,7480074
1809,4,11,1,2412,-80,-88,8,48:dd:0c:7d:86:27,7483211,362,2775,7482849,7483211
1810,4,11,1,2412,-80,-88,8,48:dd:0c:7d:86:23,7483586,323,52,7483263,7483586
1811,4,11,1,2412,-80,-88,8,48:dd:0c:7d:86:25,7483921,382,-47,7483539,7483921
1812,4,1,1,2412,-86,-88,2,,7488398,304,4173,7488094,7488398
1813,4,1,1,2412,-86,-88,2,ac:67:84:84:8a:07,7492957,416,4143,7492541,7492957
1814,6,24,1,2412,-82,-88,6,,7500066,28,7081,7500038,7500066
1815,6,6,1,2412,-81,-88,7,10:86:8c:5f:93:1e,7505163,336,4761,7504827,7505163
1816,4,1,1,2412,-85,-88,3,78:67:0e:38:6c:d3,7510429,2736,2530,7507693,7510429
1817,4,1,1,2412,-80,-88,8,d8:a0:11:11:11:5c,7513221,832,1960,7512389,7513221
1818,4,11,1,2412,-77,-88,11,48:dd:0c:90:e3:83,7519495,323,5951,7519172,7519495
1819,4,11,1,2412,-77,-88,11,48:dd:0c:90:e3:85,7519830,382,-47,7519448,7519830
1820,4,1,1,2412,-83,-88,5,78:67:0e:c4:a8:42,7521407,2736,-1159,7518671,7521407
1821,6,6,1,2412,-80,-88,8,12:86:8c:5f:93:1e,7529261,332,7522,7528929,7529261
1822,6,24,1,2412,-83,-88,5,,7535386,28,6097,7535358,7535386
1823,4,1,1,2412,-80,-88,8,b0:e4:d5:32:ec:8a,7543104,1960,5758,7541144,7543104
1824,6,6,1,2412,-76,-88,12,f8:4f:ad:f9:af:82,7545299,1292,903,7544007,7545299
1825,6,6,1,2412,-77,-88,11,f8:4f:ad:f9:af:82,7547728,1264,1165,7546464,7547728
1826,6,24,1,2412,-84,-88,4,,7550105,28,2349,7550077,7550105
1827,4,1,1,2412,-82,-88,6,,7553312,304,2903,7553008,7553312
1828,6,6,1,2412,-76,-88,12,e2:db:d1:d1:b0:4f,7563517,408,9797,7563109,7563517
1829,4,1,1,2412,-79,-88,9,3c:bd:c5:ee:96:6d,7573786,2512,7757,7571274,7573786
1830,4,1,1,2412,-86,-88,2,bc:98:df:ff:0f:8b,7576507,2568,153,7573939,7576507
1831,4,1,1,2412,-87,-88,1,ac:67:84:84:8a:07,7584176,416,7253,7583760,7584176
1832,4,11,1,2412,-80,-88,8,48:dd:0c:7d:86:27,7585611,362,1073,7585249,7585611
1833,4,11,1,2412,-80,-88,8,48:dd:0c:7d:86:23,7585985,323,51,7585662,7585985
1834,4,11,1,2412,-80,-88,8,48:dd:0c:7d:86:25,7586321,382,-46,7585939,7586321
1835,6,6,1,2412,-80,-88,8,10:86:8c:5f:93:1e,7607344,336,20687,7607008,7607344
1836,4,11,1,2412,-77,-88,11,48:dd:0c:90:e3:83,7621919,323,14252,7621596,7621919
1837,4,11,1,2412,-84,-88,4,48:dd:0c:90:e3:85,7622255,382,-46,7621873,7622255
1838,4,1,1,2412,-76,-88,12,b4:e6:2d:b4:ff:71,7622681,416,10,7622265,7622681
1839,4,1,1,2412,-80,-88,8,,7623107,304,122,7622803,7623107
1840,6,24,1,2412,-83,-88,5,,7624184,28,1049,7624156,7624184
1841,4,1,1,2412,-87,-88,1,78:67:0e:c4:a8:42,7624499,2736,-2421,7621763,7624499
1842,4,1,1,2412,-87,-88,1,ac:67:84:84:8a:07,7627288,416,2373,7626872,7627288
1843,4,1,1,2412,-87,-88,1,ac:67:84:84:8a:07,7628047,416,343,7627631,7628047
1844,6,6,1,2412,-80,-88,8,12:86:8c:5f:93:1e,7631181,332,2802,7630849,7631181
1845,6,24,1,2412,-83,-88,5,,7637875,28,6666,7637847,7637875
1846,4,1,1,2412,-83,-88,5,,7638362,304,183,7638058,7638362
1847,4,1,1,2412,-80,-88,8,b0:e4:d5:32:ec:8a,7645503,1960,5181,7643543,7645503
1848,4,1,1,2412,-86,-88,2,ac:67:84:84:8a:07,7648015,416,2096,7647599,7648015
1849,6,6,1,2412,-81,-88,7,32:86:8c:5f:93:1e,7656655,332,8308,7656323,7656655
1850,4,1,1,2412,-86,-88,2,b4:b5:2f:17:0c:b9,7663301,1376,5270,7661925,7663301
1851,6,6,1,2412,-75,-88,13,e2:db:d1:d1:b0:4a,7664560,444,815,7664116,7664560
1852,6,6,1,2412,-76,-88,12,e2:db:d1:d1:b0:4b,7665055,408,87,7664647,7665055
1853,4,1,1,2412,-87,-88,1,,7674760,304,9401,7674456,7674760
1854,4,1,1,2412,-80,-88,8,3c:bd:c5:ee:96:6d,7675426,2512,-1846,7672914,7675426
1855,4,1,1,2412,-87,-88,1,bc:98:df:ff:0f:8b,7678996,2568,1002,7676428,7678996
1856,4,1,1,2412,-88,-88,0,94:9f:3e:51:c9:e6,7681592,1088,1508,7680504,7681592
1857,6,6,1,2412,-80,-88,8,52:86:8c:5f:93:1e,7682536,332,612,7682204,7682536
1858,4,11,1,2412,-80,-88,8,48:dd:0c:7d:86:27,7688012,362,5114,7687650,7688012
1859,4,11,1,2412,-80,-88,8,48:dd:0c:7d:86:23,7688386,323,51,7688063,7688386
1860,4,11,1,2412,-80,-88,8,48:dd:0c:7d:86:25,7688722,382,-46,7688340,7688722
1861,4,1,1,2412,-88,-88,0,,7691395,304,2369,7691091,7691395
1862,6,24,1,2412,-84,-88,4,,7693819,28,2396,7693791,7693819
1863,4,1,1,2412,-85,-88,3,,7704874,304,10751,7704570,7704874
1864,6,6,1,2412,-81,-88,7,10:86:8c:5f:93:1e,7710091,336,4881,7709755,7710091
1865,4,1,1,2412,-87,-88,1,,7713822,304,3427,7713518,7713822
1866,4,1,1,2412,-87,-88,1,78:67:0e:38:6c:d3,7714846,2736,-1712,7712110,7714846
1867,4,11,1,2412,-77,-88,11,48:dd:0c:90:e3:87,7723920,362,8712,7723558,7723920
1868,4,1,1,2412,-89,-88,-1,,7731168,384,6864,7730784,7731168
1869,4,1,1,2412,-87,-88,1,,7731567,448,-49,7731119,7731567
1870,4,1,1,2412,-85,-88,3,,7732444,448,429,7731996,7732444
1871,6,6,1,2412,-79,-88,9,12:86:8c:5f:93:1e,7733631,332,855,7733299,7733631
1872,4,1,1,2412,-78,-88,10,b0:e4:d5:32:ec:8a,7747902,1960,12311,7745942,7747902
1873,6,6,1,2412,-81,-88,7,32:86:8c:5f:93:1e,7759055,332,10821,7758723,7759055
1874,4,1,1,2412,-86,-88,2,b4:b5:2f:17:0c:b9,7765703,1376,5272,7764327,7765703
1875,6,6,1,2412,-76,-88,12,e2:db:d1:d1:b0:4a,7766953,444,806,7766509,7766953
1876,6,6,1,2412,-76,-88,12,e2:db:d1:d1:b0:4b,7767439,408,78,7767031,7767439
1877,6,6,1,2412,-76,-88,12,e2:db:d1:d1:b0:4d,7767897,408,50,7767489,7767897
1878,6,6,1,2412,-75,-88,13,e2:db:d1:d1:b0:4f,7768339,408,34,7767931,7768339
1879,4,11,1,2412,-79,-88,9,48:dd:0c:7d:86:27,7790412,362,21711,7790050,7790412
1880,4,11,1,2412,-80,-88,8,48:dd:0c:7d:86:23,7790786,323,51,7790463,7790786
1881,4,11,1,2412,-80,-88,8,48:dd:0c:7d:86:25,7791121,382,-47,7790739,7791121
1882,6,6,1,2412,-79,-88,9,b4:e6:2d:b4:ff:71,7791878,64,693,7791814,7791878
1883,6,6,1,2412,-82,-88,6,,7791958,44,36,7791914,7791958
1884,4,1,1,2412,-87,-88,1,,7797698,304,5436,7797394,7797698
1885,4,1,1,2412,-84,-88,4,b4:b5:2f:17:0c:b9,7805601,1328,6575,7804273,7805601
1886,4,1,1,2412,-78,-88,10,3c:bd:c5:ee:96:6d,7810946,3280,2065,7807666,7810946
1887,4,1,1,2412,-86,-88,2,,7814469,352,3171,7814117,7814469
1888,4,1,1,2412,-84,-88,4,,7818089,352,3268,7817737,7818089
1889,4,1,1,2412,-85,-88,3,,7818541,352,100,7818189,7818541
1890,4,1,1,2412,-79,-88,9,,7820796,352,1903,7820444,7820796
1891,4,1,1,2412,-83,-88,5,,7821709,352,561,7821357,7821709
1892,4,1,1,2412,-85,-88,3,,7822170,352,109,7821818,7822170
1893,4,1,1,2412,-77,-88,11,,7824056,304,1582,7823752,7824056
1894,4,1,1,2412,-77,-88,11,,7824397,352,-11,7824045,7824397
1895,4,1,1,2412,-77,-88,11,,7825273,304,572,7824969,7825273
1896,4,1,1,2412,-84,-88,4,78:67:0e:c4:a8:42,7828606,2736,597,7825870,7828606
1897,4,1,1,2412,-86,-88,2,,7831549,352,2591,7831197,7831549
1898,4,1,1,2412,-80,-88,8,,7832248,352,347,7831896,7832248
1899,4,11,1,2412,-85,-88,3,,7834268,107,1913,7834161,7834268
1900,6,6,1,2412,-80,-88,8,b4:e6:2d:b4:ff:71,7838955,64,4623,7838891,7838955
1901,4,1,1,2412,-85,-88,3,,7839189,304,-70,7838885,7839189
1902,6,6,1,2412,-79,-88,9,b4:e6:2d:b4:ff:71,7839695,64,442,7839631,7839695
1903,6,6,1,2412,-81,-88,7,,7839775,44,36,7839731,7839775
1904,4,1,1,2412,-84,-88,4,,7840702,352,575,7840350,7840702
1905,4,1,1,2412,-79,-88,9,b0:e4:d5:32:ec:8a,7850302,1960,7640,7848342,7850302
1906,6,6,1,2412,-80,-88,8,32:86:8c:5f:93:1e,7861627,332,10993,7861295,7861627
1907,4,1,1,2412,-85,-88,3,b4:b5:2f:17:0c:b9,7868104,1376,5101,7866728,7868104
1908,6,6,1,2412,-76,-88,12,e2:db:d1:d1:b0:4a,7869364,444,816,7868920,7869364
1909,6,6,1,2412,-76,-88,12,e2:db:d1:d1:b0:4b,7869859,408,87,7869451,7869859
1910,6,6,1,2412,-77,-88,11,e2:db:d1:d1:b0:4d,7870308,408,41,7869900,7870308
1911,6,6,1,2412,-77,-88,11,e2:db:d1:d1:b0:4f,7870749,408,33,7870341,7870749
1912,4,1,1,2412,-78,-88,10,3c:bd:c5:ee:96:6d,7880223,2512,6962,7877711,7880223
1913,4,1,1,2412,-79,-88,9,b8:f8:53:cb:31:f1,7882780,976,1581,7881804,7882780
1914,6,6,1,2412,-79,-88,9,52:86:8c:5f:93:1e,7887141,332,4029,7886809,7887141
1915,4,11,1,2412,-81,-88,7,48:dd:0c:7d:86:27,7892811,362,5308,7892449,7892811
1916,4,11,1,2412,-81,-88,7,48:dd:0c:7d:86:23,7893186,323,52,7892863,7893186
1917,4,11,1,2412,-80,-88,8,48:dd:0c:7d:86:25,7893521,382,-47,7893139,7893521
1918,4,1,1,2412,-88,-88,0,78:67:0e:38:6c:d3,7919647,2736,23390,7916911,7919647
1919,4,11,1,2412,-83,-88,5,48:dd:0c:90:e3:85,7929429,382,9400,7929047,7929429
1920,4,1,1,2412,-85,-88,3,78:67:0e:c4:a8:42,7931006,2736,-1159,7928270,7931006
1921,6,24,1,2412,-82,-88,6,,7933821,28,2787,7933793,7933821
1922,4,1,1,2412,-87,-88,1,,7936050,448,1781,7935602,7936050
1923,4,1,1,2412,-90,-88,-2,00:26:62:eb:ea:74,7945061,968,8043,7944093,7945061
1924,6,24,1,2412,-83,-88,5,,7945932,28,843,7945904,7945932
1925,6,24,1,2412,-82,-88,6,,7950107,28,4147,7950079,7950107
1926,4,1,1,2412,-79,-88,9,b0:e4:d5:32:ec:8a,7952701,1960,634,7950741,7952701
1927,6,24,1,2412,-82,-88,6,,7958681,28,5952,7958653,7958681
1928,4,1,1,2412,-79,-88,9,b4:b5:2f:17:0c:b9,7970506,1376,10449,7969130,7970506
1929,6,6,1,2412,-77,-88,11,e2:db:d1:d1:b0:4a,7971738,444,788,7971294,7971738
1930,6,6,1,2412,-77,-88,11,e2:db:d1:d1:b0:4b,7972215,408,69,7971807,7972215
1931,6,6,1,2412,-77,-88,11,e2:db:d1:d1:b0:4f,7973133,408,510,7972725,7973133
1932,4,1,1,2412,-83,-88,5,,7974773,304,1336,7974469,7974773
1933,4,1,1,2412,-88,-88,0,ac:67:84:84:8a:07,7982380,416,7191,7981964,7982380
1934,4,1,1,2412,-78,-88,10,3c:bd:c5:ee:96:6d,7983440,2512,-1452,7980928,7983440
1935,4,1,1,2412,-87,-88,1,bc:98:df:ff:0f:8b,7986207,2568,199,7983639,7986207
1936,4,11,1,2412,-79,-88,9,48:dd:0c:7d:86:27,7995211,362,8642,7994849,7995211
1937,4,11,1,2412,-79,-88,9,48:dd:0c:7d:86:23,7995586,323,52,7995263,7995586
1938,4,11,1,2412,-79,-88,9,48:dd:0c:7d:86:25,7995921,382,-47,7995539,7995921
1939,6,24,1,2412,-82,-89,7,,8013823,28,17874,8013795,8013823
1940,6,6,1,2412,-79,-89,10,10:86:8c:5f:93:1e,8016943,336,2784,8016607,8016943
1941,4,1,1,2412,-84,-89,5,,8018882,304,1635,8018578,8018882
1942,4,1,1,2412,-85,-89,4,78:67:0e:38:6c:d3,8022800,2736,1182,8020064,8022800
1943,4,1,1,2412,-78,-89,11,,8029502,304,6398,8029198,8029502
1944,4,11,1,2412,-78,-89,11,48:dd:0c:90:e3:85,8031829,382,1945,8031447,8031829
1945,4,1,1,2412,-83,-89,6,78:67:0e:c4:a8:42,8033406,2736,-1159,8030670,8033406
1946,6,24,1,2412,-82,-89,7,,8039140,28,5706,8039112,8039140
1947,6,6,1,2412,-81,-89,8,12:86:8c:5f:93:1e,8040658,332,1186,8040326,8040658
1948,4,1,1,2412,-88,-89,1,ac:67:84:84:8a:07,8044168,416,3094,8043752,8044168
1949,4,1,1,2412,-83,-89,6,,8046231,448,1615,8045783,8046231
1950,4,1,1,2412,-79,-89,10,b0:e4:d5:32:ec:8a,8055100,1960,6909,8053140,8055100
1951,4,1,1,2412,-86,-89,3,b4:b5:2f:17:0c:b9,8066249,1328,9821,8064921,8066249
1952,4,1,1,2412,-85,-89,4,b4:b5:2f:17:0c:b9,8074297,1376,6672,8072921,8074297
1953,4,1,1,2412,-78,-89,11,3c:bd:c5:ee:96:6d,8075758,3280,-1819,8072478,8075758
1954,4,1,1,2412,-85,-89,4,ac:67:84:84:8a:07,8079282,416,3108,8078866,8079282
1955,4,1,1,2412,-85,-89,4,ac:67:84:84:8a:07,8080332,416,634,8079916,8080332
1956,6,6,1,2412,-75,-89,14,e2:db:d1:d1:b0:4a,8081236,444,460,8080792,8081236
1957,6,6,1,2412,-77,-89,12,e2:db:d1:d1:b0:4d,8084709,408,3065,8084301,8084709
1958,6,6,1,2412,-77,-89,12,e2:db:d1:d1:b0:4f,8085159,408,42,8084751,8085159
1959,4,1,1,2412,-90,-89,-1,3c:bd:c5:ee:96:6d,8087863,3280,-576,8084583,8087863
1960,6,6,1,2412,-79,-89,10,52:86:8c:5f:93:1e,8092210,332,4015,8091878,8092210
1961,4,1,1,2412,-86,-89,3,,8093056,352,494,8092704,8093056
1962,4,11,1,2412,-82,-89,7,,8095482,107,2319,8095375,8095482
1963,4,11,1,2412,-77,-89,12,48:dd:0c:7d:86:25,8098321,382,2457,8097939,8098321
1964,4,1,1,2412,-81,-89,8,d2:9e:43:bc:eb:ff,8105726,3600,3805,8102126,8105726
1965,6,6,1,2412,-80,-89,9,10:86:8c:5f:93:1e,8117489,336,11427,8117153,8117489
1966,6,24,1,2412,-83,-89,6,,8118653,28,1136,8118625,8118653
1967,6,6,1,2412,-85,-89,4,,8120760,44,2063,8120716,8120760
1968,4,1,1,2412,-87,-89,2,ac:67:84:84:8a:07,8122846,416,1670,8122430,8122846
1969,4,1,1,2412,-86,-89,3,78:67:0e:38:6c:d3,8124447,2736,-1135,8121711,8124447
1970,4,11,1,2412,-77,-89,12,48:dd:0c:90:e3:87,8133519,362,8710,8133157,8133519
1971,4,11,1,2412,-77,-89,12,48:dd:0c:90:e3:83,8133893,323,51,8133570,8133893
1972,4,11,1,2412,-82,-89,7,48:dd:0c:90:e3:85,8134229,382,-46,8133847,8134229
1973,4,1,1,2412,-86,-89,3,78:67:0e:c4:a8:42,8135806,2736,-1159,8133070,8135806
1974,4,1,1,2412,-88,-89,1,,8140340,384,4150,8139956,8140340
1975,4,1,1,2412,-87,-89,2,,8140738,448,-50,8140290,8140738
1976,6,6,1,2412,-79,-89,10,12:86:8c:5f:93:1e,8143059,332,1989,8142727,8143059
1977,4,1,1,2412,-77,-89,12,b0:e4:d5:32:ec:8a,8157500,1960,12481,8155540,8157500
1978,6,6,1,2412,-80,-89,9,32:86:8c:5f:93:1e,8168659,332,10827,8168327,8168659
1979,4,1,1,2412,-85,-89,4,,8172392,352,3381,8172040,8172392
1980,6,24,1,2412,-83,-89,6,,8173821,28,1401,8173793,8173821
1981,4,11,1,2412,-85,-89,4,,8174485,107,557,8174378,8174485
1982,4,1,1,2412,-84,-89,5,b4:b5:2f:17:0c:b9,8175310,1376,-551,8173934,8175310
1983,6,6,1,2412,-77,-89,12,e2:db:d1:d1:b0:4a,8176542,444,788,8176098,8176542
1984,6,6,1,2412,-77,-89,12,e2:db:d1:d1:b0:4b,8177037,408,87,8176629,8177037
1985,6,6,1,2412,-77,-89,12,e2:db:d1:d1:b0:4d,8177469,408,24,8177061,8177469
1986,6,6,1,2412,-76,-89,13,e2:db:d1:d1:b0:4f,8177919,408,42,8177511,8177919
1987,4,1,1,2412,-78,-89,11,3c:bd:c5:ee:96:6d,8187405,2512,6974,8184893,8187405
1988,4,1,1,2412,-78,-89,11,b8:f8:53:cb:31:f1,8189943,1640,898,8188303,8189943
1989,6,6,1,2412,-80,-89,9,52:86:8c:5f:93:1e,8194259,332,3984,8193927,8194259
1990,4,1,1,2412,-86,-89,3,ac:67:84:84:8a:07,8196499,416,1824,8196083,8196499
1991,6,24,1,2412,-83,-89,6,,8198636,28,2109,8198608,8198636
1992,4,11,1,2412,-80,-89,9,48:dd:0c:7d:86:27,8200011,362,1013,8199649,8200011
1993,4,11,1,2412,-80,-89,9,48:dd:0c:7d:86:23,8200385,323,51,8200062,8200385
1994,4,11,1,2412,-81,-89,8,48:dd:0c:7d:86:25,8200720,382,-47,8200338,8200720
1995,6,6,1,2412,-85,-89,4,,8203299,44,2535,8203255,8203299
1996,4,1,1,2412,-86,-89,3,78:67:0e:38:6c:d3,8226847,2736,20812,8224111,8226847
1997,4,11,1,2412,-79,-89,10,48:dd:0c:90:e3:83,8236293,323,9123,8235970,8236293
1998,4,11,1,2412,-85,-89,4,48:dd:0c:90:e3:85,8236628,382,-47,8236246,8236628
1999,4,1,1,2412,-85,-89,4,78:67:0e:c4:a8:42,8238205,2736,-1159,8235469,8238205
2000,4,1,1,2412,-88,-89,1,,8243177,384,4588,8242793,8243177
2001,4,1,1,2412,-88,-89,1,,8243575,448,-50,8243127,8243575
2002,4,1,1,2412,-88,-89,1,,8244196,384,237,8243812,8244196
2003,4,1,1,2412,-86,-89,3,,8244594,448,-50,8244146,8244594
2004,6,6,1,2412,-80,-89,9,12:86:8c:5f:93:1e,8245459,332,533,8245127,8245459
2005,6,24,1,2412,-83,-89,6,,8253822,28,8335,8253794,8253822
2006,4,1,1,2412,-79,-89,10,b0:e4:d5:32:ec:8a,8259899,1960,4117,8257939,8259899
2007,4,1,1,2412,-87,-89,2,bc:98:df:ff:0f:8b,8272853,3176,9778,8269677,8272853
2008,6,6,1,2412,-80,-89,9,32:86:8c:5f:93:1e,8276200,332,3015,8275868,8276200
2009,6,6,1,2412,-76,-89,13,e2:db:d1:d1:b0:4a,8278971,444,2327,8278527,8278971
2010,6,6,1,2412,-77,-89,12,e2:db:d1:d1:b0:4b,8279457,408,78,8279049,8279457
2011,6,6,1,2412,-76,-89,13,e2:db:d1:d1:b0:4d,8280020,408,155,8279612,8280020
2012,6,6,1,2412,-75,-89,14,e2:db:d1:d1:b0:4f,8280470,408,42,8280062,8280470
2013,4,1,1,2412,-87,-89,2,bc:98:df:ff:0f:8b,8285857,3176,2211,8282681,8285857
2014,4,1,1,2412,-79,-89,10,3c:bd:c5:ee:96:6d,8289828,2512,1459,8287316,8289828
2015,4,1,1,2412,-88,-89,1,0e:b9:49:67:a0:d6,8292788,416,2544,8292372,8292788
2016,4,1,1,2412,-87,-89,2,,8293217,304,125,8292913,8293217
2017,4,1,1,2412,-88,-89,1,,8293754,384,153,8293370,8293754
2018,4,1,1,2412,-89,-89,0,,8294151,448,-51,8293703,8294151
2019,6,6,1,2412,-80,-89,9,52:86:8c:5f:93:1e,8296823,332,2340,8296491,8296823
2020,4,11,1,2412,-80,-89,9,48:dd:0c:7d:86:27,8302410,362,5225,8302048,8302410
2021,4,11,1,2412,-80,-89,9,48:dd:0c:7d:86:23,8302785,323,52,8302462,8302785
2022,4,11,1,2412,-79,-89,10,48:dd:0c:7d:86:25,8303120,382,-47,8302738,8303120
2023,4,1,1,2412,-89,-89,0,0e:b9:49:67:a0:d6,8309425,416,5889,8309009,8309425
2024,4,1,1,2412,-85,-89,4,78:67:0e:38:6c:d3,8329247,2736,17086,8326511,8329247
2025,4,1,1,2412,-78,-89,11,78:67:0e:c4:a8:42,8340605,2736,8622,8337869,8340605
2026,6,24,1,2412,-83,-89,6,,8345083,28,4450,8345055,8345083
2027,4,1,1,2412,-88,-89,1,,8346797,384,1330,8346413,8346797
2028,4,1,1,2412,-88,-89,1,,8347195,448,-50,8346747,8347195
2029,6,6,1,2412,-80,-89,9,12:86:8c:5f:93:1e,8347860,332,333,8347528,8347860
2030,6,24,1,2412,-83,-89,6,,8350342,28,2454,8350314,8350342
2031,6,6,1,2412,-77,-89,12,e0:db:d1:d0:b0:49,8353123,212,2569,8352911,8353123
2032,4,1,1,2412,-85,-89,4,b4:b5:2f:17:0c:b9,8353527,1328,-924,8352199,8353527
2033,4,1,1,2412,-77,-89,12,,8354867,304,1036,8354563,8354867
2034,4,1,1,2412,-78,-89,11,3c:bd:c5:ee:96:6d,8355201,3280,-2946,8351921,8355201
2035,4,1,1,2412,-78,-89,11,b0:e4:d5:32:ec:8a,8362435,1960,5274,8360475,8362435
2036,6,6,1,2412,-77,-89,12,e0:db:d1:d0:b0:49,8365692,212,3045,8365480,8365692
2037,4,1,1,2412,-79,-89,10,3c:bd:c5:ee:96:6d,8366103,3280,-2869,8362823,8366103
2038,4,1,1,2412,-78,-89,11,,8369395,304,2988,8369091,8369395
2039,4,1,1,2412,-78,-89,11,,8373420,304,3721,8373116,8373420
2040,6,6,1,2412,-77,-89,12,e2:db:d1:d1:b0:4f,8382971,408,9143,8382563,8382971
2041,4,1,1,2412,-79,-89,10,3c:bd:c5:ee:96:6d,8392214,2512,6731,8389702,8392214
2042,4,1,1,2412,-89,-89,0,bc:98:df:ff:0f:8b,8395723,2568,941,8393155,8395723
2043,4,11,1,2412,-80,-89,9,48:dd:0c:7d:86:27,8404810,362,8725,8404448,8404810
2044,4,11,1,2412,-78,-89,11,48:dd:0c:7d:86:23,8405185,323,52,8404862,8405185
2045,4,11,1,2412,-80,-89,9,48:dd:0c:7d:86:25,8405520,382,-47,8405138,8405520
2046,6,24,1,2412,-83,-89,6,,8413828,28,8280,8413800,8413828
2047,4,1,1,2412,-85,-89,4,78:67:0e:38:6c:d3,8431647,2736,15083,8428911,8431647
2048,6,6,1,2412,-80,-89,9,12:86:8c:5f:93:1e,8450261,332,18282,8449929,8450261
2049,4,1,1,2412,-79,-89,10,b0:e4:d5:32:ec:8a,8464698,1960,12477,8462738,8464698
2050,6,6,1,2412,-85,-89,4,,8470922,44,6180,8470878,8470922
2051,6,6,1,2412,-80,-89,9,32:86:8c:5f:93:1e,8475861,332,4607,8475529,8475861
2052,4,1,1,2412,-87,-89,2,,8476419,304,254,8476115,8476419
2053,4,1,1,2412,-87,-89,2,,8477604,304,881,8477300,8477604
2054,4,1,1,2412,-86,-89,3,b4:b5:2f:17:0c:b9,8482515,1376,3535,8481139,8482515
2055,6,6,1,2412,-77,-89,12,e2:db:d1:d1:b0:4a,8483775,444,816,8483331,8483775
2056,6,6,1,2412,-76,-89,13,e2:db:d1:d1:b0:4b,8484260,408,77,8483852,8484260
2057,6,6,1,2412,-75,-89,14,e2:db:d1:d1:b0:4d,8484719,408,51,8484311,8484719
2058,4,1,1,2412,-79,-89,10,3c:bd:c5:ee:96:6d,8494624,2512,7393,8492112,8494624
2059,4,1,1,2412,-79,-89,10,b8:f8:53:cb:31:f1,8497162,976,1562,8496186,8497162
2060,4,1,1,2412,-88,-89,1,bc:98:df:ff:0f:8b,8498186,2568,-1544,8495618,8498186
2061,4,1,1,2412,-87,-89,2,bc:98:df:ff:0f:8a,8500782,1184,1412,8499598,8500782
2062,6,6,1,2412,-81,-89,8,52:86:8c:5f:93:1e,8501821,332,707,8501489,8501821
2063,6,24,1,2412,-82,-89,7,,8505085,28,3236,8505057,8505085
2064,4,11,1,2412,-79,-89,10,48:dd:0c:7d:86:27,8507210,362,1763,8506848,8507210
2065,4,11,1,2412,-79,-89,10,48:dd:0c:7d:86:23,8507585,323,52,8507262,8507585
2066,6,24,1,2412,-82,-89,7,,8517672,28,10059,8517644,8517672
2067,4,1,1,2412,-85,-89,4,,8525089,304,7113,8524785,8525089
2068,4,1,1,2412,-85,-89,4,,8526141,304,748,8525837,8526141
2069,6,6,1,2412,-80,-89,9,10:86:8c:5f:93:1e,8527061,336,584,8526725,8527061
2070,4,11,1,2412,-78,-89,11,48:dd:0c:90:e3:83,8543492,323,16108,8543169,8543492
2071,4,11,1,2412,-84,-89,5,48:dd:0c:90:e3:85,8543828,382,-46,8543446,8543828
2072,4,1,1,2412,-84,-89,5,78:67:0e:c4:a8:42,8545405,2736,-1159,8542669,8545405
2073,4,1,1,2412,-84,-89,5,,8552758,448,6905,8552310,8552758
2074,4,1,1,2412,-86,-89,3,ac:67:84:84:8a:07,8556169,416,2995,8555753,8556169
2075,4,11,1,2412,-84,-89,5,,8563856,107,7580,8563749,8563856
2076,4,1,1,2412,-85,-89,4,,8564495,352,287,8564143,8564495
2077,4,11,1,2412,-85,-89,4,,8566365,107,1763,8566258,8566365
2078,4,1,1,2412,-85,-89,4,,8566947,352,230,8566595,8566947
2079,4,1,1,2412,-79,-89,10,b0:e4:d5:32:ec:8a,8567560,1960,-1347,8565600,8567560
2080,4,1,1,2412,-85,-89,4,,8570362,352,2450,8570010,8570362
2081,6,24,1,2412,-82,-89,7,,8573826,28,3436,8573798,8573826
2082,6,6,1,2412,-80,-89,9,32:86:8c:5f:93:1e,8578261,332,4103,8577929,8578261
2083,6,6,1,2412,-77,-89,12,e2:db:d1:d1:b0:4a,8586158,444,7453,8585714,8586158
2084,6,6,1,2412,-76,-89,13,e2:db:d1:d1:b0:4b,8586653,408,87,8586245,8586653
2085,6,6,1,2412,-76,-89,13,e2:db:d1:d1:b0:4d,8587085,408,24,8586677,8587085
2086,6,6,1,2412,-74,-89,15,e2:db:d1:d1:b0:4f,8587517,408,24,8587109,8587517
2087,6,24,1,2412,-83,-89,6,,8590768,28,3223,8590740,8590768
2088,4,1,1,2412,-78,-89,11,3c:bd:c5:ee:96:6d,8597011,2512,3731,8594499,8597011
2089,4,1,1,2412,-86,-89,3,bc:98:df:ff:0f:8b,8600615,2568,1036,8598047,8600615
2090,6,6,1,2412,-80,-89,9,52:86:8c:5f:93:1e,8603862,332,2915,8603530,8603862
2091,4,11,1,2412,-79,-89,10,48:dd:0c:7d:86:27,8609610,362,5386,8609248,8609610
2092,4,11,1,2412,-79,-89,10,48:dd:0c:7d:86:23,8609984,323,51,8609661,8609984
2093,4,11,1,2412,-81,-89,8,48:dd:0c:7d:86:25,8610319,382,-47,8609937,8610319
2094,4,11,1,2412,-77,-89,12,48:dd:0c:90:e3:87,8645518,362,34837,8645156,8645518
2095,4,11,1,2412,-76,-89,13,48:dd:0c:90:e3:83,8645892,323,51,8645569,8645892
2096,4,11,1,2412,-81,-89,8,48:dd:0c:90:e3:85,8646227,382,-47,8645845,8646227
2097,4,1,1,2412,-84,-89,5,78:67:0e:c4:a8:42,8650428,2736,1465,8647692,8650428
2098,6,24,1,2412,-83,-89,6,,8653828,28,3372,8653800,8653828
2099,4,1,1,2412,-87,-89,2,,8654690,448,414,8654242,8654690
2100,4,1,1,2412,-89,-89,0,c8:9e:43:bc:eb:ff,8663533,3496,5347,8660037,8663533
2101,4,1,1,2412,-80,-89,9,b0:e4:d5:32:ec:8a,8669496,1960,4003,8667536,8669496
2102,6,6,1,2412,-80,-89,9,32:86:8c:5f:93:1e,8680662,332,10834,8680330,8680662
2103,6,6,1,2412,-77,-89,12,e2:db:d1:d1:b0:4b,8689046,408,7976,8688638,8689046
2104,6,6,1,2412,-75,-89,14,e2:db:d1:d1:b0:4d,8689487,408,33,8689079,8689487
2105,6,6,1,2412,-75,-89,14,e2:db:d1:d1:b0:4f,8689946,408,51,8689538,8689946
2106,4,1,1,2412,-78,-89,11,3c:bd:c5:ee:96:6d,8699404,2512,6946,8696892,8699404
2107,4,1,1,2412,-89,-89,0,bc:98:df:ff:0f:8b,8702990,2568,1018,8700422,8702990
2108,6,6,1,2412,-81,-89,8,52:86:8c:5f:93:1e,8706262,332,2940,8705930,8706262
2109,4,1,1,2412,-85,-89,4,ac:67:84:84:8a:07,8708698,416,2020,8708282,8708698
2110,4,11,1,2412,-73,-89,16,48:dd:0c:7d:86:27,8712010,362,2950,8711648,8712010
2111,4,11,1,2412,-80,-89,9,48:dd:0c:7d:86:23,8712384,323,51,8712061,8712384
2112,4,11,1,2412,-76,-89,13,48:dd:0c:7d:86:25,8712719,382,-47,8712337,8712719
2113,4,1,1,2412,-86,-89,3,ac:67:84:84:8a:07,8729498,416,16363,8729082,8729498
2114,6,6,1,2412,-80,-89,9,10:86:8c:5f:93:1e,8733943,336,4109,8733607,8733943
2115,6,24,1,2412,-82,-89,7,,8734383,28,412,8734355,8734383
2116,4,1,1,2412,-86,-89,3,78:67:0e:38:6c:d3,8738848,2736,1729,8736112,8738848
2117,4,1,1,2412,-81,-89,8,78:67:0e:c4:a8:42,8752760,2736,11176,8750024,8752760
2118,4,1,1,2412,-88,-89,1,,8757458,448,4250,8757010,8757458
2119,6,6,1,2412,-80,-89,9,12:86:8c:5f:93:1e,8758171,332,381,8757839,8758171
2120,6,6,1,2412,-84,-89,5,,8769529,44,11314,8769485,8769529
2121,6,24,1,2412,-83,-89,6,,8780078,28,10521,8780050,8780078
2122,6,6,1,2412,-81,-89,8,32:86:8c:5f:93:1e,8783063,332,2653,8782731,8783063
2123,6,6,1,2412,-77,-89,12,e2:db:d1:d1:b0:4a,8790971,444,7464,8790527,8790971
2124,6,6,1,2412,-77,-89,12,e2:db:d1:d1:b0:4b,8791456,408,77,8791048,8791456
2125,6,6,1,2412,-77,-89,12,e2:db:d1:d1:b0:4d,8791906,408,42,8791498,8791906
2126,6,6,1,2412,-76,-89,13,e2:db:d1:d1:b0:4f,8792348,408,34,8791940,8792348
2127,4,1,1,2412,-78,-89,11,3c:bd:c5:ee:96:6d,8804475,2512,9615,8801963,8804475
2128,4,1,1,2412,-89,-89,0,b8:f8:53:cb:31:f1,8807014,976,1563,8806038,8807014
2129,6,6,1,2412,-80,-89,9,52:86:8c:5f:93:1e,8808663,332,1317,8808331,8808663
2130,6,24,1,2412,-83,-89,6,,8813107,28,4416,8813079,8813107
2131,6,24,1,2412,-83,-89,6,,8813220,28,85,8813192,8813220
2132,4,11,1,2412,-80,-89,9,48:dd:0c:7d:86:27,8814409,362,827,8814047,8814409
2133,4,11,1,2412,-80,-89,9,48:dd:0c:7d:86:23,8814784,323,52,8814461,8814784
2134,6,6,1,2412,-85,-89,4,,8823930,44,9102,8823886,8823930
2135,6,24,1,2412,-83,-89,6,,8825087,28,1129,8825059,8825087
2136,6,24,1,2412,-82,-89,7,,8830113,28,4998,8830085,8830113
2137,6,6,1,2412,-80,-89,9,10:86:8c:5f:93:1e,8834854,336,4405,8834518,8834854
2138,4,1,1,2412,-87,-89,2,78:67:0e:38:6c:d3,8841248,2736,3658,8838512,8841248
2139,4,11,1,2412,-77,-89,12,48:dd:0c:90:e3:87,8850317,362,8707,8849955,8850317
2140,4,11,1,2412,-79,-89,10,48:dd:0c:90:e3:83,8850691,323,51,8850368,8850691
2141,4,11,1,2412,-84,-89,5,48:dd:0c:90:e3:85,8851027,382,-46,8850645,8851027
2142,4,1,1,2412,-83,-89,6,78:67:0e:c4:a8:42,8852605,2736,-1158,8849869,8852605
2143,6,6,1,2412,-81,-89,8,12:86:8c:5f:93:1e,8859864,332,6927,8859532,8859864
2144,4,11,1,2412,-80,-89,9,48:dd:0c:7d:86:23,8871927,254,11809,8871673,8871927
2145,4,1,1,2412,-82,-89,7,78:67:0e:c4:a8:42,8889319,848,16544,8888471,8889319
2146,4,1,1,2412,-85,-89,4,b4:b5:2f:17:0c:b9,8892122,1376,1427,8890746,8892122
2147,6,6,1,2412,-75,-89,14,e2:db:d1:d1:b0:4a,8893364,444,798,8892920,8893364
2148,6,6,1,2412,-75,-89,14,e2:db:d1:d1:b0:4f,8894722,408,950,8894314,8894722
2149,4,1,1,2412,-78,-89,11,3c:bd:c5:ee:96:6d,8904589,2512,7355,8902077,8904589
2150,4,1,1,2412,-87,-89,2,bc:98:df:ff:0f:8b,8907773,2568,616,8905205,8907773
2151,6,6,1,2412,-80,-89,9,52:86:8c:5f:93:1e,8911064,332,2959,8910732,8911064
2152,4,11,1,2412,-79,-89,10,48:dd:0c:7d:86:27,8916809,362,5383,8916447,8916809
2153,4,11,1,2412,-79,-89,10,48:dd:0c:7d:86:23,8917184,323,52,8916861,8917184
2154,4,11,1,2412,-80,-89,9,48:dd:0c:7d:86:25,8917519,382,-47,8917137,8917519
2155,6,24,1,2412,-83,-89,6,,8918151,28,604,8918123,8918151
2156,6,6,1,2412,-80,-89,9,10:86:8c:5f:93:1e,8936664,336,18177,8936328,8936664
2157,4,11,1,2412,-85,-89,4,,8943444,107,6673,8943337,8943444
2158,4,1,1,2412,-86,-89,3,78:67:0e:38:6c:d3,8943877,2736,-2303,8941141,8943877
2159,4,11,1,2412,-84,-89,5,,8946824,107,2840,8946717,8946824
2160,4,1,1,2412,-83,-89,6,,8948677,352,1501,8948325,8948677
2161,4,1,1,2412,-78,-89,11,,8951869,352,2840,8951517,8951869
2162,4,11,1,2412,-78,-89,11,48:dd:0c:90:e3:83,8953091,323,899,8952768,8953091
2163,4,1,1,2412,-85,-89,4,,8953717,352,274,8953365,8953717
2164,4,1,1,2412,-85,-89,4,78:67:0e:c4:a8:42,8955004,2736,-1449,8952268,8955004
2165,4,1,1,2412,-84,-89,5,,8958500,352,3144,8958148,8958500
2166,4,11,1,2412,-83,-89,6,,8960337,107,1730,8960230,8960337
2167,4,1,1,2412,-86,-89,3,,8960889,352,200,8960537,8960889
2168,4,1,1,2412,-82,-89,7,,8961350,352,109,8960998,8961350
2169,4,1,1,2412,-87,-89,2,,8961802,352,100,8961450,8961802
2170,4,1,1,2412,-86,-89,3,,8962272,352,118,8961920,8962272
2171,4,1,1,2412,-84,-89,5,,8962724,352,100,8962372,8962724
2172,4,1,1,2412,-87,-89,2,,8963908,448,736,8963460,8963908
2173,4,1,1,2412,-87,-89,2,,8964685,352,425,8964333,8964685
2174,4,1,1,2412,-85,-89,4,,8965763,352,726,8965411,8965763
2175,4,1,1,2412,-83,-89,6,,8966226,352,111,8965874,8966226
2176,4,1,1,2412,-83,-89,6,,8968256,352,1678,8967904,8968256
2177,4,1,1,2412,-85,-89,4,,8968739,352,131,8968387,8968739
2178,4,1,1,2412,-86,-89,3,,8969529,352,438,8969177,8969529
2179,4,1,1,2412,-86,-89,3,,8969990,352,109,8969638,8969990
2180,4,1,1,2412,-85,-89,4,,8970442,352,100,8970090,8970442
2181,4,1,1,2412,-84,-89,5,,8970894,352,100,8970542,8970894
2182,4,1,1,2412,-85,-89,4,,8971364,352,118,8971012,8971364
2183,4,1,1,2412,-86,-89,3,,8971816,352,100,8971464,8971816
2184,4,1,1,2412,-85,-89,4,,8972277,352,109,8971925,8972277
2185,4,1,1,2412,-86,-89,3,,8972723,352,94,8972371,8972723
2186,4,1,1,2412,-84,-89,5,,8973344,352,269,8972992,8973344
2187,4,1,1,2412,-84,-89,5,,8973796,352,100,8973444,8973796
2188,4,1,1,2412,-85,-89,4,,8974266,352,118,8973914,8974266
2189,4,1,1,2412,-85,-89,4,ac:67:84:84:8a:07,8974674,416,-8,8974258,8974674
2190,4,1,1,2412,-79,-89,10,b0:e4:d5:32:ec:8a,8976694,1960,60,8974734,8976694
2191,6,6,1,2412,-80,-89,9,32:86:8c:5f:93:1e,8987865,332,10839,8987533,8987865
2192,6,24,1,2412,-81,-89,8,,8990480,28,2587,8990452,8990480
2193,6,6,1,2412,-77,-89,12,e2:db:d1:d1:b0:4b,8996251,408,5363,8995843,8996251
2194,6,6,1,2412,-75,-89,14,e2:db:d1:d1:b0:4d,8996683,408,24,8996275,8996683
2195,6,6,1,2412,-75,-89,14,e2:db:d1:d1:b0:4f,8997115,408,24,8996707,8997115
2196,4,1,1,2412,-78,-89,11,3c:bd:c5:ee:96:6d,9007623,2512,7996,9005111,9007623
2197,4,1,1,2412,-88,-89,1,bc:98:df:ff:0f:8b,9010204,2568,13,9007636,9010204
2198,6,6,1,2412,-80,-89,9,52:86:8c:5f:93:1e,9013465,332,2929,9013133,9013465
2199,4,11,1,2412,-80,-89,9,48:dd:0c:7d:86:27,9019209,362,5382,9018847,9019209
2200,4,11,1,2412,-79,-89,10,48:dd:0c:7d:86:23,9019583,323,51,9019260,9019583
2201,4,11,1,2412,-80,-89,9,48:dd:0c:7d:86:25,9019919,382,-46,9019537,9019919
2202,6,6,1,2412,-85,-89,4,,9024355,44,4392,9024311,9024355
2203,4,1,1,2412,-85,-89,4,,9025728,304,1069,9025424,9025728
2204,4,1,1,2412,-85,-89,4,,9026780,304,748,9026476,9026780
2205,6,6,1,2412,-81,-89,8,10:86:8c:5f:93:1e,9039065,336,11949,9038729,9039065
2206,4,1,1,2412,-85,-89,4,78:67:0e:38:6c:d3,9046048,2736,4247,9043312,9046048
2207,4,1,1,2412,-86,-89,3,ac:67:84:84:8a:07,9056173,416,9709,9055757,9056173
2208,4,1,1,2412,-89,-89,0,,9056601,304,124,9056297,9056601
2209,4,1,1,2412,-82,-89,7,ac:67:84:84:8a:07,9057188,416,171,9056772,9057188
2210,6,6,1,2412,-81,-89,8,12:86:8c:5f:93:1e,9064665,332,7145,9064333,9064665
2211,4,1,1,2412,-83,-89,6,,9068734,304,3765,9068430,9068734
2212,4,1,1,2412,-79,-89,10,b0:e4:d5:32:ec:8a,9079094,1960,8400,9077134,9079094
2213,4,1,1,2412,-85,-89,4,,9081683,448,2141,9081235,9081683
2214,6,6,1,2412,-80,-89,9,32:86:8c:5f:93:1e,9090266,332,8251,9089934,9090266
2215,4,1,1,2412,-87,-89,2,b4:b5:2f:17:0c:b9,9096926,1376,5284,9095550,9096926
2216,6,6,1,2412,-76,-89,13,e2:db:d1:d1:b0:4a,9098158,444,788,9097714,9098158
2217,6,6,1,2412,-75,-89,14,e2:db:d1:d1:b0:4d,9099085,408,519,9098677,9099085
2218,6,6,1,2412,-75,-89,14,e2:db:d1:d1:b0:4f,9099526,408,33,9099118,9099526
2219,4,1,1,2412,-79,-89,10,3c:bd:c5:ee:96:6d,9109017,2512,6979,9106505,9109017
2220,4,1,1,2412,-85,-89,4,bc:98:df:ff:0f:8b,9112608,2568,1023,9110040,9112608
2221,6,6,1,2412,-80,-89,9,52:86:8c:5f:93:1e,9115866,332,2926,9115534,9115866
2222,4,11,1,2412,-80,-89,9,48:dd:0c:7d:86:27,9121609,362,5381,9121247,9121609
2223,4,11,1,2412,-80,-89,9,48:dd:0c:7d:86:23,9121983,323,51,9121660,9121983
2224,4,11,1,2412,-81,-89,8,48:dd:0c:7d:86:25,9122318,382,-47,9121936,9122318
2225,4,1,1,2412,-85,-89,4,,9131785,352,9115,9131433,9131785
2226,6,24,1,2412,-81,-89,8,,9134777,28,2964,9134749,9134777
2227,4,1,1,2412,-84,-89,5,,9135490,352,361,9135138,9135490
2228,6,6,1,2412,-77,-89,12,76:a2:c1:67:70:44,9136436,308,638,9136128,9136436
2229,6,6,1,2412,-77,-89,12,e0:db:d1:d0:b0:48,9136849,308,105,9136541,9136849
2230,6,6,1,2412,-77,-89,12,b2:e2:49:f6:8a:4e,9137190,308,33,9136882,9137190
2231,6,6,1,2412,-80,-89,9,b4:e6:2d:b4:ff:71,9145611,64,8357,9145547,9145611
2232,6,6,1,2412,-81,-89,8,,9145691,44,36,9145647,9145691
2233,4,11,1,2412,-83,-89,6,48:dd:0c:90:e3:85,9158226,382,12153,9157844,9158226
2234,6,6,1,2412,-77,-89,12,f8:4f:ad:f9:af:82,9158548,156,166,9158392,9158548
2235,6,6,1,2412,-77,-89,12,f8:4f:ad:f9:af:82,9159603,656,399,9158947,9159603
2236,6,6,1,2412,-77,-89,12,e0:db:d1:d0:b0:48,9163048,156,3289,9162892,9163048
2237,4,1,1,2412,-81,-89,8,,9163640,304,288,9163336,9163640
2238,4,1,1,2412,-83,-89,6,,9165543,304,1599,9165239,9165543
2239,4,1,1,2412,-79,-89,10,,9166144,304,297,9165840,9166144
2240,7,39,1,2412,-79,-89,10,10:86:8c:5f:93:26,9166295,80,71,9166215,9166295
2241,6,24,1,2412,-81,-89,8,,9166391,28,68,9166363,9166391
2242,6,6,1,2412,-81,-89,8,12:86:8c:5f:93:1e,9167066,332,343,9166734,9167066
2243,6,6,1,2412,-76,-89,13,f8:4f:ad:f9:af:82,9171859,196,4597,9171663,9171859
2244,6,6,1,2412,-77,-89,12,f8:4f:ad:f9:af:82,9173136,156,1121,9172980,9173136
2245,4,1,1,2412,-71,-89,18,b0:e4:d5:32:ec:8a,9181493,1960,6397,9179533,9181493
2246,6,24,1,2412,-80,-89,9,,9189251,32,7726,9189219,9189251
2247,6,6,1,2412,-81,-89,8,32:86:8c:5f:93:1e,9192937,332,3354,9192605,9192937
2248,4,1,1,2412,-84,-89,5,1c:f2:9a:33:8c:d5,9194052,1152,-37,9192900,9194052
2249,6,6,1,2412,-76,-89,13,e2:db:d1:d1:b0:4b,9201055,408,6595,9200647,9201055
2250,6,6,1,2412,-76,-89,13,e2:db:d1:d1:b0:4d,9201496,408,33,9201088,9201496
2251,6,6,1,2412,-77,-89,12,e2:db:d1:d1:b0:4f,9201955,408,51,9201547,9201955
2252,4,1,1,2412,-79,-89,10,3c:bd:c5:ee:96:6d,9211521,2512,7054,9209009,9211521
2253,6,6,1,2412,-79,-89,10,52:86:8c:5f:93:1e,9218266,332,6413,9217934,9218266
2254,4,11,1,2412,-80,-89,9,48:dd:0c:7d:86:27,9224008,362,5380,9223646,9224008
2255,4,11,1,2412,-79,-89,10,48:dd:0c:7d:86:23,9224383,323,52,9224060,9224383
2256,4,11,1,2412,-78,-89,11,48:dd:0c:7d:86:25,9224718,382,-47,9224336,9224718
2257,6,24,1,2412,-84,-89,5,,9225529,28,783,9225501,9225529
2258,6,24,1,2412,-82,-89,7,,9230377,28,4820,9230349,9230377
2259,6,24,1,2412,-82,-89,7,,9237666,28,7261,9237638,9237666
2260,6,6,1,2412,-80,-89,9,10:86:8c:5f:93:1e,9245839,336,7837,9245503,9245839
2261,4,1,1,2412,-86,-89,3,78:67:0e:38:6c:d3,9250849,2736,2274,9248113,9250849
2262,4,11,1,2412,-77,-89,12,48:dd:0c:90:e3:83,9260290,323,9118,9259967,9260290
2263,4,1,1,2412,-84,-89,5,78:67:0e:c4:a8:42,9263808,2736,782,9261072,9263808
2264,4,1,1,2412,-87,-89,2,,9272359,448,8103,9271911,9272359
2265,4,11,1,2412,-79,-89,10,48:dd:0c:7d:86:23,9274007,254,1394,9273753,9274007
2266,4,11,1,2412,-82,-89,7,48:dd:0c:90:e3:83,9274310,254,49,9274056,9274310
2267,6,6,1,2412,-77,-89,12,e2:db:d1:d1:b0:4d,9303916,408,29198,9303508,9303916
2268,6,6,1,2412,-75,-89,14,e2:db:d1:d1:b0:4f,9304375,408,51,9303967,9304375
2269,4,1,1,2412,-79,-89,10,3c:bd:c5:ee:96:6d,9313802,2512,6915,9311290,9313802
2270,6,6,1,2412,-81,-89,8,52:86:8c:5f:93:1e,9320667,332,6533,9320335,9320667
2271,4,1,1,2412,-89,-89,0,ce:9e:43:bc:eb:ff,9322228,3800,-2239,9318428,9322228
2272,6,6,1,2412,-79,-89,10,10:86:8c:5f:93:1e,9346267,336,23703,9345931,9346267
2273,4,1,1,2412,-85,-89,4,,9349891,352,3272,9349539,9349891
2274,4,11,1,2412,-83,-89,6,,9351631,107,1633,9351524,9351631
2275,4,1,1,2412,-85,-89,4,,9352211,352,228,9351859,9352211
2276,4,1,1,2412,-85,-89,4,78:67:0e:38:6c:d3,9353249,2736,-1698,9350513,9353249
2277,4,11,1,2412,-86,-89,3,4c:01:43:ec:a0:63,9357379,322,3808,9357057,9357379
2278,4,11,1,2412,-77,-89,12,48:dd:0c:90:e3:87,9362316,362,4575,9361954,9362316
2279,4,11,1,2412,-83,-89,6,48:dd:0c:90:e3:85,9363025,382,327,9362643,9363025
2280,4,1,1,2412,-84,-89,5,78:67:0e:c4:a8:42,9364627,2736,-1134,9361891,9364627
2281,6,6,1,2412,-86,-89,3,,9370111,44,5440,9370067,9370111
2282,6,6,1,2412,-80,-89,9,12:86:8c:5f:93:1e,9372048,332,1605,9371716,9372048
2283,6,24,1,2412,-83,-89,6,,9373836,28,1760,9373808,9373836
2284,4,1,1,2412,-85,-89,4,,9384489,448,10205,9384041,9384489
2285,6,24,1,2412,-82,-89,7,,9385101,28,584,9385073,9385101
2286,4,1,1,2412,-85,-89,4,,9385393,448,-156,9384945,9385393
2287,4,1,1,2412,-79,-89,10,b0:e4:d5:32:ec:8a,9386292,1960,-1061,9384332,9386292
2288,6,24,1,2412,-82,-89,7,,9390277,28,3957,9390249,9390277
2289,6,6,1,2412,-81,-89,8,32:86:8c:5f:93:1e,9397468,332,6859,9397136,9397468
2290,6,6,1,2412,-77,-89,12,f8:4f:ad:f9:af:82,9399358,248,1642,9399110,9399358
2291,6,6,1,2412,-77,-89,12,f8:4f:ad:f9:af:82,9400295,224,713,9400071,9400295
2292,4,1,1,2412,-85,-89,4,b4:b5:2f:17:0c:b9,9404131,1376,2460,9402755,9404131
2293,6,6,1,2412,-77,-89,12,e2:db:d1:d1:b0:4a,9405364,444,789,9404920,9405364
2294,6,6,1,2412,-77,-89,12,e2:db:d1:d1:b0:4b,9405832,408,60,9405424,9405832
2295,6,6,1,2412,-77,-89,12,e2:db:d1:d1:b0:4d,9406291,408,51,9405883,9406291
2296,6,6,1,2412,-77,-89,12,e2:db:d1:d1:b0:4f,9406722,408,23,9406314,9406722
2297,4,1,1,2412,-77,-89,12,3c:bd:c5:ee:96:6d,9416208,2512,6974,9413696,9416208
2298,4,1,1,2412,-78,-89,11,3c:bd:c5:ee:96:6a,9418746,1056,1482,9417690,9418746
2299,4,11,1,2412,-79,-89,10,48:dd:0c:7d:86:27,9428808,362,9700,9428446,9428808
2300,4,11,1,2412,-80,-89,9,48:dd:0c:7d:86:23,9429183,323,52,9428860,9429183
2301,4,11,1,2412,-80,-89,9,48:dd:0c:7d:86:25,9429518,382,-47,9429136,9429518
2302,6,6,1,2412,-81,-89,8,b4:e6:2d:b4:ff:71,9429797,64,215,9429733,9429797
2303,6,6,1,2412,-81,-89,8,,9429877,44,36,9429833,9429877
2304,6,6,1,2412,-82,-89,7,b4:e6:2d:b4:ff:71,9430169,64,228,9430105,9430169
2305,6,6,1,2412,-81,-89,8,,9430249,44,36,9430205,9430249
2306,4,1,1,2412,-83,-89,6,,9430550,304,-3,9430246,9430550
2307,4,1,1,2412,-81,-89,8,,9431090,304,236,9430786,9431090
2308,7,39,1,2412,-80,-89,9,10:86:8c:5f:93:26,9431241,60,91,9431181,9431241
2309,6,24,1,2412,-82,-89,7,,9431317,28,48,9431289,9431317
2310,4,1,1,2412,-81,-89,8,,9431686,304,65,9431382,9431686
2311,7,39,1,2412,-80,-89,9,10:86:8c:5f:93:26,9431837,80,71,9431757,9431837
2312,6,24,1,2412,-81,-89,8,,9431932,28,67,9431904,9431932
2313,4,1,1,2412,-91,-89,-2,60:b7:6e:d3:6c:f6,9432753,2152,-1331,9430601,9432753
2314,6,6,1,2412,-82,-89,7,10:86:8c:5f:93:1e,9448668,336,15579,9448332,9448668
2315,6,24,1,2412,-83,-89,6,,9454330,28,5634,9454302,9454330
2316,6,24,1,2412,-80,-89,9,,9466018,32,11656,9465986,9466018
2317,4,1,1,2412,-87,-89,2,78:67:0e:c4:a8:42,9467004,2736,-1750,9464268,9467004
2318,6,24,1,2412,-83,-89,6,,9470809,28,3777,9470781,9470809
2319,4,1,1,2412,-89,-89,0,04:a2:22:ca:52:23,9472330,1056,465,9471274,9472330
2320,6,6,1,2412,-81,-89,8,12:86:8c:5f:93:1e,9474268,332,1606,9473936,9474268
2321,4,1,1,2412,-87,-89,2,,9476945,448,2229,9476497,9476945
2322,4,1,1,2412,-85,-89,4,,9477849,448,456,9477401,9477849
2323,4,1,1,2412,-79,-89,10,b0:e4:d5:32:ec:8a,9488691,1960,8882,9486731,9488691
2324,6,6,1,2412,-80,-89,9,32:86:8c:5f:93:1e,9499875,332,10852,9499543,9499875
2325,4,1,1,2412,-85,-89,4,b4:b5:2f:17:0c:b9,9506533,1376,5282,9505157,9506533
2326,6,6,1,2412,-76,-89,13,e2:db:d1:d1:b0:4a,9507784,444,807,9507340,9507784
2327,6,6,1,2412,-75,-89,14,e2:db:d1:d1:b0:4b,9508251,408,59,9507843,9508251
2328,6,6,1,2412,-75,-89,14,e2:db:d1:d1:b0:4d,9508701,408,42,9508293,9508701
2329,6,6,1,2412,-78,-89,11,e2:db:d1:d1:b0:4f,9509160,408,51,9508752,9509160
2330,4,1,1,2412,-79,-89,10,3c:bd:c5:ee:96:6d,9518602,2512,6930,9516090,9518602
2331,4,1,1,2412,-88,-89,1,bc:98:df:ff:0f:8b,9522192,2568,1022,9519624,9522192
2332,6,6,1,2412,-80,-89,9,52:86:8c:5f:93:1e,9525469,332,2945,9525137,9525469
2333,4,1,1,2412,-85,-89,4,ac:67:84:84:8a:07,9530460,416,4575,9530044,9530460
2334,4,11,1,2412,-79,-89,10,48:dd:0c:7d:86:23,9531582,323,799,9531259,9531582
2335,4,11,1,2412,-80,-89,9,48:dd:0c:7d:86:25,9531918,382,-46,9531536,9531918
2336,4,11,1,2412,-80,-89,9,4e:f0:43:5e:cf:0e,9533867,334,1615,9533533,9533867
2337,4,11,1,2412,-80,-89,9,4e:f0:43:5e:cf:0e,9534281,348,66,9533933,9534281
2338,4,11,1,2412,-78,-89,11,48:dd:0c:7d:86:2e,9536233,344,1608,9535889,9536233
2339,4,11,1,2412,-80,-89,9,48:dd:0c:7d:86:2e,9536724,358,133,9536366,9536724
2340,4,11,1,2412,-84,-89,5,48:dd:0c:7d:86:2e,9537139,344,71,9536795,9537139
2341,4,11,1,2412,-84,-89,5,48:dd:0c:7d:86:2e,9538000,358,503,9537642,9538000
2342,6,6,1,2412,-81,-89,8,10:86:8c:5f:93:1e,9551069,336,12733,9550733,9551069
2343,6,6,1,2412,-80,-89,9,b4:e6:2d:b4:ff:71,9554062,64,2929,9553998,9554062
2344,6,6,1,2412,-80,-89,9,,9554142,44,36,9554098,9554142
2345,4,1,1,2412,-84,-89,5,,9554905,304,459,9554601,9554905
2346,4,11,1,2412,-84,-89,5,4c:01:43:ec:a0:63,9563435,322,8208,9563113,9563435
2347,4,11,1,2412,-78,-89,11,48:dd:0c:90:e3:87,9567115,362,3318,9566753,9567115
2348,4,11,1,2412,-77,-89,12,48:dd:0c:90:e3:85,9567825,382,328,9567443,9567825
2349,4,1,1,2412,-86,-89,3,ac:67:84:84:8a:07,9572835,416,4594,9572419,9572835
2350,4,1,1,2412,-85,-89,4,,9575613,304,2474,9575309,9575613
2351,6,6,1,2412,-80,-89,9,12:86:8c:5f:93:1e,9576669,332,724,9576337,9576669
2352,4,1,1,2412,-80,-89,9,,9590968,304,13995,9590664,9590968
2353,4,1,1,2412,-78,-89,11,b0:e4:d5:32:ec:8a,9591405,1960,-1523,9589445,9591405
2354,4,1,1,2412,-87,-89,2,ac:67:84:84:8a:07,9593427,416,1606,9593011,9593427
2355,4,1,1,2412,-80,-89,9,,9593876,304,145,9593572,9593876
2356,7,39,1,2412,-78,-89,11,10:86:8c:5f:93:26,9594027,60,91,9593967,9594027
2357,6,24,1,2412,-80,-89,9,,9594102,28,47,9594074,9594102
2358,4,1,1,2412,-87,-89,2,,9595481,448,931,9595033,9595481
2359,6,6,1,2412,-79,-89,10,32:86:8c:5f:93:1e,9602360,332,6547,9602028,9602360
2360,6,6,1,2412,-76,-89,13,e2:db:d1:d1:b0:4a,9610194,444,7390,9609750,9610194
2361,6,6,1,2412,-77,-89,12,e2:db:d1:d1:b0:4b,9610671,408,69,9610263,9610671
2362,6,6,1,2412,-76,-89,13,e2:db:d1:d1:b0:4d,9611103,408,24,9610695,9611103
2363,6,24,1,2412,-83,-89,6,,9613835,28,2704,9613807,9613835
2364,4,1,1,2412,-79,-89,10,3c:bd:c5:ee:96:6d,9621028,2512,4681,9618516,9621028
2365,4,1,1,2412,-88,-89,1,bc:98:df:ff:0f:8b,9624573,2568,977,9622005,9624573
2366,4,1,1,2412,-85,-89,4,,9627621,304,2744,9627317,9627621
2367,6,6,1,2412,-79,-89,10,52:86:8c:5f:93:1e,9628077,332,124,9627745,9628077
2368,6,24,1,2412,-83,-89,6,,9630121,28,2016,9630093,9630121
2369,4,1,1,2412,-88,-89,1,ac:67:84:84:8a:07,9632652,416,2115,9632236,9632652
2370,4,11,1,2412,-80,-89,9,48:dd:0c:7d:86:27,9633608,362,594,9633246,9633608
2371,4,11,1,2412,-80,-89,9,48:dd:0c:7d:86:23,9633982,323,51,9633659,9633982
2372,4,11,1,2412,-79,-89,10,48:dd:0c:7d:86:25,9634317,382,-47,9633935,9634317
2373,4,11,1,2412,-87,-89,2,4c:01:43:d7:f3:23,9646154,322,11515,9645832,9646154
2374,6,6,1,2412,-80,-89,9,10:86:8c:5f:93:1e,9653470,336,6980,9653134,9653470
2375,4,1,1,2412,-86,-89,3,ac:67:84:84:8a:07,9656077,416,2191,9655661,9656077
2376,4,1,1,2412,-88,-89,1,,9656505,304,124,9656201,9656505
2377,4,1,1,2412,-86,-89,3,ac:67:84:84:8a:07,9656832,416,-89,9656416,9656832
2378,4,1,1,2412,-90,-89,-1,d2:9e:43:bc:eb:ff,9658825,3600,-1607,9655225,9658825
2379,4,11,1,2412,-78,-89,11,48:dd:0c:90:e3:83,9669889,323,10741,9669566,9669889
2380,4,11,1,2412,-81,-89,8,48:dd:0c:90:e3:85,9670225,382,-46,9669843,9670225
2381,4,1,1,2412,-84,-89,5,,9670709,304,180,9670405,9670709
2382,4,1,1,2412,-84,-89,5,78:67:0e:c4:a8:42,9672057,2736,-1388,9669321,9672057
2383,6,6,1,2412,-80,-89,9,b4:e6:2d:b4:ff:71,9674969,64,2848,9674905,9674969
2384,6,6,1,2412,-80,-89,9,,9675050,44,37,9675006,9675050
2385,4,1,1,2412,-83,-89,6,,9678756,304,3402,9678452,9678756
2386,6,6,1,2412,-80,-89,9,12:86:8c:5f:93:1e,9679212,332,124,9678880,9679212
2387,6,6,1,2412,-84,-89,5,,9681841,44,2585,9681797,9681841
2388,4,1,1,2412,-88,-89,1,,9683380,448,1091,9682932,9683380
2389,4,1,1,2412,-77,-89,12,b0:e4:d5:32:ec:8a,9693490,1960,8150,9691530,9693490
2390,6,6,1,2412,-79,-89,10,32:86:8c:5f:93:1e,9704670,332,10848,9704338,9704670
2391,6,24,1,2412,-83,-89,6,,9705107,28,409,9705079,9705107
2392,6,6,1,2412,-77,-89,12,e2:db:d1:d1:b0:4d,9713599,408,8084,9713191,9713599
2393,6,6,1,2412,-77,-89,12,e2:db:d1:d1:b0:4f,9714031,408,24,9713623,9714031
2394,4,1,1,2412,-78,-89,11,3c:bd:c5:ee:96:6d,9724019,2512,7476,9721507,9724019
2395,4,1,1,2412,-88,-89,1,bc:98:df:ff:0f:8b,9726996,2568,409,9724428,9726996
2396,6,6,1,2412,-81,-89,8,52:86:8c:5f:93:1e,9730270,332,2942,9729938,9730270
2397,4,1,1,2412,-88,-89,1,ac:67:84:84:8a:07,9732338,416,1652,9731922,9732338
2398,4,1,1,2412,-89,-89,0,,9732766,304,124,9732462,9732766
2399,4,11,1,2412,-80,-89,9,48:dd:0c:7d:86:27,9736007,362,2879,9735645,9736007
2400,4,11,1,2412,-80,-89,9,48:dd:0c:7d:86:23,9736382,323,52,9736059,9736382
2401,4,11,1,2412,-81,-89,8,48:dd:0c:7d:86:25,9736717,382,-47,9736335,9736717
2402,4,1,1,2412,-84,-89,5,,9742475,304,5454,9742171,9742475
2403,4,1,1,2412,-85,-89,4,,9747336,352,4509,9746984,9747336
2404,4,11,1,2412,-83,-89,6,,9749836,107,2393,9749729,9749836
2405,6,6,1,2412,-80,-89,9,10:86:8c:5f:93:1e,9755870,336,5698,9755534,9755870
2406,6,6,1,2412,-77,-89,12,f8:4f:ad:f9:af:82,9759742,576,3296,9759166,9759742
2407,6,6,1,2412,-77,-89,12,f8:4f:ad:f9:af:82,9761447,548,1157,9760899,9761447
2408,4,1,1,2412,-87,-89,2,78:67:0e:38:6c:d3,9762849,2736,-1334,9760113,9762849
2409,6,6,1,2412,-81,-89,8,12:86:8c:5f:93:1e,9781476,332,18295,9781144,9781476
2410,6,24,1,2412,-82,-89,7,,9785125,28,3621,9785097,9785125
2411,6,6,1,2412,-79,-89,10,32:86:8c:5f:93:1e,9807071,332,21614,9806739,9807071
2412,4,1,1,2412,-83,-89,6,b4:b5:2f:17:0c:b9,9813738,1376,5291,9812362,9813738
2413,6,6,1,2412,-77,-89,12,e2:db:d1:d1:b0:4b,9815457,408,1311,9815049,9815457
2414,6,6,1,2412,-76,-89,13,e2:db:d1:d1:b0:4d,9815897,408,32,9815489,9815897
2415,4,1,1,2412,-78,-89,11,3c:bd:c5:ee:96:6d,9826065,2512,7656,9823553,9826065
2416,6,6,1,2412,-81,-89,8,52:86:8c:5f:93:1e,9832671,332,6274,9832339,9832671
2417,4,1,1,2412,-86,-89,3,ac:67:84:84:8a:07,9834838,416,1751,9834422,9834838
2418,4,11,1,2412,-80,-89,9,48:dd:0c:7d:86:27,9838407,362,3207,9838045,9838407
2419,4,11,1,2412,-80,-89,9,48:dd:0c:7d:86:23,9838782,323,52,9838459,9838782
2420,4,11,1,2412,-80,-89,9,48:dd:0c:7d:86:25,9839117,382,-47,9838735,9839117
2421,6,6,1,2412,-80,-89,9,10:86:8c:5f:93:1e,9858271,336,18818,9857935,9858271
2422,4,1,1,2412,-88,-89,1,78:67:0e:38:6c:d3,9865249,2736,4242,9862513,9865249
2423,4,11,1,2412,-77,-89,12,48:dd:0c:90:e3:83,9874689,323,9117,9874366,9874689
2424,4,11,1,2412,-85,-89,4,48:dd:0c:90:e3:85,9875024,382,-47,9874642,9875024
2425,4,1,1,2412,-86,-89,3,78:67:0e:c4:a8:42,9876603,2736,-1157,9873867,9876603
2426,4,1,1,2412,-79,-89,10,b0:e4:d5:32:ec:8a,9898288,1960,19725,9896328,9898288
2427,6,6,1,2412,-81,-89,8,32:86:8c:5f:93:1e,9909471,332,10851,9909139,9909471
2428,4,1,1,2412,-85,-89,4,b4:b5:2f:17:0c:b9,9916140,1376,5293,9914764,9916140
2429,6,6,1,2412,-76,-89,13,e2:db:d1:d1:b0:4a,9917373,444,789,9916929,9917373
2430,6,6,1,2412,-78,-89,11,e2:db:d1:d1:b0:4b,9917849,408,68,9917441,9917849
2431,6,6,1,2412,-77,-89,12,e2:db:d1:d1:b0:4d,9918299,408,42,9917891,9918299
2432,6,6,1,2412,-77,-89,12,e2:db:d1:d1:b0:4f,9918740,408,33,9918332,9918740
2433,4,1,1,2412,-84,-89,5,,9924357,304,5313,9924053,9924357
2434,4,1,1,2412,-84,-89,5,,9925607,304,946,9925303,9925607
2435,4,1,1,2412,-79,-89,10,3c:bd:c5:ee:96:6d,9928291,2512,172,9925779,9928291
2436,4,1,1,2412,-87,-89,2,bc:98:df:ff:0f:8b,9931813,2568,954,9929245,9931813
2437,6,6,1,2412,-80,-89,9,52:86:8c:5f:93:1e,9935072,332,2927,9934740,9935072
2438,4,11,1,2412,-79,-89,10,48:dd:0c:7d:86:27,9940807,362,5373,9940445,9940807
2439,4,11,1,2412,-80,-89,9,48:dd:0c:7d:86:23,9941181,323,51,9940858,9941181
2440,4,11,1,2412,-79,-89,10,48:dd:0c:7d:86:25,9941517,382,-46,9941135,9941517
2441,6,24,1,2412,-83,-89,6,,9951048,28,9503,9951020,9951048
2442,4,11,1,2412,-84,-89,5,,9952611,107,1456,9952504,9952611
2443,4,1,1,2412,-82,-89,7,b0:5a:da:70:43:1a,9954125,2440,-926,9951685,9954125
2444,6,24,1,2412,-83,-89,6,,9958500,28,4347,9958472,9958500
2445,6,6,1,2412,-80,-89,9,10:86:8c:5f:93:1e,9962576,336,3740,9962240,9962576
2446,4,1,1,2412,-87,-89,2,78:67:0e:38:6c:d3,9967650,2736,2338,9964914,9967650
2447,4,11,1,2412,-72,-89,17,48:dd:0c:90:e3:87,9976714,362,8702,9976352,9976714
2448,4,11,1,2412,-83,-89,6,48:dd:0c:90:e3:85,9977424,382,328,9977042,9977424
2449,4,1,1,2412,-86,-89,3,78:67:0e:c4:a8:42,9979003,2736,-1157,9976267,9979003
2450,6,6,1,2412,-81,-89,8,12:86:8c:5f:93:1e,9986272,332,6937,9985940,9986272
2451,4,1,1,2412,-83,-89,6,,10004545,304,17969,10004241,10004545
2452,6,6,1,2412,-76,-91,15,e2:db:d1:d1:b0:4a,10019910,444,14921,10019466,10019910
2453,6,6,1,2412,-77,-91,14,e2:db:d1:d1:b0:4b,10020386,408,68,10019978,10020386
2454,6,6,1,2412,-77,-91,14,e2:db:d1:d1:b0:4d,10020818,408,24,10020410,10020818
2455,6,6,1,2412,-77,-91,14,e2:db:d1:d1:b0:4f,10021277,408,51,10020869,10021277
2456,4,1,1,2412,-79,-91,12,3c:bd:c5:ee:96:6d,10031163,2512,7374,10028651,10031163
2457,6,6,1,2412,-81,-91,10,52:86:8c:5f:93:1e,10037472,332,5977,10037140,10037472
2458,4,1,1,2412,-88,-91,3,d2:9e:43:bc:eb:ff,10044933,3552,3909,10041381,10044933
2459,4,11,1,2412,-72,-91,19,48:dd:0c:90:e3:83,10079488,323,34232,10079165,10079488
2460,4,11,1,2412,-82,-91,9,48:dd:0c:90:e3:85,10079824,382,-46,10079442,10079824
2461,4,11,1,2412,-84,-91,7,,10086967,107,7036,10086860,10086967
2462,6,6,1,2412,-80,-91,11,12:86:8c:5f:93:1e,10088888,332,1589,10088556,10088888
2463,4,1,1,2412,-86,-91,5,,10090327,352,1087,10089975,10090327
2464,4,1,1,2412,-85,-91,6,,10091453,352,774,10091101,10091453
2465,4,1,1,2412,-87,-91,4,,10093645,448,1744,10093197,10093645
2466,4,1,1,2412,-91,-91,0,,10094247,352,250,10093895,10094247
2467,6,24,1,2412,-82,-91,9,,10095563,28,1288,10095535,10095563
2468,4,1,1,2412,-82,-91,9,d2:9e:43:bc:eb:ff,10096365,3600,-2798,10092765,10096365
2469,4,1,1,2412,-85,-91,6,ac:67:84:84:8a:07,10106133,416,9352,10105717,10106133
2470,6,6,1,2412,-86,-91,5,,10106620,44,443,10106576,10106620
2471,6,24,1,2412,-82,-91,9,,10110324,28,3676,10110296,10110324
2472,6,6,1,2412,-81,-91,10,32:86:8c:5f:93:1e,10114362,332,3706,10114030,10114362
2473,6,6,1,2412,-74,-91,17,e2:db:d1:d1:b0:4a,10122176,444,7370,10121732,10122176
2474,6,6,1,2412,-76,-91,15,e2:db:d1:d1:b0:4b,10122671,408,87,10122263,10122671
2475,6,6,1,2412,-77,-91,14,e2:db:d1:d1:b0:4d,10123103,408,24,10122695,10123103
2476,6,6,1,2412,-76,-91,15,e2:db:d1:d1:b0:4f,10123534,408,23,10123126,10123534
2477,4,1,1,2412,-86,-91,5,ac:67:84:84:8a:07,10132431,416,8481,10132015,10132431
2478,4,1,1,2412,-79,-91,12,3c:bd:c5:ee:96:6d,10133025,2512,-1918,10130513,10133025
2479,4,11,1,2412,-83,-91,8,,10139581,107,6449,10139474,10139581
2480,6,6,1,2412,-80,-91,11,52:86:8c:5f:93:1e,10140076,332,163,10139744,10140076
2481,4,1,1,2412,-85,-91,6,,10140839,352,411,10140487,10140839
2482,6,6,1,2412,-77,-91,14,f8:4f:ad:f9:af:82,10145050,156,4055,10144894,10145050
2483,4,11,1,2412,-79,-91,12,48:dd:0c:7d:86:27,10145606,362,194,10145244,10145606
2484,4,11,1,2412,-81,-91,10,48:dd:0c:7d:86:23,10145981,323,52,10145658,10145981
2485,4,11,1,2412,-80,-91,11,48:dd:0c:7d:86:25,10146316,382,-47,10145934,10146316
2486,6,6,1,2412,-77,-91,14,f8:4f:ad:f9:af:82,10160109,656,13137,10159453,10160109
2487,6,6,1,2412,-77,-91,14,f8:4f:ad:f9:af:82,10161109,632,368,10160477,10161109
2488,6,6,1,2412,-80,-91,11,10:86:8c:5f:93:1e,10165473,336,4028,10165137,10165473
2489,6,6,1,2412,-84,-91,7,,10168582,44,3065,10168538,10168582
2490,4,1,1,2412,-87,-91,4,78:67:0e:38:6c:d3,10172450,2736,1132,10169714,10172450
2491,6,24,1,2412,-83,-91,8,,10175264,28,2786,10175236,10175264
2492,4,1,1,2412,-87,-91,4,ac:67:84:84:8a:07,10175525,416,-155,10175109,10175525
2493,4,11,1,2412,-76,-91,15,48:dd:0c:90:e3:87,10181514,362,5627,10181152,10181514
2494,4,11,1,2412,-83,-91,8,48:dd:0c:90:e3:85,10182223,382,327,10181841,10182223
2495,4,1,1,2412,-85,-91,6,78:67:0e:c4:a8:42,10183872,2736,-1087,10181136,10183872
2496,6,24,1,2412,-83,-91,8,,10190807,28,6907,10190779,10190807
2497,6,6,1,2412,-80,-91,11,12:86:8c:5f:93:1e,10191074,332,-65,10190742,10191074
2498,4,1,1,2412,-87,-91,4,ac:67:84:84:8a:07,10194590,416,3100,10194174,10194590
2499,4,1,1,2412,-86,-91,5,,10196529,448,1491,10196081,10196529
2500,6,24,1,2412,-83,-91,8,,10197872,28,1315,10197844,10197872
2501,4,1,1,2412,-79,-91,12,b0:e4:d5:32:ec:8a,10205486,1960,5654,10203526,10205486
2502,6,6,1,2412,-80,-91,11,32:86:8c:5f:93:1e,10216674,332,10856,10216342,10216674
2503,4,1,1,2412,-85,-91,6,b4:b5:2f:17:0c:b9,10223346,1376,5296,10221970,10223346
2504,6,6,1,2412,-77,-91,14,e2:db:d1:d1:b0:4a,10224578,444,788,10224134,10224578
2505,6,6,1,2412,-76,-91,15,e2:db:d1:d1:b0:4b,10225064,408,78,10224656,10225064
2506,6,6,1,2412,-76,-91,15,e2:db:d1:d1:b0:4f,10225945,408,473,10225537,10225945
2507,4,1,1,2412,-79,-91,12,3c:bd:c5:ee:96:6d,10237207,2512,8750,10234695,10237207
2508,6,6,1,2412,-80,-91,11,52:86:8c:5f:93:1e,10242274,332,4735,10241942,10242274
2509,4,11,1,2412,-80,-91,11,48:dd:0c:7d:86:27,10248006,362,5370,10247644,10248006
2510,4,11,1,2412,-81,-91,10,48:dd:0c:7d:86:23,10248381,323,52,10248058,10248381
2511,4,11,1,2412,-80,-91,11,48:dd:0c:7d:86:25,10248716,382,-47,10248334,10248716
2512,4,1,1,2412,-88,-91,3,,10253662,304,4642,10253358,10253662
2513,4,1,1,2412,-88,-91,3,,10254028,352,14,10253676,10254028
2514,4,1,1,2412,-86,-91,5,ac:67:84:84:8a:07,10257100,416,2656,10256684,10257100
2515,6,6,1,2412,-77,-91,14,f8:4f:ad:f9:af:82,10262115,576,4439,10261539,10262115
2516,6,6,1,2412,-76,-91,15,f8:4f:ad:f9:af:82,10264891,548,2228,10264343,10264891
2517,6,6,1,2412,-80,-91,11,10:86:8c:5f:93:1e,10267874,336,2647,10267538,10267874
2518,4,11,1,2412,-83,-91,8,10:86:8c:5f:93:26,10268409,347,188,10268062,10268409
2519,6,24,1,2412,-83,-91,8,,10270264,28,1827,10270236,10270264
2520,6,6,1,2412,-79,-91,12,b4:e6:2d:b4:ff:71,10270341,64,13,10270277,10270341
2521,6,6,1,2412,-81,-91,10,b4:e6:2d:b4:ff:71,10270773,64,368,10270709,10270773
2522,6,6,1,2412,-80,-91,11,,10270853,44,36,10270809,10270853
2523,4,11,1,2412,-78,-91,13,48:dd:0c:90:e3:87,10283913,362,12698,10283551,10283913
2524,4,1,1,2412,-83,-91,8,78:67:0e:c4:a8:42,10286202,2736,-447,10283466,10286202
2525,6,6,1,2412,-80,-91,11,12:86:8c:5f:93:1e,10294700,332,8166,10294368,10294700
2526,4,1,1,2412,-88,-91,3,,10298826,384,3742,10298442,10298826
2527,4,1,1,2412,-87,-91,4,,10300111,448,837,10299663,10300111
2528,4,1,1,2412,-78,-91,13,b0:e4:d5:32:ec:8a,10307886,1960,5815,10305926,10307886
2529,6,6,1,2412,-77,-91,14,e2:db:d1:d1:b0:4b,10327474,408,19180,10327066,10327474
2530,6,6,1,2412,-76,-91,15,e2:db:d1:d1:b0:4d,10327906,408,24,10327498,10327906
2531,6,6,1,2412,-77,-91,14,e2:db:d1:d1:b0:4f,10328365,408,51,10327957,10328365
2532,4,1,1,2412,-87,-91,4,bc:98:df:ff:0f:8b,10341326,2568,10393,10338758,10341326
2533,6,24,1,2412,-82,-91,9,,10345589,28,4235,10345561,10345589
2534,4,11,1,2412,-80,-91,11,48:dd:0c:7d:86:27,10350406,362,4455,10350044,10350406
2535,4,11,1,2412,-80,-91,11,48:dd:0c:7d:86:23,10350780,323,51,10350457,10350780
2536,4,11,1,2412,-80,-91,11,48:dd:0c:7d:86:25,10351116,382,-46,10350734,10351116
2537,6,24,1,2412,-83,-91,8,,10351354,28,210,10351326,10351354
2538,6,24,1,2412,-78,-91,13,,10357690,28,6308,10357662,10357690
2539,6,6,1,2412,-84,-91,7,,10365812,44,8078,10365768,10365812
2540,6,6,1,2412,-82,-91,9,10:86:8c:5f:93:1e,10370275,336,4127,10369939,10370275
2541,4,1,1,2412,-86,-91,5,78:67:0e:38:6c:d3,10377250,2736,4239,10374514,10377250
2542,4,11,1,2412,-85,-91,6,4c:01:43:ec:a0:63,10381367,322,3795,10381045,10381367
2543,4,11,1,2412,-85,-91,6,4c:01:43:ec:a0:66,10381702,387,-52,10381315,10381702
2544,4,11,1,2412,-82,-91,9,48:dd:0c:90:e3:85,10387023,382,4939,10386641,10387023
2545,4,1,1,2412,-84,-91,7,78:67:0e:c4:a8:42,10388602,2736,-1157,10385866,10388602
2546,6,6,1,2412,-81,-91,10,12:86:8c:5f:93:1e,10395875,332,6941,10395543,10395875
2547,4,1,1,2412,-86,-91,5,,10402044,448,5721,10401596,10402044
2548,4,1,1,2412,-89,-91,2,,10402930,448,438,10402482,10402930
2549,6,6,1,2412,-77,-91,14,f8:4f:ad:f9:af:82,10406507,248,3329,10406259,10406507
2550,6,6,1,2412,-77,-91,14,f8:4f:ad:f9:af:82,10408874,224,2143,10408650,10408874
2551,4,1,1,2412,-79,-91,12,b0:e4:d5:32:ec:8a,10410285,1960,-549,10408325,10410285
2552,6,24,1,2412,-83,-91,8,,10413849,28,3536,10413821,10413849
2553,6,6,1,2412,-81,-91,10,32:86:8c:5f:93:1e,10421475,332,7294,10421143,10421475
2554,6,6,1,2412,-85,-91,6,,10426206,44,4687,10426162,10426206
2555,4,1,1,2412,-85,-91,6,b4:b5:2f:17:0c:b9,10428149,1376,567,10426773,10428149
2556,6,6,1,2412,-78,-91,13,e2:db:d1:d1:b0:4b,10429850,408,1293,10429442,10429850
2557,6,6,1,2412,-74,-91,17,e2:db:d1:d1:b0:4d,10430308,408,50,10429900,10430308
2558,6,6,1,2412,-75,-91,16,e2:db:d1:d1:b0:4f,10430758,408,42,10430350,10430758
2559,4,1,1,2412,-88,-91,3,c8:9e:43:bc:eb:ff,10433719,3496,-535,10430223,10433719
2560,4,1,1,2412,-78,-91,13,3c:bd:c5:ee:96:6d,10440997,2512,4766,10438485,10440997
2561,4,1,1,2412,-88,-91,3,bc:98:df:ff:0f:8b,10443795,2568,230,10441227,10443795
2562,6,6,1,2412,-81,-91,10,52:86:8c:5f:93:1e,10447421,332,3294,10447089,10447421
2563,6,6,1,2412,-84,-91,7,,10452155,44,4690,10452111,10452155
2564,4,11,1,2412,-80,-91,11,48:dd:0c:7d:86:27,10452806,362,289,10452444,10452806
2565,4,11,1,2412,-81,-91,10,48:dd:0c:7d:86:23,10453180,323,51,10452857,10453180
2566,4,11,1,2412,-80,-91,11,48:dd:0c:7d:86:25,10453515,382,-47,10453133,10453515
2567,6,6,1,2412,-80,-91,11,b4:e6:2d:b4:ff:71,10453785,64,206,10453721,10453785
2568,6,6,1,2412,-81,-91,10,,10453865,44,36,10453821,10453865
2569,4,11,1,2412,-88,-91,3,4c:01:43:d7:f3:23,10465350,322,11163,10465028,10465350
2570,4,1,1,2412,-86,-91,5,38:01:46:30:1a:ca,10465681,416,-85,10465265,10465681
2571,6,6,1,2412,-85,-91,6,,10468882,44,3157,10468838,10468882
2572,4,1,1,2412,-81,-91,10,66:32:b1:64:4c:f2,10479647,2696,8069,10476951,10479647
2573,4,11,1,2412,-77,-91,14,48:dd:0c:90:e3:87,10488713,362,8704,10488351,10488713
2574,6,24,1,2412,-81,-91,10,,10493844,28,5103,10493816,10493844
2575,6,6,1,2412,-80,-91,11,12:86:8c:5f:93:1e,10498276,332,4100,10497944,10498276
2576,4,1,1,2412,-87,-91,4,,10504808,448,6084,10504360,10504808
2577,6,24,1,2412,-84,-91,7,,10505115,28,279,10505087,10505115
2578,4,1,1,2412,-87,-91,4,,10505703,448,140,10505255,10505703
2579,6,24,1,2412,-82,-91,9,,10510734,28,5003,10510706,10510734
2580,6,6,1,2412,-77,-91,14,f8:4f:ad:f9:af:82,10510876,328,-186,10510548,10510876
2581,4,1,1,2412,-79,-91,12,b0:e4:d5:32:ec:8a,10512684,1960,-152,10510724,10512684
2582,6,24,1,2412,-83,-91,8,,10517801,28,5089,10517773,10517801
2583,4,1,1,2412,-84,-91,7,b4:b5:2f:17:0c:b9,10530551,1376,11374,10529175,10530551
2584,6,6,1,2412,-76,-91,15,e2:db:d1:d1:b0:4a,10531792,444,797,10531348,10531792
2585,6,6,1,2412,-77,-91,14,e2:db:d1:d1:b0:4b,10532379,408,179,10531971,10532379
2586,6,6,1,2412,-77,-91,14,e2:db:d1:d1:b0:4f,10533297,408,510,10532889,10533297
2587,4,1,1,2412,-88,-91,3,bc:98:df:ff:0f:8b,10546190,2568,10325,10543622,10546190
2588,4,11,1,2412,-80,-91,11,48:dd:0c:7d:86:27,10555206,362,8654,10554844,10555206
2589,4,11,1,2412,-79,-91,12,48:dd:0c:7d:86:23,10555580,323,51,10555257,10555580
2590,4,11,1,2412,-80,-91,11,48:dd:0c:7d:86:25,10555915,382,-47,10555533,10555915
2591,4,1,1,2412,-88,-91,3,ac:67:84:84:8a:07,10556636,416,305,10556220,10556636
2592,4,1,1,2412,-88,-91,3,3c:bd:c5:79:6b:56,10561327,1120,3571,10560207,10561327
2593,4,1,1,2412,-87,-91,4,b4:b5:2f:17:0c:b9,10562475,1328,-180,10561147,10562475
2594,4,1,1,2412,-76,-91,15,b0:e4:d5:32:ec:8a,10564984,1912,597,10563072,10564984
2595,4,1,1,2412,-78,-91,13,b0:e4:d5:32:ec:8a,10567014,1912,118,10565102,10567014
2596,4,1,1,2412,-79,-91,12,3c:bd:c5:ee:96:6d,10571130,3280,836,10567850,10571130
2597,4,1,1,2412,-78,-91,13,3c:bd:c5:ee:96:6d,10574749,3280,339,10571469,10574749
2598,4,1,1,2412,-89,-91,2,ac:67:84:84:8a:07,10580482,416,5317,10580066,10580482
2599,4,1,1,2412,-81,-91,10,66:32:b1:64:4c:f2,10581981,2696,-1197,10579285,10581981
2600,4,1,1,2412,-86,-91,5,7c:f6:66:c4:c4:3a,10584980,2208,791,10582772,10584980
2601,4,11,1,2412,-77,-91,14,48:dd:0c:90:e3:87,10591113,362,5771,10590751,10591113
2602,4,11,1,2412,-77,-91,14,48:dd:0c:90:e3:83,10591487,323,51,10591164,10591487
2603,4,11,1,2412,-83,-91,8,48:dd:0c:90:e3:85,10591822,382,-47,10591440,10591822
2604,4,11,1,2412,-87,-91,4,4c:01:43:ec:a0:66,10592408,382,204,10592026,10592408
2605,6,6,1,2412,-80,-91,11,12:86:8c:5f:93:1e,10601249,332,8509,10600917,10601249
2606,4,1,1,2412,-89,-91,2,,10608066,384,6433,10607682,10608066
2607,4,1,1,2412,-88,-91,3,,10608465,448,-49,10608017,10608465
2608,6,6,1,2412,-77,-91,14,f8:4f:ad:f9:af:82,10611332,1292,1575,10610040,10611332
2609,4,1,1,2412,-83,-91,8,,10614218,352,2534,10613866,10614218
2610,4,1,1,2412,-83,-91,8,,10614670,352,100,10614318,10614670
2611,4,1,1,2412,-79,-91,12,b0:e4:d5:32:ec:8a,10615084,1960,-1546,10613124,10615084
2612,4,1,1,2412,-85,-91,6,,10617321,352,1885,10616969,10617321
2613,4,1,1,2412,-81,-91,10,,10617782,352,109,10617430,10617782
2614,4,1,1,2412,-82,-91,9,,10618261,352,127,10617909,10618261
2615,4,1,1,2412,-85,-91,6,,10619552,352,939,10619200,10619552
2616,4,1,1,2412,-85,-91,6,,10620294,352,390,10619942,10620294
2617,4,1,1,2412,-84,-91,7,,10621583,352,937,10621231,10621583
2618,4,1,1,2412,-83,-91,8,,10622055,352,120,10621703,10622055
2619,4,1,1,2412,-83,-91,8,,10622507,352,100,10622155,10622507
2620,4,1,1,2412,-83,-91,8,,10623246,352,387,10622894,10623246
2621,4,1,1,2412,-82,-91,9,,10623752,352,154,10623400,10623752
2622,4,1,1,2412,-88,-91,3,,10624258,352,154,10623906,10624258
2623,4,1,1,2412,-84,-91,7,,10625111,352,501,10624759,10625111
2624,4,1,1,2412,-85,-91,6,,10626370,304,955,10626066,10626370
2625,6,6,1,2412,-81,-91,10,32:86:8c:5f:93:1e,10626826,332,124,10626494,10626826
2626,4,1,1,2412,-85,-91,6,b4:b5:2f:17:0c:b9,10632953,1376,4751,10631577,10632953
2627,6,6,1,2412,-76,-91,15,e2:db:d1:d1:b0:4a,10634194,444,797,10633750,10634194
2628,6,6,1,2412,-76,-91,15,e2:db:d1:d1:b0:4b,10634689,408,87,10634281,10634689
2629,6,6,1,2412,-77,-91,14,e2:db:d1:d1:b0:4d,10635130,408,33,10634722,10635130
2630,4,1,1,2412,-90,-91,1,ce:f4:11:65:3f:f8,10636996,2072,-206,10634924,10636996
2631,4,1,1,2412,-89,-91,2,ac:67:84:84:8a:07,10644411,416,6999,10643995,10644411
2632,4,1,1,2412,-79,-91,12,3c:bd:c5:ee:96:6d,10645717,2512,-1206,10643205,10645717
2633,4,1,1,2412,-75,-91,16,b8:f8:53:cb:31:f1,10648256,976,1563,10647280,10648256
2634,4,11,1,2412,-80,-91,11,48:dd:0c:7d:86:27,10657605,362,8987,10657243,10657605
2635,4,11,1,2412,-80,-91,11,48:dd:0c:7d:86:23,10657980,323,52,10657657,10657980
2636,4,11,1,2412,-79,-91,12,48:dd:0c:7d:86:25,10658315,382,-47,10657933,10658315
2637,6,24,1,2412,-82,-91,9,,10670778,28,12435,10670750,10670778
2638,6,6,1,2412,-85,-91,6,,10671055,44,233,10671011,10671055
2639,4,1,1,2412,-83,-91,8,,10672648,352,1241,10672296,10672648
2640,4,1,1,2412,-84,-91,7,,10673632,352,632,10673280,10673632
2641,4,1,1,2412,-84,-91,7,,10674553,352,569,10674201,10674553
2642,4,1,1,2412,-84,-91,7,ac:67:84:84:8a:07,10678062,416,3093,10677646,10678062
2643,4,11,1,2412,-77,-91,14,48:dd:0c:90:e3:87,10693512,362,15088,10693150,10693512
2644,4,1,1,2412,-86,-91,5,78:67:0e:c4:a8:42,10695802,2736,-446,10693066,10695802
2645,4,1,1,2412,-85,-91,6,,10702766,304,6660,10702462,10702766
2646,6,6,1,2412,-81,-91,10,12:86:8c:5f:93:1e,10703223,332,125,10702891,10703223
2647,4,1,1,2412,-79,-91,12,b0:e4:d5:32:ec:8a,10717694,1960,12511,10715734,10717694
2648,4,1,1,2412,-86,-91,5,38:01:46:30:1a:ca,10726001,416,7891,10725585,10726001
2649,4,1,1,2412,-83,-91,8,,10727604,304,1299,10727300,10727604
2650,6,6,1,2412,-80,-91,11,32:86:8c:5f:93:1e,10728677,332,741,10728345,10728677
2651,4,1,1,2412,-89,-91,2,ce:f4:11:65:3f:f8,10739396,2072,8647,10737324,10739396
2652,6,24,1,2412,-83,-91,8,,10745122,28,5698,10745094,10745122
2653,4,1,1,2412,-79,-91,12,3c:bd:c5:ee:96:6d,10747623,2512,-11,10745111,10747623
2654,6,6,1,2412,-80,-91,11,52:86:8c:5f:93:1e,10754278,332,6323,10753946,10754278
2655,4,1,1,2412,-87,-91,4,ac:67:84:84:8a:07,10757304,416,2610,10756888,10757304
2656,4,11,1,2412,-79,-91,12,48:dd:0c:7d:86:27,10760005,362,2339,10759643,10760005
2657,4,11,1,2412,-80,-91,11,48:dd:0c:7d:86:23,10760380,323,52,10760057,10760380
2658,4,11,1,2412,-80,-91,11,48:dd:0c:7d:86:25,10760715,382,-47,10760333,10760715
2659,4,1,1,2412,-89,-91,2,c8:9e:43:bc:eb:ff,10763522,3496,-689,10760026,10763522
2660,4,1,1,2412,-86,-91,5,,10770326,304,6500,10770022,10770326
2661,6,24,1,2412,-83,-91,8,,10778867,28,8513,10778839,10778867
2662,4,1,1,2412,-88,-91,3,ac:67:84:84:8a:07,10779241,416,-42,10778825,10779241
2663,4,11,1,2412,-85,-91,6,4c:01:43:ec:a0:63,10790962,322,11399,10790640,10790962
2664,4,11,1,2412,-78,-91,13,48:dd:0c:90:e3:87,10795912,362,4588,10795550,10795912
2665,4,11,1,2412,-78,-91,13,48:dd:0c:90:e3:83,10796287,323,52,10795964,10796287
2666,4,11,1,2412,-83,-91,8,48:dd:0c:90:e3:85,10796622,382,-47,10796240,10796622
2667,4,1,1,2412,-84,-91,7,78:67:0e:c4:a8:42,10798201,2736,-1157,10795465,10798201
2668,6,6,1,2412,-82,-91,9,12:86:8c:5f:93:1e,10806214,332,7681,10805882,10806214
2669,4,1,1,2412,-86,-91,5,,10814131,448,7469,10813683,10814131
2670,4,1,1,2412,-79,-91,12,b0:e4:d5:32:ec:8a,10819882,1960,3791,10817922,10819882
2671,4,1,1,2412,-82,-91,9,,10824066,304,3880,10823762,10824066
2672,6,24,1,2412,-82,-91,9,,10825118,28,1024,10825090,10825118
2673,4,1,1,2412,-83,-91,8,,10825318,304,-104,10825014,10825318
2674,6,6,1,2412,-84,-91,7,,10825973,44,611,10825929,10825973
2675,4,1,1,2412,-85,-91,6,78:67:0e:c4:a8:42,10826867,848,46,10826019,10826867
2676,6,6,1,2412,-80,-91,11,32:86:8c:5f:93:1e,10831078,332,3879,10830746,10831078
2677,4,1,1,2412,-86,-91,5,b4:b5:2f:17:0c:b9,10837756,1376,5302,10836380,10837756
2678,6,6,1,2412,-77,-91,14,e2:db:d1:d1:b0:4a,10838998,444,798,10838554,10838998
2679,6,6,1,2412,-76,-91,15,e2:db:d1:d1:b0:4b,10839474,408,68,10839066,10839474
2680,6,6,1,2412,-77,-91,14,e2:db:d1:d1:b0:4d,10839925,408,43,10839517,10839925
2681,6,6,1,2412,-76,-91,15,e2:db:d1:d1:b0:4f,10840383,408,50,10839975,10840383
2682,4,1,1,2412,-79,-91,12,3c:bd:c5:ee:96:6d,10849881,2512,6986,10847369,10849881
2683,4,1,1,2412,-87,-91,4,bc:98:df:ff:0f:8b,10853319,2568,870,10850751,10853319
2684,6,6,1,2412,-80,-91,11,52:86:8c:5f:93:1e,10856744,332,3093,10856412,10856744
2685,6,6,1,2412,-76,-91,15,e2:db:d1:d1:b0:4a,10858269,64,1461,10858205,10858269
2686,6,6,1,2412,-77,-91,14,,10858413,44,100,10858369,10858413
2687,4,11,1,2412,-80,-91,11,48:dd:0c:7d:86:27,10862405,362,3630,10862043,10862405
2688,4,11,1,2412,-79,-91,12,48:dd:0c:7d:86:23,10862779,323,51,10862456,10862779
2689,4,11,1,2412,-79,-91,12,48:dd:0c:7d:86:25,10863115,382,-46,10862733,10863115
2690,4,1,1,2412,-84,-91,7,,10868834,304,5415,10868530,10868834
2691,4,1,1,2412,-88,-91,3,ce:9e:43:bc:eb:ff,10870502,3800,-2132,10866702,10870502
2692,4,1,1,2412,-89,-91,2,c8:9e:43:bc:eb:ff,10874313,3496,315,10870817,10874313
2693,4,1,1,2412,-85,-91,6,,10879475,304,4858,10879171,10879475
2694,6,6,1,2412,-81,-91,10,10:86:8c:5f:93:1e,10882279,336,2468,10881943,10882279
2695,6,6,1,2412,-86,-91,5,,10891926,44,9603,10891882,10891926
2696,4,11,1,2412,-77,-91,14,48:dd:0c:90:e3:87,10898312,362,6024,10897950,10898312
2697,4,11,1,2412,-78,-91,13,48:dd:0c:90:e3:83,10898686,323,51,10898363,10898686
2698,4,11,1,2412,-84,-91,7,48:dd:0c:90:e3:85,10899022,382,-46,10898640,10899022
2699,4,1,1,2412,-84,-91,7,78:67:0e:c4:a8:42,10900601,2736,-1157,10897865,10900601
2700,6,6,1,2412,-81,-91,10,12:86:8c:5f:93:1e,10907879,332,6946,10907547,10907879
2701,6,24,1,2412,-82,-91,9,,10910133,28,2226,10910105,10910133
2702,6,24,1,2412,-82,-91,9,,10917697,28,7536,10917669,10917697
2703,4,1,1,2412,-78,-91,13,b0:e4:d5:32:ec:8a,10922282,1960,2625,10920322,10922282
2704,4,1,1,2412,-84,-91,7,,10925748,304,3162,10925444,10925748
2705,6,6,1,2412,-79,-91,12,32:86:8c:5f:93:1e,10933479,332,7399,10933147,10933479
2706,4,1,1,2412,-85,-91,6,b4:b5:2f:17:0c:b9,10940158,1376,5303,10938782,10940158
2707,6,6,1,2412,-77,-91,14,e2:db:d1:d1:b0:4b,10941813,408,1247,10941405,10941813
2708,6,6,1,2412,-77,-91,14,e2:db:d1:d1:b0:4d,10942263,408,42,10941855,10942263
2709,6,6,1,2412,-77,-91,14,e2:db:d1:d1:b0:4f,10942695,408,24,10942287,10942695
2710,4,1,1,2412,-78,-91,13,3c:bd:c5:ee:96:6d,10952210,2512,7003,10949698,10952210
2711,4,1,1,2412,-78,-91,13,b8:f8:53:cb:31:f1,10954851,976,1665,10953875,10954851
2712,4,1,1,2412,-88,-91,3,b8:f8:53:cb:31:f1,10955853,976,26,10954877,10955853
2713,4,1,1,2412,-88,-91,3,,10959326,304,3169,10959022,10959326
2714,4,11,1,2412,-86,-91,5,4c:01:43:ec:a0:63,10959679,254,99,10959425,10959679
2715,6,6,1,2412,-80,-91,11,52:86:8c:5f:93:1e,10960756,332,745,10960424,10960756
2716,4,1,1,2412,-78,-91,13,,10962649,304,1589,10962345,10962649
2717,4,11,1,2412,-80,-91,11,48:dd:0c:7d:86:27,10964805,362,1794,10964443,10964805
2718,4,11,1,2412,-80,-91,11,48:dd:0c:7d:86:23,10965179,323,51,10964856,10965179
2719,4,11,1,2412,-78,-91,13,48:dd:0c:7d:86:25,10965514,382,-47,10965132,10965514
2720,4,1,1,2412,-83,-91,8,,10974812,304,8994,10974508,10974812
2721,6,24,1,2412,-83,-91,8,,10975111,28,271,10975083,10975111
2722,4,11,1,2412,-86,-91,5,,10975296,107,78,10975189,10975296
2723,4,1,1,2412,-85,-91,6,,10976069,304,469,10975765,10976069
2724,4,11,1,2412,-88,-91,3,4c:01:43:d7:f3:23,10977348,322,957,10977026,10977348
2725,4,1,1,2412,-84,-91,7,,10977698,352,-2,10977346,10977698
2726,4,11,1,2412,-83,-91,8,,10980151,107,2346,10980044,10980151
2727,4,11,1,2412,-85,-91,6,,10980815,107,557,10980708,10980815
2728,6,24,1,2412,-82,-91,9,,10991108,28,10265,10991080,10991108
2729,4,1,1,2412,-84,-91,7,78:67:0e:38:6c:d3,10991651,2736,-2193,10988915,10991651
2730,4,1,1,2412,-83,-91,8,78:67:0e:c4:a8:42,11003845,2736,9458,11001109,11003845
2731,6,6,1,2412,-81,-91,10,12:86:8c:5f:93:1e,11010773,332,6596,11010441,11010773
2732,4,1,1,2412,-78,-91,13,b0:e4:d5:32:ec:8a,11024681,1960,11948,11022721,11024681
2733,4,1,1,2412,-86,-91,5,,11028541,448,3412,11028093,11028541
2734,4,1,1,2412,-86,-91,5,,11029436,448,447,11028988,11029436
2735,6,6,1,2412,-81,-91,10,32:86:8c:5f:93:1e,11035880,332,6112,11035548,11035880
2736,6,6,1,2412,-77,-91,14,e2:db:d1:d1:b0:4a,11045590,444,9266,11045146,11045590
2737,6,6,1,2412,-77,-91,14,e2:db:d1:d1:b0:4b,11046076,408,78,11045668,11046076
2738,6,6,1,2412,-76,-91,15,e2:db:d1:d1:b0:4d,11046507,408,23,11046099,11046507
2739,6,6,1,2412,-76,-91,15,e2:db:d1:d1:b0:4f,11046948,408,33,11046540,11046948
2740,6,24,1,2412,-82,-91,9,,11053849,28,6873,11053821,11053849
2741,4,1,1,2412,-78,-91,13,3c:bd:c5:ee:96:6d,11054972,2512,-1389,11052460,11054972
2742,4,1,1,2412,-88,-91,3,bc:98:df:ff:0f:8b,11058175,2568,635,11055607,11058175
2743,6,6,1,2412,-80,-91,11,52:86:8c:5f:93:1e,11061480,332,2973,11061148,11061480
2744,6,24,1,2412,-82,-91,9,,11065122,28,3614,11065094,11065122
2745,4,11,1,2412,-80,-91,11,48:dd:0c:7d:86:27,11067204,362,1720,11066842,11067204
2746,4,11,1,2412,-80,-91,11,48:dd:0c:7d:86:23,11067579,323,52,11067256,11067579
2747,6,24,1,2412,-83,-91,8,,11078752,28,11145,11078724,11078752
2748,6,6,1,2412,-80,-91,11,10:86:8c:5f:93:1e,11087080,336,7992,11086744,11087080
2749,4,11,1,2412,-85,-91,6,,11089235,107,2048,11089128,11089235
2750,4,1,1,2412,-84,-91,7,,11093337,352,3750,11092985,11093337
2751,4,1,1,2412,-82,-91,9,66:32:b1:64:4c:f2,11093649,2696,-2384,11090953,11093649
2752,4,11,1,2412,-84,-91,7,,11096881,107,3125,11096774,11096881
2753,4,11,1,2412,-82,-91,9,48:dd:0c:90:e3:85,11103821,382,6558,11103439,11103821
2754,4,1,1,2412,-88,-91,3,,11109841,304,5716,11109537,11109841
2755,6,24,1,2412,-82,-91,9,,11121969,28,12100,11121941,11121969
2756,4,1,1,2412,-89,-91,2,,11124136,304,1863,11123832,11124136
2757,4,1,1,2412,-80,-91,11,b0:e4:d5:32:ec:8a,11127080,1960,984,11125120,11127080
2758,4,1,1,2412,-88,-91,3,,11130724,448,3196,11130276,11130724
2759,6,6,1,2412,-77,-91,14,32:86:8c:5f:93:1e,11138280,332,7224,11137948,11138280
2760,4,1,1,2412,-79,-91,12,3c:bd:c5:ee:96:6d,11156999,2512,16207,11154487,11156999
2761,4,1,1,2412,-87,-91,4,bc:98:df:ff:0f:8b,11160565,2568,998,11157997,11160565
2762,4,1,1,2412,-84,-91,7,78:67:0e:c4:a8:42,11163836,3472,-201,11160364,11163836
2763,4,1,1,2412,-85,-91,6,,11186043,304,21903,11185739,11186043
2764,6,6,1,2412,-80,-91,11,10:86:8c:5f:93:1e,11191808,336,5429,11191472,11191808
2765,4,1,1,2412,-83,-91,8,66:32:b1:64:4c:f2,11195983,2696,1479,11193287,11195983
2766,4,1,1,2412,-87,-91,4,78:67:0e:38:6c:d3,11199235,848,2404,11198387,11199235
2767,4,1,1,2412,-87,-91,4,3c:bd:c5:ad:f6:9e,11200094,1056,-197,11199038,11200094
2768,4,1,1,2412,-85,-91,6,7c:f6:66:d3:26:e0,11201161,2208,-1141,11198953,11201161
2769,6,24,1,2412,-83,-91,8,,11213856,28,12667,11213828,11213856
2770,6,6,1,2412,-80,-91,11,12:86:8c:5f:93:1e,11215081,332,893,11214749,11215081
2771,4,1,1,2412,-84,-91,7,,11221080,304,5695,11220776,11221080
2772,4,1,1,2412,-87,-91,4,ac:67:84:84:8a:07,11229246,416,7750,11228830,11229246
2773,6,6,1,2412,-79,-91,12,32:86:8c:5f:93:1e,11240681,332,11103,11240349,11240681
2774,4,1,1,2412,-83,-91,8,,11241194,304,209,11240890,11241194
2775,4,1,1,2412,-79,-91,12,3c:bd:c5:ee:96:6d,11259413,2512,15707,11256901,11259413
2776,4,1,1,2412,-89,-91,2,bc:98:df:ff:0f:8b,11262974,2568,993,11260406,11262974
2777,6,6,1,2412,-81,-91,10,52:86:8c:5f:93:1e,11266281,332,2975,11265949,11266281
2778,4,1,1,2412,-84,-91,7,,11271185,304,4600,11270881,11271185
2779,6,6,1,2412,-84,-91,7,,11271502,44,273,11271458,11271502
2780,4,11,1,2412,-80,-91,11,48:dd:0c:7d:86:27,11272004,362,140,11271642,11272004
2781,4,11,1,2412,-80,-91,11,48:dd:0c:7d:86:23,11272378,323,51,11272055,11272378
2782,4,1,1,2412,-83,-91,8,,11276222,304,3540,11275918,11276222
2783,6,6,1,2412,-82,-91,9,10:86:8c:5f:93:1e,11291881,336,15323,11291545,11291881
2784,6,24,1,2412,-83,-91,8,,11293984,28,2075,11293956,11293984
2785,4,11,1,2412,-77,-91,14,48:dd:0c:90:e3:87,11307911,362,13565,11307549,11307911
2786,4,11,1,2412,-77,-91,14,48:dd:0c:90:e3:83,11308285,323,51,11307962,11308285
2787,4,11,1,2412,-84,-91,7,48:dd:0c:90:e3:85,11308621,382,-46,11308239,11308621
2788,4,1,1,2412,-87,-91,4,78:67:0e:c4:a8:42,11310201,2736,-1156,11307465,11310201
2789,4,1,1,2412,-86,-91,5,ac:67:84:84:8a:07,11316451,416,5834,11316035,11316451
2790,6,6,1,2412,-87,-91,4,,11320800,44,4305,11320756,11320800
2791,4,1,1,2412,-85,-91,6,,11321764,304,660,11321460,11321764
2792,4,1,1,2412,-89,-91,2,,11327583,384,5435,11327199,11327583
2793,4,1,1,2412,-86,-91,5,,11327982,448,-49,11327534,11327982
2794,4,11,1,2412,-79,-91,12,48:dd:0c:7d:86:23,11329902,254,1666,11329648,11329902
2795,4,11,1,2412,-83,-91,8,48:dd:0c:90:e3:83,11330204,254,48,11329950,11330204
2796,4,1,1,2412,-77,-91,14,b0:e4:d5:32:ec:8a,11331879,1960,-285,11329919,11331879
2797,4,11,1,2412,-84,-91,7,,11340839,107,8853,11340732,11340839
2798,4,11,1,2412,-84,-91,7,,11342100,107,1154,11341993,11342100
2799,4,11,1,2412,-82,-91,9,,11342636,107,429,11342529,11342636
2800,6,6,1,2412,-81,-91,10,32:86:8c:5f:93:1e,11343082,332,114,11342750,11343082
2801,4,1,1,2412,-85,-91,6,,11349274,448,5744,11348826,11349274
2802,6,6,1,2412,-76,-91,15,e2:db:d1:d1:b0:4a,11352698,444,2980,11352254,11352698
2803,6,6,1,2412,-77,-91,14,e2:db:d1:d1:b0:4b,11353166,408,60,11352758,11353166
2804,6,6,1,2412,-78,-91,13,e2:db:d1:d1:b0:4d,11353625,408,51,11353217,11353625
2805,6,6,1,2412,-76,-91,15,e2:db:d1:d1:b0:4f,11354083,408,50,11353675,11354083
2806,4,1,1,2412,-87,-91,4,ac:67:84:84:8a:07,11361233,416,6734,11360817,11361233
2807,4,1,1,2412,-78,-91,13,3c:bd:c5:ee:96:6d,11362910,2512,-835,11360398,11362910
2808,4,1,1,2412,-87,-91,4,bc:98:df:ff:0f:8b,11365402,2568,-76,11362834,11365402
2809,4,11,1,2412,-79,-91,12,48:dd:0c:7d:86:27,11374404,362,8640,11374042,11374404
2810,4,11,1,2412,-79,-91,12,48:dd:0c:7d:86:23,11374778,323,51,11374455,11374778
2811,4,11,1,2412,-80,-91,11,48:dd:0c:7d:86:25,11375113,382,-47,11374731,11375113
2812,4,1,1,2412,-89,-91,2,,11375976,304,559,11375672,11375976
2813,4,1,1,2412,-89,-91,2,,11377028,304,748,11376724,11377028
2814,4,1,1,2412,-88,-91,3,ce:9e:43:bc:eb:ff,11380793,4512,-747,11376281,11380793
2815,4,1,1,2412,-86,-91,5,d2:9e:43:bc:eb:ff,11394904,3552,10559,11391352,11394904
2816,6,24,1,2412,-84,-91,7,,11398599,28,3667,11398571,11398599
2817,4,1,1,2412,-84,-91,7,78:67:0e:38:6c:d3,11401252,2736,-83,11398516,11401252
2818,4,11,1,2412,-78,-91,13,48:dd:0c:90:e3:83,11410685,323,9110,11410362,11410685
2819,4,11,1,2412,-82,-91,9,48:dd:0c:90:e3:85,11411020,382,-47,11410638,11411020
2820,4,1,1,2412,-87,-91,4,ac:67:84:84:8a:07,11412002,416,566,11411586,11412002
2821,4,1,1,2412,-86,-91,5,78:67:0e:c4:a8:42,11412601,2736,-2137,11409865,11412601
2822,4,1,1,2412,-85,-91,6,,11418855,304,5950,11418551,11418855
2823,6,6,1,2412,-81,-91,10,12:86:8c:5f:93:1e,11419883,332,696,11419551,11419883
2824,4,1,1,2412,-86,-91,5,ac:67:84:84:8a:07,11431202,416,10903,11430786,11431202
2825,4,1,1,2412,-89,-91,2,,11431980,384,394,11431596,11431980
2826,4,1,1,2412,-88,-91,3,,11432379,448,-49,11431931,11432379
2827,4,1,1,2412,-89,-91,2,,11433265,448,438,11432817,11433265
2828,4,1,1,2412,-78,-91,13,b0:e4:d5:32:ec:8a,11434278,1960,-947,11432318,11434278
2829,6,6,1,2412,-81,-91,10,32:86:8c:5f:93:1e,11445482,332,10872,11445150,11445482
2830,4,1,1,2412,-84,-91,7,b4:b5:2f:17:0c:b9,11452167,1376,5309,11450791,11452167
2831,6,6,1,2412,-71,-91,20,e2:db:d1:d1:b0:4d,11454344,408,1769,11453936,11454344
2832,6,6,1,2412,-76,-91,15,e2:db:d1:d1:b0:4f,11454785,408,33,11454377,11454785
2833,4,1,1,2412,-79,-91,12,3c:bd:c5:ee:96:6d,11465004,2512,7707,11462492,11465004
2834,4,1,1,2412,-88,-91,3,bc:98:df:ff:0f:8a,11473380,976,7400,11472404,11473380
2835,4,1,1,2412,-87,-91,4,bc:98:df:ff:0f:8a,11474367,976,11,11473391,11474367
2836,4,11,1,2412,-80,-91,11,48:dd:0c:7d:86:27,11476804,362,2075,11476442,11476804
2837,4,11,1,2412,-80,-91,11,48:dd:0c:7d:86:23,11477179,323,52,11476856,11477179
2838,6,6,1,2412,-79,-91,12,52:86:8c:5f:93:1e,11477751,332,240,11477419,11477751
2839,4,1,1,2412,-89,-91,2,bc:98:df:ff:0f:8b,11493665,3176,12738,11490489,11493665
2840,6,6,1,2412,-80,-91,11,10:86:8c:5f:93:1e,11497011,336,3010,11496675,11497011
2841,4,1,1,2412,-89,-91,2,bc:98:df:ff:0f:8b,11500142,3176,-45,11496966,11500142
2842,4,1,1,2412,-83,-91,8,78:67:0e:38:6c:d3,11503652,2736,774,11500916,11503652
2843,4,1,1,2412,-87,-91,4,7c:f6:66:c0:cf:b8,11506444,2208,584,11504236,11506444
2844,4,11,1,2412,-78,-91,13,48:dd:0c:90:e3:87,11512710,362,5904,11512348,11512710
2845,4,1,1,2412,-84,-91,7,,11518187,304,5173,11517883,11518187
2846,4,1,1,2412,-84,-91,7,,11520273,304,1782,11519969,11520273
2847,6,6,1,2412,-81,-91,10,12:86:8c:5f:93:1e,11522283,332,1678,11521951,11522283
2848,4,1,1,2412,-88,-91,3,bc:98:df:ff:0f:8b,11524937,3176,-522,11521761,11524937
2849,6,24,1,2412,-83,-91,8,,11533861,28,8896,11533833,11533861
2850,4,1,1,2412,-84,-91,7,,11540472,304,6307,11540168,11540472
2851,6,6,1,2412,-81,-91,10,32:86:8c:5f:93:1e,11547883,332,7079,11547551,11547883
2852,6,24,1,2412,-81,-91,10,,11551595,28,3684,11551567,11551595
2853,6,6,1,2412,-77,-91,14,e2:db:d1:d1:b0:4b,11556198,408,4195,11555790,11556198
2854,6,6,1,2412,-77,-91,14,e2:db:d1:d1:b0:4d,11556639,408,33,11556231,11556639
2855,6,6,1,2412,-77,-91,14,e2:db:d1:d1:b0:4f,11557089,408,42,11556681,11557089
2856,6,24,1,2412,-82,-91,9,,11557842,28,725,11557814,11557842
2857,4,1,1,2412,-79,-91,12,3c:bd:c5:ee:96:6d,11566809,2512,6455,11564297,11566809
2858,4,1,1,2412,-88,-91,3,bc:98:df:ff:0f:8b,11570184,2568,807,11567616,11570184
2859,6,6,1,2412,-80,-91,11,52:86:8c:5f:93:1e,11573483,332,2967,11573151,11573483
2860,4,1,1,2412,-82,-91,9,,11575255,304,1468,11574951,11575255
2861,4,11,1,2412,-79,-91,12,48:dd:0c:7d:86:23,11579579,323,4001,11579256,11579579
2862,4,1,1,2412,-81,-91,10,,11603497,304,23614,11603193,11603497
2863,6,6,1,2412,-80,-91,11,12:86:8c:5f:93:1e,11626255,332,22426,11625923,11626255
2864,4,1,1,2412,-87,-91,4,,11635468,448,8765,11635020,11635468
2865,4,1,1,2412,-86,-91,5,,11636372,448,456,11635924,11636372
2866,4,1,1,2412,-80,-91,11,b0:e4:d5:32:ec:8a,11639077,1960,745,11637117,11639077
2867,6,6,1,2412,-76,-91,15,e2:db:d1:d1:b0:4a,11658141,444,18620,11657697,11658141
2868,6,6,1,2412,-76,-91,15,e2:db:d1:d1:b0:4b,11658636,408,87,11658228,11658636
2869,6,6,1,2412,-77,-91,14,e2:db:d1:d1:b0:4d,11659068,408,24,11658660,11659068
2870,6,6,1,2412,-76,-91,15,e2:db:d1:d1:b0:4f,11659518,408,42,11659110,11659518
2871,4,1,1,2412,-78,-91,13,3c:bd:c5:ee:96:6d,11669019,2512,6989,11666507,11669019
2872,6,6,1,2412,-80,-91,11,52:86:8c:5f:93:1e,11675884,332,6533,11675552,11675884
2873,4,11,1,2412,-80,-91,11,48:dd:0c:7d:86:27,11681604,362,5358,11681242,11681604
2874,4,11,1,2412,-81,-91,10,48:dd:0c:7d:86:23,11681979,323,52,11681656,11681979
2875,4,11,1,2412,-81,-91,10,48:dd:0c:7d:86:25,11682314,382,-47,11681932,11682314
2876,4,1,1,2412,-86,-91,5,,11693136,304,10518,11692832,11693136
2877,4,1,1,2412,-84,-91,7,,11704309,304,10869,11704005,11704309
2878,6,24,1,2412,-82,-91,9,,11705137,28,800,11705109,11705137
2879,4,1,1,2412,-85,-91,6,78:67:0e:38:6c:d3,11708452,2736,579,11705716,11708452
2880,6,24,1,2412,-82,-91,9,,11711176,28,2696,11711148,11711176
2881,4,11,1,2412,-77,-91,14,48:dd:0c:90:e3:87,11717510,362,5972,11717148,11717510
2882,4,11,1,2412,-84,-91,7,48:dd:0c:90:e3:85,11718220,382,328,11717838,11718220
2883,4,1,1,2412,-84,-91,7,78:67:0e:c4:a8:42,11719800,2736,-1156,11717064,11719800
2884,6,6,1,2412,-81,-91,10,12:86:8c:5f:93:1e,11729787,332,9655,11729455,11729787
2885,4,1,1,2412,-85,-91,6,,11730454,304,363,11730150,11730454
2886,4,11,1,2412,-82,-91,9,,11731051,107,490,11730944,11731051
2887,4,1,1,2412,-85,-91,6,,11731925,304,570,11731621,11731925
2888,4,1,1,2412,-87,-91,4,,11738209,448,5836,11737761,11738209
2889,4,1,1,2412,-86,-91,5,,11739113,448,456,11738665,11739113
2890,4,1,1,2412,-78,-91,13,b0:e4:d5:32:ec:8a,11741476,1960,403,11739516,11741476
2891,6,6,1,2412,-80,-91,11,32:86:8c:5f:93:1e,11752685,332,10877,11752353,11752685
2892,6,6,1,2412,-77,-91,14,e2:db:d1:d1:b0:4a,11761926,444,8797,11761482,11761926
2893,6,6,1,2412,-77,-91,14,e2:db:d1:d1:b0:4b,11762394,408,60,11761986,11762394
2894,6,6,1,2412,-76,-91,15,e2:db:d1:d1:b0:4d,11762834,408,32,11762426,11762834
2895,6,6,1,2412,-77,-91,14,e2:db:d1:d1:b0:4f,11763293,408,51,11762885,11763293
2896,4,1,1,2412,-84,-91,7,,11769986,304,6389,11769682,11769986
2897,6,6,1,2412,-84,-91,7,,11770529,44,499,11770485,11770529
2898,4,1,1,2412,-79,-91,12,3c:bd:c5:ee:96:6d,11773715,2512,674,11771203,11773715
2899,6,6,1,2412,-82,-91,9,52:86:8c:5f:93:1e,11778285,332,4238,11777953,11778285
2900,4,11,1,2412,-79,-91,12,48:dd:0c:7d:86:27,11784004,362,5357,11783642,11784004
2901,4,11,1,2412,-80,-91,11,48:dd:0c:7d:86:23,11784378,323,51,11784055,11784378
2902,4,11,1,2412,-80,-91,11,48:dd:0c:7d:86:25,11784714,382,-46,11784332,11784714
2903,6,24,1,2412,-83,-91,8,,11785346,28,604,11785318,11785346
2904,6,24,1,2412,-82,-91,9,,11790144,28,4770,11790116,11790144
2905,4,1,1,2412,-85,-91,6,,11790523,304,75,11790219,11790523
2906,6,6,1,2412,-84,-91,7,,11791067,44,500,11791023,11791067
2907,4,1,1,2412,-86,-91,5,,11791993,352,574,11791641,11791993
2908,4,11,1,2412,-83,-91,8,,11794457,107,2357,11794350,11794457
2909,4,1,1,2412,-83,-91,8,,11795036,352,227,11794684,11795036
2910,4,1,1,2412,-89,-91,2,78:67:0e:38:6c:d3,11810852,2736,13080,11808116,11810852
2911,4,5.5,1,2412,-85,-91,6,,11816162,117,5193,11816045,11816162
2912,4,11,1,2412,-77,-91,14,48:dd:0c:90:e3:87,11819910,362,3386,11819548,11819910
2913,4,11,1,2412,-76,-91,15,48:dd:0c:90:e3:83,11820284,323,51,11819961,11820284
2914,4,11,1,2412,-83,-91,8,48:dd:0c:90:e3:85,11820619,382,-47,11820237,11820619
2915,4,1,1,2412,-85,-91,6,78:67:0e:c4:a8:42,11822200,2736,-1155,11819464,11822200
2916,6,6,1,2412,-83,-91,8,,11825190,44,2946,11825146,11825190
2917,6,6,1,2412,-85,-91,6,,11825896,44,662,11825852,11825896
2918,4,1,1,2412,-85,-91,6,,11826859,304,659,11826555,11826859
2919,6,6,1,2412,-80,-91,11,12:86:8c:5f:93:1e,11829485,332,2294,11829153,11829485
2920,4,1,1,2412,-79,-91,12,b0:e4:d5:32:ec:8a,11843876,1960,12431,11841916,11843876
2921,4,1,1,2412,-87,-91,4,,11850058,448,5734,11849610,11850058
2922,6,6,1,2412,-80,-91,11,32:86:8c:5f:93:1e,11855086,332,4696,11854754,11855086
2923,4,1,1,2412,-85,-91,6,b4:b5:2f:17:0c:b9,11861774,1376,5312,11860398,11861774
2924,6,6,1,2412,-76,-91,15,e2:db:d1:d1:b0:4a,11863263,444,1045,11862819,11863263
2925,6,6,1,2412,-76,-91,15,e2:db:d1:d1:b0:4b,11863758,408,87,11863350,11863758
2926,6,6,1,2412,-77,-91,14,e2:db:d1:d1:b0:4d,11864217,408,51,11863809,11864217
2927,6,6,1,2412,-77,-91,14,e2:db:d1:d1:b0:4f,11864658,408,33,11864250,11864658
2928,6,24,1,2412,-83,-91,8,,11865412,28,726,11865384,11865412
2929,4,1,1,2412,-88,-91,3,d2:9e:43:bc:eb:ff,11865822,3600,-3190,11862222,11865822
2930,4,1,1,2412,-79,-91,12,3c:bd:c5:ee:96:6d,11874006,2512,5672,11871494,11874006
2931,6,6,1,2412,-85,-91,6,,11876837,44,2787,11876793,11876837
2932,6,6,1,2412,-81,-91,10,52:86:8c:5f:93:1e,11880855,332,3686,11880523,11880855
2933,4,11,1,2412,-80,-91,11,48:dd:0c:7d:86:27,11886404,362,5187,11886042,11886404
2934,4,11,1,2412,-79,-91,12,48:dd:0c:7d:86:23,11886778,323,51,11886455,11886778
2935,4,11,1,2412,-79,-91,12,48:dd:0c:7d:86:25,11887113,382,-47,11886731,11887113
2936,4,1,1,2412,-84,-91,7,,11904983,304,17566,11904679,11904983
2937,4,11,1,2412,-83,-91,8,48:dd:0c:90:e3:87,11923216,362,17871,11922854,11923216
2938,4,11,1,2412,-83,-91,8,48:dd:0c:90:e3:83,11923591,323,52,11923268,11923591
2939,4,11,1,2412,-81,-91,10,48:dd:0c:90:e3:85,11923926,382,-47,11923544,11923926
2940,4,1,1,2412,-86,-91,5,78:67:0e:c4:a8:42,11924600,2736,-2062,11921864,11924600
2941,4,1,1,2412,-84,-91,7,,11927805,304,2901,11927501,11927805
2942,6,6,1,2412,-81,-91,10,12:86:8c:5f:93:1e,11931886,332,3749,11931554,11931886
2943,6,24,1,2412,-83,-91,8,,11933861,28,1947,11933833,11933861
2944,4,1,1,2412,-88,-91,3,,11943411,384,9166,11943027,11943411
2945,4,1,1,2412,-88,-91,3,,11943809,448,-50,11943361,11943809
2946,4,1,1,2412,-88,-91,3,,11944704,448,447,11944256,11944704
2947,6,24,1,2412,-81,-91,10,,11945137,28,405,11945109,11945137
2948,4,1,1,2412,-79,-91,12,b0:e4:d5:32:ec:8a,11946275,1960,-822,11944315,11946275
2949,6,24,1,2412,-83,-91,8,,11950277,28,3974,11950249,11950277
2950,6,6,1,2412,-80,-91,11,32:86:8c:5f:93:1e,11957486,332,6877,11957154,11957486
2951,6,24,1,2412,-82,-91,9,,11957888,28,374,11957860,11957888
2952,6,6,1,2412,-77,-91,14,e2:db:d1:d1:b0:4b,11965835,408,7539,11965427,11965835
2953,4,1,1,2412,-86,-91,5,ac:67:84:84:8a:07,11979088,416,12837,11978672,11979088
2954,4,11,1,2412,-80,-91,11,48:dd:0c:7d:86:23,11989178,323,9767,11988855,11989178
2955,4,11,1,2412,-80,-91,11,48:dd:0c:7d:86:25,11989513,382,-47,11989131,11989513
2956,4,1,1,2412,-86,-91,5,,11990651,304,834,11990347,11990651
2957,6,6,1,2412,-80,-91,11,b4:e6:2d:b4:ff:71,12010723,64,20008,12010659,12010723
2958,6,6,1,2412,-81,-91,10,,12010803,44,36,12010759,12010803
2959,6,24,1,2412,-82,-91,9,,12013860,28,3029,12013832,12013860
2960,4,1,1,2412,-84,-91,7,,12014355,304,191,12014051,12014355
2961,4,11,1,2412,-76,-91,15,48:dd:0c:90:e3:87,12024709,362,9992,12024347,12024709
2962,4,11,1,2412,-84,-91,7,48:dd:0c:90:e3:85,12025419,382,328,12025037,12025419
2963,6,6,1,2412,-85,-91,6,,12026445,44,982,12026401,12026445
2964,4,1,1,2412,-85,-91,6,,12030264,304,3515,12029960,12030264
2965,6,6,1,2412,-81,-91,10,12:86:8c:5f:93:1e,12034319,332,3723,12033987,12034319
2966,4,1,1,2412,-78,-91,13,b0:e4:d5:32:ec:8a,12048674,1960,12395,12046714,12048674
2967,6,6,1,2412,-81,-91,10,32:86:8c:5f:93:1e,12059887,332,10881,12059555,12059887
2968,6,6,1,2412,-76,-91,15,e2:db:d1:d1:b0:4b,12068227,408,7932,12067819,12068227
2969,6,6,1,2412,-76,-91,15,e2:db:d1:d1:b0:4d,12068659,408,24,12068251,12068659
2970,6,6,1,2412,-77,-91,14,e2:db:d1:d1:b0:4f,12069100,408,33,12068692,12069100
2971,4,1,1,2412,-83,-91,8,,12069762,304,358,12069458,12069762
2972,4,1,1,2412,-85,-91,6,,12070817,304,751,12070513,12070817
2973,4,1,1,2412,-79,-91,12,3c:bd:c5:ee:96:6d,12078610,2512,5281,12076098,12078610
2974,4,1,1,2412,-88,-91,3,bc:98:df:ff:0f:8b,12082189,2568,1011,12079621,12082189
2975,4,1,1,2412,-84,-91,7,,12090537,304,8044,12090233,12090537
2976,4,11,1,2412,-80,-91,11,48:dd:0c:7d:86:23,12091578,323,718,12091255,12091578
2977,4,11,1,2412,-80,-91,11,48:dd:0c:7d:86:25,12091913,382,-47,12091531,12091913
2978,4,1,1,2412,-85,-91,6,,12092314,352,49,12091962,12092314
2979,4,11,1,2412,-84,-91,7,,12094184,107,1763,12094077,12094184
2980,4,1,1,2412,-85,-91,6,,12094768,352,232,12094416,12094768
2981,4,1,1,2412,-84,-91,7,,12096297,352,1177,12095945,12096297
2982,4,11,1,2412,-89,-91,2,4c:01:43:d7:f3:29,12103368,361,6710,12103007,12103368
2983,6,6,1,2412,-84,-91,7,,12113917,44,10505,12113873,12113917
2984,4,1,1,2412,-87,-91,4,7c:f6:66:cd:4c:69,12120845,2208,4720,12118637,12120845
2985,4,1,1,2412,-86,-91,5,78:67:0e:c4:a8:42,12129399,2736,5818,12126663,12129399
2986,4,1,1,2412,-84,-91,7,,12132803,352,3052,12132451,12132803
2987,6,6,1,2412,-81,-91,10,12:86:8c:5f:93:1e,12136817,332,3682,12136485,12136817
2988,6,6,1,2412,-77,-91,14,76:a2:c1:67:70:44,12140049,308,2924,12139741,12140049
2989,6,6,1,2412,-77,-91,14,76:a2:c1:67:70:44,12140462,308,105,12140154,12140462
2990,6,6,1,2412,-77,-91,14,e0:db:d1:d0:b0:48,12140821,308,51,12140513,12140821
2991,6,6,1,2412,-77,-91,14,b2:e2:49:f6:8a:4e,12141270,308,141,12140962,12141270
2992,4,1,1,2412,-78,-91,13,b0:e4:d5:32:ec:8a,12151074,1960,7844,12149114,12151074
2993,6,6,1,2412,-76,-91,15,f8:4f:ad:f9:af:82,12161616,656,9886,12160960,12161616
2994,6,6,1,2412,-80,-91,11,32:86:8c:5f:93:1e,12162288,332,340,12161956,12162288
2995,6,6,1,2412,-78,-91,13,f8:4f:ad:f9:af:82,12163544,632,624,12162912,12163544
2996,4,1,1,2412,-85,-91,6,b4:b5:2f:17:0c:b9,12168980,1376,4060,12167604,12168980
2997,4,1,1,2412,-86,-91,5,,12178541,448,9113,12178093,12178541
2998,4,1,1,2412,-77,-91,14,3c:bd:c5:ee:96:6d,12181893,2512,840,12179381,12181893
2999,4,1,1,2412,-89,-91,2,bc:98:df:ff:0f:8b,12184550,2568,89,12181982,12184550
3000,6,24,1,2412,-82,-91,9,,12190706,28,6128,12190678,12190706
3001,4,1,1,2412,-86,-91,5,ac:67:84:84:8a:07,12192713,416,1591,12192297,12192713
3002,4,11,1,2412,-79,-91,12,48:dd:0c:7d:86:27,12193603,362,528,12193241,12193603
3003,4,11,1,2412,-80,-91,11,48:dd:0c:7d:86:23,12193977,323,51,12193654,12193977
3004,4,11,1,2412,-80,-91,11,48:dd:0c:7d:86:25,12194313,382,-46,12193931,12194313
3005,6,6,1,2412,-81,-91,10,52:86:8c:5f:93:1e,12194549,332,-96,12194217,12194549
3006,6,6,1,2412,-80,-91,11,b4:e6:2d:b4:ff:71,12194932,64,319,12194868,12194932
3007,6,6,1,2412,-81,-91,10,,12195013,44,37,12194969,12195013
3008,4,1,1,2412,-86,-91,5,,12195246,304,-71,12194942,12195246
3009,4,5.5,1,2412,-87,-91,4,,12211035,117,15672,12210918,12211035
3010,4,1,1,2412,-82,-91,9,66:32:b1:64:4c:f2,12219320,2696,5589,12216624,12219320
3011,4,11,1,2412,-78,-91,13,48:dd:0c:90:e3:87,12229509,362,9827,12229147,12229509
3012,6,6,1,2412,-77,-91,14,e0:db:d1:d0:b0:48,12235318,156,5653,12235162,12235318
3013,6,6,1,2412,-77,-91,14,f8:4f:ad:f9:af:82,12242517,196,7003,12242321,12242517
3014,6,6,1,2412,-77,-91,14,f8:4f:ad:f9:af:82,12242844,156,171,12242688,12242844
3015,4,1,1,2412,-85,-91,6,,12252642,304,9494,12252338,12252642
3016,4,1,1,2412,-87,-91,4,,12253113,448,23,12252665,12253113
3017,4,1,1,2412,-79,-91,12,b0:e4:d5:32:ec:8a,12253473,1960,-1600,12251513,12253473
3018,6,6,1,2412,-82,-91,9,32:86:8c:5f:93:1e,12264688,332,10883,12264356,12264688
3019,6,6,1,2412,-75,-91,16,f8:4f:ad:f9:af:82,12270474,632,5154,12269842,12270474
3020,6,6,1,2412,-77,-91,14,e2:db:d1:d1:b0:4a,12272755,444,1837,12272311,12272755
3021,6,6,1,2412,-77,-91,14,e2:db:d1:d1:b0:4b,12273241,408,78,12272833,12273241
3022,6,6,1,2412,-77,-91,14,e2:db:d1:d1:b0:4d,12273699,408,50,12273291,12273699
3023,4,1,1,2412,-88,-91,3,ac:67:84:84:8a:07,12275343,416,1228,12274927,12275343
3024,6,24,1,2412,-82,-91,9,,12277839,28,2468,12277811,12277839
3025,4,1,1,2412,-79,-91,12,3c:bd:c5:ee:96:6d,12283397,2512,3046,12280885,12283397
3026,4,1,1,2412,-84,-91,7,bc:98:df:ff:0f:8b,12286989,2568,1024,12284421,12286989
3027,4,1,1,2412,-85,-91,6,,12295265,304,7972,12294961,12295265
3028,4,11,1,2412,-79,-91,12,48:dd:0c:7d:86:27,12296003,362,376,12295641,12296003
3029,4,11,1,2412,-80,-91,11,48:dd:0c:7d:86:23,12296377,323,51,12296054,12296377
3030,4,11,1,2412,-79,-91,12,48:dd:0c:7d:86:25,12296712,382,-47,12296330,12296712
3031,4,1,1,2412,-87,-91,4,c8:9e:43:bc:eb:ff,12311797,3496,11589,12308301,12311797
3032,6,6,1,2412,-80,-91,11,10:86:8c:5f:93:1e,12315889,336,3756,12315553,12315889
3033,4,1,1,2412,-87,-91,4,,12318412,304,2219,12318108,12318412
3034,4,11,1,2412,-78,-91,13,48:dd:0c:90:e3:83,12332283,323,13548,12331960,12332283
3035,4,11,1,2412,-84,-91,7,48:dd:0c:90:e3:85,12332618,382,-47,12332236,12332618
3036,6,24,1,2412,-82,-91,9,,12333864,28,1218,12333836,12333864
3037,4,1,1,2412,-84,-91,7,78:67:0e:c4:a8:42,12334227,2736,-2373,12331491,12334227
3038,4,1,1,2412,-86,-91,5,,12337864,304,3333,12337560,12337864
3039,4,1,1,2412,-85,-91,6,,12338918,304,750,12338614,12338918
3040,6,24,1,2412,-83,-91,8,,12345140,28,6194,12345112,12345140
3041,6,24,1,2412,-81,-91,10,,12350328,28,5160,12350300,12350328
3042,4,1,1,2412,-78,-91,13,b0:e4:d5:32:ec:8a,12355872,1960,3584,12353912,12355872
3043,4,1,1,2412,-86,-91,5,ac:67:84:84:8a:07,12358472,416,2184,12358056,12358472
3044,4,1,1,2412,-86,-91,5,,12366306,304,7530,12366002,12366306
3045,6,6,1,2412,-80,-91,11,32:86:8c:5f:93:1e,12367089,332,451,12366757,12367089
3046,4,1,1,2412,-84,-91,7,b4:b5:2f:17:0c:b9,12373796,1376,5331,12372420,12373796
3047,6,6,1,2412,-76,-91,15,e2:db:d1:d1:b0:4b,12375467,408,1263,12375059,12375467
3048,6,6,1,2412,-77,-91,14,e2:db:d1:d1:b0:4f,12376340,408,465,12375932,12376340
3049,4,1,1,2412,-84,-91,7,ac:67:84:84:8a:07,12381864,416,5108,12381448,12381864
3050,4,1,1,2412,-79,-91,12,3c:bd:c5:ee:96:6d,12386629,2512,2253,12384117,12386629
3051,4,1,1,2412,-88,-91,3,bc:98:df:ff:0f:8b,12389383,2568,186,12386815,12389383
3052,6,6,1,2412,-82,-91,9,52:86:8c:5f:93:1e,12392690,332,2975,12392358,12392690
3053,4,11,1,2412,-80,-91,11,48:dd:0c:7d:86:27,12398402,362,5350,12398040,12398402
3054,4,11,1,2412,-80,-91,11,48:dd:0c:7d:86:23,12398777,323,52,12398454,12398777
3055,4,11,1,2412,-80,-91,11,48:dd:0c:7d:86:25,12399112,382,-47,12398730,12399112
3056,4,1,1,2412,-85,-91,6,,12410100,304,10684,12409796,12410100
3057,6,24,1,2412,-82,-91,9,,12413871,28,3743,12413843,12413871
3058,4,1,1,2412,-85,-91,6,,12424049,304,9874,12423745,12424049
3059,4,1,1,2412,-86,-91,5,78:67:0e:38:6c:d3,12425253,2736,-1532,12422517,12425253
3060,6,24,1,2412,-81,-91,10,,12430280,28,4999,12430252,12430280
3061,6,6,1,2412,-76,-91,15,f8:4f:ad:f9:af:82,12440023,224,9519,12439799,12440023
3062,4,1,1,2412,-83,-91,8,,12442395,304,2068,12442091,12442395
3063,6,6,1,2412,-80,-91,11,12:86:8c:5f:93:1e,12443890,332,1163,12443558,12443890
3064,4,1,1,2412,-88,-91,3,00:26:62:eb:ea:74,12449731,968,4873,12448763,12449731
3065,4,1,1,2412,-79,-91,12,b0:e4:d5:32:ec:8a,12458272,1960,6581,12456312,12458272
3066,4,1,1,2412,-85,-91,6,,12469607,304,11031,12469303,12469607
3067,6,6,1,2412,-81,-91,10,32:86:8c:5f:93:1e,12470064,332,125,12469732,12470064
3068,6,6,1,2412,-78,-91,13,e2:db:d1:d1:b0:4b,12477816,408,7344,12477408,12477816
3069,6,6,1,2412,-76,-91,15,e2:db:d1:d1:b0:4d,12478274,408,50,12477866,12478274
3070,6,6,1,2412,-76,-91,15,e2:db:d1:d1:b0:4f,12478706,408,24,12478298,12478706
3071,4,1,1,2412,-86,-91,5,ac:67:84:84:8a:07,12479307,416,185,12478891,12479307
3072,4,1,1,2412,-85,-91,6,,12480475,448,720,12480027,12480475
3073,4,1,1,2412,-87,-91,4,,12481352,448,429,12480904,12481352
3074,4,1,1,2412,-79,-91,12,3c:bd:c5:ee:96:6d,12488196,2512,4332,12485684,12488196
3075,4,1,1,2412,-79,-91,12,b8:f8:53:cb:31:f1,12490734,976,1562,12489758,12490734
3076,6,6,1,2412,-80,-91,11,52:86:8c:5f:93:1e,12495090,332,4024,12494758,12495090
3077,4,11,1,2412,-79,-91,12,48:dd:0c:7d:86:23,12501177,323,5764,12500854,12501177
3078,4,1,1,2412,-85,-91,6,,12504146,352,2617,12503794,12504146
3079,4,1,1,2412,-84,-91,7,,12507957,352,3459,12507605,12507957
3080,4,1,1,2412,-85,-91,6,,12520062,304,11801,12519758,12520062
3081,6,6,1,2412,-81,-91,10,10:86:8c:5f:93:1e,12520690,336,292,12520354,12520690
3082,4,11,1,2412,-84,-91,7,48:dd:0c:90:e3:85,12537418,382,16346,12537036,12537418
3083,4,1,1,2412,-83,-91,8,78:67:0e:c4:a8:42,12538999,2736,-1155,12536263,12538999
3084,4,1,1,2412,-84,-91,7,,12542185,304,2882,12541881,12542185
3085,6,6,1,2412,-79,-91,12,12:86:8c:5f:93:1e,12546904,332,4387,12546572,12546904
3086,4,1,1,2412,-77,-91,14,b0:e4:d5:32:ec:8a,12560671,1960,11807,12558711,12560671
3087,6,6,1,2412,-81,-91,10,32:86:8c:5f:93:1e,12571891,332,10888,12571559,12571891
3088,4,1,1,2412,-87,-91,4,ac:67:84:84:8a:07,12573800,416,1493,12573384,12573800
3089,4,1,1,2412,-86,-91,5,,12574986,448,738,12574538,12574986
3090,4,1,1,2412,-86,-91,5,,12575863,448,429,12575415,12575863
3091,6,6,1,2412,-76,-91,15,e2:db:d1:d1:b0:4d,12580785,408,4514,12580377,12580785
3092,6,6,1,2412,-77,-91,14,e2:db:d1:d1:b0:4f,12581245,408,52,12580837,12581245
3093,6,24,1,2412,-83,-91,8,,12585148,28,3875,12585120,12585148
3094,6,24,1,2412,-82,-91,9,,12590231,32,5051,12590199,12590231
3095,4,1,1,2412,-79,-91,12,3c:bd:c5:ee:96:6d,12590612,2512,-2131,12588100,12590612
3096,6,24,1,2412,-81,-91,10,,12593418,32,2774,12593386,12593418
3097,4,11,1,2412,-85,-91,6,,12596895,107,3370,12596788,12596895
3098,6,6,1,2412,-81,-91,10,52:86:8c:5f:93:1e,12597491,332,264,12597159,12597491
3099,6,24,1,2412,-83,-91,8,,12597892,28,373,12597864,12597892
3100,4,2,1,2412,-89,-91,2,34:15:13:b7:0a:84,12598029,208,-71,12597821,12598029
3101,4,2,1,2412,-87,-91,4,34:15:13:b7:0a:84,12598518,208,281,12598310,12598518
3102,6,6,1,2412,-82,-91,9,,12599210,44,648,12599166,12599210
3103,4,2,1,2412,-86,-91,5,34:15:13:b7:0a:84,12599357,208,-61,12599149,12599357
3104,4,2,1,2412,-87,-91,4,34:15:13:b7:0a:84,12599845,208,280,12599637,12599845
3105,4,2,1,2412,-87,-91,4,34:15:13:b7:0a:84,12600334,208,281,12600126,12600334
3106,4,2,1,2412,-86,-91,5,,12600555,152,69,12600403,12600555
3107,4,1,1,2412,-84,-91,7,,12602397,304,1538,12602093,12602397
3108,4,11,1,2412,-80,-91,11,48:dd:0c:7d:86:27,12603202,362,443,12602840,12603202
3109,4,11,1,2412,-81,-91,10,48:dd:0c:7d:86:23,12603577,323,52,12603254,12603577
3110,4,11,1,2412,-80,-91,11,48:dd:0c:7d:86:25,12603912,382,-47,12603530,12603912
3111,6,24,1,2412,-82,-91,9,,12620117,28,16177,12620089,12620117
3112,6,6,1,2412,-80,-91,11,10:86:8c:5f:93:1e,12623091,336,2638,12622755,12623091
3113,4,1,1,2412,-84,-91,7,,12625678,304,2283,12625374,12625678
3114,4,1,1,2412,-86,-91,5,78:67:0e:38:6c:d3,12630053,2736,1639,12627317,12630053
3115,4,11,1,2412,-86,-91,5,4c:01:43:ec:a0:66,12634476,387,4036,12634089,12634476
3116,4,11,1,2412,-78,-91,13,48:dd:0c:90:e3:83,12639482,323,4683,12639159,12639482
3117,4,1,1,2412,-84,-91,7,78:67:0e:c4:a8:42,12641399,2736,-819,12638663,12641399
3118,6,6,1,2412,-77,-91,14,12:86:8c:5f:93:1e,12649179,332,7448,12648847,12649179
3119,6,24,1,2412,-84,-91,7,,12653901,28,4694,12653873,12653901
3120,6,24,1,2412,-83,-91,8,,12655423,28,1494,12655395,12655423
3121,4,1,1,2412,-79,-91,12,b0:e4:d5:32:ec:8a,12663070,1960,5687,12661110,12663070
3122,6,24,1,2412,-83,-91,8,,12666285,28,3187,12666257,12666285
3123,6,6,1,2412,-81,-91,10,32:86:8c:5f:93:1e,12674292,332,7675,12673960,12674292
3124,4,1,1,2412,-84,-91,7,b4:b5:2f:17:0c:b9,12680989,1376,5321,12679613,12680989
3125,6,6,1,2412,-76,-91,15,e2:db:d1:d1:b0:4a,12682239,444,806,12681795,12682239
3126,6,6,1,2412,-76,-91,15,e2:db:d1:d1:b0:4b,12682725,408,78,12682317,12682725
3127,6,6,1,2412,-77,-91,14,e2:db:d1:d1:b0:4d,12683184,408,51,12682776,12683184
3128,6,6,1,2412,-77,-91,14,e2:db:d1:d1:b0:4f,12683625,408,33,12683217,12683625
3129,4,1,1,2412,-80,-91,11,3c:bd:c5:ee:96:6d,12693027,2512,6890,12690515,12693027
3130,4,1,1,2412,-87,-91,4,bc:98:df:ff:0f:8b,12698679,2568,3084,12696111,12698679
3131,6,6,1,2412,-80,-91,11,52:86:8c:5f:93:1e,12701102,332,2091,12700770,12701102
3132,4,1,1,2412,-83,-91,8,,12702518,304,1112,12702214,12702518
3133,4,11,1,2412,-80,-91,11,48:dd:0c:7d:86:27,12705602,362,2722,12705240,12705602
3134,4,11,1,2412,-80,-91,11,48:dd:0c:7d:86:23,12705976,323,51,12705653,12705976
3135,4,11,1,2412,-80,-91,11,48:dd:0c:7d:86:25,12706312,382,-46,12705930,12706312
3136,4,1,1,2412,-87,-91,4,ac:67:84:84:8a:07,12707349,416,621,12706933,12707349
3137,4,1,1,2412,-84,-91,7,,12725613,304,17960,12725309,12725613
3138,4,1,1,2412,-87,-91,4,ac:67:84:84:8a:07,12729272,416,3243,12728856,12729272
3139,6,6,1,2412,-76,-91,15,f8:4f:ad:f9:af:82,12735316,548,5496,12734768,12735316
3140,4,11,1,2412,-77,-91,14,48:dd:0c:90:e3:87,12741507,362,5829,12741145,12741507
3141,4,11,1,2412,-83,-91,8,48:dd:0c:90:e3:85,12742217,382,328,12741835,12742217
3142,4,1,1,2412,-86,-91,5,78:67:0e:c4:a8:42,12743983,2736,-970,12741247,12743983
3143,6,6,1,2412,-81,-91,10,12:86:8c:5f:93:1e,12751092,332,6777,12750760,12751092
3144,4,1,1,2412,-89,-91,2,c8:9e:43:bc:eb:ff,12754161,3496,-427,12750665,12754161
3145,4,1,1,2412,-78,-91,13,b0:e4:d5:32:ec:8a,12765470,1960,9349,12763510,12765470
3146,4,1,1,2412,-84,-91,7,,12769321,304,3547,12769017,12769321
3147,6,6,1,2412,-76,-91,15,e2:db:d1:d1:b0:4d,12785469,408,15740,12785061,12785469
3148,6,6,1,2412,-77,-91,14,e2:db:d1:d1:b0:4f,12785901,408,24,12785493,12785901
3149,4,1,1,2412,-83,-91,8,,12788294,304,2089,12787990,12788294
3150,4,1,1,2412,-79,-91,12,3c:bd:c5:ee:96:6d,12795412,2512,4606,12792900,12795412
3151,6,6,1,2412,-80,-91,11,52:86:8c:5f:93:1e,12802293,332,6549,12801961,12802293
3152,4,11,1,2412,-79,-91,12,48:dd:0c:7d:86:27,12808002,362,5347,12807640,12808002
3153,4,11,1,2412,-79,-91,12,48:dd:0c:7d:86:23,12808376,323,51,12808053,12808376
3154,4,11,1,2412,-80,-91,11,48:dd:0c:7d:86:25,12808711,382,-47,12808329,12808711
3155,6,24,1,2412,-83,-91,8,,12813869,28,5130,12813841,12813869
3156,4,1,1,2412,-83,-91,8,78:67:0e:c4:a8:42,12826674,848,11957,12825826,12826674
3157,6,6,1,2412,-79,-91,12,10:86:8c:5f:93:1e,12827893,336,883,12827557,12827893
3158,4,1,1,2412,-85,-91,6,78:67:0e:38:6c:d3,12834854,2736,4225,12832118,12834854
3159,4,1,1,2412,-85,-91,6,78:67:0e:c4:a8:41,12838314,832,2628,12837482,12838314
3160,4,11,1,2412,-78,-91,13,48:dd:0c:90:e3:83,12844282,323,5645,12843959,12844282
3161,4,11,1,2412,-83,-91,8,48:dd:0c:90:e3:85,12844617,382,-47,12844235,12844617
3162,4,1,1,2412,-85,-91,6,,12852459,304,7538,12852155,12852459
3163,6,6,1,2412,-80,-91,11,12:86:8c:5f:93:1e,12853834,332,1043,12853502,12853834
3164,4,1,1,2412,-89,-91,2,ce:9e:43:bc:eb:ff,12861141,3800,3507,12857341,12861141
3165,4,1,1,2412,-85,-91,6,,12879025,304,17580,12878721,12879025
3166,6,6,1,2412,-80,-91,11,32:86:8c:5f:93:1e,12879481,332,124,12879149,12879481
3167,4,1,1,2412,-87,-91,4,,12884026,448,4097,12883578,12884026
3168,4,1,1,2412,-82,-91,9,b4:b5:2f:17:0c:b9,12885792,1376,390,12884416,12885792
3169,6,6,1,2412,-77,-91,14,e2:db:d1:d1:b0:4b,12887437,408,1237,12887029,12887437
3170,6,6,1,2412,-76,-91,15,e2:db:d1:d1:b0:4d,12887869,408,24,12887461,12887869
3171,6,6,1,2412,-77,-91,14,e2:db:d1:d1:b0:4f,12888328,408,51,12887920,12888328
3172,4,1,1,2412,-79,-91,12,3c:bd:c5:ee:96:6d,12897872,2512,7032,12895360,12897872
3173,6,6,1,2412,-87,-91,4,,12904284,44,6368,12904240,12904284
3174,6,6,1,2412,-80,-91,11,52:86:8c:5f:93:1e,12904693,332,77,12904361,12904693
3175,6,24,1,2412,-82,-91,9,,12905149,28,428,12905121,12905149
3176,4,11,1,2412,-80,-91,11,48:dd:0c:7d:86:27,12910401,362,4890,12910039,12910401
3177,4,11,1,2412,-80,-91,11,48:dd:0c:7d:86:23,12910776,323,52,12910453,12910776
3178,4,11,1,2412,-80,-91,11,48:dd:0c:7d:86:25,12911111,382,-47,12910729,12911111
3179,6,24,1,2412,-83,-91,8,,12911600,28,461,12911572,12911600
3180,6,6,1,2412,-86,-91,5,,12918809,44,7165,12918765,12918809
3181,4,1,1,2412,-86,-91,5,ac:67:84:84:8a:07,12925723,416,6498,12925307,12925723
3182,4,11,1,2412,-78,-91,13,48:dd:0c:90:e3:87,12946307,362,20222,12945945,12946307
3183,4,11,1,2412,-78,-91,13,48:dd:0c:90:e3:83,12946681,323,51,12946358,12946681
3184,4,11,1,2412,-85,-91,6,48:dd:0c:90:e3:85,12947017,382,-46,12946635,12947017
3185,4,1,1,2412,-85,-91,6,78:67:0e:c4:a8:42,12948598,2736,-1155,12945862,12948598
3186,6,6,1,2412,-80,-91,11,12:86:8c:5f:93:1e,12955894,332,6964,12955562,12955894
3187,4,2,1,2412,-88,-91,3,34:15:13:b7:0a:84,12960994,208,4892,12960786,12960994
3188,4,2,1,2412,-87,-91,4,34:15:13:b7:0a:84,12962913,208,1711,12962705,12962913
3189,4,2,1,2412,-85,-91,6,,12963134,152,69,12962982,12963134
3190,4,1,1,2412,-78,-91,13,b0:e4:d5:32:ec:8a,12970268,1960,5174,12968308,12970268
3191,4,1,1,2412,-87,-91,4,,12973103,448,2387,12972655,12973103
3192,4,2,1,2412,-83,-91,8,,12978672,152,5417,12978520,12978672
3193,6,6,1,2412,-81,-91,10,32:86:8c:5f:93:1e,12981557,332,2553,12981225,12981557
3194,4,11,1,2412,-83,-91,8,48:dd:0c:90:e3:83,12983371,254,1560,12983117,12983371
3195,4,11,1,2412,-80,-91,11,48:dd:0c:7d:86:23,12984021,254,396,12983767,12984021
3196,4,1,1,2412,-83,-91,8,,12985741,304,1416,12985437,12985741
3197,6,6,1,2412,-77,-91,14,f8:4f:ad:f9:af:82,12986012,576,-305,12985436,12986012
3198,6,6,1,2412,-77,-91,14,e2:db:d1:d1:b0:4d,12990236,408,3816,12989828,12990236
3199,6,6,1,2412,-77,-91,14,e2:db:d1:d1:b0:4f,12990667,408,23,12990259,12990667
3200,6,6,1,2412,-80,-91,11,52:86:8c:5f:93:1e,13007094,332,16095,13006762,13007094
3201,4,1,1,2412,-87,-89,2,ac:67:84:84:8a:07,13016089,416,8579,13015673,13016089
3202,4,1,1,2412,-90,-89,-1,,13016518,304,125,13016214,13016518
3203,4,1,1,2412,-88,-89,1,ac:67:84:84:8a:07,13031396,416,14462,13030980,13031396
3204,4,1,1,2412,-85,-89,4,78:67:0e:38:6c:d3,13039654,2736,5522,13036918,13039654
3205,4,11,1,2412,-79,-89,10,48:dd:0c:90:e3:87,13048707,362,8691,13048345,13048707
3206,4,11,1,2412,-77,-89,12,48:dd:0c:90:e3:85,13049416,382,327,13049034,13049416
3207,4,1,1,2412,-86,-89,3,78:67:0e:c4:a8:42,13050998,2736,-1154,13048262,13050998
3208,4,1,1,2412,-85,-89,4,,13054185,304,2883,13053881,13054185
3209,6,6,1,2412,-80,-89,9,12:86:8c:5f:93:1e,13058294,332,3777,13057962,13058294
3210,6,24,1,2412,-83,-89,6,,13065977,28,7655,13065949,13065977
3211,4,1,1,2412,-85,-89,4,,13067735,304,1454,13067431,13067735
3212,6,24,1,2412,-82,-89,7,,13070158,28,2395,13070130,13070158
3213,4,1,1,2412,-79,-89,10,b0:e4:d5:32:ec:8a,13072668,1960,550,13070708,13072668
3214,6,6,1,2412,-80,-89,9,32:86:8c:5f:93:1e,13083895,332,10895,13083563,13083895
3215,6,6,1,2412,-77,-89,12,e2:db:d1:d1:b0:4b,13092243,408,7940,13091835,13092243
3216,6,6,1,2412,-77,-89,12,e2:db:d1:d1:b0:4d,13092693,408,42,13092285,13092693
3217,6,6,1,2412,-77,-89,12,e2:db:d1:d1:b0:4f,13093143,408,42,13092735,13093143
3218,4,1,1,2412,-89,-89,0,,13096274,448,2683,13095826,13096274
3219,4,1,1,2412,-77,-89,12,3c:bd:c5:ee:96:6d,13103434,2512,4648,13100922,13103434
3220,6,6,1,2412,-81,-89,8,52:86:8c:5f:93:1e,13109495,332,5729,13109163,13109495
3221,4,11,1,2412,-79,-89,10,48:dd:0c:7d:86:27,13115201,362,5344,13114839,13115201
3222,4,11,1,2412,-80,-89,9,48:dd:0c:7d:86:23,13115575,323,51,13115252,13115575
3223,4,11,1,2412,-80,-89,9,48:dd:0c:7d:86:25,13115911,382,-46,13115529,13115911
3224,4,1,1,2412,-86,-89,3,ac:67:84:84:8a:07,13117277,416,950,13116861,13117277
3225,4,1,1,2412,-90,-89,-1,,13117706,304,125,13117402,13117706
3226,4,1,1,2412,-84,-89,5,,13126450,352,8392,13126098,13126450
3227,4,11,1,2412,-76,-89,13,,13128841,107,2284,13128734,13128841
3228,4,1,1,2412,-86,-89,3,,13131137,304,1992,13130833,13131137
3229,4,1,1,2412,-84,-89,5,,13132743,352,1254,13132391,13132743
3230,4,1,1,2412,-84,-89,5,,13133598,352,503,13133246,13133598
3231,6,24,1,2412,-84,-89,5,,13133912,28,286,13133884,13133912
3232,4,1,1,2412,-84,-89,5,,13134444,352,180,13134092,13134444
3233,4,1,1,2412,-87,-89,2,,13135290,352,494,13134938,13135290
3234,4,1,1,2412,-85,-89,4,,13136136,352,494,13135784,13136136
3235,6,6,1,2412,-81,-89,8,10:86:8c:5f:93:1e,13137086,336,614,13136750,13137086
3236,4,1,1,2412,-85,-89,4,78:67:0e:38:6c:d3,13142054,2736,2232,13139318,13142054
3237,4,11,1,2412,-86,-89,3,4c:01:43:ec:a0:66,13146470,387,4029,13146083,13146470
3238,4,11,1,2412,-78,-89,11,48:dd:0c:90:e3:87,13151106,362,4274,13150744,13151106
3239,4,11,1,2412,-83,-89,6,48:dd:0c:90:e3:85,13151816,382,328,13151434,13151816
3240,4,1,1,2412,-84,-89,5,78:67:0e:c4:a8:42,13153398,2736,-1154,13150662,13153398
3241,6,24,1,2412,-83,-89,6,,13157731,28,4305,13157703,13157731
3242,4,1,1,2412,-87,-89,2,ac:67:84:84:8a:07,13159226,416,1079,13158810,13159226
3243,6,6,1,2412,-80,-89,9,12:86:8c:5f:93:1e,13160695,332,1137,13160363,13160695
3244,4,1,1,2412,-80,-89,9,b0:e4:d5:32:ec:8a,13175067,1960,12412,13173107,13175067
3245,4,1,1,2412,-87,-89,2,ac:67:84:84:8a:07,13180740,416,5257,13180324,13180740
3246,4,1,1,2412,-87,-89,2,,13182192,448,1004,13181744,13182192
3247,6,6,1,2412,-81,-89,8,32:86:8c:5f:93:1e,13186295,332,3771,13185963,13186295
3248,6,6,1,2412,-76,-89,13,e2:db:d1:d1:b0:4b,13194617,408,7914,13194209,13194617
3249,6,6,1,2412,-77,-89,12,e2:db:d1:d1:b0:4d,13195049,408,24,13194641,13195049
3250,4,1,1,2412,-89,-89,0,c8:9e:43:bc:eb:ff,13198202,3496,-343,13194706,13198202
3251,4,1,1,2412,-78,-89,11,3c:bd:c5:ee:96:6d,13205093,2512,4379,13202581,13205093
3252,4,1,1,2412,-86,-89,3,bc:98:df:ff:0f:8b,13208582,2568,921,13206014,13208582
3253,6,6,1,2412,-82,-89,7,52:86:8c:5f:93:1e,13211895,332,2981,13211563,13211895
3254,6,24,1,2412,-83,-89,6,,13213877,28,1954,13213849,13213877
3255,4,11,1,2412,-81,-89,8,48:dd:0c:7d:86:27,13217601,362,3362,13217239,13217601
3256,4,11,1,2412,-80,-89,9,48:dd:0c:7d:86:23,13217975,323,51,13217652,13217975
3257,4,11,1,2412,-80,-89,9,48:dd:0c:7d:86:25,13218310,382,-47,13217928,13218310
3258,6,24,1,2412,-82,-89,7,,13225154,28,6816,13225126,13225154
3259,6,24,1,2412,-83,-89,6,,13230766,28,5584,13230738,13230766
3260,6,6,1,2412,-81,-89,8,10:86:8c:5f:93:1e,13237818,336,6716,13237482,13237818
3261,4,11,1,2412,-81,-89,8,10:86:8c:5f:93:26,13238353,347,188,13238006,13238353
3262,6,6,1,2412,-80,-89,9,b4:e6:2d:b4:ff:71,13239610,64,1193,13239546,13239610
3263,6,6,1,2412,-79,-89,10,,13239690,44,36,13239646,13239690
3264,6,6,1,2412,-77,-89,12,f8:4f:ad:f9:af:82,13241018,548,780,13240470,13241018
3265,4,1,1,2412,-85,-89,4,78:67:0e:38:6c:d3,13244454,2736,700,13241718,13244454
3266,4,11,1,2412,-78,-89,11,48:dd:0c:90:e3:83,13253881,323,9104,13253558,13253881
3267,4,11,1,2412,-83,-89,6,48:dd:0c:90:e3:85,13254216,382,-47,13253834,13254216
3268,4,1,1,2412,-83,-89,6,78:67:0e:c4:a8:42,13255798,2736,-1154,13253062,13255798
3269,6,6,1,2412,-79,-89,10,12:86:8c:5f:93:1e,13263096,332,6966,13262764,13263096
3270,6,6,1,2412,-77,-89,12,f8:4f:ad:f9:af:82,13270832,656,7080,13270176,13270832
3271,6,6,1,2412,-77,-89,12,f8:4f:ad:f9:af:82,13272099,632,635,13271467,13272099
3272,4,1,1,2412,-78,-89,11,b0:e4:d5:32:ec:8a,13277466,1960,3407,13275506,13277466
3273,4,1,1,2412,-85,-89,4,,13280014,448,2100,13279566,13280014
3274,4,1,1,2412,-87,-89,2,,13280900,448,438,13280452,13280900
3275,6,6,1,2412,-80,-89,9,32:86:8c:5f:93:1e,13288742,332,7510,13288410,13288742
3276,4,11,1,2412,-84,-89,5,,13290677,107,1828,13290570,13290677
3277,4,11,1,2412,-83,-89,6,,13293315,107,2531,13293208,13293315
3278,6,6,1,2412,-76,-89,13,e2:db:d1:d1:b0:4a,13296745,444,2986,13296301,13296745
3279,6,6,1,2412,-77,-89,12,e2:db:d1:d1:b0:4b,13297240,408,87,13296832,13297240
3280,6,6,1,2412,-77,-89,12,e2:db:d1:d1:b0:4d,13297690,408,42,13297282,13297690
3281,6,6,1,2412,-77,-89,12,e2:db:d1:d1:b0:4f,13298131,408,33,13297723,13298131
3282,6,6,1,2412,-81,-89,8,52:86:8c:5f:93:1e,13314296,332,15833,13313964,13314296
3283,4,11,1,2412,-79,-89,10,48:dd:0c:7d:86:27,13320001,362,5343,13319639,13320001
3284,4,11,1,2412,-80,-89,9,48:dd:0c:7d:86:23,13320375,323,51,13320052,13320375
3285,4,11,1,2412,-80,-89,9,48:dd:0c:7d:86:25,13320710,382,-47,13320328,13320710
3286,4,1,1,2412,-88,-89,1,ac:67:84:84:8a:07,13329293,416,8167,13328877,13329293
3287,6,24,1,2412,-82,-89,7,,13338948,28,9627,13338920,13338948
3288,6,6,1,2412,-81,-89,8,10:86:8c:5f:93:1e,13339897,336,613,13339561,13339897
3289,4,1,1,2412,-86,-89,3,78:67:0e:38:6c:d3,13346854,2736,4221,13344118,13346854
3290,4,11,1,2412,-83,-89,6,48:dd:0c:90:e3:85,13356616,382,9380,13356234,13356616
3291,4,1,1,2412,-84,-89,5,78:67:0e:c4:a8:42,13358197,2736,-1155,13355461,13358197
3292,6,6,1,2412,-81,-89,8,12:86:8c:5f:93:1e,13365497,332,6968,13365165,13365497
3293,4,1,1,2412,-81,-89,8,ac:67:84:84:8a:07,13372646,416,6733,13372230,13372646
3294,4,1,1,2412,-82,-89,7,,13373074,304,124,13372770,13373074
3295,6,24,1,2412,-82,-89,7,,13373878,28,776,13373850,13373878
3296,4,1,1,2412,-79,-89,10,b0:e4:d5:32:ec:8a,13379866,1960,4028,13377906,13379866
3297,4,1,1,2412,-85,-89,4,,13382811,448,2497,13382363,13382811
3298,4,11,1,2412,-83,-89,6,48:dd:0c:90:e3:83,13385907,254,2842,13385653,13385907
3299,4,11,1,2412,-80,-89,9,48:dd:0c:7d:86:23,13386209,254,48,13385955,13386209
3300,6,6,1,2412,-80,-89,9,32:86:8c:5f:93:1e,13391544,332,5003,13391212,13391544
3301,6,6,1,2412,-77,-89,12,e2:db:d1:d1:b0:4b,13399417,408,7465,13399009,13399417
3302,6,6,1,2412,-76,-89,13,e2:db:d1:d1:b0:4d,13399849,408,24,13399441,13399849
3303,4,1,1,2412,-80,-89,9,3c:bd:c5:ee:96:6d,13410637,2512,8276,13408125,13410637
3304,4,1,1,2412,-79,-89,10,3c:bd:c5:ee:96:6a,13413175,1056,1482,13412119,13413175
3305,6,6,1,2412,-81,-89,8,52:86:8c:5f:93:1e,13416697,332,3190,13416365,13416697
3306,6,6,1,2412,-81,-89,8,b4:e6:2d:b4:ff:71,13423362,64,6601,13423298,13423362
3307,6,6,1,2412,-82,-89,7,,13423443,44,37,13423399,13423443
3308,4,1,1,2412,-90,-89,-1,e4:5f:01:2c:3c:d6,13433708,2064,8201,13431644,13433708
3309,4,1,1,2412,-84,-89,5,,13438657,304,4645,13438353,13438657
3310,4,1,1,2412,-86,-89,3,,13441145,304,2184,13440841,13441145
3311,6,6,1,2412,-80,-89,9,10:86:8c:5f:93:1e,13442297,336,816,13441961,13442297
3312,6,6,1,2412,-77,-89,12,f8:4f:ad:f9:af:82,13446448,248,3903,13446200,13446448
3313,6,6,1,2412,-77,-89,12,f8:4f:ad:f9:af:82,13448363,224,1691,13448139,13448363
3314,4,11,1,2412,-78,-89,11,48:dd:0c:90:e3:87,13458306,362,9581,13457944,13458306
3315,4,11,1,2412,-83,-89,6,48:dd:0c:90:e3:85,13459015,382,327,13458633,13459015
3316,4,1,1,2412,-85,-89,4,,13460004,304,685,13459700,13460004
3317,4,1,1,2412,-84,-89,5,78:67:0e:c4:a8:42,13460597,2736,-2143,13457861,13460597
3318,6,24,1,2412,-82,-89,7,,13465165,28,4540,13465137,13465165
3319,6,6,1,2412,-81,-89,8,12:86:8c:5f:93:1e,13468361,332,2864,13468029,13468361
3320,6,24,1,2412,-82,-89,7,,13470249,28,1860,13470221,13470249
3321,6,24,1,2412,-81,-89,8,,13478898,32,8617,13478866,13478898
3322,4,1,1,2412,-78,-89,11,b0:e4:d5:32:ec:8a,13482265,1960,1407,13480305,13482265
3323,6,6,1,2412,-79,-89,10,32:86:8c:5f:93:1e,13493497,332,10900,13493165,13493497
3324,6,6,1,2412,-76,-89,13,e2:db:d1:d1:b0:4d,13502518,408,8613,13502110,13502518
3325,6,6,1,2412,-76,-89,13,e2:db:d1:d1:b0:4f,13502959,408,33,13502551,13502959
3326,4,1,1,2412,-87,-89,2,,13504337,448,930,13503889,13504337
3327,4,1,1,2412,-87,-89,2,,13505223,448,438,13504775,13505223
3328,4,1,1,2412,-79,-89,10,3c:bd:c5:ee:96:6d,13512216,2512,4481,13509704,13512216
3329,6,6,1,2412,-81,-89,8,52:86:8c:5f:93:1e,13519098,332,6550,13518766,13519098
3330,4,11,1,2412,-81,-89,8,48:dd:0c:7d:86:23,13525175,323,5754,13524852,13525175
3331,4,11,1,2412,-78,-89,11,48:dd:0c:7d:86:25,13525510,382,-47,13525128,13525510
3332,6,24,1,2412,-82,-89,7,,13535076,28,9538,13535048,13535076
3333,6,6,1,2412,-80,-89,9,10:86:8c:5f:93:1e,13544698,336,9286,13544362,13544698
3334,6,24,1,2412,-81,-89,8,,13545157,28,431,13545129,13545157
3335,4,11,1,2412,-79,-89,10,4e:f0:43:5e:cf:0e,13547277,357,1763,13546920,13547277
3336,4,11,1,2412,-80,-89,9,48:dd:0c:7d:86:2e,13549566,367,1922,13549199,13549566
3337,6,6,1,2412,-76,-89,13,f8:4f:ad:f9:af:82,13549791,1360,-1135,13548431,13549791
3338,6,6,1,2412,-76,-89,13,f8:4f:ad:f9:af:82,13551274,1332,151,13549942,13551274
3339,4,11,1,2412,-77,-89,12,48:dd:0c:90:e3:87,13560705,362,9069,13560343,13560705
3340,4,11,1,2412,-77,-89,12,48:dd:0c:90:e3:83,13561080,323,52,13560757,13561080
3341,4,11,1,2412,-83,-89,6,48:dd:0c:90:e3:85,13561415,382,-47,13561033,13561415
3342,4,1,1,2412,-83,-89,6,78:67:0e:c4:a8:42,13562997,2736,-1154,13560261,13562997
3343,4,11,1,2412,-80,-89,9,48:dd:0c:7d:86:23,13568774,254,5523,13568520,13568774
3344,4,11,1,2412,-84,-89,5,48:dd:0c:90:e3:83,13569377,254,349,13569123,13569377
3345,6,6,1,2412,-80,-89,9,12:86:8c:5f:93:1e,13570298,332,589,13569966,13570298
3346,4,1,1,2412,-80,-89,9,b0:e4:d5:32:ec:8a,13584664,1960,12406,13582704,13584664
3347,4,1,1,2412,-81,-89,8,,13588358,448,3246,13587910,13588358
3348,6,6,1,2412,-79,-89,10,32:86:8c:5f:93:1e,13597756,332,9066,13597424,13597756
3349,6,6,1,2412,-78,-89,11,e2:db:d1:d1:b0:4a,13603743,444,5543,13603299,13603743
3350,6,6,1,2412,-77,-89,12,e2:db:d1:d1:b0:4f,13605137,408,986,13604729,13605137
3351,4,1,1,2412,-80,-89,9,3c:bd:c5:ee:96:6d,13614600,2512,6951,13612088,13614600
3352,6,6,1,2412,-80,-89,9,52:86:8c:5f:93:1e,13621498,332,6566,13621166,13621498
3353,6,24,1,2412,-81,-89,8,,13625158,28,3632,13625130,13625158
3354,4,11,1,2412,-80,-89,9,48:dd:0c:7d:86:27,13627200,362,1680,13626838,13627200
3355,4,11,1,2412,-81,-89,8,48:dd:0c:7d:86:23,13627574,323,51,13627251,13627574
3356,4,11,1,2412,-80,-89,9,48:dd:0c:7d:86:25,13627910,382,-46,13627528,13627910
3357,4,1,1,2412,-89,-89,0,60:b7:6e:d3:6c:f6,13631159,2152,1097,13629007,13631159
3358,6,6,1,2412,-79,-89,10,10:86:8c:5f:93:1e,13647099,336,15604,13646763,13647099
3359,4,1,1,2412,-86,-89,3,78:67:0e:38:6c:d3,13654153,2736,4318,13651417,13654153
3360,4,11,1,2412,-77,-89,12,48:dd:0c:90:e3:87,13663105,362,8590,13662743,13663105
3361,4,11,1,2412,-83,-89,6,48:dd:0c:90:e3:85,13663815,382,328,13663433,13663815
3362,4,1,1,2412,-82,-89,7,78:67:0e:c4:a8:42,13665397,2736,-1154,13662661,13665397
3363,4,1,1,2412,-89,-89,0,00:26:62:eb:ea:74,13678538,968,12173,13677570,13678538
3364,4,11,1,2412,-84,-89,5,,13685865,107,7220,13685758,13685865
3365,4,1,1,2412,-85,-89,4,,13686495,352,278,13686143,13686495
3366,4,1,1,2412,-78,-89,11,b0:e4:d5:32:ec:8a,13687064,1960,-1391,13685104,13687064
3367,4,1,1,2412,-83,-89,6,,13689122,352,1706,13688770,13689122
3368,4,1,1,2412,-81,-89,8,,13690254,352,780,13689902,13690254
3369,4,1,1,2412,-88,-89,1,,13691163,448,461,13690715,13691163
3370,4,1,1,2412,-85,-89,4,,13691690,352,175,13691338,13691690
3371,6,24,1,2412,-81,-89,8,,13693876,28,2158,13693848,13693876
3372,6,6,1,2412,-81,-89,8,32:86:8c:5f:93:1e,13698299,332,4091,13697967,13698299
3373,4,1,1,2412,-84,-89,5,b4:b5:2f:17:0c:b9,13705007,1376,5332,13703631,13705007
3374,6,6,1,2412,-77,-89,12,e2:db:d1:d1:b0:4b,13706649,408,1234,13706241,13706649
3375,6,6,1,2412,-76,-89,13,e2:db:d1:d1:b0:4d,13707099,408,42,13706691,13707099
3376,6,6,1,2412,-76,-89,13,e2:db:d1:d1:b0:4f,13707540,408,33,13707132,13707540
3377,6,24,1,2412,-81,-89,8,,13710167,28,2599,13710139,13710167
3378,4,1,1,2412,-79,-89,10,3c:bd:c5:ee:96:6d,13717232,2512,4553,13714720,13717232
3379,4,1,1,2412,-87,-89,2,bc:98:df:ff:0f:8b,13720595,2568,795,13718027,13720595
3380,6,6,1,2412,-81,-89,8,52:86:8c:5f:93:1e,13723899,332,2972,13723567,13723899
3381,4,11,1,2412,-79,-89,10,48:dd:0c:7d:86:27,13729600,362,5339,13729238,13729600
3382,4,11,1,2412,-79,-89,10,48:dd:0c:7d:86:23,13729974,323,51,13729651,13729974
3383,4,11,1,2412,-80,-89,9,48:dd:0c:7d:86:25,13730309,382,-47,13729927,13730309
3384,4,11,1,2412,-77,-89,12,48:dd:0c:90:e3:83,13765879,323,35247,13765556,13765879
3385,4,11,1,2412,-82,-89,7,48:dd:0c:90:e3:85,13766215,382,-46,13765833,13766215
3386,4,1,1,2412,-83,-89,6,78:67:0e:c4:a8:42,13767797,2736,-1154,13765061,13767797
3387,6,24,1,2412,-83,-89,6,,13773902,28,6077,13773874,13773902
3388,6,6,1,2412,-80,-89,9,12:86:8c:5f:93:1e,13775100,332,866,13774768,13775100
3389,6,24,1,2412,-81,-89,8,,13785167,28,10039,13785139,13785167
3390,4,1,1,2412,-80,-89,9,b0:e4:d5:32:ec:8a,13789463,1960,2336,13787503,13789463
3391,4,1,1,2412,-86,-89,3,,13797262,448,7351,13796814,13797262
3392,4,1,1,2412,-84,-89,5,b4:b5:2f:17:0c:b9,13807408,1376,8770,13806032,13807408
3393,4,1,1,2412,-89,-89,0,0e:b9:49:67:a0:d6,13822412,416,14588,13821996,13822412
3394,6,6,1,2412,-80,-89,9,52:86:8c:5f:93:1e,13826300,332,3556,13825968,13826300
3395,4,11,1,2412,-80,-89,9,48:dd:0c:7d:86:27,13831999,362,5337,13831637,13831999
3396,4,11,1,2412,-80,-89,9,48:dd:0c:7d:86:23,13832374,323,52,13832051,13832374
3397,4,11,1,2412,-80,-89,9,48:dd:0c:7d:86:25,13832709,382,-47,13832327,13832709
3398,4,1,1,2412,-89,-89,0,60:b7:6e:d3:6c:f6,13835959,2152,1098,13833807,13835959
3399,4,1,1,2412,-88,-89,1,0e:b9:49:67:a0:d6,13839052,416,2677,13838636,13839052
3400,6,6,1,2412,-78,-89,11,10:86:8c:5f:93:1e,13851900,336,12512,13851564,13851900
3401,6,6,1,2412,-80,-89,9,,13853606,44,1662,13853562,13853606
3402,4,11,1,2412,-77,-89,12,48:dd:0c:90:e3:87,13867905,362,13937,13867543,13867905
3403,4,11,1,2412,-82,-89,7,48:dd:0c:90:e3:85,13868614,382,327,13868232,13868614
3404,4,1,1,2412,-84,-89,5,78:67:0e:c4:a8:42,13870197,2736,-1153,13867461,13870197
3405,6,6,1,2412,-81,-89,8,12:86:8c:5f:93:1e,13877661,332,7132,13877329,13877661
3406,6,6,1,2412,-84,-89,5,,13880355,44,2650,13880311,13880355
3407,4,1,1,2412,-78,-89,11,b0:e4:d5:32:ec:8a,13891862,1960,9547,13889902,13891862
3408,4,1,1,2412,-84,-89,5,,13896743,448,4433,13896295,13896743
3409,4,1,1,2412,-86,-89,3,,13897647,448,456,13897199,13897647
3410,6,24,1,2412,-81,-89,8,,13900128,28,2453,13900100,13900128
3411,6,6,1,2412,-80,-89,9,32:86:8c:5f:93:1e,13905202,332,4742,13904870,13905202
3412,6,6,1,2412,-76,-89,13,e2:db:d1:d1:b0:4a,13910957,444,5311,13910513,13910957
3413,6,6,1,2412,-76,-89,13,e2:db:d1:d1:b0:4b,13911452,408,87,13911044,13911452
3414,4,1,1,2412,-79,-89,10,3c:bd:c5:ee:96:6d,13921820,2512,7856,13919308,13921820
3415,4,1,1,2412,-86,-89,3,ac:67:84:84:8a:07,13924753,416,2517,13924337,13924753
3416,4,1,1,2412,-87,-89,2,bc:98:df:ff:0f:8b,13925383,2568,-1938,13922815,13925383
3417,6,6,1,2412,-72,-89,17,52:86:8c:5f:93:1e,13928701,332,2986,13928369,13928701
3418,4,11,1,2412,-85,-89,4,,13930199,107,1391,13930092,13930199
3419,4,11,1,2412,-84,-89,5,,13930851,107,545,13930744,13930851
3420,4,11,1,2412,-79,-89,10,48:dd:0c:7d:86:27,13934399,362,3186,13934037,13934399
3421,4,11,1,2412,-80,-89,9,48:dd:0c:7d:86:23,13934774,323,52,13934451,13934774
3422,4,11,1,2412,-79,-89,10,48:dd:0c:7d:86:25,13935109,382,-47,13934727,13935109
3423,4,1,1,2412,-86,-89,3,ac:67:84:84:8a:07,13945273,416,9748,13944857,13945273
3424,6,24,1,2412,-84,-89,5,,13950829,28,5528,13950801,13950829
3425,6,6,1,2412,-80,-89,9,10:86:8c:5f:93:1e,13956600,336,5435,13956264,13956600
3426,4,1,1,2412,-84,-89,5,,13966203,352,9251,13965851,13966203
3427,6,6,1,2412,-80,-89,9,12:86:8c:5f:93:1e,13979901,332,13366,13979569,13979901
3428,4,1,1,2412,-78,-89,11,b0:e4:d5:32:ec:8a,13994262,1960,12401,13992302,13994262
3429,6,6,1,2412,-82,-89,7,32:86:8c:5f:93:1e,14005571,332,10977,14005239,14005571
3430,6,6,1,2412,-85,-89,4,,14008807,44,3192,14008763,14008807
3431,6,6,1,2412,-77,-89,12,e2:db:d1:d1:b0:4b,14014128,408,4913,14013720,14014128
3432,6,6,1,2412,-77,-89,12,e2:db:d1:d1:b0:4d,14014568,408,32,14014160,14014568
3433,6,6,1,2412,-77,-89,12,e2:db:d1:d1:b0:4f,14015000,408,24,14014592,14015000
3434,4,1,1,2412,-87,-89,2,ac:67:84:84:8a:07,14018179,416,2763,14017763,14018179
3435,4,1,1,2412,-87,-89,2,10:7b:44:eb:35:60,14021648,1960,1509,14019688,14021648
3436,4,1,1,2412,-78,-89,11,3c:bd:c5:ee:96:6d,14025011,2512,851,14022499,14025011
3437,4,1,1,2412,-86,-89,3,bc:98:df:ff:0f:8b,14027778,2568,199,14025210,14027778
3438,4,1,1,2412,-86,-89,3,ac:67:84:84:8a:07,14030499,416,2305,14030083,14030499
3439,6,6,1,2412,-80,-89,9,52:86:8c:5f:93:1e,14031102,332,271,14030770,14031102
3440,4,11,1,2412,-80,-89,9,48:dd:0c:7d:86:27,14036799,362,5335,14036437,14036799
3441,4,11,1,2412,-80,-89,9,48:dd:0c:7d:86:23,14037173,323,51,14036850,14037173
3442,4,11,1,2412,-80,-89,9,48:dd:0c:7d:86:25,14037509,382,-46,14037127,14037509
3443,6,6,1,2412,-80,-89,9,b4:e6:2d:b4:ff:71,14038417,64,844,14038353,14038417
3444,6,6,1,2412,-81,-89,8,,14038498,44,37,14038454,14038498
3445,4,11,1,2412,-76,-89,13,48:dd:0c:90:e3:83,14073079,323,34258,14072756,14073079
3446,4,11,1,2412,-80,-89,9,48:dd:0c:90:e3:85,14073414,382,-47,14073032,14073414
3447,4,1,1,2412,-85,-89,4,78:67:0e:c4:a8:42,14074996,2736,-1154,14072260,14074996
3448,6,6,1,2412,-80,-89,9,b4:e6:2d:b4:ff:71,14085345,64,10285,14085281,14085345
3449,6,6,1,2412,-80,-89,9,,14085425,44,36,14085381,14085425
3450,4,1,1,2412,-84,-89,5,78:67:0e:c4:a8:42,14091187,3472,2290,14087715,14091187
3451,4,1,1,2412,-80,-89,9,b0:e4:d5:32:ec:8a,14096661,1960,3514,14094701,14096661
3452,4,1,1,2412,-85,-89,4,,14102271,448,5162,14101823,14102271
3453,4,1,1,2412,-85,-89,4,,14103166,448,447,14102718,14103166
3454,6,24,1,2412,-83,-89,6,,14110174,28,6980,14110146,14110174
3455,6,6,1,2412,-81,-89,8,32:86:8c:5f:93:1e,14111387,332,881,14111055,14111387
3456,4,1,1,2412,-82,-89,7,60:32:b1:64:4c:f2,14112550,3224,-2061,14109326,14112550
3457,6,6,1,2412,-76,-89,13,e2:db:d1:d1:b0:4a,14115947,444,2953,14115503,14115947
3458,6,6,1,2412,-77,-89,12,e2:db:d1:d1:b0:4b,14116424,408,69,14116016,14116424
3459,6,6,1,2412,-77,-89,12,e2:db:d1:d1:b0:4d,14116874,408,42,14116466,14116874
3460,6,6,1,2412,-77,-89,12,e2:db:d1:d1:b0:4f,14117315,408,33,14116907,14117315
3461,6,24,1,2412,-85,-89,4,,14117813,28,470,14117785,14117813
3462,4,1,1,2412,-79,-89,10,,14124748,304,6631,14124444,14124748
3463,4,1,1,2412,-79,-89,10,3c:bd:c5:ee:96:6d,14126606,2512,-654,14124094,14126606
3464,4,11,1,2412,-82,-89,7,,14129180,107,2467,14129073,14129180
3465,4,11,1,2412,-84,-89,5,,14129899,107,612,14129792,14129899
3466,4,1,1,2412,-83,-89,6,,14130207,352,-44,14129855,14130207
3467,4,1,1,2412,-83,-89,6,,14130668,352,109,14130316,14130668
3468,4,1,1,2412,-87,-89,2,,14131517,352,497,14131165,14131517
3469,4,1,1,2412,-85,-89,4,,14132375,352,506,14132023,14132375
3470,4,11,1,2412,-86,-89,3,,14133238,107,756,14133131,14133238
3471,4,1,1,2412,-86,-89,3,,14133612,352,22,14133260,14133612
3472,4,11,1,2412,-84,-89,5,,14134040,107,321,14133933,14134040
3473,6,12,1,2412,-84,-89,5,,14134187,44,103,14134143,14134187
3474,4,1,1,2412,-85,-89,4,,14134464,352,-75,14134112,14134464
3475,4,11,1,2412,-84,-89,5,,14135593,107,1022,14135486,14135593
3476,4,1,1,2412,-85,-89,4,,14135965,352,20,14135613,14135965
3477,6,6,1,2412,-80,-89,9,52:86:8c:5f:93:1e,14136619,332,322,14136287,14136619
3478,4,1,1,2412,-86,-89,3,,14137223,352,252,14136871,14137223
3479,4,11,1,2412,-83,-89,6,,14138229,107,899,14138122,14138229
3480,4,11,1,2412,-79,-89,10,48:dd:0c:7d:86:27,14139199,362,608,14138837,14139199
3481,4,11,1,2412,-81,-89,8,48:dd:0c:7d:86:23,14139573,323,51,14139250,14139573
3482,4,11,1,2412,-80,-89,9,48:dd:0c:7d:86:25,14139908,382,-47,14139526,14139908
3483,4,1,1,2412,-86,-89,3,,14140453,352,193,14140101,14140453
3484,4,1,1,2412,-85,-89,4,b4:b5:2f:17:0c:b9,14143800,1328,2019,14142472,14143800
3485,4,1,1,2412,-86,-89,3,b4:b5:2f:17:0c:b9,14145449,1328,321,14144121,14145449
3486,4,1,1,2412,-84,-89,5,b4:b5:2f:17:0c:b9,14148749,1328,1972,14147421,14148749
3487,4,1,1,2412,-86,-89,3,b4:b5:2f:17:0c:b9,14150399,1328,322,14149071,14150399
3488,4,1,1,2412,-85,-89,4,b4:b5:2f:17:0c:b9,14153971,1328,2244,14152643,14153971
3489,4,1,1,2412,-86,-89,3,b4:b5:2f:17:0c:b9,14155621,1328,322,14154293,14155621
3490,4,1,1,2412,-85,-89,4,b4:b5:2f:17:0c:b9,14157271,1328,322,14155943,14157271
3491,6,6,1,2412,-81,-89,8,10:86:8c:5f:93:1e,14159103,336,1496,14158767,14159103
3492,4,11,1,2412,-84,-89,5,,14163252,107,4042,14163145,14163252
3493,4,1,1,2412,-82,-89,7,66:32:b1:64:4c:f2,14163800,2696,-2148,14161104,14163800
3494,4,1,1,2412,-82,-89,7,,14168928,304,4824,14168624,14168928
3495,4,1,1,2412,-81,-89,8,78:67:0e:c4:a8:42,14177396,2736,5732,14174660,14177396
3496,4,1,1,2412,-81,-89,8,1c:f2:9a:33:8c:d5,14180179,1064,1719,14179115,14180179
3497,6,6,1,2412,-80,-89,9,12:86:8c:5f:93:1e,14184703,332,4192,14184371,14184703
3498,6,24,1,2412,-83,-89,6,,14198369,28,13638,14198341,14198369
3499,4,1,1,2412,-80,-89,9,b0:e4:d5:32:ec:8a,14199060,1960,-1269,14197100,14199060
3500,4,1,1,2412,-86,-89,3,,14205130,448,5622,14204682,14205130
3501,4,1,1,2412,-88,-89,1,,14206007,448,429,14205559,14206007
3502,6,6,1,2412,-80,-89,9,32:86:8c:5f:93:1e,14210318,332,3979,14209986,14210318
3503,6,6,1,2412,-76,-89,13,e2:db:d1:d1:b0:4a,14224235,444,13473,14223791,14224235
3504,6,6,1,2412,-77,-89,12,e2:db:d1:d1:b0:4b,14224721,408,78,14224313,14224721
3505,6,6,1,2412,-76,-89,13,e2:db:d1:d1:b0:4d,14225162,408,33,14224754,14225162
3506,6,6,1,2412,-76,-89,13,e2:db:d1:d1:b0:4f,14225594,408,24,14225186,14225594
3507,4,1,1,2412,-78,-89,11,3c:bd:c5:ee:96:6d,14229618,2512,1512,14227106,14229618
3508,6,6,1,2412,-80,-89,9,52:86:8c:5f:93:1e,14235903,332,5953,14235571,14235903
3509,4,1,1,2412,-87,-89,2,b4:b5:2f:17:0c:b9,14238423,1328,1192,14237095,14238423
3510,4,1,1,2412,-84,-89,5,b4:b5:2f:17:0c:b9,14240073,1328,322,14238745,14240073
3511,4,1,1,2412,-88,-89,1,,14243171,304,2794,14242867,14243171
3512,6,6,1,2412,-80,-89,9,b4:e6:2d:b4:ff:71,14253109,64,9874,14253045,14253109
3513,6,6,1,2412,-81,-89,8,,14253190,44,37,14253146,14253190
3514,6,24,1,2412,-83,-89,6,,14254752,28,1534,14254724,14254752
3515,4,1,1,2412,-86,-89,3,b4:b5:2f:17:0c:b9,14260082,1328,4002,14258754,14260082
3516,4,1,1,2412,-85,-89,4,b4:b5:2f:17:0c:b9,14264200,1328,2790,14262872,14264200
3517,4,1,1,2412,-85,-89,4,b4:b5:2f:17:0c:b9,14265850,1328,322,14264522,14265850
3518,4,1,1,2412,-85,-89,4,78:67:0e:c4:a8:42,14279796,2736,11210,14277060,14279796
3519,6,6,1,2412,-80,-89,9,12:86:8c:5f:93:1e,14287104,332,6976,14286772,14287104
3520,4,1,1,2412,-85,-89,4,,14290393,304,2985,14290089,14290393
3521,4,1,1,2412,-71,-89,18,00:26:62:eb:ea:74,14292942,968,1581,14291974,14292942
3522,4,11,1,2412,-86,-89,3,4c:01:43:ec:a0:63,14295573,254,2377,14295319,14295573
3523,4,1,1,2412,-88,-89,1,,14307883,448,11862,14307435,14307883
3524,4,1,1,2412,-87,-89,2,,14308760,448,429,14308312,14308760
3525,6,6,1,2412,-81,-89,8,32:86:8c:5f:93:1e,14312704,332,3612,14312372,14312704
3526,6,6,1,2412,-76,-89,13,e2:db:d1:d1:b0:4b,14321352,408,8240,14320944,14321352
3527,6,6,1,2412,-76,-89,13,e2:db:d1:d1:b0:4d,14321793,408,33,14321385,14321793
3528,6,6,1,2412,-76,-89,13,e2:db:d1:d1:b0:4f,14322225,408,24,14321817,14322225
3529,4,1,1,2412,-84,-89,5,,14324340,304,1811,14324036,14324340
3530,4,1,1,2412,-84,-89,5,,14325590,304,946,14325286,14325590
3531,4,1,1,2412,-78,-89,11,3c:bd:c5:ee:96:6d,14331393,2512,3291,14328881,14331393
3532,6,6,1,2412,-79,-89,10,52:86:8c:5f:93:1e,14338304,332,6579,14337972,14338304
3533,4,1,1,2412,-87,-89,2,ac:67:84:84:8a:07,14341685,416,2965,14341269,14341685
3534,4,11,1,2412,-80,-89,9,48:dd:0c:7d:86:27,14343998,362,1951,14343636,14343998
3535,4,11,1,2412,-79,-89,10,48:dd:0c:7d:86:23,14344373,323,52,14344050,14344373
3536,4,11,1,2412,-80,-89,9,48:dd:0c:7d:86:25,14344708,382,-47,14344326,14344708
3537,4,1,1,2412,-84,-89,5,,14369323,304,24311,14369019,14369323
3538,6,6,1,2412,-81,-89,8,12:86:8c:5f:93:1e,14389504,332,19849,14389172,14389504
3539,4,1,1,2412,-83,-89,6,,14398473,304,8665,14398169,14398473
3540,4,1,1,2412,-78,-89,11,b0:e4:d5:32:ec:8a,14403859,1960,3426,14401899,14403859
3541,4,1,1,2412,-84,-89,5,,14421033,304,16870,14420729,14421033
3542,4,1,1,2412,-84,-89,5,b4:b5:2f:17:0c:b9,14422709,1376,300,14421333,14422709
3543,4,1,1,2412,-86,-89,3,ac:67:84:84:8a:07,14424108,416,983,14423692,14424108
3544,6,6,1,2412,-76,-89,13,e2:db:d1:d1:b0:4a,14424994,444,442,14424550,14424994
3545,6,6,1,2412,-76,-89,13,e2:db:d1:d1:b0:4b,14425471,408,69,14425063,14425471
3546,6,6,1,2412,-76,-89,13,e2:db:d1:d1:b0:4d,14425930,408,51,14425522,14425930
3547,6,6,1,2412,-76,-89,13,e2:db:d1:d1:b0:4f,14426371,408,33,14425963,14426371
3548,4,1,1,2412,-79,-89,10,3c:bd:c5:ee:96:6d,14433967,2512,5084,14431455,14433967
3549,6,6,1,2412,-80,-89,9,52:86:8c:5f:93:1e,14440705,332,6406,14440373,14440705
3550,4,11,1,2412,-79,-89,10,48:dd:0c:7d:86:27,14446398,362,5331,14446036,14446398
3551,4,11,1,2412,-78,-89,11,48:dd:0c:7d:86:23,14446773,323,52,14446450,14446773
3552,4,11,1,2412,-79,-89,10,48:dd:0c:7d:86:25,14447108,382,-47,14446726,14447108
3553,6,24,1,2412,-82,-89,7,,14453089,32,5949,14453057,14453089
3554,4,1,1,2412,-84,-89,5,,14465550,304,12157,14465246,14465550
3555,6,6,1,2412,-80,-89,9,10:86:8c:5f:93:1e,14466596,336,710,14466260,14466596
3556,4,1,1,2412,-82,-89,7,66:32:b1:64:4c:f2,14470660,2696,1368,14467964,14470660
3557,4,11,1,2412,-77,-89,12,,14481157,107,10390,14481050,14481157
3558,4,11,1,2412,-76,-89,13,48:dd:0c:90:e3:83,14482678,323,1198,14482355,14482678
3559,4,11,1,2412,-82,-89,7,48:dd:0c:90:e3:85,14483013,382,-47,14482631,14483013
3560,4,1,1,2412,-84,-89,5,,14483413,304,96,14483109,14483413
3561,4,1,1,2412,-84,-89,5,,14487369,352,3604,14487017,14487369
3562,4,1,1,2412,-84,-89,5,,14488209,352,488,14487857,14488209
3563,4,11,1,2412,-85,-89,4,,14490149,107,1833,14490042,14490149
3564,4,1,1,2412,-84,-89,5,,14490740,352,239,14490388,14490740
3565,6,6,1,2412,-81,-89,8,12:86:8c:5f:93:1e,14491905,332,833,14491573,14491905
3566,6,24,1,2412,-82,-89,7,,14505181,28,13248,14505153,14505181
3567,4,1,1,2412,-79,-89,10,b0:e4:d5:32:ec:8a,14506258,1960,-883,14504298,14506258
3568,6,24,1,2412,-81,-89,8,,14510522,28,4236,14510494,14510522
3569,4,1,1,2412,-86,-89,3,,14513415,448,2445,14512967,14513415
3570,4,1,1,2412,-86,-89,3,,14514292,448,429,14513844,14514292
3571,6,6,1,2412,-80,-89,9,32:86:8c:5f:93:1e,14517505,332,2881,14517173,14517505
3572,6,24,1,2412,-83,-89,6,,14517907,28,374,14517879,14517907
3573,6,6,1,2412,-76,-89,13,e2:db:d1:d1:b0:4b,14526022,408,7707,14525614,14526022
3574,6,6,1,2412,-76,-89,13,e2:db:d1:d1:b0:4f,14526913,408,483,14526505,14526913
3575,4,1,1,2412,-86,-89,3,ac:67:84:84:8a:07,14533621,416,6292,14533205,14533621
3576,6,6,1,2412,-81,-89,8,52:86:8c:5f:93:1e,14543105,332,9152,14542773,14543105
3577,4,11,1,2412,-79,-89,10,48:dd:0c:7d:86:27,14548798,362,5331,14548436,14548798
3578,4,11,1,2412,-79,-89,10,48:dd:0c:7d:86:23,14549172,323,51,14548849,14549172
3579,4,11,1,2412,-79,-89,10,48:dd:0c:7d:86:25,14549508,382,-46,14549126,14549508
3580,6,6,1,2412,-75,-89,14,f8:4f:ad:f9:af:82,14550998,1360,130,14549638,14550998
3581,4,1,1,2412,-90,-89,-1,10:0c:6b:2e:43:07,14564559,3496,10065,14561063,14564559
3582,4,1,1,2412,-86,-89,3,78:67:0e:38:6c:d3,14575656,2736,8361,14572920,14575656
3583,4,11,1,2412,-78,-89,11,48:dd:0c:90:e3:87,14584703,362,8685,14584341,14584703
3584,4,11,1,2412,-82,-89,7,48:dd:0c:90:e3:85,14585413,382,328,14585031,14585413
3585,4,1,1,2412,-84,-89,5,78:67:0e:c4:a8:42,14586996,2736,-1153,14584260,14586996
3586,6,24,1,2412,-83,-89,6,,14591918,28,4894,14591890,14591918
3587,6,6,1,2412,-81,-89,8,12:86:8c:5f:93:1e,14594785,332,2535,14594453,14594785
3588,4,1,1,2412,-88,-89,1,ac:67:84:84:8a:07,14597792,416,2591,14597376,14597792
3589,4,1,1,2412,-79,-89,10,b0:e4:d5:32:ec:8a,14608658,1960,8906,14606698,14608658
3590,4,1,1,2412,-87,-89,2,,14617339,448,8233,14616891,14617339
3591,6,6,1,2412,-80,-89,9,32:86:8c:5f:93:1e,14619906,332,2235,14619574,14619906
3592,6,6,1,2412,-76,-89,13,e2:db:d1:d1:b0:4b,14628224,408,7910,14627816,14628224
3593,6,6,1,2412,-75,-89,14,e2:db:d1:d1:b0:4d,14628683,408,51,14628275,14628683
3594,6,6,1,2412,-76,-89,13,e2:db:d1:d1:b0:4f,14629124,408,33,14628716,14629124
3595,6,24,1,2412,-86,-89,3,,14630185,28,1033,14630157,14630185
3596,4,1,1,2412,-88,-89,1,ce:9e:43:bc:eb:ff,14630598,3800,-3387,14626798,14630598
3597,4,1,1,2412,-88,-89,1,c8:9e:43:bc:eb:ff,14634408,3496,314,14630912,14634408
3598,4,1,1,2412,-78,-89,11,3c:bd:c5:ee:96:6d,14638748,2512,1828,14636236,14638748
3599,4,1,1,2412,-80,-89,9,b8:f8:53:cb:31:f1,14641286,976,1562,14640310,14641286
3600,6,6,1,2412,-82,-89,7,52:86:8c:5f:93:1e,14645506,332,3888,14645174,14645506
3601,6,24,1,2412,-82,-89,7,,14646911,28,1377,14646883,14646911
3602,4,11,1,2412,-80,-89,9,48:dd:0c:7d:86:27,14651198,362,3925,14650836,14651198
3603,4,11,1,2412,-80,-89,9,48:dd:0c:7d:86:23,14651572,323,51,14651249,14651572
3604,4,11,1,2412,-79,-89,10,48:dd:0c:7d:86:25,14651907,382,-47,14651525,14651907
3605,4,11,1,2412,-87,-89,2,4c:01:43:d7:f3:23,14663730,322,11501,14663408,14663730
3606,6,24,1,2412,-83,-89,6,,14670898,28,7140,14670870,14670898
3607,6,6,1,2412,-81,-89,8,10:86:8c:5f:93:1e,14673098,336,1864,14672762,14673098
3608,4,11,1,2412,-86,-89,3,4c:01:43:ec:a0:69,14681745,361,8286,14681384,14681745
3609,4,11,1,2412,-77,-89,12,48:dd:0c:90:e3:87,14687103,362,4996,14686741,14687103
3610,4,11,1,2412,-78,-89,11,48:dd:0c:90:e3:83,14687477,323,51,14687154,14687477
3611,4,11,1,2412,-81,-89,8,48:dd:0c:90:e3:85,14687812,382,-47,14687430,14687812
3612,4,1,1,2412,-84,-89,5,78:67:0e:c4:a8:42,14689395,2736,-1153,14686659,14689395
3613,6,6,1,2412,-81,-89,8,12:86:8c:5f:93:1e,14696706,332,6979,14696374,14696706
3614,4,1,1,2412,-80,-89,9,b0:e4:d5:32:ec:8a,14711057,1960,12391,14709097,14711057
3615,6,6,1,2412,-76,-89,13,e2:db:d1:d1:b0:4b,14730767,408,19302,14730359,14730767
3616,6,6,1,2412,-76,-89,13,e2:db:d1:d1:b0:4d,14731199,408,24,14730791,14731199
3617,6,6,1,2412,-76,-89,13,e2:db:d1:d1:b0:4f,14731640,408,33,14731232,14731640
3618,6,24,1,2412,-83,-89,6,,14733888,28,2220,14733860,14733888
3619,4,1,1,2412,-80,-89,9,3c:bd:c5:ee:96:6d,14740992,2512,4592,14738480,14740992
3620,6,24,1,2412,-83,-89,6,,14750329,28,9309,14750301,14750329
3621,4,11,1,2412,-79,-89,10,48:dd:0c:7d:86:27,14753597,362,2906,14753235,14753597
3622,4,11,1,2412,-80,-89,9,48:dd:0c:7d:86:23,14753972,323,52,14753649,14753972
3623,4,11,1,2412,-79,-89,10,48:dd:0c:7d:86:25,14754307,382,-47,14753925,14754307
3624,4,1,1,2412,-86,-89,3,ac:67:84:84:8a:07,14764055,416,9332,14763639,14764055
3625,4,1,1,2412,-86,-89,3,ac:67:84:84:8a:07,14764811,416,340,14764395,14764811
3626,4,1,1,2412,-86,-89,3,,14770133,304,5018,14769829,14770133
3627,4,11,1,2412,-78,-89,11,48:dd:0c:90:e3:83,14789877,323,19421,14789554,14789877
3628,4,11,1,2412,-82,-89,7,48:dd:0c:90:e3:85,14790212,382,-47,14789830,14790212
3629,4,1,1,2412,-85,-89,4,78:67:0e:c4:a8:42,14791795,2736,-1153,14789059,14791795
3630,4,1,1,2412,-85,-89,4,ac:67:84:84:8a:07,14794764,416,2553,14794348,14794764
3631,6,6,1,2412,-81,-89,8,12:86:8c:5f:93:1e,14799896,332,4800,14799564,14799896
3632,4,1,1,2412,-80,-89,9,b0:e4:d5:32:ec:8a,14813456,1960,11600,14811496,14813456
3633,4,1,1,2412,-85,-89,4,,14817545,304,3785,14817241,14817545
3634,4,1,1,2412,-85,-89,4,,14821781,448,3788,14821333,14821781
3635,4,1,1,2412,-84,-89,5,,14822667,448,438,14822219,14822667
3636,6,6,1,2412,-80,-89,9,32:86:8c:5f:93:1e,14824707,332,1708,14824375,14824707
3637,6,24,1,2412,-83,-89,6,,14825181,28,446,14825153,14825181
3638,4,1,1,2412,-84,-89,5,b4:b5:2f:17:0c:b9,14831426,1376,4869,14830050,14831426
3639,6,6,1,2412,-76,-89,13,e2:db:d1:d1:b0:4a,14832688,444,818,14832244,14832688
3640,6,6,1,2412,-76,-89,13,e2:db:d1:d1:b0:4b,14833174,408,78,14832766,14833174
3641,6,6,1,2412,-77,-89,12,e2:db:d1:d1:b0:4d,14833615,408,33,14833207,14833615
3642,6,6,1,2412,-76,-89,13,e2:db:d1:d1:b0:4f,14834064,408,41,14833656,14834064
3643,6,24,1,2412,-82,-89,7,,14837759,28,3667,14837731,14837759
3644,4,1,1,2412,-80,-89,9,3c:bd:c5:ee:96:6d,14843404,2512,3133,14840892,14843404
3645,4,1,1,2412,-72,-89,17,bc:98:df:ff:0f:8b,14846990,2568,1018,14844422,14846990
3646,6,6,1,2412,-79,-89,10,52:86:8c:5f:93:1e,14850308,332,2986,14849976,14850308
3647,4,1,1,2412,-90,-89,-1,ce:9e:43:bc:eb:ff,14851780,3800,-2328,14847980,14851780
3648,4,1,1,2412,-84,-89,5,,14862123,304,10039,14861819,14862123
3649,6,6,1,2412,-81,-89,8,10:86:8c:5f:93:1e,14875908,336,13449,14875572,14875908
3650,4,1,1,2412,-87,-89,2,ac:67:84:84:8a:07,14877995,416,1671,14877579,14877995
3651,4,11,1,2412,-83,-89,6,,14878481,107,379,14878374,14878481
3652,4,1,1,2412,-87,-89,2,ac:67:84:84:8a:07,14879344,416,447,14878928,14879344
3653,4,1,1,2412,-82,-89,7,78:67:0e:38:6c:d3,14882857,2736,777,14880121,14882857
3654,4,1,1,2412,-78,-89,11,b4:b5:2f:17:0c:b9,14889404,1328,5219,14888076,14889404
3655,4,1,1,2412,-83,-89,6,78:67:0e:c4:a8:42,14894195,2736,2055,14891459,14894195
3656,4,1,1,2412,-84,-89,5,b4:b5:2f:17:0c:b9,14897654,1328,2131,14896326,14897654
3657,4,1,1,2412,-84,-89,5,b4:b5:2f:17:0c:b9,14899341,1328,359,14898013,14899341
3658,4,1,1,2412,-86,-89,3,b4:b5:2f:17:0c:b9,14902641,1328,1972,14901313,14902641
3659,4,1,1,2412,-85,-89,4,b4:b5:2f:17:0c:b9,14904291,1328,322,14902963,14904291
3660,6,24,1,2412,-81,-89,8,,14905626,28,1307,14905598,14905626
3661,4,1,1,2412,-85,-89,4,b4:b5:2f:17:0c:b9,14907591,1328,637,14906263,14907591
3662,4,1,1,2412,-84,-89,5,78:67:0e:c4:a8:42,14908859,848,420,14908011,14908859
3663,4,1,1,2412,-82,-89,7,,14909768,352,557,14909416,14909768
3664,4,11,1,2412,-83,-89,6,,14912154,107,2279,14912047,14912154
3665,4,1,1,2412,-87,-89,2,b4:b5:2f:17:0c:b9,14912688,1328,-794,14911360,14912688
3666,4,1,1,2412,-84,-89,5,b4:b5:2f:17:0c:b9,14914338,1328,322,14913010,14914338
3667,4,1,1,2412,-78,-89,11,b0:e4:d5:32:ec:8a,14915856,1960,-442,14913896,14915856
3668,6,6,1,2412,-85,-89,4,,14918911,44,3011,14918867,14918911
3669,4,1,1,2412,-87,-89,2,b4:b5:2f:17:0c:b9,14919316,1328,-923,14917988,14919316
3670,4,1,1,2412,-87,-89,2,b4:b5:2f:17:0c:b9,14920966,1328,322,14919638,14920966
3671,4,1,1,2412,-87,-89,2,b4:b5:2f:17:0c:b9,14922616,1328,322,14921288,14922616
3672,4,1,1,2412,-86,-89,3,b4:b5:2f:17:0c:b9,14925916,1328,1972,14924588,14925916
3673,6,6,1,2412,-81,-89,8,32:86:8c:5f:93:1e,14927108,332,860,14926776,14927108
3674,4,1,1,2412,-84,-89,5,b4:b5:2f:17:0c:b9,14927566,1328,-870,14926238,14927566
3675,6,6,1,2412,-75,-89,14,e2:db:d1:d1:b0:4f,14937374,408,9400,14936966,14937374
3676,4,1,1,2412,-86,-89,3,68:54:fd:aa:49:4f,14939731,2128,229,14937603,14939731
3677,6,6,1,2412,-81,-89,8,,14943435,68,3636,14943367,14943435
3678,4,1,1,2412,-80,-89,9,3c:bd:c5:ee:96:6d,14947204,2512,1257,14944692,14947204
3679,6,6,1,2412,-83,-89,6,52:86:8c:5f:93:1e,14952708,332,5172,14952376,14952708
3680,4,1,1,2412,-87,-89,2,ac:67:84:84:8a:07,14954499,416,1375,14954083,14954499
3681,4,11,1,2412,-79,-89,10,48:dd:0c:7d:86:27,14958397,362,3536,14958035,14958397
3682,4,11,1,2412,-79,-89,10,48:dd:0c:7d:86:23,14958772,323,52,14958449,14958772
3683,4,11,1,2412,-80,-89,9,48:dd:0c:7d:86:25,14959107,382,-47,14958725,14959107
3684,4,11,1,2412,-83,-89,6,,14960141,107,927,14960034,14960141
3685,4,1,1,2412,-89,-89,0,d2:9e:43:bc:eb:ff,14962371,3600,-1370,14958771,14962371
3686,4,1,1,2412,-89,-89,0,c8:9e:43:bc:eb:ff,14965981,3496,114,14962485,14965981
3687,4,1,1,2412,-85,-89,4,,14971714,352,5381,14971362,14971714
3688,6,24,1,2412,-81,-89,8,,14973892,28,2150,14973864,14973892
3689,6,6,1,2412,-85,-89,4,,14977067,44,3131,14977023,14977067
3690,4,11,1,2412,-80,-89,9,48:dd:0c:90:e3:85,14995012,382,17563,14994630,14995012
3691,4,11,1,2412,-84,-89,5,,14996167,107,1048,14996060,14996167
3692,4,1,1,2412,-85,-89,4,78:67:0e:c4:a8:42,14996595,2736,-2308,14993859,14996595
3693,6,6,1,2412,-82,-89,7,12:86:8c:5f:93:1e,15003909,332,6982,15003577,15003909
3694,6,6,1,2412,-84,-89,5,,15007033,44,3080,15006989,15007033
3695,4,1,1,2412,-87,-89,2,ac:67:84:84:8a:07,15007466,416,17,15007050,15007466
3696,4,1,1,2412,-86,-89,3,,15027365,448,19451,15026917,15027365
3697,4,1,1,2412,-84,-89,5,b4:b5:2f:17:0c:b9,15036230,1376,7489,15034854,15036230
3698,6,6,1,2412,-76,-89,13,e2:db:d1:d1:b0:4a,15037530,444,856,15037086,15037530
3699,6,6,1,2412,-76,-89,13,e2:db:d1:d1:b0:4b,15038025,408,87,15037617,15038025
3700,6,6,1,2412,-76,-89,13,e2:db:d1:d1:b0:4d,15038466,408,33,15038058,15038466
3701,6,6,1,2412,-74,-89,15,e2:db:d1:d1:b0:4f,15038925,408,51,15038517,15038925
3702,4,1,1,2412,-79,-89,10,3c:bd:c5:ee:96:6d,15048200,2512,6763,15045688,15048200
3703,6,6,1,2412,-80,-89,9,52:86:8c:5f:93:1e,15055109,332,6577,15054777,15055109
3704,4,11,1,2412,-79,-89,10,48:dd:0c:7d:86:27,15060797,362,5326,15060435,15060797
3705,4,11,1,2412,-80,-89,9,48:dd:0c:7d:86:23,15061171,323,51,15060848,15061171
3706,4,11,1,2412,-80,-89,9,48:dd:0c:7d:86:25,15061506,382,-47,15061124,15061506
3707,4,1,1,2412,-88,-89,1,ac:67:84:84:8a:07,15062227,416,305,15061811,15062227
3708,4,1,1,2412,-90,-89,-1,,15062655,304,124,15062351,15062655
3709,6,24,1,2412,-83,-89,6,,15071243,28,8560,15071215,15071243
3710,6,6,1,2412,-82,-89,7,10:86:8c:5f:93:1e,15080709,336,9130,15080373,15080709
3711,6,24,1,2412,-82,-89,7,,15084045,32,3304,15084013,15084045
3712,4,1,1,2412,-88,-89,1,ac:67:84:84:8a:07,15084429,416,-32,15084013,15084429
3713,4,1,1,2412,-86,-89,3,78:67:0e:38:6c:d3,15087657,2736,492,15084921,15087657
3714,6,6,1,2412,-82,-89,7,,15090948,68,3223,15090880,15090948
3715,4,11,1,2412,-78,-89,11,48:dd:0c:90:e3:83,15097076,323,5805,15096753,15097076
3716,4,11,1,2412,-86,-89,3,,15102856,203,5577,15102653,15102856
3717,4,11,1,2412,-84,-89,5,,15103628,107,665,15103521,15103628
3718,4,1,1,2412,-85,-89,4,,15104222,352,242,15103870,15104222
3719,6,6,1,2412,-81,-89,8,12:86:8c:5f:93:1e,15106310,332,1756,15105978,15106310
3720,4,1,1,2412,-77,-89,12,b0:e4:d5:32:ec:8a,15120654,1960,12384,15118694,15120654
3721,4,1,1,2412,-88,-89,1,ac:67:84:84:8a:07,15127372,416,6302,15126956,15127372
3722,6,6,1,2412,-81,-89,8,32:86:8c:5f:93:1e,15132013,332,4309,15131681,15132013
3723,6,24,1,2412,-82,-89,7,,15133894,28,1853,15133866,15133894
3724,4,1,1,2412,-84,-89,5,b4:b5:2f:17:0c:b9,15138632,1376,3362,15137256,15138632
3725,6,6,1,2412,-76,-89,13,e2:db:d1:d1:b0:4a,15139920,444,844,15139476,15139920
3726,6,6,1,2412,-76,-89,13,e2:db:d1:d1:b0:4b,15140415,408,87,15140007,15140415
3727,6,6,1,2412,-76,-89,13,e2:db:d1:d1:b0:4d,15140856,408,33,15140448,15140856
3728,6,6,1,2412,-76,-89,13,e2:db:d1:d1:b0:4f,15141287,408,23,15140879,15141287
3729,6,24,1,2412,-83,-89,6,,15145187,28,3872,15145159,15145187
3730,6,6,1,2412,-76,-89,13,b2:e2:49:f6:8a:4e,15145324,308,-171,15145016,15145324
3731,4,1,1,2412,-88,-89,1,ac:67:84:84:8a:07,15150272,416,4532,15149856,15150272
3732,4,1,1,2412,-78,-89,11,3c:bd:c5:ee:96:6d,15150808,2512,-1976,15148296,15150808
3733,4,1,1,2412,-88,-89,1,bc:98:df:ff:0f:8b,15154186,2568,810,15151618,15154186
3734,6,6,1,2412,-80,-89,9,52:86:8c:5f:93:1e,15157510,332,2992,15157178,15157510
3735,4,1,1,2412,-82,-89,7,,15176744,304,18930,15176440,15176744
3736,4,1,1,2412,-90,-89,-1,7a:a2:22:ca:52:27,15182281,2168,3369,15180113,15182281
3737,6,6,1,2412,-80,-89,9,10:86:8c:5f:93:1e,15185067,336,2450,15184731,15185067
3738,4,1,1,2412,-84,-89,5,78:67:0e:38:6c:d3,15190057,2736,2254,15187321,15190057
3739,4,1,1,2412,-85,-89,4,78:67:0e:38:6c:d3,15192849,848,1944,15192001,15192849
3740,4,1,1,2412,-84,-89,5,3c:bd:c5:ad:f6:9e,15193708,1056,-197,15192652,15193708
3741,6,6,1,2412,-75,-89,14,e0:db:d1:d0:b0:48,15202733,156,8869,15202577,15202733
3742,4,1,1,2412,-83,-89,6,ac:67:84:84:8a:07,15207240,416,4091,15206824,15207240
3743,6,6,1,2412,-81,-89,8,12:86:8c:5f:93:1e,15208755,332,1183,15208423,15208755
3744,6,6,1,2412,-77,-89,12,f8:4f:ad:f9:af:82,15214712,196,5761,15214516,15214712
3745,6,6,1,2412,-76,-89,13,f8:4f:ad:f9:af:82,15216479,156,1611,15216323,15216479
3746,4,1,1,2412,-85,-89,4,78:67:0e:c4:a8:41,15217273,1888,-1094,15215385,15217273
3747,4,1,1,2412,-85,-89,4,,15219612,304,2035,15219308,15219612
3748,4,1,1,2412,-86,-89,3,b4:b5:2f:17:0c:b9,15220438,1328,-502,15219110,15220438
3749,4,11,1,2412,-78,-89,11,48:dd:0c:7d:86:25,15221761,377,946,15221384,15221761
3750,4,1,1,2412,-79,-89,10,b0:e4:d5:32:ec:8a,15223468,1960,-253,15221508,15223468
3751,4,1,1,2412,-86,-89,3,b4:b5:2f:17:0c:b9,15225388,1328,592,15224060,15225388
3752,4,1,1,2412,-88,-89,1,b4:b5:2f:17:0c:b9,15227038,1328,322,15225710,15227038
3753,4,1,1,2412,-87,-89,2,b4:b5:2f:17:0c:b9,15228688,1328,322,15227360,15228688
3754,4,1,1,2412,-86,-89,3,b4:b5:2f:17:0c:b9,15230338,1328,322,15229010,15230338
3755,4,1,1,2412,-83,-89,6,,15239517,304,8875,15239213,15239517
3756,4,1,1,2412,-86,-89,3,,15240272,304,451,15239968,15240272
3757,6,6,1,2412,-76,-89,13,e2:db:d1:d1:b0:4a,15242307,444,1591,15241863,15242307
3758,6,6,1,2412,-77,-89,12,e2:db:d1:d1:b0:4b,15242802,408,87,15242394,15242802
3759,6,6,1,2412,-75,-89,14,e2:db:d1:d1:b0:4f,15243701,408,491,15243293,15243701
3760,4,1,1,2412,-79,-89,10,3c:bd:c5:ee:96:6d,15253964,2512,7751,15251452,15253964
3761,6,6,1,2412,-82,-89,7,52:86:8c:5f:93:1e,15259910,332,5614,15259578,15259910
3762,4,11,1,2412,-80,-89,9,48:dd:0c:7d:86:27,15265597,362,5325,15265235,15265597
3763,4,11,1,2412,-80,-89,9,48:dd:0c:7d:86:23,15265972,323,52,15265649,15265972
3764,4,11,1,2412,-79,-89,10,48:dd:0c:7d:86:25,15266307,382,-47,15265925,15266307
3765,4,1,1,2412,-85,-89,4,,15274511,304,7900,15274207,15274511
3766,4,1,1,2412,-87,-89,2,,15275997,304,1182,15275693,15275997
3767,4,1,1,2412,-85,-89,4,78:67:0e:c4:a8:41,15276889,832,60,15276057,15276889
3768,4,11,1,2412,-84,-89,5,,15279522,107,2526,15279415,15279522
3769,4,1,1,2412,-85,-89,4,,15280112,352,238,15279760,15280112
3770,6,6,1,2412,-76,-89,13,f8:4f:ad:f9:af:82,15287361,248,7001,15287113,15287361
3771,4,1,1,2412,-87,-89,2,,15288314,304,649,15288010,15288314
3772,6,6,1,2412,-77,-89,12,f8:4f:ad:f9:af:82,15288601,224,63,15288377,15288601
3773,6,24,1,2412,-83,-89,6,,15295093,28,6464,15295065,15295093
3774,4,11,1,2412,-86,-89,3,4c:01:43:ec:a0:63,15296512,322,1097,15296190,15296512
3775,4,1,1,2412,-85,-89,4,b4:b5:2f:17:0c:b9,15308906,1328,11066,15307578,15308906
3776,4,1,1,2412,-85,-89,4,b4:b5:2f:17:0c:b9,15312205,1328,1971,15310877,15312205
3777,4,1,1,2412,-85,-89,4,b4:b5:2f:17:0c:b9,15313855,1328,322,15312527,15313855
3778,4,1,1,2412,-85,-89,4,b4:b5:2f:17:0c:b9,15315530,1328,347,15314202,15315530
3779,4,1,1,2412,-86,-89,3,b4:b5:2f:17:0c:b9,15317180,1328,322,15315852,15317180
3780,4,1,1,2412,-77,-89,12,b0:e4:d5:32:ec:8a,15325453,1960,6313,15323493,15325453
3781,4,1,1,2412,-85,-89,4,38:01:46:30:1a:ca,15333873,416,8004,15333457,15333873
3782,4,1,1,2412,-88,-89,1,,15335746,448,1425,15335298,15335746
3783,4,1,1,2412,-87,-89,2,,15336641,448,447,15336193,15336641
3784,6,6,1,2412,-87,-89,2,,15338107,44,1422,15338063,15338107
3785,6,6,1,2412,-76,-89,13,e2:db:d1:d1:b0:4a,15344739,444,6188,15344295,15344739
3786,6,6,1,2412,-76,-89,13,e2:db:d1:d1:b0:4b,15345207,408,60,15344799,15345207
3787,6,6,1,2412,-76,-89,13,e2:db:d1:d1:b0:4d,15345665,408,50,15345257,15345665
3788,6,6,1,2412,-76,-89,13,e2:db:d1:d1:b0:4f,15346097,408,24,15345689,15346097
3789,4,1,1,2412,-80,-89,9,3c:bd:c5:ee:96:6d,15355392,2512,6783,15352880,15355392
3790,6,6,1,2412,-80,-89,9,52:86:8c:5f:93:1e,15362311,332,6587,15361979,15362311
3791,4,11,1,2412,-80,-89,9,48:dd:0c:7d:86:27,15367997,362,5324,15367635,15367997
3792,4,11,1,2412,-81,-89,8,48:dd:0c:7d:86:23,15368372,323,52,15368049,15368372
3793,4,11,1,2412,-80,-89,9,48:dd:0c:7d:86:25,15368707,382,-47,15368325,15368707
3794,6,24,1,2412,-83,-89,6,,15373894,28,5159,15373866,15373894
3795,4,1,1,2412,-87,-89,2,38:01:46:30:1a:ca,15377300,416,2990,15376884,15377300
3796,4,1,1,2412,-90,-89,-1,0e:b9:49:67:a0:d6,15383212,416,5496,15382796,15383212
3797,4,1,1,2412,-87,-89,2,,15384622,448,962,15384174,15384622
3798,6,6,1,2412,-84,-89,5,,15386228,44,1562,15386184,15386228
3799,6,6,1,2412,-80,-89,9,10:86:8c:5f:93:1e,15387912,336,1348,15387576,15387912
3800,4,11,1,2412,-83,-89,6,00:d4:9e:83:a2:07,15388447,397,138,15388050,15388447
3801,6,6,1,2412,-79,-89,10,b4:e6:2d:b4:ff:71,15389889,64,1378,15389825,15389889
3802,6,6,1,2412,-81,-89,8,,15389969,44,36,15389925,15389969
3803,4,1,1,2412,-82,-89,7,66:32:b1:64:4c:f2,15391663,2696,-1002,15388967,15391663
3804,4,1,1,2412,-86,-89,3,78:67:0e:38:6c:d3,15394857,2736,458,15392121,15394857
3805,4,1,1,2412,-84,-89,5,78:67:0e:c4:a8:42,15406194,2736,8601,15403458,15406194
3806,6,6,1,2412,-80,-89,9,12:86:8c:5f:93:1e,15413512,332,6986,15413180,15413512
3807,6,6,1,2412,-76,-89,13,f8:4f:ad:f9:af:82,15425130,156,11462,15424974,15425130
3808,4,1,1,2412,-78,-89,11,b0:e4:d5:32:ec:8a,15427852,1960,762,15425892,15427852
3809,4,1,1,2412,-88,-89,1,ac:67:84:84:8a:07,15431129,416,2861,15430713,15431129
3810,4,1,1,2412,-86,-89,3,,15438502,448,6925,15438054,15438502
3811,6,6,1,2412,-81,-89,8,32:86:8c:5f:93:1e,15439112,332,278,15438780,15439112
3812,4,11,1,2412,-80,-89,9,48:dd:0c:7d:86:23,15441873,254,2507,15441619,15441873
3813,4,11,1,2412,-82,-89,7,48:dd:0c:90:e3:83,15442176,254,49,15441922,15442176
3814,6,6,1,2412,-76,-89,13,e2:db:d1:d1:b0:4a,15447106,444,4486,15446662,15447106
3815,6,6,1,2412,-75,-89,14,e2:db:d1:d1:b0:4b,15447574,408,60,15447166,15447574
3816,6,6,1,2412,-76,-89,13,e2:db:d1:d1:b0:4d,15448006,408,24,15447598,15448006
3817,4,1,1,2412,-86,-89,3,38:01:46:30:1a:ca,15460465,848,11611,15459617,15460465
3818,4,1,1,2412,-86,-89,3,bc:98:df:ff:0f:8b,15461360,2568,-1673,15458792,15461360
3819,4,1,1,2412,-87,-89,2,bc:98:df:ff:0f:8a,15463957,840,1757,15463117,15463957
3820,6,6,1,2412,-80,-89,9,52:86:8c:5f:93:1e,15465463,332,1174,15465131,15465463
3821,6,24,1,2412,-82,-89,7,,15470162,28,4671,15470134,15470162
3822,4,11,1,2412,-79,-89,10,48:dd:0c:7d:86:27,15470397,362,-127,15470035,15470397
3823,4,11,1,2412,-79,-89,10,48:dd:0c:7d:86:23,15470771,323,51,15470448,15470771
3824,4,11,1,2412,-78,-89,11,48:dd:0c:7d:86:25,15471107,382,-46,15470725,15471107
3825,4,11,1,2412,-88,-89,1,4c:01:43:d7:f3:26,15483260,387,11766,15482873,15483260
3826,4,1,1,2412,-88,-89,1,78:67:0e:38:6c:d3,15497446,2736,11450,15494710,15497446
3827,4,1,1,2412,-86,-89,3,7c:f6:66:c4:c4:3a,15501081,2208,1427,15498873,15501081
3828,4,11,1,2412,-76,-89,13,48:dd:0c:90:e3:87,15506301,362,4858,15505939,15506301
3829,4,11,1,2412,-78,-89,11,48:dd:0c:90:e3:83,15506675,323,51,15506352,15506675
3830,4,11,1,2412,-84,-89,5,48:dd:0c:90:e3:85,15507010,382,-47,15506628,15507010
3831,4,1,1,2412,-85,-89,4,78:67:0e:c4:a8:42,15508594,2736,-1152,15505858,15508594
3832,4,1,1,2412,-78,-89,11,b0:e4:d5:32:ec:8a,15530252,1960,19698,15528292,15530252
3833,6,24,1,2412,-83,-89,6,,15533902,28,3622,15533874,15533902
3834,4,1,1,2412,-86,-89,3,,15542184,448,7834,15541736,15542184
3835,6,6,1,2412,-76,-89,13,e2:db:d1:d1:b0:4a,15549510,444,6882,15549066,15549510
3836,6,6,1,2412,-76,-89,13,e2:db:d1:d1:b0:4b,15549996,408,78,15549588,15549996
3837,6,6,1,2412,-76,-89,13,e2:db:d1:d1:b0:4d,15550455,408,51,15550047,15550455
3838,6,6,1,2412,-76,-89,13,e2:db:d1:d1:b0:4f,15550905,408,42,15550497,15550905
3839,6,24,1,2412,-83,-89,6,,15551367,28,434,15551339,15551367
3840,4,1,1,2412,-85,-89,4,ac:67:84:84:8a:07,15557189,416,5406,15556773,15557189
3841,4,1,1,2412,-80,-89,9,3c:bd:c5:ee:96:6d,15560190,2512,489,15557678,15560190
3842,4,1,1,2412,-86,-89,3,bc:98:df:ff:0f:8b,15563761,2568,1003,15561193,15563761
3843,6,6,1,2412,-81,-89,8,52:86:8c:5f:93:1e,15567113,332,3020,15566781,15567113
3844,4,11,1,2412,-80,-89,9,48:dd:0c:7d:86:27,15572797,362,5322,15572435,15572797
3845,4,11,1,2412,-80,-89,9,48:dd:0c:7d:86:23,15573171,323,51,15572848,15573171
3846,4,11,1,2412,-79,-89,10,48:dd:0c:7d:86:25,15573506,382,-47,15573124,15573506
3847,6,6,1,2412,-80,-89,9,b4:e6:2d:b4:ff:71,15573767,64,197,15573703,15573767
3848,6,6,1,2412,-80,-89,9,,15573847,44,36,15573803,15573847
3849,4,1,1,2412,-74,-89,15,60:b7:6e:d3:6c:f6,15576762,2152,763,15574610,15576762
3850,4,1,1,2412,-87,-89,2,ac:67:84:84:8a:07,15581230,416,4052,15580814,15581230
3851,6,24,1,2412,-84,-89,5,0e:b9:49:67:a0:d6,15584364,32,3102,15584332,15584364
3852,4,1,1,2412,-81,-89,8,66:32:b1:64:4c:f2,15596330,2696,9270,15593634,15596330
3853,4,1,1,2412,-87,-89,2,78:67:0e:38:6c:d3,15599658,2736,592,15596922,15599658
3854,4,11,1,2412,-87,-89,2,4c:01:43:ec:a0:66,15604043,387,3998,15603656,15604043
3855,4,11,1,2412,-75,-89,14,48:dd:0c:90:e3:83,15609075,323,4709,15608752,15609075
3856,4,11,1,2412,-82,-89,7,48:dd:0c:90:e3:85,15609410,382,-47,15609028,15609410
3857,4,1,1,2412,-85,-89,4,78:67:0e:c4:a8:42,15610994,2736,-1152,15608258,15610994
3858,6,6,1,2412,-80,-89,9,12:86:8c:5f:93:1e,15618841,332,7515,15618509,15618841
3859,4,1,1,2412,-87,-89,2,0e:b9:49:67:a0:d6,15620370,416,1113,15619954,15620370
3860,4,11,1,2412,-79,-89,10,48:dd:0c:7d:86:23,15624793,254,4169,15624539,15624793
3861,4,1,1,2412,-87,-89,2,,15626197,304,1100,15625893,15626197
3862,4,1,1,2412,-87,-89,2,ac:67:84:84:8a:07,15645874,416,19261,15645458,15645874
3863,4,1,1,2412,-88,-89,1,,15647042,448,720,15646594,15647042
3864,6,6,1,2412,-77,-89,12,e2:db:d1:d1:b0:4a,15652055,444,4569,15651611,15652055
3865,6,6,1,2412,-75,-89,14,e2:db:d1:d1:b0:4b,15652541,408,78,15652133,15652541
3866,6,6,1,2412,-76,-89,13,e2:db:d1:d1:b0:4f,15653423,408,474,15653015,15653423
3867,4,1,1,2412,-80,-89,9,3c:bd:c5:ee:96:6d,15662610,2512,6675,15660098,15662610
3868,4,1,1,2412,-85,-89,4,ac:67:84:84:8a:07,15669220,416,6194,15668804,15669220
3869,6,6,1,2412,-80,-89,9,52:86:8c:5f:93:1e,15669816,332,264,15669484,15669816
3870,4,1,1,2412,-84,-89,5,,15688497,304,18377,15688193,15688497
3871,4,11,1,2412,-86,-89,3,,15688922,107,318,15688815,15688922
3872,4,1,1,2412,-89,-89,0,d2:9e:43:bc:eb:ff,15696512,3552,4038,15692960,15696512
3873,4,11,1,2412,-84,-89,5,48:dd:0c:90:e3:85,15711810,382,14916,15711428,15711810
3874,4,1,1,2412,-84,-89,5,78:67:0e:c4:a8:42,15713394,2736,-1152,15710658,15713394
3875,6,24,1,2412,-81,-89,8,,15717776,28,4354,15717748,15717776
3876,6,6,1,2412,-80,-89,9,12:86:8c:5f:93:1e,15720714,332,2606,15720382,15720714
3877,4,1,1,2412,-87,-89,2,ac:67:84:84:8a:07,15724176,416,3046,15723760,15724176
3878,4,11,1,2412,-84,-89,5,,15725346,107,1063,15725239,15725346
3879,4,1,1,2412,-85,-89,4,,15726124,304,474,15725820,15726124
3880,4,1,1,2412,-83,-89,6,,15728120,352,1644,15727768,15728120
3881,4,1,1,2412,-79,-89,10,b0:e4:d5:32:ec:8a,15735050,1960,4970,15733090,15735050
3882,6,6,1,2412,-80,-89,9,32:86:8c:5f:93:1e,15746314,332,10932,15745982,15746314
3883,4,1,1,2412,-86,-89,3,b4:b5:2f:17:0c:b9,15753042,1376,5352,15751666,15753042
3884,6,6,1,2412,-76,-89,13,e2:db:d1:d1:b0:4b,15754743,408,1293,15754335,15754743
3885,6,6,1,2412,-77,-89,12,e2:db:d1:d1:b0:4d,15755174,408,23,15754766,15755174
3886,6,6,1,2412,-76,-89,13,e2:db:d1:d1:b0:4f,15755634,408,52,15755226,15755634
3887,4,1,1,2412,-91,-89,-2,ce:f4:11:65:3f:f8,15756983,2072,-723,15754911,15756983
3888,4,1,1,2412,-80,-89,9,3c:bd:c5:ee:96:6d,15765014,2512,5519,15762502,15765014
3889,4,1,1,2412,-88,-89,1,bc:98:df:ff:0f:8b,15768575,2568,993,15766007,15768575
3890,6,6,1,2412,-80,-89,9,52:86:8c:5f:93:1e,15771914,332,3007,15771582,15771914
3891,6,24,1,2412,-82,-89,7,,15773900,28,1958,15773872,15773900
3892,4,11,1,2412,-80,-89,9,48:dd:0c:7d:86:27,15777596,362,3334,15777234,15777596
3893,4,11,1,2412,-80,-89,9,48:dd:0c:7d:86:23,15777971,323,52,15777648,15777971
3894,4,11,1,2412,-80,-89,9,48:dd:0c:7d:86:25,15778306,382,-47,15777924,15778306
3895,4,1,1,2412,-87,-89,2,78:67:0e:38:6c:d3,15804458,2736,23416,15801722,15804458
3896,4,11,1,2412,-77,-89,12,48:dd:0c:90:e3:83,15813874,323,9093,15813551,15813874
3897,6,6,1,2412,-87,-89,2,,15820047,44,6129,15820003,15820047
3898,6,6,1,2412,-81,-89,8,12:86:8c:5f:93:1e,15823115,332,2736,15822783,15823115
3899,6,6,1,2412,-85,-89,4,,15826296,44,3137,15826252,15826296
3900,4,1,1,2412,-79,-89,10,b0:e4:d5:32:ec:8a,15837450,1960,9194,15835490,15837450
3901,4,1,1,2412,-74,-89,15,,15850538,448,12640,15850090,15850538
3902,6,6,1,2412,-76,-89,13,e2:db:d1:d1:b0:4a,15856695,444,5713,15856251,15856695
3903,6,6,1,2412,-76,-89,13,e2:db:d1:d1:b0:4b,15857162,408,59,15856754,15857162
3904,6,6,1,2412,-76,-89,13,e2:db:d1:d1:b0:4d,15857594,408,24,15857186,15857594
3905,4,1,1,2412,-80,-89,9,3c:bd:c5:ee:96:6d,15867609,2512,7503,15865097,15867609
3906,4,1,1,2412,-86,-89,3,ac:67:84:84:8a:07,15873677,416,5652,15873261,15873677
3907,6,6,1,2412,-80,-89,9,52:86:8c:5f:93:1e,15874315,332,306,15873983,15874315
3908,6,24,1,2412,-82,-89,7,,15878732,28,4389,15878704,15878732
3909,4,11,1,2412,-80,-89,9,48:dd:0c:7d:86:27,15879996,362,902,15879634,15879996
3910,4,11,1,2412,-80,-89,9,48:dd:0c:7d:86:23,15880370,323,51,15880047,15880370
3911,4,11,1,2412,-80,-89,9,48:dd:0c:7d:86:25,15880706,382,-46,15880324,15880706
3912,4,1,1,2412,-87,-89,2,ac:67:84:84:8a:07,15894195,416,13073,15893779,15894195
3913,6,24,1,2412,-82,-89,7,,15898949,28,4726,15898921,15898949
3914,4,1,1,2412,-86,-89,3,78:67:0e:38:6c:d3,15906858,2736,5173,15904122,15906858
3915,4,11,1,2412,-85,-89,4,4c:01:43:ec:a0:66,15911239,387,3994,15910852,15911239
3916,4,11,1,2412,-83,-89,6,48:dd:0c:90:e3:85,15916609,382,4988,15916227,15916609
3917,4,1,1,2412,-84,-89,5,78:67:0e:c4:a8:42,15918193,2736,-1152,15915457,15918193
3918,6,6,1,2412,-81,-89,8,12:86:8c:5f:93:1e,15925515,332,6990,15925183,15925515
3919,6,24,1,2412,-83,-89,6,,15928222,28,2679,15928194,15928222
3920,4,1,1,2412,-85,-89,4,ac:67:84:84:8a:07,15932506,416,3868,15932090,15932506
3921,4,1,1,2412,-88,-89,1,,15932934,304,124,15932630,15932934
3922,4,1,1,2412,-87,-89,2,ac:67:84:84:8a:07,15933559,416,209,15933143,15933559
3923,4,1,1,2412,-89,-89,0,,15933987,304,124,15933683,15933987
3924,4,1,1,2412,-79,-89,10,b0:e4:d5:32:ec:8a,15939849,1960,3902,15937889,15939849
3925,6,24,1,2412,-82,-89,7,,15945205,28,5328,15945177,15945205
3926,6,24,1,2412,-82,-89,7,,15951517,28,6284,15951489,15951517
3927,4,1,1,2412,-87,-89,2,,15952451,448,486,15952003,15952451
3928,6,6,1,2412,-76,-89,13,f8:4f:ad:f9:af:82,15953803,576,776,15953227,15953803
3929,4,1,1,2412,-84,-89,5,,15957147,448,2896,15956699,15957147
3930,4,1,1,2412,-84,-89,5,b4:b5:2f:17:0c:b9,15957846,1376,-677,15956470,15957846
3931,4,1,1,2412,-80,-89,9,3c:bd:c5:ee:96:6d,15970654,2512,10296,15968142,15970654
3932,4,1,1,2412,-89,-89,0,bc:98:df:ff:0f:8b,15973376,2568,154,15970808,15973376
3933,6,6,1,2412,-79,-89,10,52:86:8c:5f:93:1e,15976716,332,3008,15976384,15976716
3934,4,11,1,2412,-80,-89,9,48:dd:0c:7d:86:27,15982396,362,5318,15982034,15982396
3935,4,11,1,2412,-79,-89,10,48:dd:0c:7d:86:23,15982770,323,51,15982447,15982770
3936,4,11,1,2412,-80,-89,9,48:dd:0c:7d:86:25,15983105,382,-47,15982723,15983105
3937,4,11,1,2412,-91,-89,-2,4c:01:43:d7:f3:29,15994550,361,11084,15994189,15994550
3938,4,11,1,2412,-83,-88,5,48:dd:0c:90:e3:85,16019009,382,24077,16018627,16019009
3939,6,6,1,2412,-81,-88,7,12:86:8c:5f:93:1e,16027916,332,8575,16027584,16027916
3940,6,24,1,2412,-81,-88,7,,16030192,28,2248,16030164,16030192
3941,6,24,1,2412,-83,-88,5,,16037777,28,7557,16037749,16037777
3942,4,1,1,2412,-87,-88,1,,16039317,304,1236,16039013,16039317
3943,4,1,1,2412,-79,-88,9,b0:e4:d5:32:ec:8a,16042248,1960,971,16040288,16042248
3944,6,6,1,2412,-80,-88,8,32:86:8c:5f:93:1e,16053516,332,10936,16053184,16053516
3945,4,1,1,2412,-86,-88,2,b4:b5:2f:17:0c:b9,16060248,1376,5356,16058872,16060248
3946,6,6,1,2412,-76,-88,12,e2:db:d1:d1:b0:4a,16061507,444,815,16061063,16061507
3947,6,6,1,2412,-77,-88,11,e2:db:d1:d1:b0:4b,16061984,408,69,16061576,16061984
3948,6,6,1,2412,-77,-88,11,e2:db:d1:d1:b0:4d,16062425,408,33,16062017,16062425
3949,6,6,1,2412,-77,-88,11,e2:db:d1:d1:b0:4f,16062857,408,24,16062449,16062857
3950,4,1,1,2412,-79,-88,9,,16071828,352,8619,16071476,16071828
3951,4,1,1,2412,-78,-88,10,3c:bd:c5:ee:96:6d,16072336,2512,-2004,16069824,16072336
3952,4,1,1,2412,-84,-88,4,,16075735,304,3095,16075431,16075735
3953,4,1,1,2412,-88,-88,0,,16076787,304,748,16076483,16076787
3954,4,1,1,2412,-84,-88,4,,16078199,352,1060,16077847,16078199
3955,6,6,1,2412,-80,-88,8,52:86:8c:5f:93:1e,16079117,332,586,16078785,16079117
3956,4,11,1,2412,-86,-88,2,,16083007,107,3783,16082900,16083007
3957,4,11,1,2412,-85,-88,3,,16083659,107,545,16083552,16083659
3958,4,11,1,2412,-82,-88,6,,16084310,107,544,16084203,16084310
3959,4,11,1,2412,-80,-88,8,48:dd:0c:7d:86:27,16084795,362,123,16084433,16084795
3960,4,11,1,2412,-81,-88,7,48:dd:0c:7d:86:23,16085170,323,52,16084847,16085170
3961,4,11,1,2412,-78,-88,10,48:dd:0c:7d:86:25,16085505,382,-47,16085123,16085505
3962,4,11,1,2412,-85,-88,3,,16089730,107,4118,16089623,16089730
3963,4,1,1,2412,-85,-88,3,,16090294,352,212,16089942,16090294
3964,4,11,1,2412,-85,-88,3,,16092167,107,1766,16092060,16092167
3965,6,24,1,2412,-82,-88,6,,16095539,28,3344,16095511,16095539
3966,6,6,1,2412,-80,-88,8,10:86:8c:5f:93:1e,16104746,336,8871,16104410,16104746
3967,4,1,1,2412,-83,-88,5,66:32:b1:64:4c:f2,16107998,2696,556,16105302,16107998
3968,4,1,1,2412,-86,-88,2,78:67:0e:38:6c:d3,16111658,2736,924,16108922,16111658
3969,4,1,1,2412,-87,-88,1,7c:f6:66:d3:26:e0,16114450,2208,584,16112242,16114450
3970,4,1,1,2412,-83,-88,5,78:67:0e:c4:a8:42,16127818,3472,9896,16124346,16127818
3971,6,6,1,2412,-81,-88,7,12:86:8c:5f:93:1e,16131461,332,3311,16131129,16131461
3972,4,1,1,2412,-86,-88,2,78:67:0e:c4:a8:42,16134602,3472,-331,16131130,16134602
3973,4,1,1,2412,-83,-88,5,78:67:0e:c4:a8:42,16138846,3472,772,16135374,16138846
3974,4,1,1,2412,-77,-88,11,b0:e4:d5:32:ec:8a,16144648,1960,3842,16142688,16144648
3975,6,6,1,2412,-86,-88,2,,16151919,44,7227,16151875,16151919
3976,6,6,1,2412,-81,-88,7,32:86:8c:5f:93:1e,16155917,332,3666,16155585,16155917
3977,4,1,1,2412,-90,-88,-2,,16157595,384,1294,16157211,16157595
3978,4,1,1,2412,-88,-88,0,,16157993,448,-50,16157545,16157993
3979,4,1,1,2412,-86,-88,2,,16158879,448,438,16158431,16158879
3980,4,1,1,2412,-78,-88,10,3c:bd:c5:ee:96:6d,16174825,2512,13434,16172313,16174825
3981,4,1,1,2412,-87,-88,1,c8:9e:43:bc:eb:ff,16182683,3496,4362,16179187,16182683
3982,4,11,1,2412,-81,-88,7,48:dd:0c:7d:86:27,16187195,362,4150,16186833,16187195
3983,4,11,1,2412,-79,-88,9,48:dd:0c:7d:86:23,16187570,323,52,16187247,16187570
3984,4,11,1,2412,-80,-88,8,48:dd:0c:7d:86:25,16187905,382,-47,16187523,16187905
3985,6,24,1,2412,-82,-88,6,,16190192,28,2259,16190164,16190192
3986,6,6,1,2412,-85,-88,3,,16191564,44,1328,16191520,16191564
3987,6,6,1,2412,-84,-88,4,,16191810,44,202,16191766,16191810
3988,4,1,1,2412,-86,-88,2,,16192911,304,797,16192607,16192911
3989,6,24,1,2412,-82,-88,6,,16197816,28,4877,16197788,16197816
3990,6,6,1,2412,-76,-88,12,f8:4f:ad:f9:af:82,16203943,576,5551,16203367,16203943
3991,6,6,1,2412,-76,-88,12,f8:4f:ad:f9:af:82,16204552,656,-47,16203896,16204552
3992,6,6,1,2412,-77,-88,11,f8:4f:ad:f9:af:82,16205867,548,767,16205319,16205867
3993,4,1,1,2412,-86,-88,2,78:67:0e:38:6c:d3,16214058,2736,5455,16211322,16214058
3994,4,11,1,2412,-83,-88,5,48:dd:0c:90:e3:85,16223809,382,9369,16223427,16223809
3995,4,1,1,2412,-83,-88,5,,16224501,304,388,16224197,16224501
3996,4,1,1,2412,-84,-88,4,78:67:0e:c4:a8:42,16225393,2736,-1844,16222657,16225393
3997,4,1,1,2412,-80,-88,8,b0:e4:d5:32:ec:8a,16247047,1960,19694,16245087,16247047
3998,6,24,1,2412,-83,-88,5,,16253902,28,6827,16253874,16253902
3999,6,6,1,2412,-80,-88,8,32:86:8c:5f:93:1e,16258318,332,4084,16257986,16258318
4000,4,1,1,2412,-84,-88,4,b4:b5:2f:17:0c:b9,16265051,1376,5357,16263675,16265051
4001,6,6,1,2412,-75,-88,13,e2:db:d1:d1:b0:4a,16266293,444,798,16265849,16266293
4002,6,6,1,2412,-77,-88,11,e2:db:d1:d1:b0:4b,16266788,408,87,16266380,16266788
4003,6,6,1,2412,-77,-88,11,e2:db:d1:d1:b0:4d,16267238,408,42,16266830,16267238
4004,6,6,1,2412,-77,-88,11,e2:db:d1:d1:b0:4f,16267669,408,23,16267261,16267669
4005,4,1,1,2412,-84,-88,4,,16269086,304,1113,16268782,16269086
4006,6,6,1,2412,-80,-88,8,52:86:8c:5f:93:1e,16283918,332,14500,16283586,16283918
4007,4,11,1,2412,-79,-88,9,48:dd:0c:7d:86:23,16289970,323,5729,16289647,16289970
4008,4,11,1,2412,-79,-88,9,48:dd:0c:7d:86:25,16290305,382,-47,16289923,16290305
4009,6,6,1,2412,-76,-88,12,f8:4f:ad:f9:af:82,16305247,248,14694,16304999,16305247
4010,6,6,1,2412,-76,-88,12,f8:4f:ad:f9:af:82,16306688,224,1217,16306464,16306688
4011,6,6,1,2412,-80,-88,8,10:86:8c:5f:93:1e,16309807,336,2783,16309471,16309807
4012,4,11,1,2412,-83,-88,5,10:86:8c:5f:93:26,16310343,347,189,16309996,16310343
4013,6,6,1,2412,-79,-88,9,b4:e6:2d:b4:ff:71,16311726,64,1319,16311662,16311726
4014,6,6,1,2412,-80,-88,8,,16311806,44,36,16311762,16311806
4015,4,1,1,2412,-88,-88,0,66:32:b1:64:4c:f2,16312666,2696,-1836,16309970,16312666
4016,4,1,1,2412,-86,-88,2,78:67:0e:38:6c:d3,16316459,2736,1057,16313723,16316459
4017,4,11,1,2412,-77,-88,11,48:dd:0c:90:e3:83,16325873,323,9091,16325550,16325873
4018,4,1,1,2412,-81,-88,7,00:26:62:eb:ea:74,16340954,968,14113,16339986,16340954
4019,6,24,1,2412,-83,-88,5,,16345205,28,4223,16345177,16345205
4020,4,1,1,2412,-77,-88,11,b0:e4:d5:32:ec:8a,16349446,1960,2281,16347486,16349446
4021,6,6,1,2412,-79,-88,9,32:86:8c:5f:93:1e,16360719,332,10941,16360387,16360719
4022,6,6,1,2412,-76,-88,12,e2:db:d1:d1:b0:4a,16368704,444,7541,16368260,16368704
4023,6,6,1,2412,-77,-88,11,e2:db:d1:d1:b0:4d,16369603,408,491,16369195,16369603
4024,6,6,1,2412,-77,-88,11,e2:db:d1:d1:b0:4f,16370062,408,51,16369654,16370062
4025,4,1,1,2412,-73,-88,15,3c:bd:c5:ee:96:6d,16380323,2512,7749,16377811,16380323
4026,4,1,1,2412,-87,-88,1,bc:98:df:ff:0f:8b,16382974,2568,83,16380406,16382974
4027,6,6,1,2412,-81,-88,7,52:86:8c:5f:93:1e,16386319,332,3013,16385987,16386319
4028,4,11,1,2412,-79,-88,9,48:dd:0c:7d:86:27,16391995,362,5314,16391633,16391995
4029,4,11,1,2412,-82,-88,6,48:dd:0c:7d:86:23,16392369,323,51,16392046,16392369
4030,4,11,1,2412,-81,-88,7,48:dd:0c:7d:86:25,16392705,382,-46,16392323,16392705
4031,4,1,1,2412,-85,-88,3,,16406709,304,13700,16406405,16406709
4032,6,24,1,2412,-83,-88,5,,16413933,28,7196,16413905,16413933
4033,4,1,1,2412,-88,-88,0,78:67:0e:38:6c:d3,16418859,2736,2190,16416123,16418859
4034,4,11,1,2412,-82,-88,6,48:dd:0c:90:e3:85,16428608,382,9367,16428226,16428608
4035,4,1,1,2412,-85,-88,3,78:67:0e:c4:a8:42,16430193,2736,-1151,16427457,16430193
4036,4,1,1,2412,-86,-88,2,,16447760,304,17263,16447456,16447760
4037,6,6,1,2412,-76,-88,12,f8:4f:ad:f9:af:82,16454617,1360,5497,16453257,16454617
4038,6,6,1,2412,-76,-88,12,f8:4f:ad:f9:af:82,16456010,1332,61,16454678,16456010
4039,6,6,1,2412,-80,-88,8,32:86:8c:5f:93:1e,16463119,332,6777,16462787,16463119
4040,4,1,1,2412,-87,-88,1,,16466569,448,3002,16466121,16466569
4041,4,1,1,2412,-85,-88,3,,16467473,448,456,16467025,16467473
4042,4,1,1,2412,-85,-88,3,b4:b5:2f:17:0c:b9,16469855,1376,1006,16468479,16469855
4043,6,6,1,2412,-77,-88,11,e2:db:d1:d1:b0:4b,16471458,408,1195,16471050,16471458
4044,6,6,1,2412,-77,-88,11,e2:db:d1:d1:b0:4d,16471899,408,33,16471491,16471899
4045,6,6,1,2412,-77,-88,11,e2:db:d1:d1:b0:4f,16472331,408,24,16471923,16472331
4046,4,1,1,2412,-83,-88,5,,16478283,304,5648,16477979,16478283
4047,4,1,1,2412,-84,-88,4,,16479653,304,1066,16479349,16479653
4048,4,1,1,2412,-83,-88,5,,16481126,352,1121,16480774,16481126
4049,4,1,1,2412,-87,-88,1,ac:67:84:84:8a:07,16481398,416,-144,16480982,16481398
4050,4,1,1,2412,-78,-88,10,3c:bd:c5:ee:96:6d,16481891,2512,-2019,16479379,16481891
4051,4,1,1,2412,-80,-88,8,b8:f8:53:cb:31:f1,16484429,976,1562,16483453,16484429
4052,6,6,1,2412,-80,-88,8,52:86:8c:5f:93:1e,16489685,332,4924,16489353,16489685
4053,6,24,1,2412,-82,-88,6,,16493196,28,3483,16493168,16493196
4054,4,11,1,2412,-78,-88,10,48:dd:0c:7d:86:27,16494395,362,837,16494033,16494395
4055,4,11,1,2412,-81,-88,7,48:dd:0c:7d:86:23,16494769,323,51,16494446,16494769
4056,4,11,1,2412,-81,-88,7,48:dd:0c:7d:86:25,16495104,382,-47,16494722,16495104
4057,6,6,1,2412,-79,-88,9,b4:e6:2d:b4:ff:71,16495383,64,215,16495319,16495383
4058,6,6,1,2412,-79,-88,9,b4:e6:2d:b4:ff:71,16495716,64,269,16495652,16495716
4059,6,6,1,2412,-80,-88,8,,16495796,44,36,16495752,16495796
4060,6,6,1,2412,-81,-88,7,10:86:8c:5f:93:1e,16521268,336,25136,16520932,16521268
4061,4,1,1,2412,-85,-88,3,78:67:0e:c4:a8:42,16521718,3472,-3022,16518246,16521718
4062,4,1,1,2412,-84,-88,4,,16526120,304,4098,16525816,16526120
4063,4,11,1,2412,-78,-88,10,48:dd:0c:90:e3:87,16530298,362,3816,16529936,16530298
4064,4,11,1,2412,-81,-88,7,48:dd:0c:90:e3:85,16531008,382,328,16530626,16531008
4065,4,1,1,2412,-84,-88,4,78:67:0e:c4:a8:42,16532593,2736,-1151,16529857,16532593
4066,6,6,1,2412,-81,-88,7,12:86:8c:5f:93:1e,16539920,332,6995,16539588,16539920
4067,4,1,1,2412,-85,-88,3,,16543584,304,3360,16543280,16543584
4068,4,1,1,2412,-87,-88,1,ac:67:84:84:8a:07,16546906,416,2906,16546490,16546906
4069,4,1,1,2412,-78,-88,10,b0:e4:d5:32:ec:8a,16554245,1960,5379,16552285,16554245
4070,4,1,1,2412,-85,-88,3,b4:b5:2f:17:0c:b9,16573130,1376,17509,16571754,16573130
4071,6,6,1,2412,-76,-88,12,e2:db:d1:d1:b0:4a,16574362,444,788,16573918,16574362
4072,6,6,1,2412,-76,-88,12,e2:db:d1:d1:b0:4b,16574857,408,87,16574449,16574857
4073,6,6,1,2412,-76,-88,12,e2:db:d1:d1:b0:4f,16575721,408,456,16575313,16575721
4074,4,1,1,2412,-90,-88,-2,,16584091,304,8066,16583787,16584091
4075,4,1,1,2412,-79,-88,9,3c:bd:c5:ee:96:6d,16584801,2512,-1802,16582289,16584801
4076,4,1,1,2412,-89,-88,-1,bc:98:df:ff:0f:8b,16587774,2568,405,16585206,16587774
4077,6,24,1,2412,-83,-88,5,,16590323,28,2521,16590295,16590323
4078,6,6,1,2412,-81,-88,7,52:86:8c:5f:93:1e,16591121,332,466,16590789,16591121
4079,4,11,1,2412,-80,-88,8,48:dd:0c:7d:86:27,16596794,362,5311,16596432,16596794
4080,4,11,1,2412,-80,-88,8,48:dd:0c:7d:86:23,16597169,323,52,16596846,16597169
4081,4,11,1,2412,-80,-88,8,48:dd:0c:7d:86:25,16597504,382,-47,16597122,16597504
4082,6,24,1,2412,-82,-88,6,,16598137,28,605,16598109,16598137
4083,4,1,1,2412,-83,-88,5,,16603422,304,4981,16603118,16603422
4084,4,11,1,2412,-88,-88,0,4c:01:43:d7:f3:29,16608947,361,5164,16608586,16608947
4085,4,11,1,2412,-90,-88,-2,4c:01:43:d7:f3:23,16609320,322,51,16608998,16609320
4086,4,1,1,2412,-85,-88,3,78:67:0e:38:6c:d3,16623661,2736,11605,16620925,16623661
4087,4,11,1,2412,-82,-88,6,48:dd:0c:90:e3:85,16633408,382,9365,16633026,16633408
4088,4,1,1,2412,-85,-88,3,78:67:0e:c4:a8:42,16636416,2736,272,16633680,16636416
4089,6,6,1,2412,-81,-88,7,12:86:8c:5f:93:1e,16642780,332,6032,16642448,16642780
4090,4,1,1,2412,-88,-88,0,ac:67:84:84:8a:07,16645794,416,2598,16645378,16645794
4091,6,24,1,2412,-82,-88,6,,16653910,28,8088,16653882,16653910
4092,4,1,1,2412,-78,-88,10,b0:e4:d5:32:ec:8a,16656685,1960,815,16654725,16656685
4093,6,6,1,2412,-80,-88,8,32:86:8c:5f:93:1e,16667934,332,10917,16667602,16667934
4094,6,24,1,2412,-82,-88,6,,16670196,28,2234,16670168,16670196
4095,4,1,1,2412,-82,-88,6,,16672833,304,2333,16672529,16672833
4096,4,1,1,2412,-86,-88,2,b4:b5:2f:17:0c:b9,16674659,1376,450,16673283,16674659
4097,6,6,1,2412,-76,-88,12,e2:db:d1:d1:b0:4a,16675891,444,788,16675447,16675891
4098,6,6,1,2412,-75,-88,13,e2:db:d1:d1:b0:4b,16676377,408,78,16675969,16676377
4099,6,6,1,2412,-77,-88,11,e2:db:d1:d1:b0:4d,16676836,408,51,16676428,16676836
4100,4,1,1,2412,-87,-88,1,ac:67:84:84:8a:07,16678021,416,769,16677605,16678021
4101,4,1,1,2412,-90,-88,-2,,16678449,304,124,16678145,16678449
4102,4,1,1,2412,-84,-88,4,0e:b9:49:67:a0:d6,16686823,416,7958,16686407,16686823
4103,4,1,1,2412,-80,-88,8,3c:bd:c5:ee:96:6d,16687387,2512,-1948,16684875,16687387
4104,6,6,1,2412,-84,-88,4,,16692882,44,5451,16692838,16692882
4105,4,1,1,2412,-86,-88,2,,16693506,304,320,16693202,16693506
4106,6,6,1,2412,-80,-88,8,52:86:8c:5f:93:1e,16693962,332,124,16693630,16693962
4107,4,11,1,2412,-79,-88,9,48:dd:0c:7d:86:27,16699194,362,4870,16698832,16699194
4108,4,11,1,2412,-80,-88,8,48:dd:0c:7d:86:23,16699569,323,52,16699246,16699569
4109,4,11,1,2412,-80,-88,8,48:dd:0c:7d:86:25,16699904,382,-47,16699522,16699904
4110,4,1,1,2412,-88,-88,0,,16706034,304,5826,16705730,16706034
4111,4,1,1,2412,-83,-88,5,,16724998,304,18660,16724694,16724998
4112,4,1,1,2412,-86,-88,2,78:67:0e:38:6c:d3,16726059,2736,-1675,16723323,16726059
4113,4,1,1,2412,-87,-88,1,7c:f6:66:c0:cf:b8,16728834,2208,567,16726626,16728834
4114,4,11,1,2412,-81,-88,7,48:dd:0c:90:e3:85,16735807,382,6591,16735425,16735807
4115,4,1,1,2412,-85,-88,3,,16744454,304,8343,16744150,16744454
4116,6,24,1,2412,-82,-88,6,,16745238,28,756,16745210,16745238
4117,6,24,1,2412,-83,-88,5,,16750632,28,5366,16750604,16750632
4118,4,1,1,2412,-84,-88,4,0e:b9:49:67:a0:d6,16755751,416,4703,16755335,16755751
4119,4,1,1,2412,-90,-88,-2,,16756179,304,124,16755875,16756179
4120,4,1,1,2412,-78,-88,10,b0:e4:d5:32:ec:8a,16759044,1960,905,16757084,16759044
4121,4,1,1,2412,-84,-88,4,ac:67:84:84:8a:07,16767221,416,7761,16766805,16767221
4122,6,6,1,2412,-80,-88,8,32:86:8c:5f:93:1e,16770322,332,2769,16769990,16770322
4123,4,1,1,2412,-83,-88,5,b4:b5:2f:17:0c:b9,16777060,1376,5362,16775684,16777060
4124,6,6,1,2412,-76,-88,12,e2:db:d1:d1:b0:4a,16778311,444,807,16777867,16778311
4125,6,6,1,2412,-76,-88,12,e2:db:d1:d1:b0:4b,16778788,408,69,16778380,16778788
4126,6,6,1,2412,-76,-88,12,e2:db:d1:d1:b0:4d,16779238,408,42,16778830,16779238
4127,6,6,1,2412,-77,-88,11,e2:db:d1:d1:b0:4f,16779696,408,50,16779288,16779696
4128,4,1,1,2412,-83,-88,5,,16781915,304,1915,16781611,16781915
4129,4,1,1,2412,-79,-88,9,3c:bd:c5:ee:96:6d,16790171,2512,5744,16787659,16790171
4130,4,1,1,2412,-89,-88,-1,b8:f8:53:cb:31:f1,16792709,976,1562,16791733,16792709
4131,6,6,1,2412,-81,-88,7,52:86:8c:5f:93:1e,16795922,332,2881,16795590,16795922
4132,4,11,1,2412,-80,-88,8,48:dd:0c:7d:86:27,16801594,362,5310,16801232,16801594
4133,4,11,1,2412,-80,-88,8,48:dd:0c:7d:86:23,16801968,323,51,16801645,16801968
4134,4,11,1,2412,-79,-88,9,48:dd:0c:7d:86:25,16802304,382,-46,16801922,16802304
4135,6,24,1,2412,-83,-88,5,,16814749,28,12417,16814721,16814749
4136,6,6,1,2412,-79,-88,9,10:86:8c:5f:93:1e,16821522,336,6437,16821186,16821522
4137,4,1,1,2412,-81,-88,7,,16825454,304,3628,16825150,16825454
4138,4,11,1,2412,-77,-88,11,48:dd:0c:90:e3:87,16837497,362,11681,16837135,16837497
4139,4,11,1,2412,-84,-88,4,48:dd:0c:90:e3:85,16838207,382,328,16837825,16838207
4140,4,1,1,2412,-78,-88,10,b0:e4:d5:32:ec:8a,16861443,1960,21276,16859483,16861443
4141,4,11,1,2412,-82,-88,6,,16864998,107,3448,16864891,16864998
4142,4,1,1,2412,-85,-88,3,,16865619,352,269,16865267,16865619
4143,4,1,1,2412,-85,-88,3,,16866089,352,118,16865737,16866089
4144,4,1,1,2412,-85,-88,3,,16866541,352,100,16866189,16866541
4145,4,1,1,2412,-83,-88,5,,16866993,352,100,16866641,16866993
4146,4,1,1,2412,-86,-88,2,,16867445,352,100,16867093,16867445
4147,4,1,1,2412,-83,-88,5,,16867897,352,100,16867545,16867897
4148,4,1,1,2412,-83,-88,5,,16868349,352,100,16867997,16868349
4149,4,1,1,2412,-85,-88,3,,16868801,352,100,16868449,16868801
4150,4,1,1,2412,-84,-88,4,,16869253,352,100,16868901,16869253
4151,4,1,1,2412,-83,-88,5,,16869702,352,97,16869350,16869702
4152,4,1,1,2412,-83,-88,5,,16870172,352,118,16869820,16870172
4153,4,1,1,2412,-84,-88,4,,16870624,352,100,16870272,16870624
4154,4,1,1,2412,-83,-88,5,,16871874,352,898,16871522,16871874
4155,4,1,1,2412,-83,-88,5,,16872335,352,109,16871983,16872335
4156,4,1,1,2412,-84,-88,4,,16872787,352,100,16872435,16872787
4157,4,1,1,2412,-84,-88,4,,16873239,352,100,16872887,16873239
4158,4,1,1,2412,-84,-88,4,,16873688,352,97,16873336,16873688
4159,6,6,1,2412,-80,-88,8,32:86:8c:5f:93:1e,16874328,332,308,16873996,16874328
4160,4,11,1,2412,-88,-88,0,,16879179,107,4744,16879072,16879179
4161,4,1,1,2412,-81,-88,7,,16879750,352,219,16879398,16879750
4162,4,1,1,2412,-81,-88,7,b4:b5:2f:17:0c:b9,16880318,1376,-808,16878942,16880318
4163,6,6,1,2412,-76,-88,12,e2:db:d1:d1:b0:4a,16881578,444,816,16881134,16881578
4164,6,6,1,2412,-76,-88,12,e2:db:d1:d1:b0:4b,16882046,408,60,16881638,16882046
4165,6,6,1,2412,-76,-88,12,e2:db:d1:d1:b0:4d,16882495,408,41,16882087,16882495
4166,6,6,1,2412,-76,-88,12,e2:db:d1:d1:b0:4f,16882927,408,24,16882519,16882927
4167,4,1,1,2412,-80,-88,8,3c:bd:c5:ee:96:6d,16892252,2512,6813,16889740,16892252
4168,4,1,1,2412,-88,-88,0,bc:98:df:ff:0f:8b,16894963,2568,143,16892395,16894963
4169,6,6,1,2412,-81,-88,7,52:86:8c:5f:93:1e,16898323,332,3028,16897991,16898323
4170,4,11,1,2412,-80,-88,8,48:dd:0c:7d:86:27,16903994,362,5309,16903632,16903994
4171,4,11,1,2412,-80,-88,8,48:dd:0c:7d:86:23,16904368,323,51,16904045,16904368
4172,4,11,1,2412,-80,-88,8,48:dd:0c:7d:86:25,16904703,382,-47,16904321,16904703
4173,6,24,1,2412,-82,-88,6,,16905336,28,605,16905308,16905336
4174,6,24,1,2412,-82,-88,6,,16910196,28,4832,16910168,16910196
4175,6,6,1,2412,-76,-88,12,e0:db:d1:d0:b0:48,16927712,380,17136,16927332,16927712
4176,6,6,1,2412,-75,-88,13,e0:db:d1:d0:b0:48,16928124,384,28,16927740,16928124
4177,6,6,1,2412,-76,-88,12,e0:db:d1:d0:b0:48,16928550,392,34,16928158,16928550
4178,6,6,1,2412,-76,-88,12,e0:db:d1:d0:b0:48,16928984,380,54,16928604,16928984
4179,4,11,1,2412,-82,-88,6,48:dd:0c:90:e3:85,16940607,382,11241,16940225,16940607
4180,4,1,1,2412,-84,-88,4,78:67:0e:c4:a8:42,16942192,2736,-1151,16939456,16942192
4181,6,6,1,2412,-80,-88,8,12:86:8c:5f:93:1e,16949523,332,6999,16949191,16949523
4182,4,1,1,2412,-86,-88,2,d2:9e:43:bc:eb:ff,16953520,3600,397,16949920,16953520
4183,4,1,1,2412,-88,-88,0,c8:9e:43:bc:eb:ff,16957131,3496,115,16953635,16957131
4184,4,1,1,2412,-79,-88,9,b0:e4:d5:32:ec:8a,16963842,1960,4751,16961882,16963842
4185,6,6,1,2412,-80,-88,8,32:86:8c:5f:93:1e,16975123,332,10949,16974791,16975123
4186,4,1,1,2412,-84,-88,4,,16976279,304,852,16975975,16976279
4187,6,6,1,2412,-76,-88,12,e2:db:d1:d1:b0:4b,16983483,408,6796,16983075,16983483
4188,6,6,1,2412,-76,-88,12,e2:db:d1:d1:b0:4d,16983933,408,42,16983525,16983933
4189,6,6,1,2412,-77,-88,11,e2:db:d1:d1:b0:4f,16984374,408,33,16983966,16984374
4190,6,24,1,2412,-82,-88,6,,16985222,28,820,16985194,16985222
4191,4,1,1,2412,-90,-88,-2,,16985586,384,-20,16985202,16985586
4192,4,1,1,2412,-87,-88,1,,16985984,448,-50,16985536,16985984
4193,4,1,1,2412,-88,-88,0,,16986481,384,113,16986097,16986481
4194,4,1,1,2412,-88,-88,0,,16986879,448,-50,16986431,16986879
4195,4,1,1,2412,-79,-88,9,3c:bd:c5:ee:96:6d,16993812,2512,4421,16991300,16993812
4196,6,6,1,2412,-80,-88,8,52:86:8c:5f:93:1e,17000723,332,6579,17000391,17000723
4197,4,11,1,2412,-79,-88,9,48:dd:0c:7d:86:27,17006394,362,5309,17006032,17006394
4198,4,11,1,2412,-80,-88,8,48:dd:0c:7d:86:23,17006768,323,51,17006445,17006768
4199,4,11,1,2412,-80,-88,8,48:dd:0c:7d:86:25,17007103,382,-47,17006721,17007103
4200,4,11,1,2412,-89,-87,-2,4c:01:43:d7:f3:26,17019253,387,11763,17018866,17019253
4201,6,6,1,2412,-84,-87,3,,17019578,44,281,17019534,17019578
4202,4,1,1,2412,-88,-87,-1,,17023425,304,3543,17023121,17023425
4203,4,1,1,2412,-80,-87,7,,17029209,304,5480,17028905,17029209
4204,4,1,1,2412,-85,-87,2,78:67:0e:38:6c:d3,17033260,2736,1315,17030524,17033260
4205,4,1,1,2412,-86,-87,1,78:67:0e:38:6c:d2,17036052,1640,1152,17034412,17036052
4206,4,1,1,2412,-86,-87,1,78:67:0e:38:6c:d3,17037703,848,803,17036855,17037703
4207,4,11,1,2412,-77,-87,10,48:dd:0c:90:e3:85,17043077,382,4992,17042695,17043077
4208,4,1,1,2412,-85,-87,2,78:67:0e:c4:a8:42,17044592,2736,-1221,17041856,17044592
4209,6,6,1,2412,-81,-87,6,12:86:8c:5f:93:1e,17051924,332,7000,17051592,17051924
4210,6,24,1,2412,-83,-87,4,,17053914,28,1962,17053886,17053914
4211,4,1,1,2412,-79,-87,8,b0:e4:d5:32:ec:8a,17066242,1960,10368,17064282,17066242
4212,4,1,1,2412,-85,-87,2,,17070621,304,4075,17070317,17070621
4213,6,6,1,2412,-80,-87,7,32:86:8c:5f:93:1e,17077524,332,6571,17077192,17077524
4214,6,24,1,2412,-82,-87,5,,17077926,28,374,17077898,17077926
4215,4,1,1,2412,-81,-87,6,60:32:b1:64:4c:f2,17080168,3224,-982,17076944,17080168
4216,4,1,1,2412,-87,-87,0,ac:67:84:84:8a:07,17083639,416,3055,17083223,17083639
4217,4,1,1,2412,-84,-87,3,b4:b5:2f:17:0c:b9,17084266,1376,-749,17082890,17084266
4218,6,6,1,2412,-76,-87,11,e2:db:d1:d1:b0:4a,17085516,444,806,17085072,17085516
4219,6,6,1,2412,-76,-87,11,e2:db:d1:d1:b0:4b,17086112,408,188,17085704,17086112
4220,6,6,1,2412,-77,-87,10,e2:db:d1:d1:b0:4d,17086571,408,51,17086163,17086571
4221,6,6,1,2412,-76,-87,11,e2:db:d1:d1:b0:4f,17087012,408,33,17086604,17087012
4222,4,1,1,2412,-84,-87,3,,17091130,304,3814,17090826,17091130
4223,4,11,1,2412,-79,-87,8,,17091519,107,282,17091412,17091519
4224,4,1,1,2412,-84,-87,3,,17093944,352,2073,17093592,17093944
4225,4,11,1,2412,-81,-87,6,,17095699,107,1648,17095592,17095699
4226,4,11,1,2412,-77,-87,10,48:dd:0c:7d:86:23,17096371,254,418,17096117,17096371
4227,4,1,1,2412,-79,-87,8,3c:bd:c5:ee:96:6d,17097062,2512,-1821,17094550,17097062
4228,4,1,1,2412,-88,-87,-1,bc:98:df:ff:0f:8b,17099771,2568,141,17097203,17099771
4229,6,6,1,2412,-81,-87,6,52:86:8c:5f:93:1e,17103124,332,3021,17102792,17103124
4230,4,11,1,2412,-80,-87,7,48:dd:0c:7d:86:27,17108793,362,5307,17108431,17108793
4231,4,11,1,2412,-79,-87,8,48:dd:0c:7d:86:23,17109168,323,52,17108845,17109168
4232,4,11,1,2412,-80,-87,7,48:dd:0c:7d:86:25,17109503,382,-47,17109121,17109503
4233,4,1,1,2412,-87,-87,0,ac:67:84:84:8a:07,17127426,416,17507,17127010,17127426
4234,4,11,1,2412,-81,-87,6,4c:01:43:ec:a0:63,17139691,322,11943,17139369,17139691
4235,4,11,1,2412,-84,-87,3,48:dd:0c:90:e3:85,17145406,382,5333,17145024,17145406
4236,4,1,1,2412,-82,-87,5,78:67:0e:c4:a8:42,17146992,2736,-1150,17144256,17146992
4237,4,1,1,2412,-88,-87,-1,ac:67:84:84:8a:07,17150470,416,3062,17150054,17150470
4238,6,6,1,2412,-80,-87,7,12:86:8c:5f:93:1e,17154324,332,3522,17153992,17154324
4239,4,1,1,2412,-86,-87,1,b4:b5:2f:17:0c:b9,17161276,1328,5624,17159948,17161276
4240,4,1,1,2412,-80,-87,7,3c:bd:c5:ee:96:6d,17162943,3280,-1613,17159663,17162943
4241,4,1,1,2412,-80,-87,7,3c:bd:c5:ee:96:6d,17166657,3280,434,17163377,17166657
4242,4,1,1,2412,-77,-87,10,b0:e4:d5:32:ec:8a,17170273,1960,1656,17168313,17170273
4243,4,1,1,2412,-87,-87,0,b4:b5:2f:17:0c:b9,17186668,1376,15019,17185292,17186668
4244,6,6,1,2412,-75,-87,12,e2:db:d1:d1:b0:4b,17188309,408,1233,17187901,17188309
4245,6,6,1,2412,-76,-87,11,e2:db:d1:d1:b0:4d,17188750,408,33,17188342,17188750
4246,6,6,1,2412,-76,-87,11,e2:db:d1:d1:b0:4f,17189191,408,33,17188783,17189191
4247,6,6,1,2412,-86,-87,1,,17192636,44,3401,17192592,17192636
4248,4,1,1,2412,-87,-87,0,10:7b:44:eb:35:60,17196072,1960,1476,17194112,17196072
4249,4,1,1,2412,-80,-87,7,3c:bd:c5:ee:96:6d,17198590,2512,6,17196078,17198590
4250,4,1,1,2412,-89,-87,-2,bc:98:df:ff:0f:8b,17202158,2568,1000,17199590,17202158
4251,6,6,1,2412,-81,-87,6,52:86:8c:5f:93:1e,17205525,332,3035,17205193,17205525
4252,6,24,1,2412,-83,-87,4,,17206582,28,1029,17206554,17206582
4253,4,11,1,2412,-79,-87,8,48:dd:0c:7d:86:27,17211193,362,4249,17210831,17211193
4254,4,11,1,2412,-77,-87,10,48:dd:0c:7d:86:23,17211568,323,52,17211245,17211568
4255,4,11,1,2412,-79,-87,8,48:dd:0c:7d:86:25,17211903,382,-47,17211521,17211903
4256,6,24,1,2412,-82,-87,5,,17225220,28,13289,17225192,17225220
4257,4,1,1,2412,-88,-87,-1,ac:67:84:84:8a:07,17226612,416,976,17226196,17226612
4258,4,1,1,2412,-88,-87,-1,ac:67:84:84:8a:07,17230518,416,3490,17230102,17230518
4259,6,6,1,2412,-81,-87,6,10:86:8c:5f:93:1e,17231125,336,271,17230789,17231125
4260,4,1,1,2412,-87,-87,0,78:67:0e:38:6c:d3,17238060,2736,4199,17235324,17238060
4261,4,11,1,2412,-77,-87,10,48:dd:0c:90:e3:83,17247471,323,9088,17247148,17247471
4262,4,11,1,2412,-83,-87,4,48:dd:0c:90:e3:85,17247806,382,-47,17247424,17247806
4263,4,1,1,2412,-83,-87,4,78:67:0e:c4:a8:42,17249391,2736,-1151,17246655,17249391
4264,6,6,1,2412,-80,-87,7,12:86:8c:5f:93:1e,17256725,332,7002,17256393,17256725
4265,4,11,1,2412,-86,-87,1,,17264147,107,7315,17264040,17264147
4266,4,11,1,2412,-85,-87,2,,17264831,107,577,17264724,17264831
4267,4,1,1,2412,-86,-87,1,ac:67:84:84:8a:07,17273563,416,8316,17273147,17273563
4268,4,1,1,2412,-83,-87,4,,17276689,352,2774,17276337,17276689
4269,6,6,1,2412,-81,-87,6,32:86:8c:5f:93:1e,17282326,332,5305,17281994,17282326
4270,4,1,1,2412,-85,-87,2,,17288755,448,5981,17288307,17288755
4271,6,6,1,2412,-75,-87,12,e2:db:d1:d1:b0:4b,17290947,408,1784,17290539,17290947
4272,6,6,1,2412,-75,-87,12,e2:db:d1:d1:b0:4d,17291406,408,51,17290998,17291406
4273,6,6,1,2412,-76,-87,11,e2:db:d1:d1:b0:4f,17291847,408,33,17291439,17291847
4274,4,1,1,2412,-84,-87,3,,17292445,352,246,17292093,17292445
4275,6,24,1,2412,-82,-87,5,,17293918,28,1445,17293890,17293918
4276,6,6,1,2412,-80,-87,7,52:86:8c:5f:93:1e,17307926,332,13676,17307594,17307926
4277,4,11,1,2412,-80,-87,7,48:dd:0c:7d:86:27,17313593,362,5305,17313231,17313593
4278,4,11,1,2412,-79,-87,8,48:dd:0c:7d:86:23,17313967,323,51,17313644,17313967
4279,4,11,1,2412,-80,-87,7,48:dd:0c:7d:86:25,17314303,382,-46,17313921,17314303
4280,4,1,1,2412,-85,-87,2,78:67:0e:38:6c:d3,17340460,2736,23421,17337724,17340460
4281,4,1,1,2412,-85,-87,2,7c:f6:66:cd:4c:69,17343244,2208,576,17341036,17343244
4282,4,11,1,2412,-83,-87,4,48:dd:0c:90:e3:85,17350206,382,6580,17349824,17350206
4283,4,1,1,2412,-85,-87,2,78:67:0e:c4:a8:42,17351791,2736,-1151,17349055,17351791
4284,6,6,1,2412,-81,-87,6,12:86:8c:5f:93:1e,17359126,332,7003,17358794,17359126
4285,4,1,1,2412,-91,-87,-4,00:26:62:eb:ea:74,17364960,968,4866,17363992,17364960
4286,4,1,1,2412,-88,-87,-1,3c:bd:c5:83:41:63,17369909,1120,3829,17368789,17369909
4287,4,1,1,2412,-76,-87,11,b0:e4:d5:32:ec:8a,17373437,1912,1616,17371525,17373437
4288,4,1,1,2412,-73,-87,14,b0:e4:d5:32:ec:8a,17375467,1960,70,17373507,17375467
4289,4,1,1,2412,-76,-87,11,,17382348,304,6577,17382044,17382348
4290,4,1,1,2412,-82,-87,5,,17389082,304,6430,17388778,17389082
4291,4,1,1,2412,-81,-87,6,,17397886,304,8500,17397582,17397886
4292,4,1,1,2412,-78,-87,9,3c:bd:c5:ee:96:6d,17403390,2512,2992,17400878,17403390
4293,4,1,1,2412,-80,-87,7,3c:bd:c5:ee:96:6a,17405928,1056,1482,17404872,17405928
4294,4,1,1,2412,-84,-87,3,bc:98:df:ff:0f:8b,17406949,2568,-1547,17404381,17406949
4295,6,6,1,2412,-79,-87,8,52:86:8c:5f:93:1e,17410326,332,3045,17409994,17410326
4296,4,11,1,2412,-79,-87,8,48:dd:0c:7d:86:27,17415993,362,5305,17415631,17415993
4297,4,11,1,2412,-79,-87,8,48:dd:0c:7d:86:23,17416367,323,51,17416044,17416367
4298,4,11,1,2412,-81,-87,6,48:dd:0c:7d:86:25,17416702,382,-47,17416320,17416702
4299,4,1,1,2412,-89,-87,-2,ac:67:84:84:8a:07,17429895,416,12777,17429479,17429895
4300,4,1,1,2412,-83,-87,4,,17441073,304,10874,17440769,17441073
4301,4,1,1,2412,-85,-87,2,78:67:0e:38:6c:d3,17442860,2736,-949,17440124,17442860
4302,4,11,1,2412,-77,-87,10,48:dd:0c:90:e3:83,17452270,323,9087,17451947,17452270
4303,4,11,1,2412,-81,-87,6,48:dd:0c:90:e3:85,17452606,382,-46,17452224,17452606
4304,6,24,1,2412,-83,-87,4,,17453916,28,1282,17453888,17453916
4305,4,1,1,2412,-83,-87,4,78:67:0e:c4:a8:42,17454231,2736,-2421,17451495,17454231
4306,6,6,1,2412,-77,-87,10,f8:4f:ad:f9:af:82,17457079,1332,1516,17455747,17457079
4307,6,6,1,2412,-81,-87,6,12:86:8c:5f:93:1e,17461527,332,4116,17461195,17461527
4308,6,24,1,2412,-84,-87,3,,17465231,28,3676,17465203,17465231
4309,4,1,1,2412,-86,-87,1,,17474387,304,8852,17474083,17474387
4310,6,24,1,2412,-82,-87,5,,17478115,28,3700,17478087,17478115
4311,6,6,1,2412,-81,-87,6,32:86:8c:5f:93:1e,17487127,332,8680,17486795,17487127
4312,4,1,1,2412,-85,-87,2,,17494202,448,6627,17493754,17494202
4313,6,6,1,2412,-75,-87,12,e2:db:d1:d1:b0:4a,17496133,444,1487,17495689,17496133
4314,6,6,1,2412,-76,-87,11,e2:db:d1:d1:b0:4b,17496629,408,88,17496221,17496629
4315,6,6,1,2412,-76,-87,11,e2:db:d1:d1:b0:4d,17497060,408,23,17496652,17497060
4316,6,6,1,2412,-75,-87,12,e2:db:d1:d1:b0:4f,17497520,408,52,17497112,17497520
4317,4,11,1,2412,-83,-87,4,48:dd:0c:90:e3:83,17498038,254,264,17497784,17498038
4318,4,11,1,2412,-82,-87,5,48:dd:0c:7d:86:23,17498340,254,48,17498086,17498340
4319,4,1,1,2412,-79,-87,8,3c:bd:c5:ee:96:6d,17506980,2512,6128,17504468,17506980
4320,4,1,1,2412,-88,-87,-1,c8:9e:43:bc:eb:ff,17510463,3496,-13,17506967,17510463
4321,6,6,1,2412,-81,-87,6,52:86:8c:5f:93:1e,17514534,332,3739,17514202,17514534
4322,4,1,1,2412,-84,-87,3,,17517726,304,2888,17517422,17517726
4323,4,11,1,2412,-79,-87,8,48:dd:0c:7d:86:27,17518392,362,304,17518030,17518392
4324,4,11,1,2412,-78,-87,9,48:dd:0c:7d:86:25,17519102,382,328,17518720,17519102
4325,4,1,1,2412,-85,-87,2,,17524809,304,5403,17524505,17524809
4326,4,1,1,2412,-84,-87,3,,17525861,304,748,17525557,17525861
4327,4,11,1,2412,-87,-87,0,4c:01:43:d7:f3:23,17530916,322,4733,17530594,17530916
4328,4,11,1,2412,-76,-87,11,48:dd:0c:90:e3:83,17554670,323,23431,17554347,17554670
4329,4,11,1,2412,-83,-87,4,48:dd:0c:90:e3:85,17555005,382,-47,17554623,17555005
4330,4,1,1,2412,-84,-87,3,78:67:0e:c4:a8:42,17556591,2736,-1150,17553855,17556591
4331,6,6,1,2412,-81,-87,6,12:86:8c:5f:93:1e,17563927,332,7004,17563595,17563927
4332,4,1,1,2412,-80,-87,7,,17569495,304,5264,17569191,17569495
4333,4,1,1,2412,-83,-87,4,,17575008,304,5209,17574704,17575008
4334,4,1,1,2412,-84,-87,3,,17576258,304,946,17575954,17576258
4335,6,6,1,2412,-81,-87,6,32:86:8c:5f:93:1e,17589528,332,12938,17589196,17589528
4336,4,1,1,2412,-84,-87,3,b4:b5:2f:17:0c:b9,17596275,1376,5371,17594899,17596275
4337,6,6,1,2412,-76,-87,11,e2:db:d1:d1:b0:4a,17597525,444,806,17597081,17597525
4338,6,6,1,2412,-76,-87,11,e2:db:d1:d1:b0:4b,17597993,408,60,17597585,17597993
4339,6,6,1,2412,-76,-87,11,e2:db:d1:d1:b0:4d,17598452,408,51,17598044,17598452
4340,4,1,1,2412,-79,-87,8,3c:bd:c5:ee:96:6d,17608190,2512,7226,17605678,17608190
4341,6,6,1,2412,-81,-87,6,52:86:8c:5f:93:1e,17615128,332,6606,17614796,17615128
4342,4,1,1,2412,-84,-87,3,,17623937,304,8505,17623633,17623937
4343,6,24,1,2412,-82,-87,5,,17625848,28,1883,17625820,17625848
4344,4,1,1,2412,-84,-87,3,,17626970,304,818,17626666,17626970
4345,4,1,1,2412,-87,-87,0,ac:67:84:84:8a:07,17627980,416,594,17627564,17627980
4346,6,24,1,2412,-82,-87,5,,17631098,28,3090,17631070,17631098
4347,4,1,1,2412,-80,-87,7,3c:bd:c5:ee:96:6d,17637447,3280,3069,17634167,17637447
4348,6,6,1,2412,-80,-87,7,10:86:8c:5f:93:1e,17640728,336,2945,17640392,17640728
4349,4,1,1,2412,-79,-87,8,3c:bd:c5:ee:96:6d,17645244,3280,1236,17641964,17645244
4350,4,1,1,2412,-78,-87,9,3c:bd:c5:ee:96:6d,17649880,3280,1356,17646600,17649880
4351,4,11,1,2412,-83,-87,4,48:dd:0c:90:e3:85,17657405,382,7143,17657023,17657405
4352,4,11,1,2412,-83,-87,4,,17664575,107,7063,17664468,17664575
4353,6,6,1,2412,-80,-87,7,12:86:8c:5f:93:1e,17666328,332,1421,17665996,17666328
4354,6,6,1,2412,-85,-87,2,,17668406,44,2034,17668362,17668406
4355,6,6,1,2412,-86,-87,1,,17668858,44,408,17668814,17668858
4356,4,1,1,2412,-88,-87,-1,ac:67:84:84:8a:07,17673446,416,4172,17673030,17673446
4357,4,1,1,2412,-89,-87,-2,,17673874,304,124,17673570,17673874
4358,4,1,1,2412,-86,-87,1,,17678573,304,4395,17678269,17678573
4359,4,1,1,2412,-77,-87,10,b0:e4:d5:32:ec:8a,17680638,1960,105,17678678,17680638
4360,6,6,1,2412,-81,-87,6,32:86:8c:5f:93:1e,17691929,332,10959,17691597,17691929
4361,6,24,1,2412,-83,-87,4,,17693918,28,1961,17693890,17693918
4362,4,1,1,2412,-87,-87,0,b4:b5:2f:17:0c:b9,17698677,1376,3383,17697301,17698677
4363,6,6,1,2412,-76,-87,11,e2:db:d1:d1:b0:4a,17699909,444,788,17699465,17699909
4364,6,6,1,2412,-76,-87,11,e2:db:d1:d1:b0:4b,17700377,408,60,17699969,17700377
4365,6,6,1,2412,-76,-87,11,e2:db:d1:d1:b0:4d,17701027,408,242,17700619,17701027
4366,6,6,1,2412,-76,-87,11,e2:db:d1:d1:b0:4f,17701477,408,42,17701069,17701477
4367,6,24,1,2412,-83,-87,4,,17705230,28,3725,17705202,17705230
4368,4,1,1,2412,-78,-87,9,3c:bd:c5:ee:96:6d,17711606,2512,3864,17709094,17711606
4369,4,1,1,2412,-81,-87,6,bc:98:df:ff:0f:8b,17714154,2568,-20,17711586,17714154
4370,6,6,1,2412,-81,-87,6,52:86:8c:5f:93:1e,17717529,332,3043,17717197,17717529
4371,6,24,1,2412,-82,-87,5,,17718520,28,963,17718492,17718520
4372,4,1,1,2412,-85,-87,2,,17719989,304,1165,17719685,17719989
4373,6,6,1,2412,-84,-87,3,,17720585,44,552,17720541,17720585
4374,4,1,1,2412,-85,-87,2,,17721335,304,446,17721031,17721335
4375,4,11,1,2412,-81,-87,6,48:dd:0c:7d:86:27,17723192,362,1495,17722830,17723192
4376,4,11,1,2412,-80,-87,7,48:dd:0c:7d:86:23,17723566,323,51,17723243,17723566
4377,4,11,1,2412,-79,-87,8,48:dd:0c:7d:86:25,17723902,382,-46,17723520,17723902
4378,4,1,1,2412,-87,-87,0,ac:67:84:84:8a:07,17724822,416,504,17724406,17724822
4379,6,24,1,2412,-82,-87,5,,17740169,28,15319,17740141,17740169
4380,4,1,1,2412,-84,-87,3,,17740577,304,104,17740273,17740577
4381,6,6,1,2412,-79,-87,8,10:86:8c:5f:93:1e,17743129,336,2216,17742793,17743129
4382,4,11,1,2412,-77,-87,10,48:dd:0c:90:e3:87,17759095,362,15604,17758733,17759095
4383,4,11,1,2412,-82,-87,5,48:dd:0c:90:e3:85,17759805,382,328,17759423,17759805
4384,4,1,1,2412,-84,-87,3,78:67:0e:c4:a8:42,17761391,2736,-1150,17758655,17761391
4385,6,6,1,2412,-80,-87,7,12:86:8c:5f:93:1e,17768729,332,7006,17768397,17768729
4386,4,1,1,2412,-85,-87,2,,17774518,304,5485,17774214,17774518
4387,6,24,1,2412,-83,-87,4,,17775183,28,637,17775155,17775183
4388,4,1,1,2412,-86,-87,1,,17775572,304,85,17775268,17775572
4389,4,1,1,2412,-84,-87,3,,17776824,304,948,17776520,17776824
4390,4,1,1,2412,-88,-87,-1,ac:67:84:84:8a:07,17779308,416,2068,17778892,17779308
4391,4,1,1,2412,-89,-87,-2,,17779736,304,124,17779432,17779736
4392,4,1,1,2412,-80,-87,7,b0:e4:d5:32:ec:8a,17783037,1960,1341,17781077,17783037
4393,6,24,1,2412,-82,-87,5,,17786321,28,3256,17786293,17786321
4394,6,6,1,2412,-80,-87,7,32:86:8c:5f:93:1e,17794329,332,7676,17793997,17794329
4395,4,1,1,2412,-88,-87,-1,60:32:b1:64:4c:f2,17797278,3224,-275,17794054,17797278
4396,4,1,1,2412,-84,-87,3,b4:b5:2f:17:0c:b9,17801078,1376,2424,17799702,17801078
4397,6,6,1,2412,-76,-87,11,e2:db:d1:d1:b0:4a,17802329,444,807,17801885,17802329
4398,6,6,1,2412,-76,-87,11,e2:db:d1:d1:b0:4d,17803339,408,602,17802931,17803339
4399,6,6,1,2412,-76,-87,11,e2:db:d1:d1:b0:4f,17803780,408,33,17803372,17803780
4400,4,1,1,2412,-79,-87,8,3c:bd:c5:ee:96:6d,17814086,2512,7794,17811574,17814086
4401,4,1,1,2412,-87,-87,0,bc:98:df:ff:0f:8b,17816583,2568,-71,17814015,17816583
4402,4,1,1,2412,-86,-87,1,ac:67:84:84:8a:07,17822886,416,5887,17822470,17822886
4403,4,1,1,2412,-77,-87,10,,17823314,304,124,17823010,17823314
4404,4,11,1,2412,-79,-87,8,48:dd:0c:7d:86:27,17825592,362,1916,17825230,17825592
4405,4,11,1,2412,-79,-87,8,48:dd:0c:7d:86:23,17825966,323,51,17825643,17825966
4406,4,11,1,2412,-78,-87,9,48:dd:0c:7d:86:25,17826301,382,-47,17825919,17826301
4407,4,1,1,2412,-81,-87,6,66:32:b1:64:4c:f2,17848649,2696,19652,17845953,17848649
4408,4,11,1,2412,-77,-87,10,48:dd:0c:90:e3:87,17861495,362,12484,17861133,17861495
4409,4,11,1,2412,-77,-87,10,48:dd:0c:90:e3:83,17861869,323,51,17861546,17861869
4410,4,11,1,2412,-84,-87,3,48:dd:0c:90:e3:85,17862205,382,-46,17861823,17862205
4411,4,1,1,2412,-86,-87,1,78:67:0e:c4:a8:42,17863790,2736,-1151,17861054,17863790
4412,6,24,1,2412,-82,-87,5,,17866435,28,2617,17866407,17866435
4413,6,24,1,2412,-82,-87,5,,17870758,28,4295,17870730,17870758
4414,6,6,1,2412,-80,-87,7,12:86:8c:5f:93:1e,17871130,332,40,17870798,17871130
4415,4,1,1,2412,-84,-87,3,,17875932,304,4498,17875628,17875932
4416,4,1,1,2412,-84,-87,3,,17876987,304,751,17876683,17876987
4417,4,1,1,2412,-78,-87,9,b0:e4:d5:32:ec:8a,17885437,1960,6490,17883477,17885437
4418,6,6,1,2412,-79,-87,8,32:86:8c:5f:93:1e,17896730,332,10961,17896398,17896730
4419,6,6,1,2412,-76,-87,11,e2:db:d1:d1:b0:4a,17904731,444,7557,17904287,17904731
4420,6,6,1,2412,-76,-87,11,e2:db:d1:d1:b0:4b,17905207,408,68,17904799,17905207
4421,6,6,1,2412,-76,-87,11,e2:db:d1:d1:b0:4f,17906098,408,483,17905690,17906098
4422,4,1,1,2412,-87,-87,0,,17907131,448,585,17906683,17907131
4423,4,1,1,2412,-85,-87,2,,17908017,448,438,17907569,17908017
4424,4,1,1,2412,-80,-87,7,3c:bd:c5:ee:96:6d,17915413,2512,4884,17912901,17915413
4425,6,6,1,2412,-81,-87,6,52:86:8c:5f:93:1e,17922330,332,6585,17921998,17922330
4426,4,1,1,2412,-88,-87,-1,ac:67:84:84:8a:07,17924082,416,1336,17923666,17924082
4427,4,11,1,2412,-79,-87,8,48:dd:0c:7d:86:27,17927992,362,3548,17927630,17927992
4428,4,11,1,2412,-80,-87,7,48:dd:0c:7d:86:23,17928366,323,51,17928043,17928366
4429,4,11,1,2412,-79,-87,8,48:dd:0c:7d:86:25,17928701,382,-47,17928319,17928701
4430,6,24,1,2412,-83,-87,4,,17933937,28,5208,17933909,17933937
4431,6,24,1,2412,-81,-87,6,,17945239,28,11274,17945211,17945239
4432,6,6,1,2412,-80,-87,7,10:86:8c:5f:93:1e,17947930,336,2355,17947594,17947930
4433,4,11,1,2412,-77,-87,10,48:dd:0c:90:e3:83,17964269,323,16016,17963946,17964269
4434,4,11,1,2412,-83,-87,4,48:dd:0c:90:e3:85,17964604,382,-47,17964222,17964604
4435,4,1,1,2412,-86,-87,1,78:67:0e:c4:a8:42,17966190,2736,-1150,17963454,17966190
4436,4,1,1,2412,-86,-87,1,,17969692,304,3198,17969388,17969692
4437,4,1,1,2412,-85,-87,2,,17970851,304,855,17970547,17970851
4438,4,1,1,2412,-88,-87,-1,,17972290,352,1087,17971938,17972290
4439,6,6,1,2412,-80,-87,7,12:86:8c:5f:93:1e,17973530,332,908,17973198,17973530
4440,4,11,1,2412,-87,-87,0,,17975372,107,1735,17975265,17975372
4441,4,1,1,2412,-87,-87,0,ac:67:84:84:8a:07,17980821,416,5033,17980405,17980821
4442,4,1,1,2412,-78,-87,9,b0:e4:d5:32:ec:8a,17987836,1960,5055,17985876,17987836
4443,4,1,1,2412,-85,-87,2,,17991236,352,3048,17990884,17991236
4444,4,11,1,2412,-86,-87,1,,17992750,107,1407,17992643,17992750
4445,6,6,1,2412,-79,-87,8,32:86:8c:5f:93:1e,17999131,332,6049,17998799,17999131
4446,4,1,1,2412,-86,-87,1,b4:b5:2f:17:0c:b9,18005882,1376,5375,18004506,18005882
4447,6,6,1,2412,-76,-87,11,e2:db:d1:d1:b0:4a,18007123,444,797,18006679,18007123
4448,6,6,1,2412,-76,-87,11,e2:db:d1:d1:b0:4b,18007600,408,69,18007192,18007600
4449,6,6,1,2412,-76,-87,11,e2:db:d1:d1:b0:4d,18008050,408,42,18007642,18008050
4450,6,6,1,2412,-76,-87,11,e2:db:d1:d1:b0:4f,18008500,408,42,18008092,18008500
4451,4,1,1,2412,-85,-87,2,,18013463,304,4659,18013159,18013463
4452,4,1,1,2412,-79,-87,8,3c:bd:c5:ee:96:6d,18018667,2512,2692,18016155,18018667
4453,4,11,1,2412,-81,-87,6,48:dd:0c:7d:86:27,18030391,362,11362,18030029,18030391
4454,4,11,1,2412,-80,-87,7,48:dd:0c:7d:86:23,18030766,323,52,18030443,18030766
4455,4,11,1,2412,-80,-87,7,48:dd:0c:7d:86:25,18031101,382,-47,18030719,18031101
4456,6,24,1,2412,-82,-87,5,,18039769,28,8640,18039741,18039769
4457,4,1,1,2412,-86,-87,1,,18047514,304,7441,18047210,18047514
4458,4,11,1,2412,-86,-87,1,,18050364,107,2743,18050257,18050364
4459,6,6,1,2412,-80,-87,7,10:86:8c:5f:93:1e,18051082,336,382,18050746,18051082
4460,4,1,1,2412,-85,-87,2,b0:e8:92:05:d3:46,18051875,976,-183,18050899,18051875
4461,4,1,1,2412,-86,-87,1,78:67:0e:38:6c:d3,18057261,2736,2650,18054525,18057261
4462,4,11,1,2412,-82,-87,5,48:dd:0c:90:e3:85,18067004,382,9361,18066622,18067004
4463,4,1,1,2412,-83,-87,4,78:67:0e:c4:a8:42,18068590,2736,-1150,18065854,18068590
4464,4,11,1,2412,-83,-87,4,,18074381,107,5684,18074274,18074381
4465,4,1,1,2412,-84,-87,3,,18075002,352,269,18074650,18075002
4466,4,11,1,2412,-83,-87,4,,18078794,107,3685,18078687,18078794
4467,4,1,1,2412,-84,-87,3,,18079365,352,219,18079013,18079365
4468,4,11,1,2412,-85,-87,2,,18089024,107,9552,18088917,18089024
4469,4,1,1,2412,-85,-87,2,,18089604,352,228,18089252,18089604
4470,4,1,1,2412,-79,-87,8,b0:e4:d5:32:ec:8a,18090235,1960,-1329,18088275,18090235
4471,6,6,1,2412,-81,-87,6,32:86:8c:5f:93:1e,18101531,332,10964,18101199,18101531
4472,4,1,1,2412,-85,-87,2,b4:b5:2f:17:0c:b9,18108284,1376,5377,18106908,18108284
4473,6,6,1,2412,-76,-87,11,e2:db:d1:d1:b0:4a,18109543,444,815,18109099,18109543
4474,6,6,1,2412,-76,-87,11,e2:db:d1:d1:b0:4b,18110029,408,78,18109621,18110029
4475,4,1,1,2412,-86,-87,1,,18111035,448,558,18110587,18111035
4476,6,6,1,2412,-76,-87,11,e2:db:d1:d1:b0:4f,18111339,408,-104,18110931,18111339
4477,4,1,1,2412,-76,-87,11,3c:bd:c5:ee:96:6d,18120282,2512,6431,18117770,18120282
4478,4,1,1,2412,-83,-87,4,,18124782,304,4196,18124478,18124782
4479,4,1,1,2412,-84,-87,3,,18126195,352,1061,18125843,18126195
4480,4,1,1,2412,-91,-87,-4,,18129780,304,3281,18129476,18129780
4481,4,11,1,2412,-79,-87,8,48:dd:0c:7d:86:27,18132791,362,2649,18132429,18132791
4482,4,11,1,2412,-80,-87,7,48:dd:0c:7d:86:23,18133166,323,52,18132843,18133166
4483,4,11,1,2412,-79,-87,8,48:dd:0c:7d:86:25,18133501,382,-47,18133119,18133501
4484,6,6,1,2412,-76,-87,11,76:a2:c1:67:70:44,18145883,308,12074,18145575,18145883
4485,6,6,1,2412,-76,-87,11,e0:db:d1:d0:b0:48,18146645,308,454,18146337,18146645
4486,6,6,1,2412,-76,-87,11,b2:e2:49:f6:8a:4e,18147000,308,47,18146692,18147000
4487,6,6,1,2412,-76,-87,11,e0:db:d1:d0:b0:49,18148289,212,1077,18148077,18148289
4488,4,1,1,2412,-77,-87,10,3c:bd:c5:ee:96:6d,18154754,3280,3185,18151474,18154754
4489,4,1,1,2412,-79,-87,8,3c:bd:c5:ee:96:6d,18158420,3280,386,18155140,18158420
4490,4,1,1,2412,-80,-87,7,,18161712,304,2988,18161408,18161712
4491,4,1,1,2412,-78,-87,9,,18163617,304,1601,18163313,18163617
4492,4,1,1,2412,-77,-87,10,3c:bd:c5:ee:96:6d,18167285,3280,388,18164005,18167285
4493,6,6,1,2412,-77,-87,10,e0:db:d1:d0:b0:48,18170406,156,2965,18170250,18170406
4494,4,1,1,2412,-79,-87,8,3c:bd:c5:ee:96:6d,18174416,3280,730,18171136,18174416
4495,4,1,1,2412,-80,-87,7,,18177708,304,2988,18177404,18177708
4496,6,6,1,2412,-80,-87,7,12:86:8c:5f:93:1e,18178332,332,292,18178000,18178332
4497,6,6,1,2412,-77,-87,10,f8:4f:ad:f9:af:82,18183146,156,4658,18182990,18183146
4498,6,24,1,2412,-82,-87,5,,18185239,28,2065,18185211,18185239
4499,4,1,1,2412,-79,-87,8,b0:e4:d5:32:ec:8a,18192635,1960,5436,18190675,18192635
4500,6,6,1,2412,-80,-87,7,32:86:8c:5f:93:1e,18203932,332,10965,18203600,18203932
4501,6,6,1,2412,-85,-87,2,,18225120,44,21144,18225076,18225120
4502,4,1,1,2412,-87,-87,0,bc:98:df:ff:0f:8b,18226194,2568,-1494,18223626,18226194
4503,6,6,1,2412,-80,-87,7,52:86:8c:5f:93:1e,18229532,332,3006,18229200,18229532
4504,4,11,1,2412,-79,-87,8,48:dd:0c:7d:86:27,18235191,362,5297,18234829,18235191
4505,4,11,1,2412,-80,-87,7,48:dd:0c:7d:86:23,18235565,323,51,18235242,18235565
4506,4,11,1,2412,-79,-87,8,48:dd:0c:7d:86:25,18235901,382,-46,18235519,18235901
4507,6,24,1,2412,-82,-87,5,,18253921,28,17992,18253893,18253921
4508,6,6,1,2412,-81,-87,6,10:86:8c:5f:93:1e,18257121,336,2864,18256785,18257121
4509,4,1,1,2412,-87,-87,0,78:67:0e:38:6c:d3,18262061,2736,2204,18259325,18262061
4510,4,1,1,2412,-78,-87,9,,18270314,304,7949,18270010,18270314
4511,4,11,1,2412,-78,-87,9,48:dd:0c:90:e3:83,18271468,323,831,18271145,18271468
4512,4,11,1,2412,-82,-87,5,48:dd:0c:90:e3:85,18271804,382,-46,18271422,18271804
4513,6,6,1,2412,-76,-87,11,f8:4f:ad:f9:af:82,18272925,248,873,18272677,18272925
4514,6,24,1,2412,-83,-87,4,,18277810,28,4857,18277782,18277810
4515,4,1,1,2412,-86,-87,1,,18278750,304,636,18278446,18278750
4516,4,1,1,2412,-80,-87,7,b0:e4:d5:32:ec:8a,18295034,1960,14324,18293074,18295034
4517,6,6,1,2412,-81,-87,6,32:86:8c:5f:93:1e,18306333,332,10967,18306001,18306333
4518,6,6,1,2412,-76,-87,11,e2:db:d1:d1:b0:4a,18314778,444,8001,18314334,18314778
4519,6,6,1,2412,-77,-87,10,e2:db:d1:d1:b0:4b,18315246,408,60,18314838,18315246
4520,6,6,1,2412,-76,-87,11,e2:db:d1:d1:b0:4d,18315678,408,24,18315270,18315678
4521,6,6,1,2412,-76,-87,11,e2:db:d1:d1:b0:4f,18316110,408,24,18315702,18316110
4522,4,1,1,2412,-89,-87,-2,bc:98:df:ff:0f:8b,18318212,3176,-1074,18315036,18318212
4523,4,1,1,2412,-85,-87,2,,18321956,304,3440,18321652,18321956
4524,4,1,1,2412,-83,-87,4,3c:bd:c5:ee:96:6d,18324995,2512,527,18322483,18324995
4525,4,1,1,2412,-86,-87,1,,18329000,448,3557,18328552,18329000
4526,4,1,1,2412,-87,-87,0,bc:98:df:ff:0f:8b,18331505,2568,-63,18328937,18331505
4527,6,6,1,2412,-81,-87,6,52:86:8c:5f:93:1e,18333928,332,2091,18333596,18333928
4528,6,24,1,2412,-83,-87,4,,18334555,28,599,18334527,18334555
4529,4,11,1,2412,-80,-87,7,48:dd:0c:7d:86:27,18337591,362,2674,18337229,18337591
4530,4,11,1,2412,-80,-87,7,48:dd:0c:7d:86:23,18337965,323,51,18337642,18337965
4531,4,11,1,2412,-79,-87,8,48:dd:0c:7d:86:25,18338300,382,-47,18337918,18338300
4532,6,6,1,2412,-80,-87,7,b4:e6:2d:b4:ff:71,18338832,64,468,18338768,18338832
4533,6,6,1,2412,-80,-87,7,,18338912,44,36,18338868,18338912
4534,6,6,1,2412,-80,-87,7,b4:e6:2d:b4:ff:71,18339045,64,69,18338981,18339045
4535,6,6,1,2412,-81,-87,6,,18339125,44,36,18339081,18339125
4536,4,1,1,2412,-84,-87,3,,18342313,304,2884,18342009,18342313
4537,6,24,1,2412,-83,-87,4,,18345244,28,2903,18345216,18345244
4538,4,11,1,2412,-89,-87,-2,4c:01:43:d7:f3:23,18350112,322,4546,18349790,18350112
4539,6,24,1,2412,-83,-87,4,,18351650,28,1510,18351622,18351650
4540,6,6,1,2412,-80,-87,7,10:86:8c:5f:93:1e,18357533,336,5547,18357197,18357533
4541,4,1,1,2412,-88,-87,-1,78:67:0e:38:6c:d3,18364462,2736,4193,18361726,18364462
4542,4,11,1,2412,-77,-87,10,48:dd:0c:90:e3:87,18373494,362,8670,18373132,18373494
4543,4,11,1,2412,-77,-87,10,48:dd:0c:90:e3:83,18373868,323,51,18373545,18373868
4544,4,1,1,2412,-84,-87,3,,18375949,304,1777,18375645,18375949
4545,4,1,1,2412,-82,-87,5,78:67:0e:c4:a8:42,18376274,2736,-2411,18373538,18376274
4546,6,6,1,2412,-80,-87,7,12:86:8c:5f:93:1e,18383539,332,6933,18383207,18383539
4547,6,6,1,2412,-80,-87,7,32:86:8c:5f:93:1e,18408733,332,24862,18408401,18408733
4548,6,6,1,2412,-75,-87,12,e2:db:d1:d1:b0:4a,18416731,444,7554,18416287,18416731
4549,6,6,1,2412,-76,-87,11,e2:db:d1:d1:b0:4b,18417225,408,86,18416817,18417225
4550,4,1,1,2412,-84,-87,3,,18417804,304,275,18417500,18417804
4551,4,1,1,2412,-76,-87,11,3c:bd:c5:ee:96:6d,18428245,2512,7929,18425733,18428245
4552,4,1,1,2412,-86,-87,1,,18432189,448,3496,18431741,18432189
4553,6,6,1,2412,-81,-87,6,52:86:8c:5f:93:1e,18434334,332,1813,18434002,18434334
4554,4,1,1,2412,-88,-87,-1,38:01:46:30:1a:ca,18437463,416,2713,18437047,18437463
4555,6,24,1,2412,-83,-87,4,,18438418,28,927,18438390,18438418
4556,4,11,1,2412,-80,-87,7,48:dd:0c:7d:86:27,18439990,362,1210,18439628,18439990
4557,4,11,1,2412,-81,-87,6,48:dd:0c:7d:86:23,18440365,323,52,18440042,18440365
4558,4,11,1,2412,-80,-87,7,48:dd:0c:7d:86:25,18440700,382,-47,18440318,18440700
4559,6,6,1,2412,-80,-87,7,10:86:8c:5f:93:1e,18459934,336,18898,18459598,18459934
4560,4,1,1,2412,-82,-87,5,66:32:b1:64:4c:f2,18461858,2696,-772,18459162,18461858
4561,4,1,1,2412,-87,-87,0,78:67:0e:38:6c:d3,18466862,2736,2268,18464126,18466862
4562,4,1,1,2412,-83,-87,4,,18470275,304,3109,18469971,18470275
4563,4,11,1,2412,-77,-87,10,48:dd:0c:90:e3:87,18475893,362,5256,18475531,18475893
4564,4,11,1,2412,-77,-87,10,48:dd:0c:90:e3:83,18476268,323,52,18475945,18476268
4565,4,11,1,2412,-81,-87,6,48:dd:0c:90:e3:85,18476603,382,-47,18476221,18476603
4566,4,11,1,2412,-84,-87,3,,18477771,107,1061,18477664,18477771
4567,4,1,1,2412,-90,-87,-3,,18482842,352,4719,18482490,18482842
4568,4,11,1,2412,-85,-87,2,,18484680,107,1731,18484573,18484680
4569,4,1,1,2412,-86,-87,1,,18485250,352,218,18484898,18485250
4570,6,6,1,2412,-81,-87,6,12:86:8c:5f:93:1e,18486197,332,615,18485865,18486197
4571,6,24,1,2412,-83,-87,4,,18488420,28,2195,18488392,18488420
4572,4,1,1,2412,-79,-87,8,b0:e4:d5:32:ec:8a,18499833,1960,9453,18497873,18499833
4573,4,1,1,2412,-86,-87,1,c8:9e:43:bc:eb:fe,18508438,768,7837,18507670,18508438
4574,6,6,1,2412,-80,-87,7,32:86:8c:5f:93:1e,18511144,332,2374,18510812,18511144
4575,6,24,1,2412,-83,-87,4,,18511897,28,725,18511869,18511897
4576,4,1,1,2412,-83,-87,4,60:32:b1:64:4c:f2,18512839,3224,-2282,18509615,18512839
4577,4,1,1,2412,-86,-87,1,b4:b5:2f:17:0c:b9,18517891,1376,3676,18516515,18517891
4578,6,6,1,2412,-76,-87,11,e2:db:d1:d1:b0:4a,18519132,444,797,18518688,18519132
4579,6,6,1,2412,-76,-87,11,e2:db:d1:d1:b0:4b,18519618,408,78,18519210,18519618
4580,6,6,1,2412,-76,-87,11,e2:db:d1:d1:b0:4d,18520077,408,51,18519669,18520077
4581,6,6,1,2412,-76,-87,11,e2:db:d1:d1:b0:4f,18520518,408,33,18520110,18520518
4582,4,1,1,2412,-91,-87,-4,ce:f4:11:65:3f:f8,18521776,2072,-814,18519704,18521776
4583,4,1,1,2412,-83,-87,4,,18528753,304,6673,18528449,18528753
4584,4,1,1,2412,-79,-87,8,3c:bd:c5:ee:96:6d,18530602,2512,-663,18528090,18530602
4585,4,1,1,2412,-88,-87,-1,bc:98:df:ff:0f:8b,18533373,2568,203,18530805,18533373
4586,6,6,1,2412,-81,-87,6,52:86:8c:5f:93:1e,18536735,332,3030,18536403,18536735
4587,4,11,1,2412,-81,-87,6,48:dd:0c:7d:86:27,18542390,362,5293,18542028,18542390
4588,4,11,1,2412,-80,-87,7,48:dd:0c:7d:86:23,18542765,323,52,18542442,18542765
4589,4,11,1,2412,-79,-87,8,48:dd:0c:7d:86:25,18543100,382,-47,18542718,18543100
4590,6,24,1,2412,-83,-87,4,,18574070,28,30942,18574042,18574070
4591,4,11,1,2412,-77,-87,10,48:dd:0c:90:e3:87,18578293,362,3861,18577931,18578293
4592,4,11,1,2412,-76,-87,11,48:dd:0c:90:e3:83,18578668,323,52,18578345,18578668
4593,4,11,1,2412,-82,-87,5,48:dd:0c:90:e3:85,18579003,382,-47,18578621,18579003
4594,6,6,1,2412,-80,-87,7,12:86:8c:5f:93:1e,18589647,332,10312,18589315,18589647
4595,6,24,1,2412,-82,-87,5,,18590986,28,1311,18590958,18590986
4596,4,1,1,2412,-86,-87,1,,18591271,304,-19,18590967,18591271
4597,4,1,1,2412,-78,-87,9,b0:e4:d5:32:ec:8a,18602232,1960,9001,18600272,18602232
4598,6,6,1,2412,-75,-87,12,e2:db:d1:d1:b0:4a,18621401,444,18725,18620957,18621401
4599,4,1,1,2412,-88,-87,-1,,18625144,448,3295,18624696,18625144
4600,4,1,1,2412,-84,-87,3,,18625715,304,267,18625411,18625715
4601,4,1,1,2412,-86,-87,1,,18626030,448,-133,18625582,18626030
4602,4,1,1,2412,-79,-87,8,3c:bd:c5:ee:96:6d,18632206,2512,3664,18629694,18632206
4603,4,1,1,2412,-78,-87,9,b8:f8:53:cb:31:f1,18634744,976,1562,18633768,18634744
4604,4,1,1,2412,-88,-87,-1,bc:98:df:ff:0f:8b,18635759,2568,-1553,18633191,18635759
4605,6,6,1,2412,-81,-87,6,52:86:8c:5f:93:1e,18639136,332,3045,18638804,18639136
4606,4,1,1,2412,-78,-87,9,,18644808,304,5368,18644504,18644808
4607,6,6,1,2412,-79,-87,8,10:86:8c:5f:93:1e,18644958,500,-350,18644458,18644958
4608,4,11,1,2412,-79,-87,8,48:dd:0c:7d:86:27,18645608,362,288,18645246,18645608
4609,4,11,1,2412,-80,-87,7,48:dd:0c:7d:86:23,18645982,323,51,18645659,18645982
4610,4,11,1,2412,-79,-87,8,48:dd:0c:7d:86:25,18646318,382,-46,18645936,18646318
4611,4,1,1,2412,-82,-87,5,,18646782,304,160,18646478,18646782
4612,6,6,1,2412,-80,-87,7,10:86:8c:5f:93:1e,18646931,500,-351,18646431,18646931
4613,4,1,1,2412,-78,-87,9,,18647703,304,468,18647399,18647703
4614,6,6,1,2412,-80,-87,7,10:86:8c:5f:93:1e,18647852,500,-351,18647352,18647852
4615,6,24,1,2412,-83,-87,4,,18656378,28,8498,18656350,18656378
4616,6,6,1,2412,-79,-87,8,10:86:8c:5f:93:1e,18665398,336,8684,18665062,18665398
4617,4,1,1,2412,-85,-87,2,,18669522,304,3820,18669218,18669522
4618,6,6,1,2412,-76,-87,11,f8:4f:ad:f9:af:82,18670792,576,694,18670216,18670792
4619,4,11,1,2412,-77,-87,10,48:dd:0c:90:e3:83,18681067,323,9952,18680744,18681067
4620,4,11,1,2412,-83,-87,4,48:dd:0c:90:e3:85,18681403,382,-46,18681021,18681403
4621,4,1,1,2412,-84,-87,3,78:67:0e:c4:a8:42,18682989,2736,-1150,18680253,18682989
4622,6,6,1,2412,-81,-87,6,12:86:8c:5f:93:1e,18690336,332,7015,18690004,18690336
4623,4,1,1,2412,-84,-87,3,,18691449,304,809,18691145,18691449
4624,4,1,1,2412,-77,-87,10,b0:e4:d5:32:ec:8a,18704631,1960,11222,18702671,18704631
4625,6,6,1,2412,-79,-87,8,32:86:8c:5f:93:1e,18715936,332,10973,18715604,18715936
4626,4,1,1,2412,-84,-87,3,b4:b5:2f:17:0c:b9,18723575,1376,6263,18722199,18723575
4627,6,6,1,2412,-76,-87,11,e2:db:d1:d1:b0:4a,18724807,444,788,18724363,18724807
4628,6,6,1,2412,-76,-87,11,e2:db:d1:d1:b0:4b,18725275,408,60,18724867,18725275
4629,4,1,1,2412,-86,-87,1,,18728474,448,2751,18728026,18728474
4630,6,24,1,2412,-82,-87,5,,18733927,28,5425,18733899,18733927
4631,6,6,1,2412,-80,-87,7,52:86:8c:5f:93:1e,18741536,332,7277,18741204,18741536
4632,6,24,1,2412,-82,-87,5,,18745250,28,3686,18745222,18745250
4633,4,11,1,2412,-80,-87,7,48:dd:0c:7d:86:27,18747190,362,1578,18746828,18747190
4634,4,11,1,2412,-80,-87,7,48:dd:0c:7d:86:23,18747564,323,51,18747241,18747564
4635,4,1,1,2412,-84,-87,3,,18754288,304,6420,18753984,18754288
4636,6,24,1,2412,-82,-87,5,,18758607,28,4291,18758579,18758607
4637,6,6,1,2412,-79,-87,8,10:86:8c:5f:93:1e,18767136,336,8193,18766800,18767136
4638,4,1,1,2412,-87,-87,0,78:67:0e:38:6c:d3,18774062,2736,4190,18771326,18774062
4639,4,1,1,2412,-83,-87,4,,18777245,304,2879,18776941,18777245
4640,4,11,1,2412,-77,-87,10,48:dd:0c:90:e3:87,18783093,362,5486,18782731,18783093
4641,4,11,1,2412,-77,-87,10,48:dd:0c:90:e3:83,18783467,323,51,18783144,18783467
4642,4,1,1,2412,-85,-87,2,78:67:0e:c4:a8:42,18785389,2736,-814,18782653,18785389
4643,6,6,1,2412,-80,-87,7,12:86:8c:5f:93:1e,18792737,332,7016,18792405,18792737
4644,4,1,1,2412,-89,-87,-2,00:26:62:eb:ea:74,18798569,968,4864,18797601,18798569
4645,4,1,1,2412,-79,-87,8,b0:e4:d5:32:ec:8a,18807031,1960,6502,18805071,18807031
4646,6,24,1,2412,-83,-87,4,,18813926,28,6867,18813898,18813926
4647,4,1,1,2412,-82,-87,5,,18818395,304,4165,18818091,18818395
4648,6,6,1,2412,-80,-87,7,32:86:8c:5f:93:1e,18818850,332,123,18818518,18818850
4649,6,6,1,2412,-84,-87,3,,18819317,44,423,18819273,18819317
4650,6,6,1,2412,-76,-87,11,e2:db:d1:d1:b0:4b,18828012,408,8287,18827604,18828012
4651,6,6,1,2412,-76,-87,11,e2:db:d1:d1:b0:4d,18828444,408,24,18828036,18828444
4652,6,6,1,2412,-77,-87,10,e2:db:d1:d1:b0:4f,18828894,408,42,18828486,18828894
4653,4,1,1,2412,-86,-87,1,ce:9e:43:bc:eb:ff,18833057,3800,363,18829257,18833057
4654,6,6,1,2412,-77,-87,10,52:86:8c:5f:93:1e,18843936,332,10547,18843604,18843936
4655,4,1,1,2412,-87,-87,0,,18844466,448,82,18844018,18844466
4656,4,11,1,2412,-79,-87,8,48:dd:0c:7d:86:25,18850299,382,5451,18849917,18850299
4657,4,1,1,2412,-85,-87,2,78:67:0e:c4:a8:42,18875956,848,24809,18875108,18875956
4658,4,1,1,2412,-86,-87,1,78:67:0e:38:6c:d3,18876825,2736,-1867,18874089,18876825
4659,4,1,1,2412,-85,-87,2,,18879599,352,2422,18879247,18879599
4660,4,1,1,2412,-86,-87,1,78:67:0e:38:6c:d2,18880460,832,29,18879628,18880460
4661,4,1,1,2412,-80,-87,7,,18881980,352,1168,18881628,18881980
4662,4,1,1,2412,-83,-87,4,,18882952,352,620,18882600,18882952
4663,4,1,1,2412,-82,-87,5,,18883798,352,494,18883446,18883798
4664,4,1,1,2412,-77,-87,10,,18884943,352,793,18884591,18884943
4665,4,11,1,2412,-76,-87,11,48:dd:0c:90:e3:87,18885492,362,187,18885130,18885492
4666,4,11,1,2412,-77,-87,10,48:dd:0c:90:e3:83,18885867,323,52,18885544,18885867
4667,4,11,1,2412,-77,-87,10,48:dd:0c:90:e3:85,18886202,382,-47,18885820,18886202
4668,4,1,1,2412,-83,-87,4,78:67:0e:c4:a8:42,18887789,2736,-1149,18885053,18887789
4669,4,1,1,2412,-86,-87,1,,18890554,352,2413,18890202,18890554
4670,6,24,1,2412,-82,-87,5,,18893928,28,3346,18893900,18893928
4671,6,6,1,2412,-81,-87,6,12:86:8c:5f:93:1e,18895137,332,877,18894805,18895137
4672,6,24,1,2412,-83,-87,4,,18905248,28,10083,18905220,18905248
4673,4,1,1,2412,-88,-87,-1,ac:67:84:84:8a:07,18907173,416,1509,18906757,18907173
4674,4,1,1,2412,-78,-87,9,b0:e4:d5:32:ec:8a,18909430,1960,297,18907470,18909430
4675,6,6,1,2412,-79,-87,8,32:86:8c:5f:93:1e,18920737,332,10975,18920405,18920737
4676,6,6,1,2412,-76,-87,11,f8:4f:ad:f9:af:82,18922316,576,1003,18921740,18922316
4677,6,6,1,2412,-75,-87,12,f8:4f:ad:f9:af:82,18924699,548,1835,18924151,18924699
4678,6,6,1,2412,-76,-87,11,e2:db:d1:d1:b0:4b,18929918,408,4811,18929510,18929918
4679,6,6,1,2412,-76,-87,11,e2:db:d1:d1:b0:4d,18930359,408,33,18929951,18930359
4680,6,6,1,2412,-77,-87,10,e2:db:d1:d1:b0:4f,18930791,408,24,18930383,18930791
4681,4,1,1,2412,-87,-87,0,ac:67:84:84:8a:07,18931391,416,184,18930975,18931391
4682,4,1,1,2412,-89,-87,-2,,18931819,304,124,18931515,18931819
4683,4,1,1,2412,-85,-87,2,,18934065,448,1798,18933617,18934065
4684,4,1,1,2412,-80,-87,7,3c:bd:c5:ee:96:6d,18940204,2512,3627,18937692,18940204
4685,4,11,1,2412,-88,-87,-1,4c:01:43:d7:f3:26,18964843,387,24252,18964456,18964843
4686,6,6,1,2412,-79,-87,8,10:86:8c:5f:93:1e,18971938,336,6759,18971602,18971938
4687,4,1,1,2412,-85,-87,2,,18976070,352,3780,18975718,18976070
4688,4,1,1,2412,-85,-87,2,,18977324,304,950,18977020,18977324
4689,6,24,1,2412,-82,-87,5,,18979656,32,2300,18979624,18979656
4690,4,1,1,2412,-86,-87,1,78:67:0e:38:6c:d3,18979887,2736,-2505,18977151,18979887
4691,4,1,1,2412,-83,-87,4,,18983860,352,3621,18983508,18983860
4692,4,1,1,2412,-85,-87,2,,18984729,352,517,18984377,18984729
4693,4,1,1,2412,-77,-87,10,,18985634,352,553,18985282,18985634
4694,4,11,1,2412,-77,-87,10,48:dd:0c:90:e3:83,18988267,323,2310,18987944,18988267
4695,4,11,1,2412,-81,-87,6,48:dd:0c:90:e3:85,18988602,382,-47,18988220,18988602
4696,4,1,1,2412,-85,-87,2,78:67:0e:c4:a8:42,18990189,2736,-1149,18987453,18990189
4697,4,1,1,2412,-88,-87,-1,ac:67:84:84:8a:07,18994823,416,4218,18994407,18994823
4698,4,1,1,2412,-89,-87,-2,,18995251,304,124,18994947,18995251
4699,6,6,1,2412,-80,-87,7,12:86:8c:5f:93:1e,18997538,332,1955,18997206,18997538
4700,6,24,1,2412,-83,-87,4,,19016514,32,18944,19016482,19016514
4701,6,24,1,2412,-83,-87,4,,19016732,32,186,19016700,19016732
4702,6,24,1,2412,-83,-87,4,,19016897,32,133,19016865,19016897
4703,6,6,1,2412,-82,-87,5,,19018252,44,1311,19018208,19018252
4704,6,6,1,2412,-81,-87,6,32:86:8c:5f:93:1e,19023138,332,4554,19022806,19023138
4705,4,1,1,2412,-85,-87,2,b4:b5:2f:17:0c:b9,19029900,1376,5386,19028524,19029900
4706,6,6,1,2412,-76,-87,11,e2:db:d1:d1:b0:4a,19031141,444,797,19030697,19031141
4707,6,6,1,2412,-75,-87,12,e2:db:d1:d1:b0:4b,19031609,408,60,19031201,19031609
4708,6,6,1,2412,-76,-87,11,e2:db:d1:d1:b0:4d,19032068,408,51,19031660,19032068
4709,6,6,1,2412,-76,-87,11,e2:db:d1:d1:b0:4f,19032509,408,33,19032101,19032509
4710,4,1,1,2412,-87,-87,0,ac:67:84:84:8a:07,19033720,416,795,19033304,19033720
4711,4,1,1,2412,-90,-87,-3,,19034149,304,125,19033845,19034149
4712,6,6,1,2412,-84,-87,3,,19041126,44,6933,19041082,19041126
4713,4,1,1,2412,-79,-87,8,3c:bd:c5:ee:96:6d,19041785,2512,-1853,19039273,19041785
4714,4,1,1,2412,-88,-87,-1,bc:98:df:ff:0f:8b,19045366,2568,1013,19042798,19045366
4715,6,6,1,2412,-80,-87,7,52:86:8c:5f:93:1e,19048738,332,3040,19048406,19048738
4716,4,11,1,2412,-78,-87,9,48:dd:0c:7d:86:23,19054765,323,5704,19054442,19054765
4717,4,11,1,2412,-79,-87,8,48:dd:0c:7d:86:25,19055100,382,-47,19054718,19055100
4718,4,1,1,2412,-87,-87,0,c8:9e:43:bc:eb:ff,19062955,3496,4359,19059459,19062955
4719,6,24,1,2412,-82,-87,5,,19070221,28,7238,19070193,19070221
4720,6,6,1,2412,-80,-87,7,10:86:8c:5f:93:1e,19074339,336,3782,19074003,19074339
4721,6,6,1,2412,-84,-87,3,,19075458,44,1075,19075414,19075458
4722,4,11,1,2412,-85,-87,2,,19084391,203,8730,19084188,19084391
4723,4,11,1,2412,-82,-87,5,48:dd:0c:90:e3:85,19091002,382,6229,19090620,19091002
4724,4,1,1,2412,-86,-87,1,78:67:0e:c4:a8:42,19092588,2736,-1150,19089852,19092588
4725,4,1,1,2412,-83,-87,4,,19095352,352,2412,19095000,19095352
4726,4,11,1,2412,-85,-87,2,,19097189,107,1730,19097082,19097189
4727,4,1,1,2412,-83,-87,4,,19097765,352,224,19097413,19097765
4728,6,6,1,2412,-81,-87,6,12:86:8c:5f:93:1e,19100030,332,1933,19099698,19100030
4729,4,1,1,2412,-78,-87,9,b0:e4:d5:32:ec:8a,19114229,1960,12239,19112269,19114229
4730,4,11,1,2412,-88,-87,-1,,19117062,203,2630,19116859,19117062
4731,6,6,1,2412,-86,-87,1,,19118084,44,978,19118040,19118084
4732,6,24,1,2412,-84,-87,3,,19118444,32,328,19118412,19118444
4733,6,24,1,2412,-82,-87,5,,19120543,32,2067,19120511,19120543
4734,6,24,1,2412,-82,-87,5,,19120777,32,202,19120745,19120777
4735,6,6,1,2412,-79,-87,8,32:86:8c:5f:93:1e,19125539,332,4430,19125207,19125539
4736,4,1,1,2412,-72,-87,15,b4:b5:2f:17:0c:b9,19132302,1376,5387,19130926,19132302
4737,6,6,1,2412,-76,-87,11,e2:db:d1:d1:b0:4a,19133543,444,797,19133099,19133543
4738,6,6,1,2412,-76,-87,11,e2:db:d1:d1:b0:4f,19134902,408,951,19134494,19134902
4739,4,11,1,2412,-85,-87,2,,19136352,107,1343,19136245,19136352
4740,4,1,1,2412,-91,-87,-4,,19138343,384,1607,19137959,19138343
4741,4,1,1,2412,-86,-87,1,,19138741,448,-50,19138293,19138741
4742,4,1,1,2412,-88,-87,-1,,19139220,384,95,19138836,19139220
4743,4,1,1,2412,-86,-87,1,,19139618,448,-50,19139170,19139618
4744,4,1,1,2412,-79,-87,8,3c:bd:c5:ee:96:6d,19145080,2512,2950,19142568,19145080
4745,4,1,1,2412,-87,-87,0,bc:98:df:ff:0f:8b,19147773,2568,125,19145205,19147773
4746,6,6,1,2412,-81,-87,6,52:86:8c:5f:93:1e,19151139,332,3034,19150807,19151139
4747,4,11,1,2412,-80,-87,7,48:dd:0c:7d:86:23,19152000,254,607,19151746,19152000
4748,4,1,1,2412,-86,-87,1,,19152501,352,149,19152149,19152501
4749,4,1,1,2412,-83,-87,4,,19154124,352,1271,19153772,19154124
4750,4,1,1,2412,-84,-87,3,,19155646,352,1170,19155294,19155646
4751,4,11,1,2412,-77,-87,10,48:dd:0c:7d:86:27,19156790,362,782,19156428,19156790
4752,4,11,1,2412,-77,-87,10,48:dd:0c:7d:86:23,19157164,323,51,19156841,19157164
4753,4,11,1,2412,-79,-87,8,48:dd:0c:7d:86:25,19157500,382,-46,19157118,19157500
4754,4,1,1,2412,-80,-87,7,,19159529,352,1677,19159177,19159529
4755,4,1,1,2412,-84,-87,3,,19162508,352,2627,19162156,19162508
4756,4,1,1,2412,-86,-87,1,,19163032,352,172,19162680,19163032
4757,4,1,1,2412,-82,-87,5,,19164074,352,690,19163722,19164074
4758,4,1,1,2412,-84,-87,3,,19164742,352,316,19164390,19164742
4759,4,1,1,2412,-83,-87,4,,19165257,352,163,19164905,19165257
4760,4,1,1,2412,-89,-87,-2,,19169682,352,4073,19169330,19169682
4761,4,1,1,2412,-84,-87,3,,19172412,352,2378,19172060,19172412
4762,6,24,1,2412,-82,-87,5,,19173367,32,923,19173335,19173367
4763,6,24,1,2412,-82,-87,5,,19174981,32,1582,19174949,19174981
4764,6,6,1,2412,-76,-87,11,f8:4f:ad:f9:af:82,19175093,576,-464,19174517,19175093
4765,4,1,1,2412,-83,-87,4,,19177935,352,2490,19177583,19177935
4766,4,1,1,2412,-85,-87,2,,19178742,304,503,19178438,19178742
4767,4,1,1,2412,-83,-87,4,,19179794,304,748,19179490,19179794
4768,4,1,1,2412,-85,-87,2,78:67:0e:38:6c:d3,19183667,2736,1137,19180931,19183667
4769,4,1,1,2412,-86,-87,1,78:67:0e:38:6c:d3,19186459,848,1944,19185611,19186459
4770,4,11,1,2412,-77,-87,10,48:dd:0c:90:e3:83,19193066,323,6284,19192743,19193066
4771,4,11,1,2412,-80,-87,7,48:dd:0c:90:e3:85,19193401,382,-47,19193019,19193401
4772,6,24,1,2412,-83,-87,4,,19193752,28,323,19193724,19193752
4773,4,1,1,2412,-84,-87,3,78:67:0e:c4:a8:42,19194988,2736,-1500,19192252,19194988
4774,4,11,1,2412,-87,-87,0,,19198828,203,3637,19198625,19198828
4775,4,11,1,2412,-85,-87,2,,19200900,203,1869,19200697,19200900
4776,4,11,1,2412,-86,-87,1,,19201372,203,269,19201169,19201372
4777,4,11,1,2412,-87,-87,0,,19202322,203,747,19202119,19202322
4778,4,11,1,2412,-85,-87,2,,19203259,203,734,19203056,19203259
4779,6,6,1,2412,-79,-87,8,12:86:8c:5f:93:1e,19203926,332,335,19203594,19203926
4780,4,1,1,2412,-84,-87,3,,19210558,352,6280,19210206,19210558
4781,4,1,1,2412,-79,-87,8,b0:e4:d5:32:ec:8a,19216628,1960,4110,19214668,19216628
4782,4,1,1,2412,-84,-87,3,,19223664,304,6732,19223360,19223664
4783,6,24,1,2412,-82,-87,5,,19225397,28,1705,19225369,19225397
4784,6,6,1,2412,-80,-87,7,32:86:8c:5f:93:1e,19227940,332,2211,19227608,19227940
4785,4,1,1,2412,-75,-87,12,b4:b5:2f:17:0c:b9,19234703,1376,5387,19233327,19234703
4786,6,6,1,2412,-76,-87,11,e2:db:d1:d1:b0:4a,19235936,444,789,19235492,19235936
4787,6,6,1,2412,-76,-87,11,e2:db:d1:d1:b0:4b,19236422,408,78,19236014,19236422
4788,6,6,1,2412,-76,-87,11,e2:db:d1:d1:b0:4d,19236881,408,51,19236473,19236881
4789,6,6,1,2412,-77,-87,10,e2:db:d1:d1:b0:4f,19237339,408,50,19236931,19237339
4790,6,24,1,2412,-83,-87,4,,19237831,28,464,19237803,19237831
4791,4,11,1,2412,-84,-87,3,,19238107,203,73,19237904,19238107
4792,4,11,1,2412,-88,-87,-1,,19238651,203,341,19238448,19238651
4793,6,24,1,2412,-82,-87,5,,19239525,32,842,19239493,19239525
4794,4,1,1,2412,-86,-87,1,,19241556,448,1583,19241108,19241556
4795,4,1,1,2412,-79,-87,8,3c:bd:c5:ee:96:6d,19246587,2512,2519,19244075,19246587
4796,4,1,1,2412,-87,-87,0,bc:98:df:ff:0f:8b,19250171,2568,1016,19247603,19250171
4797,6,6,1,2412,-80,-87,7,52:86:8c:5f:93:1e,19253619,332,3116,19253287,19253619
4798,4,11,1,2412,-79,-87,8,48:dd:0c:7d:86:27,19259190,362,5209,19258828,19259190
4799,4,11,1,2412,-79,-87,8,48:dd:0c:7d:86:23,19259564,323,51,19259241,19259564
4800,4,11,1,2412,-80,-87,7,48:dd:0c:7d:86:25,19259899,382,-47,19259517,19259899
4801,6,24,1,2412,-82,-87,5,,19265538,32,5607,19265506,19265538
4802,4,1,1,2412,-87,-87,0,ac:67:84:84:8a:07,19273833,416,7879,19273417,19273833
4803,6,6,1,2412,-75,-87,12,f8:4f:ad:f9:af:82,19278451,248,4370,19278203,19278451
4804,4,1,1,2412,-87,-87,0,,19278871,304,116,19278567,19278871
4805,4,11,1,2412,-87,-87,0,10:86:8c:5f:93:26,19279863,347,645,19279516,19279863
4806,4,1,1,2412,-85,-87,2,,19280337,352,122,19279985,19280337
4807,4,1,1,2412,-84,-87,3,,19282051,352,1362,19281699,19282051
4808,4,1,1,2412,-82,-87,5,,19282900,352,497,19282548,19282900
4809,4,1,1,2412,-83,-87,4,,19283748,352,496,19283396,19283748
4810,4,1,1,2412,-84,-87,3,,19284636,352,536,19284284,19284636
4811,4,1,1,2412,-83,-87,4,,19286067,352,1079,19285715,19286067
4812,4,1,1,2412,-83,-87,4,,19288109,352,1690,19287757,19288109
4813,4,1,1,2412,-84,-87,3,,19288963,352,502,19288611,19288963
4814,4,1,1,2412,-85,-87,2,,19290844,352,1529,19290492,19290844
4815,4,1,1,2412,-77,-87,10,,19291917,352,721,19291565,19291917
4816,4,1,1,2412,-78,-87,9,,19292779,352,510,19292427,19292779
4817,4,1,1,2412,-86,-87,1,,19296471,352,3340,19296119,19296471
4818,4,1,1,2412,-80,-87,7,78:67:0e:c4:a8:42,19297388,2736,-1819,19294652,19297388
4819,6,6,1,2412,-80,-87,7,12:86:8c:5f:93:1e,19304740,332,7020,19304408,19304740
4820,6,24,1,2412,-83,-87,4,,19317829,28,13061,19317801,19317829
4821,6,6,1,2412,-81,-87,6,32:86:8c:5f:93:1e,19330340,332,12179,19330008,19330340
4822,6,6,1,2412,-76,-87,11,e2:db:d1:d1:b0:4a,19338365,444,7581,19337921,19338365
4823,6,6,1,2412,-77,-87,10,e2:db:d1:d1:b0:4b,19338833,408,60,19338425,19338833
4824,6,6,1,2412,-77,-87,10,e2:db:d1:d1:b0:4d,19339273,408,32,19338865,19339273
4825,6,6,1,2412,-77,-87,10,e2:db:d1:d1:b0:4f,19339732,408,51,19339324,19339732
4826,4,1,1,2412,-87,-87,0,,19343906,384,3790,19343522,19343906
4827,4,1,1,2412,-84,-87,3,,19344305,448,-49,19343857,19344305
4828,4,1,1,2412,-86,-87,1,,19345182,448,429,19344734,19345182
4829,4,1,1,2412,-86,-87,1,38:01:46:30:1a:ca,19347231,416,1633,19346815,19347231
4830,4,1,1,2412,-79,-87,8,3c:bd:c5:ee:96:6d,19349868,2512,125,19347356,19349868
4831,4,1,1,2412,-86,-87,1,ac:67:84:84:8a:07,19356089,416,5805,19355673,19356089
4832,4,11,1,2412,-80,-87,7,48:dd:0c:7d:86:25,19362299,382,5828,19361917,19362299
4833,4,1,1,2412,-86,-87,1,38:01:46:30:1a:ca,19368457,416,5742,19368041,19368457
4834,4,1,1,2412,-77,-87,10,b0:e4:d5:32:ec:8a,19372861,1912,2492,19370949,19372861
4835,6,24,1,2412,-84,-87,3,,19374728,28,1839,19374700,19374728
4836,4,1,1,2412,-88,-87,-1,66:32:b1:64:4c:f2,19384930,2696,7506,19382234,19384930
4837,4,1,1,2412,-88,-87,-1,78:67:0e:38:6c:d3,19388463,2736,797,19385727,19388463
4838,4,1,1,2412,-81,-87,6,78:67:0e:c4:a8:42,19401768,2736,10569,19399032,19401768
4839,4,1,1,2412,-84,-87,3,,19405359,304,3287,19405055,19405359
4840,4,1,1,2412,-84,-87,3,,19406577,304,914,19406273,19406577
4841,6,6,1,2412,-79,-87,8,12:86:8c:5f:93:1e,19407141,332,232,19406809,19407141
4842,4,1,1,2412,-78,-87,9,b0:e4:d5:32:ec:8a,19421427,1960,12326,19419467,19421427
4843,4,1,1,2412,-86,-87,1,,19425304,304,3573,19425000,19425304
4844,4,1,1,2412,-83,-87,4,,19426355,304,747,19426051,19426355
4845,6,6,1,2412,-76,-87,11,f8:4f:ad:f9:af:82,19428527,1332,840,19427195,19428527
4846,6,6,1,2412,-81,-87,6,32:86:8c:5f:93:1e,19433057,332,4198,19432725,19433057
4847,4,1,1,2412,-86,-87,1,b4:b5:2f:17:0c:b9,19439507,1376,5074,19438131,19439507
4848,6,6,1,2412,-76,-87,11,e2:db:d1:d1:b0:4a,19440739,444,788,19440295,19440739
4849,6,6,1,2412,-76,-87,11,e2:db:d1:d1:b0:4b,19441207,408,60,19440799,19441207
4850,6,6,1,2412,-76,-87,11,e2:db:d1:d1:b0:4d,19441648,408,33,19441240,19441648
4851,6,6,1,2412,-76,-87,11,e2:db:d1:d1:b0:4f,19442107,408,51,19441699,19442107
4852,4,1,1,2412,-85,-87,2,,19447102,448,4547,19446654,19447102
4853,4,1,1,2412,-79,-87,8,3c:bd:c5:ee:96:6d,19452270,2512,2656,19449758,19452270
4854,4,1,1,2412,-87,-87,0,bc:98:df:ff:0f:8b,19454958,2568,120,19452390,19454958
4855,6,6,1,2412,-81,-87,6,52:86:8c:5f:93:1e,19459174,332,3884,19458842,19459174
4856,4,11,1,2412,-80,-87,7,48:dd:0c:7d:86:27,19463989,362,4453,19463627,19463989
4857,4,11,1,2412,-80,-87,7,48:dd:0c:7d:86:23,19464364,323,52,19464041,19464364
4858,4,11,1,2412,-80,-87,7,48:dd:0c:7d:86:25,19464699,382,-47,19464317,19464699
4859,6,6,1,2412,-81,-87,6,b4:e6:2d:b4:ff:71,19464961,64,198,19464897,19464961
4860,6,6,1,2412,-80,-87,7,,19465041,44,36,19464997,19465041
4861,4,1,1,2412,-85,-87,2,,19468628,304,3283,19468324,19468628
4862,6,24,1,2412,-82,-87,5,,19478358,28,9702,19478330,19478358
4863,4,1,1,2412,-85,-87,2,,19489123,304,10461,19488819,19489123
4864,4,1,1,2412,-86,-87,1,78:67:0e:38:6c:d3,19490863,2736,-996,19488127,19490863
4865,6,6,1,2412,-80,-87,7,12:86:8c:5f:93:1e,19509541,332,18346,19509209,19509541
4866,4,1,1,2412,-86,-87,1,ac:67:84:84:8a:07,19521507,416,11550,19521091,19521507
4867,4,1,1,2412,-84,-87,3,,19522040,304,229,19521736,19522040
4868,4,1,1,2412,-80,-87,7,b0:e4:d5:32:ec:8a,19523826,1960,-174,19521866,19523826
4869,4,1,1,2412,-86,-87,1,,19527769,304,3639,19527465,19527769
4870,6,6,1,2412,-81,-87,6,32:86:8c:5f:93:1e,19535229,332,7128,19534897,19535229
4871,6,24,1,2412,-83,-87,4,,19535670,28,413,19535642,19535670
4872,4,1,1,2412,-83,-87,4,b4:b5:2f:17:0c:b9,19541909,1376,4863,19540533,19541909
4873,6,6,1,2412,-76,-87,11,e2:db:d1:d1:b0:4d,19545139,408,2822,19544731,19545139
4874,6,6,1,2412,-76,-87,11,e2:db:d1:d1:b0:4f,19545580,408,33,19545172,19545580
4875,4,1,1,2412,-86,-87,1,,19549871,448,3843,19549423,19549871
4876,4,1,1,2412,-86,-87,1,,19550757,448,438,19550309,19550757
4877,6,6,1,2412,-81,-87,6,52:86:8c:5f:93:1e,19560742,332,9653,19560410,19560742
4878,4,11,1,2412,-80,-87,7,48:dd:0c:7d:86:27,19566389,362,5285,19566027,19566389
4879,4,11,1,2412,-80,-87,7,48:dd:0c:7d:86:23,19566763,323,51,19566440,19566763
4880,4,11,1,2412,-80,-87,7,48:dd:0c:7d:86:25,19567099,382,-46,19566717,19567099
4881,4,1,1,2412,-87,-87,0,ac:67:84:84:8a:07,19578020,416,10505,19577604,19578020
4882,4,1,1,2412,-86,-87,1,68:54:fd:aa:49:4f,19581323,912,2391,19580411,19581323
4883,6,24,1,2412,-83,-87,4,,19583181,32,1826,19583149,19583181
4884,4,1,1,2412,-84,-87,3,,19589568,304,6083,19589264,19589568
4885,4,1,1,2412,-87,-87,0,78:67:0e:38:6c:d3,19593263,2736,959,19590527,19593263
4886,4,11,1,2412,-77,-87,10,48:dd:0c:90:e3:87,19602291,362,8666,19601929,19602291
4887,4,11,1,2412,-77,-87,10,48:dd:0c:90:e3:83,19602665,323,51,19602342,19602665
4888,4,11,1,2412,-83,-87,4,48:dd:0c:90:e3:85,19603000,382,-47,19602618,19603000
4889,4,1,1,2412,-84,-87,3,78:67:0e:c4:a8:42,19604588,2736,-1148,19601852,19604588
4890,6,24,1,2412,-82,-87,5,,19625260,28,20644,19625232,19625260
4891,4,1,1,2412,-78,-87,9,b0:e4:d5:32:ec:8a,19626225,1960,-995,19624265,19626225
4892,4,1,1,2412,-85,-87,2,68:54:fd:aa:49:4f,19628385,912,1248,19627473,19628385
4893,4,1,1,2412,-84,-87,3,68:54:fd:aa:49:4f,19630158,912,861,19629246,19630158
4894,6,6,1,2412,-80,-87,7,32:86:8c:5f:93:1e,19637543,332,7053,19637211,19637543
4895,4,11,1,2412,-84,-87,3,,19642547,107,4897,19642440,19642547
4896,4,1,1,2412,-84,-87,3,,19643108,352,209,19642756,19643108
4897,4,1,1,2412,-84,-87,3,b4:b5:2f:17:0c:b9,19644311,1376,-173,19642935,19644311
4898,6,6,1,2412,-76,-87,11,e2:db:d1:d1:b0:4a,19645561,444,806,19645117,19645561
4899,6,6,1,2412,-76,-87,11,e2:db:d1:d1:b0:4b,19646056,408,87,19645648,19646056
4900,6,6,1,2412,-76,-87,11,e2:db:d1:d1:b0:4d,19646506,408,42,19646098,19646506
4901,6,6,1,2412,-76,-87,11,e2:db:d1:d1:b0:4f,19646938,408,24,19646530,19646938
4902,4,1,1,2412,-88,-87,-1,10:7b:44:eb:35:60,19653696,1960,4798,19651736,19653696
4903,4,1,1,2412,-86,-87,1,68:54:fd:aa:49:4f,19662602,912,7994,19661690,19662602
4904,6,6,1,2412,-81,-87,6,52:86:8c:5f:93:1e,19663681,332,747,19663349,19663681
4905,6,24,1,2412,-83,-87,4,,19664193,32,480,19664161,19664193
4906,4,11,1,2412,-74,-87,13,48:dd:0c:7d:86:27,19668789,362,4234,19668427,19668789
4907,4,11,1,2412,-80,-87,7,48:dd:0c:7d:86:23,19669163,323,51,19668840,19669163
4908,4,11,1,2412,-79,-87,8,48:dd:0c:7d:86:25,19669498,382,-47,19669116,19669498
4909,6,6,1,2412,-82,-87,5,10:86:8c:5f:93:1e,19688743,336,18909,19688407,19688743
4910,4,1,1,2412,-88,-87,-1,0e:b9:49:67:a0:d6,19700538,416,11379,19700122,19700538
4911,4,11,1,2412,-78,-87,9,48:dd:0c:90:e3:83,19705065,323,4204,19704742,19705065
4912,4,11,1,2412,-83,-87,4,48:dd:0c:90:e3:85,19705400,382,-47,19705018,19705400
4913,4,1,1,2412,-85,-87,2,68:54:fd:aa:49:4f,19706731,912,419,19705819,19706731
4914,4,1,1,2412,-84,-87,3,78:67:0e:c4:a8:42,19708403,2736,-1064,19705667,19708403
4915,6,24,1,2412,-83,-87,4,,19711951,32,3516,19711919,19711951
4916,6,6,1,2412,-80,-87,7,12:86:8c:5f:93:1e,19714898,332,2615,19714566,19714898
4917,4,1,1,2412,-88,-87,-1,c8:9e:43:bc:eb:ff,19721706,3496,3312,19718210,19721706
4918,6,6,1,2412,-85,-87,2,,19726532,44,4782,19726488,19726532
4919,4,1,1,2412,-79,-87,8,b0:e4:d5:32:ec:8a,19728625,1960,133,19726665,19728625
4920,4,11,1,2412,-80,-87,7,48:dd:0c:7d:86:23,19736757,254,7878,19736503,19736757
4921,6,6,1,2412,-80,-87,7,32:86:8c:5f:93:1e,19739944,332,2855,19739612,19739944
4922,4,1,1,2412,-86,-87,1,68:54:fd:aa:49:4f,19743027,912,2171,19742115,19743027
4923,6,6,1,2412,-76,-87,11,e2:db:d1:d1:b0:4b,19748687,408,5252,19748279,19748687
4924,6,6,1,2412,-75,-87,12,e2:db:d1:d1:b0:4f,19749577,408,482,19749169,19749577
4925,4,1,1,2412,-82,-87,5,,19756353,448,6328,19755905,19756353
4926,4,1,1,2412,-90,-87,-3,3c:bd:c5:ee:96:6d,19758644,2512,-221,19756132,19758644
4927,4,1,1,2412,-87,-87,0,bc:98:df:ff:0f:8b,19762160,2568,948,19759592,19762160
4928,4,1,1,2412,-86,-87,1,0e:b9:49:67:a0:d6,19764768,416,2192,19764352,19764768
4929,4,1,1,2412,-89,-87,-2,,19765196,304,124,19764892,19765196
4930,6,6,1,2412,-81,-87,6,52:86:8c:5f:93:1e,19765544,332,16,19765212,19765544
4931,6,24,1,2412,-83,-87,4,,19766589,28,1017,19766561,19766589
4932,4,1,1,2412,-85,-87,2,,19768955,304,2062,19768651,19768955
4933,4,11,1,2412,-80,-87,7,48:dd:0c:7d:86:27,19771188,362,1871,19770826,19771188
4934,4,11,1,2412,-80,-87,7,48:dd:0c:7d:86:23,19771563,323,52,19771240,19771563
4935,4,11,1,2412,-80,-87,7,48:dd:0c:7d:86:25,19771898,382,-47,19771516,19771898
4936,6,24,1,2412,-81,-87,6,,19773940,28,2014,19773912,19773940
4937,6,24,1,2412,-82,-87,5,,19785261,28,11293,19785233,19785261
4938,4,1,1,2412,-85,-87,2,,19789089,304,3524,19788785,19789089
4939,4,1,1,2412,-85,-87,2,68:54:fd:aa:49:4f,19792189,912,2188,19791277,19792189
4940,6,24,1,2412,-82,-87,5,,19797830,28,5613,19797802,19797830
4941,4,1,1,2412,-86,-87,1,78:67:0e:38:6c:d3,19798064,2736,-2502,19795328,19798064
4942,4,11,1,2412,-77,-87,10,48:dd:0c:90:e3:87,19807090,362,8664,19806728,19807090
4943,4,11,1,2412,-76,-87,11,48:dd:0c:90:e3:83,19807465,323,52,19807142,19807465
4944,4,11,1,2412,-83,-87,4,48:dd:0c:90:e3:85,19807800,382,-47,19807418,19807800
4945,4,1,1,2412,-85,-87,2,78:67:0e:c4:a8:42,19809387,2736,-1149,19806651,19809387
4946,4,1,1,2412,-86,-87,1,,19818039,304,8348,19817735,19818039
4947,4,1,1,2412,-85,-87,2,68:54:fd:aa:49:4f,19824374,912,5423,19823462,19824374
4948,4,1,1,2412,-83,-87,4,,19828138,304,3460,19827834,19828138
4949,4,1,1,2412,-89,-87,-2,b0:e4:d5:32:ec:8a,19831024,1960,926,19829064,19831024
4950,6,6,1,2412,-81,-87,6,32:86:8c:5f:93:1e,19842344,332,10988,19842012,19842344
4951,4,1,1,2412,-82,-87,5,60:32:b1:64:4c:f2,19843176,3224,-2392,19839952,19843176
4952,4,1,1,2412,-85,-87,2,b4:b5:2f:17:0c:b9,19849114,1376,4562,19847738,19849114
4953,6,6,1,2412,-76,-87,11,e2:db:d1:d1:b0:4a,19850347,444,789,19849903,19850347
4954,6,6,1,2412,-76,-87,11,e2:db:d1:d1:b0:4b,19850841,408,86,19850433,19850841
4955,6,6,1,2412,-75,-87,12,e2:db:d1:d1:b0:4d,19851300,408,51,19850892,19851300
4956,6,24,1,2412,-82,-87,5,,19853937,28,2609,19853909,19853937
4957,4,1,1,2412,-87,-87,0,,19861094,448,6709,19860646,19861094
4958,4,1,1,2412,-80,-87,7,3c:bd:c5:ee:96:6d,19862196,2512,-1410,19859684,19862196
4959,4,1,1,2412,-86,-87,1,,19869905,304,7405,19869601,19869905
4960,6,24,1,2412,-84,-87,3,,19872775,28,2842,19872747,19872775
4961,4,11,1,2412,-78,-87,9,48:dd:0c:7d:86:27,19873588,362,451,19873226,19873588
4962,4,11,1,2412,-79,-87,8,48:dd:0c:7d:86:25,19874298,382,328,19873916,19874298
4963,6,24,1,2412,-80,-87,7,,19874914,32,584,19874882,19874914
4964,4,1,1,2412,-85,-87,2,,19878763,304,3545,19878459,19878763
4965,4,1,1,2412,-87,-87,0,ac:67:84:84:8a:07,19883955,416,4776,19883539,19883955
4966,4,1,1,2412,-89,-87,-2,,19884383,304,124,19884079,19884383
4967,6,6,1,2412,-80,-87,7,10:86:8c:5f:93:1e,19893545,336,8826,19893209,19893545
4968,4,1,1,2412,-86,-87,1,78:67:0e:38:6c:d3,19900464,2736,4183,19897728,19900464
4969,4,11,1,2412,-77,-87,10,48:dd:0c:90:e3:83,19909864,323,9077,19909541,19909864
4970,4,11,1,2412,-82,-87,5,48:dd:0c:90:e3:85,19910200,382,-46,19909818,19910200
4971,4,1,1,2412,-85,-87,2,78:67:0e:c4:a8:42,19911787,2736,-1149,19909051,19911787
4972,6,6,1,2412,-77,-87,10,12:86:8c:5f:93:1e,19919145,332,7026,19918813,19919145
4973,4,1,1,2412,-82,-87,5,,19920627,304,1178,19920323,19920627
4974,4,1,1,2412,-80,-87,7,b0:e4:d5:32:ec:8a,19933423,1960,10836,19931463,19933423
4975,4,1,1,2412,-85,-87,2,b4:b5:2f:17:0c:b9,19951516,1376,16717,19950140,19951516
4976,6,6,1,2412,-75,-87,12,e2:db:d1:d1:b0:4d,19953702,408,1778,19953294,19953702
4977,6,6,1,2412,-77,-87,10,e2:db:d1:d1:b0:4f,19954143,408,33,19953735,19954143
4978,6,24,1,2412,-82,-87,5,,19958701,28,4530,19958673,19958701
4979,4,1,1,2412,-88,-87,-1,10:7b:44:eb:35:60,19960886,1960,225,19958926,19960886
4980,4,1,1,2412,-80,-87,7,3c:bd:c5:ee:96:6d,19964783,2512,1385,19962271,19964783
4981,6,6,1,2412,-81,-87,6,52:86:8c:5f:93:1e,19970345,332,5230,19970013,19970345
4982,4,11,1,2412,-72,-87,15,48:dd:0c:7d:86:27,19975988,362,5281,19975626,19975988
4983,4,11,1,2412,-80,-87,7,48:dd:0c:7d:86:23,19976363,323,52,19976040,19976363
4984,4,11,1,2412,-81,-87,6,48:dd:0c:7d:86:25,19976698,382,-47,19976316,19976698
4985,4,1,1,2412,-84,-87,3,ac:67:84:84:8a:07,19977580,416,466,19977164,19977580
4986,4,1,1,2412,-87,-87,0,68:54:fd:aa:49:4f,19987406,912,8914,19986494,19987406
4987,6,24,1,2412,-82,-87,5,,19989779,32,2341,19989747,19989779
4988,6,6,1,2412,-80,-87,7,10:86:8c:5f:93:1e,19995945,336,5830,19995609,19995945
4989,4,1,1,2412,-84,-87,3,,20002211,304,5962,20001907,20002211
4990,4,1,1,2412,-85,-87,2,78:67:0e:38:6c:d3,20002864,2736,-2083,20000128,20002864
4991,4,11,1,2412,-86,-87,1,4c:01:43:ec:a0:69,20006485,361,3260,20006124,20006485
4992,4,1,1,2412,-83,-85,2,,20025638,304,18849,20025334,20025638
4993,4,1,1,2412,-81,-85,4,68:54:fd:aa:49:4f,20031361,912,4811,20030449,20031361
4994,6,24,1,2412,-82,-85,3,,20032661,32,1268,20032629,20032661
4995,4,1,1,2412,-78,-85,7,b0:e4:d5:32:ec:8a,20035823,1960,1202,20033863,20035823
4996,4,1,1,2412,-86,-85,-1,ac:67:84:84:8a:07,20042402,416,6163,20041986,20042402
4997,6,6,1,2412,-80,-85,5,32:86:8c:5f:93:1e,20047146,332,4412,20046814,20047146
4998,4,1,1,2412,-86,-85,-1,b4:b5:2f:17:0c:b9,20053944,1376,5422,20052568,20053944
4999,6,6,1,2412,-76,-85,9,e2:db:d1:d1:b0:4f,20056544,408,2192,20056136,20056544
5000,4,1,1,2412,-86,-85,-1,,20065327,352,8431,20064975,20065327
5001,4,1,1,2412,-79,-85,6,3c:bd:c5:ee:96:6d,20066683,2512,-1156,20064171,20066683
5002,4,1,1,2412,-85,-85,0,68:54:fd:aa:49:4f,20069189,912,1594,20068277,20069189
5003,4,1,1,2412,-88,-85,-3,bc:98:df:ff:0f:8a,20071956,976,1791,20070980,20071956
5004,4,11,1,2412,-85,-85,0,,20078026,107,5963,20077919,20078026
5005,4,11,1,2412,-79,-85,6,48:dd:0c:7d:86:27,20078388,362,,20078026,20078388
5006,4,11,1,2412,-81,-85,4,48:dd:0c:7d:86:23,20078762,323,51,20078439,20078762
5007,4,11,1,2412,-79,-85,6,48:dd:0c:7d:86:25,20079098,382,-46,20078716,20079098
5008,4,11,1,2412,-83,-85,2,,20089173,107,9968,20089066,20089173
5009,4,1,1,2412,-84,-85,1,,20089805,352,280,20089453,20089805
5010,4,11,1,2412,-83,-85,2,,20092901,107,2989,20092794,20092901
5011,4,1,1,2412,-85,-85,0,,20093506,352,253,20093154,20093506
5012,6,6,1,2412,-80,-85,5,10:86:8c:5f:93:1e,20098346,336,4504,20098010,20098346
5013,4,1,1,2412,-86,-85,-1,78:67:0e:38:6c:d3,20105264,2736,4182,20102528,20105264
5014,4,1,1,2412,-85,-85,0,68:54:fd:aa:49:4f,20110033,912,3857,20109121,20110033
5015,4,1,1,2412,-76,-85,9,68:54:fd:aa:49:4f,20111695,912,750,20110783,20111695
5016,4,11,1,2412,-82,-85,3,48:dd:0c:90:e3:85,20114999,382,2922,20114617,20114999
5017,4,1,1,2412,-85,-85,0,78:67:0e:c4:a8:42,20116587,2736,-1148,20113851,20116587
5018,6,6,1,2412,-79,-85,6,12:86:8c:5f:93:1e,20123946,332,7027,20123614,20123946
5019,6,6,1,2412,-84,-85,1,,20127114,44,3124,20127070,20127114
5020,4,1,1,2412,-78,-85,7,b0:e4:d5:32:ec:8a,20138222,1960,9148,20136262,20138222
5021,4,1,1,2412,-86,-85,-1,68:54:fd:aa:49:4f,20149130,912,9996,20148218,20149130
5022,6,6,1,2412,-76,-85,9,32:86:8c:5f:93:1e,20150213,332,751,20149881,20150213
5023,4,1,1,2412,-87,-85,-2,b4:b5:2f:17:0c:b9,20156320,1376,4731,20154944,20156320
5024,6,6,1,2412,-76,-85,9,e2:db:d1:d1:b0:4a,20157570,444,806,20157126,20157570
5025,6,6,1,2412,-76,-85,9,e2:db:d1:d1:b0:4b,20158056,408,78,20157648,20158056
5026,6,6,1,2412,-76,-85,9,e2:db:d1:d1:b0:4d,20158515,408,51,20158107,20158515
5027,6,6,1,2412,-76,-85,9,e2:db:d1:d1:b0:4f,20158956,408,33,20158548,20158956
5028,4,1,1,2412,-89,-85,-4,ce:9e:43:bc:eb:ff,20160149,3800,-2607,20156349,20160149
5029,4,1,1,2412,-78,-85,7,3c:bd:c5:ee:96:6d,20169301,2512,6640,20166789,20169301
5030,4,1,1,2412,-88,-85,-3,bc:98:df:ff:0f:8b,20172085,2568,216,20169517,20172085
5031,6,6,1,2412,-81,-85,4,52:86:8c:5f:93:1e,20175147,332,2730,20174815,20175147
5032,4,1,1,2412,-88,-85,-3,,20179390,384,3859,20179006,20179390
5033,4,1,1,2412,-86,-85,-1,,20179788,448,-50,20179340,20179788
5034,4,11,1,2412,-80,-85,5,48:dd:0c:7d:86:23,20181162,323,1051,20180839,20181162
5035,4,11,1,2412,-80,-85,5,48:dd:0c:7d:86:25,20181497,382,-47,20181115,20181497
5036,6,24,1,2412,-83,-85,2,,20197934,28,16409,20197906,20197934
5037,6,24,1,2412,-82,-85,3,,20198281,28,319,20198253,20198281
5038,6,6,1,2412,-80,-85,5,10:86:8c:5f:93:1e,20200747,336,2130,20200411,20200747
5039,4,1,1,2412,-85,-85,0,78:67:0e:38:6c:d3,20207664,2736,4181,20204928,20207664
5040,4,11,1,2412,-84,-85,1,48:dd:0c:90:e3:87,20221746,362,13720,20221384,20221746
5041,4,11,1,2412,-84,-85,1,48:dd:0c:90:e3:83,20222121,323,52,20221798,20222121
5042,4,11,1,2412,-83,-85,2,48:dd:0c:90:e3:85,20222456,382,-47,20222074,20222456
5043,6,6,1,2412,-80,-85,5,12:86:8c:5f:93:1e,20226347,332,3559,20226015,20226347
5044,4,1,1,2412,-77,-85,8,b0:e4:d5:32:ec:8a,20240621,1960,12314,20238661,20240621
5045,6,6,1,2412,-82,-85,3,32:86:8c:5f:93:1e,20251947,332,10994,20251615,20251947
5046,4,1,1,2412,-83,-85,2,b4:b5:2f:17:0c:b9,20258721,1376,5398,20257345,20258721
5047,6,6,1,2412,-76,-85,9,e2:db:d1:d1:b0:4a,20260054,444,889,20259610,20260054
5048,6,6,1,2412,-76,-85,9,e2:db:d1:d1:b0:4b,20260540,408,78,20260132,20260540
5049,6,6,1,2412,-76,-85,9,e2:db:d1:d1:b0:4f,20261430,408,482,20261022,20261430
5050,4,1,1,2412,-85,-85,0,,20270479,448,8601,20270031,20270479
5051,4,1,1,2412,-78,-85,7,3c:bd:c5:ee:96:6d,20271028,2512,-1963,20268516,20271028
5052,6,24,1,2412,-83,-85,2,,20280229,32,9169,20280197,20280229
5053,4,11,1,2412,-80,-85,5,48:dd:0c:7d:86:27,20283187,362,2596,20282825,20283187
5054,4,11,1,2412,-81,-85,4,48:dd:0c:7d:86:23,20283562,323,52,20283239,20283562
5055,4,11,1,2412,-80,-85,5,48:dd:0c:7d:86:25,20283897,382,-47,20283515,20283897
5056,4,1,1,2412,-88,-85,-3,bc:98:df:ff:0f:8b,20287331,3176,258,20284155,20287331
5057,6,24,1,2412,-81,-85,4,,20300700,28,13341,20300672,20300700
5058,6,6,1,2412,-81,-85,4,10:86:8c:5f:93:1e,20303292,336,2256,20302956,20303292
5059,4,11,1,2412,-82,-85,3,48:dd:0c:90:e3:85,20319799,382,16125,20319417,20319799
5060,4,1,1,2412,-86,-85,-1,78:67:0e:c4:a8:42,20321387,2736,-1148,20318651,20321387
5061,6,6,1,2412,-87,-85,-2,,20325133,44,3702,20325089,20325133
5062,4,1,1,2412,-86,-85,-1,ac:67:84:84:8a:07,20328981,416,3432,20328565,20328981
5063,6,6,1,2412,-80,-85,5,12:86:8c:5f:93:1e,20330882,332,1569,20330550,20330882
5064,6,24,1,2412,-83,-85,2,,20338523,28,7613,20338495,20338523
5065,4,1,1,2412,-80,-85,5,b0:e4:d5:32:ec:8a,20343021,1960,2538,20341061,20343021
5066,6,6,1,2412,-81,-85,4,,20360284,68,17195,20360216,20360284
5067,4,1,1,2412,-85,-85,0,b4:b5:2f:17:0c:b9,20361123,1376,-537,20359747,20361123
5068,6,6,1,2412,-76,-85,9,e2:db:d1:d1:b0:4a,20362382,444,815,20361938,20362382
5069,6,6,1,2412,-76,-85,9,e2:db:d1:d1:b0:4b,20362859,408,69,20362451,20362859
5070,6,6,1,2412,-76,-85,9,e2:db:d1:d1:b0:4f,20363750,408,483,20363342,20363750
5071,4,1,1,2412,-87,-85,-2,,20372908,448,8710,20372460,20372908
5072,4,1,1,2412,-77,-85,8,3c:bd:c5:ee:96:6d,20373386,2512,-2034,20370874,20373386
5073,4,1,1,2412,-88,-85,-3,bc:98:df:ff:0f:8b,20376574,2568,620,20374006,20376574
5074,6,6,1,2412,-80,-85,5,52:86:8c:5f:93:1e,20379948,332,3042,20379616,20379948
5075,4,1,1,2412,-89,-85,-4,ce:9e:43:bc:eb:ff,20381332,3800,-2416,20377532,20381332
5076,4,1,1,2412,-87,-85,-2,,20392706,448,10926,20392258,20392706
5077,4,1,1,2412,-86,-85,-1,68:54:fd:aa:49:4f,20401489,912,7871,20400577,20401489
5078,6,24,1,2412,-83,-85,2,,20402835,32,1314,20402803,20402835
5079,6,6,1,2412,-81,-85,4,10:86:8c:5f:93:1e,20405548,336,2377,20405212,20405548
5080,4,1,1,2412,-86,-85,-1,78:67:0e:38:6c:d3,20412711,2736,4427,20409975,20412711
5081,4,1,1,2412,-86,-85,-1,78:67:0e:38:6c:d2,20415503,832,1960,20414671,20415503
5082,4,11,1,2412,-77,-85,8,48:dd:0c:90:e3:83,20421995,323,6169,20421672,20421995
5083,4,11,1,2412,-82,-85,3,48:dd:0c:90:e3:85,20422330,382,-47,20421948,20422330
5084,4,11,1,2412,-84,-85,1,,20427807,107,5370,20427700,20427807
5085,6,6,1,2412,-79,-85,6,12:86:8c:5f:93:1e,20431552,332,3413,20431220,20431552
5086,4,11,1,2412,-83,-85,2,48:dd:0c:90:e3:85,20433977,377,2048,20433600,20433977
5087,4,1,1,2412,-88,-85,-3,ac:67:84:84:8a:07,20434596,416,203,20434180,20434596
5088,4,1,1,2412,-87,-85,-2,00:26:62:eb:ea:74,20436978,968,1414,20436010,20436978
5089,6,24,1,2412,-83,-85,2,,20437880,28,874,20437852,20437880
5090,4,11,1,2412,-85,-85,0,,20438434,207,347,20438227,20438434
5091,4,1,1,2412,-86,-85,-1,68:54:fd:aa:49:4f,20439913,912,567,20439001,20439913
5092,6,24,1,2412,-83,-85,2,,20441151,32,1206,20441119,20441151
5093,6,24,1,2412,-83,-85,2,,20441343,32,160,20441311,20441343
5094,6,24,1,2412,-83,-85,2,,20442487,32,1112,20442455,20442487
5095,4,1,1,2412,-77,-85,8,b0:e4:d5:32:ec:8a,20445420,1960,973,20443460,20445420
5096,6,6,1,2412,-80,-85,5,32:86:8c:5f:93:1e,20457085,332,11333,20456753,20457085
5097,6,6,1,2412,-76,-85,9,e2:db:d1:d1:b0:4b,20465234,408,7741,20464826,20465234
5098,6,6,1,2412,-76,-85,9,e2:db:d1:d1:b0:4d,20465684,408,42,20465276,20465684
5099,6,6,1,2412,-76,-85,9,e2:db:d1:d1:b0:4f,20466125,408,33,20465717,20466125
5100,4,1,1,2412,-78,-85,7,3c:bd:c5:ee:96:6d,20475771,2512,7134,20473259,20475771
5101,4,1,1,2412,-79,-85,6,b8:f8:53:cb:31:f1,20478309,976,1562,20477333,20478309
5102,6,6,1,2412,-79,-85,6,52:86:8c:5f:93:1e,20482349,332,3708,20482017,20482349
5103,4,11,1,2412,-80,-85,5,48:dd:0c:7d:86:27,20487987,362,5276,20487625,20487987
5104,4,11,1,2412,-80,-85,5,48:dd:0c:7d:86:23,20488361,323,51,20488038,20488361
5105,4,11,1,2412,-79,-85,6,48:dd:0c:7d:86:25,20488697,382,-46,20488315,20488697
5106,4,1,1,2412,-89,-85,-4,c8:9e:43:bc:eb:ff,20495533,3496,3340,20492037,20495533
5107,6,6,1,2412,-81,-85,4,10:86:8c:5f:93:1e,20507949,336,12080,20507613,20507949
5108,4,1,1,2412,-86,-85,-1,78:67:0e:38:6c:d3,20514865,2736,4180,20512129,20514865
5109,6,24,1,2412,-83,-85,2,,20518084,32,3187,20518052,20518084
5110,4,11,1,2412,-87,-85,-2,4c:01:43:ec:a0:66,20519187,387,716,20518800,20519187
5111,4,1,1,2412,-84,-85,1,,20520188,304,697,20519884,20520188
5112,4,1,1,2412,-77,-85,8,68:54:fd:aa:49:4f,20520851,912,-249,20519939,20520851
5113,4,1,1,2412,-78,-85,7,,20522710,304,1555,20522406,20522710
5114,4,11,1,2412,-77,-85,8,48:dd:0c:90:e3:87,20523888,362,816,20523526,20523888
5115,4,11,1,2412,-77,-85,8,48:dd:0c:90:e3:83,20524263,323,52,20523940,20524263
5116,4,11,1,2412,-83,-85,2,48:dd:0c:90:e3:85,20524598,382,-47,20524216,20524598
5117,4,1,1,2412,-84,-85,1,78:67:0e:c4:a8:42,20526186,2736,-1148,20523450,20526186
5118,6,6,1,2412,-81,-85,4,12:86:8c:5f:93:1e,20533549,332,7031,20533217,20533549
5119,4,1,1,2412,-84,-85,1,,20539209,304,5356,20538905,20539209
5120,4,1,1,2412,-85,-85,0,,20540299,304,786,20539995,20540299
5121,6,24,1,2412,-82,-85,3,,20541843,32,1512,20541811,20541843
5122,6,24,1,2412,-83,-85,2,,20542588,32,713,20542556,20542588
5123,6,24,1,2412,-83,-85,2,,20542757,32,137,20542725,20542757
5124,4,1,1,2412,-86,-85,-1,0e:b9:49:67:a0:d6,20544636,416,1463,20544220,20544636
5125,4,1,1,2412,-79,-85,6,b0:e4:d5:32:ec:8a,20547819,1960,1223,20545859,20547819
5126,4,1,1,2412,-86,-85,-1,b6:77:db:5a:58:27,20551544,1488,2237,20550056,20551544
5127,4,1,1,2412,-86,-85,-1,b6:77:db:5a:58:27,20553132,1648,-60,20551484,20553132
5128,6,6,1,2412,-80,-85,5,32:86:8c:5f:93:1e,20559150,332,5686,20558818,20559150
5129,4,1,1,2412,-84,-85,1,68:54:fd:aa:49:4f,20560268,912,206,20559356,20560268
5130,6,6,1,2412,-77,-85,8,e2:db:d1:d1:b0:4b,20568459,408,7783,20568051,20568459
5131,6,6,1,2412,-76,-85,9,e2:db:d1:d1:b0:4d,20568918,408,51,20568510,20568918
5132,6,6,1,2412,-75,-85,10,e2:db:d1:d1:b0:4f,20569350,408,24,20568942,20569350
5133,4,11,1,2412,-86,-85,-1,,20573020,203,3467,20572817,20573020
5134,4,1,1,2412,-85,-85,0,,20574634,304,1310,20574330,20574634
5135,4,1,1,2412,-83,-85,2,,20575821,304,883,20575517,20575821
5136,4,11,1,2412,-86,-85,-1,,20577412,203,1388,20577209,20577412
5137,4,1,1,2412,-80,-85,5,3c:bd:c5:ee:96:6d,20578138,2512,-1786,20575626,20578138
5138,4,1,1,2412,-88,-85,-3,ac:67:84:84:8a:07,20580799,416,2245,20580383,20580799
5139,4,1,1,2412,-86,-85,-1,,20584144,304,3041,20583840,20584144
5140,6,6,1,2412,-80,-85,5,52:86:8c:5f:93:1e,20584750,332,274,20584418,20584750
5141,4,11,1,2412,-79,-85,6,48:dd:0c:7d:86:27,20590387,362,5275,20590025,20590387
5142,4,11,1,2412,-79,-85,6,48:dd:0c:7d:86:23,20590761,323,51,20590438,20590761
5143,4,11,1,2412,-80,-85,5,48:dd:0c:7d:86:25,20591096,382,-47,20590714,20591096
5144,4,1,1,2412,-85,-85,0,68:54:fd:df:ca:29,20591386,912,-622,20590474,20591386
5145,6,24,1,2412,-84,-85,1,,20592812,32,1394,20592780,20592812
5146,4,11,1,2412,-85,-85,0,,20593839,203,824,20593636,20593839
5147,4,11,1,2412,-85,-85,0,,20597511,207,3465,20597304,20597511
5148,6,24,1,2412,-82,-85,3,,20598697,28,1158,20598669,20598697
5149,4,11,1,2412,-86,-85,-1,,20598959,203,59,20598756,20598959
5150,4,1,1,2412,-87,-85,-2,c8:9e:43:bc:eb:ff,20606324,3496,3869,20602828,20606324
5151,4,1,1,2412,-83,-85,2,66:32:b1:64:4c:f2,20612714,2696,3694,20610018,20612714
5152,4,1,1,2412,-87,-85,-2,78:67:0e:38:6c:d3,20617265,2736,1815,20614529,20617265
5153,4,1,1,2412,-84,-85,1,,20620611,304,3042,20620307,20620611
5154,4,1,1,2412,-76,-85,9,68:54:fd:df:ca:29,20623159,912,1636,20622247,20623159
5155,4,1,1,2412,-76,-85,9,,20624739,304,1276,20624435,20624739
5156,4,11,1,2412,-76,-85,9,48:dd:0c:90:e3:83,20626663,323,1601,20626340,20626663
5157,4,11,1,2412,-83,-85,2,48:dd:0c:90:e3:85,20626998,382,-47,20626616,20626998
5158,4,1,1,2412,-85,-85,0,78:67:0e:c4:a8:42,20628586,2736,-1148,20625850,20628586
5159,6,6,1,2412,-79,-85,6,12:86:8c:5f:93:1e,20635950,332,7032,20635618,20635950
5160,4,1,1,2412,-84,-85,1,,20638682,304,2428,20638378,20638682
5161,4,1,1,2412,-86,-85,-1,68:54:fd:aa:49:4f,20641944,912,2350,20641032,20641944
5162,4,1,1,2412,-80,-85,5,b0:e4:d5:32:ec:8a,20650219,1960,6315,20648259,20650219
5163,6,24,1,2412,-83,-85,2,,20653944,28,3697,20653916,20653944
5164,6,6,1,2412,-79,-85,6,32:86:8c:5f:93:1e,20661550,332,7274,20661218,20661550
5165,4,1,1,2412,-86,-85,-1,b4:b5:2f:17:0c:b9,20668329,1376,5403,20666953,20668329
5166,6,6,1,2412,-77,-85,8,e2:db:d1:d1:b0:4a,20669570,444,797,20669126,20669570
5167,6,6,1,2412,-77,-85,8,e2:db:d1:d1:b0:4d,20670478,408,500,20670070,20670478
5168,6,6,1,2412,-77,-85,8,e2:db:d1:d1:b0:4f,20670911,408,25,20670503,20670911
5169,4,11,1,2412,-85,-85,0,,20676382,203,5268,20676179,20676382
5170,4,11,1,2412,-81,-85,4,,20678575,203,1990,20678372,20678575
5171,4,1,1,2412,-80,-85,5,3c:bd:c5:ee:96:6d,20680180,2512,-907,20677668,20680180
5172,4,1,1,2412,-85,-85,0,68:54:fd:aa:49:4f,20682787,912,1695,20681875,20682787
5173,6,6,1,2412,-79,-85,6,52:86:8c:5f:93:1e,20687150,332,4031,20686818,20687150
5174,4,1,1,2412,-85,-85,0,,20689098,304,1644,20688794,20689098
5175,4,11,1,2412,-80,-85,5,48:dd:0c:7d:86:27,20692787,362,3327,20692425,20692787
5176,4,11,1,2412,-80,-85,5,48:dd:0c:7d:86:25,20693496,382,327,20693114,20693496
5177,4,11,1,2412,-83,-85,2,,20699908,107,6305,20699801,20699908
5178,6,24,1,2412,-82,-85,3,,20702595,32,2655,20702563,20702595
5179,4,1,1,2412,-87,-85,-2,68:54:fd:df:ca:29,20703583,912,76,20702671,20703583
5180,6,24,1,2412,-81,-85,4,,20706470,32,2855,20706438,20706470
5181,4,11,1,2412,-85,-85,0,,20707798,203,1125,20707595,20707798
5182,4,1,1,2412,-84,-85,1,,20712250,304,4148,20711946,20712250
5183,4,1,1,2412,-87,-85,-2,c8:9e:43:bc:eb:ff,20718283,3496,2537,20714787,20718283
5184,4,1,1,2412,-77,-85,8,,20727734,304,9147,20727430,20727734
5185,4,11,1,2412,-79,-85,6,48:dd:0c:90:e3:87,20728688,362,592,20728326,20728688
5186,4,1,1,2412,-85,-85,0,78:67:0e:c4:a8:42,20730986,2736,-438,20728250,20730986
5187,4,1,1,2412,-85,-85,0,,20734173,304,2883,20733869,20734173
5188,6,6,1,2412,-79,-85,6,12:86:8c:5f:93:1e,20738351,332,3846,20738019,20738351
5189,6,24,1,2412,-82,-85,3,,20742835,32,4452,20742803,20742835
5190,4,1,1,2412,-85,-85,0,,20743689,352,502,20743337,20743689
5191,4,1,1,2412,-86,-85,-1,68:54:fd:df:ca:29,20744333,912,-268,20743421,20744333
5192,4,11,1,2412,-85,-85,0,,20745725,207,1185,20745518,20745725
5193,6,24,1,2412,-83,-85,2,,20746072,28,319,20746044,20746072
5194,4,1,1,2412,-87,-85,-2,68:54:fd:df:ca:29,20746837,912,-147,20745925,20746837
5195,4,1,1,2412,-85,-85,0,68:54:fd:df:ca:29,20749306,912,1557,20748394,20749306
5196,4,11,1,2412,-86,-85,-1,,20750890,207,1377,20750683,20750890
5197,4,1,1,2412,-84,-85,1,68:54:fd:df:ca:29,20751323,912,-479,20750411,20751323
5198,4,1,1,2412,-78,-85,7,b0:e4:d5:32:ec:8a,20752618,1960,-665,20750658,20752618
5199,4,11,1,2412,-86,-85,-1,,20759094,203,6273,20758891,20759094
5200,6,6,1,2412,-80,-85,5,32:86:8c:5f:93:1e,20763951,332,4525,20763619,20763951
5201,6,6,1,2412,-77,-85,8,e2:db:d1:d1:b0:4a,20772170,444,7775,20771726,20772170
5202,6,6,1,2412,-77,-85,8,e2:db:d1:d1:b0:4b,20772647,408,69,20772239,20772647
5203,6,6,1,2412,-77,-85,8,e2:db:d1:d1:b0:4d,20773097,408,42,20772689,20773097
5204,6,6,1,2412,-77,-85,8,e2:db:d1:d1:b0:4f,20773556,408,51,20773148,20773556
5205,4,1,1,2412,-82,-85,3,68:54:fd:df:ca:29,20785687,912,11219,20784775,20785687
5206,6,6,1,2412,-81,-85,4,52:86:8c:5f:93:1e,20789551,332,3532,20789219,20789551
5207,4,1,1,2412,-88,-85,-3,,20793465,448,3466,20793017,20793465
5208,4,11,1,2412,-79,-85,6,48:dd:0c:7d:86:27,20795186,362,1359,20794824,20795186
5209,4,11,1,2412,-81,-85,4,48:dd:0c:7d:86:23,20795561,323,52,20795238,20795561
5210,4,11,1,2412,-79,-85,6,48:dd:0c:7d:86:25,20795896,382,-47,20795514,20795896
5211,4,1,1,2412,-84,-85,1,,20802234,304,6034,20801930,20802234
5212,4,1,1,2412,-84,-85,1,,20803289,304,751,20802985,20803289
5213,4,11,1,2412,-88,-85,-3,4c:01:43:d7:f3:26,20808035,387,4359,20807648,20808035
5214,4,1,1,2412,-89,-85,-4,78:67:0e:38:6c:d3,20822065,2736,11294,20819329,20822065
5215,6,24,1,2412,-84,-85,1,,20825311,28,3218,20825283,20825311
5216,4,1,1,2412,-83,-85,2,,20825651,304,36,20825347,20825651
5217,4,1,1,2412,-86,-85,-1,68:54:fd:df:ca:29,20826825,912,262,20825913,20826825
5218,4,1,1,2412,-78,-85,7,,20830808,304,3679,20830504,20830808
5219,4,1,1,2412,-85,-85,0,78:67:0e:c4:a8:42,20833386,2736,-158,20830650,20833386
5220,4,1,1,2412,-85,-85,0,,20836159,352,2421,20835807,20836159
5221,4,1,1,2412,-84,-85,1,78:67:0e:c4:a8:42,20837163,848,156,20836315,20837163
5222,4,11,1,2412,-85,-85,0,,20838766,203,1400,20838563,20838766
5223,4,1,1,2412,-83,-85,2,,20839451,352,333,20839099,20839451
5224,6,6,1,2412,-78,-85,7,12:86:8c:5f:93:1e,20840752,332,969,20840420,20840752
5225,4,1,1,2412,-88,-85,-3,00:26:62:eb:ea:74,20846788,968,5068,20845820,20846788
5226,4,1,1,2412,-79,-85,6,b0:e4:d5:32:ec:8a,20855017,1960,6269,20853057,20855017
5227,4,1,1,2412,-84,-85,1,68:54:fd:df:ca:29,20865902,912,9973,20864990,20865902
5228,6,6,1,2412,-79,-85,6,32:86:8c:5f:93:1e,20866985,332,751,20866653,20866985
5229,4,1,1,2412,-86,-85,-1,b4:b5:2f:17:0c:b9,20873132,1376,4771,20871756,20873132
5230,6,6,1,2412,-77,-85,8,e2:db:d1:d1:b0:4a,20874392,444,816,20873948,20874392
5231,6,6,1,2412,-77,-85,8,e2:db:d1:d1:b0:4b,20874868,408,68,20874460,20874868
5232,6,6,1,2412,-77,-85,8,e2:db:d1:d1:b0:4d,20875300,408,24,20874892,20875300
5233,6,6,1,2412,-77,-85,8,e2:db:d1:d1:b0:4f,20875750,408,42,20875342,20875750
5234,4,1,1,2412,-78,-85,7,3c:bd:c5:ee:96:6d,20885211,2512,6949,20882699,20885211
5235,4,11,1,2412,-80,-85,5,48:dd:0c:7d:86:27,20897586,362,12013,20897224,20897586
5236,4,11,1,2412,-80,-85,5,48:dd:0c:7d:86:23,20897961,323,52,20897638,20897961
5237,4,11,1,2412,-80,-85,5,48:dd:0c:7d:86:25,20898296,382,-47,20897914,20898296
5238,6,24,1,2412,-82,-85,3,,20905909,28,7585,20905881,20905909
5239,6,24,1,2412,-82,-85,3,,20910729,28,4792,20910701,20910729
5240,4,1,1,2412,-86,-85,-1,68:54:fd:df:ca:29,20911077,912,-564,20910165,20911077
5241,4,11,1,2412,-85,-85,0,,20918454,203,7174,20918251,20918454
5242,4,1,1,2412,-86,-85,-1,78:67:0e:38:6c:d3,20924465,2736,3275,20921729,20924465
5243,4,5.5,1,2412,-87,-85,-2,,20929385,117,4803,20929268,20929385
5244,4,11,1,2412,-77,-85,8,48:dd:0c:90:e3:83,20933862,323,4154,20933539,20933862
5245,4,11,1,2412,-82,-85,3,48:dd:0c:90:e3:85,20934197,382,-47,20933815,20934197
5246,4,1,1,2412,-83,-85,2,78:67:0e:c4:a8:42,20935786,2736,-1147,20933050,20935786
5247,6,6,1,2412,-78,-85,7,12:86:8c:5f:93:1e,20943152,332,7034,20942820,20943152
5248,4,11,1,2412,-86,-85,-1,,20948620,203,5265,20948417,20948620
5249,4,1,1,2412,-79,-85,6,b0:e4:d5:32:ec:8a,20957417,1960,6837,20955457,20957417
5250,6,24,1,2412,-81,-85,4,,20973951,28,16506,20973923,20973951
5251,4,1,1,2412,-86,-85,-1,b4:b5:2f:17:0c:b9,20975534,1376,207,20974158,20975534
5252,6,6,1,2412,-77,-85,8,e2:db:d1:d1:b0:4a,20976775,444,797,20976331,20976775
5253,4,1,1,2412,-88,-85,-3,10:7b:44:eb:35:60,20984911,1960,6176,20982951,20984911
5254,4,1,1,2412,-77,-85,8,3c:bd:c5:ee:96:6d,20987404,2512,-19,20984892,20987404
5255,4,1,1,2412,-87,-85,-2,,20990620,448,2768,20990172,20990620
5256,6,6,1,2412,-79,-85,6,52:86:8c:5f:93:1e,20994353,332,3401,20994021,20994353
5257,4,11,1,2412,-80,-85,5,48:dd:0c:7d:86:23,21000360,323,5684,21000037,21000360
5258,4,11,1,2412,-80,-85,5,48:dd:0c:7d:86:25,21000696,382,-46,21000314,21000696
5259,4,1,1,2412,-91,-85,-6,60:b7:6e:d3:6c:f6,21003970,2152,1122,21001818,21003970
5260,6,24,1,2412,-82,-87,5,,21019032,28,15034,21019004,21019032
5261,6,6,1,2412,-80,-87,7,10:86:8c:5f:93:1e,21019953,336,585,21019617,21019953
5262,4,1,1,2412,-83,-87,4,,21022086,304,1829,21021782,21022086
5263,4,1,1,2412,-86,-87,1,78:67:0e:38:6c:d3,21026865,2736,2043,21024129,21026865
5264,4,1,1,2412,-87,-87,0,78:67:0e:38:6c:d3,21029657,848,1944,21028809,21029657
5265,4,11,1,2412,-76,-87,11,48:dd:0c:90:e3:83,21036262,323,6282,21035939,21036262
5266,4,11,1,2412,-82,-87,5,48:dd:0c:90:e3:85,21036597,382,-47,21036215,21036597
5267,4,1,1,2412,-83,-87,4,78:67:0e:c4:a8:42,21038185,2736,-1148,21035449,21038185
5268,4,1,1,2412,-84,-87,3,,21041372,304,2883,21041068,21041372
5269,4,11,1,2412,-86,-87,1,,21052695,203,11120,21052492,21052695
5270,6,24,1,2412,-81,-87,6,,21053946,28,1223,21053918,21053946
5271,4,1,1,2412,-80,-87,7,b0:e4:d5:32:ec:8a,21059816,1960,3910,21057856,21059816
5272,6,6,1,2412,-80,-87,7,32:86:8c:5f:93:1e,21071153,332,11005,21070821,21071153
5273,4,1,1,2412,-85,-87,2,,21075655,304,4198,21075351,21075655
5274,4,1,1,2412,-83,-87,4,,21076986,304,1027,21076682,21076986
5275,4,1,1,2412,-86,-87,1,b4:b5:2f:17:0c:b9,21078071,1376,-291,21076695,21078071
5276,6,6,1,2412,-76,-87,11,e2:db:d1:d1:b0:4a,21079321,444,806,21078877,21079321
5277,6,6,1,2412,-82,-87,5,,21082056,68,2667,21081988,21082056
5278,4,11,1,2412,-87,-87,0,,21082945,203,686,21082742,21082945
5279,4,11,1,2412,-82,-87,5,,21089355,107,6303,21089248,21089355
5280,4,1,1,2412,-79,-87,8,3c:bd:c5:ee:96:6d,21089779,2512,-2088,21087267,21089779
5281,4,1,1,2412,-88,-87,-1,bc:98:df:ff:0f:8b,21093691,2568,1344,21091123,21093691
5282,4,11,1,2412,-85,-87,2,,21096650,107,2852,21096543,21096650
5283,6,6,1,2412,-79,-87,8,52:86:8c:5f:93:1e,21096910,332,-72,21096578,21096910
5284,4,11,1,2412,-80,-87,7,48:dd:0c:7d:86:27,21102386,362,5114,21102024,21102386
5285,4,11,1,2412,-81,-87,6,48:dd:0c:7d:86:23,21102760,323,51,21102437,21102760
5286,6,6,1,2412,-83,-87,4,,21113194,68,10366,21113126,21113194
5287,6,6,1,2412,-79,-87,8,10:86:8c:5f:93:1e,21122354,336,8824,21122018,21122354
5288,4,1,1,2412,-86,-87,1,78:67:0e:38:6c:d3,21129266,2736,4176,21126530,21129266
5289,4,11,1,2412,-75,-87,12,48:dd:0c:90:e3:87,21138287,362,8659,21137925,21138287
5290,4,11,1,2412,-81,-87,6,48:dd:0c:90:e3:85,21138997,382,328,21138615,21138997
5291,4,1,1,2412,-83,-87,4,,21140949,304,1648,21140645,21140949
5292,6,24,1,2412,-82,-87,5,,21145285,28,4308,21145257,21145285
5293,6,6,1,2412,-79,-87,8,12:86:8c:5f:93:1e,21148326,332,2709,21147994,21148326
5294,6,6,1,2412,-77,-87,10,76:a2:c1:67:70:44,21148858,308,224,21148550,21148858
5295,6,6,1,2412,-76,-87,11,76:a2:c1:67:70:44,21149199,308,33,21148891,21149199
5296,6,6,1,2412,-77,-87,10,b2:e2:49:f6:8a:4e,21152237,308,2730,21151929,21152237
5297,6,6,1,2412,-77,-87,10,f8:4f:ad:f9:af:82,21177358,632,24489,21176726,21177358
5298,6,6,1,2412,-77,-87,10,e2:db:d1:d1:b0:4b,21182064,408,4298,21181656,21182064
5299,6,6,1,2412,-76,-87,11,e2:db:d1:d1:b0:4f,21182946,408,474,21182538,21182946
5300,4,1,1,2412,-83,-87,4,,21186057,304,2807,21185753,21186057
5301,4,1,1,2412,-87,-87,0,68:54:fd:df:ca:29,21190815,912,3846,21189903,21190815
5302,4,1,1,2412,-78,-87,9,3c:bd:c5:ee:96:6d,21192382,2512,-945,21189870,21192382
5303,6,6,1,2412,-79,-87,8,52:86:8c:5f:93:1e,21199154,332,6440,21198822,21199154
5304,4,1,1,2412,-86,-87,1,,21201566,448,1964,21201118,21201566
5305,4,1,1,2412,-85,-87,2,,21202461,448,447,21202013,21202461
5306,4,11,1,2412,-80,-87,7,48:dd:0c:7d:86:27,21204785,362,1962,21204423,21204785
5307,4,11,1,2412,-80,-87,7,48:dd:0c:7d:86:23,21205160,323,52,21204837,21205160
5308,4,11,1,2412,-80,-87,7,48:dd:0c:7d:86:25,21205495,382,-47,21205113,21205495
5309,4,11,1,2412,-83,-87,4,48:dd:0c:90:e3:83,21207276,254,1527,21207022,21207276
5310,4,1,1,2412,-83,-87,4,,21219248,304,11668,21218944,21219248
5311,6,6,1,2412,-79,-87,8,10:86:8c:5f:93:1e,21224754,336,5170,21224418,21224754
5312,4,1,1,2412,-84,-87,3,,21226309,304,1251,21226005,21226309
5313,6,24,1,2412,-82,-87,5,,21230285,28,3948,21230257,21230285
5314,4,1,1,2412,-86,-87,1,78:67:0e:38:6c:d3,21231666,2736,-1355,21228930,21231666
5315,4,11,1,2412,-87,-87,0,4c:01:43:ec:a0:69,21235271,361,3244,21234910,21235271
5316,4,11,1,2412,-76,-87,11,48:dd:0c:90:e3:87,21240687,362,5054,21240325,21240687
5317,4,11,1,2412,-78,-87,9,48:dd:0c:90:e3:83,21241061,323,51,21240738,21241061
5318,4,11,1,2412,-83,-87,4,48:dd:0c:90:e3:85,21241396,382,-47,21241014,21241396
5319,4,11,1,2412,-85,-87,2,,21241818,203,219,21241615,21241818
5320,4,1,1,2412,-83,-87,4,78:67:0e:c4:a8:42,21242985,2736,-1569,21240249,21242985
5321,4,1,1,2412,-83,-87,4,,21253583,304,10294,21253279,21253583
5322,4,11,1,2412,-83,-87,4,,21253972,107,282,21253865,21253972
5323,6,6,1,2412,-76,-87,11,e0:db:d1:d0:b0:48,21256954,156,2826,21256798,21256954
5324,6,6,1,2412,-77,-87,10,f8:4f:ad:f9:af:82,21257364,196,214,21257168,21257364
5325,6,6,1,2412,-77,-87,10,f8:4f:ad:f9:af:82,21257638,156,118,21257482,21257638
5326,4,1,1,2412,-80,-87,7,b0:e4:d5:32:ec:8a,21264615,1960,5017,21262655,21264615
5327,4,1,1,2412,-83,-87,4,,21275549,304,10630,21275245,21275549
5328,4,1,1,2412,-82,-87,5,,21276986,352,1085,21276634,21276986
5329,6,6,1,2412,-75,-87,12,f8:4f:ad:f9:af:82,21277258,656,-384,21276602,21277258
5330,4,11,1,2412,-82,-87,5,,21279633,107,2268,21279526,21279633
5331,4,1,1,2412,-85,-87,2,b4:b5:2f:17:0c:b9,21282739,1376,1730,21281363,21282739
5332,6,6,1,2412,-76,-87,11,e2:db:d1:d1:b0:4a,21283972,444,789,21283528,21283972
5333,6,6,1,2412,-77,-87,10,e2:db:d1:d1:b0:4b,21284449,408,69,21284041,21284449
5334,6,6,1,2412,-77,-87,10,e2:db:d1:d1:b0:4d,21284890,408,33,21284482,21284890
5335,6,6,1,2412,-76,-87,11,e2:db:d1:d1:b0:4f,21285348,408,50,21284940,21285348
5336,4,1,1,2412,-87,-87,0,ac:67:84:84:8a:07,21288387,416,2623,21287971,21288387
5337,4,1,1,2412,-83,-87,4,,21292509,352,3770,21292157,21292509
5338,4,1,1,2412,-78,-87,9,3c:bd:c5:ee:96:6d,21294834,2512,-187,21292322,21294834
5339,4,1,1,2412,-87,-87,0,,21297270,448,1988,21296822,21297270
5340,4,11,1,2412,-79,-87,8,48:dd:0c:7d:86:27,21307185,362,9553,21306823,21307185
5341,4,11,1,2412,-80,-87,7,48:dd:0c:7d:86:23,21307560,323,52,21307237,21307560
5342,4,11,1,2412,-81,-87,6,48:dd:0c:7d:86:25,21307895,382,-47,21307513,21307895
5343,4,11,1,2412,-86,-87,1,,21324347,203,16249,21324144,21324347
5344,6,6,1,2412,-78,-87,9,b4:e6:2d:b4:ff:71,21329265,64,4854,21329201,21329265
5345,6,6,1,2412,-80,-87,7,,21329345,44,36,21329301,21329345
5346,4,1,1,2412,-86,-87,1,7c:f6:66:d3:26:e0,21336858,2208,5305,21334650,21336858
5347,4,11,1,2412,-76,-87,11,48:dd:0c:90:e3:83,21343461,323,6280,21343138,21343461
5348,4,11,1,2412,-81,-87,6,48:dd:0c:90:e3:85,21343796,382,-47,21343414,21343796
5349,4,1,1,2412,-79,-87,8,b0:e4:d5:32:ec:8a,21367014,1960,21258,21365054,21367014
5350,6,6,1,2412,-76,-87,11,e2:db:d1:d1:b0:4a,21386454,444,18996,21386010,21386454
5351,6,6,1,2412,-77,-87,10,e2:db:d1:d1:b0:4b,21386932,408,70,21386524,21386932
5352,6,6,1,2412,-77,-87,10,e2:db:d1:d1:b0:4d,21387363,408,23,21386955,21387363
5353,6,6,1,2412,-77,-87,10,e2:db:d1:d1:b0:4f,21387795,408,24,21387387,21387795
5354,6,24,1,2412,-82,-87,5,,21391715,28,3892,21391687,21391715
5355,4,1,1,2412,-77,-87,10,3c:bd:c5:ee:96:6d,21396999,2512,2772,21394487,21396999
5356,4,1,1,2412,-78,-87,9,3c:bd:c5:ee:96:6a,21399537,1056,1482,21398481,21399537
5357,4,11,1,2412,-83,-87,4,,21405088,207,5344,21404881,21405088
5358,4,11,1,2412,-80,-87,7,48:dd:0c:7d:86:27,21409585,362,4135,21409223,21409585
5359,4,11,1,2412,-81,-87,6,48:dd:0c:7d:86:23,21409960,323,52,21409637,21409960
5360,4,11,1,2412,-81,-87,6,48:dd:0c:7d:86:25,21410295,382,-47,21409913,21410295
5361,4,1,1,2412,-66,-87,21,da:51:5c:d4:99:cb,21420236,1152,8789,21419084,21420236
5362,4,1,1,2412,-79,-87,8,b0:e4:d5:32:ec:8a,21421649,1912,-499,21419737,21421649
5363,4,1,1,2412,-79,-87,8,b0:e4:d5:32:ec:8a,21423832,1912,271,21421920,21423832
5364,4,1,1,2412,-64,-87,23,,21425756,304,1620,21425452,21425756
5365,4,1,1,2412,-82,-87,5,68:54:fd:df:ca:29,21433517,912,6849,21432605,21433517
5366,6,6,1,2412,-82,-87,5,,21436028,68,2443,21435960,21436028
5367,4,1,1,2412,-88,-87,-1,78:67:0e:38:6c:d3,21436466,2736,-2298,21433730,21436466
5368,4,11,1,2412,-86,-87,1,,21439260,203,2591,21439057,21439260
5369,4,1,1,2412,-67,-87,20,da:51:5c:d4:99:cb,21439660,1152,-752,21438508,21439660
5370,4,1,1,2412,-78,-87,9,,21445158,304,5194,21444854,21445158
5371,6,6,1,2412,-67,-87,20,,21445823,44,621,21445779,21445823
5372,4,11,1,2412,-84,-87,3,,21450687,107,4757,21450580,21450687
5373,4,11,1,2412,-85,-87,2,,21451281,107,487,21451174,21451281
5374,6,24,1,2412,-83,-87,4,,21453956,28,2647,21453928,21453956
5375,4,1,1,2412,-88,-87,-1,,21458475,304,4215,21458171,21458475
5376,4,1,1,2412,-86,-87,1,ac:67:84:84:8a:07,21465299,416,6408,21464883,21465299
5377,4,1,1,2412,-79,-87,8,b0:e4:d5:32:ec:8a,21469413,1960,2154,21467453,21469413
5378,4,1,1,2412,-85,-87,2,,21472747,304,3030,21472443,21472747
5379,6,6,1,2412,-79,-87,8,32:86:8c:5f:93:1e,21480756,332,7677,21480424,21480756
5380,4,1,1,2412,-82,-87,5,b4:b5:2f:17:0c:b9,21488469,1376,6337,21487093,21488469
5381,6,6,1,2412,-77,-87,10,e2:db:d1:d1:b0:4a,21489701,444,788,21489257,21489701
5382,6,6,1,2412,-77,-87,10,e2:db:d1:d1:b0:4d,21490628,408,519,21490220,21490628
5383,6,6,1,2412,-77,-87,10,e2:db:d1:d1:b0:4f,21491087,408,51,21490679,21491087
5384,6,6,1,2412,-79,-87,8,52:86:8c:5f:93:1e,21507273,332,15854,21506941,21507273
5385,4,11,1,2412,-80,-87,7,48:dd:0c:7d:86:27,21511985,362,4350,21511623,21511985
5386,4,11,1,2412,-81,-87,6,48:dd:0c:7d:86:23,21512359,323,51,21512036,21512359
5387,4,11,1,2412,-81,-87,6,48:dd:0c:7d:86:25,21512694,382,-47,21512312,21512694
5388,6,6,1,2412,-79,-87,8,,21513044,44,306,21513000,21513044
5389,4,11,1,2412,-82,-87,5,48:dd:0c:90:e3:85,21548596,382,35170,21548214,21548596
5390,6,6,1,2412,-81,-87,6,12:86:8c:5f:93:1e,21557557,332,8629,21557225,21557557
5391,4,11,1,2412,-83,-87,4,,21561001,203,3241,21560798,21561001
5392,4,1,1,2412,-84,-87,3,,21562456,352,1103,21562104,21562456
5393,4,11,1,2412,-83,-87,4,,21565200,107,2637,21565093,21565200
5394,4,11,1,2412,-84,-87,3,,21567174,107,1867,21567067,21567174
5395,4,11,1,2412,-83,-87,4,,21568558,107,1277,21568451,21568558
5396,4,1,1,2412,-85,-87,2,,21569999,448,993,21569551,21569999
5397,4,1,1,2412,-78,-87,9,b0:e4:d5:32:ec:8a,21571813,1960,-146,21569853,21571813
5398,4,1,1,2412,-87,-87,0,ac:67:84:84:8a:07,21580588,416,8359,21580172,21580588
5399,6,6,1,2412,-81,-87,6,32:86:8c:5f:93:1e,21583157,332,2237,21582825,21583157
5400,6,6,1,2412,-76,-87,11,e2:db:d1:d1:b0:4b,21591663,408,8098,21591255,21591663
5401,4,1,1,2412,-78,-87,9,3c:bd:c5:ee:96:6d,21602666,2512,8491,21600154,21602666
5402,6,6,1,2412,-81,-87,6,52:86:8c:5f:93:1e,21608757,332,5759,21608425,21608757
5403,4,11,1,2412,-81,-87,6,48:dd:0c:7d:86:23,21609790,254,779,21609536,21609790
5404,4,11,1,2412,-82,-87,5,48:dd:0c:90:e3:83,21610092,254,48,21609838,21610092
5405,4,11,1,2412,-80,-87,7,48:dd:0c:7d:86:27,21614385,362,3931,21614023,21614385
5406,4,11,1,2412,-81,-87,6,48:dd:0c:7d:86:23,21614759,323,51,21614436,21614759
5407,4,11,1,2412,-81,-87,6,48:dd:0c:7d:86:25,21615094,382,-47,21614712,21615094
5408,4,1,1,2412,-88,-87,-1,ac:67:84:84:8a:07,21622710,416,7200,21622294,21622710
5409,4,1,1,2412,-86,-87,1,,21626424,304,3410,21626120,21626424
5410,4,11,1,2412,-85,-87,2,,21633407,203,6780,21633204,21633407
5411,6,6,1,2412,-81,-87,6,10:86:8c:5f:93:1e,21634777,336,1034,21634441,21634777
5412,4,11,1,2412,-82,-87,5,48:dd:0c:90:e3:85,21650995,382,15836,21650613,21650995
5413,4,11,1,2412,-84,-87,3,,21652128,107,1026,21652021,21652128
5414,4,1,1,2412,-85,-87,2,78:67:0e:c4:a8:42,21652584,2736,-2280,21649848,21652584
5415,4,1,1,2412,-86,-87,1,,21655357,352,2421,21655005,21655357
5416,6,6,1,2412,-81,-87,6,12:86:8c:5f:93:1e,21660391,332,4702,21660059,21660391
5417,4,1,1,2412,-79,-87,8,b0:e4:d5:32:ec:8a,21674212,1960,11861,21672252,21674212
5418,6,6,1,2412,-80,-87,7,32:86:8c:5f:93:1e,21685723,332,11179,21685391,21685723
5419,4,1,1,2412,-85,-87,2,b4:b5:2f:17:0c:b9,21692347,1376,5248,21690971,21692347
5420,6,6,1,2412,-77,-87,10,e2:db:d1:d1:b0:4a,21693597,444,806,21693153,21693597
5421,6,6,1,2412,-75,-87,12,e2:db:d1:d1:b0:4b,21694065,408,60,21693657,21694065
5422,6,6,1,2412,-75,-87,12,e2:db:d1:d1:b0:4d,21694524,408,51,21694116,21694524
5423,6,6,1,2412,-75,-87,12,e2:db:d1:d1:b0:4f,21694956,408,24,21694548,21694956
5424,4,1,1,2412,-78,-87,9,3c:bd:c5:ee:96:6d,21704179,2512,6711,21701667,21704179
5425,6,6,1,2412,-80,-87,7,52:86:8c:5f:93:1e,21711317,332,6806,21710985,21711317
5426,6,24,1,2412,-84,-87,3,,21715656,32,4307,21715624,21715656
5427,4,11,1,2412,-81,-87,6,48:dd:0c:7d:86:27,21716784,362,766,21716422,21716784
5428,4,11,1,2412,-80,-87,7,48:dd:0c:7d:86:25,21717494,382,328,21717112,21717494
5429,6,24,1,2412,-82,-87,5,,21718331,28,809,21718303,21718331
5430,6,24,1,2412,-82,-87,5,,21718563,32,200,21718531,21718563
5431,6,24,1,2412,-82,-87,5,,21718934,32,339,21718902,21718934
5432,4,11,1,2412,-84,-87,3,,21728529,107,9488,21728422,21728529
5433,4,11,1,2412,-83,-87,4,,21730195,107,1559,21730088,21730195
5434,4,1,1,2412,-84,-87,3,,21730630,352,83,21730278,21730630
5435,4,11,1,2412,-84,-87,3,,21733185,107,2448,21733078,21733185
5436,4,11,1,2412,-84,-87,3,,21734113,107,821,21734006,21734113
5437,4,11,1,2412,-84,-87,3,,21734954,107,734,21734847,21734954
5438,6,6,1,2412,-79,-87,8,10:86:8c:5f:93:1e,21736758,336,1468,21736422,21736758
5439,4,1,1,2412,-83,-87,4,,21741830,352,4720,21741478,21741830
5440,6,24,1,2412,-82,-87,5,,21743066,32,1204,21743034,21743066
5441,4,11,1,2412,-84,-87,3,,21746479,107,3306,21746372,21746479
5442,4,1,1,2412,-84,-87,3,,21746908,352,77,21746556,21746908
5443,6,24,1,2412,-83,-87,4,,21747751,32,811,21747719,21747751
5444,6,24,1,2412,-83,-87,4,,21748143,32,360,21748111,21748143
5445,4,11,1,2412,-85,-87,2,,21748607,107,357,21748500,21748607
5446,4,1,1,2412,-83,-87,4,,21749107,352,148,21748755,21749107
5447,4,11,1,2412,-77,-87,10,48:dd:0c:90:e3:83,21753060,323,3630,21752737,21753060
5448,4,11,1,2412,-85,-87,2,48:dd:0c:90:e3:85,21753395,382,-47,21753013,21753395
5449,6,6,1,2412,-80,-87,7,12:86:8c:5f:93:1e,21762393,332,8666,21762061,21762393
5450,4,1,1,2412,-85,-87,2,,21767560,352,4815,21767208,21767560
5451,4,11,1,2412,-83,-87,4,,21769418,107,1751,21769311,21769418
5452,4,11,1,2412,-83,-87,4,,21770220,203,599,21770017,21770220
5453,4,11,1,2412,-84,-87,3,,21772795,107,2468,21772688,21772795
5454,4,11,1,2412,-86,-87,1,,21775680,203,2682,21775477,21775680
5455,4,1,1,2412,-78,-87,9,b0:e4:d5:32:ec:8a,21776611,1960,-1029,21774651,21776611
5456,6,6,1,2412,-80,-87,7,32:86:8c:5f:93:1e,21787958,332,11015,21787626,21787958
5457,4,11,1,2412,-80,-87,7,48:dd:0c:7d:86:23,21792742,254,4530,21792488,21792742
5458,6,6,1,2412,-77,-87,10,e2:db:d1:d1:b0:4a,21795981,444,2795,21795537,21795981
5459,6,6,1,2412,-77,-87,10,e2:db:d1:d1:b0:4b,21796458,408,69,21796050,21796458
5460,6,6,1,2412,-76,-87,11,e2:db:d1:d1:b0:4d,21796898,408,32,21796490,21796898
5461,6,6,1,2412,-77,-87,10,e2:db:d1:d1:b0:4f,21797339,408,33,21796931,21797339
5462,6,24,1,2412,-81,-87,6,,21799012,28,1645,21798984,21799012
5463,4,11,1,2412,-86,-87,1,,21801059,203,1844,21800856,21801059
5464,4,1,1,2412,-79,-87,8,3c:bd:c5:ee:96:6d,21806626,2512,3055,21804114,21806626
5465,4,1,1,2412,-88,-87,-1,bc:98:df:ff:0f:8b,21810181,2568,987,21807613,21810181
5466,6,6,1,2412,-80,-87,7,52:86:8c:5f:93:1e,21813559,332,3046,21813227,21813559
5467,6,6,1,2412,-86,-87,1,,21814571,44,968,21814527,21814571
5468,4,11,1,2412,-79,-87,8,48:dd:0c:7d:86:27,21819184,362,4251,21818822,21819184
5469,4,11,1,2412,-80,-87,7,48:dd:0c:7d:86:23,21819559,323,52,21819236,21819559
5470,4,1,1,2412,-90,-87,-3,00:1e:06:43:41:c9,21826169,976,5634,21825193,21826169
5471,4,1,1,2412,-88,-87,-1,c8:9e:43:bc:eb:fe,21827156,1016,-29,21826140,21827156
5472,4,1,1,2412,-88,-87,-1,c8:9e:43:bc:eb:fe,21828183,800,227,21827383,21828183
5473,4,1,1,2412,-92,-87,-5,,21830166,384,1599,21829782,21830166
5474,4,1,1,2412,-87,-87,0,,21830565,448,-49,21830117,21830565
5475,4,1,1,2412,-85,-87,2,,21837382,352,6465,21837030,21837382
5476,6,6,1,2412,-79,-87,8,10:86:8c:5f:93:1e,21841650,336,3932,21841314,21841650
5477,4,1,1,2412,-86,-87,1,78:67:0e:38:6c:d3,21846067,2736,1681,21843331,21846067
5478,6,24,1,2412,-81,-87,6,,21848794,32,2695,21848762,21848794
5479,4,11,1,2412,-76,-87,11,48:dd:0c:90:e3:83,21855460,323,6343,21855137,21855460
5480,4,11,1,2412,-83,-87,4,48:dd:0c:90:e3:85,21855795,382,-47,21855413,21855795
5481,4,1,1,2412,-85,-87,2,78:67:0e:c4:a8:42,21857384,2736,-1147,21854648,21857384
5482,6,24,1,2412,-83,-87,4,,21870247,28,12835,21870219,21870247
5483,6,24,1,2412,-81,-87,6,,21878057,32,7778,21878025,21878057
5484,4,1,1,2412,-78,-87,9,b0:e4:d5:32:ec:8a,21879011,1960,-1006,21877051,21879011
5485,6,6,1,2412,-80,-87,7,32:86:8c:5f:93:1e,21890359,332,11016,21890027,21890359
5486,4,1,1,2412,-86,-87,1,b4:b5:2f:17:0c:b9,21897150,1376,5415,21895774,21897150
5487,6,6,1,2412,-77,-87,10,e2:db:d1:d1:b0:4b,21898886,408,1328,21898478,21898886
5488,6,6,1,2412,-77,-87,10,e2:db:d1:d1:b0:4d,21899327,408,33,21898919,21899327
5489,6,6,1,2412,-77,-87,10,e2:db:d1:d1:b0:4f,21899759,408,24,21899351,21899759
5490,4,11,1,2412,-85,-87,2,,21904892,203,4930,21904689,21904892
5491,4,1,1,2412,-78,-87,9,3c:bd:c5:ee:96:6d,21908978,2512,1574,21906466,21908978
5492,6,6,1,2412,-76,-87,11,e0:db:d1:d0:b0:48,21912671,380,3313,21912291,21912671
5493,6,6,1,2412,-78,-87,9,52:86:8c:5f:93:1e,21915959,332,2956,21915627,21915959
5494,6,6,1,2412,-77,-87,10,e0:db:d1:d0:b0:48,21920309,392,3958,21919917,21920309
5495,4,11,1,2412,-80,-87,7,48:dd:0c:7d:86:27,21921584,362,913,21921222,21921584
5496,4,11,1,2412,-81,-87,6,48:dd:0c:7d:86:23,21921958,323,51,21921635,21921958
5497,4,11,1,2412,-80,-87,7,48:dd:0c:7d:86:25,21922294,382,-46,21921912,21922294
5498,6,6,1,2412,-77,-87,10,e0:db:d1:d0:b0:48,21923935,380,1261,21923555,21923935
5499,4,1,1,2412,-81,-87,6,,21944180,304,19941,21943876,21944180
5500,4,1,1,2412,-87,-87,0,78:67:0e:38:6c:d3,21948467,2736,1551,21945731,21948467
5501,6,24,1,2412,-83,-87,4,,21951208,28,2713,21951180,21951208
5502,4,11,1,2412,-76,-87,11,48:dd:0c:90:e3:87,21957485,362,5915,21957123,21957485
5503,4,11,1,2412,-83,-87,4,48:dd:0c:90:e3:85,21958195,382,328,21957813,21958195
5504,4,1,1,2412,-84,-87,3,78:67:0e:c4:a8:42,21959784,2736,-1147,21957048,21959784
5505,6,6,1,2412,-80,-87,7,12:86:8c:5f:93:1e,21967160,332,7044,21966828,21967160
5506,4,1,1,2412,-82,-87,5,00:26:62:eb:ea:74,21972988,968,4860,21972020,21972988
5507,4,1,1,2412,-84,-87,3,,21974430,304,1138,21974126,21974430
5508,4,1,1,2412,-77,-87,10,b0:e4:d5:32:ec:8a,21981410,1960,5020,21979450,21981410
5509,6,6,1,2412,-80,-87,7,32:86:8c:5f:93:1e,21992895,332,11153,21992563,21992895
5510,6,6,1,2412,-77,-87,10,f8:4f:ad:f9:af:82,21996582,576,3111,21996006,21996582
5511,6,6,1,2412,-77,-87,10,f8:4f:ad:f9:af:82,21999285,548,2155,21998737,21999285
5512,4,1,1,2412,-84,-87,3,b4:b5:2f:17:0c:b9,22000024,1376,-637,21998648,22000024
5513,6,6,1,2412,-77,-87,10,e2:db:d1:d1:b0:4a,22001256,444,788,22000812,22001256
5514,6,6,1,2412,-77,-87,10,e2:db:d1:d1:b0:4b,22001751,408,87,22001343,22001751
5515,6,6,1,2412,-77,-87,10,e2:db:d1:d1:b0:4d,22002183,408,24,22001775,22002183
5516,6,6,1,2412,-77,-87,10,e2:db:d1:d1:b0:4f,22002615,408,24,22002207,22002615
5517,4,11,1,2412,-84,-87,3,,22010142,107,7420,22010035,22010142
5518,4,11,1,2412,-84,-88,4,,22014120,107,3871,22014013,22014120
5519,6,12,1,2412,-84,-88,4,,22014267,44,103,22014223,22014267
5520,4,1,1,2412,-84,-88,4,,22014715,352,96,22014363,22014715
5521,6,6,1,2412,-80,-88,8,52:86:8c:5f:93:1e,22018391,332,3344,22018059,22018391
5522,4,11,1,2412,-79,-88,9,48:dd:0c:7d:86:27,22023984,362,5231,22023622,22023984
5523,4,11,1,2412,-79,-88,9,48:dd:0c:7d:86:23,22024358,323,51,22024035,22024358
5524,4,11,1,2412,-79,-88,9,48:dd:0c:7d:86:25,22024693,382,-47,22024311,22024693
5525,6,24,1,2412,-83,-88,5,,22030249,28,5528,22030221,22030249
5526,6,24,1,2412,-81,-88,7,,22037905,28,7628,22037877,22037905
5527,4,1,1,2412,-88,-88,0,d2:9e:43:bc:eb:ff,22040197,3600,-1308,22036597,22040197
5528,6,6,1,2412,-79,-88,9,10:86:8c:5f:93:1e,22043960,336,3427,22043624,22043960
5529,4,11,1,2412,-78,-88,10,48:dd:0c:90:e3:87,22059885,362,15563,22059523,22059885
5530,4,11,1,2412,-77,-88,11,48:dd:0c:90:e3:83,22060259,323,51,22059936,22060259
5531,4,11,1,2412,-82,-88,6,48:dd:0c:90:e3:85,22060594,382,-47,22060212,22060594
5532,6,6,1,2412,-81,-88,7,12:86:8c:5f:93:1e,22069560,332,8634,22069228,22069560
5533,4,1,1,2412,-85,-88,3,,22074325,304,4461,22074021,22074325
5534,4,1,1,2412,-88,-88,0,,22080039,448,5266,22079591,22080039
5535,4,11,1,2412,-85,-88,3,,22089565,107,9419,22089458,22089565
5536,4,1,1,2412,-83,-88,5,,22090314,352,397,22089962,22090314
5537,4,11,1,2412,-83,-88,5,,22092211,107,1790,22092104,22092211
5538,4,1,1,2412,-83,-88,5,,22092769,352,206,22092417,22092769
5539,4,1,1,2412,-83,-88,5,,22093981,352,860,22093629,22093981
5540,6,24,1,2412,-84,-88,4,,22094584,28,575,22094556,22094584
5541,6,6,1,2412,-80,-88,8,32:86:8c:5f:93:1e,22095252,332,336,22094920,22095252
5542,4,1,1,2412,-86,-88,2,b4:b5:2f:17:0c:b9,22102371,1376,5743,22100995,22102371
5543,6,6,1,2412,-77,-88,11,e2:db:d1:d1:b0:4a,22103622,444,807,22103178,22103622
5544,6,6,1,2412,-76,-88,12,e2:db:d1:d1:b0:4b,22104090,408,60,22103682,22104090
5545,6,6,1,2412,-77,-88,11,e2:db:d1:d1:b0:4d,22104522,408,24,22104114,22104522
5546,6,6,1,2412,-76,-88,12,e2:db:d1:d1:b0:4f,22104962,408,32,22104554,22104962
5547,4,1,1,2412,-79,-88,9,3c:bd:c5:ee:96:6d,22113862,2512,6388,22111350,22113862
5548,4,1,1,2412,-88,-88,0,bc:98:df:ff:0f:8a,22120282,976,5444,22119306,22120282
5549,4,1,1,2412,-89,-88,-1,bc:98:df:ff:0f:8a,22121268,976,10,22120292,22121268
5550,6,6,1,2412,-81,-88,7,52:86:8c:5f:93:1e,22122100,332,500,22121768,22122100
5551,6,6,1,2412,-77,-88,11,10:86:8c:5f:93:1e,22148742,336,26306,22148406,22148742
5552,6,6,1,2412,-80,-88,8,12:86:8c:5f:93:1e,22171961,332,22887,22171629,22171961
5553,6,6,1,2412,-76,-88,12,f8:4f:ad:f9:af:82,22181925,196,9768,22181729,22181925
5554,4,1,1,2412,-77,-88,11,b0:e4:d5:32:ec:8a,22186209,1960,2324,22184249,22186209
5555,6,6,1,2412,-79,-88,9,32:86:8c:5f:93:1e,22197562,332,11021,22197230,22197562
5556,4,1,1,2412,-90,-88,-2,b4:b5:2f:17:0c:b9,22204356,1376,5418,22202980,22204356
5557,6,6,1,2412,-77,-88,11,e2:db:d1:d1:b0:4a,22205588,444,788,22205144,22205588
5558,6,6,1,2412,-77,-88,11,e2:db:d1:d1:b0:4b,22206074,408,78,22205666,22206074
5559,6,6,1,2412,-76,-88,12,e2:db:d1:d1:b0:4d,22206524,408,42,22206116,22206524
5560,6,6,1,2412,-77,-88,11,e2:db:d1:d1:b0:4f,22206974,408,42,22206566,22206974
5561,4,1,1,2412,-87,-88,1,10:7b:44:eb:35:60,22213725,1960,4791,22211765,22213725
5562,4,1,1,2412,-80,-88,8,3c:bd:c5:ee:96:6d,22216202,2512,-35,22213690,22216202
5563,4,1,1,2412,-88,-88,0,bc:98:df:ff:0f:8a,22224823,976,7645,22223847,22224823
5564,6,6,1,2412,-80,-88,8,52:86:8c:5f:93:1e,22225654,332,499,22225322,22225654
5565,4,1,1,2412,-85,-88,3,,22226163,304,205,22225859,22226163
5566,4,11,1,2412,-81,-88,7,48:dd:0c:7d:86:27,22228783,362,2258,22228421,22228783
5567,4,11,1,2412,-81,-88,7,48:dd:0c:7d:86:25,22229493,382,328,22229111,22229493
5568,4,11,1,2412,-81,-88,7,,22243566,107,13966,22243459,22243566
5569,6,6,1,2412,-80,-88,8,10:86:8c:5f:93:1e,22248762,336,4860,22248426,22248762
5570,6,6,1,2412,-77,-88,11,f8:4f:ad:f9:af:82,22251715,576,2377,22251139,22251715
5571,4,1,1,2412,-85,-88,3,bc:98:df:ff:0f:8a,22252664,976,-27,22251688,22252664
5572,6,6,1,2412,-76,-88,12,f8:4f:ad:f9:af:82,22253635,548,423,22253087,22253635
5573,4,1,1,2412,-88,-88,0,,22255067,352,1080,22254715,22255067
5574,4,1,1,2412,-88,-88,0,,22255434,304,63,22255130,22255434
5575,4,1,1,2412,-86,-88,2,78:67:0e:38:6c:d3,22255667,2736,-2503,22252931,22255667
5576,4,1,1,2412,-77,-88,11,,22261876,352,5857,22261524,22261876
5577,4,11,1,2412,-82,-88,6,48:dd:0c:90:e3:85,22265394,382,3136,22265012,22265394
5578,4,1,1,2412,-86,-88,2,,22270934,304,5236,22270630,22270934
5579,6,6,1,2412,-80,-88,8,12:86:8c:5f:93:1e,22274362,332,3096,22274030,22274362
5580,4,1,1,2412,-78,-88,10,b0:e4:d5:32:ec:8a,22288608,1960,12286,22286648,22288608
5581,4,1,1,2412,-84,-88,4,0e:1f:71:52:01:49,22291620,656,2356,22290964,22291620
5582,4,1,1,2412,-77,-88,11,,22294654,304,2730,22294350,22294654
5583,6,6,1,2412,-76,-88,12,10:86:8c:5f:93:1e,22294804,500,-350,22294304,22294804
5584,4,1,1,2412,-76,-88,12,,22295593,304,485,22295289,22295593
5585,6,6,1,2412,-78,-88,10,10:86:8c:5f:93:1e,22295743,500,-350,22295243,22295743
5586,4,1,1,2412,-79,-88,9,3c:bd:c5:ee:96:6d,22297320,3280,-1703,22294040,22297320
5587,4,1,1,2412,-78,-88,10,3c:bd:c5:ee:96:6d,22300959,3280,359,22297679,22300959
5588,4,1,1,2412,-83,-88,5,,22304250,304,2987,22303946,22304250
5589,4,1,1,2412,-85,-88,3,,22307541,304,2987,22307237,22307541
5590,6,6,1,2412,-77,-88,11,e2:db:d1:d1:b0:4a,22309106,444,1121,22308662,22309106
5591,6,6,1,2412,-76,-88,12,e2:db:d1:d1:b0:4b,22310584,408,1070,22310176,22310584
5592,6,6,1,2412,-77,-88,11,e2:db:d1:d1:b0:4d,22311781,408,789,22311373,22311781
5593,6,6,1,2412,-77,-88,11,e2:db:d1:d1:b0:4f,22312230,408,41,22311822,22312230
5594,4,1,1,2412,-87,-88,1,10:7b:44:eb:35:60,22316102,1960,1912,22314142,22316102
5595,4,1,1,2412,-79,-88,9,3c:bd:c5:ee:96:6d,22319481,2512,867,22316969,22319481
5596,6,6,1,2412,-80,-88,8,52:86:8c:5f:93:1e,22325562,332,5749,22325230,22325562
5597,4,1,1,2412,-86,-88,2,,22327700,304,1834,22327396,22327700
5598,6,6,1,2412,-77,-88,11,f8:4f:ad:f9:af:82,22332344,632,4012,22331712,22332344
5599,6,24,1,2412,-83,-88,5,,22333963,28,1591,22333935,22333963
5600,4,1,1,2412,-80,-88,8,,22344442,304,10175,22344138,22344442
5601,6,6,1,2412,-79,-88,9,10:86:8c:5f:93:1e,22344592,500,-350,22344092,22344592
5602,4,1,1,2412,-80,-88,8,,22345373,304,477,22345069,22345373
5603,6,6,1,2412,-79,-88,9,10:86:8c:5f:93:1e,22345522,500,-351,22345022,22345522
5604,4,1,1,2412,-80,-88,8,,22346285,304,459,22345981,22346285
5605,6,6,1,2412,-80,-88,8,10:86:8c:5f:93:1e,22346434,500,-351,22345934,22346434
5606,4,1,1,2412,-77,-88,11,,22347242,304,504,22346938,22347242
5607,6,6,1,2412,-80,-88,8,10:86:8c:5f:93:1e,22351163,336,3585,22350827,22351163
5608,4,11,1,2412,-79,-88,9,10:86:8c:5f:93:26,22351698,347,188,22351351,22351698
5609,4,1,1,2412,-79,-88,9,,22352153,304,151,22351849,22352153
5610,6,6,1,2412,-80,-88,8,10:86:8c:5f:93:1e,22352303,500,-350,22351803,22352303
5611,4,1,1,2412,-81,-88,7,,22354510,304,1903,22354206,22354510
5612,6,6,1,2412,-79,-88,9,10:86:8c:5f:93:1e,22354660,500,-350,22354160,22354660
5613,4,1,1,2412,-82,-88,6,,22355422,304,458,22355118,22355422
5614,6,6,1,2412,-79,-88,9,10:86:8c:5f:93:1e,22355572,500,-350,22355072,22355572
5615,6,6,1,2412,-79,-88,9,b4:e6:2d:b4:ff:71,22356186,64,550,22356122,22356186
5616,6,6,1,2412,-80,-88,8,,22356266,44,36,22356222,22356266
5617,6,6,1,2412,-77,-88,11,f8:4f:ad:f9:af:82,22357172,248,658,22356924,22357172
5618,6,6,1,2412,-77,-88,11,f8:4f:ad:f9:af:82,22357453,224,57,22357229,22357453
5619,4,1,1,2412,-86,-88,2,78:67:0e:38:6c:d3,22358067,2736,-2122,22355331,22358067
5620,4,11,1,2412,-78,-88,10,48:dd:0c:90:e3:87,22367084,362,8655,22366722,22367084
5621,4,11,1,2412,-82,-88,6,48:dd:0c:90:e3:85,22367794,382,328,22367412,22367794
5622,4,1,1,2412,-86,-88,2,,22369803,304,1705,22369499,22369803
5623,4,1,1,2412,-87,-88,1,78:67:0e:c4:a8:42,22370127,2736,-2412,22367391,22370127
5624,4,1,1,2412,-78,-88,10,,22389898,304,19467,22389594,22389898
5625,4,1,1,2412,-75,-88,13,b0:e4:d5:32:ec:8a,22391007,1960,-851,22389047,22391007
5626,4,1,1,2412,-77,-88,11,78:67:0e:c4:a8:41,22394590,832,2751,22393758,22394590
5627,4,1,1,2412,-77,-88,11,,22404210,352,9268,22403858,22404210
5628,4,1,1,2412,-83,-88,5,,22408255,352,3693,22407903,22408255
5629,4,1,1,2412,-83,-88,5,b4:b5:2f:17:0c:b9,22409257,1376,-374,22407881,22409257
5630,6,6,1,2412,-77,-88,11,e2:db:d1:d1:b0:4a,22410490,444,789,22410046,22410490
5631,6,6,1,2412,-77,-88,11,e2:db:d1:d1:b0:4b,22410966,408,68,22410558,22410966
5632,4,11,1,2412,-89,-88,-1,48:dd:0c:7d:86:25,22412469,377,1126,22412092,22412469
5633,6,24,1,2412,-81,-88,7,,22413965,28,1468,22413937,22413965
5634,4,1,1,2412,-79,-88,9,3c:bd:c5:ee:96:6d,22421412,2512,4935,22418900,22421412
5635,6,6,1,2412,-80,-88,8,52:86:8c:5f:93:1e,22427963,332,6219,22427631,22427963
5636,6,24,1,2412,-83,-88,5,,22430782,28,2791,22430754,22430782
5637,4,11,1,2412,-81,-88,7,48:dd:0c:7d:86:27,22433583,362,2439,22433221,22433583
5638,4,11,1,2412,-81,-88,7,48:dd:0c:7d:86:23,22433957,323,51,22433634,22433957
5639,4,11,1,2412,-81,-88,7,48:dd:0c:7d:86:25,22434293,382,-46,22433911,22434293
5640,6,24,1,2412,-83,-88,5,,22439212,28,4891,22439184,22439212
5641,4,11,1,2412,-89,-88,-1,4c:01:43:d7:f3:26,22446427,387,6828,22446040,22446427
5642,6,6,1,2412,-78,-88,10,10:86:8c:5f:93:1e,22453563,336,6800,22453227,22453563
5643,4,1,1,2412,-87,-88,1,,22457505,448,3494,22457057,22457505
5644,4,1,1,2412,-87,-88,1,78:67:0e:38:6c:d3,22460467,2736,226,22457731,22460467
5645,4,11,1,2412,-77,-88,11,48:dd:0c:90:e3:87,22469484,362,8655,22469122,22469484
5646,4,11,1,2412,-77,-88,11,48:dd:0c:90:e3:83,22469858,323,51,22469535,22469858
5647,4,11,1,2412,-83,-88,5,48:dd:0c:90:e3:85,22470193,382,-47,22469811,22470193
5648,4,1,1,2412,-84,-88,4,,22471057,304,560,22470753,22471057
5649,6,6,1,2412,-81,-88,7,12:86:8c:5f:93:1e,22479216,332,7827,22478884,22479216
5650,4,1,1,2412,-87,-88,1,d2:9e:43:bc:eb:ff,22482561,3600,-255,22478961,22482561
5651,4,1,1,2412,-87,-88,1,c8:9e:43:bc:eb:ff,22486172,3496,115,22482676,22486172
5652,4,1,1,2412,-90,-88,-2,00:1e:06:43:41:c9,22489723,976,2575,22488747,22489723
5653,4,1,1,2412,-84,-88,4,,22491496,304,1469,22491192,22491496
5654,4,1,1,2412,-79,-88,9,b0:e4:d5:32:ec:8a,22493407,1960,-49,22491447,22493407
5655,4,1,1,2412,-89,-88,-1,16:0c:6b:2e:43:07,22498790,3800,1583,22494990,22498790
5656,6,6,1,2412,-76,-88,12,f8:4f:ad:f9:af:82,22504244,1332,4122,22502912,22504244
5657,4,1,1,2412,-86,-88,2,b4:b5:2f:17:0c:b9,22511561,1376,5941,22510185,22511561
5658,6,6,1,2412,-76,-88,12,e2:db:d1:d1:b0:4a,22512811,444,806,22512367,22512811
5659,6,6,1,2412,-77,-88,11,e2:db:d1:d1:b0:4b,22513297,408,78,22512889,22513297
5660,6,6,1,2412,-77,-88,11,e2:db:d1:d1:b0:4d,22513747,408,42,22513339,22513747
5661,6,6,1,2412,-77,-88,11,e2:db:d1:d1:b0:4f,22514206,408,51,22513798,22514206
5662,4,1,1,2412,-84,-88,4,,22520541,304,6031,22520237,22520541
5663,4,1,1,2412,-85,-88,3,ac:67:84:84:8a:07,22526489,416,5532,22526073,22526489
5664,4,1,1,2412,-85,-88,3,,22530296,304,3503,22529992,22530296
5665,6,6,1,2412,-81,-88,7,52:86:8c:5f:93:1e,22530752,332,124,22530420,22530752
5666,4,11,1,2412,-80,-88,8,48:dd:0c:7d:86:27,22535983,362,4869,22535621,22535983
5667,4,11,1,2412,-81,-88,7,48:dd:0c:7d:86:23,22536357,323,51,22536034,22536357
5668,4,11,1,2412,-81,-88,7,48:dd:0c:7d:86:25,22536692,382,-47,22536310,22536692
5669,6,6,1,2412,-79,-88,9,b4:e6:2d:b4:ff:71,22536972,64,216,22536908,22536972
5670,6,6,1,2412,-80,-88,8,,22537052,44,36,22537008,22537052
5671,4,1,1,2412,-87,-88,1,0e:b9:49:67:a0:d6,22544958,416,7490,22544542,22544958
5672,4,1,1,2412,-87,-88,1,,22546893,448,1487,22546445,22546893
5673,4,1,1,2412,-87,-88,1,,22547788,448,447,22547340,22547788
5674,4,1,1,2412,-86,-88,2,78:67:0e:38:6c:d3,22562868,2736,12344,22560132,22562868
5675,4,11,1,2412,-81,-88,7,4c:01:43:ec:a0:69,22566456,361,3227,22566095,22566456
5676,4,11,1,2412,-81,-88,7,4c:01:43:ec:a0:63,22566830,322,52,22566508,22566830
5677,4,11,1,2412,-83,-88,5,4c:01:43:ec:a0:66,22567164,387,-53,22566777,22567164
5678,4,11,1,2412,-80,-88,8,4e:f0:43:5e:cf:0e,22567891,357,370,22567534,22567891
5679,4,11,1,2412,-81,-88,7,4e:f0:43:5e:cf:0e,22568325,371,63,22567954,22568325
5680,4,11,1,2412,-77,-88,11,48:dd:0c:7d:86:2e,22570180,367,1488,22569813,22570180
5681,4,11,1,2412,-77,-88,11,48:dd:0c:90:e3:83,22572300,323,1797,22571977,22572300
5682,4,11,1,2412,-82,-88,6,48:dd:0c:90:e3:85,22572635,382,-47,22572253,22572635
5683,4,1,1,2412,-84,-88,4,78:67:0e:c4:a8:42,22574378,2736,-993,22571642,22574378
5684,4,1,1,2412,-86,-88,2,ac:67:84:84:8a:07,22578453,416,3659,22578037,22578453
5685,6,6,1,2412,-81,-88,7,12:86:8c:5f:93:1e,22581564,332,2779,22581232,22581564
5686,6,24,1,2412,-82,-88,6,,22590248,28,8656,22590220,22590248
5687,4,1,1,2412,-85,-88,3,,22592332,304,1780,22592028,22592332
5688,4,1,1,2412,-86,-88,2,ac:67:84:84:8a:07,22592975,416,227,22592559,22592975
5689,4,1,1,2412,-83,-88,5,,22615013,304,21734,22614709,22615013
5690,6,6,1,2412,-77,-88,11,e2:db:d1:d1:b0:4d,22616113,408,692,22615705,22616113
5691,4,1,1,2412,-90,-88,-2,ce:f4:11:65:3f:f8,22617766,2072,-419,22615694,22617766
5692,4,1,1,2412,-84,-88,4,,22622834,304,4764,22622530,22622834
5693,4,1,1,2412,-86,-88,2,10:7b:44:eb:35:60,22623299,1960,-1495,22621339,22623299
5694,4,1,1,2412,-78,-88,10,b8:f8:53:cb:31:f1,22628912,976,4637,22627936,22628912
5695,6,6,1,2412,-80,-88,8,52:86:8c:5f:93:1e,22632765,332,3521,22632433,22632765
5696,4,11,1,2412,-80,-88,8,48:dd:0c:7d:86:27,22638382,362,5255,22638020,22638382
5697,4,11,1,2412,-80,-88,8,48:dd:0c:7d:86:23,22638757,323,52,22638434,22638757
5698,4,11,1,2412,-81,-88,7,48:dd:0c:7d:86:25,22639092,382,-47,22638710,22639092
5699,4,1,1,2412,-87,-88,1,ac:67:84:84:8a:07,22645014,416,5506,22644598,22645014
5700,4,1,1,2412,-89,-88,-1,,22645442,304,124,22645138,22645442
5701,6,24,1,2412,-82,-88,6,,22653969,28,8499,22653941,22653969
5702,4,11,1,2412,-75,-88,13,48:dd:0c:90:e3:87,22674283,362,19952,22673921,22674283
5703,4,11,1,2412,-76,-88,12,48:dd:0c:90:e3:83,22674658,323,52,22674335,22674658
5704,4,11,1,2412,-80,-88,8,48:dd:0c:90:e3:85,22674993,382,-47,22674611,22674993
5705,4,1,1,2412,-86,-88,2,ac:67:84:84:8a:07,22679968,416,4559,22679552,22679968
5706,4,1,1,2412,-90,-88,-2,,22680396,304,124,22680092,22680396
5707,4,1,1,2412,-87,-88,1,ac:67:84:84:8a:07,22681020,416,208,22680604,22681020
5708,4,1,1,2412,-90,-88,-2,,22681449,304,125,22681145,22681449
5709,6,6,1,2412,-80,-88,8,12:86:8c:5f:93:1e,22686310,332,4529,22685978,22686310
5710,4,1,1,2412,-83,-88,5,,22686905,304,291,22686601,22686905
5711,4,1,1,2412,-85,-88,3,,22687960,304,751,22687656,22687960
5712,4,1,1,2412,-79,-88,9,b0:e4:d5:32:ec:8a,22698205,1960,8285,22696245,22698205
5713,4,1,1,2412,-88,-88,0,d2:9e:43:bc:eb:ff,22703743,3600,1938,22700143,22703743
5714,6,6,1,2412,-78,-88,10,32:86:8c:5f:93:1e,22709565,332,5490,22709233,22709565
5715,6,6,1,2412,-77,-88,11,e2:db:d1:d1:b0:4a,22718368,444,8359,22717924,22718368
5716,6,6,1,2412,-76,-88,12,e2:db:d1:d1:b0:4b,22718835,408,59,22718427,22718835
5717,4,1,1,2412,-87,-88,1,ac:67:84:84:8a:07,22721236,416,1985,22720820,22721236
5718,4,1,1,2412,-78,-88,10,3c:bd:c5:ee:96:6d,22728572,2512,4824,22726060,22728572
5719,6,6,1,2412,-80,-88,8,52:86:8c:5f:93:1e,22735165,332,6261,22734833,22735165
5720,4,11,1,2412,-82,-88,6,48:dd:0c:7d:86:27,22740783,362,5256,22740421,22740783
5721,4,11,1,2412,-80,-88,8,48:dd:0c:7d:86:23,22741158,323,52,22740835,22741158
5722,4,11,1,2412,-81,-88,7,48:dd:0c:7d:86:25,22741493,382,-47,22741111,22741493
5723,6,24,1,2412,-82,-88,6,,22745817,28,4296,22745789,22745817
5724,4,1,1,2412,-89,-88,-1,ac:67:84:84:8a:07,22747120,416,887,22746704,22747120
5725,4,1,1,2412,-89,-88,-1,,22747548,304,124,22747244,22747548
5726,4,1,1,2412,-87,-88,1,,22749183,448,1187,22748735,22749183
5727,6,24,1,2412,-83,-88,5,,22751039,28,1828,22751011,22751039
5728,4,1,1,2412,-84,-88,4,,22751414,352,23,22751062,22751414
5729,4,1,1,2412,-85,-88,3,78:67:0e:38:6c:d3,22767668,2736,13518,22764932,22767668
5730,4,1,1,2412,-88,-88,0,ac:67:84:84:8a:07,22777987,416,9903,22777571,22777987
5731,4,1,1,2412,-84,-88,4,,22778415,304,124,22778111,22778415
5732,4,1,1,2412,-82,-88,6,78:67:0e:c4:a8:42,22779024,2736,-2127,22776288,22779024
5733,4,1,1,2412,-81,-88,7,,22781797,352,2421,22781445,22781797
5734,4,11,1,2412,-85,-88,3,,22783953,203,1953,22783750,22783953
5735,6,6,1,2412,-81,-88,7,12:86:8c:5f:93:1e,22786366,332,2081,22786034,22786366
5736,4,11,1,2412,-83,-88,5,,22797730,107,11257,22797623,22797730
5737,4,1,1,2412,-86,-88,2,,22798342,352,260,22797990,22798342
5738,4,11,1,2412,-84,-88,4,,22800236,107,1787,22800129,22800236
5739,4,1,1,2412,-77,-88,11,b0:e4:d5:32:ec:8a,22800997,1960,-1199,22799037,22800997
5740,6,6,1,2412,-79,-88,9,32:86:8c:5f:93:1e,22811966,332,10637,22811634,22811966
5741,4,1,1,2412,-85,-88,3,b4:b5:2f:17:0c:b9,22818766,1376,5424,22817390,22818766
5742,6,6,1,2412,-76,-88,12,e2:db:d1:d1:b0:4a,22819999,444,789,22819555,22819999
5743,6,6,1,2412,-76,-88,12,e2:db:d1:d1:b0:4b,22820484,408,77,22820076,22820484
5744,4,1,1,2412,-87,-88,1,,22822753,304,1965,22822449,22822753
5745,4,1,1,2412,-78,-88,10,3c:bd:c5:ee:96:6d,22831061,2512,5796,22828549,22831061
5746,4,1,1,2412,-87,-88,1,bc:98:df:ff:0f:8b,22834842,2568,1213,22832274,22834842
5747,6,6,1,2412,-80,-88,8,52:86:8c:5f:93:1e,22838445,332,3271,22838113,22838445
5748,4,1,1,2412,-87,-88,1,,22838900,448,7,22838452,22838900
5749,4,1,1,2412,-88,-88,0,,22839939,448,591,22839491,22839939
5750,4,1,1,2412,-85,-88,3,,22840876,304,633,22840572,22840876
5751,4,1,1,2412,-86,-88,2,,22841931,304,751,22841627,22841931
5752,4,11,1,2412,-90,-88,-2,4c:01:43:d7:f3:23,22855690,322,13437,22855368,22855690
5753,6,24,1,2412,-83,-88,5,,22860217,28,4499,22860189,22860217
5754,4,1,1,2412,-78,-88,10,,22878334,304,17813,22878030,22878334
5755,4,11,1,2412,-86,-88,2,48:dd:0c:90:e3:85,22879792,382,1076,22879410,22879792
5756,6,6,1,2412,-80,-88,8,12:86:8c:5f:93:1e,22891483,332,11359,22891151,22891483
5757,6,24,1,2412,-82,-88,6,,22898358,28,6847,22898330,22898358
5758,4,1,1,2412,-79,-88,9,b0:e4:d5:32:ec:8a,22903004,1960,2686,22901044,22903004
5759,6,24,1,2412,-83,-88,5,,22906368,28,3336,22906340,22906368
5760,6,24,1,2412,-82,-88,6,,22910252,28,3856,22910224,22910252
5761,6,6,1,2412,-80,-88,8,32:86:8c:5f:93:1e,22914367,332,3783,22914035,22914367
5762,6,6,1,2412,-77,-88,11,e2:db:d1:d1:b0:4a,22922400,444,7589,22921956,22922400
5763,6,6,1,2412,-77,-88,11,e2:db:d1:d1:b0:4b,22922877,408,69,22922469,22922877
5764,6,6,1,2412,-77,-88,11,e2:db:d1:d1:b0:4d,22923309,408,24,22922901,22923309
5765,6,6,1,2412,-76,-88,12,e2:db:d1:d1:b0:4f,22923750,408,33,22923342,22923750
5766,4,1,1,2412,-79,-88,9,3c:bd:c5:ee:96:6d,22932976,2512,6714,22930464,22932976
5767,4,1,1,2412,-78,-88,10,7a:69:2f:c5:b4:03,22935532,1608,948,22933924,22935532
5768,6,6,1,2412,-79,-88,9,52:86:8c:5f:93:1e,22939967,332,4103,22939635,22939967
5769,4,1,1,2412,-84,-88,4,,22941957,304,1686,22941653,22941957
5770,4,11,1,2412,-80,-88,8,48:dd:0c:7d:86:25,22946292,382,3953,22945910,22946292
5771,4,1,1,2412,-83,-88,5,,22971449,304,24853,22971145,22971449
5772,4,1,1,2412,-83,-88,5,,22972236,304,483,22971932,22972236
5773,6,24,1,2412,-82,-88,6,,22975505,28,3241,22975477,22975505
5774,4,1,1,2412,-76,-88,12,,22979066,304,3257,22978762,22979066
5775,4,11,1,2412,-77,-88,11,48:dd:0c:90:e3:83,22981857,323,2468,22981534,22981857
5776,4,11,1,2412,-82,-88,6,48:dd:0c:90:e3:85,22982192,382,-47,22981810,22982192
5777,4,1,1,2412,-84,-88,4,78:67:0e:c4:a8:42,22983782,2736,-1146,22981046,22983782
5778,6,6,1,2412,-80,-88,8,12:86:8c:5f:93:1e,22991167,332,7053,22990835,22991167
5779,4,1,1,2412,-84,-86,2,,23022088,304,30617,23021784,23022088
5780,6,6,1,2412,-76,-86,10,e2:db:d1:d1:b0:4a,23024660,444,2128,23024216,23024660
5781,6,6,1,2412,-76,-86,10,e2:db:d1:d1:b0:4b,23026328,408,1260,23025920,23026328
5782,6,6,1,2412,-77,-86,9,e2:db:d1:d1:b0:4d,23026760,408,24,23026352,23026760
5783,6,6,1,2412,-76,-86,10,e2:db:d1:d1:b0:4f,23027210,408,42,23026802,23027210
5784,4,1,1,2412,-83,-86,3,,23029576,352,2014,23029224,23029576
5785,4,1,1,2412,-78,-86,8,3c:bd:c5:ee:96:6d,23035383,2512,3295,23032871,23035383
5786,4,1,1,2412,-88,-86,-2,bc:98:df:ff:0f:8b,23038964,2568,1013,23036396,23038964
5787,4,1,1,2412,-85,-86,1,,23042595,304,3327,23042291,23042595
5788,4,1,1,2412,-86,-86,0,,23044466,448,1423,23044018,23044466
5789,4,11,1,2412,-78,-86,8,48:dd:0c:7d:86:25,23048692,382,3844,23048310,23048692
5790,6,24,1,2412,-82,-86,4,,23054173,32,5449,23054141,23054173
5791,4,11,1,2412,-85,-86,1,,23055748,107,1468,23055641,23055748
5792,4,11,1,2412,-85,-86,1,,23056306,107,451,23056199,23056306
5793,4,1,1,2412,-86,-86,0,,23058089,384,1399,23057705,23058089
5794,4,1,1,2412,-89,-86,-3,,23058873,384,400,23058489,23058873
5795,4,1,1,2412,-84,-86,2,,23059270,448,-51,23058822,23059270
5796,6,24,1,2412,-82,-86,4,,23065322,28,6024,23065294,23065322
5797,6,6,1,2412,-80,-86,6,10:86:8c:5f:93:1e,23067968,336,2310,23067632,23067968
5798,6,24,1,2412,-82,-86,4,,23071133,28,3137,23071105,23071133
5799,4,1,1,2412,-84,-86,2,,23074543,304,3106,23074239,23074543
5800,4,1,1,2412,-86,-86,0,78:67:0e:38:6c:d3,23075169,2736,-2110,23072433,23075169
5801,4,1,1,2412,-87,-86,-1,,23078356,304,2883,23078052,23078356
5802,4,11,1,2412,-77,-86,9,48:dd:0c:90:e3:87,23083882,362,5164,23083520,23083882
5803,4,11,1,2412,-84,-86,2,48:dd:0c:90:e3:85,23084592,382,328,23084210,23084592
5804,4,1,1,2412,-85,-86,1,78:67:0e:c4:a8:42,23086182,2736,-1146,23083446,23086182
5805,4,11,1,2412,-83,-86,3,,23089523,107,3234,23089416,23089523
5806,4,1,1,2412,-84,-86,2,,23090153,352,278,23089801,23090153
5807,4,11,1,2412,-85,-86,1,,23092240,107,1980,23092133,23092240
5808,4,1,1,2412,-85,-86,1,,23092807,352,215,23092455,23092807
5809,6,6,1,2412,-80,-86,6,12:86:8c:5f:93:1e,23093568,332,429,23093236,23093568
5810,4,1,1,2412,-79,-86,7,b0:e4:d5:32:ec:8a,23107803,1960,12275,23105843,23107803
5811,6,6,1,2412,-80,-86,6,32:86:8c:5f:93:1e,23119168,332,11033,23118836,23119168
5812,4,1,1,2412,-86,-86,0,,23121107,304,1635,23120803,23121107
5813,6,6,1,2412,-76,-86,10,e2:db:d1:d1:b0:4a,23127260,444,5709,23126816,23127260
5814,6,6,1,2412,-76,-86,10,e2:db:d1:d1:b0:4b,23127728,408,60,23127320,23127728
5815,6,6,1,2412,-76,-86,10,e2:db:d1:d1:b0:4d,23128186,408,50,23127778,23128186
5816,6,6,1,2412,-77,-86,9,e2:db:d1:d1:b0:4f,23128645,408,51,23128237,23128645
5817,4,1,1,2412,-86,-86,0,bc:98:df:ff:0f:8b,23129141,3176,-2680,23125965,23129141
5818,4,1,1,2412,-85,-86,1,bc:98:df:ff:0f:8b,23132690,3176,373,23129514,23132690
5819,4,1,1,2412,-79,-86,7,3c:bd:c5:ee:96:6d,23137792,2512,2590,23135280,23137792
5820,4,1,1,2412,-85,-86,1,,23141190,304,3094,23140886,23141190
5821,6,6,1,2412,-81,-86,5,52:86:8c:5f:93:1e,23144768,332,3246,23144436,23144768
5822,6,24,1,2412,-82,-86,4,,23145323,28,527,23145295,23145323
5823,4,1,1,2412,-89,-86,-3,d2:9e:43:bc:eb:ff,23146108,3600,-2815,23142508,23146108
5824,4,11,1,2412,-82,-86,4,48:dd:0c:7d:86:23,23150757,323,4326,23150434,23150757
5825,4,11,1,2412,-80,-86,6,48:dd:0c:7d:86:25,23151092,382,-47,23150710,23151092
5826,6,24,1,2412,-83,-86,3,,23157892,28,6772,23157864,23157892
5827,4,11,1,2412,-87,-86,-1,4c:01:43:d7:f3:29,23164502,361,6249,23164141,23164502
5828,4,1,1,2412,-86,-86,0,,23166327,304,1521,23166023,23166327
5829,6,6,1,2412,-78,-86,8,10:86:8c:5f:93:1e,23170368,336,3705,23170032,23170368
5830,6,6,1,2412,-80,-86,6,b4:e6:2d:b4:ff:71,23172549,64,2117,23172485,23172549
5831,6,6,1,2412,-80,-86,6,,23172630,44,37,23172586,23172630
5832,4,11,1,2412,-77,-86,9,48:dd:0c:90:e3:85,23186992,382,13980,23186610,23186992
5833,4,1,1,2412,-84,-86,2,78:67:0e:c4:a8:42,23188582,2736,-1146,23185846,23188582
5834,4,11,1,2412,-86,-86,0,,23192740,107,4051,23192633,23192740
5835,4,1,1,2412,-84,-86,2,,23193361,352,269,23193009,23193361
5836,4,11,1,2412,-84,-86,2,,23195196,107,1728,23195089,23195196
5837,4,1,1,2412,-85,-86,1,,23195773,352,225,23195421,23195773
5838,6,6,1,2412,-80,-86,6,12:86:8c:5f:93:1e,23196720,332,615,23196388,23196720
5839,4,1,1,2412,-85,-86,1,,23198432,352,1360,23198080,23198432
5840,4,1,1,2412,-78,-86,8,b0:e4:d5:32:ec:8a,23210202,1960,9810,23208242,23210202
5841,4,1,1,2412,-87,-86,-1,ac:67:84:84:8a:07,23221476,416,10858,23221060,23221476
5842,6,24,1,2412,-82,-86,4,,23226129,28,4625,23226101,23226129
5843,6,6,1,2412,-85,-86,1,,23226368,44,195,23226324,23226368
5844,6,6,1,2412,-84,-86,2,,23226557,44,145,23226513,23226557
5845,4,1,1,2412,-85,-86,1,b4:b5:2f:17:0c:b9,23228373,1376,440,23226997,23228373
5846,6,6,1,2412,-76,-86,10,e2:db:d1:d1:b0:4a,23229606,444,789,23229162,23229606
5847,6,6,1,2412,-76,-86,10,e2:db:d1:d1:b0:4b,23230092,408,78,23229684,23230092
5848,6,6,1,2412,-76,-86,10,e2:db:d1:d1:b0:4d,23230542,408,42,23230134,23230542
5849,6,6,1,2412,-76,-86,10,e2:db:d1:d1:b0:4f,23230973,408,23,23230565,23230973
5850,4,1,1,2412,-85,-86,1,,23231926,304,649,23231622,23231926
5851,4,1,1,2412,-86,-86,0,ac:67:84:84:8a:07,23232467,416,125,23232051,23232467
5852,4,1,1,2412,-79,-86,7,3c:bd:c5:ee:96:6d,23241087,2512,6108,23238575,23241087
5853,4,1,1,2412,-80,-86,6,88:71:b1:b4:0e:c7,23243643,3320,-764,23240323,23243643
5854,6,6,1,2412,-80,-86,6,52:86:8c:5f:93:1e,23247169,332,3194,23246837,23247169
5855,4,1,1,2412,-88,-86,-2,,23250098,448,2481,23249650,23250098
5856,4,1,1,2412,-90,-86,-4,,23250577,384,95,23250193,23250577
5857,4,1,1,2412,-87,-86,-1,,23250975,448,-50,23250527,23250975
5858,4,11,1,2412,-79,-86,7,48:dd:0c:7d:86:27,23252782,362,1445,23252420,23252782
5859,4,11,1,2412,-79,-86,7,48:dd:0c:7d:86:23,23253156,323,51,23252833,23253156
5860,4,11,1,2412,-79,-86,7,48:dd:0c:7d:86:25,23253492,382,-46,23253110,23253492
5861,4,1,1,2412,-90,-86,-4,ce:9e:43:bc:eb:ff,23256699,3800,-593,23252899,23256699
5862,4,11,1,2412,-81,-86,5,48:dd:0c:7d:86:23,23264162,254,7209,23263908,23264162
5863,6,6,1,2412,-81,-86,5,10:86:8c:5f:93:1e,23272769,336,8271,23272433,23272769
5864,4,1,1,2412,-85,-86,1,ac:67:84:84:8a:07,23274617,416,1432,23274201,23274617
5865,4,1,1,2412,-85,-86,1,,23279416,304,4495,23279112,23279416
5866,4,11,1,2412,-76,-86,10,48:dd:0c:90:e3:87,23288682,362,8904,23288320,23288682
5867,4,11,1,2412,-76,-86,10,48:dd:0c:90:e3:83,23289056,323,51,23288733,23289056
5868,4,11,1,2412,-83,-86,3,48:dd:0c:90:e3:85,23289391,382,-47,23289009,23289391
5869,4,1,1,2412,-84,-86,2,78:67:0e:c4:a8:42,23290982,2736,-1145,23288246,23290982
5870,6,24,1,2412,-83,-86,3,,23294191,28,3181,23294163,23294191
5871,4,1,1,2412,-87,-86,-1,ac:67:84:84:8a:07,23295412,416,805,23294996,23295412
5872,6,6,1,2412,-81,-86,5,12:86:8c:5f:93:1e,23298370,332,2626,23298038,23298370
5873,4,1,1,2412,-89,-86,-3,7a:a2:22:ca:52:27,23307460,2168,6922,23305292,23307460
5874,6,24,1,2412,-82,-86,4,,23310580,28,3092,23310552,23310580
5875,4,1,1,2412,-78,-86,8,b0:e4:d5:32:ec:8a,23312601,1960,61,23310641,23312601
5876,4,1,1,2412,-86,-86,0,ac:67:84:84:8a:07,23328434,416,15417,23328018,23328434
5877,4,1,1,2412,-88,-86,-2,ac:67:84:84:8a:07,23329487,416,637,23329071,23329487
5878,6,6,1,2412,-76,-86,10,e2:db:d1:d1:b0:4a,23331857,444,1926,23331413,23331857
5879,6,6,1,2412,-76,-86,10,e2:db:d1:d1:b0:4b,23332333,408,68,23331925,23332333
5880,6,6,1,2412,-76,-86,10,e2:db:d1:d1:b0:4f,23333224,408,483,23332816,23333224
5881,4,1,1,2412,-85,-86,1,b4:b5:2f:17:0c:b9,23333954,1376,-646,23332578,23333954
5882,4,1,1,2412,-83,-86,3,,23338253,304,3995,23337949,23338253
5883,4,1,1,2412,-87,-86,-1,bc:98:df:ff:0f:8b,23346180,2568,5359,23343612,23346180
5884,6,6,1,2412,-81,-86,5,52:86:8c:5f:93:1e,23349570,332,3058,23349238,23349570
5885,4,1,1,2412,-86,-86,0,,23352846,448,2828,23352398,23352846
5886,4,1,1,2412,-86,-86,0,,23353936,448,642,23353488,23353936
5887,4,11,1,2412,-79,-86,7,48:dd:0c:7d:86:27,23355182,362,884,23354820,23355182
5888,4,11,1,2412,-80,-86,6,48:dd:0c:7d:86:23,23355556,323,51,23355233,23355556
5889,4,11,1,2412,-81,-86,5,48:dd:0c:7d:86:25,23355891,382,-47,23355509,23355891
5890,6,6,1,2412,-81,-86,5,b4:e6:2d:b4:ff:71,23356153,64,198,23356089,23356153
5891,6,6,1,2412,-81,-86,5,,23356233,44,36,23356189,23356233
5892,6,6,1,2412,-81,-86,5,b4:e6:2d:b4:ff:71,23356458,64,161,23356394,23356458
5893,6,6,1,2412,-81,-86,5,,23356538,44,36,23356494,23356538
5894,4,1,1,2412,-86,-86,0,,23378560,304,21718,23378256,23378560
5895,4,1,1,2412,-87,-86,-1,78:67:0e:38:6c:d3,23382069,2736,773,23379333,23382069
5896,6,24,1,2412,-81,-86,5,,23385325,28,3228,23385297,23385325
5897,4,11,1,2412,-85,-86,1,4c:01:43:ec:a0:66,23386355,387,643,23385968,23386355
5898,4,11,1,2412,-82,-86,4,48:dd:0c:90:e3:85,23391791,382,5054,23391409,23391791
5899,6,6,1,2412,-85,-86,1,,23392640,44,805,23392596,23392640
5900,4,1,1,2412,-84,-86,2,78:67:0e:c4:a8:42,23394494,2736,-882,23391758,23394494
5901,6,24,1,2412,-83,-86,3,,23398537,28,4015,23398509,23398537
5902,4,1,1,2412,-85,-86,1,,23399084,304,243,23398780,23399084
5903,6,6,1,2412,-82,-86,4,12:86:8c:5f:93:1e,23400770,332,1354,23400438,23400770
5904,4,1,1,2412,-84,-86,2,,23418324,304,17250,23418020,23418324
5905,6,6,1,2412,-79,-86,7,32:86:8c:5f:93:1e,23426371,332,7715,23426039,23426371
5906,4,1,1,2412,-82,-86,4,,23428159,304,1484,23427855,23428159
5907,4,1,1,2412,-85,-86,1,b4:b5:2f:17:0c:b9,23433177,1376,3642,23431801,23433177
5908,6,6,1,2412,-76,-86,10,e2:db:d1:d1:b0:4a,23434427,444,806,23433983,23434427
5909,6,6,1,2412,-77,-86,9,e2:db:d1:d1:b0:4b,23434913,408,78,23434505,23434913
5910,6,6,1,2412,-77,-86,9,e2:db:d1:d1:b0:4d,23435372,408,51,23434964,23435372
5911,6,6,1,2412,-76,-86,10,e2:db:d1:d1:b0:4f,23435822,408,42,23435414,23435822
5912,4,1,1,2412,-79,-86,7,3c:bd:c5:ee:96:6d,23445002,2512,6668,23442490,23445002
5913,4,1,1,2412,-88,-86,-2,bc:98:df:ff:0f:8b,23448566,2568,996,23445998,23448566
5914,6,6,1,2412,-80,-86,6,52:86:8c:5f:93:1e,23451971,332,3073,23451639,23451971
5915,6,24,1,2412,-82,-86,4,,23453972,28,1973,23453944,23453972
5916,4,1,1,2412,-90,-86,-4,,23455188,384,832,23454804,23455188
5917,4,1,1,2412,-88,-86,-2,,23455586,448,-50,23455138,23455586
5918,4,1,1,2412,-89,-86,-3,,23456092,384,122,23455708,23456092
5919,4,1,1,2412,-88,-86,-2,,23456491,448,-49,23456043,23456491
5920,4,11,1,2412,-80,-86,6,48:dd:0c:7d:86:27,23457582,362,729,23457220,23457582
5921,4,11,1,2412,-80,-86,6,48:dd:0c:7d:86:23,23457956,323,51,23457633,23457956
5922,4,11,1,2412,-79,-86,7,48:dd:0c:7d:86:25,23458291,382,-47,23457909,23458291
5923,4,1,1,2412,-84,-86,2,,23470459,304,11864,23470155,23470459
5924,6,24,1,2412,-84,-86,2,,23470707,28,220,23470679,23470707
5925,6,6,1,2412,-80,-86,6,10:86:8c:5f:93:1e,23477571,336,6528,23477235,23477571
5926,4,1,1,2412,-91,-86,-5,c8:9e:43:bc:eb:ff,23483295,3496,2228,23479799,23483295
5927,4,1,1,2412,-78,-86,8,,23491554,304,7955,23491250,23491554
5928,4,11,1,2412,-76,-86,10,48:dd:0c:90:e3:87,23493481,362,1565,23493119,23493481
5929,4,11,1,2412,-85,-86,1,48:dd:0c:90:e3:85,23494191,382,328,23493809,23494191
5930,4,1,1,2412,-85,-86,1,78:67:0e:c4:a8:42,23495782,2736,-1145,23493046,23495782
5931,6,6,1,2412,-76,-86,10,f8:4f:ad:f9:af:82,23506489,1360,9347,23505129,23506489
5932,6,6,1,2412,-77,-86,9,f8:4f:ad:f9:af:82,23508530,1332,709,23507198,23508530
5933,4,1,1,2412,-70,-86,16,b0:e4:d5:32:ec:8a,23517400,1960,6910,23515440,23517400
5934,6,6,1,2412,-81,-86,5,32:86:8c:5f:93:1e,23528771,332,11039,23528439,23528771
5935,6,24,1,2412,-83,-86,3,,23533988,28,5189,23533960,23533988
5936,6,6,1,2412,-75,-86,11,e2:db:d1:d1:b0:4b,23537306,408,2910,23536898,23537306
5937,6,6,1,2412,-76,-86,10,e2:db:d1:d1:b0:4f,23538188,408,474,23537780,23538188
5938,6,24,1,2412,-81,-86,5,,23550382,28,12166,23550354,23550382
5939,4,1,1,2412,-86,-86,0,bc:98:df:ff:0f:8b,23550991,2568,-1959,23548423,23550991
5940,6,24,1,2412,-83,-86,3,,23558436,28,7417,23558408,23558436
5941,4,11,1,2412,-81,-86,5,48:dd:0c:7d:86:27,23559981,362,1183,23559619,23559981
5942,4,11,1,2412,-79,-86,7,48:dd:0c:7d:86:23,23560356,323,52,23560033,23560356
5943,4,11,1,2412,-80,-86,6,48:dd:0c:7d:86:25,23560691,382,-47,23560309,23560691
5944,4,1,1,2412,-84,-86,2,,23576838,304,15843,23576534,23576838
5945,6,6,1,2412,-79,-86,7,10:86:8c:5f:93:1e,23579971,336,2797,23579635,23579971
5946,4,1,1,2412,-84,-86,2,,23590366,352,10043,23590014,23590366
5947,4,1,1,2412,-84,-86,2,,23591613,352,895,23591261,23591613
5948,4,1,1,2412,-78,-86,8,,23593447,352,1482,23593095,23593447
5949,4,1,1,2412,-84,-86,2,78:67:0e:c4:a8:42,23598182,2736,1999,23595446,23598182
5950,4,11,1,2412,-84,-86,2,,23601641,107,3352,23601534,23601641
5951,6,12,1,2412,-85,-86,1,,23602444,44,759,23602400,23602444
5952,6,6,1,2412,-80,-86,6,12:86:8c:5f:93:1e,23605572,332,2796,23605240,23605572
5953,4,1,1,2412,-78,-86,8,b0:e4:d5:32:ec:8a,23619799,1960,12267,23617839,23619799
5954,6,24,1,2412,-83,-86,3,,23626810,28,6983,23626782,23626810
5955,6,6,1,2412,-75,-86,11,e2:db:d1:d1:b0:4b,23639717,408,12499,23639309,23639717
5956,4,1,1,2412,-78,-86,8,3c:bd:c5:ee:96:6d,23649784,2512,7555,23647272,23649784
5957,4,1,1,2412,-84,-86,2,,23652989,304,2901,23652685,23652989
5958,4,1,1,2412,-86,-86,0,bc:98:df:ff:0f:8b,23653375,2568,-2182,23650807,23653375
5959,6,6,1,2412,-80,-86,6,52:86:8c:5f:93:1e,23656772,332,3065,23656440,23656772
5960,4,11,1,2412,-80,-86,6,48:dd:0c:7d:86:23,23662756,323,5661,23662433,23662756
5961,4,11,1,2412,-84,-86,2,48:dd:0c:90:e3:83,23665872,254,2862,23665618,23665872
5962,4,11,1,2412,-80,-86,6,48:dd:0c:7d:86:23,23666174,254,48,23665920,23666174
5963,4,11,1,2412,-88,-86,-2,4c:01:43:d7:f3:29,23674512,361,7977,23674151,23674512
5964,4,1,1,2412,-84,-86,2,,23675664,304,848,23675360,23675664
5965,6,6,1,2412,-80,-86,6,12:86:8c:5f:93:1e,23708478,332,32482,23708146,23708478
5966,4,1,1,2412,-78,-86,8,b0:e4:d5:32:ec:8a,23722199,1960,11761,23720239,23722199
5967,6,6,1,2412,-83,-86,3,,23724925,44,2682,23724881,23724925
5968,4,1,1,2412,-85,-86,1,b4:b5:2f:17:0c:b9,23740382,1376,14081,23739006,23740382
5969,6,6,1,2412,-76,-86,10,e2:db:d1:d1:b0:4a,23741642,444,816,23741198,23741642
5970,6,6,1,2412,-77,-86,9,e2:db:d1:d1:b0:4b,23742110,408,60,23741702,23742110
5971,6,6,1,2412,-76,-86,10,e2:db:d1:d1:b0:4d,23742568,408,50,23742160,23742568
5972,6,6,1,2412,-77,-86,9,e2:db:d1:d1:b0:4f,23743000,408,24,23742592,23743000
5973,4,1,1,2412,-79,-86,7,3c:bd:c5:ee:96:6d,23752174,2512,6662,23749662,23752174
5974,4,1,1,2412,-88,-86,-2,bc:98:df:ff:0f:8b,23756604,2568,1862,23754036,23756604
5975,6,6,1,2412,-79,-86,7,52:86:8c:5f:93:1e,23759173,332,2237,23758841,23759173
5976,4,11,1,2412,-80,-86,6,48:dd:0c:7d:86:23,23765155,323,5659,23764832,23765155
5977,4,1,1,2412,-87,-86,-1,,23767660,304,2201,23767356,23767660
5978,4,1,1,2412,-85,-86,1,,23775664,304,7700,23775360,23775664
5979,4,11,1,2412,-90,-86,-4,4c:01:43:d7:f3:23,23777286,322,1300,23776964,23777286
5980,6,6,1,2412,-81,-86,5,10:86:8c:5f:93:1e,23784773,336,7151,23784437,23784773
5981,6,24,1,2412,-82,-86,4,,23790263,28,5462,23790235,23790263
5982,4,1,1,2412,-88,-86,-2,78:67:0e:38:6c:d3,23791669,2736,-1330,23788933,23791669
5983,4,11,1,2412,-84,-86,2,48:dd:0c:90:e3:85,23801390,382,9339,23801008,23801390
5984,4,1,1,2412,-85,-86,1,78:67:0e:c4:a8:42,23802981,2736,-1145,23800245,23802981
5985,4,1,1,2412,-87,-86,-1,00:1e:06:43:41:c9,23821470,976,17513,23820494,23821470
5986,4,1,1,2412,-79,-86,7,b0:e4:d5:32:ec:8a,23824598,1960,1168,23822638,23824598
5987,6,6,1,2412,-79,-86,7,32:86:8c:5f:93:1e,23835973,332,11043,23835641,23835973
5988,4,1,1,2412,-84,-86,2,,23838493,304,2216,23838189,23838493
5989,4,1,1,2412,-85,-86,1,b4:b5:2f:17:0c:b9,23842784,1376,2915,23841408,23842784
5990,6,6,1,2412,-76,-86,10,e2:db:d1:d1:b0:4a,23844026,444,798,23843582,23844026
5991,6,6,1,2412,-76,-86,10,e2:db:d1:d1:b0:4b,23844520,408,86,23844112,23844520
5992,6,6,1,2412,-77,-86,9,e2:db:d1:d1:b0:4d,23844952,408,24,23844544,23844952
5993,6,6,1,2412,-76,-86,10,e2:db:d1:d1:b0:4f,23845411,408,51,23845003,23845411
5994,4,11,1,2412,-80,-86,6,48:dd:0c:7d:86:23,23848728,254,3063,23848474,23848728
5995,4,1,1,2412,-78,-86,8,3c:bd:c5:ee:96:6d,23854882,2512,3642,23852370,23854882
5996,6,6,1,2412,-79,-86,7,52:86:8c:5f:93:1e,23861573,332,6359,23861241,23861573
5997,4,11,1,2412,-80,-86,6,48:dd:0c:7d:86:23,23867555,323,5659,23867232,23867555
5998,4,11,1,2412,-80,-86,6,48:dd:0c:7d:86:25,23867890,382,-47,23867508,23867890
5999,4,1,1,2412,-86,-86,0,,23871175,304,2981,23870871,23871175
6000,4,1,1,2412,-83,-86,3,,23877546,304,6067,23877242,23877546
6001,6,24,1,2412,-83,-86,3,,23878315,28,741,23878287,23878315
6002,4,1,1,2412,-84,-86,2,,23882296,448,3533,23881848,23882296
6003,4,1,1,2412,-84,-86,2,,23883191,448,447,23882743,23883191
6004,6,6,1,2412,-79,-86,7,10:86:8c:5f:93:1e,23887174,336,3647,23886838,23887174
6005,4,1,1,2412,-84,-86,2,,23887785,304,307,23887481,23887785
6006,6,6,1,2412,-83,-86,3,,23887938,44,109,23887894,23887938
6007,4,1,1,2412,-86,-86,0,78:67:0e:38:6c:d3,23894070,2736,3396,23891334,23894070
6008,4,11,1,2412,-76,-86,10,48:dd:0c:90:e3:87,23903080,362,8648,23902718,23903080
6009,4,11,1,2412,-77,-86,9,48:dd:0c:90:e3:83,23903455,323,52,23903132,23903455
6010,4,11,1,2412,-84,-86,2,48:dd:0c:90:e3:85,23903790,382,-47,23903408,23903790
6011,4,1,1,2412,-85,-86,1,78:67:0e:c4:a8:42,23905381,2736,-1145,23902645,23905381
6012,4,1,1,2412,-87,-86,-1,ce:9e:43:bc:eb:ff,23920378,3800,11197,23916578,23920378
6013,6,24,1,2412,-81,-86,5,,23933974,28,13568,23933946,23933974
6014,6,6,1,2412,-79,-86,7,32:86:8c:5f:93:1e,23938374,332,4068,23938042,23938374
6015,6,6,1,2412,-76,-86,10,e2:db:d1:d1:b0:4a,23946264,444,7446,23945820,23946264
6016,6,6,1,2412,-77,-86,9,e2:db:d1:d1:b0:4d,23948151,408,1479,23947743,23948151
6017,6,6,1,2412,-76,-86,10,e2:db:d1:d1:b0:4f,23948583,408,24,23948175,23948583
6018,6,24,1,2412,-82,-86,4,,23950260,28,1649,23950232,23950260
6019,4,11,1,2412,-86,-86,0,,23951161,107,794,23951054,23951161
6020,4,1,1,2412,-85,-86,1,,23952817,352,1304,23952465,23952817
6021,4,1,1,2412,-85,-86,1,,23956447,352,3278,23956095,23956447
6022,4,1,1,2412,-79,-86,7,3c:bd:c5:ee:96:6d,23957952,2520,-1015,23955432,23957952
6023,4,11,1,2412,-78,-86,8,,23963190,203,5035,23962987,23963190
6024,4,1,1,2412,-79,-86,7,3c:bd:c5:ee:96:6d,23963445,432,-177,23963013,23963445
6025,4,11,1,2412,-79,-86,7,48:dd:0c:7d:86:27,23969580,362,5773,23969218,23969580
6026,4,11,1,2412,-79,-86,7,48:dd:0c:7d:86:23,23969955,323,52,23969632,23969955
6027,4,11,1,2412,-78,-86,8,48:dd:0c:7d:86:25,23970290,382,-47,23969908,23970290
6028,4,1,1,2412,-85,-86,1,,23975466,304,4872,23975162,23975466
6029,4,1,1,2412,-86,-86,0,,23976518,304,748,23976214,23976518
6030,4,1,1,2412,-91,-86,-5,,23980173,304,3351,23979869,23980173
6031,4,1,1,2412,-87,-86,-1,ac:67:84:84:8a:07,23980496,416,-93,23980080,23980496
6032,4,1,1,2412,-87,-86,-1,ac:67:84:84:8a:07,23981549,416,637,23981133,23981549
6033,4,1,1,2412,-81,-86,5,,23988448,352,6547,23988096,23988448
6034,4,1,1,2412,-80,-86,6,,23989333,352,533,23988981,23989333
6035,4,1,1,2412,-80,-86,6,,23990183,352,498,23989831,23990183
6036,4,1,1,2412,-84,-86,2,,23991034,352,499,23990682,23991034
6037,4,1,1,2412,-84,-86,2,,23992255,352,869,23991903,23992255
6038,6,6,1,2412,-79,-86,7,10:86:8c:5f:93:1e,23993209,336,618,23992873,23993209
6039,4,1,1,2412,-86,-86,0,78:67:0e:38:6c:d3,23996470,2736,525,23993734,23996470
6040,4,11,1,2412,-77,-86,9,48:dd:0c:90:e3:83,24005854,323,9061,24005531,24005854
6041,4,11,1,2412,-83,-86,3,48:dd:0c:90:e3:85,24006190,382,-46,24005808,24006190
6042,4,1,1,2412,-85,-86,1,78:67:0e:c4:a8:42,24007781,2736,-1145,24005045,24007781
6043,6,24,1,2412,-83,-87,4,,24013980,28,6171,24013952,24013980
6044,6,6,1,2412,-81,-87,6,12:86:8c:5f:93:1e,24015175,332,863,24014843,24015175
6045,4,1,1,2412,-79,-87,8,b0:e4:d5:32:ec:8a,24029397,1960,12262,24027437,24029397
6046,4,1,1,2412,-88,-87,-1,d2:9e:43:bc:eb:ff,24032614,3600,-383,24029014,24032614
6047,4,1,1,2412,-84,-87,3,b4:b5:2f:17:0c:b9,24047588,1376,13598,24046212,24047588
6048,6,6,1,2412,-75,-87,12,e2:db:d1:d1:b0:4a,24048820,444,788,24048376,24048820
6049,6,6,1,2412,-77,-87,10,e2:db:d1:d1:b0:4b,24049297,408,69,24048889,24049297
6050,6,6,1,2412,-76,-87,11,e2:db:d1:d1:b0:4d,24049738,408,33,24049330,24049738
6051,6,6,1,2412,-76,-87,11,e2:db:d1:d1:b0:4f,24050197,408,51,24049789,24050197
6052,4,11,1,2412,-84,-87,3,,24052896,203,2496,24052693,24052896
6053,4,11,1,2412,-87,-87,0,,24054407,107,1404,24054300,24054407
6054,4,11,1,2412,-87,-87,0,,24055150,107,636,24055043,24055150
6055,6,12,1,2412,-83,-87,4,,24055942,44,748,24055898,24055942
6056,4,1,1,2412,-78,-87,9,3c:bd:c5:ee:96:6d,24060317,2512,1863,24057805,24060317
6057,4,1,1,2412,-87,-87,0,bc:98:df:ff:0f:8b,24062992,2568,107,24060424,24062992
6058,4,11,1,2412,-79,-87,8,,24081873,203,18678,24081670,24081873
6059,4,11,1,2412,-84,-87,3,,24089543,107,7563,24089436,24089543
6060,4,11,1,2412,-84,-87,3,,24090199,107,549,24090092,24090199
6061,4,1,1,2412,-86,-87,1,,24090846,352,295,24090494,24090846
6062,4,1,1,2412,-84,-87,3,,24094096,352,2898,24093744,24094096
6063,4,1,1,2412,-87,-87,0,ac:67:84:84:8a:07,24095525,416,1013,24095109,24095525
6064,4,1,1,2412,-87,-87,0,78:67:0e:38:6c:d3,24098870,2736,609,24096134,24098870
6065,4,11,1,2412,-85,-87,2,4c:01:43:ec:a0:69,24102439,361,3208,24102078,24102439
6066,4,11,1,2412,-76,-87,11,48:dd:0c:90:e3:83,24108254,323,5492,24107931,24108254
6067,4,11,1,2412,-84,-87,3,48:dd:0c:90:e3:85,24108589,382,-47,24108207,24108589
6068,6,24,1,2412,-84,-87,3,,24116550,28,7933,24116522,24116550
6069,6,24,1,2412,-83,-87,4,,24116912,32,330,24116880,24116912
6070,6,6,1,2412,-80,-87,7,12:86:8c:5f:93:1e,24117575,332,331,24117243,24117575
6071,4,1,1,2412,-87,-87,0,ac:67:84:84:8a:07,24127055,416,9064,24126639,24127055
6072,6,6,1,2412,-85,-87,2,,24129358,44,2259,24129314,24129358
6073,4,1,1,2412,-86,-87,1,ac:67:84:84:8a:07,24129850,416,76,24129434,24129850
6074,4,11,1,2412,-85,-87,2,,24130207,107,250,24130100,24130207
6075,4,1,1,2412,-79,-87,8,b0:e4:d5:32:ec:8a,24131796,1960,-371,24129836,24131796
6076,4,1,1,2412,-84,-87,3,,24135769,352,3621,24135417,24135769
6077,4,1,1,2412,-84,-87,3,,24136998,352,877,24136646,24136998
6078,6,6,1,2412,-80,-87,7,32:86:8c:5f:93:1e,24143176,332,5846,24142844,24143176
6079,4,1,1,2412,-78,-87,9,3c:bd:c5:ee:96:6d,24161786,2512,16098,24159274,24161786
6080,4,1,1,2412,-78,-87,9,7a:69:2f:c5:b4:03,24164352,1840,726,24162512,24164352
6081,6,6,1,2412,-80,-87,7,52:86:8c:5f:93:1e,24168776,332,4092,24168444,24168776
6082,4,1,1,2412,-89,-87,-2,ac:67:84:84:8a:07,24173151,416,3959,24172735,24173151
6083,4,11,1,2412,-80,-87,7,48:dd:0c:7d:86:27,24174380,362,867,24174018,24174380
6084,4,11,1,2412,-80,-87,7,48:dd:0c:7d:86:23,24174754,323,51,24174431,24174754
6085,4,11,1,2412,-80,-87,7,48:dd:0c:7d:86:25,24175090,382,-46,24174708,24175090
6086,6,24,1,2412,-81,-87,6,,24197996,28,22878,24197968,24197996
6087,4,1,1,2412,-87,-87,0,78:67:0e:38:6c:d3,24201270,2736,538,24198534,24201270
6088,6,6,1,2412,-86,-87,1,,24205871,44,4557,24205827,24205871
6089,4,11,1,2412,-77,-87,10,48:dd:0c:90:e3:87,24210279,362,4046,24209917,24210279
6090,4,11,1,2412,-84,-87,3,48:dd:0c:90:e3:85,24210989,382,328,24210607,24210989
6091,4,1,1,2412,-87,-87,0,78:67:0e:c4:a8:42,24212581,2736,-1144,24209845,24212581
6092,4,11,1,2412,-87,-87,0,4c:01:43:ec:a0:73,24217714,284,4849,24217430,24217714
6093,6,6,1,2412,-78,-87,9,76:a2:c1:67:70:44,24219789,308,1767,24219481,24219789
6094,6,6,1,2412,-77,-87,10,e0:db:d1:d0:b0:48,24220516,308,419,24220208,24220516
6095,6,6,1,2412,-77,-87,10,b2:e2:49:f6:8a:4e,24220884,308,60,24220576,24220884
6096,6,6,1,2412,-77,-87,10,f8:4f:ad:f9:af:82,24221225,156,185,24221069,24221225
6097,6,6,1,2412,-77,-87,10,f8:4f:ad:f9:af:82,24223585,656,1704,24222929,24223585
6098,6,6,1,2412,-76,-87,11,f8:4f:ad:f9:af:82,24224274,632,57,24223642,24224274
6099,6,6,1,2412,-77,-87,10,e0:db:d1:d0:b0:48,24224984,156,554,24224828,24224984
6100,6,6,1,2412,-77,-87,10,f8:4f:ad:f9:af:82,24225209,196,29,24225013,24225209
6101,6,6,1,2412,-77,-87,10,f8:4f:ad:f9:af:82,24225473,156,108,24225317,24225473
6102,4,1,1,2412,-79,-87,8,b0:e4:d5:32:ec:8a,24234195,1960,6762,24232235,24234195
6103,6,6,1,2412,-80,-87,7,32:86:8c:5f:93:1e,24245577,332,11050,24245245,24245577
6104,6,6,1,2412,-76,-87,11,e2:db:d1:d1:b0:4b,24254206,408,8221,24253798,24254206
6105,6,6,1,2412,-76,-87,11,e2:db:d1:d1:b0:4d,24254638,408,24,24254230,24254638
6106,4,1,1,2412,-86,-87,1,,24255615,304,673,24255311,24255615
6107,4,1,1,2412,-87,-87,0,c8:9e:43:bc:eb:ff,24257414,3496,-1697,24253918,24257414
6108,4,1,1,2412,-79,-87,8,3c:bd:c5:ee:96:6d,24264245,2512,4319,24261733,24264245
6109,4,1,1,2412,-86,-87,1,bc:98:df:ff:0f:8b,24267891,2568,1078,24265323,24267891
6110,6,24,1,2412,-82,-87,5,,24270751,28,2832,24270723,24270751
6111,6,6,1,2412,-81,-87,6,52:86:8c:5f:93:1e,24271177,332,94,24270845,24271177
6112,4,1,1,2412,-86,-87,1,,24272999,304,1518,24272695,24272999
6113,4,1,1,2412,-83,-87,4,,24276306,304,3003,24276002,24276306
6114,4,11,1,2412,-81,-87,6,48:dd:0c:7d:86:27,24276780,362,112,24276418,24276780
6115,4,11,1,2412,-81,-87,6,48:dd:0c:7d:86:23,24277154,323,51,24276831,24277154
6116,6,6,1,2412,-79,-87,8,10:86:8c:5f:93:1e,24299396,336,21906,24299060,24299396
6117,4,1,1,2412,-84,-87,3,78:67:0e:38:6c:d3,24303670,2736,1538,24300934,24303670
6118,4,1,1,2412,-84,-87,3,78:67:0e:c4:a8:42,24314980,2736,8574,24312244,24314980
6119,4,1,1,2412,-85,-87,2,,24318167,304,2883,24317863,24318167
6120,4,1,1,2412,-85,-87,2,,24319663,304,1192,24319359,24319663
6121,4,1,1,2412,-88,-87,-1,,24320681,304,714,24320377,24320681
6122,6,6,1,2412,-82,-87,5,12:86:8c:5f:93:1e,24322493,332,1480,24322161,24322493
6123,4,1,1,2412,-88,-87,-1,,24330550,448,7609,24330102,24330550
6124,6,24,1,2412,-82,-87,5,,24333983,28,3405,24333955,24333983
6125,4,1,1,2412,-78,-87,9,b0:e4:d5:32:ec:8a,24336595,1960,652,24334635,24336595
6126,6,6,1,2412,-80,-87,7,32:86:8c:5f:93:1e,24347977,332,11050,24347645,24347977
6127,6,24,1,2412,-82,-87,5,,24351286,28,3281,24351258,24351286
6128,6,6,1,2412,-85,-87,2,e0:db:d1:37:3f:8f,24353976,212,2478,24353764,24353976
6129,6,6,1,2412,-75,-87,12,e2:db:d1:d1:b0:4b,24356529,408,2145,24356121,24356529
6130,6,6,1,2412,-77,-87,10,e2:db:d1:d1:b0:4f,24357402,408,465,24356994,24357402
6131,4,11,1,2412,-84,-87,3,48:dd:0c:90:e3:85,24358887,377,1108,24358510,24358887
6132,4,11,1,2412,-83,-87,4,48:dd:0c:90:e3:85,24359394,377,130,24359017,24359394
6133,4,1,1,2412,-86,-87,1,,24361058,304,1360,24360754,24361058
6134,4,1,1,2412,-75,-87,12,,24366634,304,5272,24366330,24366634
6135,4,1,1,2412,-88,-87,-1,,24371183,448,4101,24370735,24371183
6136,4,1,1,2412,-86,-87,1,,24374532,304,3045,24374228,24374532
6137,4,1,1,2412,-85,-87,2,,24375350,304,514,24375046,24375350
6138,4,11,1,2412,-81,-87,6,48:dd:0c:7d:86:27,24379180,362,3468,24378818,24379180
6139,4,11,1,2412,-80,-87,7,48:dd:0c:7d:86:23,24379554,323,51,24379231,24379554
6140,4,11,1,2412,-79,-87,8,48:dd:0c:7d:86:25,24379889,382,-47,24379507,24379889
6141,4,1,1,2412,-84,-87,3,,24381410,304,1217,24381106,24381410
6142,6,6,1,2412,-88,-87,-1,e0:db:d1:37:3f:8f,24381592,212,-30,24381380,24381592
6143,4,1,1,2412,-79,-87,8,,24382661,304,765,24382357,24382661
6144,6,6,1,2412,-79,-87,8,10:86:8c:5f:93:1e,24382811,500,-350,24382311,24382811
6145,4,1,1,2412,-83,-87,4,,24383557,304,442,24383253,24383557
6146,6,6,1,2412,-79,-87,8,10:86:8c:5f:93:1e,24383707,500,-350,24383207,24383707
6147,4,1,1,2412,-80,-87,7,,24385409,304,1398,24385105,24385409
6148,6,6,1,2412,-81,-87,6,10:86:8c:5f:93:1e,24385558,500,-351,24385058,24385558
6149,4,11,1,2412,-80,-87,7,48:dd:0c:7d:86:25,24386339,377,404,24385962,24386339
6150,4,1,1,2412,-85,-87,2,,24389543,352,2852,24389191,24389543
6151,4,1,1,2412,-86,-87,1,78:67:0e:38:6c:d3,24406070,2736,13791,24403334,24406070
6152,4,11,1,2412,-83,-87,4,48:dd:0c:90:e3:85,24415789,382,9337,24415407,24415789
6153,4,1,1,2412,-84,-87,3,78:67:0e:c4:a8:42,24417380,2736,-1145,24414644,24417380
6154,6,6,1,2412,-76,-87,11,f8:4f:ad:f9:af:82,24423058,248,5430,24422810,24423058
6155,6,6,1,2412,-76,-87,11,f8:4f:ad:f9:af:82,24424570,224,1288,24424346,24424570
6156,4,1,1,2412,-88,-87,-1,ac:67:84:84:8a:07,24428247,416,3261,24427831,24428247
6157,6,24,1,2412,-82,-87,5,,24430810,28,2535,24430782,24430810
6158,6,24,1,2412,-82,-87,5,,24437917,28,7079,24437889,24437917
6159,6,6,1,2412,-78,-87,9,32:86:8c:5f:93:1e,24450378,332,12129,24450046,24450378
6160,4,1,1,2412,-85,-87,2,b4:b5:2f:17:0c:b9,24457195,1376,5441,24455819,24457195
6161,6,6,1,2412,-76,-87,11,e2:db:d1:d1:b0:4a,24458436,444,797,24457992,24458436
6162,6,6,1,2412,-77,-87,10,e2:db:d1:d1:b0:4b,24458922,408,78,24458514,24458922
6163,6,6,1,2412,-77,-87,10,e2:db:d1:d1:b0:4d,24459354,408,24,24458946,24459354
6164,6,6,1,2412,-77,-87,10,e2:db:d1:d1:b0:4f,24459804,408,42,24459396,24459804
6165,4,1,1,2412,-78,-87,9,3c:bd:c5:ee:96:6d,24469900,2512,7584,24467388,24469900
6166,4,1,1,2412,-79,-87,8,b8:f8:53:cb:31:f1,24472465,976,1589,24471489,24472465
6167,4,1,1,2412,-88,-87,-1,00:1e:06:43:41:c9,24480362,976,6921,24479386,24480362
6168,4,11,1,2412,-80,-87,7,48:dd:0c:7d:86:23,24481954,323,1269,24481631,24481954
6169,4,11,1,2412,-81,-87,6,48:dd:0c:7d:86:25,24482289,382,-47,24481907,24482289
6170,6,24,1,2412,-82,-87,5,,24494703,28,12386,24494675,24494703
6171,4,1,1,2412,-80,-87,7,78:67:0e:38:6c:d3,24508470,2736,11031,24505734,24508470
6172,6,24,1,2412,-82,-87,5,,24511423,28,2925,24511395,24511423
6173,4,11,1,2412,-83,-87,4,48:dd:0c:90:e3:87,24517479,362,5694,24517117,24517479
6174,4,11,1,2412,-83,-87,4,48:dd:0c:90:e3:83,24517853,323,51,24517530,24517853
6175,4,1,1,2412,-77,-87,10,78:67:0e:c4:a8:42,24519938,2736,-651,24517202,24519938
6176,6,6,1,2412,-82,-87,5,12:86:8c:5f:93:1e,24527179,332,6909,24526847,24527179
6177,6,6,1,2412,-83,-87,4,,24530020,44,2797,24529976,24530020
6178,4,1,1,2412,-85,-87,2,,24534361,304,4037,24534057,24534361
6179,4,1,1,2412,-77,-87,10,b0:e4:d5:32:ec:8a,24541393,1960,5072,24539433,24541393
6180,6,6,1,2412,-81,-87,6,32:86:8c:5f:93:1e,24552779,332,11054,24552447,24552779
6181,4,1,1,2412,-84,-87,3,b4:b5:2f:17:0c:b9,24560342,1376,6187,24558966,24560342
6182,6,6,1,2412,-76,-87,11,e2:db:d1:d1:b0:4a,24561593,444,807,24561149,24561593
6183,6,6,1,2412,-76,-87,11,e2:db:d1:d1:b0:4b,24562079,408,78,24561671,24562079
6184,6,6,1,2412,-76,-87,11,e2:db:d1:d1:b0:4d,24562519,408,32,24562111,24562519
6185,6,6,1,2412,-77,-87,10,e2:db:d1:d1:b0:4f,24562952,408,25,24562544,24562952
6186,4,1,1,2412,-79,-87,8,3c:bd:c5:ee:96:6d,24571395,2512,5931,24568883,24571395
6187,6,24,1,2412,-82,-87,5,,24573987,28,2564,24573959,24573987
6188,4,11,1,2412,-86,-87,1,4c:01:43:ec:a0:63,24575522,254,1281,24575268,24575522
6189,4,11,1,2412,-78,-87,9,48:dd:0c:7d:86:27,24583979,362,8095,24583617,24583979
6190,4,11,1,2412,-80,-87,7,48:dd:0c:7d:86:23,24584354,323,52,24584031,24584354
6191,4,11,1,2412,-80,-87,7,48:dd:0c:7d:86:25,24584689,382,-47,24584307,24584689
6192,4,1,1,2412,-85,-87,2,,24586257,448,1120,24585809,24586257
6193,4,1,1,2412,-85,-87,2,,24592001,304,5440,24591697,24592001
6194,6,24,1,2412,-83,-87,4,,24597917,28,5888,24597889,24597917
6195,6,6,1,2412,-80,-87,7,10:86:8c:5f:93:1e,24603979,336,5726,24603643,24603979
6196,4,1,1,2412,-72,-87,15,78:67:0e:c4:a8:42,24622180,2736,15465,24619444,24622180
6197,4,1,1,2412,-78,-87,9,b0:e4:d5:32:ec:8a,24643793,1960,19653,24641833,24643793
6198,4,1,1,2412,-83,-87,4,,24653664,304,9567,24653360,24653664
6199,6,6,1,2412,-77,-87,10,e2:db:d1:d1:b0:4d,24664194,408,10122,24663786,24664194
6200,6,6,1,2412,-76,-87,11,e2:db:d1:d1:b0:4f,24664652,408,50,24664244,24664652
6201,6,6,1,2412,-80,-87,7,52:86:8c:5f:93:1e,24680780,332,15796,24680448,24680780
6202,4,11,1,2412,-81,-87,6,48:dd:0c:7d:86:27,24686379,362,5237,24686017,24686379
6203,4,11,1,2412,-81,-87,6,48:dd:0c:7d:86:23,24686753,323,51,24686430,24686753
6204,4,11,1,2412,-80,-87,7,48:dd:0c:7d:86:25,24687089,382,-46,24686707,24687089
6205,4,1,1,2412,-89,-87,-2,,24688655,384,1182,24688271,24688655
6206,4,1,1,2412,-87,-87,0,,24689054,448,-49,24688606,24689054
6207,4,1,1,2412,-88,-87,-1,,24689940,448,438,24689492,24689940
6208,6,6,1,2412,-77,-87,10,10:86:8c:5f:93:1e,24706380,336,16104,24706044,24706380
6209,6,6,1,2412,-76,-87,11,f8:4f:ad:f9:af:82,24712491,576,5535,24711915,24712491
6210,4,1,1,2412,-79,-87,8,,24720936,304,8141,24720632,24720936
6211,4,1,1,2412,-81,-87,6,78:67:0e:c4:a8:42,24724580,2736,908,24721844,24724580
6212,4,1,1,2412,-87,-87,0,ac:67:84:84:8a:07,24729222,416,4226,24728806,24729222
6213,4,1,1,2412,-86,-87,1,ac:67:84:84:8a:07,24730472,416,834,24730056,24730472
6214,6,6,1,2412,-80,-87,7,12:86:8c:5f:93:1e,24732397,332,1593,24732065,24732397
6215,6,24,1,2412,-82,-87,5,,24733985,28,1560,24733957,24733985
6216,4,1,1,2412,-84,-87,3,,24741302,304,7013,24740998,24741302
6217,4,1,1,2412,-79,-87,8,b0:e4:d5:32:ec:8a,24746192,1960,2930,24744232,24746192
6218,6,24,1,2412,-82,-87,5,,24750272,28,4052,24750244,24750272
6219,6,6,1,2412,-79,-87,8,32:86:8c:5f:93:1e,24757580,332,6976,24757248,24757580
6220,4,1,1,2412,-89,-87,-2,b4:b5:2f:17:0c:b9,24764400,1376,5444,24763024,24764400
6221,6,6,1,2412,-77,-87,10,e2:db:d1:d1:b0:4a,24765660,444,816,24765216,24765660
6222,6,6,1,2412,-77,-87,10,e2:db:d1:d1:b0:4b,24766136,408,68,24765728,24766136
6223,6,6,1,2412,-77,-87,10,e2:db:d1:d1:b0:4d,24766596,408,52,24766188,24766596
6224,6,6,1,2412,-77,-87,10,e2:db:d1:d1:b0:4f,24767054,408,50,24766646,24767054
6225,4,1,1,2412,-84,-87,3,,24767641,304,283,24767337,24767641
6226,4,1,1,2412,-79,-87,8,3c:bd:c5:ee:96:6d,24777412,2512,7259,24774900,24777412
6227,4,1,1,2412,-85,-87,2,,24782681,352,4917,24782329,24782681
6228,6,6,1,2412,-82,-87,5,52:86:8c:5f:93:1e,24783332,332,319,24783000,24783332
6229,4,1,1,2412,-87,-87,0,,24785008,352,1324,24784656,24785008
6230,4,11,1,2412,-79,-87,8,48:dd:0c:7d:86:27,24788779,362,3409,24788417,24788779
6231,4,11,1,2412,-80,-87,7,48:dd:0c:7d:86:23,24789153,323,51,24788830,24789153
6232,4,11,1,2412,-80,-87,7,48:dd:0c:7d:86:25,24789488,382,-47,24789106,24789488
6233,4,1,1,2412,-88,-87,-1,,24809307,304,19515,24809003,24809307
6234,4,1,1,2412,-78,-87,9,,24809622,304,11,24809318,24809622
6235,4,1,1,2412,-79,-87,8,,24809937,304,11,24809633,24809937
6236,4,1,1,2412,-80,-87,7,,24810251,304,10,24809947,24810251
6237,4,1,1,2412,-87,-87,0,,24810917,304,362,24810613,24810917
6238,4,1,1,2412,-81,-87,6,,24811232,304,11,24810928,24811232
6239,4,1,1,2412,-81,-87,6,,24811546,304,10,24811242,24811546
6240,4,1,1,2412,-81,-87,6,,24811861,304,11,24811557,24811861
6241,4,1,1,2412,-81,-87,6,,24812176,304,11,24811872,24812176
6242,4,1,1,2412,-77,-87,10,,24812500,304,20,24812196,24812500
6243,4,1,1,2412,-90,-87,-3,,24828742,384,15858,24828358,24828742
6244,4,1,1,2412,-87,-87,0,,24829140,448,-50,24828692,24829140
6245,4,1,1,2412,-78,-87,9,b0:e4:d5:32:ec:8a,24848591,1960,17491,24846631,24848591
6246,4,11,1,2412,-84,-87,3,,24852666,107,3968,24852559,24852666
6247,4,1,1,2412,-84,-87,3,,24855555,304,2585,24855251,24855555
6248,4,1,1,2412,-84,-87,3,1c:f2:9a:10:7c:14,24856932,1064,313,24855868,24856932
6249,4,1,1,2412,-85,-87,2,b4:b5:2f:17:0c:b9,24866802,1376,8494,24865426,24866802
6250,4,1,1,2412,-86,-87,1,ac:67:84:84:8a:07,24872896,416,5678,24872480,24872896
6251,4,1,1,2412,-84,-87,3,,24876299,304,3099,24875995,24876299
6252,4,1,1,2412,-79,-87,8,3c:bd:c5:ee:96:6d,24878675,2512,-136,24876163,24878675
6253,6,24,1,2412,-83,-87,4,,24887298,28,8595,24887270,24887298
6254,4,11,1,2412,-80,-87,7,48:dd:0c:7d:86:27,24891178,362,3518,24890816,24891178
6255,4,11,1,2412,-79,-87,8,48:dd:0c:7d:86:25,24891888,382,328,24891506,24891888
6256,6,24,1,2412,-83,-87,4,,24893989,28,2073,24893961,24893989
6257,4,1,1,2412,-87,-87,0,,24894590,448,153,24894142,24894590
6258,4,1,1,2412,-87,-87,0,,24895476,448,438,24895028,24895476
6259,6,24,1,2412,-82,-87,5,,24905345,28,9841,24905317,24905345
6260,4,1,1,2412,-85,-87,2,78:67:0e:38:6c:d3,24918071,2736,9990,24915335,24918071
6261,4,11,1,2412,-86,-87,1,4c:01:43:ec:a0:69,24921802,361,3370,24921441,24921802
6262,4,11,1,2412,-82,-87,5,48:dd:0c:90:e3:85,24927787,382,5603,24927405,24927787
6263,6,24,1,2412,-83,-87,4,,24936395,32,8576,24936363,24936395
6264,4,1,1,2412,-85,-87,2,68:54:fd:aa:49:4f,24939569,2128,1046,24937441,24939569
6265,4,1,1,2412,-76,-87,11,b0:e4:d5:32:ec:8a,24950991,1960,9462,24949031,24950991
6266,6,6,1,2412,-76,-87,11,f8:4f:ad:f9:af:82,24964917,576,13350,24964341,24964917
6267,4,1,1,2412,-84,-87,3,,24966337,304,1116,24966033,24966337
6268,6,6,1,2412,-76,-87,11,f8:4f:ad:f9:af:82,24966779,548,-106,24966231,24966779
6269,6,6,1,2412,-77,-87,10,e2:db:d1:d1:b0:4b,24970752,408,3565,24970344,24970752
6270,6,6,1,2412,-77,-87,10,e2:db:d1:d1:b0:4d,24972017,408,857,24971609,24972017
6271,6,6,1,2412,-76,-87,11,e2:db:d1:d1:b0:4f,24972449,408,24,24972041,24972449
6272,4,1,1,2412,-90,-87,-3,ce:f4:11:65:3f:f8,24972960,2072,-1561,24970888,24972960
6273,4,11,1,2412,-79,-87,8,48:dd:0c:7d:86:27,24993578,362,20256,24993216,24993578
6274,4,11,1,2412,-80,-87,7,48:dd:0c:7d:86:23,24993953,323,52,24993630,24993953
6275,4,11,1,2412,-77,-87,10,48:dd:0c:7d:86:25,24994288,382,-47,24993906,24994288
6276,4,1,1,2412,-89,-87,-2,1a:0c:6b:2e:43:07,24997220,3552,-620,24993668,24997220
6277,4,1,1,2412,-82,-87,5,68:54:fd:df:ca:29,25014713,2144,15349,25012569,25014713
6278,6,24,1,2412,-82,-87,5,,25017566,32,2821,25017534,25017566
6279,6,6,1,2412,-80,-87,7,b4:e6:2d:b4:ff:71,25017984,64,354,25017920,25017984
6280,6,6,1,2412,-80,-87,7,,25018064,44,36,25018020,25018064
6281,4,11,1,2412,-86,-87,1,,25018927,203,660,25018724,25018927
6282,6,6,1,2412,-84,-87,3,,25019149,44,178,25019105,25019149
6283,4,1,1,2412,-86,-87,1,78:67:0e:38:6c:d3,25020471,2736,-1414,25017735,25020471
6284,4,1,1,2412,-87,-87,0,78:67:0e:38:6c:d3,25023246,848,1927,25022398,25023246
6285,4,11,1,2412,-86,-87,1,4c:01:43:ec:a0:69,25024116,361,509,25023755,25024116
6286,4,11,1,2412,-82,-87,5,48:dd:0c:90:e3:85,25030187,382,5689,25029805,25030187
6287,4,1,1,2412,-79,-87,8,b0:e4:d5:32:ec:8a,25053390,1960,21243,25051430,25053390
6288,4,1,1,2412,-84,-87,3,,25067431,304,13737,25067127,25067431
6289,6,6,1,2412,-77,-87,10,e2:db:d1:d1:b0:4f,25074250,408,6411,25073842,25074250
6290,6,24,1,2412,-82,-87,5,,25077922,28,3644,25077894,25077922
6291,4,1,1,2412,-80,-87,7,3c:bd:c5:ee:96:6d,25083372,2512,2938,25080860,25083372
6292,4,1,1,2412,-86,-87,1,bc:98:df:ff:0f:8b,25086975,2568,1035,25084407,25086975
6293,4,11,1,2412,-84,-87,3,,25089647,107,2565,25089540,25089647
6294,4,11,1,2412,-85,-87,2,,25090303,107,549,25090196,25090303
6295,4,11,1,2412,-82,-87,5,48:dd:0c:7d:86:27,25095978,362,5313,25095616,25095978
6296,4,11,1,2412,-79,-87,8,48:dd:0c:7d:86:23,25096353,323,52,25096030,25096353
6297,4,1,1,2412,-86,-87,1,,25101250,352,4545,25100898,25101250
6298,4,1,1,2412,-81,-87,6,,25102318,352,716,25101966,25102318
6299,4,11,1,2412,-85,-87,2,,25104279,107,1854,25104172,25104279
6300,4,1,1,2412,-85,-87,2,,25104835,352,204,25104483,25104835
6301,4,1,1,2412,-87,-87,0,,25113113,448,7830,25112665,25113113
6302,4,1,1,2412,-87,-87,0,78:67:0e:38:6c:d3,25122871,2736,7022,25120135,25122871
6303,4,11,1,2412,-77,-87,10,48:dd:0c:90:e3:83,25132252,323,9058,25131929,25132252
6304,4,11,1,2412,-83,-87,4,48:dd:0c:90:e3:85,25132587,382,-47,25132205,25132587
6305,4,1,1,2412,-86,-87,1,78:67:0e:c4:a8:42,25134179,2736,-1144,25131443,25134179
6306,6,6,1,2412,-85,-87,2,,25146674,44,12451,25146630,25146674
6307,6,24,1,2412,-82,-87,5,,25151150,28,4448,25151122,25151150
6308,4,1,1,2412,-78,-87,9,b0:e4:d5:32:ec:8a,25155789,1960,2679,25153829,25155789
6309,6,24,1,2412,-83,-87,4,,25159244,28,3427,25159216,25159244
6310,6,6,1,2412,-77,-87,10,e2:db:d1:d1:b0:4a,25175081,444,15393,25174637,25175081
6311,6,6,1,2412,-76,-87,11,e2:db:d1:d1:b0:4b,25175567,408,78,25175159,25175567
6312,6,6,1,2412,-76,-87,11,e2:db:d1:d1:b0:4d,25176026,408,51,25175618,25176026
6313,6,6,1,2412,-76,-87,11,e2:db:d1:d1:b0:4f,25176476,408,42,25176068,25176476
6314,4,11,1,2412,-86,-87,1,,25178501,107,1918,25178394,25178501
6315,4,1,1,2412,-84,-87,3,,25179149,352,296,25178797,25179149
6316,4,11,1,2412,-82,-87,5,,25180925,107,1669,25180818,25180925
6317,4,1,1,2412,-84,-87,3,,25181498,352,221,25181146,25181498
6318,4,1,1,2412,-87,-87,0,bc:98:df:ff:0f:8b,25189371,2568,5305,25186803,25189371
6319,4,11,1,2412,-81,-87,6,48:dd:0c:7d:86:27,25198378,362,8645,25198016,25198378
6320,4,11,1,2412,-80,-87,7,48:dd:0c:7d:86:23,25198752,323,51,25198429,25198752
6321,4,11,1,2412,-81,-87,6,48:dd:0c:7d:86:25,25199088,382,-46,25198706,25199088
6322,4,1,1,2412,-87,-87,0,,25203017,448,3481,25202569,25203017
6323,4,1,1,2412,-87,-87,0,,25203894,448,429,25203446,25203894
6324,6,6,1,2412,-76,-87,11,f8:4f:ad:f9:af:82,25214207,656,9657,25213551,25214207
6325,6,6,1,2412,-77,-87,10,f8:4f:ad:f9:af:82,25214896,576,113,25214320,25214896
6326,6,6,1,2412,-76,-87,11,f8:4f:ad:f9:af:82,25216500,632,972,25215868,25216500
6327,6,6,1,2412,-76,-87,11,f8:4f:ad:f9:af:82,25217412,548,364,25216864,25217412
6328,4,1,1,2412,-87,-87,0,78:67:0e:38:6c:d3,25225271,2736,5123,25222535,25225271
6329,6,6,1,2412,-84,-87,3,,25228401,44,3086,25228357,25228401
6330,6,24,1,2412,-82,-87,5,,25230278,28,1849,25230250,25230278
6331,4,11,1,2412,-76,-87,11,48:dd:0c:90:e3:87,25234277,362,3637,25233915,25234277
6332,4,11,1,2412,-78,-87,9,48:dd:0c:90:e3:83,25234651,323,51,25234328,25234651
6333,4,11,1,2412,-82,-87,5,48:dd:0c:90:e3:85,25234987,382,-46,25234605,25234987
6334,4,1,1,2412,-78,-87,9,b0:e4:d5:32:ec:8a,25258189,1960,21242,25256229,25258189
6335,4,1,1,2412,-86,-87,1,b4:b5:2f:17:0c:b9,25276409,1376,16844,25275033,25276409
6336,6,6,1,2412,-77,-87,10,e2:db:d1:d1:b0:4a,25277651,444,798,25277207,25277651
6337,6,6,1,2412,-76,-87,11,e2:db:d1:d1:b0:4b,25278127,408,68,25277719,25278127
6338,6,6,1,2412,-76,-87,11,e2:db:d1:d1:b0:4d,25278577,408,42,25278169,25278577
6339,6,6,1,2412,-77,-87,10,e2:db:d1:d1:b0:4f,25279027,408,42,25278619,25279027
6340,4,1,1,2412,-79,-87,8,3c:bd:c5:ee:96:6d,25288178,2512,6639,25285666,25288178
6341,4,1,1,2412,-87,-87,0,0e:b9:49:67:a0:d6,25291210,416,2616,25290794,25291210
6342,4,11,1,2412,-80,-87,7,48:dd:0c:7d:86:27,25300778,362,9206,25300416,25300778
6343,4,11,1,2412,-79,-87,8,48:dd:0c:7d:86:23,25301152,323,51,25300829,25301152
6344,4,11,1,2412,-80,-87,7,48:dd:0c:7d:86:25,25301487,382,-47,25301105,25301487
6345,4,1,1,2412,-87,-87,0,,25306224,384,4353,25305840,25306224
6346,4,1,1,2412,-87,-87,0,,25306622,448,-50,25306174,25306622
6347,4,1,1,2412,-87,-87,0,0e:b9:49:67:a0:d6,25308887,416,1849,25308471,25308887
6348,4,11,1,2412,-83,-87,4,10:86:8c:5f:93:26,25309346,347,112,25308999,25309346
6349,4,11,1,2412,-89,-87,-2,4c:01:43:d7:f3:23,25313278,322,3610,25312956,25313278
6350,4,1,1,2412,-84,-87,3,,25316128,304,2546,25315824,25316128
6351,4,11,1,2412,-80,-87,7,48:dd:0c:7d:86:23,25319789,254,3407,25319535,25319789
6352,4,1,1,2412,-88,-87,-1,78:67:0e:38:6c:d3,25327672,2736,5147,25324936,25327672
6353,4,11,1,2412,-76,-87,11,48:dd:0c:90:e3:83,25337051,323,9056,25336728,25337051
6354,4,11,1,2412,-85,-87,2,48:dd:0c:90:e3:85,25337386,382,-47,25337004,25337386
6355,4,1,1,2412,-84,-87,3,78:67:0e:c4:a8:42,25338979,2736,-1143,25336243,25338979
6356,4,1,1,2412,-83,-87,4,,25360134,304,20851,25359830,25360134
6357,4,1,1,2412,-79,-87,8,b0:e4:d5:32:ec:8a,25360760,1960,-1334,25358800,25360760
6358,6,24,1,2412,-83,-87,4,,25373987,28,13199,25373959,25373987
6359,4,1,1,2412,-87,-87,0,,25377550,304,3259,25377246,25377550
6360,4,1,1,2412,-86,-87,1,ac:67:84:84:8a:07,25378023,416,57,25377607,25378023
6361,6,6,1,2412,-76,-87,11,e2:db:d1:d1:b0:4b,25380520,408,2089,25380112,25380520
6362,4,1,1,2412,-79,-87,8,3c:bd:c5:ee:96:6d,25390685,2512,7653,25388173,25390685
6363,6,6,1,2412,-80,-87,7,b4:e6:2d:b4:ff:71,25393058,64,2309,25392994,25393058
6364,4,1,1,2412,-76,-87,11,88:71:b1:b4:0e:c7,25393250,3320,-3128,25389930,25393250
6365,4,1,1,2412,-79,-87,8,3c:bd:c5:ee:96:6a,25396623,1056,2317,25395567,25396623
6366,6,24,1,2412,-83,-87,4,,25398992,28,2341,25398964,25398992
6367,4,11,1,2412,-80,-87,7,48:dd:0c:7d:86:27,25403177,362,3823,25402815,25403177
6368,4,11,1,2412,-80,-87,7,48:dd:0c:7d:86:23,25403552,323,52,25403229,25403552
6369,4,11,1,2412,-81,-87,6,48:dd:0c:7d:86:25,25403887,382,-47,25403505,25403887
6370,4,1,1,2412,-81,-87,6,,25420953,304,16762,25420649,25420953
6371,4,1,1,2412,-86,-87,1,,25423963,304,2706,25423659,25423963
6372,4,1,1,2412,-87,-87,0,,25425899,304,1632,25425595,25425899
6373,6,6,1,2412,-76,-87,11,f8:4f:ad:f9:af:82,25427064,248,917,25426816,25427064
6374,6,6,1,2412,-77,-87,10,f8:4f:ad:f9:af:82,25428573,224,1285,25428349,25428573
6375,6,6,1,2412,-80,-87,7,b4:e6:2d:b4:ff:71,25429726,64,1089,25429662,25429726
6376,6,6,1,2412,-80,-87,7,b4:e6:2d:b4:ff:71,25432715,64,2925,25432651,25432715
6377,6,6,1,2412,-81,-87,6,,25432795,44,36,25432751,25432795
6378,4,11,1,2412,-83,-87,4,48:dd:0c:90:e3:85,25439786,382,6609,25439404,25439786
6379,4,1,1,2412,-85,-87,2,78:67:0e:c4:a8:42,25441379,2736,-1143,25438643,25441379
6380,6,24,1,2412,-81,-87,6,,25457132,28,15725,25457104,25457132
6381,4,1,1,2412,-85,-87,2,,25458881,304,1445,25458577,25458881
6382,4,1,1,2412,-77,-87,10,b0:e4:d5:32:ec:8a,25463030,1960,2189,25461070,25463030
6383,6,24,1,2412,-83,-87,4,,25466497,28,3439,25466469,25466497
6384,4,1,1,2412,-83,-87,4,b4:b5:2f:17:0c:b9,25482081,1376,14208,25480705,25482081
6385,6,6,1,2412,-76,-87,11,e2:db:d1:d1:b0:4a,25483322,444,797,25482878,25483322
6386,6,6,1,2412,-76,-87,11,e2:db:d1:d1:b0:4b,25483799,408,69,25483391,25483799
6387,4,1,1,2412,-78,-87,9,3c:bd:c5:ee:96:6d,25492992,2512,6681,25490480,25492992
6388,4,1,1,2412,-86,-87,1,bc:98:df:ff:0f:8b,25496573,2568,1013,25494005,25496573
6389,4,1,1,2412,-84,-87,3,,25503727,304,6850,25503423,25503727
6390,4,1,1,2412,-86,-87,1,,25505291,304,1260,25504987,25505291
6391,4,11,1,2412,-80,-87,7,48:dd:0c:7d:86:27,25505577,362,-76,25505215,25505577
6392,4,11,1,2412,-80,-87,7,48:dd:0c:7d:86:23,25505952,323,52,25505629,25505952
6393,4,11,1,2412,-80,-87,7,48:dd:0c:7d:86:25,25506287,382,-47,25505905,25506287
6394,4,1,1,2412,-85,-87,2,,25525666,304,19075,25525362,25525666
6395,4,1,1,2412,-83,-87,4,,25526721,304,751,25526417,25526721
6396,6,6,1,2412,-77,-87,10,f8:4f:ad:f9:af:82,25530294,1332,2241,25528962,25530294
6397,4,11,1,2412,-77,-87,10,48:dd:0c:90:e3:83,25541851,323,11234,25541528,25541851
6398,4,11,1,2412,-82,-87,5,48:dd:0c:90:e3:85,25542186,382,-47,25541804,25542186
6399,4,1,1,2412,-85,-87,2,78:67:0e:c4:a8:42,25543778,2736,-1144,25541042,25543778
6400,6,24,1,2412,-83,-87,4,,25546414,28,2608,25546386,25546414
6401,6,24,1,2412,-82,-87,5,,25550783,28,4341,25550755,25550783
6402,4,1,1,2412,-78,-87,9,b0:e4:d5:32:ec:8a,25565387,1960,12644,25563427,25565387
6403,4,1,1,2412,-85,-87,2,,25569662,304,3971,25569358,25569662
6404,4,1,1,2412,-82,-87,5,,25570717,304,751,25570413,25570717
6405,6,6,1,2412,-79,-87,8,e2:db:d1:d1:b0:4b,25585168,408,14043,25584760,25585168
6406,6,6,1,2412,-76,-87,11,e2:db:d1:d1:b0:4d,25585610,408,34,25585202,25585610
6407,4,1,1,2412,-84,-87,3,,25591567,304,5653,25591263,25591567
6408,4,1,1,2412,-85,-87,2,,25594497,352,2578,25594145,25594497
6409,4,1,1,2412,-88,-87,-1,ac:67:84:84:8a:07,25594912,416,-1,25594496,25594912
6410,4,1,1,2412,-79,-87,8,3c:bd:c5:ee:96:6d,25595665,2512,-1759,25593153,25595665
6411,4,11,1,2412,-85,-87,2,,25598457,107,2685,25598350,25598457
6412,4,1,1,2412,-88,-87,-1,bc:98:df:ff:0f:8b,25598998,2568,-2027,25596430,25598998
6413,4,11,1,2412,-84,-87,3,,25601939,107,2834,25601832,25601939
6414,4,11,1,2412,-83,-87,4,,25602707,107,661,25602600,25602707
6415,4,1,1,2412,-85,-87,2,,25603996,448,841,25603548,25603996
6416,4,11,1,2412,-79,-87,8,48:dd:0c:7d:86:27,25607982,362,3624,25607620,25607982
6417,4,11,1,2412,-79,-87,8,48:dd:0c:7d:86:23,25608356,323,51,25608033,25608356
6418,4,11,1,2412,-80,-87,7,48:dd:0c:7d:86:25,25608692,382,-46,25608310,25608692
6419,6,24,1,2412,-82,-87,5,,25614256,28,5536,25614228,25614256
6420,4,11,1,2412,-83,-87,4,,25614460,107,97,25614353,25614460
6421,4,1,1,2412,-80,-87,7,,25625175,304,10411,25624871,25625175
6422,4,1,1,2412,-84,-87,3,,25628711,352,3184,25628359,25628711
6423,4,1,1,2412,-85,-87,2,,25629590,352,527,25629238,25629590
6424,6,24,1,2412,-83,-87,4,,25630284,28,666,25630256,25630284
6425,4,1,1,2412,-86,-87,1,78:67:0e:38:6c:d3,25634872,2736,1852,25632136,25634872
6426,4,1,1,2412,-87,-87,0,7c:f6:66:c4:c4:3a,25637664,2208,584,25635456,25637664
6427,4,11,1,2412,-84,-87,3,48:dd:0c:90:e3:85,25644586,382,6540,25644204,25644586
6428,4,1,1,2412,-84,-87,3,78:67:0e:c4:a8:42,25646178,2736,-1144,25643442,25646178
6429,4,1,1,2412,-79,-87,8,b0:e4:d5:32:ec:8a,25667786,1960,19648,25665826,25667786
6430,4,1,1,2412,-85,-87,2,,25671022,304,2932,25670718,25671022
6431,4,11,1,2412,-85,-87,2,,25685654,107,14525,25685547,25685654
6432,4,1,1,2412,-86,-87,1,b4:b5:2f:17:0c:b9,25686017,1376,-1013,25684641,25686017
6433,6,6,1,2412,-76,-87,11,e2:db:d1:d1:b0:4a,25687258,444,797,25686814,25687258
6434,6,6,1,2412,-77,-87,10,e2:db:d1:d1:b0:4b,25687753,408,87,25687345,25687753
6435,6,6,1,2412,-77,-87,10,e2:db:d1:d1:b0:4d,25688194,408,33,25687786,25688194
6436,6,6,1,2412,-77,-87,10,e2:db:d1:d1:b0:4f,25688635,408,33,25688227,25688635
6437,4,1,1,2412,-79,-87,8,3c:bd:c5:ee:96:6d,25698695,2512,7548,25696183,25698695
6438,6,24,1,2412,-83,-87,4,,25705856,28,7133,25705828,25705856
6439,4,11,1,2412,-87,-87,0,48:dd:0c:7d:86:23,25710825,323,4646,25710502,25710825
6440,4,11,1,2412,-81,-87,6,48:dd:0c:7d:86:25,25711160,382,-47,25710778,25711160
6441,4,1,1,2412,-88,-87,-1,,25717828,448,6220,25717380,25717828
6442,6,24,1,2412,-83,-87,4,,25718910,28,1054,25718882,25718910
6443,4,11,1,2412,-80,-87,7,48:dd:0c:7d:86:23,25721770,254,2606,25721516,25721770
6444,4,11,1,2412,-84,-87,3,48:dd:0c:90:e3:83,25722072,254,48,25721818,25722072
6445,4,1,1,2412,-86,-87,1,,25725774,304,3398,25725470,25725774
6446,4,1,1,2412,-85,-87,2,,25727022,304,944,25726718,25727022
6447,4,1,1,2412,-86,-87,1,ac:67:84:84:8a:07,25742741,416,15303,25742325,25742741
6448,4,1,1,2412,-85,-87,2,78:67:0e:c4:a8:42,25748578,2736,3101,25745842,25748578
6449,4,1,1,2412,-86,-87,1,78:67:0e:c4:a8:41,25751361,1184,1599,25750177,25751361
6450,4,1,1,2412,-89,-87,-2,ac:67:84:84:8a:07,25769525,416,17748,25769109,25769525
6451,4,1,1,2412,-78,-87,9,b0:e4:d5:32:ec:8a,25770185,1960,-1300,25768225,25770185
6452,4,1,1,2412,-84,-87,3,,25772192,304,1703,25771888,25772192
6453,6,24,1,2412,-82,-87,5,,25776049,28,3829,25776021,25776049
6454,4,1,1,2412,-86,-87,1,78:67:0e:38:6c:d3,25779242,3472,-279,25775770,25779242
6455,4,1,1,2412,-85,-87,2,b4:b5:2f:17:0c:b9,25789141,1376,8523,25787765,25789141
6456,6,6,1,2412,-76,-87,11,e2:db:d1:d1:b0:4a,25790382,444,797,25789938,25790382
6457,6,6,1,2412,-77,-87,10,e2:db:d1:d1:b0:4b,25790850,408,60,25790442,25790850
6458,6,6,1,2412,-77,-87,10,e2:db:d1:d1:b0:4d,25791282,408,24,25790874,25791282
6459,6,6,1,2412,-76,-87,11,e2:db:d1:d1:b0:4f,25791723,408,33,25791315,25791723
6460,4,11,1,2412,-80,-87,7,48:dd:0c:7d:86:27,25812776,362,20691,25812414,25812776
6461,4,11,1,2412,-78,-87,9,48:dd:0c:7d:86:23,25813151,323,52,25812828,25813151
6462,4,11,1,2412,-80,-87,7,48:dd:0c:7d:86:25,25813486,382,-47,25813104,25813486
6463,4,1,1,2412,-85,-87,2,,25815278,304,1488,25814974,25815278
6464,4,1,1,2412,-88,-87,-1,,25819661,448,3935,25819213,25819661
6465,4,1,1,2412,-88,-87,-1,,25820547,448,438,25820099,25820547
6466,4,1,1,2412,-89,-87,-2,ac:67:84:84:8a:07,25824401,416,3438,25823985,25824401
6467,4,11,1,2412,-89,-87,-2,4c:01:43:d7:f3:26,25825610,387,822,25825223,25825610
6468,4,1,1,2412,-87,-87,0,ac:67:84:84:8a:07,25832341,416,6315,25831925,25832341
6469,6,6,1,2412,-79,-87,8,10:86:8c:5f:93:1e,25837420,336,4743,25837084,25837420
6470,4,1,1,2412,-85,-87,2,78:67:0e:38:6c:d3,25839672,2736,-484,25836936,25839672
6471,4,11,1,2412,-76,-87,11,48:dd:0c:90:e3:83,25849050,323,9055,25848727,25849050
6472,4,11,1,2412,-83,-87,4,48:dd:0c:90:e3:85,25849385,382,-47,25849003,25849385
6473,4,1,1,2412,-85,-87,2,78:67:0e:c4:a8:42,25850978,2736,-1143,25848242,25850978
6474,6,6,1,2412,-80,-87,7,12:86:8c:5f:93:1e,25858388,332,7078,25858056,25858388
6475,4,1,1,2412,-84,-87,3,,25861580,304,2888,25861276,25861580
6476,6,24,1,2412,-82,-87,5,,25865366,28,3758,25865338,25865366
6477,4,1,1,2412,-85,-87,2,,25869334,304,3664,25869030,25869334
6478,6,24,1,2412,-83,-87,4,,25870633,28,1271,25870605,25870633
6479,4,1,1,2412,-77,-87,10,b0:e4:d5:32:ec:8a,25872585,1960,-8,25870625,25872585
6480,6,6,1,2412,-80,-87,7,32:86:8c:5f:93:1e,25883988,332,11071,25883656,25883988
6481,4,1,1,2412,-84,-87,3,,25889414,304,5122,25889110,25889414
6482,4,1,1,2412,-87,-87,0,b4:b5:2f:17:0c:b9,25890820,1376,30,25889444,25890820
6483,6,6,1,2412,-76,-87,11,e2:db:d1:d1:b0:4a,25892052,444,788,25891608,25892052
6484,6,6,1,2412,-76,-87,11,e2:db:d1:d1:b0:4b,25892547,408,87,25892139,25892547
6485,6,6,1,2412,-76,-87,11,e2:db:d1:d1:b0:4d,25893006,408,51,25892598,25893006
6486,6,6,1,2412,-77,-87,10,e2:db:d1:d1:b0:4f,25893447,408,33,25893039,25893447
6487,4,1,1,2412,-79,-87,8,3c:bd:c5:ee:96:6d,25902573,2512,6614,25900061,25902573
6488,4,11,1,2412,-84,-87,3,48:dd:0c:90:e3:83,25905601,254,2774,25905347,25905601
6489,4,1,1,2412,-88,-87,-1,bc:98:df:ff:0f:8b,25906175,2568,-1994,25903607,25906175
6490,6,6,1,2412,-80,-87,7,52:86:8c:5f:93:1e,25909589,332,3082,25909257,25909589
6491,4,1,1,2412,-84,-87,3,78:67:0e:c4:a8:41,25915140,1184,4367,25913956,25915140
6492,6,6,1,2412,-79,-87,8,10:86:8c:5f:93:1e,25938580,336,23104,25938244,25938580
6493,4,1,1,2412,-84,-87,3,78:67:0e:38:6c:d3,25942073,2736,757,25939337,25942073
6494,4,11,1,2412,-82,-87,5,48:dd:0c:90:e3:85,25951785,382,9330,25951403,25951785
6495,4,1,1,2412,-82,-87,5,78:67:0e:c4:a8:42,25953378,2736,-1143,25950642,25953378
6496,4,1,1,2412,-84,-87,3,,25956564,304,2882,25956260,25956564
6497,4,1,1,2412,-85,-87,2,,25957619,304,751,25957315,25957619
6498,6,6,1,2412,-80,-87,7,12:86:8c:5f:93:1e,25960947,332,2996,25960615,25960947
6499,4,1,1,2412,-78,-87,9,b0:e4:d5:32:ec:8a,25974984,1960,12077,25973024,25974984
6500,4,1,1,2412,-84,-87,3,,25978223,304,2935,25977919,25978223
6501,4,11,1,2412,-85,-87,2,,25978861,107,531,25978754,25978861
6502,4,11,1,2412,-84,-87,3,,25979508,107,540,25979401,25979508
6503,4,1,1,2412,-84,-87,3,,25980282,304,470,25979978,25980282
6504,4,1,1,2412,-86,-87,1,,25981730,352,1096,25981378,25981730
6505,4,1,1,2412,-79,-87,8,,25982592,352,510,25982240,25982592
6506,4,1,1,2412,-85,-87,2,,25983445,352,501,25983093,25983445
6507,4,1,1,2412,-84,-87,3,,25984298,352,501,25983946,25984298
6508,4,1,1,2412,-84,-87,3,,25985322,352,672,25984970,25985322
6509,6,6,1,2412,-80,-87,7,32:86:8c:5f:93:1e,25986389,332,735,25986057,25986389
6510,4,1,1,2412,-86,-87,1,b4:b5:2f:17:0c:b9,25993272,1376,5507,25991896,25993272
6511,6,6,1,2412,-76,-87,11,e2:db:d1:d1:b0:4a,25994513,444,797,25994069,25994513
6512,6,6,1,2412,-76,-87,11,e2:db:d1:d1:b0:4d,25995440,408,519,25995032,25995440
6513,6,6,1,2412,-77,-87,10,e2:db:d1:d1:b0:4f,25995872,408,24,25995464,25995872
6514,4,1,1,2412,-90,-87,-3,ce:f4:11:65:3f:f8,25996957,2072,-987,25994885,25996957
6515,4,1,1,2412,-80,-87,7,3c:bd:c5:ee:96:6d,26004989,2512,5520,26002477,26004989
6516,4,1,1,2412,-81,-87,6,b8:f8:53:cb:31:f1,26007554,976,1589,26006578,26007554
6517,4,1,1,2412,-88,-87,-1,bc:98:df:ff:0f:8b,26008591,2568,-1531,26006023,26008591
6518,6,6,1,2412,-80,-88,8,52:86:8c:5f:93:1e,26011989,332,3066,26011657,26011989
6519,6,24,1,2412,-83,-88,5,,26014002,28,1985,26013974,26014002
6520,4,11,1,2412,-78,-88,10,48:dd:0c:7d:86:27,26017576,362,3212,26017214,26017576
6521,4,11,1,2412,-81,-88,7,48:dd:0c:7d:86:23,26017950,323,51,26017627,26017950
6522,4,11,1,2412,-79,-88,9,48:dd:0c:7d:86:25,26018286,382,-46,26017904,26018286
6523,4,1,1,2412,-85,-88,3,,26029641,352,11003,26029289,26029641
6524,6,24,1,2412,-82,-88,6,,26030935,28,1266,26030907,26030935
6525,4,1,1,2412,-87,-88,1,,26043002,448,11619,26042554,26043002
6526,4,1,1,2412,-90,-88,-2,,26043508,384,122,26043124,26043508
6527,4,1,1,2412,-87,-88,1,,26043906,448,-50,26043458,26043906
6528,4,1,1,2412,-88,-88,0,78:67:0e:38:6c:d3,26044473,2736,-2169,26041737,26044473
6529,6,6,1,2412,-80,-88,8,10:86:8c:5f:93:1e,26048233,336,3424,26047897,26048233
6530,4,1,1,2412,-85,-88,3,78:67:0e:c4:a8:42,26055778,2736,4809,26053042,26055778
6531,6,6,1,2412,-82,-88,6,12:86:8c:5f:93:1e,26063305,332,7195,26062973,26063305
6532,6,6,1,2412,-82,-88,6,32:86:8c:5f:93:1e,26088790,332,25153,26088458,26088790
6533,4,11,1,2412,-83,-88,5,,26091567,107,2670,26091460,26091567
6534,4,1,1,2412,-85,-88,3,b4:b5:2f:17:0c:b9,26095624,1376,2681,26094248,26095624
6535,6,6,1,2412,-76,-88,12,e2:db:d1:d1:b0:4d,26097792,408,1760,26097384,26097792
6536,6,6,1,2412,-77,-88,11,e2:db:d1:d1:b0:4f,26098224,408,24,26097816,26098224
6537,4,1,1,2412,-78,-88,10,3c:bd:c5:ee:96:6d,26107390,2512,6654,26104878,26107390
6538,4,1,1,2412,-85,-88,3,,26110003,352,2261,26109651,26110003
6539,4,1,1,2412,-84,-88,4,,26110456,352,101,26110104,26110456
6540,4,1,1,2412,-83,-88,5,,26111387,352,579,26111035,26111387
6541,4,1,1,2412,-82,-88,6,,26111839,352,100,26111487,26111839
6542,4,1,1,2412,-83,-88,5,,26112743,352,552,26112391,26112743
6543,4,1,1,2412,-80,-88,8,,26113195,352,100,26112843,26113195
6544,4,1,1,2412,-83,-88,5,,26113667,352,120,26113315,26113667
6545,4,1,1,2412,-85,-88,3,,26114119,352,100,26113767,26114119
6546,6,6,1,2412,-81,-88,7,52:86:8c:5f:93:1e,26114913,332,462,26114581,26114913
6547,4,1,1,2412,-84,-88,4,,26115578,352,313,26115226,26115578
6548,4,1,1,2412,-85,-88,3,,26116039,352,109,26115687,26116039
6549,4,1,1,2412,-85,-88,3,,26116793,352,402,26116441,26116793
6550,4,1,1,2412,-85,-88,3,,26117245,352,100,26116893,26117245
6551,4,1,1,2412,-84,-88,4,,26117715,352,118,26117363,26117715
6552,4,1,1,2412,-84,-88,4,,26118168,352,101,26117816,26118168
6553,4,1,1,2412,-83,-88,5,,26118620,352,100,26118268,26118620
6554,4,1,1,2412,-85,-88,3,,26119072,352,100,26118720,26119072
6555,4,1,1,2412,-84,-88,4,,26119520,352,96,26119168,26119520
6556,4,11,1,2412,-80,-88,8,48:dd:0c:7d:86:23,26120350,323,507,26120027,26120350
6557,4,11,1,2412,-80,-88,8,48:dd:0c:7d:86:25,26120686,382,-46,26120304,26120686
6558,4,1,1,2412,-85,-88,3,,26121087,352,49,26120735,26121087
6559,4,1,1,2412,-83,-88,5,,26122000,352,561,26121648,26122000
6560,4,1,1,2412,-85,-88,3,,26122470,352,118,26122118,26122470
6561,4,1,1,2412,-85,-88,3,,26122922,352,100,26122570,26122922
6562,4,1,1,2412,-85,-88,3,,26123374,352,100,26123022,26123374
6563,4,1,1,2412,-84,-88,4,,26124278,352,552,26123926,26124278
6564,4,1,1,2412,-84,-88,4,,26125147,352,517,26124795,26125147
6565,4,1,1,2412,-84,-88,4,,26127023,304,1572,26126719,26127023
6566,4,1,1,2412,-85,-88,3,,26128075,304,748,26127771,26128075
6567,4,1,1,2412,-85,-88,3,,26129515,352,1088,26129163,26129515
6568,4,5.5,1,2412,-85,-88,3,,26146961,213,17233,26146748,26146961
6569,4,1,1,2412,-87,-88,1,78:67:0e:38:6c:d3,26147257,2736,-2440,26144521,26147257
6570,4,11,1,2412,-78,-88,10,48:dd:0c:90:e3:83,26156249,323,8669,26155926,26156249
6571,4,11,1,2412,-83,-88,5,48:dd:0c:90:e3:85,26156584,382,-47,26156202,26156584
6572,4,1,1,2412,-84,-88,4,78:67:0e:c4:a8:42,26158177,2736,-1143,26155441,26158177
6573,6,24,1,2412,-82,-88,6,,26168214,28,10009,26168186,26168214
6574,4,11,1,2412,-80,-88,8,ba:1f:47:ca:32:d7,26169702,339,1149,26169363,26169702
6575,4,11,1,2412,-80,-88,8,ba:1f:47:ca:32:d7,26170153,342,109,26169811,26170153
6576,6,24,1,2412,-83,-88,5,,26173998,28,3817,26173970,26173998
6577,4,11,1,2412,-84,-88,4,48:dd:0c:7d:86:2e,26178484,352,4134,26178132,26178484
6578,4,1,1,2412,-79,-88,9,b0:e4:d5:32:ec:8a,26179783,1960,-661,26177823,26179783
6579,6,24,1,2412,-82,-88,6,,26185368,28,5557,26185340,26185368
6580,6,6,1,2412,-78,-88,10,32:86:8c:5f:93:1e,26191369,332,5669,26191037,26191369
6581,6,6,1,2412,-76,-88,12,e2:db:d1:d1:b0:4a,26199276,444,7463,26198832,26199276
6582,6,6,1,2412,-76,-88,12,e2:db:d1:d1:b0:4b,26199762,408,78,26199354,26199762
6583,6,6,1,2412,-76,-88,12,e2:db:d1:d1:b0:4d,26200193,408,23,26199785,26200193
6584,6,6,1,2412,-77,-88,11,e2:db:d1:d1:b0:4f,26200625,408,24,26200217,26200625
6585,6,24,1,2412,-82,-88,6,,26201402,28,749,26201374,26201402
6586,4,1,1,2412,-80,-88,8,3c:bd:c5:ee:96:6d,26209776,2512,5862,26207264,26209776
6587,4,1,1,2412,-90,-88,-2,bc:98:df:ff:0f:8b,26213399,2568,1055,26210831,26213399
6588,6,6,1,2412,-80,-88,8,52:86:8c:5f:93:1e,26216791,332,3060,26216459,26216791
6589,4,11,1,2412,-80,-88,8,48:dd:0c:7d:86:27,26222376,362,5223,26222014,26222376
6590,4,11,1,2412,-80,-88,8,48:dd:0c:7d:86:23,26222750,323,51,26222427,26222750
6591,4,11,1,2412,-80,-88,8,48:dd:0c:7d:86:25,26223085,382,-47,26222703,26223085
6592,6,6,1,2412,-86,-88,2,,26228389,44,5260,26228345,26228389
6593,4,1,1,2412,-87,-88,1,,26237986,448,9149,26237538,26237986
6594,4,1,1,2412,-81,-88,7,66:32:b1:64:4c:f2,26240955,2696,273,26238259,26240955
6595,6,6,1,2412,-80,-88,8,10:86:8c:5f:93:1e,26246065,336,4774,26245729,26246065
6596,4,1,1,2412,-85,-88,3,7c:f6:66:d3:26:e0,26252057,2208,3784,26249849,26252057
6597,4,11,1,2412,-77,-88,11,48:dd:0c:90:e3:87,26258274,362,5855,26257912,26258274
6598,4,11,1,2412,-83,-88,5,48:dd:0c:90:e3:85,26258984,382,328,26258602,26258984
6599,4,1,1,2412,-83,-88,5,78:67:0e:c4:a8:42,26260599,2736,-1121,26257863,26260599
6600,6,24,1,2412,-84,-88,4,,26265372,28,4745,26265344,26265372
6601,6,24,1,2412,-82,-88,6,,26271118,28,5718,26271090,26271118
6602,4,1,1,2412,-86,-88,2,ac:67:84:84:8a:07,26273896,416,2362,26273480,26273896
6603,6,24,1,2412,-83,-88,5,,26278643,28,4719,26278615,26278643
6604,4,1,1,2412,-78,-88,10,b0:e4:d5:32:ec:8a,26282182,1960,1579,26280222,26282182
6605,6,6,1,2412,-78,-88,10,32:86:8c:5f:93:1e,26293608,332,11094,26293276,26293608
6606,4,1,1,2412,-85,-88,3,b4:b5:2f:17:0c:b9,26300427,1376,5443,26299051,26300427
6607,6,6,1,2412,-76,-88,12,e2:db:d1:d1:b0:4a,26301678,444,807,26301234,26301678
6608,6,6,1,2412,-76,-88,12,e2:db:d1:d1:b0:4d,26302778,408,692,26302370,26302778
6609,6,6,1,2412,-76,-88,12,e2:db:d1:d1:b0:4f,26303236,408,50,26302828,26303236
6610,4,1,1,2412,-79,-88,9,3c:bd:c5:ee:96:6d,26312177,2512,6429,26309665,26312177
6611,4,1,1,2412,-79,-88,9,3c:bd:c5:ee:96:6d,26318955,3280,3498,26315675,26318955
6612,4,1,1,2412,-90,-88,-2,,26322247,304,2988,26321943,26322247
6613,4,11,1,2412,-80,-88,8,48:dd:0c:7d:86:27,26324775,362,2166,26324413,26324775
6614,4,11,1,2412,-80,-88,8,48:dd:0c:7d:86:23,26325150,323,52,26324827,26325150
6615,4,11,1,2412,-80,-88,8,48:dd:0c:7d:86:25,26325485,382,-47,26325103,26325485
6616,4,1,1,2412,-87,-88,1,90:0f:0c:d7:4d:0b,26327837,1152,1200,26326685,26327837
6617,4,1,1,2412,-81,-88,7,b4:b5:2f:17:0c:b9,26329016,1328,-149,26327688,26329016
6618,4,1,1,2412,-78,-88,10,3c:bd:c5:ee:96:6d,26330375,3280,-1921,26327095,26330375
6619,4,1,1,2412,-88,-88,0,,26333667,304,2988,26333363,26333667
6620,4,1,1,2412,-87,-88,1,,26334425,448,310,26333977,26334425
6621,6,24,1,2412,-82,-88,6,,26336070,28,1617,26336042,26336070
6622,4,1,1,2412,-80,-88,8,66:32:b1:64:4c:f2,26341364,2696,2598,26338668,26341364
6623,6,6,1,2412,-80,-88,8,10:86:8c:5f:93:1e,26348429,336,6729,26348093,26348429
6624,6,6,1,2412,-80,-88,8,12:86:8c:5f:93:1e,26375320,332,26559,26374988,26375320
6625,6,6,1,2412,-84,-88,4,,26383108,44,7744,26383064,26383108
6626,4,1,1,2412,-78,-88,10,b0:e4:d5:32:ec:8a,26384581,1960,-487,26382621,26384581
6627,4,1,1,2412,-86,-88,2,ac:67:84:84:8a:07,26387387,416,2390,26386971,26387387
6628,4,11,1,2412,-84,-88,4,,26389503,107,2009,26389396,26389503
6629,4,1,1,2412,-84,-88,4,,26390142,352,287,26389790,26390142
6630,4,1,1,2412,-82,-88,6,,26396926,352,6432,26396574,26396926
6631,4,1,1,2412,-82,-88,6,,26397772,352,494,26397420,26397772
6632,6,6,1,2412,-80,-88,8,32:86:8c:5f:93:1e,26398519,332,415,26398187,26398519
6633,4,1,1,2412,-85,-88,3,b4:b5:2f:17:0c:b9,26402925,1376,3030,26401549,26402925
6634,6,6,1,2412,-76,-88,12,e2:db:d1:d1:b0:4a,26404166,444,797,26403722,26404166
6635,6,6,1,2412,-76,-88,12,e2:db:d1:d1:b0:4b,26404643,408,69,26404235,26404643
6636,6,6,1,2412,-76,-88,12,e2:db:d1:d1:b0:4d,26405084,408,33,26404676,26405084
6637,6,24,1,2412,-83,-88,5,,26414005,28,8893,26413977,26414005
6638,4,1,1,2412,-80,-88,8,3c:bd:c5:ee:96:6d,26414585,2512,-1932,26412073,26414585
6639,4,1,1,2412,-87,-88,1,bc:98:df:ff:0f:8b,26418179,2568,1026,26415611,26418179
6640,4,1,1,2412,-82,-88,6,bc:98:df:ff:0f:8a,26424721,976,5566,26423745,26424721
6641,4,1,1,2412,-88,-88,0,bc:98:df:ff:0f:8a,26425708,976,11,26424732,26425708
6642,4,11,1,2412,-80,-88,8,48:dd:0c:7d:86:25,26427885,382,1795,26427503,26427885
6643,6,6,1,2412,-80,-88,8,52:86:8c:5f:93:1e,26428122,332,-95,26427790,26428122
6644,6,24,1,2412,-81,-88,7,,26431047,28,2897,26431019,26431047
6645,6,24,1,2412,-82,-88,6,,26438543,28,7468,26438515,26438543
6646,4,1,1,2412,-85,-88,3,,26446868,448,7877,26446420,26446868
6647,6,6,1,2412,-81,-88,7,10:86:8c:5f:93:1e,26449018,336,1814,26448682,26449018
6648,4,1,1,2412,-87,-88,1,78:67:0e:38:6c:d3,26454073,2736,2319,26451337,26454073
6649,4,11,1,2412,-77,-88,11,48:dd:0c:90:e3:87,26463074,362,8639,26462712,26463074
6650,4,11,1,2412,-78,-88,10,48:dd:0c:90:e3:83,26463448,323,51,26463125,26463448
6651,4,11,1,2412,-84,-88,4,48:dd:0c:90:e3:85,26463784,382,-46,26463402,26463784
6652,6,6,1,2412,-86,-88,2,,26479010,44,15182,26478966,26479010
6653,4,1,1,2412,-78,-88,10,b0:e4:d5:32:ec:8a,26486981,1960,6011,26485021,26486981
6654,6,6,1,2412,-79,-88,9,32:86:8c:5f:93:1e,26500730,332,13417,26500398,26500730
6655,4,1,1,2412,-84,-88,4,b4:b5:2f:17:0c:b9,26505231,1376,3125,26503855,26505231
6656,6,6,1,2412,-76,-88,12,e2:db:d1:d1:b0:4a,26506481,444,806,26506037,26506481
6657,6,6,1,2412,-76,-88,12,e2:db:d1:d1:b0:4b,26506949,408,60,26506541,26506949
6658,6,6,1,2412,-77,-88,11,e2:db:d1:d1:b0:4f,26507822,408,465,26507414,26507822
6659,6,24,1,2412,-82,-88,6,,26510771,28,2921,26510743,26510771
6660,4,1,1,2412,-79,-88,9,3c:bd:c5:ee:96:6d,26517910,2512,4627,26515398,26517910
6661,4,1,1,2412,-82,-88,6,bc:98:df:ff:0f:8b,26520590,2568,112,26518022,26520590
6662,6,6,1,2412,-81,-88,7,52:86:8c:5f:93:1e,26523993,332,3071,26523661,26523993
6663,4,11,1,2412,-80,-88,8,48:dd:0c:7d:86:27,26529576,362,5221,26529214,26529576
6664,4,11,1,2412,-80,-88,8,48:dd:0c:7d:86:23,26529950,323,51,26529627,26529950
6665,4,11,1,2412,-80,-88,8,48:dd:0c:7d:86:25,26530286,382,-46,26529904,26530286
6666,6,6,1,2412,-76,-88,12,f8:4f:ad:f9:af:82,26532221,1360,575,26530861,26532221
6667,6,6,1,2412,-77,-88,11,f8:4f:ad:f9:af:82,26533730,1332,177,26532398,26533730
6668,4,1,1,2412,-87,-88,1,,26538779,384,4665,26538395,26538779
6669,4,1,1,2412,-87,-88,1,,26539178,448,-49,26538730,26539178
6670,4,1,1,2412,-87,-88,1,,26540055,448,429,26539607,26540055
6671,6,6,1,2412,-80,-88,8,10:86:8c:5f:93:1e,26553208,336,12817,26552872,26553208
6672,4,1,1,2412,-86,-88,2,78:67:0e:38:6c:d3,26556473,2736,529,26553737,26556473
6673,4,1,1,2412,-85,-88,3,7c:f6:66:c0:cf:b8,26559265,2208,584,26557057,26559265
6674,4,11,1,2412,-82,-88,6,48:dd:0c:90:e3:85,26566183,382,6536,26565801,26566183
6675,4,1,1,2412,-86,-88,2,78:67:0e:c4:a8:42,26567777,2736,-1142,26565041,26567777
6676,4,1,1,2412,-79,-88,9,b0:e4:d5:32:ec:8a,26589380,1960,19643,26587420,26589380
6677,6,6,1,2412,-80,-88,8,32:86:8c:5f:93:1e,26603063,332,13351,26602731,26603063
6678,4,1,1,2412,-86,-88,2,b4:b5:2f:17:0c:b9,26608363,1376,3924,26606987,26608363
6679,6,6,1,2412,-76,-88,12,e2:db:d1:d1:b0:4a,26609614,444,807,26609170,26609614
6680,6,6,1,2412,-76,-88,12,e2:db:d1:d1:b0:4b,26610109,408,87,26609701,26610109
6681,6,6,1,2412,-75,-88,13,e2:db:d1:d1:b0:4f,26610999,408,482,26610591,26610999
6682,4,1,1,2412,-81,-88,7,10:7b:44:eb:35:60,26616943,1960,3984,26614983,26616943
6683,4,1,1,2412,-79,-88,9,3c:bd:c5:ee:96:6d,26619467,2512,12,26616955,26619467
6684,4,1,1,2412,-80,-88,8,b8:f8:53:cb:31:f1,26622030,976,1587,26621054,26622030
6685,6,6,1,2412,-81,-88,7,52:86:8c:5f:93:1e,26626394,332,4032,26626062,26626394
6686,4,11,1,2412,-79,-88,9,48:dd:0c:7d:86:27,26631975,362,5219,26631613,26631975
6687,4,11,1,2412,-80,-88,8,48:dd:0c:7d:86:23,26632349,323,51,26632026,26632349
6688,4,11,1,2412,-81,-88,7,48:dd:0c:7d:86:25,26632684,382,-47,26632302,26632684
6689,4,1,1,2412,-86,-88,2,,26641999,448,8867,26641551,26641999
6690,4,1,1,2412,-89,-88,-1,,26642682,384,299,26642298,26642682
6691,4,1,1,2412,-87,-88,1,,26643080,448,-50,26642632,26643080
6692,6,6,1,2412,-80,-88,8,10:86:8c:5f:93:1e,26656160,336,12744,26655824,26656160
6693,4,1,1,2412,-87,-88,1,78:67:0e:38:6c:d3,26658873,2736,-23,26656137,26658873
6694,4,11,1,2412,-83,-88,5,48:dd:0c:90:e3:85,26668583,382,9328,26668201,26668583
6695,6,6,1,2412,-80,-88,8,12:86:8c:5f:93:1e,26678029,332,9114,26677697,26678029
6696,6,24,1,2412,-82,-88,6,,26679003,28,946,26678975,26679003
6697,4,1,1,2412,-82,-88,6,d2:9e:43:bc:eb:ff,26686585,3600,3982,26682985,26686585
6698,4,1,1,2412,-84,-88,4,b4:b5:2f:17:0c:b9,26710738,1376,22777,26709362,26710738
6699,6,6,1,2412,-76,-88,12,e2:db:d1:d1:b0:4a,26711979,444,797,26711535,26711979
6700,6,6,1,2412,-76,-88,12,e2:db:d1:d1:b0:4b,26712447,408,60,26712039,26712447
6701,6,6,1,2412,-77,-88,11,e2:db:d1:d1:b0:4d,26712906,408,51,26712498,26712906
6702,6,6,1,2412,-77,-88,11,e2:db:d1:d1:b0:4f,26713338,408,24,26712930,26713338
6703,4,1,1,2412,-87,-88,1,bc:98:df:ff:0f:8b,26725403,2568,9497,26722835,26725403
6704,6,6,1,2412,-81,-88,7,52:86:8c:5f:93:1e,26728795,332,3060,26728463,26728795
6705,4,1,1,2412,-88,-88,0,ac:67:84:84:8a:07,26731902,416,2691,26731486,26731902
6706,4,1,1,2412,-89,-88,-1,,26732330,304,124,26732026,26732330
6707,4,11,1,2412,-80,-88,8,48:dd:0c:7d:86:27,26733645,362,953,26733283,26733645
6708,4,11,1,2412,-81,-88,7,48:dd:0c:7d:86:23,26734020,323,52,26733697,26734020
6709,4,11,1,2412,-81,-88,7,48:dd:0c:7d:86:25,26734355,382,-47,26733973,26734355
6710,6,6,1,2412,-85,-88,3,,26743054,44,8655,26743010,26743054
6711,6,24,1,2412,-82,-88,6,,26745376,28,2294,26745348,26745376
6712,6,6,1,2412,-81,-88,7,10:86:8c:5f:93:1e,26757720,336,12008,26757384,26757720
6713,6,24,1,2412,-84,-88,4,,26758134,28,386,26758106,26758134
6714,4,1,1,2412,-86,-88,2,78:67:0e:38:6c:d3,26761274,2736,404,26758538,26761274
6715,4,11,1,2412,-84,-88,4,48:dd:0c:90:e3:85,26770983,382,9327,26770601,26770983
6716,4,1,1,2412,-85,-88,3,78:67:0e:c4:a8:42,26772577,2736,-1142,26769841,26772577
6717,6,6,1,2412,-80,-88,8,12:86:8c:5f:93:1e,26779995,332,7086,26779663,26779995
6718,4,1,1,2412,-88,-88,0,ac:67:84:84:8a:07,26793796,416,13385,26793380,26793796
6719,4,1,1,2412,-77,-88,11,b0:e4:d5:32:ec:8a,26794179,1960,-1577,26792219,26794179
6720,6,6,1,2412,-81,-88,7,32:86:8c:5f:93:1e,26807831,332,13320,26807499,26807831
6721,6,6,1,2412,-76,-88,12,e2:db:d1:d1:b0:4a,26813687,444,5412,26813243,26813687
6722,6,6,1,2412,-76,-88,12,e2:db:d1:d1:b0:4d,26814613,408,518,26814205,26814613
6723,6,6,1,2412,-77,-88,11,e2:db:d1:d1:b0:4f,26815072,408,51,26814664,26815072
6724,4,1,1,2412,-78,-88,10,3c:bd:c5:ee:96:6d,26824405,2512,6821,26821893,26824405
6725,4,1,1,2412,-89,-88,-1,bc:98:df:ff:0f:8b,26827787,2568,814,26825219,26827787
6726,6,24,1,2412,-83,-88,5,,26830521,28,2706,26830493,26830521
6727,4,11,1,2412,-80,-88,8,48:dd:0c:7d:86:27,26836775,362,5892,26836413,26836775
6728,4,11,1,2412,-81,-88,7,48:dd:0c:7d:86:23,26837150,323,52,26836827,26837150
6729,4,11,1,2412,-81,-88,7,48:dd:0c:7d:86:25,26837485,382,-47,26837103,26837485
6730,6,24,1,2412,-82,-88,6,,26839201,28,1688,26839173,26839201
6731,4,1,1,2412,-87,-88,1,,26847572,448,7923,26847124,26847572
6732,4,11,1,2412,-87,-88,1,4c:01:43:d7:f3:23,26849271,322,1377,26848949,26849271
6733,6,6,1,2412,-80,-88,8,10:86:8c:5f:93:1e,26859644,336,10037,26859308,26859644
6734,4,1,1,2412,-87,-88,1,78:67:0e:38:6c:d3,26863674,2736,1294,26860938,26863674
6735,4,11,1,2412,-82,-88,6,48:dd:0c:90:e3:85,26873383,382,9327,26873001,26873383
6736,4,1,1,2412,-85,-88,3,78:67:0e:c4:a8:42,26874976,2736,-1143,26872240,26874976
6737,4,1,1,2412,-87,-88,1,,26877799,352,2471,26877447,26877799
6738,4,1,1,2412,-87,-88,1,ac:67:84:84:8a:07,26880061,416,1846,26879645,26880061
6739,4,11,1,2412,-85,-88,3,,26880612,203,348,26880409,26880612
6740,4,1,1,2412,-86,-88,2,78:67:0e:c4:a8:42,26881070,848,-390,26880222,26881070
6741,4,1,1,2412,-85,-88,3,,26881988,352,566,26881636,26881988
6742,6,6,1,2412,-78,-88,10,12:86:8c:5f:93:1e,26884965,332,2645,26884633,26884965
6743,6,24,1,2412,-82,-88,6,,26894007,28,9014,26893979,26894007
6744,4,1,1,2412,-78,-88,10,b0:e4:d5:32:ec:8a,26896578,1960,611,26894618,26896578
6745,6,24,1,2412,-82,-88,6,,26905378,28,8772,26905350,26905378
6746,6,6,1,2412,-80,-88,8,32:86:8c:5f:93:1e,26919735,332,14025,26919403,26919735
6747,6,6,1,2412,-76,-88,12,e0:db:d1:d0:b0:48,26920648,380,533,26920268,26920648
6748,4,1,1,2412,-80,-88,8,3c:bd:c5:ee:96:6d,26926581,2512,3421,26924069,26926581
6749,4,1,1,2412,-79,-88,9,7a:69:2f:c5:b4:03,26929120,1840,699,26927280,26929120
6750,4,1,1,2412,-77,-88,11,7a:69:2f:c5:b4:03,26930986,2000,-134,26928986,26930986
6751,6,6,1,2412,-76,-88,12,e0:db:d1:d0:b0:48,26932869,384,1499,26932485,26932869
6752,6,6,1,2412,-76,-88,12,e0:db:d1:d0:b0:48,26933331,392,70,26932939,26933331
6753,4,11,1,2412,-81,-88,7,48:dd:0c:7d:86:27,26939191,362,5498,26938829,26939191
6754,4,11,1,2412,-80,-88,8,48:dd:0c:7d:86:23,26939566,323,52,26939243,26939566
6755,4,11,1,2412,-80,-88,8,48:dd:0c:7d:86:25,26939901,382,-47,26939519,26939901
6756,4,1,1,2412,-89,-88,-1,,26949911,384,9626,26949527,26949911
6757,4,1,1,2412,-87,-88,1,,26950309,448,-50,26949861,26950309
6758,4,1,1,2412,-90,-88,-2,,26950815,384,122,26950431,26950815
6759,4,1,1,2412,-87,-88,1,,26951213,448,-50,26950765,26951213
6760,4,1,1,2412,-83,-88,5,66:32:b1:64:4c:f2,26956470,2696,2561,26953774,26956470
6761,4,1,1,2412,-87,-88,1,78:67:0e:38:6c:d3,26966074,2736,6868,26963338,26966074
6762,4,11,1,2412,-84,-88,4,48:dd:0c:90:e3:85,26975782,382,9326,26975400,26975782
6763,4,11,1,2412,-84,-88,4,,26976173,107,284,26976066,26976173
6764,4,1,1,2412,-84,-88,4,78:67:0e:c4:a8:42,26977376,2736,-1533,26974640,26977376
6765,4,1,1,2412,-88,-88,0,ac:67:84:84:8a:07,26983302,416,5510,26982886,26983302
6766,4,1,1,2412,-89,-88,-1,,26983730,304,124,26983426,26983730
6767,6,6,1,2412,-80,-88,8,12:86:8c:5f:93:1e,26984796,332,734,26984464,26984796
6768,6,24,1,2412,-83,-88,5,,26998231,28,13407,26998203,26998231
6769,6,6,1,2412,-81,-88,7,32:86:8c:5f:93:1e,27012394,332,13831,27012062,27012394
6770,4,1,1,2412,-86,-88,2,b4:b5:2f:17:0c:b9,27018866,1376,5096,27017490,27018866
6771,6,6,1,2412,-76,-88,12,e2:db:d1:d1:b0:4b,27020107,408,833,27019699,27020107
6772,4,1,1,2412,-88,-88,0,ac:67:84:84:8a:07,27028499,416,7976,27028083,27028499
6773,4,1,1,2412,-78,-88,10,3c:bd:c5:ee:96:6d,27028974,2512,-2037,27026462,27028974
6774,6,6,1,2412,-80,-88,8,52:86:8c:5f:93:1e,27035997,332,6691,27035665,27035997
6775,4,11,1,2412,-81,-88,7,48:dd:0c:7d:86:23,27041949,323,5629,27041626,27041949
6776,4,11,1,2412,-80,-88,8,48:dd:0c:7d:86:25,27042285,382,-46,27041903,27042285
6777,4,1,1,2412,-90,-88,-2,60:b7:6e:d3:6c:f6,27045579,2152,1142,27043427,27045579
6778,4,1,1,2412,-89,-88,-1,ac:67:84:84:8a:07,27048070,416,2075,27047654,27048070
6779,4,1,1,2412,-88,-88,0,,27048498,304,124,27048194,27048498
6780,4,1,1,2412,-88,-88,0,,27053070,448,4124,27052622,27053070
6781,6,24,1,2412,-84,-88,4,,27054734,28,1636,27054706,27054734
6782,4,1,1,2412,-83,-88,5,66:32:b1:64:4c:f2,27057700,2696,270,27055004,27057700
6783,6,24,1,2412,-83,-88,5,,27065382,28,7654,27065354,27065382
6784,4,1,1,2412,-85,-88,3,78:67:0e:38:6c:d3,27068474,2736,356,27065738,27068474
6785,4,11,1,2412,-85,-88,3,4c:01:43:ec:a0:69,27072005,361,3170,27071644,27072005
6786,4,11,1,2412,-83,-88,5,48:dd:0c:90:e3:85,27078182,382,5795,27077800,27078182
6787,4,1,1,2412,-85,-88,3,,27079858,304,1372,27079554,27079858
6788,4,1,1,2412,-85,-88,3,78:67:0e:c4:a8:42,27080182,2736,-2412,27077446,27080182
6789,6,6,1,2412,-80,-88,8,12:86:8c:5f:93:1e,27088459,332,7945,27088127,27088459
6790,4,1,1,2412,-85,-88,3,,27097759,304,8996,27097455,27097759
6791,4,11,1,2412,-84,-88,4,,27098581,107,715,27098474,27098581
6792,6,12,1,2412,-84,-88,4,,27099384,44,759,27099340,27099384
6793,4,1,1,2412,-79,-88,9,b0:e4:d5:32:ec:8a,27101377,1960,33,27099417,27101377
6794,6,6,1,2412,-81,-88,7,32:86:8c:5f:93:1e,27114726,332,13017,27114394,27114726
6795,4,1,1,2412,-85,-88,3,b4:b5:2f:17:0c:b9,27119642,1376,3540,27118266,27119642
6796,6,6,1,2412,-76,-88,12,e2:db:d1:d1:b0:4a,27120874,444,788,27120430,27120874
6797,6,6,1,2412,-75,-88,13,e2:db:d1:d1:b0:4b,27121351,408,69,27120943,27121351
6798,6,6,1,2412,-77,-88,11,e2:db:d1:d1:b0:4d,27121810,408,51,27121402,27121810
6799,6,6,1,2412,-76,-88,12,e2:db:d1:d1:b0:4f,27122269,408,51,27121861,27122269
6800,4,1,1,2412,-84,-88,4,,27122960,352,339,27122608,27122960
6801,4,1,1,2412,-83,-88,5,,27125424,352,2112,27125072,27125424
6802,6,6,1,2412,-79,-88,9,52:86:8c:5f:93:1e,27138398,332,12642,27138066,27138398
6803,4,11,1,2412,-80,-88,8,48:dd:0c:7d:86:27,27143975,362,5215,27143613,27143975
6804,4,11,1,2412,-80,-88,8,48:dd:0c:7d:86:23,27144349,323,51,27144026,27144349
6805,4,11,1,2412,-80,-88,8,48:dd:0c:7d:86:25,27144684,382,-47,27144302,27144684
6806,6,24,1,2412,-82,-88,6,,27145379,28,667,27145351,27145379
6807,6,24,1,2412,-83,-88,5,,27151156,28,5749,27151128,27151156
6808,6,6,1,2412,-75,-88,13,76:a2:c1:67:70:44,27154318,308,2854,27154010,27154318
6809,6,6,1,2412,-76,-88,12,76:a2:c1:67:70:44,27154659,308,33,27154351,27154659
6810,6,6,1,2412,-76,-88,12,e0:db:d1:d0:b0:48,27155090,308,123,27154782,27155090
6811,6,6,1,2412,-76,-88,12,b2:e2:49:f6:8a:4e,27155430,308,32,27155122,27155430
6812,4,1,1,2412,-86,-88,2,,27157426,448,1548,27156978,27157426
6813,4,1,1,2412,-78,-88,10,3c:bd:c5:ee:96:6d,27161449,3280,743,27158169,27161449
6814,6,6,1,2412,-79,-88,9,10:86:8c:5f:93:1e,27167979,336,6194,27167643,27167979
6815,4,1,1,2412,-87,-88,1,78:67:0e:38:6c:d3,27170874,2736,159,27168138,27170874
6816,4,1,1,2412,-87,-88,1,78:67:0e:38:6c:d3,27174821,848,3099,27173973,27174821
6817,4,1,1,2412,-85,-88,3,3c:bd:c5:ad:f6:9e,27175680,1056,-197,27174624,27175680
6818,4,11,1,2412,-76,-88,12,48:dd:0c:90:e3:85,27180582,382,4520,27180200,27180582
6819,6,6,1,2412,-76,-88,12,f8:4f:ad:f9:af:82,27181484,156,746,27181328,27181484
6820,6,6,1,2412,-77,-88,11,e0:db:d1:d0:b0:48,27185098,156,3458,27184942,27185098
6821,6,6,1,2412,-80,-88,8,12:86:8c:5f:93:1e,27189598,332,4168,27189266,27189598
6822,6,6,1,2412,-76,-88,12,f8:4f:ad:f9:af:82,27193240,196,3446,27193044,27193240
6823,6,6,1,2412,-76,-88,12,f8:4f:ad:f9:af:82,27193726,156,330,27193570,27193726
6824,4,1,1,2412,-78,-88,10,b0:e4:d5:32:ec:8a,27203776,1960,8090,27201816,27203776
6825,6,6,1,2412,-80,-88,8,32:86:8c:5f:93:1e,27217059,332,12951,27216727,27217059
6826,6,6,1,2412,-84,-88,4,,27220204,44,3101,27220160,27220204
6827,4,1,1,2412,-86,-88,2,b4:b5:2f:17:0c:b9,27222043,1376,463,27220667,27222043
6828,6,6,1,2412,-76,-88,12,e2:db:d1:d1:b0:4a,27223275,444,788,27222831,27223275
6829,6,6,1,2412,-76,-88,12,e2:db:d1:d1:b0:4b,27223770,408,87,27223362,27223770
6830,6,6,1,2412,-76,-88,12,e2:db:d1:d1:b0:4d,27224220,408,42,27223812,27224220
6831,6,6,1,2412,-76,-88,12,e2:db:d1:d1:b0:4f,27224652,408,24,27224244,27224652
6832,6,24,1,2412,-86,-88,2,,27225223,28,543,27225195,27225223
6833,4,11,1,2412,-86,-88,2,,27225520,107,190,27225413,27225520
6834,6,24,1,2412,-84,-88,4,,27225973,28,425,27225945,27225973
6835,6,24,1,2412,-83,-88,5,,27230367,28,4366,27230339,27230367
6836,4,1,1,2412,-80,-88,8,3c:bd:c5:ee:96:6d,27234706,2512,1827,27232194,27234706
6837,4,1,1,2412,-80,-88,8,,27243068,352,8010,27242716,27243068
6838,4,1,1,2412,-84,-88,4,,27245591,352,2171,27245239,27245591
6839,4,11,1,2412,-81,-88,7,48:dd:0c:7d:86:27,27246374,362,421,27246012,27246374
6840,4,11,1,2412,-80,-88,8,48:dd:0c:7d:86:23,27246749,323,52,27246426,27246749
6841,4,11,1,2412,-80,-88,8,48:dd:0c:7d:86:25,27247084,382,-47,27246702,27247084
6842,4,1,1,2412,-91,-88,-3,,27258339,384,10871,27257955,27258339
6843,4,1,1,2412,-88,-88,0,,27259614,448,827,27259166,27259614
6844,6,6,1,2412,-76,-88,12,f8:4f:ad:f9:af:82,27260840,248,978,27260592,27260840
6845,6,6,1,2412,-76,-88,12,f8:4f:ad:f9:af:82,27262773,224,1709,27262549,27262773
6846,6,6,1,2412,-81,-88,7,10:86:8c:5f:93:1e,27266577,336,3468,27266241,27266577
6847,4,1,1,2412,-88,-88,0,78:67:0e:38:6c:d3,27273274,2736,3961,27270538,27273274
6848,4,1,1,2412,-86,-88,2,ac:67:84:84:8a:07,27278088,416,4398,27277672,27278088
6849,4,1,1,2412,-86,-88,2,ac:67:84:84:8a:07,27279231,416,727,27278815,27279231
6850,4,1,1,2412,-87,-88,1,,27279660,304,125,27279356,27279660
6851,4,11,1,2412,-76,-88,12,48:dd:0c:90:e3:87,27282272,362,2250,27281910,27282272
6852,4,11,1,2412,-76,-88,12,48:dd:0c:90:e3:83,27282646,323,51,27282323,27282646
6853,4,11,1,2412,-77,-88,11,48:dd:0c:90:e3:85,27282982,382,-46,27282600,27282982
6854,4,1,1,2412,-85,-88,3,78:67:0e:c4:a8:42,27287250,2736,1532,27284514,27287250
6855,6,24,1,2412,-82,-88,6,,27294010,28,6732,27293982,27294010
6856,6,6,1,2412,-81,-88,7,12:86:8c:5f:93:1e,27295276,332,934,27294944,27295276
6857,4,1,1,2412,-79,-88,9,b0:e4:d5:32:ec:8a,27306175,1960,8939,27304215,27306175
6858,4,1,1,2412,-88,-88,0,60:32:b1:64:4c:f2,27313533,3224,4134,27310309,27313533
6859,6,6,1,2412,-81,-88,7,32:86:8c:5f:93:1e,27319496,332,5631,27319164,27319496
6860,6,6,1,2412,-84,-88,4,,27319936,44,396,27319892,27319936
6861,4,1,1,2412,-84,-88,4,b4:b5:2f:17:0c:b9,27324445,1376,3133,27323069,27324445
6862,6,6,1,2412,-76,-88,12,e2:db:d1:d1:b0:4a,27325695,444,806,27325251,27325695
6863,6,6,1,2412,-76,-88,12,e2:db:d1:d1:b0:4b,27326190,408,87,27325782,27326190
6864,6,6,1,2412,-76,-88,12,e2:db:d1:d1:b0:4d,27326640,408,42,27326232,27326640
6865,6,6,1,2412,-76,-88,12,e2:db:d1:d1:b0:4f,27327090,408,42,27326682,27327090
6866,4,1,1,2412,-80,-88,8,3c:bd:c5:ee:96:6d,27336168,2512,6566,27333656,27336168
6867,6,6,1,2412,-76,-88,12,f8:4f:ad:f9:af:82,27338554,196,2190,27338358,27338554
6868,4,1,1,2412,-88,-88,0,bc:98:df:ff:0f:8b,27339780,2568,-1342,27337212,27339780
6869,4,1,1,2412,-87,-88,1,ac:67:84:84:8a:07,27342409,416,2213,27341993,27342409
6870,6,6,1,2412,-81,-88,7,52:86:8c:5f:93:1e,27343199,332,458,27342867,27343199
6871,4,1,1,2412,-91,-88,-3,,27361940,384,18357,27361556,27361940
6872,4,1,1,2412,-87,-88,1,,27362339,448,-49,27361891,27362339
6873,6,24,1,2412,-82,-88,6,,27374009,28,11642,27373981,27374009
6874,6,6,1,2412,-81,-88,7,10:86:8c:5f:93:1e,27374253,336,-92,27373917,27374253
6875,4,11,1,2412,-83,-88,5,48:dd:0c:90:e3:83,27375358,254,851,27375104,27375358
6876,4,11,1,2412,-78,-88,10,48:dd:0c:90:e3:83,27385046,323,9365,27384723,27385046
6877,4,1,1,2412,-85,-88,3,78:67:0e:c4:a8:42,27387015,2736,-767,27384279,27387015
6878,6,24,1,2412,-82,-88,6,,27390298,28,3255,27390270,27390298
6879,6,6,1,2412,-81,-88,7,12:86:8c:5f:93:1e,27394399,332,3769,27394067,27394399
6880,6,24,1,2412,-83,-88,5,,27398944,28,4517,27398916,27398944
6881,4,11,1,2412,-85,-88,3,4c:01:43:ec:a0:63,27406712,254,7514,27406458,27406712
6882,4,1,1,2412,-79,-88,9,b0:e4:d5:32:ec:8a,27408575,1960,-97,27406615,27408575
6883,6,6,1,2412,-79,-88,9,32:86:8c:5f:93:1e,27420032,332,11125,27419700,27420032
6884,4,1,1,2412,-85,-88,3,b4:b5:2f:17:0c:b9,27426847,1376,5439,27425471,27426847
6885,6,6,1,2412,-76,-88,12,e2:db:d1:d1:b0:4a,27428106,444,815,27427662,27428106
6886,6,6,1,2412,-77,-88,11,e2:db:d1:d1:b0:4d,27429051,408,537,27428643,27429051
6887,6,6,1,2412,-77,-88,11,e2:db:d1:d1:b0:4f,27429483,408,24,27429075,27429483
6888,4,1,1,2412,-87,-88,1,10:7b:44:eb:35:60,27436133,1960,4690,27434173,27436133
6889,4,1,1,2412,-79,-88,9,3c:bd:c5:ee:96:6d,27438640,2512,-5,27436128,27438640
6890,4,1,1,2412,-88,-88,0,bc:98:df:ff:0f:8b,27442987,2568,1779,27440419,27442987
6891,4,11,1,2412,-78,-88,10,48:dd:0c:7d:86:27,27451174,362,7825,27450812,27451174
6892,4,11,1,2412,-78,-88,10,48:dd:0c:7d:86:23,27451548,323,51,27451225,27451548
6893,4,11,1,2412,-78,-88,10,48:dd:0c:7d:86:25,27451884,382,-46,27451502,27451884
6894,4,1,1,2412,-88,-88,0,ce:9e:43:bc:eb:ff,27459158,3800,3474,27455358,27459158
6895,6,6,1,2412,-79,-88,9,10:86:8c:5f:93:1e,27480666,336,21172,27480330,27480666
6896,4,11,1,2412,-77,-88,11,48:dd:0c:90:e3:87,27487071,362,6043,27486709,27487071
6897,4,11,1,2412,-82,-88,6,48:dd:0c:90:e3:85,27487781,382,328,27487399,27487781
6898,4,1,1,2412,-85,-88,3,78:67:0e:c4:a8:42,27489529,2736,-988,27486793,27489529
6899,6,6,1,2412,-80,-88,8,12:86:8c:5f:93:1e,27496800,332,6939,27496468,27496800
6900,4,1,1,2412,-79,-88,9,b0:e4:d5:32:ec:8a,27510974,1960,12214,27509014,27510974
6901,6,6,1,2412,-81,-88,7,32:86:8c:5f:93:1e,27524058,332,12752,27523726,27524058
6902,4,1,1,2412,-86,-88,2,b4:b5:2f:17:0c:b9,27529249,1376,3815,27527873,27529249
6903,6,6,1,2412,-76,-88,12,e2:db:d1:d1:b0:4a,27530490,444,797,27530046,27530490
6904,6,6,1,2412,-76,-88,12,e2:db:d1:d1:b0:4b,27530967,408,69,27530559,27530967
6905,6,6,1,2412,-76,-88,12,e2:db:d1:d1:b0:4f,27531849,408,474,27531441,27531849
6906,4,1,1,2412,-78,-88,10,3c:bd:c5:ee:96:6d,27540969,2512,6608,27538457,27540969
6907,4,1,1,2412,-87,-88,1,bc:98:df:ff:0f:8b,27544606,2568,1069,27542038,27544606
6908,6,6,1,2412,-79,-88,9,52:86:8c:5f:93:1e,27548001,332,3063,27547669,27548001
6909,4,11,1,2412,-78,-88,10,48:dd:0c:7d:86:27,27553574,362,5211,27553212,27553574
6910,4,11,1,2412,-79,-88,9,48:dd:0c:7d:86:23,27553948,323,51,27553625,27553948
6911,4,11,1,2412,-80,-88,8,48:dd:0c:7d:86:25,27554283,382,-47,27553901,27554283
6912,4,1,1,2412,-90,-88,-2,60:b7:6e:d3:6c:f6,27557580,2152,1145,27555428,27557580
6913,6,6,1,2412,-80,-88,8,10:86:8c:5f:93:1e,27575883,336,17967,27575547,27575883
6914,6,6,1,2412,-83,-88,5,,27578376,44,2449,27578332,27578376
6915,4,1,1,2412,-86,-88,2,,27580257,352,1529,27579905,27580257
6916,4,1,1,2412,-85,-88,3,78:67:0e:38:6c:d3,27580928,2736,-2065,27578192,27580928
6917,4,1,1,2412,-85,-88,3,,27583689,352,2409,27583337,27583689
6918,4,1,1,2412,-85,-88,3,,27585150,352,1109,27584798,27585150
6919,4,1,1,2412,-85,-88,3,,27586003,352,501,27585651,27586003
6920,4,11,1,2412,-77,-88,11,48:dd:0c:90:e3:83,27589846,323,3520,27589523,27589846
6921,4,11,1,2412,-80,-88,8,48:dd:0c:90:e3:85,27590181,382,-47,27589799,27590181
6922,4,1,1,2412,-88,-88,0,,27591315,448,686,27590867,27591315
6923,4,1,1,2412,-85,-88,3,78:67:0e:c4:a8:42,27591777,2736,-2274,27589041,27591777
6924,4,1,1,2412,-85,-88,3,,27594541,352,2412,27594189,27594541
6925,6,6,1,2412,-80,-88,8,12:86:8c:5f:93:1e,27599201,332,4328,27598869,27599201
6926,4,1,1,2412,-90,-88,-2,00:26:62:eb:ea:74,27605021,968,4852,27604053,27605021
6927,4,1,1,2412,-90,-88,-2,,27606156,304,831,27605852,27606156
6928,4,1,1,2412,-77,-88,11,b0:e4:d5:32:ec:8a,27613373,1960,5257,27611413,27613373
6929,4,1,1,2412,-87,-88,1,b4:b5:2f:17:0c:b9,27631651,1376,16902,27630275,27631651
6930,6,6,1,2412,-76,-88,12,e2:db:d1:d1:b0:4a,27632901,444,806,27632457,27632901
6931,6,6,1,2412,-76,-88,12,e2:db:d1:d1:b0:4b,27633368,408,59,27632960,27633368
6932,6,6,1,2412,-77,-88,11,e2:db:d1:d1:b0:4d,27633819,408,43,27633411,27633819
6933,6,24,1,2412,-83,-88,5,,27638038,28,4191,27638010,27638038
6934,4,1,1,2412,-78,-88,10,3c:bd:c5:ee:96:6d,27643374,2512,2824,27640862,27643374
6935,4,1,1,2412,-87,-88,1,bc:98:df:ff:0f:8b,27646984,2568,1042,27644416,27646984
6936,6,6,1,2412,-80,-88,8,52:86:8c:5f:93:1e,27650402,332,3086,27650070,27650402
6937,4,1,1,2412,-87,-88,1,ac:67:84:84:8a:07,27653934,416,3116,27653518,27653934
6938,4,11,1,2412,-80,-88,8,48:dd:0c:7d:86:27,27655973,362,1677,27655611,27655973
6939,4,11,1,2412,-79,-88,9,48:dd:0c:7d:86:25,27656683,382,328,27656301,27656683
6940,4,1,1,2412,-89,-88,-1,04:a2:22:de:87:a6,27675356,2512,16161,27672844,27675356
6941,4,1,1,2412,-88,-88,0,,27681708,384,5968,27681324,27681708
6942,4,1,1,2412,-86,-88,2,,27682106,448,-50,27681658,27682106
6943,4,1,1,2412,-89,-88,-1,,27682612,384,122,27682228,27682612
6944,4,1,1,2412,-85,-88,3,78:67:0e:c4:a8:42,27694175,2736,8827,27691439,27694175
6945,6,6,1,2412,-79,-88,9,12:86:8c:5f:93:1e,27702029,332,7522,27701697,27702029
6946,6,24,1,2412,-83,-88,5,,27705394,28,3337,27705366,27705394
6947,6,24,1,2412,-83,-88,5,,27711271,28,5849,27711243,27711271
6948,6,6,1,2412,-85,-88,3,,27721745,44,10430,27721701,27721745
6949,6,6,1,2412,-80,-88,8,32:86:8c:5f:93:1e,27728723,332,6646,27728391,27728723
6950,6,6,1,2412,-76,-88,12,e2:db:d1:d1:b0:4a,27735284,444,6117,27734840,27735284
6951,6,6,1,2412,-76,-88,12,e2:db:d1:d1:b0:4b,27735780,408,88,27735372,27735780
6952,6,6,1,2412,-76,-88,12,e2:db:d1:d1:b0:4d,27736211,408,23,27735803,27736211
6953,6,6,1,2412,-77,-88,11,e2:db:d1:d1:b0:4f,27736643,408,24,27736235,27736643
6954,4,1,1,2412,-80,-88,8,3c:bd:c5:ee:96:6d,27745778,2512,6623,27743266,27745778
6955,4,1,1,2412,-89,-88,-1,bc:98:df:ff:0f:8b,27749408,2568,1062,27746840,27749408
6956,6,6,1,2412,-80,-88,8,52:86:8c:5f:93:1e,27752802,332,3062,27752470,27752802
6957,4,11,1,2412,-78,-88,10,48:dd:0c:7d:86:23,27758748,323,5623,27758425,27758748
6958,4,11,1,2412,-80,-88,8,48:dd:0c:7d:86:25,27759083,382,-47,27758701,27759083
6959,4,11,1,2412,-90,-88,-2,4c:01:43:d7:f3:23,27770866,322,11461,27770544,27770866
6960,4,1,1,2412,-85,-88,3,,27772576,448,1262,27772128,27772576
6961,4,1,1,2412,-86,-88,2,,27773453,448,429,27773005,27773453
6962,4,11,1,2412,-78,-88,10,48:dd:0c:7d:86:23,27777788,254,4081,27777534,27777788
6963,4,11,1,2412,-83,-88,5,48:dd:0c:90:e3:83,27778091,254,49,27777837,27778091
6964,4,1,1,2412,-88,-88,0,78:67:0e:38:6c:d3,27785275,2736,4448,27782539,27785275
6965,4,11,1,2412,-85,-88,3,4c:01:43:ec:a0:69,27788797,361,3161,27788436,27788797
6966,6,24,1,2412,-83,-88,5,,27790289,28,1464,27790261,27790289
6967,4,1,1,2412,-85,-88,3,78:67:0e:c4:a8:42,27796575,2736,3550,27793839,27796575
6968,6,6,1,2412,-81,-88,7,12:86:8c:5f:93:1e,27804839,332,7932,27804507,27804839
6969,4,1,1,2412,-79,-88,9,3c:bd:c5:ee:96:6d,27807146,3280,-973,27803866,27807146
6970,4,1,1,2412,-86,-88,2,ac:67:84:84:8a:07,27814562,416,7000,27814146,27814562
6971,4,1,1,2412,-79,-88,9,b0:e4:d5:32:ec:8a,27819599,1960,3077,27817639,27819599
6972,4,1,1,2412,-88,-88,0,,27824497,304,4594,27824193,27824497
6973,4,1,1,2412,-87,-88,1,ac:67:84:84:8a:07,27829483,416,4570,27829067,27829483
6974,6,6,1,2412,-81,-88,7,32:86:8c:5f:93:1e,27835260,332,5445,27834928,27835260
6975,4,1,1,2412,-83,-88,5,b4:b5:2f:17:0c:b9,27837566,1376,930,27836190,27837566
6976,6,6,1,2412,-76,-88,12,e2:db:d1:d1:b0:4a,27838807,444,797,27838363,27838807
6977,6,6,1,2412,-77,-88,11,e2:db:d1:d1:b0:4b,27839302,408,87,27838894,27839302
6978,6,6,1,2412,-76,-88,12,e2:db:d1:d1:b0:4d,27839761,408,51,27839353,27839761
6979,6,6,1,2412,-76,-88,12,e2:db:d1:d1:b0:4f,27840202,408,33,27839794,27840202
6980,4,1,1,2412,-78,-88,10,3c:bd:c5:ee:96:6d,27848179,2512,5465,27845667,27848179
6981,4,1,1,2412,-88,-88,0,94:9f:3e:51:c9:e6,27854387,1088,5120,27853299,27854387
6982,6,6,1,2412,-80,-88,8,52:86:8c:5f:93:1e,27855511,332,792,27855179,27855511
6983,4,11,1,2412,-80,-88,8,48:dd:0c:7d:86:27,27860777,362,4904,27860415,27860777
6984,4,11,1,2412,-79,-88,9,48:dd:0c:7d:86:23,27861152,323,52,27860829,27861152
6985,4,11,1,2412,-78,-88,10,48:dd:0c:7d:86:25,27861487,382,-47,27861105,27861487
6986,6,24,1,2412,-82,-88,6,,27871123,28,9608,27871095,27871123
6987,6,6,1,2412,-87,-88,1,,27873886,44,2719,27873842,27873886
6988,4,1,1,2412,-86,-88,2,ac:67:84:84:8a:07,27880569,416,6267,27880153,27880569
6989,4,1,1,2412,-85,-88,3,ac:67:84:84:8a:07,27881630,416,645,27881214,27881630
6990,6,6,1,2412,-81,-88,7,10:86:8c:5f:93:1e,27883001,336,1035,27882665,27883001
6991,6,6,1,2412,-81,-88,7,b4:e6:2d:b4:ff:71,27884481,64,1416,27884417,27884481
6992,6,6,1,2412,-80,-88,8,b4:e6:2d:b4:ff:71,27884769,64,224,27884705,27884769
6993,6,6,1,2412,-80,-88,8,b4:e6:2d:b4:ff:71,27884957,64,124,27884893,27884957
6994,6,6,1,2412,-80,-88,8,b4:e6:2d:b4:ff:71,27885129,64,108,27885065,27885129
6995,6,6,1,2412,-80,-88,8,,27885209,44,36,27885165,27885209
6996,4,1,1,2412,-87,-88,1,78:67:0e:38:6c:d3,27887675,2736,-270,27884939,27887675
6997,4,11,1,2412,-86,-88,2,4c:01:43:ec:a0:63,27891570,322,3573,27891248,27891570
6998,4,1,1,2412,-85,-88,3,78:67:0e:c4:a8:42,27898975,2736,4669,27896239,27898975
6999,4,1,1,2412,-78,-88,10,b0:e4:d5:32:ec:8a,27920571,1960,19636,27918611,27920571
7000,4,1,1,2412,-85,-88,3,ac:67:84:84:8a:07,27930660,416,9673,27930244,27930660
7001,6,6,1,2412,-80,-88,8,32:86:8c:5f:93:1e,27933388,332,2396,27933056,27933388
7002,6,24,1,2412,-83,-88,5,,27934021,28,605,27933993,27934021
7003,6,6,1,2412,-77,-88,11,f8:4f:ad:f9:af:82,27934916,576,319,27934340,27934916
7004,6,6,1,2412,-76,-88,12,f8:4f:ad:f9:af:82,27936268,548,804,27935720,27936268
7005,6,6,1,2412,-76,-88,12,e2:db:d1:d1:b0:4a,27940141,444,3429,27939697,27940141
7006,6,6,1,2412,-77,-88,11,e2:db:d1:d1:b0:4b,27940618,408,69,27940210,27940618
7007,6,6,1,2412,-77,-88,11,e2:db:d1:d1:b0:4d,27941059,408,33,27940651,27941059
7008,6,6,1,2412,-76,-88,12,e2:db:d1:d1:b0:4f,27941500,408,33,27941092,27941500
7009,4,1,1,2412,-85,-88,3,ac:67:84:84:8a:07,27945131,416,3215,27944715,27945131
7010,6,24,1,2412,-83,-88,5,,27945398,28,239,27945370,27945398
7011,6,24,1,2412,-82,-88,6,,27950307,28,4881,27950279,27950307
7012,4,1,1,2412,-79,-88,9,3c:bd:c5:ee:96:6d,27950583,2512,-2236,27948071,27950583
7013,4,1,1,2412,-89,-88,-1,bc:98:df:ff:0f:8b,27954189,2568,1038,27951621,27954189
7014,6,6,1,2412,-80,-88,8,52:86:8c:5f:93:1e,27957604,332,3083,27957272,27957604
7015,6,24,1,2412,-82,-88,6,,27958015,28,383,27957987,27958015
7016,4,11,1,2412,-80,-88,8,48:dd:0c:7d:86:23,27960696,254,2427,27960442,27960696
7017,4,11,1,2412,-83,-88,5,48:dd:0c:90:e3:83,27961268,254,318,27961014,27961268
7018,4,11,1,2412,-80,-88,8,48:dd:0c:7d:86:27,27963173,362,1543,27962811,27963173
7019,4,11,1,2412,-80,-88,8,48:dd:0c:7d:86:23,27963547,323,51,27963224,27963547
7020,4,11,1,2412,-80,-88,8,48:dd:0c:7d:86:25,27963883,382,-46,27963501,27963883
7021,6,6,1,2412,-80,-88,8,10:86:8c:5f:93:1e,27985459,336,21240,27985123,27985459
7022,4,1,1,2412,-88,-88,0,78:67:0e:38:6c:d3,27990075,2736,1880,27987339,27990075
7023,4,11,1,2412,-77,-88,11,48:dd:0c:90:e3:87,27999086,362,8649,27998724,27999086
7024,4,11,1,2412,-78,-88,10,48:dd:0c:90:e3:83,27999461,323,52,27999138,27999461
7025,4,11,1,2412,-83,-88,5,48:dd:0c:90:e3:85,27999796,382,-47,27999414,27999796
7026,4,1,1,2412,-87,-88,1,78:67:0e:c4:a8:42,28001375,2736,-1157,27998639,28001375
7027,4,1,1,2412,-86,-89,3,ac:67:84:84:8a:07,28022566,416,20775,28022150,28022566
7028,4,1,1,2412,-77,-89,12,b0:e4:d5:32:ec:8a,28022971,1960,-1555,28021011,28022971
7029,4,1,1,2412,-85,-89,4,b4:b5:2f:17:0c:b9,28026316,1328,2017,28024988,28026316
7030,4,1,1,2412,-79,-89,10,3c:bd:c5:ee:96:6d,28028390,3280,-1206,28025110,28028390
7031,6,6,1,2412,-80,-89,9,32:86:8c:5f:93:1e,28035721,332,6999,28035389,28035721
7032,4,1,1,2412,-84,-89,5,b4:b5:2f:17:0c:b9,28041258,1376,4161,28039882,28041258
7033,6,6,1,2412,-76,-89,13,e2:db:d1:d1:b0:4a,28042490,444,788,28042046,28042490
7034,6,6,1,2412,-76,-89,13,e2:db:d1:d1:b0:4b,28042958,408,60,28042550,28042958
7035,6,6,1,2412,-77,-89,12,e2:db:d1:d1:b0:4f,28043957,408,591,28043549,28043957
7036,4,1,1,2412,-79,-89,10,3c:bd:c5:ee:96:6d,28052983,2512,6514,28050471,28052983
7037,4,1,1,2412,-75,-89,14,bc:98:df:ff:0f:8b,28056591,2568,1040,28054023,28056591
7038,6,6,1,2412,-79,-89,10,52:86:8c:5f:93:1e,28060004,332,3081,28059672,28060004
7039,4,11,1,2412,-80,-89,9,48:dd:0c:7d:86:27,28065573,362,5207,28065211,28065573
7040,4,11,1,2412,-81,-89,8,48:dd:0c:7d:86:23,28065947,323,51,28065624,28065947
7041,4,11,1,2412,-80,-89,9,48:dd:0c:7d:86:25,28066282,382,-47,28065900,28066282
7042,4,1,1,2412,-88,-89,1,bc:98:df:ff:0f:8b,28066655,3176,-2803,28063479,28066655
7043,6,6,1,2412,-85,-89,4,,28073993,44,7294,28073949,28073993
7044,4,11,1,2412,-88,-89,1,4c:01:43:d7:f3:23,28078065,322,3750,28077743,28078065
7045,4,1,1,2412,-87,-89,2,,28080965,448,2452,28080517,28080965
7046,6,6,1,2412,-81,-89,8,10:86:8c:5f:93:1e,28087488,336,6187,28087152,28087488
7047,6,24,1,2412,-82,-89,7,,28088496,32,976,28088464,28088496
7048,4,1,1,2412,-78,-89,11,,28091005,352,2157,28090653,28091005
7049,4,11,1,2412,-75,-89,14,48:dd:0c:90:e3:87,28101470,362,10103,28101108,28101470
7050,6,6,1,2412,-81,-89,8,12:86:8c:5f:93:1e,28114538,332,12736,28114206,28114538
7051,6,6,1,2412,-84,-89,5,,28118909,44,4327,28118865,28118909
7052,4,1,1,2412,-87,-89,2,80:02:9c:10:d2:2a,28131679,432,12338,28131247,28131679
7053,6,6,1,2412,-80,-89,9,32:86:8c:5f:93:1e,28138053,332,6042,28137721,28138053
7054,4,1,1,2412,-84,-89,5,b4:b5:2f:17:0c:b9,28143659,1376,4230,28142283,28143659
7055,6,6,1,2412,-76,-89,13,e2:db:d1:d1:b0:4a,28144901,444,798,28144457,28144901
7056,4,1,1,2412,-87,-89,2,,28146795,304,1590,28146491,28146795
7057,4,1,1,2412,-80,-89,9,3c:bd:c5:ee:96:6d,28158754,2512,9447,28156242,28158754
7058,6,6,1,2412,-76,-89,13,e0:db:d1:d0:b0:49,28162095,212,3129,28161883,28162095
7059,6,6,1,2412,-76,-89,13,e0:db:d1:d0:b0:49,28162322,212,15,28162110,28162322
7060,4,1,1,2412,-73,-89,16,,28164066,304,1440,28163762,28164066
7061,4,1,1,2412,-84,-89,5,b4:b5:2f:17:0c:b9,28164391,1328,-1003,28163063,28164391
7062,4,1,1,2412,-79,-89,10,3c:bd:c5:ee:96:6d,28165750,3280,-1921,28162470,28165750
7063,4,1,1,2412,-78,-89,11,3c:bd:c5:ee:96:6d,28169921,3280,891,28166641,28169921
7064,4,1,1,2412,-73,-89,16,,28173213,304,2988,28172909,28173213
7065,6,24,1,2412,-82,-89,7,,28178722,28,5481,28178694,28178722
7066,6,6,1,2412,-77,-89,12,f8:4f:ad:f9:af:82,28185944,576,6646,28185368,28185944
7067,6,6,1,2412,-77,-89,12,f8:4f:ad:f9:af:82,28186769,632,193,28186137,28186769
7068,6,6,1,2412,-77,-89,12,f8:4f:ad:f9:af:82,28187434,548,117,28186886,28187434
7069,6,6,1,2412,-79,-89,10,10:86:8c:5f:93:1e,28189821,336,2051,28189485,28189821
7070,6,24,1,2412,-82,-89,7,,28191103,28,1254,28191075,28191103
7071,4,1,1,2412,-86,-89,3,78:67:0e:38:6c:d3,28194876,2736,1037,28192140,28194876
7072,6,6,1,2412,-81,-89,8,12:86:8c:5f:93:1e,28213605,332,18397,28213273,28213605
7073,4,1,1,2412,-77,-89,12,b0:e4:d5:32:ec:8a,28227769,1960,12204,28225809,28227769
7074,6,6,1,2412,-76,-89,13,e2:db:d1:d1:b0:4a,28247294,444,19081,28246850,28247294
7075,6,6,1,2412,-76,-89,13,e2:db:d1:d1:b0:4b,28247762,408,60,28247354,28247762
7076,6,6,1,2412,-77,-89,12,e2:db:d1:d1:b0:4d,28248193,408,23,28247785,28248193
7077,6,6,1,2412,-77,-89,12,e2:db:d1:d1:b0:4f,28248652,408,51,28248244,28248652
7078,4,1,1,2412,-84,-89,5,,28264720,304,15764,28264416,28264720
7079,6,24,1,2412,-82,-89,7,,28265403,28,655,28265375,28265403
7080,6,6,1,2412,-79,-89,10,52:86:8c:5f:93:1e,28265553,332,-182,28265221,28265553
7081,4,11,1,2412,-81,-89,8,48:dd:0c:7d:86:27,28270433,362,4518,28270071,28270433
7082,4,11,1,2412,-81,-89,8,48:dd:0c:7d:86:23,28270808,323,52,28270485,28270808
7083,4,11,1,2412,-80,-89,9,48:dd:0c:7d:86:25,28271143,382,-47,28270761,28271143
7084,6,24,1,2412,-83,-89,6,,28277970,28,6799,28277942,28277970
7085,4,1,1,2412,-85,-89,4,,28291182,304,12908,28290878,28291182
7086,4,11,1,2412,-84,-89,5,,28292400,203,1015,28292197,28292400
7087,6,6,1,2412,-78,-89,11,10:86:8c:5f:93:1e,28301008,336,8272,28300672,28301008
7088,4,11,1,2412,-76,-89,13,48:dd:0c:90:e3:83,28306644,323,5313,28306321,28306644
7089,4,11,1,2412,-82,-89,7,48:dd:0c:90:e3:85,28306979,382,-47,28306597,28306979
7090,4,1,1,2412,-85,-89,4,78:67:0e:c4:a8:42,28308574,2736,-1141,28305838,28308574
7091,6,6,1,2412,-81,-89,8,12:86:8c:5f:93:1e,28316007,332,7101,28315675,28316007
7092,4,1,1,2412,-90,-89,-1,00:26:62:eb:ea:74,28321825,968,4850,28320857,28321825
7093,4,1,1,2412,-87,-89,2,ac:67:84:84:8a:07,28322905,416,664,28322489,28322905
7094,4,1,1,2412,-79,-89,10,b0:e4:d5:32:ec:8a,28330169,1960,5304,28328209,28330169
7095,4,1,1,2412,-83,-89,6,,28335716,304,5243,28335412,28335716
7096,4,1,1,2412,-82,-89,7,60:32:b1:64:4c:f2,28336870,3224,-2070,28333646,28336870
7097,6,6,1,2412,-75,-89,14,e2:db:d1:d1:b0:4a,28349713,444,12399,28349269,28349713
7098,6,6,1,2412,-76,-89,13,e2:db:d1:d1:b0:4b,28350199,408,78,28349791,28350199
7099,6,6,1,2412,-76,-89,13,e2:db:d1:d1:b0:4d,28350649,408,42,28350241,28350649
7100,6,6,1,2412,-76,-89,13,e2:db:d1:d1:b0:4f,28351081,408,24,28350673,28351081
7101,4,1,1,2412,-79,-89,10,3c:bd:c5:ee:96:6d,28360742,2512,7149,28358230,28360742
7102,4,1,1,2412,-87,-89,2,bc:98:df:ff:0f:8b,28363784,2568,474,28361216,28363784
7103,6,6,1,2412,-80,-89,9,52:86:8c:5f:93:1e,28370775,332,6659,28370443,28370775
7104,4,1,1,2412,-85,-89,4,ac:67:84:84:8a:07,28371800,416,609,28371384,28371800
7105,4,1,1,2412,-89,-89,0,,28372228,304,124,28371924,28372228
7106,4,11,1,2412,-80,-89,9,48:dd:0c:7d:86:27,28372772,362,182,28372410,28372772
7107,4,11,1,2412,-81,-89,8,48:dd:0c:7d:86:23,28373146,323,51,28372823,28373146
7108,4,11,1,2412,-79,-89,10,48:dd:0c:7d:86:25,28373482,382,-46,28373100,28373482
7109,4,1,1,2412,-87,-89,2,,28374392,304,606,28374088,28374392
7110,4,11,1,2412,-86,-89,3,,28379014,107,4515,28378907,28379014
7111,4,1,1,2412,-84,-89,5,,28382309,352,2943,28381957,28382309
7112,4,11,1,2412,-89,-89,0,4c:01:43:d7:f3:29,28384890,361,2220,28384529,28384890
7113,6,6,1,2412,-81,-89,8,10:86:8c:5f:93:1e,28394485,336,9259,28394149,28394485
7114,4,11,1,2412,-82,-89,7,10:86:8c:5f:93:26,28395093,347,261,28394746,28395093
7115,4,1,1,2412,-87,-89,2,78:67:0e:38:6c:d3,28399676,2736,1847,28396940,28399676
7116,4,11,1,2412,-86,-89,3,4c:01:43:ec:a0:69,28403190,361,3153,28402829,28403190
7117,4,11,1,2412,-78,-89,11,48:dd:0c:90:e3:87,28408669,362,5117,28408307,28408669
7118,4,11,1,2412,-82,-89,7,48:dd:0c:90:e3:85,28409379,382,328,28408997,28409379
7119,4,1,1,2412,-87,-89,2,78:67:0e:c4:a8:42,28410974,2736,-1141,28408238,28410974
7120,6,6,1,2412,-80,-89,9,12:86:8c:5f:93:1e,28418422,332,7116,28418090,28418422
7121,4,1,1,2412,-88,-89,1,bc:98:df:ff:0f:8b,28422188,3176,590,28419012,28422188
7122,6,24,1,2412,-83,-89,6,,28425506,28,3290,28425478,28425506
7123,4,1,1,2412,-89,-89,0,bc:98:df:ff:0f:8b,28425707,3176,-2975,28422531,28425707
7124,4,1,1,2412,-79,-89,10,b0:e4:d5:32:ec:8a,28432568,1960,4901,28430608,28432568
7125,6,6,1,2412,-77,-89,12,f8:4f:ad:f9:af:82,28440382,1360,6454,28439022,28440382
7126,6,6,1,2412,-76,-89,13,f8:4f:ad:f9:af:82,28441927,1332,213,28440595,28441927
7127,6,6,1,2412,-80,-89,9,32:86:8c:5f:93:1e,28445051,332,2792,28444719,28445051
7128,4,1,1,2412,-85,-89,4,b4:b5:2f:17:0c:b9,28451041,1376,4614,28449665,28451041
7129,6,6,1,2412,-76,-89,13,e2:db:d1:d1:b0:4a,28452283,444,798,28451839,28452283
7130,6,6,1,2412,-77,-89,12,e2:db:d1:d1:b0:4b,28452759,408,68,28452351,28452759
7131,6,6,1,2412,-76,-89,13,e2:db:d1:d1:b0:4d,28453219,408,52,28452811,28453219
7132,6,6,1,2412,-76,-89,13,e2:db:d1:d1:b0:4f,28453668,408,41,28453260,28453668
7133,4,1,1,2412,-79,-89,10,3c:bd:c5:ee:96:6d,28462566,2512,6386,28460054,28462566
7134,4,1,1,2412,-79,-89,10,b8:f8:53:cb:31:f1,28465104,976,1562,28464128,28465104
7135,4,11,1,2412,-79,-89,10,48:dd:0c:7d:86:25,28475881,382,10395,28475499,28475881
7136,6,6,1,2412,-77,-89,12,10:86:8c:5f:93:1e,28495547,336,19330,28495211,28495547
7137,4,1,1,2412,-87,-89,2,78:67:0e:38:6c:d3,28502076,2736,3793,28499340,28502076
7138,6,24,1,2412,-82,-89,7,,28506593,28,4489,28506565,28506593
7139,4,11,1,2412,-76,-89,13,48:dd:0c:90:e3:83,28511443,323,4527,28511120,28511443
7140,4,11,1,2412,-84,-89,5,48:dd:0c:90:e3:85,28511779,382,-46,28511397,28511779
7141,4,1,1,2412,-84,-89,5,78:67:0e:c4:a8:42,28513374,2736,-1141,28510638,28513374
7142,4,1,1,2412,-83,-89,6,,28516560,304,2882,28516256,28516560
7143,6,24,1,2412,-84,-89,5,,28518890,28,2302,28518862,28518890
7144,4,1,1,2412,-86,-89,3,,28526266,304,7072,28525962,28526266
7145,4,1,1,2412,-90,-89,-1,00:26:62:eb:ea:74,28527216,968,-18,28526248,28527216
7146,4,1,1,2412,-77,-89,12,b0:e4:d5:32:ec:8a,28534967,1960,5791,28533007,28534967
7147,6,6,1,2412,-81,-89,8,32:86:8c:5f:93:1e,28548123,332,12824,28547791,28548123
7148,4,1,1,2412,-86,-89,3,b4:b5:2f:17:0c:b9,28553942,1376,4443,28552566,28553942
7149,6,6,1,2412,-76,-89,13,e2:db:d1:d1:b0:4a,28555174,444,788,28554730,28555174
7150,6,6,1,2412,-76,-89,13,e2:db:d1:d1:b0:4b,28555651,408,69,28555243,28555651
7151,6,6,1,2412,-76,-89,13,e2:db:d1:d1:b0:4d,28556110,408,51,28555702,28556110
7152,6,6,1,2412,-76,-89,13,e2:db:d1:d1:b0:4f,28556541,408,23,28556133,28556541
7153,4,1,1,2412,-83,-89,6,,28569464,304,12619,28569160,28569464
7154,4,1,1,2412,-88,-89,1,ac:67:84:84:8a:07,28572776,416,2896,28572360,28572776
7155,4,1,1,2412,-88,-89,1,ac:67:84:84:8a:07,28573894,416,702,28573478,28573894
7156,4,1,1,2412,-90,-89,-1,,28574323,304,125,28574019,28574323
7157,4,11,1,2412,-80,-89,9,48:dd:0c:7d:86:27,28577571,362,2886,28577209,28577571
7158,4,11,1,2412,-80,-89,9,48:dd:0c:7d:86:23,28577946,323,52,28577623,28577946
7159,4,11,1,2412,-81,-89,8,48:dd:0c:7d:86:25,28578281,382,-47,28577899,28578281
7160,6,24,1,2412,-82,-89,7,,28585406,28,7097,28585378,28585406
7161,4,1,1,2412,-86,-89,3,,28595794,448,9940,28595346,28595794
7162,6,6,1,2412,-81,-89,8,10:86:8c:5f:93:1e,28600115,336,3985,28599779,28600115
7163,4,1,1,2412,-87,-89,2,78:67:0e:38:6c:d3,28604476,2736,1625,28601740,28604476
7164,4,11,1,2412,-84,-89,5,4c:01:43:ec:a0:63,28608362,322,3564,28608040,28608362
7165,4,11,1,2412,-85,-89,4,4c:01:43:ec:a0:66,28608696,387,-53,28608309,28608696
7166,4,11,1,2412,-83,-89,6,48:dd:0c:90:e3:85,28614178,382,5100,28613796,28614178
7167,4,1,1,2412,-84,-89,5,78:67:0e:c4:a8:42,28615774,2736,-1140,28613038,28615774
7168,6,6,1,2412,-80,-89,9,12:86:8c:5f:93:1e,28623209,332,7103,28622877,28623209
7169,4,1,1,2412,-87,-89,2,ac:67:84:84:8a:07,28624780,416,1155,28624364,28624780
7170,4,1,1,2412,-89,-89,0,ac:67:84:84:8a:07,28637305,416,12109,28636889,28637305
7171,6,6,1,2412,-80,-89,9,32:86:8c:5f:93:1e,28649733,332,12096,28649401,28649733
7172,6,24,1,2412,-81,-89,8,,28654023,28,4262,28653995,28654023
7173,6,6,1,2412,-76,-89,13,e2:db:d1:d1:b0:4a,28656901,444,2434,28656457,28656901
7174,6,6,1,2412,-76,-89,13,e2:db:d1:d1:b0:4d,28657827,408,518,28657419,28657827
7175,4,1,1,2412,-82,-89,7,,28658329,304,198,28658025,28658329
7176,4,1,1,2412,-78,-89,11,,28661085,304,2452,28660781,28661085
7177,6,6,1,2412,-80,-89,9,10:86:8c:5f:93:1e,28661234,500,-351,28660734,28661234
7178,4,1,1,2412,-80,-89,9,3c:bd:c5:ee:96:6d,28667375,2512,3629,28664863,28667375
7179,6,6,1,2412,-79,-89,10,10:86:8c:5f:93:1e,28669839,500,1964,28669339,28669839
7180,4,1,1,2412,-88,-89,1,d2:9e:43:bc:eb:ff,28675660,3600,2221,28672060,28675660
7181,4,1,1,2412,-82,-89,7,66:32:b1:64:4c:f2,28695100,2696,16744,28692404,28695100
7182,4,1,1,2412,-86,-89,3,,28698583,448,3035,28698135,28698583
7183,6,6,1,2412,-80,-89,9,10:86:8c:5f:93:1e,28701484,336,2565,28701148,28701484
7184,4,1,1,2412,-86,-89,3,ac:67:84:84:8a:07,28706820,416,4920,28706404,28706820
7185,4,11,1,2412,-76,-89,13,48:dd:0c:90:e3:87,28715868,362,8686,28715506,28715868
7186,4,11,1,2412,-77,-89,12,48:dd:0c:90:e3:83,28716243,323,52,28715920,28716243
7187,4,11,1,2412,-83,-89,6,48:dd:0c:90:e3:85,28716578,382,-47,28716196,28716578
7188,4,1,1,2412,-85,-89,4,78:67:0e:c4:a8:42,28718174,2736,-1140,28715438,28718174
7189,4,1,1,2412,-86,-89,3,,28720956,352,2430,28720604,28720956
7190,4,1,1,2412,-85,-89,4,,28722237,304,977,28721933,28722237
7191,4,1,1,2412,-86,-89,3,,28723292,304,751,28722988,28723292
7192,6,6,1,2412,-81,-89,8,12:86:8c:5f:93:1e,28725944,332,2320,28725612,28725944
7193,6,24,1,2412,-83,-89,6,,28727375,28,1403,28727347,28727375
7194,4,1,1,2412,-88,-89,1,ac:67:84:84:8a:07,28729914,416,2123,28729498,28729914
7195,6,24,1,2412,-82,-89,7,,28734023,28,4081,28733995,28734023
7196,4,1,1,2412,-78,-89,11,b0:e4:d5:32:ec:8a,28739766,1960,3783,28737806,28739766
7197,4,1,1,2412,-84,-89,5,,28744218,304,4148,28743914,28744218
7198,4,1,1,2412,-85,-89,4,,28745272,304,750,28744968,28745272
7199,6,24,1,2412,-83,-89,6,,28745776,28,476,28745748,28745776
7200,6,6,1,2412,-78,-89,11,32:86:8c:5f:93:1e,28752049,332,5941,28751717,28752049
7201,4,1,1,2412,-85,-89,4,b4:b5:2f:17:0c:b9,28758070,1376,4645,28756694,28758070
7202,6,6,1,2412,-76,-89,13,e2:db:d1:d1:b0:4a,28759320,444,806,28758876,28759320
7203,6,6,1,2412,-76,-89,13,e2:db:d1:d1:b0:4b,28759788,408,60,28759380,28759788
7204,6,6,1,2412,-76,-89,13,e2:db:d1:d1:b0:4d,28760229,408,33,28759821,28760229
7205,6,6,1,2412,-76,-89,13,e2:db:d1:d1:b0:4f,28760661,408,24,28760253,28760661
7206,4,1,1,2412,-86,-89,3,,28775996,304,15031,28775692,28775996
7207,4,1,1,2412,-85,-89,4,,28777048,304,748,28776744,28777048
7208,6,6,1,2412,-80,-89,9,52:86:8c:5f:93:1e,28777310,332,-70,28776978,28777310
7209,4,1,1,2412,-84,-89,5,,28778262,304,648,28777958,28778262
7210,4,1,1,2412,-84,-89,5,,28779315,352,701,28778963,28779315
7211,4,11,1,2412,-82,-89,7,,28781323,107,1901,28781216,28781323
7212,4,1,1,2412,-84,-89,5,,28781899,352,224,28781547,28781899
7213,4,11,1,2412,-79,-89,10,48:dd:0c:7d:86:27,28782371,362,110,28782009,28782371
7214,4,11,1,2412,-79,-89,10,48:dd:0c:7d:86:23,28782746,323,52,28782423,28782746
7215,4,11,1,2412,-79,-89,10,48:dd:0c:7d:86:25,28783081,382,-47,28782699,28783081
7216,4,1,1,2412,-89,-89,0,ce:9e:43:bc:eb:ff,28786251,3800,-630,28782451,28786251
7217,4,1,1,2412,-89,-89,0,c8:9e:43:bc:eb:ff,28790061,3496,314,28786565,28790061
7218,4,11,1,2412,-90,-89,-1,4c:01:43:d7:f3:23,28794861,322,4478,28794539,28794861
7219,4,1,1,2412,-87,-89,2,,28800455,448,5146,28800007,28800455
7220,6,6,1,2412,-80,-89,9,10:86:8c:5f:93:1e,28802521,336,1730,28802185,28802521
7221,4,1,1,2412,-86,-89,3,78:67:0e:c4:a8:42,28820573,2736,15316,28817837,28820573
7222,6,6,1,2412,-84,-89,5,,28823248,44,2631,28823204,28823248
7223,6,24,1,2412,-83,-89,6,,28825409,28,2133,28825381,28825409
7224,6,6,1,2412,-79,-89,10,12:86:8c:5f:93:1e,28828010,332,2269,28827678,28828010
7225,6,24,1,2412,-82,-89,7,,28830489,28,2451,28830461,28830489
7226,6,24,1,2412,-83,-89,6,,28840245,28,9728,28840217,28840245
7227,4,1,1,2412,-77,-89,12,b0:e4:d5:32:ec:8a,28842165,1960,-40,28840205,28842165
7228,4,1,1,2412,-85,-89,4,78:67:0e:c4:a8:42,28845838,848,2825,28844990,28845838
7229,6,6,1,2412,-80,-89,9,32:86:8c:5f:93:1e,28854746,332,8576,28854414,28854746
7230,4,1,1,2412,-84,-89,5,b4:b5:2f:17:0c:b9,28860472,1376,4350,28859096,28860472
7231,6,6,1,2412,-76,-89,13,e2:db:d1:d1:b0:4a,28861722,444,806,28861278,28861722
7232,6,6,1,2412,-76,-89,13,e2:db:d1:d1:b0:4b,28862215,408,85,28861807,28862215
7233,6,6,1,2412,-76,-89,13,e2:db:d1:d1:b0:4d,28862647,408,24,28862239,28862647
7234,6,6,1,2412,-76,-89,13,e2:db:d1:d1:b0:4f,28863105,408,50,28862697,28863105
7235,4,1,1,2412,-80,-89,9,3c:bd:c5:ee:96:6d,28872273,2512,6656,28869761,28872273
7236,4,1,1,2412,-86,-89,3,bc:98:df:ff:0f:8b,28875786,2568,945,28873218,28875786
7237,6,6,1,2412,-81,-89,8,52:86:8c:5f:93:1e,28879210,332,3092,28878878,28879210
7238,4,11,1,2412,-80,-89,9,48:dd:0c:7d:86:27,28884771,362,5199,28884409,28884771
7239,4,11,1,2412,-80,-89,9,48:dd:0c:7d:86:23,28885145,323,51,28884822,28885145
7240,4,11,1,2412,-80,-89,9,48:dd:0c:7d:86:25,28885481,382,-46,28885099,28885481
7241,6,24,1,2412,-81,-89,8,,28896321,28,10812,28896293,28896321
7242,4,1,1,2412,-89,-89,0,d2:9e:43:bc:eb:ff,28896842,3600,-3079,28893242,28896842
7243,4,1,1,2412,-86,-89,3,,28904204,448,6914,28903756,28904204
7244,6,24,1,2412,-82,-89,7,,28905415,28,1183,28905387,28905415
7245,6,6,1,2412,-81,-89,8,10:86:8c:5f:93:1e,28905947,336,196,28905611,28905947
7246,6,24,1,2412,-84,-89,5,,28910311,28,4336,28910283,28910311
7247,4,1,1,2412,-86,-89,3,78:67:0e:38:6c:d3,28911677,2736,-1370,28908941,28911677
7248,4,11,1,2412,-76,-89,13,48:dd:0c:90:e3:83,28921042,323,9042,28920719,28921042
7249,4,11,1,2412,-81,-89,8,48:dd:0c:90:e3:85,28921378,382,-46,28920996,28921378
7250,4,1,1,2412,-84,-89,5,78:67:0e:c4:a8:42,28922973,2736,-1141,28920237,28922973
7251,6,6,1,2412,-81,-89,8,12:86:8c:5f:93:1e,28930411,332,7106,28930079,28930411
7252,4,11,1,2412,-83,-89,6,,28937546,107,7028,28937439,28937546
7253,4,1,1,2412,-86,-89,3,,28939212,352,1314,28938860,28939212
7254,4,1,1,2412,-84,-89,5,,28942428,352,2864,28942076,28942428
7255,4,1,1,2412,-78,-89,11,b0:e4:d5:32:ec:8a,28944565,1960,177,28942605,28944565
7256,4,1,1,2412,-86,-89,3,ac:67:84:84:8a:07,28947474,416,2493,28947058,28947474
7257,6,6,1,2412,-79,-89,10,32:86:8c:5f:93:1e,28957169,332,9363,28956837,28957169
7258,4,1,1,2412,-84,-89,5,b4:b5:2f:17:0c:b9,28962874,1376,4329,28961498,28962874
7259,6,6,1,2412,-76,-89,13,e2:db:d1:d1:b0:4a,28964115,444,797,28963671,28964115
7260,6,6,1,2412,-76,-89,13,e2:db:d1:d1:b0:4b,28964583,408,60,28964175,28964583
7261,6,6,1,2412,-76,-89,13,e2:db:d1:d1:b0:4d,28965024,408,33,28964616,28965024
7262,6,6,1,2412,-76,-89,13,e2:db:d1:d1:b0:4f,28965456,408,24,28965048,28965456
7263,6,24,1,2412,-81,-89,8,,28974026,28,8542,28973998,28974026
7264,4,1,1,2412,-77,-89,12,3c:bd:c5:ee:96:6d,28974576,2512,-1962,28972064,28974576
7265,6,6,1,2412,-80,-89,9,52:86:8c:5f:93:1e,28983341,332,8433,28983009,28983341
7266,6,24,1,2412,-81,-89,8,,28985408,28,2039,28985380,28985408
7267,4,11,1,2412,-81,-89,8,48:dd:0c:7d:86:27,28987171,362,1401,28986809,28987171
7268,4,11,1,2412,-79,-89,10,48:dd:0c:7d:86:23,28987545,323,51,28987222,28987545
7269,4,11,1,2412,-81,-89,8,48:dd:0c:7d:86:25,28987880,382,-47,28987498,28987880
7270,6,24,1,2412,-83,-89,6,,28992169,28,4261,28992141,28992169
7271,6,24,1,2412,-81,-89,8,,28999102,28,6905,28999074,28999102
7272,4,11,1,2412,-89,-89,0,4c:01:43:d7:f3:23,28999703,322,279,28999381,28999703
7273,4,1,1,2412,-86,-89,3,,29006016,448,5865,29005568,29006016
7274,4,1,1,2412,-86,-89,3,ac:67:84:84:8a:07,29006483,416,51,29006067,29006483
7275,6,6,1,2412,-81,-89,8,10:86:8c:5f:93:1e,29008481,336,1662,29008145,29008481
7276,4,1,1,2412,-89,-89,0,ce:9e:43:bc:eb:ff,29009104,3800,-3177,29005304,29009104
7277,4,11,1,2412,-82,-88,6,48:dd:0c:90:e3:85,29023777,382,14291,29023395,29023777
7278,4,1,1,2412,-86,-88,2,ac:67:84:84:8a:07,29029702,416,5509,29029286,29029702
7279,4,1,1,2412,-86,-88,2,,29030879,448,729,29030431,29030879
7280,6,6,1,2412,-79,-88,9,12:86:8c:5f:93:1e,29032812,332,1601,29032480,29032812
7281,4,1,1,2412,-77,-88,11,b0:e4:d5:32:ec:8a,29046964,1960,12192,29045004,29046964
7282,6,24,1,2412,-82,-88,6,,29054032,28,7040,29054004,29054032
7283,6,6,1,2412,-79,-88,9,32:86:8c:5f:93:1e,29059546,332,5182,29059214,29059546
7284,4,1,1,2412,-90,-88,-2,b4:b5:2f:17:0c:b9,29065276,1376,4354,29063900,29065276
7285,6,6,1,2412,-76,-88,12,e2:db:d1:d1:b0:4a,29066517,444,797,29066073,29066517
7286,6,6,1,2412,-76,-88,12,e2:db:d1:d1:b0:4b,29067012,408,87,29066604,29067012
7287,6,6,1,2412,-76,-88,12,e2:db:d1:d1:b0:4d,29067452,408,32,29067044,29067452
7288,6,6,1,2412,-77,-88,11,e2:db:d1:d1:b0:4f,29067885,408,25,29067477,29067885
7289,6,24,1,2412,-86,-88,2,,29070922,28,3009,29070894,29070922
7290,4,1,1,2412,-84,-88,4,ac:67:84:84:8a:07,29071771,416,433,29071355,29071771
7291,4,1,1,2412,-79,-88,9,3c:bd:c5:ee:96:6d,29076984,2512,2701,29074472,29076984
7292,6,6,1,2412,-80,-88,8,52:86:8c:5f:93:1e,29084012,332,6696,29083680,29084012
7293,4,11,1,2412,-80,-88,8,48:dd:0c:7d:86:25,29090280,382,5886,29089898,29090280
7294,4,1,1,2412,-82,-88,6,,29092428,352,1796,29092076,29092428
7295,4,1,1,2412,-84,-88,4,,29095720,352,2940,29095368,29095720
7296,4,1,1,2412,-88,-88,0,bc:98:df:ff:0f:8b,29097985,3176,-911,29094809,29097985
7297,4,1,1,2412,-87,-88,1,bc:98:df:ff:0f:8b,29111647,3176,10486,29108471,29111647
7298,4,1,1,2412,-86,-88,2,78:67:0e:38:6c:d3,29116477,2736,2094,29113741,29116477
7299,6,24,1,2412,-83,-88,5,,29134035,28,17530,29134007,29134035
7300,6,6,1,2412,-81,-88,7,12:86:8c:5f:93:1e,29135212,332,845,29134880,29135212
7301,6,24,1,2412,-82,-88,6,,29145413,28,10173,29145385,29145413
7302,4,1,1,2412,-78,-88,10,b0:e4:d5:32:ec:8a,29149363,1960,1990,29147403,29149363
7303,4,1,1,2412,-76,-88,12,bc:98:df:ff:0f:8b,29153760,3176,1221,29150584,29153760
7304,6,6,1,2412,-76,-88,12,e2:db:d1:d1:b0:4a,29169610,444,15406,29169166,29169610
7305,6,6,1,2412,-76,-88,12,e2:db:d1:d1:b0:4b,29170105,408,87,29169697,29170105
7306,6,6,1,2412,-76,-88,12,e2:db:d1:d1:b0:4d,29170554,408,41,29170146,29170554
7307,6,6,1,2412,-77,-88,11,e2:db:d1:d1:b0:4f,29171013,408,51,29170605,29171013
7308,4,1,1,2412,-87,-88,1,bc:98:df:ff:0f:8b,29183847,2568,10266,29181279,29183847
7309,6,6,1,2412,-79,-88,9,52:86:8c:5f:93:1e,29186599,332,2420,29186267,29186599
7310,4,11,1,2412,-78,-88,10,48:dd:0c:7d:86:27,29191970,362,5009,29191608,29191970
7311,4,11,1,2412,-80,-88,8,48:dd:0c:7d:86:23,29192345,323,52,29192022,29192345
7312,4,11,1,2412,-80,-88,8,48:dd:0c:7d:86:25,29192680,382,-47,29192298,29192680
7313,4,1,1,2412,-83,-88,5,,29193453,352,421,29193101,29193453
7314,4,11,1,2412,-84,-88,4,,29194370,107,810,29194263,29194370
7315,4,11,1,2412,-83,-88,5,,29196169,107,1692,29196062,29196169
7316,4,1,1,2412,-85,-88,3,,29197747,352,1226,29197395,29197747
7317,4,1,1,2412,-86,-88,2,,29211677,448,13482,29211229,29211677
7318,6,6,1,2412,-79,-88,9,10:86:8c:5f:93:1e,29213961,336,1948,29213625,29213961
7319,4,11,1,2412,-72,-88,16,48:dd:0c:90:e3:83,29228242,323,13958,29227919,29228242
7320,4,1,1,2412,-88,-88,0,78:67:0e:c4:a8:42,29230173,2736,-805,29227437,29230173
7321,6,24,1,2412,-83,-88,5,,29240408,28,10207,29240380,29240408
7322,6,6,1,2412,-80,-88,8,12:86:8c:5f:93:1e,29240468,332,-272,29240136,29240468
7323,4,1,1,2412,-79,-88,9,b0:e4:d5:32:ec:8a,29251763,1960,9335,29249803,29251763
7324,6,6,1,2412,-80,-88,8,32:86:8c:5f:93:1e,29264251,332,12156,29263919,29264251
7325,6,6,1,2412,-76,-88,12,e2:db:d1:d1:b0:4a,29271330,444,6635,29270886,29271330
7326,6,6,1,2412,-76,-88,12,e2:db:d1:d1:b0:4b,29271815,408,77,29271407,29271815
7327,6,6,1,2412,-77,-88,11,e2:db:d1:d1:b0:4d,29272274,408,51,29271866,29272274
7328,6,6,1,2412,-76,-88,12,e2:db:d1:d1:b0:4f,29272724,408,42,29272316,29272724
7329,4,1,1,2412,-79,-88,9,3c:bd:c5:ee:96:6d,29281772,2512,6536,29279260,29281772
7330,4,1,1,2412,-87,-88,1,bc:98:df:ff:0f:8b,29285396,2568,1056,29282828,29285396
7331,6,24,1,2412,-82,-88,6,,29293431,28,8007,29293403,29293431
7332,6,24,1,2412,-83,-88,5,,29294047,28,588,29294019,29294047
7333,4,11,1,2412,-90,-88,-2,48:dd:0c:7d:86:27,29294370,362,-39,29294008,29294370
7334,4,11,1,2412,-81,-88,7,48:dd:0c:7d:86:23,29294744,323,51,29294421,29294744
7335,4,11,1,2412,-80,-88,8,48:dd:0c:7d:86:25,29295080,382,-46,29294698,29295080
7336,6,6,1,2412,-79,-88,9,52:86:8c:5f:93:1e,29295316,332,-96,29294984,29295316
7337,4,1,1,2412,-85,-88,3,,29315284,448,19520,29314836,29315284
7338,6,6,1,2412,-80,-88,8,10:86:8c:5f:93:1e,29318263,336,2643,29317927,29318263
7339,6,24,1,2412,-83,-88,5,,29318714,28,423,29318686,29318714
7340,4,1,1,2412,-86,-88,2,78:67:0e:38:6c:d3,29321277,2736,-173,29318541,29321277
7341,4,1,1,2412,-86,-88,2,78:67:0e:38:6c:d2,29324069,832,1960,29323237,29324069
7342,4,11,1,2412,-78,-88,10,48:dd:0c:90:e3:87,29330267,362,5836,29329905,29330267
7343,4,11,1,2412,-78,-88,10,48:dd:0c:90:e3:83,29330641,323,51,29330318,29330641
7344,4,1,1,2412,-79,-88,9,b0:e4:d5:32:ec:8a,29354162,1960,21561,29352202,29354162
7345,4,1,1,2412,-81,-88,7,,29363811,304,9345,29363507,29363811
7346,6,6,1,2412,-80,-88,8,32:86:8c:5f:93:1e,29366496,332,2353,29366164,29366496
7347,6,6,1,2412,-76,-88,12,e2:db:d1:d1:b0:4b,29374217,408,7313,29373809,29374217
7348,6,6,1,2412,-77,-88,11,e2:db:d1:d1:b0:4d,29374649,408,24,29374241,29374649
7349,6,6,1,2412,-76,-88,12,e2:db:d1:d1:b0:4f,29375090,408,33,29374682,29375090
7350,4,1,1,2412,-82,-88,6,,29375594,304,200,29375290,29375594
7351,4,1,1,2412,-89,-88,-1,,29376648,304,750,29376344,29376648
7352,4,1,1,2412,-79,-88,9,3c:bd:c5:ee:96:6d,29384691,2512,5531,29382179,29384691
7353,4,1,1,2412,-80,-88,8,34:15:13:4b:3a:77,29387229,976,1562,29386253,29387229
7354,4,1,1,2412,-88,-88,0,3c:bd:c5:ee:96:6a,29388231,1056,-54,29387175,29388231
7355,6,24,1,2412,-81,-88,7,,29390721,28,2462,29390693,29390721
7356,6,6,1,2412,-80,-88,8,52:86:8c:5f:93:1e,29391255,332,202,29390923,29391255
7357,4,11,1,2412,-81,-88,7,48:dd:0c:7d:86:27,29396770,362,5153,29396408,29396770
7358,4,11,1,2412,-80,-88,8,48:dd:0c:7d:86:23,29397144,323,51,29396821,29397144
7359,4,11,1,2412,-80,-88,8,48:dd:0c:7d:86:25,29397479,382,-47,29397097,29397479
7360,6,24,1,2412,-82,-88,6,,29398470,28,963,29398442,29398470
7361,6,6,1,2412,-78,-88,10,10:86:8c:5f:93:1e,29417987,336,19181,29417651,29417987
7362,4,1,1,2412,-86,-88,2,,29418986,304,695,29418682,29418986
7363,4,1,1,2412,-85,-88,3,,29420040,304,750,29419736,29420040
7364,4,1,1,2412,-88,-88,0,78:67:0e:38:6c:d3,29423677,2736,901,29420941,29423677
7365,4,11,1,2412,-77,-88,11,48:dd:0c:90:e3:87,29432666,362,8627,29432304,29432666
7366,4,11,1,2412,-77,-88,11,48:dd:0c:90:e3:83,29433041,323,52,29432718,29433041
7367,4,11,1,2412,-84,-88,4,48:dd:0c:90:e3:85,29433376,382,-47,29432994,29433376
7368,4,1,1,2412,-84,-88,4,78:67:0e:c4:a8:42,29434972,2736,-1140,29432236,29434972
7369,4,1,1,2412,-87,-88,1,,29439525,304,4249,29439221,29439525
7370,6,6,1,2412,-76,-88,12,f8:4f:ad:f9:af:82,29442263,1360,1378,29440903,29442263
7371,6,6,1,2412,-76,-88,12,f8:4f:ad:f9:af:82,29443656,1332,61,29442324,29443656
7372,4,1,1,2412,-85,-88,3,,29467548,304,23588,29467244,29467548
7373,6,6,1,2412,-81,-88,7,32:86:8c:5f:93:1e,29470279,332,2399,29469947,29470279
7374,4,1,1,2412,-85,-88,3,b4:b5:2f:17:0c:b9,29475561,1376,3906,29474185,29475561
7375,6,6,1,2412,-77,-88,11,e2:db:d1:d1:b0:4a,29476803,444,798,29476359,29476803
7376,6,6,1,2412,-76,-88,12,e2:db:d1:d1:b0:4b,29477270,408,59,29476862,29477270
7377,6,6,1,2412,-76,-88,12,e2:db:d1:d1:b0:4d,29477702,408,24,29477294,29477702
7378,6,6,1,2412,-76,-88,12,e2:db:d1:d1:b0:4f,29478134,408,24,29477726,29478134
7379,6,24,1,2412,-81,-88,7,,29478955,28,793,29478927,29478955
7380,4,1,1,2412,-79,-88,9,3c:bd:c5:ee:96:6d,29487564,2512,6097,29485052,29487564
7381,4,1,1,2412,-87,-88,1,bc:98:df:ff:0f:8b,29490213,2568,81,29487645,29490213
7382,6,6,1,2412,-80,-88,8,52:86:8c:5f:93:1e,29493615,332,3070,29493283,29493615
7383,4,11,1,2412,-79,-88,9,48:dd:0c:7d:86:27,29499174,362,5197,29498812,29499174
7384,4,11,1,2412,-80,-88,8,48:dd:0c:7d:86:23,29499549,323,52,29499226,29499549
7385,4,11,1,2412,-80,-88,8,48:dd:0c:7d:86:25,29499884,382,-47,29499502,29499884
7386,6,6,1,2412,-79,-88,9,10:86:8c:5f:93:1e,29520390,336,20170,29520054,29520390
7387,4,1,1,2412,-85,-88,3,,29522936,304,2242,29522632,29522936
7388,4,1,1,2412,-87,-88,1,78:67:0e:38:6c:d3,29526078,2736,406,29523342,29526078
7389,4,1,1,2412,-83,-88,5,,29529579,304,3197,29529275,29529579
7390,4,11,1,2412,-77,-88,11,48:dd:0c:90:e3:87,29535066,362,5125,29534704,29535066
7391,4,11,1,2412,-77,-88,11,48:dd:0c:90:e3:83,29535441,323,52,29535118,29535441
7392,4,11,1,2412,-83,-88,5,48:dd:0c:90:e3:85,29535776,382,-47,29535394,29535776
7393,4,1,1,2412,-85,-88,3,78:67:0e:c4:a8:42,29537372,2736,-1140,29534636,29537372
7394,4,1,1,2412,-83,-88,5,,29544069,304,6393,29543765,29544069
7395,6,6,1,2412,-81,-88,7,12:86:8c:5f:93:1e,29544816,332,415,29544484,29544816
7396,6,24,1,2412,-84,-88,4,,29551500,28,6656,29551472,29551500
7397,4,11,1,2412,-85,-88,3,4c:01:43:ec:a0:63,29555208,254,3454,29554954,29555208
7398,4,1,1,2412,-78,-88,10,b0:e4:d5:32:ec:8a,29558961,1960,1793,29557001,29558961
